kernel,Outer,Inner,Iter,VarDecl,refExpr,intLiteral,floatLiteral,mem_to,mem_from,add_sub_int,add_sub_double,mul_int,mul_double,div_double,assign_int,assign_double,runtime1,runtime
39,43,41,1763,2,318,81,1,40312,40312,118,39,79,39,0,1,41,7100,0.0071
539,43,41,1763,2,4318,1081,1,376312,376312,1618,539,1079,539,0,1,541,3372,0.003372
1039,43,41,1763,2,8318,2081,1,712312,712312,3118,1039,2079,1039,0,1,1041,13121,0.013121
1539,43,41,1763,2,12318,3081,1,1048312,1048312,4618,1539,3079,1539,0,1,1541,6049,0.006049
2039,43,41,1763,2,16318,4081,1,1384312,1384312,6118,2039,4079,2039,0,1,2041,7693,0.007693
2539,43,41,1763,2,20318,5081,1,1720312,1720312,7618,2539,5079,2539,0,1,2541,9449,0.009449
3039,43,41,1763,2,24318,6081,1,2056312,2056312,9118,3039,6079,3039,0,1,3041,3292,0.003292
3539,43,41,1763,2,28318,7081,1,2392312,2392312,10618,3539,7079,3539,0,1,3541,12675,0.012675
4039,43,41,1763,2,32318,8081,1,2728312,2728312,12118,4039,8079,4039,0,1,4041,15744,0.015744
4539,43,41,1763,2,36318,9081,1,3064312,3064312,13618,4539,9079,4539,0,1,4541,15524,0.015524
5039,43,41,1763,2,40318,10081,1,3400312,3400312,15118,5039,10079,5039,0,1,5041,17154,0.017154
5539,43,41,1763,2,44318,11081,1,3736312,3736312,16618,5539,11079,5539,0,1,5541,18385,0.018385
6039,43,41,1763,2,48318,12081,1,4072312,4072312,18118,6039,12079,6039,0,1,6041,2044,0.002044
6539,43,41,1763,2,52318,13081,1,4408312,4408312,19618,6539,13079,6539,0,1,6541,19479,0.019479
7039,43,41,1763,2,56318,14081,1,4744312,4744312,21118,7039,14079,7039,0,1,7041,22622,0.022622
35,40,45,1800,2,286,73,1,38200,38200,106,35,71,35,0,1,37,2220,0.00222
535,40,45,1800,2,4286,1073,1,378200,378200,1606,535,1071,535,0,1,537,3413,0.003413
1035,40,45,1800,2,8286,2073,1,718200,718200,3106,1035,2071,1035,0,1,1037,4786,0.004786
1535,40,45,1800,2,12286,3073,1,1058200,1058200,4606,1535,3071,1535,0,1,1537,5842,0.005842
2035,40,45,1800,2,16286,4073,1,1398200,1398200,6106,2035,4071,2035,0,1,2037,7501,0.007501
2535,40,45,1800,2,20286,5073,1,1738200,1738200,7606,2535,5071,2535,0,1,2537,8817,0.008817
3035,40,45,1800,2,24286,6073,1,2078200,2078200,9106,3035,6071,3035,0,1,3037,881,0.000881
3535,40,45,1800,2,28286,7073,1,2418200,2418200,10606,3535,7071,3535,0,1,3537,12571,0.012571
4035,40,45,1800,2,32286,8073,1,2758200,2758200,12106,4035,8071,4035,0,1,4037,14577,0.014577
4535,40,45,1800,2,36286,9073,1,3098200,3098200,13606,4535,9071,4535,0,1,4537,14945,0.014945
5035,40,45,1800,2,40286,10073,1,3438200,3438200,15106,5035,10071,5035,0,1,5037,16917,0.016917
5535,40,45,1800,2,44286,11073,1,3778200,3778200,16606,5535,11071,5535,0,1,5537,17825,0.017825
6035,40,45,1800,2,48286,12073,1,4118200,4118200,18106,6035,12071,6035,0,1,6037,19951,0.019951
6535,40,45,1800,2,52286,13073,1,4458200,4458200,19606,6535,13071,6535,0,1,6537,20754,0.020754
7035,40,45,1800,2,56286,14073,1,4798200,4798200,21106,7035,14071,7035,0,1,7037,22250,0.02225
40,50,40,2000,2,326,83,1,44800,44800,121,40,81,40,0,1,42,8249,0.008249
440,50,40,2000,2,3526,883,1,332800,332800,1321,440,881,440,0,1,442,3530,0.00353
840,50,40,2000,2,6726,1683,1,620800,620800,2521,840,1681,840,0,1,842,3531,0.003531
1240,50,40,2000,2,9926,2483,1,908800,908800,3721,1240,2481,1240,0,1,1242,13852,0.013852
1640,50,40,2000,2,13126,3283,1,1196800,1196800,4921,1640,3281,1640,0,1,1642,204,0.000204
2040,50,40,2000,2,16326,4083,1,1484800,1484800,6121,2040,4081,2040,0,1,2042,8591,0.008591
2440,50,40,2000,2,19526,4883,1,1772800,1772800,7321,2440,4881,2440,0,1,2442,8785,0.008785
2840,50,40,2000,2,22726,5683,1,2060800,2060800,8521,2840,5681,2840,0,1,2842,9822,0.009822
3240,50,40,2000,2,25926,6483,1,2348800,2348800,9721,3240,6481,3240,0,1,3242,11534,0.011534
3640,50,40,2000,2,29126,7283,1,2636800,2636800,10921,3640,7281,3640,0,1,3642,12738,0.012738
4040,50,40,2000,2,32326,8083,1,2924800,2924800,12121,4040,8081,4040,0,1,4042,13810,0.01381
4440,50,40,2000,2,35526,8883,1,3212800,3212800,13321,4440,8881,4440,0,1,4442,15532,0.015532
4840,50,40,2000,2,38726,9683,1,3500800,3500800,14521,4840,9681,4840,0,1,4842,14987,0.014987
5240,50,40,2000,2,41926,10483,1,3788800,3788800,15721,5240,10481,5240,0,1,5242,17528,0.017528
5640,50,40,2000,2,45126,11283,1,4076800,4076800,16921,5640,11281,5640,0,1,5642,18550,0.01855
6040,50,40,2000,2,48326,12083,1,4364800,4364800,18121,6040,12081,6040,0,1,6042,20129,0.020129
6440,50,40,2000,2,51526,12883,1,4652800,4652800,19321,6440,12881,6440,0,1,6442,20774,0.020774
6840,50,40,2000,2,54726,13683,1,4940800,4940800,20521,6840,13681,6840,0,1,6842,23055,0.023055
44,53,55,2915,2,358,91,1,61336,61336,133,44,89,44,0,1,46,5217,0.005217
544,53,55,2915,2,4358,1091,1,493336,493336,1633,544,1089,544,0,1,546,4135,0.004135
1044,53,55,2915,2,8358,2091,1,925336,925336,3133,1044,2089,1044,0,1,1046,6156,0.006156
1544,53,55,2915,2,12358,3091,1,1357336,1357336,4633,1544,3089,1544,0,1,1546,7238,0.007238
2044,53,55,2915,2,16358,4091,1,1789336,1789336,6133,2044,4089,2044,0,1,2046,7624,0.007624
2544,53,55,2915,2,20358,5091,1,2221336,2221336,7633,2544,5089,2544,0,1,2546,25450,0.02545
3044,53,55,2915,2,24358,6091,1,2653336,2653336,9133,3044,6089,3044,0,1,3046,11617,0.011617
3544,53,55,2915,2,28358,7091,1,3085336,3085336,10633,3544,7089,3544,0,1,3546,12532,0.012532
4044,53,55,2915,2,32358,8091,1,3517336,3517336,12133,4044,8089,4044,0,1,4046,14045,0.014045
4544,53,55,2915,2,36358,9091,1,3949336,3949336,13633,4544,9089,4544,0,1,4546,15505,0.015505
5044,53,55,2915,2,40358,10091,1,4381336,4381336,15133,5044,10089,5044,0,1,5046,16999,0.016999
5544,53,55,2915,2,44358,11091,1,4813336,4813336,16633,5544,11089,5544,0,1,5546,18494,0.018494
6044,53,55,2915,2,48358,12091,1,5245336,5245336,18133,6044,12089,6044,0,1,6046,19956,0.019956
6544,53,55,2915,2,52358,13091,1,5677336,5677336,19633,6544,13089,6544,0,1,6546,21930,0.02193
7044,53,55,2915,2,56358,14091,1,6109336,6109336,21133,7044,14089,7044,0,1,7046,22962,0.022962
55,55,65,3575,2,446,113,1,81400,81400,166,55,111,55,0,1,57,6852,0.006852
455,55,65,3575,2,3646,913,1,465400,465400,1366,455,911,455,0,1,457,3554,0.003554
855,55,65,3575,2,6846,1713,1,849400,849400,2566,855,1711,855,0,1,857,3962,0.003962
1255,55,65,3575,2,10046,2513,1,1233400,1233400,3766,1255,2511,1255,0,1,1257,4366,0.004366
1655,55,65,3575,2,13246,3313,1,1617400,1617400,4966,1655,3311,1655,0,1,1657,6983,0.006983
2055,55,65,3575,2,16446,4113,1,2001400,2001400,6166,2055,4111,2055,0,1,2057,8545,0.008545
2455,55,65,3575,2,19646,4913,1,2385400,2385400,7366,2455,4911,2455,0,1,2457,669,0.000669
2855,55,65,3575,2,22846,5713,1,2769400,2769400,8566,2855,5711,2855,0,1,2857,11254,0.011254
3255,55,65,3575,2,26046,6513,1,3153400,3153400,9766,3255,6511,3255,0,1,3257,12706,0.012706
3655,55,65,3575,2,29246,7313,1,3537400,3537400,10966,3655,7311,3655,0,1,3657,14833,0.014833
4055,55,65,3575,2,32446,8113,1,3921400,3921400,12166,4055,8111,4055,0,1,4057,13831,0.013831
4455,55,65,3575,2,35646,8913,1,4305400,4305400,13366,4455,8911,4455,0,1,4457,16680,0.01668
4855,55,65,3575,2,38846,9713,1,4689400,4689400,14566,4855,9711,4855,0,1,4857,18172,0.018172
5255,55,65,3575,2,42046,10513,1,5073400,5073400,15766,5255,10511,5255,0,1,5257,19265,0.019265
5655,55,65,3575,2,45246,11313,1,5457400,5457400,16966,5655,11311,5655,0,1,5657,21180,0.02118
6055,55,65,3575,2,48446,12113,1,5841400,5841400,18166,6055,12111,6055,0,1,6057,25399,0.025399
6455,55,65,3575,2,51646,12913,1,6225400,6225400,19366,6455,12911,6455,0,1,6457,24113,0.024113
6855,55,65,3575,2,54846,13713,1,6609400,6609400,20566,6855,13711,6855,0,1,6857,25075,0.025075
40,300,40,12000,2,326,83,1,204800,204800,121,40,81,40,0,1,42,1100,0.0011
440,300,40,12000,2,3526,883,1,1292800,1292800,1321,440,881,440,0,1,442,3446,0.003446
840,300,40,12000,2,6726,1683,1,2380800,2380800,2521,840,1681,840,0,1,842,5459,0.005459
1240,300,40,12000,2,9926,2483,1,3468800,3468800,3721,1240,2481,1240,0,1,1242,7126,0.007126
1640,300,40,12000,2,13126,3283,1,4556800,4556800,4921,1640,3281,1640,0,1,1642,9010,0.00901
2040,300,40,12000,2,16326,4083,1,5644800,5644800,6121,2040,4081,2040,0,1,2042,10719,0.010719
2440,300,40,12000,2,19526,4883,1,6732800,6732800,7321,2440,4881,2440,0,1,2442,12588,0.012588
2840,300,40,12000,2,22726,5683,1,7820800,7820800,8521,2840,5681,2840,0,1,2842,14692,0.014692
3240,300,40,12000,2,25926,6483,1,8908800,8908800,9721,3240,6481,3240,0,1,3242,17040,0.01704
3640,300,40,12000,2,29126,7283,1,9996800,9996800,10921,3640,7281,3640,0,1,3642,20933,0.020933
4040,300,40,12000,2,32326,8083,1,11084800,11084800,12121,4040,8081,4040,0,1,4042,21036,0.021036
4440,300,40,12000,2,35526,8883,1,12172800,12172800,13321,4440,8881,4440,0,1,4442,25659,0.025659
4840,300,40,12000,2,38726,9683,1,13260800,13260800,14521,4840,9681,4840,0,1,4842,24063,0.024063
5240,300,40,12000,2,41926,10483,1,14348800,14348800,15721,5240,10481,5240,0,1,5242,7287,0.007287
5640,300,40,12000,2,45126,11283,1,15436800,15436800,16921,5640,11281,5640,0,1,5642,28143,0.028143
6040,300,40,12000,2,48326,12083,1,16524800,16524800,18121,6040,12081,6040,0,1,6042,30619,0.030619
6440,300,40,12000,2,51526,12883,1,17612800,17612800,19321,6440,12881,6440,0,1,6442,32116,0.032116
6840,300,40,12000,2,54726,13683,1,18700800,18700800,20521,6840,13681,6840,0,1,6842,35826,0.035826
40,50,340,17000,2,326,83,1,260800,260800,121,40,81,40,0,1,42,3791,0.003791
440,50,340,17000,2,3526,883,1,1508800,1508800,1321,440,881,440,0,1,442,5182,0.005182
840,50,340,17000,2,6726,1683,1,2756800,2756800,2521,840,1681,840,0,1,842,14508,0.014508
1240,50,340,17000,2,9926,2483,1,4004800,4004800,3721,1240,2481,1240,0,1,1242,7543,0.007543
1640,50,340,17000,2,13126,3283,1,5252800,5252800,4921,1640,3281,1640,0,1,1642,2344,0.002344
2040,50,340,17000,2,16326,4083,1,6500800,6500800,6121,2040,4081,2040,0,1,2042,12068,0.012068
2440,50,340,17000,2,19526,4883,1,7748800,7748800,7321,2440,4881,2440,0,1,2442,14419,0.014419
2840,50,340,17000,2,22726,5683,1,8996800,8996800,8521,2840,5681,2840,0,1,2842,16631,0.016631
3240,50,340,17000,2,25926,6483,1,10244800,10244800,9721,3240,6481,3240,0,1,3242,18487,0.018487
3640,50,340,17000,2,29126,7283,1,11492800,11492800,10921,3640,7281,3640,0,1,3642,22286,0.022286
4040,50,340,17000,2,32326,8083,1,12740800,12740800,12121,4040,8081,4040,0,1,4042,22373,0.022373
4440,50,340,17000,2,35526,8883,1,13988800,13988800,13321,4440,8881,4440,0,1,4442,25495,0.025495
4840,50,340,17000,2,38726,9683,1,15236800,15236800,14521,4840,9681,4840,0,1,4842,26887,0.026887
5240,50,340,17000,2,41926,10483,1,16484800,16484800,15721,5240,10481,5240,0,1,5242,28899,0.028899
5640,50,340,17000,2,45126,11283,1,17732800,17732800,16921,5640,11281,5640,0,1,5642,30974,0.030974
6040,50,340,17000,2,48326,12083,1,18980800,18980800,18121,6040,12081,6040,0,1,6042,2481,0.002481
6440,50,340,17000,2,51526,12883,1,20228800,20228800,19321,6440,12881,6440,0,1,6442,34857,0.034857
6840,50,340,17000,2,54726,13683,1,21476800,21476800,20521,6840,13681,6840,0,1,6842,37304,0.037304
55,305,65,19825,2,446,113,1,321400,321400,166,55,111,55,0,1,57,1413,0.001413
455,305,65,19825,2,3646,913,1,1505400,1505400,1366,455,911,455,0,1,457,3995,0.003995
855,305,65,19825,2,6846,1713,1,2689400,2689400,2566,855,1711,855,0,1,857,5971,0.005971
1255,305,65,19825,2,10046,2513,1,3873400,3873400,3766,1255,2511,1255,0,1,1257,8098,0.008098
1655,305,65,19825,2,13246,3313,1,5057400,5057400,4966,1655,3311,1655,0,1,1657,10557,0.010557
2055,305,65,19825,2,16446,4113,1,6241400,6241400,6166,2055,4111,2055,0,1,2057,12650,0.01265
2455,305,65,19825,2,19646,4913,1,7425400,7425400,7366,2455,4911,2455,0,1,2457,14888,0.014888
2855,305,65,19825,2,22846,5713,1,8609400,8609400,8566,2855,5711,2855,0,1,2857,18842,0.018842
3255,305,65,19825,2,26046,6513,1,9793400,9793400,9766,3255,6511,3255,0,1,3257,19101,0.019101
3655,305,65,19825,2,29246,7313,1,10977400,10977400,10966,3655,7311,3655,0,1,3657,24195,0.024195
4055,305,65,19825,2,32446,8113,1,12161400,12161400,12166,4055,8111,4055,0,1,4057,23401,0.023401
4455,305,65,19825,2,35646,8913,1,13345400,13345400,13366,4455,8911,4455,0,1,4457,25467,0.025467
4855,305,65,19825,2,38846,9713,1,14529400,14529400,14566,4855,9711,4855,0,1,4857,27725,0.027725
5255,305,65,19825,2,42046,10513,1,15713400,15713400,15766,5255,10511,5255,0,1,5257,30142,0.030142
5655,305,65,19825,2,45246,11313,1,16897400,16897400,16966,5655,11311,5655,0,1,5657,31582,0.031582
6055,305,65,19825,2,48446,12113,1,18081400,18081400,18166,6055,12111,6055,0,1,6057,33863,0.033863
6455,305,65,19825,2,51646,12913,1,19265400,19265400,19366,6455,12911,6455,0,1,6457,36192,0.036192
6855,305,65,19825,2,54846,13713,1,20449400,20449400,20566,6855,13711,6855,0,1,6857,38223,0.038223
55,55,365,20075,2,446,113,1,345400,345400,166,55,111,55,0,1,57,1130,0.00113
455,55,365,20075,2,3646,913,1,1689400,1689400,1366,455,911,455,0,1,457,5411,0.005411
855,55,365,20075,2,6846,1713,1,3033400,3033400,2566,855,1711,855,0,1,857,257,0.000257
1255,55,365,20075,2,10046,2513,1,4377400,4377400,3766,1255,2511,1255,0,1,1257,8339,0.008339
1655,55,365,20075,2,13246,3313,1,5721400,5721400,4966,1655,3311,1655,0,1,1657,10283,0.010283
2055,55,365,20075,2,16446,4113,1,7065400,7065400,6166,2055,4111,2055,0,1,2057,15426,0.015426
2455,55,365,20075,2,19646,4913,1,8409400,8409400,7366,2455,4911,2455,0,1,2457,18192,0.018192
2855,55,365,20075,2,22846,5713,1,9753400,9753400,8566,2855,5711,2855,0,1,2857,17092,0.017092
3255,55,365,20075,2,26046,6513,1,11097400,11097400,9766,3255,6511,3255,0,1,3257,21032,0.021032
3655,55,365,20075,2,29246,7313,1,12441400,12441400,10966,3655,7311,3655,0,1,3657,22561,0.022561
4055,55,365,20075,2,32446,8113,1,13785400,13785400,12166,4055,8111,4055,0,1,4057,23194,0.023194
4455,55,365,20075,2,35646,8913,1,15129400,15129400,13366,4455,8911,4455,0,1,4457,15165,0.015165
4855,55,365,20075,2,38846,9713,1,16473400,16473400,14566,4855,9711,4855,0,1,4857,29012,0.029012
5255,55,365,20075,2,42046,10513,1,17817400,17817400,15766,5255,10511,5255,0,1,5257,30184,0.030184
5655,55,365,20075,2,45246,11313,1,19161400,19161400,16966,5655,11311,5655,0,1,5657,35345,0.035345
6055,55,365,20075,2,48446,12113,1,20505400,20505400,18166,6055,12111,6055,0,1,6057,29082,0.029082
6455,55,365,20075,2,51646,12913,1,21849400,21849400,19366,6455,12911,6455,0,1,6457,43476,0.043476
6855,55,365,20075,2,54846,13713,1,23193400,23193400,20566,6855,13711,6855,0,1,6857,39293,0.039293
35,40,545,21800,2,286,73,1,338200,338200,106,35,71,35,0,1,37,1730,0.00173
535,40,545,21800,2,4286,1073,1,2678200,2678200,1606,535,1071,535,0,1,537,6587,0.006587
1035,40,545,21800,2,8286,2073,1,5018200,5018200,3106,1035,2071,1035,0,1,1037,9073,0.009073
1535,40,545,21800,2,12286,3073,1,7358200,7358200,4606,1535,3071,1535,0,1,1537,10550,0.01055
2035,40,545,21800,2,16286,4073,1,9698200,9698200,6106,2035,4071,2035,0,1,2037,13461,0.013461
2535,40,545,21800,2,20286,5073,1,12038200,12038200,7606,2535,5071,2535,0,1,2537,16532,0.016532
3035,40,545,21800,2,24286,6073,1,14378200,14378200,9106,3035,6071,3035,0,1,3037,20840,0.02084
3535,40,545,21800,2,28286,7073,1,16718200,16718200,10606,3535,7071,3535,0,1,3537,22949,0.022949
4035,40,545,21800,2,32286,8073,1,19058200,19058200,12106,4035,8071,4035,0,1,4037,27215,0.027215
4535,40,545,21800,2,36286,9073,1,21398200,21398200,13606,4535,9071,4535,0,1,4537,28341,0.028341
5035,40,545,21800,2,40286,10073,1,23738200,23738200,15106,5035,10071,5035,0,1,5037,31476,0.031476
5535,40,545,21800,2,44286,11073,1,26078200,26078200,16606,5535,11071,5535,0,1,5537,34199,0.034199
6035,40,545,21800,2,48286,12073,1,28418200,28418200,18106,6035,12071,6035,0,1,6037,37450,0.03745
6535,40,545,21800,2,52286,13073,1,30758200,30758200,19606,6535,13071,6535,0,1,6537,40142,0.040142
7035,40,545,21800,2,56286,14073,1,33098200,33098200,21106,7035,14071,7035,0,1,7037,43215,0.043215
40,550,40,22000,2,326,83,1,364800,364800,121,40,81,40,0,1,42,2420,0.00242
440,550,40,22000,2,3526,883,1,2252800,2252800,1321,440,881,440,0,1,442,4135,0.004135
840,550,40,22000,2,6726,1683,1,4140800,4140800,2521,840,1681,840,0,1,842,6535,0.006535
1240,550,40,22000,2,9926,2483,1,6028800,6028800,3721,1240,2481,1240,0,1,1242,8871,0.008871
1640,550,40,22000,2,13126,3283,1,7916800,7916800,4921,1640,3281,1640,0,1,1642,11848,0.011848
2040,550,40,22000,2,16326,4083,1,9804800,9804800,6121,2040,4081,2040,0,1,2042,13526,0.013526
2440,550,40,22000,2,19526,4883,1,11692800,11692800,7321,2440,4881,2440,0,1,2442,16119,0.016119
2840,550,40,22000,2,22726,5683,1,13580800,13580800,8521,2840,5681,2840,0,1,2842,19032,0.019032
3240,550,40,22000,2,25926,6483,1,15468800,15468800,9721,3240,6481,3240,0,1,3242,21811,0.021811
3640,550,40,22000,2,29126,7283,1,17356800,17356800,10921,3640,7281,3640,0,1,3642,25656,0.025656
4040,550,40,22000,2,32326,8083,1,19244800,19244800,12121,4040,8081,4040,0,1,4042,26401,0.026401
4440,550,40,22000,2,35526,8883,1,21132800,21132800,13321,4440,8881,4440,0,1,4442,28609,0.028609
4840,550,40,22000,2,38726,9683,1,23020800,23020800,14521,4840,9681,4840,0,1,4842,30757,0.030757
5240,550,40,22000,2,41926,10483,1,24908800,24908800,15721,5240,10481,5240,0,1,5242,33569,0.033569
5640,550,40,22000,2,45126,11283,1,26796800,26796800,16921,5640,11281,5640,0,1,5642,36237,0.036237
6040,550,40,22000,2,48326,12083,1,28684800,28684800,18121,6040,12081,6040,0,1,6042,38131,0.038131
6440,550,40,22000,2,51526,12883,1,30572800,30572800,19321,6440,12881,6440,0,1,6442,40897,0.040897
6840,550,40,22000,2,54726,13683,1,32460800,32460800,20521,6840,13681,6840,0,1,6842,43601,0.043601
39,43,541,23263,2,318,81,1,368312,368312,118,39,79,39,0,1,41,4642,0.004642
539,43,541,23263,2,4318,1081,1,2704312,2704312,1618,539,1079,539,0,1,541,10891,0.010891
1039,43,541,23263,2,8318,2081,1,5040312,5040312,3118,1039,2079,1039,0,1,1041,11622,0.011622
1539,43,541,23263,2,12318,3081,1,7376312,7376312,4618,1539,3079,1539,0,1,1541,10833,0.010833
2039,43,541,23263,2,16318,4081,1,9712312,9712312,6118,2039,4079,2039,0,1,2041,14431,0.014431
2539,43,541,23263,2,20318,5081,1,12048312,12048312,7618,2539,5079,2539,0,1,2541,1267,0.001267
3039,43,541,23263,2,24318,6081,1,14384312,14384312,9118,3039,6079,3039,0,1,3041,22244,0.022244
3539,43,541,23263,2,28318,7081,1,16720312,16720312,10618,3539,7079,3539,0,1,3541,24247,0.024247
4039,43,541,23263,2,32318,8081,1,19056312,19056312,12118,4039,8079,4039,0,1,4041,2433,0.002433
4539,43,541,23263,2,36318,9081,1,21392312,21392312,13618,4539,9079,4539,0,1,4541,30328,0.030328
5039,43,541,23263,2,40318,10081,1,23728312,23728312,15118,5039,10079,5039,0,1,5041,33412,0.033412
5539,43,541,23263,2,44318,11081,1,26064312,26064312,16618,5539,11079,5539,0,1,5541,35281,0.035281
6039,43,541,23263,2,48318,12081,1,28400312,28400312,18118,6039,12079,6039,0,1,6041,39657,0.039657
6539,43,541,23263,2,52318,13081,1,30736312,30736312,19618,6539,13079,6539,0,1,6541,41378,0.041378
7039,43,541,23263,2,56318,14081,1,33072312,33072312,21118,7039,14079,7039,0,1,7041,44103,0.044103
39,593,41,24313,2,318,81,1,392312,392312,118,39,79,39,0,1,41,1411,0.001411
539,593,41,24313,2,4318,1081,1,2928312,2928312,1618,539,1079,539,0,1,541,5949,0.005949
1039,593,41,24313,2,8318,2081,1,5464312,5464312,3118,1039,2079,1039,0,1,1041,10396,0.010396
1539,593,41,24313,2,12318,3081,1,8000312,8000312,4618,1539,3079,1539,0,1,1541,11240,0.01124
2039,593,41,24313,2,16318,4081,1,10536312,10536312,6118,2039,4079,2039,0,1,2041,14131,0.014131
2539,593,41,24313,2,20318,5081,1,13072312,13072312,7618,2539,5079,2539,0,1,2541,17442,0.017442
3039,593,41,24313,2,24318,6081,1,15608312,15608312,9118,3039,6079,3039,0,1,3041,21169,0.021169
3539,593,41,24313,2,28318,7081,1,18144312,18144312,10618,3539,7079,3539,0,1,3541,23976,0.023976
4039,593,41,24313,2,32318,8081,1,20680312,20680312,12118,4039,8079,4039,0,1,4041,28837,0.028837
4539,593,41,24313,2,36318,9081,1,23216312,23216312,13618,4539,9079,4539,0,1,4541,31109,0.031109
5039,593,41,24313,2,40318,10081,1,25752312,25752312,15118,5039,10079,5039,0,1,5041,35966,0.035966
5539,593,41,24313,2,44318,11081,1,28288312,28288312,16618,5539,11079,5539,0,1,5541,38293,0.038293
6039,593,41,24313,2,48318,12081,1,30824312,30824312,18118,6039,12079,6039,0,1,6041,40093,0.040093
6539,593,41,24313,2,52318,13081,1,33360312,33360312,19618,6539,13079,6539,0,1,6541,42193,0.042193
7039,593,41,24313,2,56318,14081,1,35896312,35896312,21118,7039,14079,7039,0,1,7041,47148,0.047148
35,590,45,26550,2,286,73,1,390200,390200,106,35,71,35,0,1,37,1383,0.001383
535,590,45,26550,2,4286,1073,1,2930200,2930200,1606,535,1071,535,0,1,537,5421,0.005421
1035,590,45,26550,2,8286,2073,1,5470200,5470200,3106,1035,2071,1035,0,1,1037,8687,0.008687
1535,590,45,26550,2,12286,3073,1,8010200,8010200,4606,1535,3071,1535,0,1,1537,12452,0.012452
2035,590,45,26550,2,16286,4073,1,10550200,10550200,6106,2035,4071,2035,0,1,2037,15824,0.015824
2535,590,45,26550,2,20286,5073,1,13090200,13090200,7606,2535,5071,2535,0,1,2537,22540,0.02254
3035,590,45,26550,2,24286,6073,1,15630200,15630200,9106,3035,6071,3035,0,1,3037,22512,0.022512
3535,590,45,26550,2,28286,7073,1,18170200,18170200,10606,3535,7071,3535,0,1,3537,25747,0.025747
4035,590,45,26550,2,32286,8073,1,20710200,20710200,12106,4035,8071,4035,0,1,4037,29242,0.029242
4535,590,45,26550,2,36286,9073,1,23250200,23250200,13606,4535,9071,4535,0,1,4537,33394,0.033394
5035,590,45,26550,2,40286,10073,1,25790200,25790200,15106,5035,10071,5035,0,1,5037,36678,0.036678
5535,590,45,26550,2,44286,11073,1,28330200,28330200,16606,5535,11071,5535,0,1,5537,38391,0.038391
6035,590,45,26550,2,48286,12073,1,30870200,30870200,18106,6035,12071,6035,0,1,6037,41937,0.041937
6535,590,45,26550,2,52286,13073,1,33410200,33410200,19606,6535,13071,6535,0,1,6537,52278,0.052278
7035,590,45,26550,2,56286,14073,1,35950200,35950200,21106,7035,14071,7035,0,1,7037,48883,0.048883
44,53,555,29415,2,358,91,1,449336,449336,133,44,89,44,0,1,46,762,0.000762
544,53,555,29415,2,4358,1091,1,2881336,2881336,1633,544,1089,544,0,1,546,11658,0.011658
1044,53,555,29415,2,8358,2091,1,5313336,5313336,3133,1044,2089,1044,0,1,1046,324,0.000324
1544,53,555,29415,2,12358,3091,1,7745336,7745336,4633,1544,3089,1544,0,1,1546,14171,0.014171
2044,53,555,29415,2,16358,4091,1,10177336,10177336,6133,2044,4089,2044,0,1,2046,1841,0.001841
2544,53,555,29415,2,20358,5091,1,12609336,12609336,7633,2544,5089,2544,0,1,2546,28315,0.028315
3044,53,555,29415,2,24358,6091,1,15041336,15041336,9133,3044,6089,3044,0,1,3046,35641,0.035641
3544,53,555,29415,2,28358,7091,1,17473336,17473336,10633,3544,7089,3544,0,1,3546,18235,0.018235
4044,53,555,29415,2,32358,8091,1,19905336,19905336,12133,4044,8089,4044,0,1,4046,42292,0.042292
4544,53,555,29415,2,36358,9091,1,22337336,22337336,13633,4544,9089,4544,0,1,4546,47174,0.047174
5044,53,555,29415,2,40358,10091,1,24769336,24769336,15133,5044,10089,5044,0,1,5046,51517,0.051517
5544,53,555,29415,2,44358,11091,1,27201336,27201336,16633,5544,11089,5544,0,1,5546,57380,0.05738
6044,53,555,29415,2,48358,12091,1,29633336,29633336,18133,6044,12089,6044,0,1,6046,61666,0.061666
6544,53,555,29415,2,52358,13091,1,32065336,32065336,19633,6544,13089,6544,0,1,6546,67325,0.067325
7044,53,555,29415,2,56358,14091,1,34497336,34497336,21133,7044,14089,7044,0,1,7046,71047,0.071047
40,50,640,32000,2,326,83,1,476800,476800,121,40,81,40,0,1,42,1970,0.00197
440,50,640,32000,2,3526,883,1,2684800,2684800,1321,440,881,440,0,1,442,9055,0.009055
840,50,640,32000,2,6726,1683,1,4892800,4892800,2521,840,1681,840,0,1,842,12548,0.012548
1240,50,640,32000,2,9926,2483,1,7100800,7100800,3721,1240,2481,1240,0,1,1242,15119,0.015119
1640,50,640,32000,2,13126,3283,1,9308800,9308800,4921,1640,3281,1640,0,1,1642,19113,0.019113
2040,50,640,32000,2,16326,4083,1,11516800,11516800,6121,2040,4081,2040,0,1,2042,24171,0.024171
2440,50,640,32000,2,19526,4883,1,13724800,13724800,7321,2440,4881,2440,0,1,2442,27793,0.027793
2840,50,640,32000,2,22726,5683,1,15932800,15932800,8521,2840,5681,2840,0,1,2842,32071,0.032071
3240,50,640,32000,2,25926,6483,1,18140800,18140800,9721,3240,6481,3240,0,1,3242,36285,0.036285
3640,50,640,32000,2,29126,7283,1,20348800,20348800,10921,3640,7281,3640,0,1,3642,40297,0.040297
4040,50,640,32000,2,32326,8083,1,22556800,22556800,12121,4040,8081,4040,0,1,4042,44079,0.044079
4440,50,640,32000,2,35526,8883,1,24764800,24764800,13321,4440,8881,4440,0,1,4442,49071,0.049071
4840,50,640,32000,2,38726,9683,1,26972800,26972800,14521,4840,9681,4840,0,1,4842,52894,0.052894
5240,50,640,32000,2,41926,10483,1,29180800,29180800,15721,5240,10481,5240,0,1,5242,56571,0.056571
5640,50,640,32000,2,45126,11283,1,31388800,31388800,16921,5640,11281,5640,0,1,5642,60110,0.06011
6040,50,640,32000,2,48326,12083,1,33596800,33596800,18121,6040,12081,6040,0,1,6042,64409,0.064409
6440,50,640,32000,2,51526,12883,1,35804800,35804800,19321,6440,12881,6440,0,1,6442,67851,0.067851
6840,50,640,32000,2,54726,13683,1,38012800,38012800,20521,6840,13681,6840,0,1,6842,72705,0.072705
40,800,40,32000,2,326,83,1,524800,524800,121,40,81,40,0,1,42,3822,0.003822
440,800,40,32000,2,3526,883,1,3212800,3212800,1321,440,881,440,0,1,442,7597,0.007597
840,800,40,32000,2,6726,1683,1,5900800,5900800,2521,840,1681,840,0,1,842,11537,0.011537
1240,800,40,32000,2,9926,2483,1,8588800,8588800,3721,1240,2481,1240,0,1,1242,15106,0.015106
1640,800,40,32000,2,13126,3283,1,11276800,11276800,4921,1640,3281,1640,0,1,1642,19372,0.019372
2040,800,40,32000,2,16326,4083,1,13964800,13964800,6121,2040,4081,2040,0,1,2042,23745,0.023745
2440,800,40,32000,2,19526,4883,1,16652800,16652800,7321,2440,4881,2440,0,1,2442,30707,0.030707
2840,800,40,32000,2,22726,5683,1,19340800,19340800,8521,2840,5681,2840,0,1,2842,33451,0.033451
3240,800,40,32000,2,25926,6483,1,22028800,22028800,9721,3240,6481,3240,0,1,3242,37904,0.037904
3640,800,40,32000,2,29126,7283,1,24716800,24716800,10921,3640,7281,3640,0,1,3642,41896,0.041896
4040,800,40,32000,2,32326,8083,1,27404800,27404800,12121,4040,8081,4040,0,1,4042,42481,0.042481
4440,800,40,32000,2,35526,8883,1,30092800,30092800,13321,4440,8881,4440,0,1,4442,51509,0.051509
4840,800,40,32000,2,38726,9683,1,32780800,32780800,14521,4840,9681,4840,0,1,4842,54795,0.054795
5240,800,40,32000,2,41926,10483,1,35468800,35468800,15721,5240,10481,5240,0,1,5242,59871,0.059871
5640,800,40,32000,2,45126,11283,1,38156800,38156800,16921,5640,11281,5640,0,1,5642,63657,0.063657
6040,800,40,32000,2,48326,12083,1,40844800,40844800,18121,6040,12081,6040,0,1,6042,68292,0.068292
6440,800,40,32000,2,51526,12883,1,43532800,43532800,19321,6440,12881,6440,0,1,6442,74312,0.074312
6840,800,40,32000,2,54726,13683,1,46220800,46220800,20521,6840,13681,6840,0,1,6842,76386,0.076386
44,603,55,33165,2,358,91,1,496936,496936,133,44,89,44,0,1,46,1819,0.001819
544,603,55,33165,2,4358,1091,1,3128936,3128936,1633,544,1089,544,0,1,546,7430,0.00743
1044,603,55,33165,2,8358,2091,1,5760936,5760936,3133,1044,2089,1044,0,1,1046,12496,0.012496
1544,603,55,33165,2,12358,3091,1,8392936,8392936,4633,1544,3089,1544,0,1,1546,18107,0.018107
2044,603,55,33165,2,16358,4091,1,11024936,11024936,6133,2044,4089,2044,0,1,2046,26203,0.026203
2544,603,55,33165,2,20358,5091,1,13656936,13656936,7633,2544,5089,2544,0,1,2546,32329,0.032329
3044,603,55,33165,2,24358,6091,1,16288936,16288936,9133,3044,6089,3044,0,1,3046,34599,0.034599
3544,603,55,33165,2,28358,7091,1,18920936,18920936,10633,3544,7089,3544,0,1,3546,39623,0.039623
4044,603,55,33165,2,32358,8091,1,21552936,21552936,12133,4044,8089,4044,0,1,4046,45270,0.04527
4544,603,55,33165,2,36358,9091,1,24184936,24184936,13633,4544,9089,4544,0,1,4546,49091,0.049091
5044,603,55,33165,2,40358,10091,1,26816936,26816936,15133,5044,10089,5044,0,1,5046,54610,0.05461
5544,603,55,33165,2,44358,11091,1,29448936,29448936,16633,5544,11089,5544,0,1,5546,60076,0.060076
6044,603,55,33165,2,48358,12091,1,32080936,32080936,18133,6044,12089,6044,0,1,6046,29192,0.029192
6544,603,55,33165,2,52358,13091,1,34712936,34712936,19633,6544,13089,6544,0,1,6546,69445,0.069445
7044,603,55,33165,2,56358,14091,1,37344936,37344936,21133,7044,14089,7044,0,1,7046,75508,0.075508
55,555,65,36075,2,446,113,1,561400,561400,166,55,111,55,0,1,57,368,0.000368
455,555,65,36075,2,3646,913,1,2545400,2545400,1366,455,911,455,0,1,457,6459,0.006459
855,555,65,36075,2,6846,1713,1,4529400,4529400,2566,855,1711,855,0,1,857,10738,0.010738
1255,555,65,36075,2,10046,2513,1,6513400,6513400,3766,1255,2511,1255,0,1,1257,14966,0.014966
1655,555,65,36075,2,13246,3313,1,8497400,8497400,4966,1655,3311,1655,0,1,1657,20150,0.02015
2055,555,65,36075,2,16446,4113,1,10481400,10481400,6166,2055,4111,2055,0,1,2057,23953,0.023953
2455,555,65,36075,2,19646,4913,1,12465400,12465400,7366,2455,4911,2455,0,1,2457,28136,0.028136
2855,555,65,36075,2,22846,5713,1,14449400,14449400,8566,2855,5711,2855,0,1,2857,32253,0.032253
3255,555,65,36075,2,26046,6513,1,16433400,16433400,9766,3255,6511,3255,0,1,3257,37074,0.037074
3655,555,65,36075,2,29246,7313,1,18417400,18417400,10966,3655,7311,3655,0,1,3657,40948,0.040948
4055,555,65,36075,2,32446,8113,1,20401400,20401400,12166,4055,8111,4055,0,1,4057,8078,0.008078
4455,555,65,36075,2,35646,8913,1,22385400,22385400,13366,4455,8911,4455,0,1,4457,49614,0.049614
4855,555,65,36075,2,38846,9713,1,24369400,24369400,14566,4855,9711,4855,0,1,4857,53371,0.053371
5255,555,65,36075,2,42046,10513,1,26353400,26353400,15766,5255,10511,5255,0,1,5257,57815,0.057815
5655,555,65,36075,2,45246,11313,1,28337400,28337400,16966,5655,11311,5655,0,1,5657,60706,0.060706
6055,555,65,36075,2,48446,12113,1,30321400,30321400,18166,6055,12111,6055,0,1,6057,65092,0.065092
6455,555,65,36075,2,51646,12913,1,32305400,32305400,19366,6455,12911,6455,0,1,6457,70358,0.070358
6855,555,65,36075,2,54846,13713,1,34289400,34289400,20566,6855,13711,6855,0,1,6857,18523,0.018523
55,55,665,36575,2,446,113,1,609400,609400,166,55,111,55,0,1,57,3851,0.003851
455,55,665,36575,2,3646,913,1,2913400,2913400,1366,455,911,455,0,1,457,9651,0.009651
855,55,665,36575,2,6846,1713,1,5217400,5217400,2566,855,1711,855,0,1,857,368,0.000368
1255,55,665,36575,2,10046,2513,1,7521400,7521400,3766,1255,2511,1255,0,1,1257,7407,0.007407
1655,55,665,36575,2,13246,3313,1,9825400,9825400,4966,1655,3311,1655,0,1,1657,19741,0.019741
2055,55,665,36575,2,16446,4113,1,12129400,12129400,6166,2055,4111,2055,0,1,2057,22247,0.022247
2455,55,665,36575,2,19646,4913,1,14433400,14433400,7366,2455,4911,2455,0,1,2457,29381,0.029381
2855,55,665,36575,2,22846,5713,1,16737400,16737400,8566,2855,5711,2855,0,1,2857,32610,0.03261
3255,55,665,36575,2,26046,6513,1,19041400,19041400,9766,3255,6511,3255,0,1,3257,37362,0.037362
3655,55,665,36575,2,29246,7313,1,21345400,21345400,10966,3655,7311,3655,0,1,3657,41642,0.041642
4055,55,665,36575,2,32446,8113,1,23649400,23649400,12166,4055,8111,4055,0,1,4057,43026,0.043026
4455,55,665,36575,2,35646,8913,1,25953400,25953400,13366,4455,8911,4455,0,1,4457,49647,0.049647
4855,55,665,36575,2,38846,9713,1,28257400,28257400,14566,4855,9711,4855,0,1,4857,2535,0.002535
5255,55,665,36575,2,42046,10513,1,30561400,30561400,15766,5255,10511,5255,0,1,5257,58145,0.058145
5655,55,665,36575,2,45246,11313,1,32865400,32865400,16966,5655,11311,5655,0,1,5657,25784,0.025784
6055,55,665,36575,2,48446,12113,1,35169400,35169400,18166,6055,12111,6055,0,1,6057,19972,0.019972
6455,55,665,36575,2,51646,12913,1,37473400,37473400,19366,6455,12911,6455,0,1,6457,76354,0.076354
6855,55,665,36575,2,54846,13713,1,39777400,39777400,20566,6855,13711,6855,0,1,6857,76749,0.076749
35,40,1045,41800,2,286,73,1,638200,638200,106,35,71,35,0,1,37,3913,0.003913
535,40,1045,41800,2,4286,1073,1,4978200,4978200,1606,535,1071,535,0,1,537,12407,0.012407
1035,40,1045,41800,2,8286,2073,1,9318200,9318200,3106,1035,2071,1035,0,1,1037,16632,0.016632
1535,40,1045,41800,2,12286,3073,1,13658200,13658200,4606,1535,3071,1535,0,1,1537,9619,0.009619
2035,40,1045,41800,2,16286,4073,1,17998200,17998200,6106,2035,4071,2035,0,1,2037,25743,0.025743
2535,40,1045,41800,2,20286,5073,1,22338200,22338200,7606,2535,5071,2535,0,1,2537,32075,0.032075
3035,40,1045,41800,2,24286,6073,1,26678200,26678200,9106,3035,6071,3035,0,1,3037,38826,0.038826
3535,40,1045,41800,2,28286,7073,1,31018200,31018200,10606,3535,7071,3535,0,1,3537,44423,0.044423
4035,40,1045,41800,2,32286,8073,1,35358200,35358200,12106,4035,8071,4035,0,1,4037,6454,0.006454
4535,40,1045,41800,2,36286,9073,1,39698200,39698200,13606,4535,9071,4535,0,1,4537,54402,0.054402
5035,40,1045,41800,2,40286,10073,1,44038200,44038200,15106,5035,10071,5035,0,1,5037,60792,0.060792
5535,40,1045,41800,2,44286,11073,1,48378200,48378200,16606,5535,11071,5535,0,1,5537,65593,0.065593
6035,40,1045,41800,2,48286,12073,1,52718200,52718200,18106,6035,12071,6035,0,1,6037,71835,0.071835
6535,40,1045,41800,2,52286,13073,1,57058200,57058200,19606,6535,13071,6535,0,1,6537,78022,0.078022
7035,40,1045,41800,2,56286,14073,1,61398200,61398200,21106,7035,14071,7035,0,1,7037,83640,0.08364
40,1050,40,42000,2,326,83,1,684800,684800,121,40,81,40,0,1,42,1587,0.001587
440,1050,40,42000,2,3526,883,1,4172800,4172800,1321,440,881,440,0,1,442,6877,0.006877
840,1050,40,42000,2,6726,1683,1,7660800,7660800,2521,840,1681,840,0,1,842,12525,0.012525
1240,1050,40,42000,2,9926,2483,1,11148800,11148800,3721,1240,2481,1240,0,1,1242,18733,0.018733
1640,1050,40,42000,2,13126,3283,1,14636800,14636800,4921,1640,3281,1640,0,1,1642,22433,0.022433
2040,1050,40,42000,2,16326,4083,1,18124800,18124800,6121,2040,4081,2040,0,1,2042,26812,0.026812
2440,1050,40,42000,2,19526,4883,1,21612800,21612800,7321,2440,4881,2440,0,1,2442,31994,0.031994
2840,1050,40,42000,2,22726,5683,1,25100800,25100800,8521,2840,5681,2840,0,1,2842,4696,0.004696
3240,1050,40,42000,2,25926,6483,1,28588800,28588800,9721,3240,6481,3240,0,1,3242,39421,0.039421
3640,1050,40,42000,2,29126,7283,1,32076800,32076800,10921,3640,7281,3640,0,1,3642,38538,0.038538
4040,1050,40,42000,2,32326,8083,1,35564800,35564800,12121,4040,8081,4040,0,1,4042,51809,0.051809
4440,1050,40,42000,2,35526,8883,1,39052800,39052800,13321,4440,8881,4440,0,1,4442,55377,0.055377
4840,1050,40,42000,2,38726,9683,1,42540800,42540800,14521,4840,9681,4840,0,1,4842,59523,0.059523
5240,1050,40,42000,2,41926,10483,1,46028800,46028800,15721,5240,10481,5240,0,1,5242,65906,0.065906
5640,1050,40,42000,2,45126,11283,1,49516800,49516800,16921,5640,11281,5640,0,1,5642,67692,0.067692
6040,1050,40,42000,2,48326,12083,1,53004800,53004800,18121,6040,12081,6040,0,1,6042,72869,0.072869
6440,1050,40,42000,2,51526,12883,1,56492800,56492800,19321,6440,12881,6440,0,1,6442,78504,0.078504
6840,1050,40,42000,2,54726,13683,1,59980800,59980800,20521,6840,13681,6840,0,1,6842,79940,0.07994
39,43,1041,44763,2,318,81,1,696312,696312,118,39,79,39,0,1,41,2647,0.002647
539,43,1041,44763,2,4318,1081,1,5032312,5032312,1618,539,1079,539,0,1,541,11710,0.01171
1039,43,1041,44763,2,8318,2081,1,9368312,9368312,3118,1039,2079,1039,0,1,1041,6021,0.006021
1539,43,1041,44763,2,12318,3081,1,13704312,13704312,4618,1539,3079,1539,0,1,1541,20004,0.020004
2039,43,1041,44763,2,16318,4081,1,18040312,18040312,6118,2039,4079,2039,0,1,2041,1676,0.001676
2539,43,1041,44763,2,20318,5081,1,22376312,22376312,7618,2539,5079,2539,0,1,2541,33882,0.033882
3039,43,1041,44763,2,24318,6081,1,26712312,26712312,9118,3039,6079,3039,0,1,3041,31218,0.031218
3539,43,1041,44763,2,28318,7081,1,31048312,31048312,10618,3539,7079,3539,0,1,3541,53528,0.053528
4039,43,1041,44763,2,32318,8081,1,35384312,35384312,12118,4039,8079,4039,0,1,4041,59157,0.059157
4539,43,1041,44763,2,36318,9081,1,39720312,39720312,13618,4539,9079,4539,0,1,4541,3767,0.003767
5039,43,1041,44763,2,40318,10081,1,44056312,44056312,15118,5039,10079,5039,0,1,5041,65402,0.065402
5539,43,1041,44763,2,44318,11081,1,48392312,48392312,16618,5539,11079,5539,0,1,5541,53709,0.053709
6039,43,1041,44763,2,48318,12081,1,52728312,52728312,18118,6039,12079,6039,0,1,6041,73472,0.073472
6539,43,1041,44763,2,52318,13081,1,57064312,57064312,19618,6539,13079,6539,0,1,6541,84555,0.084555
7039,43,1041,44763,2,56318,14081,1,61400312,61400312,21118,7039,14079,7039,0,1,7041,85390,0.08539
39,1143,41,46863,2,318,81,1,744312,744312,118,39,79,39,0,1,41,2153,0.002153
539,1143,41,46863,2,4318,1081,1,5480312,5480312,1618,539,1079,539,0,1,541,221,0.000221
1039,1143,41,46863,2,8318,2081,1,10216312,10216312,3118,1039,2079,1039,0,1,1041,14483,0.014483
1539,1143,41,46863,2,12318,3081,1,14952312,14952312,4618,1539,3079,1539,0,1,1541,18357,0.018357
2039,1143,41,46863,2,16318,4081,1,19688312,19688312,6118,2039,4079,2039,0,1,2041,27585,0.027585
2539,1143,41,46863,2,20318,5081,1,24424312,24424312,7618,2539,5079,2539,0,1,2541,34218,0.034218
3039,1143,41,46863,2,24318,6081,1,29160312,29160312,9118,3039,6079,3039,0,1,3041,41130,0.04113
3539,1143,41,46863,2,28318,7081,1,33896312,33896312,10618,3539,7079,3539,0,1,3541,47834,0.047834
4039,1143,41,46863,2,32318,8081,1,38632312,38632312,12118,4039,8079,4039,0,1,4041,46413,0.046413
4539,1143,41,46863,2,36318,9081,1,43368312,43368312,13618,4539,9079,4539,0,1,4541,56561,0.056561
5039,1143,41,46863,2,40318,10081,1,48104312,48104312,15118,5039,10079,5039,0,1,5041,66415,0.066415
5539,1143,41,46863,2,44318,11081,1,52840312,52840312,16618,5539,11079,5539,0,1,5541,72950,0.07295
6039,1143,41,46863,2,48318,12081,1,57576312,57576312,18118,6039,12079,6039,0,1,6041,76906,0.076906
6539,1143,41,46863,2,52318,13081,1,62312312,62312312,19618,6539,13079,6539,0,1,6541,85718,0.085718
7039,1143,41,46863,2,56318,14081,1,67048312,67048312,21118,7039,14079,7039,0,1,7041,89405,0.089405
40,50,940,47000,2,326,83,1,692800,692800,121,40,81,40,0,1,42,405,0.000405
440,50,940,47000,2,3526,883,1,3860800,3860800,1321,440,881,440,0,1,442,3912,0.003912
840,50,940,47000,2,6726,1683,1,7028800,7028800,2521,840,1681,840,0,1,842,441,0.000441
1240,50,940,47000,2,9926,2483,1,10196800,10196800,3721,1240,2481,1240,0,1,1242,653,0.000653
1640,50,940,47000,2,13126,3283,1,13364800,13364800,4921,1640,3281,1640,0,1,1642,21282,0.021282
2040,50,940,47000,2,16326,4083,1,16532800,16532800,6121,2040,4081,2040,0,1,2042,29539,0.029539
2440,50,940,47000,2,19526,4883,1,19700800,19700800,7321,2440,4881,2440,0,1,2442,28365,0.028365
2840,50,940,47000,2,22726,5683,1,22868800,22868800,8521,2840,5681,2840,0,1,2842,22062,0.022062
3240,50,940,47000,2,25926,6483,1,26036800,26036800,9721,3240,6481,3240,0,1,3242,2552,0.002552
3640,50,940,47000,2,29126,7283,1,29204800,29204800,10921,3640,7281,3640,0,1,3642,44105,0.044105
4040,50,940,47000,2,32326,8083,1,32372800,32372800,12121,4040,8081,4040,0,1,4042,48728,0.048728
4440,50,940,47000,2,35526,8883,1,35540800,35540800,13321,4440,8881,4440,0,1,4442,3243,0.003243
4840,50,940,47000,2,38726,9683,1,38708800,38708800,14521,4840,9681,4840,0,1,4842,7628,0.007628
5240,50,940,47000,2,41926,10483,1,41876800,41876800,15721,5240,10481,5240,0,1,5242,29697,0.029697
5640,50,940,47000,2,45126,11283,1,45044800,45044800,16921,5640,11281,5640,0,1,5642,68103,0.068103
6040,50,940,47000,2,48326,12083,1,48212800,48212800,18121,6040,12081,6040,0,1,6042,74027,0.074027
6440,50,940,47000,2,51526,12883,1,51380800,51380800,19321,6440,12881,6440,0,1,6442,34395,0.034395
6840,50,940,47000,2,54726,13683,1,54548800,54548800,20521,6840,13681,6840,0,1,6842,83338,0.083338
35,1140,45,51300,2,286,73,1,742200,742200,106,35,71,35,0,1,37,5524,0.005524
535,1140,45,51300,2,4286,1073,1,5482200,5482200,1606,535,1071,535,0,1,537,10034,0.010034
1035,1140,45,51300,2,8286,2073,1,10222200,10222200,3106,1035,2071,1035,0,1,1037,15426,0.015426
1535,1140,45,51300,2,12286,3073,1,14962200,14962200,4606,1535,3071,1535,0,1,1537,21686,0.021686
2035,1140,45,51300,2,16286,4073,1,19702200,19702200,6106,2035,4071,2035,0,1,2037,28794,0.028794
2535,1140,45,51300,2,20286,5073,1,24442200,24442200,7606,2535,5071,2535,0,1,2537,34789,0.034789
3035,1140,45,51300,2,24286,6073,1,29182200,29182200,9106,3035,6071,3035,0,1,3037,41658,0.041658
3535,1140,45,51300,2,28286,7073,1,33922200,33922200,10606,3535,7071,3535,0,1,3537,46404,0.046404
4035,1140,45,51300,2,32286,8073,1,38662200,38662200,12106,4035,8071,4035,0,1,4037,52983,0.052983
40,1300,40,52000,2,326,83,1,844800,844800,121,40,81,40,0,1,42,6612,0.006612
440,1300,40,52000,2,3526,883,1,5132800,5132800,1321,440,881,440,0,1,442,7298,0.007298
840,1300,40,52000,2,6726,1683,1,9420800,9420800,2521,840,1681,840,0,1,842,12474,0.012474
1240,1300,40,52000,2,9926,2483,1,13708800,13708800,3721,1240,2481,1240,0,1,1242,17774,0.017774
1640,1300,40,52000,2,13126,3283,1,17996800,17996800,4921,1640,3281,1640,0,1,1642,22719,0.022719
2040,1300,40,52000,2,16326,4083,1,22284800,22284800,6121,2040,4081,2040,0,1,2042,28500,0.0285
2440,1300,40,52000,2,19526,4883,1,26572800,26572800,7321,2440,4881,2440,0,1,2442,32841,0.032841
2840,1300,40,52000,2,22726,5683,1,30860800,30860800,8521,2840,5681,2840,0,1,2842,39445,0.039445
3240,1300,40,52000,2,25926,6483,1,35148800,35148800,9721,3240,6481,3240,0,1,3242,44202,0.044202
3640,1300,40,52000,2,29126,7283,1,39436800,39436800,10921,3640,7281,3640,0,1,3642,50044,0.050044
4040,1300,40,52000,2,32326,8083,1,43724800,43724800,12121,4040,8081,4040,0,1,4042,24425,0.024425
4440,1300,40,52000,2,35526,8883,1,48012800,48012800,13321,4440,8881,4440,0,1,4442,61946,0.061946
4840,1300,40,52000,2,38726,9683,1,52300800,52300800,14521,4840,9681,4840,0,1,4842,65355,0.065355
5240,1300,40,52000,2,41926,10483,1,56588800,56588800,15721,5240,10481,5240,0,1,5242,76333,0.076333
5640,1300,40,52000,2,45126,11283,1,60876800,60876800,16921,5640,11281,5640,0,1,5642,80284,0.080284
6040,1300,40,52000,2,48326,12083,1,65164800,65164800,18121,6040,12081,6040,0,1,6042,90445,0.090445
6440,1300,40,52000,2,51526,12883,1,69452800,69452800,19321,6440,12881,6440,0,1,6442,93161,0.093161
6840,1300,40,52000,2,54726,13683,1,73740800,73740800,20521,6840,13681,6840,0,1,6842,91346,0.091346
55,805,65,52325,2,446,113,1,801400,801400,166,55,111,55,0,1,57,4262,0.004262
455,805,65,52325,2,3646,913,1,3585400,3585400,1366,455,911,455,0,1,457,7947,0.007947
855,805,65,52325,2,6846,1713,1,6369400,6369400,2566,855,1711,855,0,1,857,12480,0.01248
1255,805,65,52325,2,10046,2513,1,9153400,9153400,3766,1255,2511,1255,0,1,1257,16606,0.016606
1655,805,65,52325,2,13246,3313,1,11937400,11937400,4966,1655,3311,1655,0,1,1657,21328,0.021328
2055,805,65,52325,2,16446,4113,1,14721400,14721400,6166,2055,4111,2055,0,1,2057,25941,0.025941
2455,805,65,52325,2,19646,4913,1,17505400,17505400,7366,2455,4911,2455,0,1,2457,31492,0.031492
2855,805,65,52325,2,22846,5713,1,20289400,20289400,8566,2855,5711,2855,0,1,2857,35056,0.035056
3255,805,65,52325,2,26046,6513,1,23073400,23073400,9766,3255,6511,3255,0,1,3257,39921,0.039921
3655,805,65,52325,2,29246,7313,1,25857400,25857400,10966,3655,7311,3655,0,1,3657,44925,0.044925
4055,805,65,52325,2,32446,8113,1,28641400,28641400,12166,4055,8111,4055,0,1,4057,49707,0.049707
4455,805,65,52325,2,35646,8913,1,31425400,31425400,13366,4455,8911,4455,0,1,4457,54717,0.054717
4855,805,65,52325,2,38846,9713,1,34209400,34209400,14566,4855,9711,4855,0,1,4857,58868,0.058868
5255,805,65,52325,2,42046,10513,1,36993400,36993400,15766,5255,10511,5255,0,1,5257,63483,0.063483
5655,805,65,52325,2,45246,11313,1,39777400,39777400,16966,5655,11311,5655,0,1,5657,68138,0.068138
6055,805,65,52325,2,48446,12113,1,42561400,42561400,18166,6055,12111,6055,0,1,6057,72933,0.072933
6455,805,65,52325,2,51646,12913,1,45345400,45345400,19366,6455,12911,6455,0,1,6457,78121,0.078121
6855,805,65,52325,2,54846,13713,1,48129400,48129400,20566,6855,13711,6855,0,1,6857,83384,0.083384
55,55,965,53075,2,446,113,1,873400,873400,166,55,111,55,0,1,57,3638,0.003638
455,55,965,53075,2,3646,913,1,4137400,4137400,1366,455,911,455,0,1,457,4038,0.004038
855,55,965,53075,2,6846,1713,1,7401400,7401400,2566,855,1711,855,0,1,857,466,0.000466
1255,55,965,53075,2,10046,2513,1,10665400,10665400,3766,1255,2511,1255,0,1,1257,642,0.000642
1655,55,965,53075,2,13246,3313,1,13929400,13929400,4966,1655,3311,1655,0,1,1657,23618,0.023618
2055,55,965,53075,2,16446,4113,1,17193400,17193400,6166,2055,4111,2055,0,1,2057,1735,0.001735
2455,55,965,53075,2,19646,4913,1,20457400,20457400,7366,2455,4911,2455,0,1,2457,1954,0.001954
2855,55,965,53075,2,22846,5713,1,23721400,23721400,8566,2855,5711,2855,0,1,2857,36701,0.036701
3255,55,965,53075,2,26046,6513,1,26985400,26985400,9766,3255,6511,3255,0,1,3257,21735,0.021735
3655,55,965,53075,2,29246,7313,1,30249400,30249400,10966,3655,7311,3655,0,1,3657,48004,0.048004
4055,55,965,53075,2,32446,8113,1,33513400,33513400,12166,4055,8111,4055,0,1,4057,51973,0.051973
4455,55,965,53075,2,35646,8913,1,36777400,36777400,13366,4455,8911,4455,0,1,4457,57422,0.057422
4855,55,965,53075,2,38846,9713,1,40041400,40041400,14566,4855,9711,4855,0,1,4857,63299,0.063299
5255,55,965,53075,2,42046,10513,1,43305400,43305400,15766,5255,10511,5255,0,1,5257,17566,0.017566
5655,55,965,53075,2,45246,11313,1,46569400,46569400,16966,5655,11311,5655,0,1,5657,80192,0.080192
6055,55,965,53075,2,48446,12113,1,49833400,49833400,18166,6055,12111,6055,0,1,6057,36361,0.036361
6455,55,965,53075,2,51646,12913,1,53097400,53097400,19366,6455,12911,6455,0,1,6457,87254,0.087254
6855,55,965,53075,2,54846,13713,1,56361400,56361400,20566,6855,13711,6855,0,1,6857,4764,0.004764
44,53,1055,55915,2,358,91,1,837336,837336,133,44,89,44,0,1,46,662,0.000662
544,53,1055,55915,2,4358,1091,1,5269336,5269336,1633,544,1089,544,0,1,546,15229,0.015229
1044,53,1055,55915,2,8358,2091,1,9701336,9701336,3133,1044,2089,1044,0,1,1046,411,0.000411
1544,53,1055,55915,2,12358,3091,1,14133336,14133336,4633,1544,3089,1544,0,1,1546,27725,0.027725
2044,53,1055,55915,2,16358,4091,1,18565336,18565336,6133,2044,4089,2044,0,1,2046,19245,0.019245
2544,53,1055,55915,2,20358,5091,1,22997336,22997336,7633,2544,5089,2544,0,1,2546,30430,0.03043
3044,53,1055,55915,2,24358,6091,1,27429336,27429336,9133,3044,6089,3044,0,1,3046,51993,0.051993
3544,53,1055,55915,2,28358,7091,1,31861336,31861336,10633,3544,7089,3544,0,1,3546,16487,0.016487
4044,53,1055,55915,2,32358,8091,1,36293336,36293336,12133,4044,8089,4044,0,1,4046,28857,0.028857
4544,53,1055,55915,2,36358,9091,1,40725336,40725336,13633,4544,9089,4544,0,1,4546,3544,0.003544
5044,53,1055,55915,2,40358,10091,1,45157336,45157336,15133,5044,10089,5044,0,1,5046,80763,0.080763
5544,53,1055,55915,2,44358,11091,1,49589336,49589336,16633,5544,11089,5544,0,1,5546,87030,0.08703
6044,53,1055,55915,2,48358,12091,1,54021336,54021336,18133,6044,12089,6044,0,1,6046,95659,0.095659
6544,53,1055,55915,2,52358,13091,1,58453336,58453336,19633,6544,13089,6544,0,1,6546,102456,0.102456
7044,53,1055,55915,2,56358,14091,1,62885336,62885336,21133,7044,14089,7044,0,1,7046,113978,0.113978
35,40,1545,61800,2,286,73,1,938200,938200,106,35,71,35,0,1,37,3891,0.003891
535,40,1545,61800,2,4286,1073,1,7278200,7278200,1606,535,1071,535,0,1,537,11799,0.011799
1035,40,1545,61800,2,8286,2073,1,13618200,13618200,3106,1035,2071,1035,0,1,1037,23591,0.023591
1535,40,1545,61800,2,12286,3073,1,19958200,19958200,4606,1535,3071,1535,0,1,1537,28297,0.028297
2035,40,1545,61800,2,16286,4073,1,26298200,26298200,6106,2035,4071,2035,0,1,2037,37241,0.037241
2535,40,1545,61800,2,20286,5073,1,32638200,32638200,7606,2535,5071,2535,0,1,2537,46288,0.046288
3035,40,1545,61800,2,24286,6073,1,38978200,38978200,9106,3035,6071,3035,0,1,3037,55912,0.055912
3535,40,1545,61800,2,28286,7073,1,45318200,45318200,10606,3535,7071,3535,0,1,3537,63498,0.063498
4035,40,1545,61800,2,32286,8073,1,51658200,51658200,12106,4035,8071,4035,0,1,4037,75717,0.075717
4535,40,1545,61800,2,36286,9073,1,57998200,57998200,13606,4535,9071,4535,0,1,4537,79912,0.079912
5035,40,1545,61800,2,40286,10073,1,64338200,64338200,15106,5035,10071,5035,0,1,5037,88773,0.088773
5535,40,1545,61800,2,44286,11073,1,70678200,70678200,16606,5535,11071,5535,0,1,5537,50532,0.050532
6035,40,1545,61800,2,48286,12073,1,77018200,77018200,18106,6035,12071,6035,0,1,6037,106753,0.106753
6535,40,1545,61800,2,52286,13073,1,83358200,83358200,19606,6535,13071,6535,0,1,6537,114295,0.114295
7035,40,1545,61800,2,56286,14073,1,89698200,89698200,21106,7035,14071,7035,0,1,7037,122459,0.122459
40,50,1240,62000,2,326,83,1,908800,908800,121,40,81,40,0,1,42,2905,0.002905
440,50,1240,62000,2,3526,883,1,5036800,5036800,1321,440,881,440,0,1,442,2500,0.0025
840,50,1240,62000,2,6726,1683,1,9164800,9164800,2521,840,1681,840,0,1,842,2008,0.002008
1240,50,1240,62000,2,9926,2483,1,13292800,13292800,3721,1240,2481,1240,0,1,1242,25085,0.025085
1640,50,1240,62000,2,13126,3283,1,17420800,17420800,4921,1640,3281,1640,0,1,1642,1884,0.001884
2040,50,1240,62000,2,16326,4083,1,21548800,21548800,6121,2040,4081,2040,0,1,2042,2139,0.002139
2440,50,1240,62000,2,19526,4883,1,25676800,25676800,7321,2440,4881,2440,0,1,2442,43176,0.043176
2840,50,1240,62000,2,22726,5683,1,29804800,29804800,8521,2840,5681,2840,0,1,2842,41070,0.04107
3240,50,1240,62000,2,25926,6483,1,33932800,33932800,9721,3240,6481,3240,0,1,3242,62321,0.062321
3640,50,1240,62000,2,29126,7283,1,38060800,38060800,10921,3640,7281,3640,0,1,3642,22466,0.022466
4040,50,1240,62000,2,32326,8083,1,42188800,42188800,12121,4040,8081,4040,0,1,4042,68985,0.068985
4440,50,1240,62000,2,35526,8883,1,46316800,46316800,13321,4440,8881,4440,0,1,4442,79957,0.079957
4840,50,1240,62000,2,38726,9683,1,50444800,50444800,14521,4840,9681,4840,0,1,4842,30840,0.03084
5240,50,1240,62000,2,41926,10483,1,54572800,54572800,15721,5240,10481,5240,0,1,5242,90394,0.090394
5640,50,1240,62000,2,45126,11283,1,58700800,58700800,16921,5640,11281,5640,0,1,5642,18989,0.018989
6040,50,1240,62000,2,48326,12083,1,62828800,62828800,18121,6040,12081,6040,0,1,6042,103348,0.103348
6440,50,1240,62000,2,51526,12883,1,66956800,66956800,19321,6440,12881,6440,0,1,6442,22668,0.022668
6840,50,1240,62000,2,54726,13683,1,71084800,71084800,20521,6840,13681,6840,0,1,6842,75152,0.075152
40,1550,40,62000,2,326,83,1,1004800,1004800,121,40,81,40,0,1,42,8181,0.008181
440,1550,40,62000,2,3526,883,1,6092800,6092800,1321,440,881,440,0,1,442,9686,0.009686
840,1550,40,62000,2,6726,1683,1,11180800,11180800,2521,840,1681,840,0,1,842,17032,0.017032
1240,1550,40,62000,2,9926,2483,1,16268800,16268800,3721,1240,2481,1240,0,1,1242,24072,0.024072
1640,1550,40,62000,2,13126,3283,1,21356800,21356800,4921,1640,3281,1640,0,1,1642,31874,0.031874
2040,1550,40,62000,2,16326,4083,1,26444800,26444800,6121,2040,4081,2040,0,1,2042,39188,0.039188
2440,1550,40,62000,2,19526,4883,1,31532800,31532800,7321,2440,4881,2440,0,1,2442,46144,0.046144
2840,1550,40,62000,2,22726,5683,1,36620800,36620800,8521,2840,5681,2840,0,1,2842,56176,0.056176
3240,1550,40,62000,2,25926,6483,1,41708800,41708800,9721,3240,6481,3240,0,1,3242,59441,0.059441
3640,1550,40,62000,2,29126,7283,1,46796800,46796800,10921,3640,7281,3640,0,1,3642,66790,0.06679
4040,1550,40,62000,2,32326,8083,1,51884800,51884800,12121,4040,8081,4040,0,1,4042,73135,0.073135
4440,1550,40,62000,2,35526,8883,1,56972800,56972800,13321,4440,8881,4440,0,1,4442,82818,0.082818
4840,1550,40,62000,2,38726,9683,1,62060800,62060800,14521,4840,9681,4840,0,1,4842,84152,0.084152
5240,1550,40,62000,2,41926,10483,1,67148800,67148800,15721,5240,10481,5240,0,1,5242,93048,0.093048
5640,1550,40,62000,2,45126,11283,1,72236800,72236800,16921,5640,11281,5640,0,1,5642,101500,0.1015
6040,1550,40,62000,2,48326,12083,1,77324800,77324800,18121,6040,12081,6040,0,1,6042,41069,0.041069
6440,1550,40,62000,2,51526,12883,1,82412800,82412800,19321,6440,12881,6440,0,1,6442,115882,0.115882
6840,1550,40,62000,2,54726,13683,1,87500800,87500800,20521,6840,13681,6840,0,1,6842,119367,0.119367
44,1153,55,63415,2,358,91,1,932536,932536,133,44,89,44,0,1,46,6205,0.006205
544,1153,55,63415,2,4358,1091,1,5764536,5764536,1633,544,1089,544,0,1,546,10503,0.010503
1044,1153,55,63415,2,8358,2091,1,10596536,10596536,3133,1044,2089,1044,0,1,1046,19683,0.019683
1544,1153,55,63415,2,12358,3091,1,15428536,15428536,4633,1544,3089,1544,0,1,1546,28579,0.028579
2044,1153,55,63415,2,16358,4091,1,20260536,20260536,6133,2044,4089,2044,0,1,2046,37112,0.037112
2544,1153,55,63415,2,20358,5091,1,25092536,25092536,7633,2544,5089,2544,0,1,2546,45960,0.04596
3044,1153,55,63415,2,24358,6091,1,29924536,29924536,9133,3044,6089,3044,0,1,3046,53172,0.053172
3544,1153,55,63415,2,28358,7091,1,34756536,34756536,10633,3544,7089,3544,0,1,3546,62830,0.06283
4044,1153,55,63415,2,32358,8091,1,39588536,39588536,12133,4044,8089,4044,0,1,4046,70875,0.070875
4544,1153,55,63415,2,36358,9091,1,44420536,44420536,13633,4544,9089,4544,0,1,4546,78089,0.078089
5044,1153,55,63415,2,40358,10091,1,49252536,49252536,15133,5044,10089,5044,0,1,5046,87229,0.087229
5544,1153,55,63415,2,44358,11091,1,54084536,54084536,16633,5544,11089,5544,0,1,5546,97398,0.097398
6044,1153,55,63415,2,48358,12091,1,58916536,58916536,18133,6044,12089,6044,0,1,6046,101906,0.101906
6544,1153,55,63415,2,52358,13091,1,63748536,63748536,19633,6544,13089,6544,0,1,6546,114244,0.114244
7044,1153,55,63415,2,56358,14091,1,68580536,68580536,21133,7044,14089,7044,0,1,7046,116386,0.116386
39,43,1541,66263,2,318,81,1,1024312,1024312,118,39,79,39,0,1,41,4358,0.004358
539,43,1541,66263,2,4318,1081,1,7360312,7360312,1618,539,1079,539,0,1,541,11904,0.011904
1039,43,1541,66263,2,8318,2081,1,13696312,13696312,3118,1039,2079,1039,0,1,1041,6112,0.006112
1539,43,1541,66263,2,12318,3081,1,20032312,20032312,4618,1539,3079,1539,0,1,1541,29567,0.029567
2039,43,1541,66263,2,16318,4081,1,26368312,26368312,6118,2039,4079,2039,0,1,2041,39450,0.03945
2539,43,1541,66263,2,20318,5081,1,32704312,32704312,7618,2539,5079,2539,0,1,2541,47754,0.047754
3039,43,1541,66263,2,24318,6081,1,39040312,39040312,9118,3039,6079,3039,0,1,3041,56743,0.056743
3539,43,1541,66263,2,28318,7081,1,45376312,45376312,10618,3539,7079,3539,0,1,3541,58760,0.05876
4039,43,1541,66263,2,32318,8081,1,51712312,51712312,12118,4039,8079,4039,0,1,4041,75294,0.075294
4539,43,1541,66263,2,36318,9081,1,58048312,58048312,13618,4539,9079,4539,0,1,4541,13251,0.013251
5039,43,1541,66263,2,40318,10081,1,64384312,64384312,15118,5039,10079,5039,0,1,5041,5573,0.005573
5539,43,1541,66263,2,44318,11081,1,70720312,70720312,16618,5539,11079,5539,0,1,5541,100603,0.100603
6039,43,1541,66263,2,48318,12081,1,77056312,77056312,18118,6039,12079,6039,0,1,6041,34651,0.034651
6539,43,1541,66263,2,52318,13081,1,83392312,83392312,19618,6539,13079,6539,0,1,6541,18874,0.018874
7039,43,1541,66263,2,56318,14081,1,89728312,89728312,21118,7039,14079,7039,0,1,7041,127406,0.127406
55,1055,65,68575,2,446,113,1,1041400,1041400,166,55,111,55,0,1,57,5162,0.005162
455,1055,65,68575,2,3646,913,1,4625400,4625400,1366,455,911,455,0,1,457,1489,0.001489
855,1055,65,68575,2,6846,1713,1,8209400,8209400,2566,855,1711,855,0,1,857,16702,0.016702
1255,1055,65,68575,2,10046,2513,1,11793400,11793400,3766,1255,2511,1255,0,1,1257,24637,0.024637
1655,1055,65,68575,2,13246,3313,1,15377400,15377400,4966,1655,3311,1655,0,1,1657,30425,0.030425
2055,1055,65,68575,2,16446,4113,1,18961400,18961400,6166,2055,4111,2055,0,1,2057,37674,0.037674
2455,1055,65,68575,2,19646,4913,1,22545400,22545400,7366,2455,4911,2455,0,1,2457,44543,0.044543
2855,1055,65,68575,2,22846,5713,1,26129400,26129400,8566,2855,5711,2855,0,1,2857,51121,0.051121
3255,1055,65,68575,2,26046,6513,1,29713400,29713400,9766,3255,6511,3255,0,1,3257,56948,0.056948
3655,1055,65,68575,2,29246,7313,1,33297400,33297400,10966,3655,7311,3655,0,1,3657,64682,0.064682
4055,1055,65,68575,2,32446,8113,1,36881400,36881400,12166,4055,8111,4055,0,1,4057,71112,0.071112
4455,1055,65,68575,2,35646,8913,1,40465400,40465400,13366,4455,8911,4455,0,1,4457,78009,0.078009
4855,1055,65,68575,2,38846,9713,1,44049400,44049400,14566,4855,9711,4855,0,1,4857,83482,0.083482
5255,1055,65,68575,2,42046,10513,1,47633400,47633400,15766,5255,10511,5255,0,1,5257,90543,0.090543
5655,1055,65,68575,2,45246,11313,1,51217400,51217400,16966,5655,11311,5655,0,1,5657,97661,0.097661
6055,1055,65,68575,2,48446,12113,1,54801400,54801400,18166,6055,12111,6055,0,1,6057,103341,0.103341
6455,1055,65,68575,2,51646,12913,1,58385400,58385400,19366,6455,12911,6455,0,1,6457,111536,0.111536
6855,1055,65,68575,2,54846,13713,1,61969400,61969400,20566,6855,13711,6855,0,1,6857,115237,0.115237
39,1693,41,69413,2,318,81,1,1096312,1096312,118,39,79,39,0,1,41,8267,0.008267
539,1693,41,69413,2,4318,1081,1,8032312,8032312,1618,539,1079,539,0,1,541,11709,0.011709
1039,1693,41,69413,2,8318,2081,1,14968312,14968312,3118,1039,2079,1039,0,1,1041,23255,0.023255
1539,1693,41,69413,2,12318,3081,1,21904312,21904312,4618,1539,3079,1539,0,1,1541,30408,0.030408
2039,1693,41,69413,2,16318,4081,1,28840312,28840312,6118,2039,4079,2039,0,1,2041,40210,0.04021
2539,1693,41,69413,2,20318,5081,1,35776312,35776312,7618,2539,5079,2539,0,1,2541,49334,0.049334
3039,1693,41,69413,2,24318,6081,1,42712312,42712312,9118,3039,6079,3039,0,1,3041,57164,0.057164
3539,1693,41,69413,2,28318,7081,1,49648312,49648312,10618,3539,7079,3539,0,1,3541,68979,0.068979
4039,1693,41,69413,2,32318,8081,1,56584312,56584312,12118,4039,8079,4039,0,1,4041,74888,0.074888
4539,1693,41,69413,2,36318,9081,1,63520312,63520312,13618,4539,9079,4539,0,1,4541,87115,0.087115
5039,1693,41,69413,2,40318,10081,1,70456312,70456312,15118,5039,10079,5039,0,1,5041,104610,0.10461
5539,1693,41,69413,2,44318,11081,1,77392312,77392312,16618,5539,11079,5539,0,1,5541,115084,0.115084
6039,1693,41,69413,2,48318,12081,1,84328312,84328312,18118,6039,12079,6039,0,1,6041,115805,0.115805
6539,1693,41,69413,2,52318,13081,1,91264312,91264312,19618,6539,13079,6539,0,1,6541,121090,0.12109
7039,1693,41,69413,2,56318,14081,1,98200312,98200312,21118,7039,14079,7039,0,1,7041,137385,0.137385
55,55,1265,69575,2,446,113,1,1137400,1137400,166,55,111,55,0,1,57,247,0.000247
455,55,1265,69575,2,3646,913,1,5361400,5361400,1366,455,911,455,0,1,457,16995,0.016995
855,55,1265,69575,2,6846,1713,1,9585400,9585400,2566,855,1711,855,0,1,857,15589,0.015589
1255,55,1265,69575,2,10046,2513,1,13809400,13809400,3766,1255,2511,1255,0,1,1257,24239,0.024239
1655,55,1265,69575,2,13246,3313,1,18033400,18033400,4966,1655,3311,1655,0,1,1657,12764,0.012764
2055,55,1265,69575,2,16446,4113,1,22257400,22257400,6166,2055,4111,2055,0,1,2057,42840,0.04284
2455,55,1265,69575,2,19646,4913,1,26481400,26481400,7366,2455,4911,2455,0,1,2457,44259,0.044259
2855,55,1265,69575,2,22846,5713,1,30705400,30705400,8566,2855,5711,2855,0,1,2857,50654,0.050654
3255,55,1265,69575,2,26046,6513,1,34929400,34929400,9766,3255,6511,3255,0,1,3257,57881,0.057881
3655,55,1265,69575,2,29246,7313,1,39153400,39153400,10966,3655,7311,3655,0,1,3657,66062,0.066062
4055,55,1265,69575,2,32446,8113,1,43377400,43377400,12166,4055,8111,4055,0,1,4057,3812,0.003812
4455,55,1265,69575,2,35646,8913,1,47601400,47601400,13366,4455,8911,4455,0,1,4457,34753,0.034753
4855,55,1265,69575,2,38846,9713,1,51825400,51825400,14566,4855,9711,4855,0,1,4857,4451,0.004451
5255,55,1265,69575,2,42046,10513,1,56049400,56049400,15766,5255,10511,5255,0,1,5257,92455,0.092455
5655,55,1265,69575,2,45246,11313,1,60273400,60273400,16966,5655,11311,5655,0,1,5657,28027,0.028027
6055,55,1265,69575,2,48446,12113,1,64497400,64497400,18166,6055,12111,6055,0,1,6057,108223,0.108223
6455,55,1265,69575,2,51646,12913,1,68721400,68721400,19366,6455,12911,6455,0,1,6457,64886,0.064886
6855,55,1265,69575,2,54846,13713,1,72945400,72945400,20566,6855,13711,6855,0,1,6857,12974,0.012974
40,1800,40,72000,2,326,83,1,1164800,1164800,121,40,81,40,0,1,42,9703,0.009703
440,1800,40,72000,2,3526,883,1,7052800,7052800,1321,440,881,440,0,1,442,11395,0.011395
840,1800,40,72000,2,6726,1683,1,12940800,12940800,2521,840,1681,840,0,1,842,18361,0.018361
1240,1800,40,72000,2,9926,2483,1,18828800,18828800,3721,1240,2481,1240,0,1,1242,26791,0.026791
1640,1800,40,72000,2,13126,3283,1,24716800,24716800,4921,1640,3281,1640,0,1,1642,27649,0.027649
2040,1800,40,72000,2,16326,4083,1,30604800,30604800,6121,2040,4081,2040,0,1,2042,40921,0.040921
2440,1800,40,72000,2,19526,4883,1,36492800,36492800,7321,2440,4881,2440,0,1,2442,48752,0.048752
2840,1800,40,72000,2,22726,5683,1,42380800,42380800,8521,2840,5681,2840,0,1,2842,56213,0.056213
3240,1800,40,72000,2,25926,6483,1,48268800,48268800,9721,3240,6481,3240,0,1,3242,61340,0.06134
3640,1800,40,72000,2,29126,7283,1,54156800,54156800,10921,3640,7281,3640,0,1,3642,69499,0.069499
4040,1800,40,72000,2,32326,8083,1,60044800,60044800,12121,4040,8081,4040,0,1,4042,65348,0.065348
4440,1800,40,72000,2,35526,8883,1,65932800,65932800,13321,4440,8881,4440,0,1,4442,85004,0.085004
4840,1800,40,72000,2,38726,9683,1,71820800,71820800,14521,4840,9681,4840,0,1,4842,92971,0.092971
5240,1800,40,72000,2,41926,10483,1,77708800,77708800,15721,5240,10481,5240,0,1,5242,113464,0.113464
5640,1800,40,72000,2,45126,11283,1,83596800,83596800,16921,5640,11281,5640,0,1,5642,107933,0.107933
6040,1800,40,72000,2,48326,12083,1,89484800,89484800,18121,6040,12081,6040,0,1,6042,122016,0.122016
6440,1800,40,72000,2,51526,12883,1,95372800,95372800,19321,6440,12881,6440,0,1,6442,126002,0.126002
6840,1800,40,72000,2,54726,13683,1,101260800,101260800,20521,6840,13681,6840,0,1,6842,127211,0.127211
40,50,1540,77000,2,326,83,1,1124800,1124800,121,40,81,40,0,1,42,1906,0.001906
440,50,1540,77000,2,3526,883,1,6212800,6212800,1321,440,881,440,0,1,442,4145,0.004145
840,50,1540,77000,2,6726,1683,1,11300800,11300800,2521,840,1681,840,0,1,842,5127,0.005127
1240,50,1540,77000,2,9926,2483,1,16388800,16388800,3721,1240,2481,1240,0,1,1242,1753,0.001753
1640,50,1540,77000,2,13126,3283,1,21476800,21476800,4921,1640,3281,1640,0,1,1642,34312,0.034312
2040,50,1540,77000,2,16326,4083,1,26564800,26564800,6121,2040,4081,2040,0,1,2042,43358,0.043358
2440,50,1540,77000,2,19526,4883,1,31652800,31652800,7321,2440,4881,2440,0,1,2442,46615,0.046615
2840,50,1540,77000,2,22726,5683,1,36740800,36740800,8521,2840,5681,2840,0,1,2842,54294,0.054294
3240,50,1540,77000,2,25926,6483,1,41828800,41828800,9721,3240,6481,3240,0,1,3242,67161,0.067161
3640,50,1540,77000,2,29126,7283,1,46916800,46916800,10921,3640,7281,3640,0,1,3642,73425,0.073425
4040,50,1540,77000,2,32326,8083,1,52004800,52004800,12121,4040,8081,4040,0,1,4042,75781,0.075781
4440,50,1540,77000,2,35526,8883,1,57092800,57092800,13321,4440,8881,4440,0,1,4442,36059,0.036059
4840,50,1540,77000,2,38726,9683,1,62180800,62180800,14521,4840,9681,4840,0,1,4842,90144,0.090144
5240,50,1540,77000,2,41926,10483,1,67268800,67268800,15721,5240,10481,5240,0,1,5242,98441,0.098441
5640,50,1540,77000,2,45126,11283,1,72356800,72356800,16921,5640,11281,5640,0,1,5642,106057,0.106057
6040,50,1540,77000,2,48326,12083,1,77444800,77444800,18121,6040,12081,6040,0,1,6042,113106,0.113106
6440,50,1540,77000,2,51526,12883,1,82532800,82532800,19321,6440,12881,6440,0,1,6442,115292,0.115292
6840,50,1540,77000,2,54726,13683,1,87620800,87620800,20521,6840,13681,6840,0,1,6842,127435,0.127435
35,40,2045,81800,2,286,73,1,1238200,1238200,106,35,71,35,0,1,37,5095,0.005095
535,40,2045,81800,2,4286,1073,1,9578200,9578200,1606,535,1071,535,0,1,537,20947,0.020947
1035,40,2045,81800,2,8286,2073,1,17918200,17918200,3106,1035,2071,1035,0,1,1037,20276,0.020276
1535,40,2045,81800,2,12286,3073,1,26258200,26258200,4606,1535,3071,1535,0,1,1537,36873,0.036873
2035,40,2045,81800,2,16286,4073,1,34598200,34598200,6106,2035,4071,2035,0,1,2037,48029,0.048029
2535,40,2045,81800,2,20286,5073,1,42938200,42938200,7606,2535,5071,2535,0,1,2537,41151,0.041151
3035,40,2045,81800,2,24286,6073,1,51278200,51278200,9106,3035,6071,3035,0,1,3037,70504,0.070504
3535,40,2045,81800,2,28286,7073,1,59618200,59618200,10606,3535,7071,3535,0,1,3537,5234,0.005234
4035,40,2045,81800,2,32286,8073,1,67958200,67958200,12106,4035,8071,4035,0,1,4037,104169,0.104169
4535,40,2045,81800,2,36286,9073,1,76298200,76298200,13606,4535,9071,4535,0,1,4537,20125,0.020125
5035,40,2045,81800,2,40286,10073,1,84638200,84638200,15106,5035,10071,5035,0,1,5037,113329,0.113329
5535,40,2045,81800,2,44286,11073,1,92978200,92978200,16606,5535,11071,5535,0,1,5537,124602,0.124602
6035,40,2045,81800,2,48286,12073,1,101318200,101318200,18106,6035,12071,6035,0,1,6037,135556,0.135556
6535,40,2045,81800,2,52286,13073,1,109658200,109658200,19606,6535,13071,6535,0,1,6537,20682,0.020682
7035,40,2045,81800,2,56286,14073,1,117998200,117998200,21106,7035,14071,7035,0,1,7037,158340,0.15834
40,2050,40,82000,2,326,83,1,1324800,1324800,121,40,81,40,0,1,42,918,0.000918
440,2050,40,82000,2,3526,883,1,8012800,8012800,1321,440,881,440,0,1,442,4769,0.004769
840,2050,40,82000,2,6726,1683,1,14700800,14700800,2521,840,1681,840,0,1,842,22122,0.022122
1240,2050,40,82000,2,9926,2483,1,21388800,21388800,3721,1240,2481,1240,0,1,1242,31442,0.031442
1640,2050,40,82000,2,13126,3283,1,28076800,28076800,4921,1640,3281,1640,0,1,1642,42209,0.042209
2040,2050,40,82000,2,16326,4083,1,34764800,34764800,6121,2040,4081,2040,0,1,2042,48271,0.048271
2440,2050,40,82000,2,19526,4883,1,41452800,41452800,7321,2440,4881,2440,0,1,2442,57144,0.057144
2840,2050,40,82000,2,22726,5683,1,48140800,48140800,8521,2840,5681,2840,0,1,2842,67733,0.067733
3240,2050,40,82000,2,25926,6483,1,54828800,54828800,9721,3240,6481,3240,0,1,3242,57757,0.057757
3640,2050,40,82000,2,29126,7283,1,61516800,61516800,10921,3640,7281,3640,0,1,3642,87624,0.087624
4040,2050,40,82000,2,32326,8083,1,68204800,68204800,12121,4040,8081,4040,0,1,4042,94161,0.094161
4440,2050,40,82000,2,35526,8883,1,74892800,74892800,13321,4440,8881,4440,0,1,4442,107397,0.107397
4840,2050,40,82000,2,38726,9683,1,81580800,81580800,14521,4840,9681,4840,0,1,4842,111587,0.111587
5240,2050,40,82000,2,41926,10483,1,88268800,88268800,15721,5240,10481,5240,0,1,5242,126922,0.126922
5640,2050,40,82000,2,45126,11283,1,94956800,94956800,16921,5640,11281,5640,0,1,5642,12135,0.012135
6040,2050,40,82000,2,48326,12083,1,101644800,101644800,18121,6040,12081,6040,0,1,6042,139108,0.139108
6440,2050,40,82000,2,51526,12883,1,108332800,108332800,19321,6440,12881,6440,0,1,6442,150074,0.150074
6840,2050,40,82000,2,54726,13683,1,115020800,115020800,20521,6840,13681,6840,0,1,6842,155058,0.155058
44,53,1555,82415,2,358,91,1,1225336,1225336,133,44,89,44,0,1,46,5880,0.00588
544,53,1555,82415,2,4358,1091,1,7657336,7657336,1633,544,1089,544,0,1,546,1952,0.001952
1044,53,1555,82415,2,8358,2091,1,14089336,14089336,3133,1044,2089,1044,0,1,1046,6745,0.006745
1544,53,1555,82415,2,12358,3091,1,20521336,20521336,4633,1544,3089,1544,0,1,1546,12785,0.012785
2044,53,1555,82415,2,16358,4091,1,26953336,26953336,6133,2044,4089,2044,0,1,2046,46762,0.046762
2544,53,1555,82415,2,20358,5091,1,33385336,33385336,7633,2544,5089,2544,0,1,2546,57075,0.057075
3044,53,1555,82415,2,24358,6091,1,39817336,39817336,9133,3044,6089,3044,0,1,3046,71701,0.071701
3544,53,1555,82415,2,28358,7091,1,46249336,46249336,10633,3544,7089,3544,0,1,3546,83353,0.083353
4044,53,1555,82415,2,32358,8091,1,52681336,52681336,12133,4044,8089,4044,0,1,4046,89511,0.089511
4544,53,1555,82415,2,36358,9091,1,59113336,59113336,13633,4544,9089,4544,0,1,4546,18894,0.018894
5044,53,1555,82415,2,40358,10091,1,65545336,65545336,15133,5044,10089,5044,0,1,5046,57907,0.057907
5544,53,1555,82415,2,44358,11091,1,71977336,71977336,16633,5544,11089,5544,0,1,5546,85398,0.085398
6044,53,1555,82415,2,48358,12091,1,78409336,78409336,18133,6044,12089,6044,0,1,6046,132284,0.132284
6544,53,1555,82415,2,52358,13091,1,84841336,84841336,19633,6544,13089,6544,0,1,6546,144137,0.144137
7044,53,1555,82415,2,56358,14091,1,91273336,91273336,21133,7044,14089,7044,0,1,7046,146230,0.14623
55,1305,65,84825,2,446,113,1,1281400,1281400,166,55,111,55,0,1,57,7846,0.007846
455,1305,65,84825,2,3646,913,1,5665400,5665400,1366,455,911,455,0,1,457,11872,0.011872
855,1305,65,84825,2,6846,1713,1,10049400,10049400,2566,855,1711,855,0,1,857,21518,0.021518
1255,1305,65,84825,2,10046,2513,1,14433400,14433400,3766,1255,2511,1255,0,1,1257,29874,0.029874
1655,1305,65,84825,2,13246,3313,1,18817400,18817400,4966,1655,3311,1655,0,1,1657,38911,0.038911
2055,1305,65,84825,2,16446,4113,1,23201400,23201400,6166,2055,4111,2055,0,1,2057,47958,0.047958
2455,1305,65,84825,2,19646,4913,1,27585400,27585400,7366,2455,4911,2455,0,1,2457,56523,0.056523
2855,1305,65,84825,2,22846,5713,1,31969400,31969400,8566,2855,5711,2855,0,1,2857,65449,0.065449
3255,1305,65,84825,2,26046,6513,1,36353400,36353400,9766,3255,6511,3255,0,1,3257,75035,0.075035
3655,1305,65,84825,2,29246,7313,1,40737400,40737400,10966,3655,7311,3655,0,1,3657,81860,0.08186
4055,1305,65,84825,2,32446,8113,1,45121400,45121400,12166,4055,8111,4055,0,1,4057,91412,0.091412
4455,1305,65,84825,2,35646,8913,1,49505400,49505400,13366,4455,8911,4455,0,1,4457,99227,0.099227
4855,1305,65,84825,2,38846,9713,1,53889400,53889400,14566,4855,9711,4855,0,1,4857,107502,0.107502
5255,1305,65,84825,2,42046,10513,1,58273400,58273400,15766,5255,10511,5255,0,1,5257,111502,0.111502
5655,1305,65,84825,2,45246,11313,1,62657400,62657400,16966,5655,11311,5655,0,1,5657,122097,0.122097
6055,1305,65,84825,2,48446,12113,1,67041400,67041400,18166,6055,12111,6055,0,1,6057,135682,0.135682
6455,1305,65,84825,2,51646,12913,1,71425400,71425400,19366,6455,12911,6455,0,1,6457,138231,0.138231
6855,1305,65,84825,2,54846,13713,1,75809400,75809400,20566,6855,13711,6855,0,1,6857,131074,0.131074
55,55,1565,86075,2,446,113,1,1401400,1401400,166,55,111,55,0,1,57,7917,0.007917
455,55,1565,86075,2,3646,913,1,6585400,6585400,1366,455,911,455,0,1,457,799,0.000799
855,55,1565,86075,2,6846,1713,1,11769400,11769400,2566,855,1711,855,0,1,857,21704,0.021704
1255,55,1565,86075,2,10046,2513,1,16953400,16953400,3766,1255,2511,1255,0,1,1257,11350,0.01135
1655,55,1565,86075,2,13246,3313,1,22137400,22137400,4966,1655,3311,1655,0,1,1657,38554,0.038554
2055,55,1565,86075,2,16446,4113,1,27321400,27321400,6166,2055,4111,2055,0,1,2057,5618,0.005618
2455,55,1565,86075,2,19646,4913,1,32505400,32505400,7366,2455,4911,2455,0,1,2457,37703,0.037703
2855,55,1565,86075,2,22846,5713,1,37689400,37689400,8566,2855,5711,2855,0,1,2857,12660,0.01266
3255,55,1565,86075,2,26046,6513,1,42873400,42873400,9766,3255,6511,3255,0,1,3257,74092,0.074092
3655,55,1565,86075,2,29246,7313,1,48057400,48057400,10966,3655,7311,3655,0,1,3657,84343,0.084343
4055,55,1565,86075,2,32446,8113,1,53241400,53241400,12166,4055,8111,4055,0,1,4057,92247,0.092247
4455,55,1565,86075,2,35646,8913,1,58425400,58425400,13366,4455,8911,4455,0,1,4457,101230,0.10123
4855,55,1565,86075,2,38846,9713,1,63609400,63609400,14566,4855,9711,4855,0,1,4857,109842,0.109842
5255,55,1565,86075,2,42046,10513,1,68793400,68793400,15766,5255,10511,5255,0,1,5257,118281,0.118281
5655,55,1565,86075,2,45246,11313,1,73977400,73977400,16966,5655,11311,5655,0,1,5657,133605,0.133605
6055,55,1565,86075,2,48446,12113,1,79161400,79161400,18166,6055,12111,6055,0,1,6057,136106,0.136106
6455,55,1565,86075,2,51646,12913,1,84345400,84345400,19366,6455,12911,6455,0,1,6457,70021,0.070021
6855,55,1565,86075,2,54846,13713,1,89529400,89529400,20566,6855,13711,6855,0,1,6857,68475,0.068475
39,43,2041,87763,2,318,81,1,1352312,1352312,118,39,79,39,0,1,41,2731,0.002731
539,43,2041,87763,2,4318,1081,1,9688312,9688312,1618,539,1079,539,0,1,541,4857,0.004857
1039,43,2041,87763,2,8318,2081,1,18024312,18024312,3118,1039,2079,1039,0,1,1041,2594,0.002594
1539,43,2041,87763,2,12318,3081,1,26360312,26360312,4618,1539,3079,1539,0,1,1541,6448,0.006448
2039,43,2041,87763,2,16318,4081,1,34696312,34696312,6118,2039,4079,2039,0,1,2041,3411,0.003411
2539,43,2041,87763,2,20318,5081,1,43032312,43032312,7618,2539,5079,2539,0,1,2541,63291,0.063291
3039,43,2041,87763,2,24318,6081,1,51368312,51368312,9118,3039,6079,3039,0,1,3041,19369,0.019369
3539,43,2041,87763,2,28318,7081,1,59704312,59704312,10618,3539,7079,3539,0,1,3541,30938,0.030938
4039,43,2041,87763,2,32318,8081,1,68040312,68040312,12118,4039,8079,4039,0,1,4041,97453,0.097453
4539,43,2041,87763,2,36318,9081,1,76376312,76376312,13618,4539,9079,4539,0,1,4541,113415,0.113415
5039,43,2041,87763,2,40318,10081,1,84712312,84712312,15118,5039,10079,5039,0,1,5041,126245,0.126245
5539,43,2041,87763,2,44318,11081,1,93048312,93048312,16618,5539,11079,5539,0,1,5541,7833,0.007833
6039,43,2041,87763,2,48318,12081,1,101384312,101384312,18118,6039,12079,6039,0,1,6041,143054,0.143054
6539,43,2041,87763,2,52318,13081,1,109720312,109720312,19618,6539,13079,6539,0,1,6541,155886,0.155886
7039,43,2041,87763,2,56318,14081,1,118056312,118056312,21118,7039,14079,7039,0,1,7041,146724,0.146724
39,2243,41,91963,2,318,81,1,1448312,1448312,118,39,79,39,0,1,41,1687,0.001687
539,2243,41,91963,2,4318,1081,1,10584312,10584312,1618,539,1079,539,0,1,541,15910,0.01591
1039,2243,41,91963,2,8318,2081,1,19720312,19720312,3118,1039,2079,1039,0,1,1041,28376,0.028376
1539,2243,41,91963,2,12318,3081,1,28856312,28856312,4618,1539,3079,1539,0,1,1541,19999,0.019999
2039,2243,41,91963,2,16318,4081,1,37992312,37992312,6118,2039,4079,2039,0,1,2041,7589,0.007589
2539,2243,41,91963,2,20318,5081,1,47128312,47128312,7618,2539,5079,2539,0,1,2541,54241,0.054241
3039,2243,41,91963,2,24318,6081,1,56264312,56264312,9118,3039,6079,3039,0,1,3041,75317,0.075317
3539,2243,41,91963,2,28318,7081,1,65400312,65400312,10618,3539,7079,3539,0,1,3541,86466,0.086466
4039,2243,41,91963,2,32318,8081,1,74536312,74536312,12118,4039,8079,4039,0,1,4041,91195,0.091195
4539,2243,41,91963,2,36318,9081,1,83672312,83672312,13618,4539,9079,4539,0,1,4541,119132,0.119132
5039,2243,41,91963,2,40318,10081,1,92808312,92808312,15118,5039,10079,5039,0,1,5041,119653,0.119653
5539,2243,41,91963,2,44318,11081,1,101944312,101944312,16618,5539,11079,5539,0,1,5541,132780,0.13278
6039,2243,41,91963,2,48318,12081,1,111080312,111080312,18118,6039,12079,6039,0,1,6041,146485,0.146485
6539,2243,41,91963,2,52318,13081,1,120216312,120216312,19618,6539,13079,6539,0,1,6541,167028,0.167028
7039,2243,41,91963,2,56318,14081,1,129352312,129352312,21118,7039,14079,7039,0,1,7041,169642,0.169642
40,50,1840,92000,2,326,83,1,1340800,1340800,121,40,81,40,0,1,42,4536,0.004536
440,50,1840,92000,2,3526,883,1,7388800,7388800,1321,440,881,440,0,1,442,18867,0.018867
840,50,1840,92000,2,6726,1683,1,13436800,13436800,2521,840,1681,840,0,1,842,23838,0.023838
1240,50,1840,92000,2,9926,2483,1,19484800,19484800,3721,1240,2481,1240,0,1,1242,1928,0.001928
1640,50,1840,92000,2,13126,3283,1,25532800,25532800,4921,1640,3281,1640,0,1,1642,39094,0.039094
2040,50,1840,92000,2,16326,4083,1,31580800,31580800,6121,2040,4081,2040,0,1,2042,9012,0.009012
2440,50,1840,92000,2,19526,4883,1,37628800,37628800,7321,2440,4881,2440,0,1,2442,22455,0.022455
2840,50,1840,92000,2,22726,5683,1,43676800,43676800,8521,2840,5681,2840,0,1,2842,59941,0.059941
3240,50,1840,92000,2,25926,6483,1,49724800,49724800,9721,3240,6481,3240,0,1,3242,83160,0.08316
3640,50,1840,92000,2,29126,7283,1,55772800,55772800,10921,3640,7281,3640,0,1,3642,88794,0.088794
4040,50,1840,92000,2,32326,8083,1,61820800,61820800,12121,4040,8081,4040,0,1,4042,64123,0.064123
4440,50,1840,92000,2,35526,8883,1,67868800,67868800,13321,4440,8881,4440,0,1,4442,73516,0.073516
4840,50,1840,92000,2,38726,9683,1,73916800,73916800,14521,4840,9681,4840,0,1,4842,113496,0.113496
5240,50,1840,92000,2,41926,10483,1,79964800,79964800,15721,5240,10481,5240,0,1,5242,49034,0.049034
5640,50,1840,92000,2,45126,11283,1,86012800,86012800,16921,5640,11281,5640,0,1,5642,131799,0.131799
6040,50,1840,92000,2,48326,12083,1,92060800,92060800,18121,6040,12081,6040,0,1,6042,141253,0.141253
6440,50,1840,92000,2,51526,12883,1,98108800,98108800,19321,6440,12881,6440,0,1,6442,44590,0.04459
6840,50,1840,92000,2,54726,13683,1,104156800,104156800,20521,6840,13681,6840,0,1,6842,158857,0.158857
40,2300,40,92000,2,326,83,1,1484800,1484800,121,40,81,40,0,1,42,12288,0.012288
440,2300,40,92000,2,3526,883,1,8972800,8972800,1321,440,881,440,0,1,442,13289,0.013289
840,2300,40,92000,2,6726,1683,1,16460800,16460800,2521,840,1681,840,0,1,842,23123,0.023123
1240,2300,40,92000,2,9926,2483,1,23948800,23948800,3721,1240,2481,1240,0,1,1242,32524,0.032524
1640,2300,40,92000,2,13126,3283,1,31436800,31436800,4921,1640,3281,1640,0,1,1642,38050,0.03805
2040,2300,40,92000,2,16326,4083,1,38924800,38924800,6121,2040,4081,2040,0,1,2042,52194,0.052194
2440,2300,40,92000,2,19526,4883,1,46412800,46412800,7321,2440,4881,2440,0,1,2442,62917,0.062917
2840,2300,40,92000,2,22726,5683,1,53900800,53900800,8521,2840,5681,2840,0,1,2842,73846,0.073846
3240,2300,40,92000,2,25926,6483,1,61388800,61388800,9721,3240,6481,3240,0,1,3242,84964,0.084964
3640,2300,40,92000,2,29126,7283,1,68876800,68876800,10921,3640,7281,3640,0,1,3642,58327,0.058327
4040,2300,40,92000,2,32326,8083,1,76364800,76364800,12121,4040,8081,4040,0,1,4042,98064,0.098064
4440,2300,40,92000,2,35526,8883,1,83852800,83852800,13321,4440,8881,4440,0,1,4442,109130,0.10913
4840,2300,40,92000,2,38726,9683,1,91340800,91340800,14521,4840,9681,4840,0,1,4842,122667,0.122667
5240,2300,40,92000,2,41926,10483,1,98828800,98828800,15721,5240,10481,5240,0,1,5242,127394,0.127394
5640,2300,40,92000,2,45126,11283,1,106316800,106316800,16921,5640,11281,5640,0,1,5642,87112,0.087112
6040,2300,40,92000,2,48326,12083,1,113804800,113804800,18121,6040,12081,6040,0,1,6042,122563,0.122563
6440,2300,40,92000,2,51526,12883,1,121292800,121292800,19321,6440,12881,6440,0,1,6442,154501,0.154501
6840,2300,40,92000,2,54726,13683,1,128780800,128780800,20521,6840,13681,6840,0,1,6842,164165,0.164165
44,1703,55,93665,2,358,91,1,1368136,1368136,133,44,89,44,0,1,46,8819,0.008819
544,1703,55,93665,2,4358,1091,1,8400136,8400136,1633,544,1089,544,0,1,546,14311,0.014311
1044,1703,55,93665,2,8358,2091,1,15432136,15432136,3133,1044,2089,1044,0,1,1046,26665,0.026665
1544,1703,55,93665,2,12358,3091,1,22464136,22464136,4633,1544,3089,1544,0,1,1546,39163,0.039163
2044,1703,55,93665,2,16358,4091,1,29496136,29496136,6133,2044,4089,2044,0,1,2046,49408,0.049408
2544,1703,55,93665,2,20358,5091,1,36528136,36528136,7633,2544,5089,2544,0,1,2546,61563,0.061563
3044,1703,55,93665,2,24358,6091,1,43560136,43560136,9133,3044,6089,3044,0,1,3046,77195,0.077195
3544,1703,55,93665,2,28358,7091,1,50592136,50592136,10633,3544,7089,3544,0,1,3546,85110,0.08511
4044,1703,55,93665,2,32358,8091,1,57624136,57624136,12133,4044,8089,4044,0,1,4046,101273,0.101273
4544,1703,55,93665,2,36358,9091,1,64656136,64656136,13633,4544,9089,4544,0,1,4546,109034,0.109034
5044,1703,55,93665,2,40358,10091,1,71688136,71688136,15133,5044,10089,5044,0,1,5046,117649,0.117649
5544,1703,55,93665,2,44358,11091,1,78720136,78720136,16633,5544,11089,5544,0,1,5546,127261,0.127261
6044,1703,55,93665,2,48358,12091,1,85752136,85752136,18133,6044,12089,6044,0,1,6046,141615,0.141615
6544,1703,55,93665,2,52358,13091,1,92784136,92784136,19633,6544,13089,6544,0,1,6546,149855,0.149855
7044,1703,55,93665,2,56358,14091,1,99816136,99816136,21133,7044,14089,7044,0,1,7046,163010,0.16301
35,2240,45,100800,2,286,73,1,1446200,1446200,106,35,71,35,0,1,37,7608,0.007608
535,2240,45,100800,2,4286,1073,1,10586200,10586200,1606,535,1071,535,0,1,537,15494,0.015494
1035,2240,45,100800,2,8286,2073,1,19726200,19726200,3106,1035,2071,1035,0,1,1037,29175,0.029175
1535,2240,45,100800,2,12286,3073,1,28866200,28866200,4606,1535,3071,1535,0,1,1537,40794,0.040794
2035,2240,45,100800,2,16286,4073,1,38006200,38006200,6106,2035,4071,2035,0,1,2037,58863,0.058863
2535,2240,45,100800,2,20286,5073,1,47146200,47146200,7606,2535,5071,2535,0,1,2537,64981,0.064981
55,1555,65,101075,2,446,113,1,1521400,1521400,166,55,111,55,0,1,57,9838,0.009838
455,1555,65,101075,2,3646,913,1,6705400,6705400,1366,455,911,455,0,1,457,12532,0.012532
855,1555,65,101075,2,6846,1713,1,11889400,11889400,2566,855,1711,855,0,1,857,22543,0.022543
1255,1555,65,101075,2,10046,2513,1,17073400,17073400,3766,1255,2511,1255,0,1,1257,34125,0.034125
1655,1555,65,101075,2,13246,3313,1,22257400,22257400,4966,1655,3311,1655,0,1,1657,41918,0.041918
2055,1555,65,101075,2,16446,4113,1,27441400,27441400,6166,2055,4111,2055,0,1,2057,51116,0.051116
2455,1555,65,101075,2,19646,4913,1,32625400,32625400,7366,2455,4911,2455,0,1,2457,60665,0.060665
2855,1555,65,101075,2,22846,5713,1,37809400,37809400,8566,2855,5711,2855,0,1,2857,68498,0.068498
3255,1555,65,101075,2,26046,6513,1,42993400,42993400,9766,3255,6511,3255,0,1,3257,77004,0.077004
3655,1555,65,101075,2,29246,7313,1,48177400,48177400,10966,3655,7311,3655,0,1,3657,87380,0.08738
4055,1555,65,101075,2,32446,8113,1,53361400,53361400,12166,4055,8111,4055,0,1,4057,94846,0.094846
4455,1555,65,101075,2,35646,8913,1,58545400,58545400,13366,4455,8911,4455,0,1,4457,102863,0.102863
4855,1555,65,101075,2,38846,9713,1,63729400,63729400,14566,4855,9711,4855,0,1,4857,75488,0.075488
5255,1555,65,101075,2,42046,10513,1,68913400,68913400,15766,5255,10511,5255,0,1,5257,126217,0.126217
5655,1555,65,101075,2,45246,11313,1,74097400,74097400,16966,5655,11311,5655,0,1,5657,70584,0.070584
6055,1555,65,101075,2,48446,12113,1,79281400,79281400,18166,6055,12111,6055,0,1,6057,147211,0.147211
6455,1555,65,101075,2,51646,12913,1,84465400,84465400,19366,6455,12911,6455,0,1,6457,155838,0.155838
6855,1555,65,101075,2,54846,13713,1,89649400,89649400,20566,6855,13711,6855,0,1,6857,157183,0.157183
35,40,2545,101800,2,286,73,1,1538200,1538200,106,35,71,35,0,1,37,2597,0.002597
535,40,2545,101800,2,4286,1073,1,11878200,11878200,1606,535,1071,535,0,1,537,14333,0.014333
1035,40,2545,101800,2,8286,2073,1,22218200,22218200,3106,1035,2071,1035,0,1,1037,32612,0.032612
1535,40,2545,101800,2,12286,3073,1,32558200,32558200,4606,1535,3071,1535,0,1,1537,42152,0.042152
2035,40,2545,101800,2,16286,4073,1,42898200,42898200,6106,2035,4071,2035,0,1,2037,23828,0.023828
2535,40,2545,101800,2,20286,5073,1,53238200,53238200,7606,2535,5071,2535,0,1,2537,67280,0.06728
3035,40,2545,101800,2,24286,6073,1,63578200,63578200,9106,3035,6071,3035,0,1,3037,8952,0.008952
3535,40,2545,101800,2,28286,7073,1,73918200,73918200,10606,3535,7071,3535,0,1,3537,109851,0.109851
4035,40,2545,101800,2,32286,8073,1,84258200,84258200,12106,4035,8071,4035,0,1,4037,121598,0.121598
4535,40,2545,101800,2,36286,9073,1,94598200,94598200,13606,4535,9071,4535,0,1,4537,34235,0.034235
5035,40,2545,101800,2,40286,10073,1,104938200,104938200,15106,5035,10071,5035,0,1,5037,34757,0.034757
5535,40,2545,101800,2,44286,11073,1,115278200,115278200,16606,5535,11071,5535,0,1,5537,141514,0.141514
6035,40,2545,101800,2,48286,12073,1,125618200,125618200,18106,6035,12071,6035,0,1,6037,43208,0.043208
6535,40,2545,101800,2,52286,13073,1,135958200,135958200,19606,6535,13071,6535,0,1,6537,168116,0.168116
7035,40,2545,101800,2,56286,14073,1,146298200,146298200,21106,7035,14071,7035,0,1,7037,148901,0.148901
40,300,340,102000,2,326,83,1,1020800,1020800,121,40,81,40,0,1,42,2675,0.002675
440,300,340,102000,2,3526,883,1,3068800,3068800,1321,440,881,440,0,1,442,11516,0.011516
840,300,340,102000,2,6726,1683,1,5116800,5116800,2521,840,1681,840,0,1,842,19646,0.019646
1240,300,340,102000,2,9926,2483,1,7164800,7164800,3721,1240,2481,1240,0,1,1242,27255,0.027255
1640,300,340,102000,2,13126,3283,1,9212800,9212800,4921,1640,3281,1640,0,1,1642,5280,0.00528
2040,300,340,102000,2,16326,4083,1,11260800,11260800,6121,2040,4081,2040,0,1,2042,43478,0.043478
2440,300,340,102000,2,19526,4883,1,13308800,13308800,7321,2440,4881,2440,0,1,2442,51547,0.051547
2840,300,340,102000,2,22726,5683,1,15356800,15356800,8521,2840,5681,2840,0,1,2842,59358,0.059358
3240,300,340,102000,2,25926,6483,1,17404800,17404800,9721,3240,6481,3240,0,1,3242,69312,0.069312
3640,300,340,102000,2,29126,7283,1,19452800,19452800,10921,3640,7281,3640,0,1,3642,78214,0.078214
4040,300,340,102000,2,32326,8083,1,21500800,21500800,12121,4040,8081,4040,0,1,4042,25576,0.025576
4440,300,340,102000,2,35526,8883,1,23548800,23548800,13321,4440,8881,4440,0,1,4442,77002,0.077002
4840,300,340,102000,2,38726,9683,1,25596800,25596800,14521,4840,9681,4840,0,1,4842,99114,0.099114
5240,300,340,102000,2,41926,10483,1,27644800,27644800,15721,5240,10481,5240,0,1,5242,109309,0.109309
5640,300,340,102000,2,45126,11283,1,29692800,29692800,16921,5640,11281,5640,0,1,5642,40291,0.040291
6040,300,340,102000,2,48326,12083,1,31740800,31740800,18121,6040,12081,6040,0,1,6042,33706,0.033706
6440,300,340,102000,2,51526,12883,1,33788800,33788800,19321,6440,12881,6440,0,1,6442,134184,0.134184
6840,300,340,102000,2,54726,13683,1,35836800,35836800,20521,6840,13681,6840,0,1,6842,143895,0.143895
40,2550,40,102000,2,326,83,1,1644800,1644800,121,40,81,40,0,1,42,14238,0.014238
440,2550,40,102000,2,3526,883,1,9932800,9932800,1321,440,881,440,0,1,442,13293,0.013293
840,2550,40,102000,2,6726,1683,1,18220800,18220800,2521,840,1681,840,0,1,842,23875,0.023875
1240,2550,40,102000,2,9926,2483,1,26508800,26508800,3721,1240,2481,1240,0,1,1242,33668,0.033668
1640,2550,40,102000,2,13126,3283,1,34796800,34796800,4921,1640,3281,1640,0,1,1642,46076,0.046076
2040,2550,40,102000,2,16326,4083,1,43084800,43084800,6121,2040,4081,2040,0,1,2042,54226,0.054226
2440,2550,40,102000,2,19526,4883,1,51372800,51372800,7321,2440,4881,2440,0,1,2442,62728,0.062728
2840,2550,40,102000,2,22726,5683,1,59660800,59660800,8521,2840,5681,2840,0,1,2842,79029,0.079029
3240,2550,40,102000,2,25926,6483,1,67948800,67948800,9721,3240,6481,3240,0,1,3242,83867,0.083867
3640,2550,40,102000,2,29126,7283,1,76236800,76236800,10921,3640,7281,3640,0,1,3642,106252,0.106252
4040,2550,40,102000,2,32326,8083,1,84524800,84524800,12121,4040,8081,4040,0,1,4042,102018,0.102018
4440,2550,40,102000,2,35526,8883,1,92812800,92812800,13321,4440,8881,4440,0,1,4442,111755,0.111755
4840,2550,40,102000,2,38726,9683,1,101100800,101100800,14521,4840,9681,4840,0,1,4842,127366,0.127366
5240,2550,40,102000,2,41926,10483,1,109388800,109388800,15721,5240,10481,5240,0,1,5242,135038,0.135038
5640,2550,40,102000,2,45126,11283,1,117676800,117676800,16921,5640,11281,5640,0,1,5642,141452,0.141452
6040,2550,40,102000,2,48326,12083,1,125964800,125964800,18121,6040,12081,6040,0,1,6042,140472,0.140472
6440,2550,40,102000,2,51526,12883,1,134252800,134252800,19321,6440,12881,6440,0,1,6442,160424,0.160424
6840,2550,40,102000,2,54726,13683,1,142540800,142540800,20521,6840,13681,6840,0,1,6842,171160,0.17116
55,55,1865,102575,2,446,113,1,1665400,1665400,166,55,111,55,0,1,57,3224,0.003224
455,55,1865,102575,2,3646,913,1,7809400,7809400,1366,455,911,455,0,1,457,18182,0.018182
855,55,1865,102575,2,6846,1713,1,13953400,13953400,2566,855,1711,855,0,1,857,10951,0.010951
1255,55,1865,102575,2,10046,2513,1,20097400,20097400,3766,1255,2511,1255,0,1,1257,1885,0.001885
1655,55,1865,102575,2,13246,3313,1,26241400,26241400,4966,1655,3311,1655,0,1,1657,20519,0.020519
2055,55,1865,102575,2,16446,4113,1,32385400,32385400,6166,2055,4111,2055,0,1,2057,20999,0.020999
2455,55,1865,102575,2,19646,4913,1,38529400,38529400,7366,2455,4911,2455,0,1,2457,62039,0.062039
2855,55,1865,102575,2,22846,5713,1,44673400,44673400,8566,2855,5711,2855,0,1,2857,5069,0.005069
3255,55,1865,102575,2,26046,6513,1,50817400,50817400,9766,3255,6511,3255,0,1,3257,80675,0.080675
3655,55,1865,102575,2,29246,7313,1,56961400,56961400,10966,3655,7311,3655,0,1,3657,30889,0.030889
4055,55,1865,102575,2,32446,8113,1,63105400,63105400,12166,4055,8111,4055,0,1,4057,70081,0.070081
4455,55,1865,102575,2,35646,8913,1,69249400,69249400,13366,4455,8911,4455,0,1,4457,76522,0.076522
4855,55,1865,102575,2,38846,9713,1,75393400,75393400,14566,4855,9711,4855,0,1,4857,124654,0.124654
5255,55,1865,102575,2,42046,10513,1,81537400,81537400,15766,5255,10511,5255,0,1,5257,128906,0.128906
5655,55,1865,102575,2,45246,11313,1,87681400,87681400,16966,5655,11311,5655,0,1,5657,143063,0.143063
6055,55,1865,102575,2,48446,12113,1,93825400,93825400,18166,6055,12111,6055,0,1,6057,39571,0.039571
6455,55,1865,102575,2,51646,12913,1,99969400,99969400,19366,6455,12911,6455,0,1,6457,128778,0.128778
6855,55,1865,102575,2,54846,13713,1,106113400,106113400,20566,6855,13711,6855,0,1,6857,24137,0.024137
40,50,2140,107000,2,326,83,1,1556800,1556800,121,40,81,40,0,1,42,3064,0.003064
440,50,2140,107000,2,3526,883,1,8564800,8564800,1321,440,881,440,0,1,442,4399,0.004399
840,50,2140,107000,2,6726,1683,1,15572800,15572800,2521,840,1681,840,0,1,842,4051,0.004051
1240,50,2140,107000,2,9926,2483,1,22580800,22580800,3721,1240,2481,1240,0,1,1242,31947,0.031947
1640,50,2140,107000,2,13126,3283,1,29588800,29588800,4921,1640,3281,1640,0,1,1642,47082,0.047082
2040,50,2140,107000,2,16326,4083,1,36596800,36596800,6121,2040,4081,2040,0,1,2042,54431,0.054431
2440,50,2140,107000,2,19526,4883,1,43604800,43604800,7321,2440,4881,2440,0,1,2442,63445,0.063445
2840,50,2140,107000,2,22726,5683,1,50612800,50612800,8521,2840,5681,2840,0,1,2842,21080,0.02108
3240,50,2140,107000,2,25926,6483,1,57620800,57620800,9721,3240,6481,3240,0,1,3242,9542,0.009542
3640,50,2140,107000,2,29126,7283,1,64628800,64628800,10921,3640,7281,3640,0,1,3642,102882,0.102882
4040,50,2140,107000,2,32326,8083,1,71636800,71636800,12121,4040,8081,4040,0,1,4042,101471,0.101471
4440,50,2140,107000,2,35526,8883,1,78644800,78644800,13321,4440,8881,4440,0,1,4442,39605,0.039605
4840,50,2140,107000,2,38726,9683,1,85652800,85652800,14521,4840,9681,4840,0,1,4842,133123,0.133123
5240,50,2140,107000,2,41926,10483,1,92660800,92660800,15721,5240,10481,5240,0,1,5242,145078,0.145078
5640,50,2140,107000,2,45126,11283,1,99668800,99668800,16921,5640,11281,5640,0,1,5642,155202,0.155202
6040,50,2140,107000,2,48326,12083,1,106676800,106676800,18121,6040,12081,6040,0,1,6042,167614,0.167614
6440,50,2140,107000,2,51526,12883,1,113684800,113684800,19321,6440,12881,6440,0,1,6442,34496,0.034496
6840,50,2140,107000,2,54726,13683,1,120692800,120692800,20521,6840,13681,6840,0,1,6842,187908,0.187908
44,53,2055,108915,2,358,91,1,1613336,1613336,133,44,89,44,0,1,46,2671,0.002671
544,53,2055,108915,2,4358,1091,1,10045336,10045336,1633,544,1089,544,0,1,546,27225,0.027225
1044,53,2055,108915,2,8358,2091,1,18477336,18477336,3133,1044,2089,1044,0,1,1046,32387,0.032387
1544,53,2055,108915,2,12358,3091,1,26909336,26909336,4633,1544,3089,1544,0,1,1546,2518,0.002518
2044,53,2055,108915,2,16358,4091,1,35341336,35341336,6133,2044,4089,2044,0,1,2046,3213,0.003213
2544,53,2055,108915,2,20358,5091,1,43773336,43773336,7633,2544,5089,2544,0,1,2546,3812,0.003812
3044,53,2055,108915,2,24358,6091,1,52205336,52205336,9133,3044,6089,3044,0,1,3046,29116,0.029116
3544,53,2055,108915,2,28358,7091,1,60637336,60637336,10633,3544,7089,3544,0,1,3546,106056,0.106056
4044,53,2055,108915,2,32358,8091,1,69069336,69069336,12133,4044,8089,4044,0,1,4046,114149,0.114149
4544,53,2055,108915,2,36358,9091,1,77501336,77501336,13633,4544,9089,4544,0,1,4546,6513,0.006513
5044,53,2055,108915,2,40358,10091,1,85933336,85933336,15133,5044,10089,5044,0,1,5046,44323,0.044323
5544,53,2055,108915,2,44358,11091,1,94365336,94365336,16633,5544,11089,5544,0,1,5546,66947,0.066947
6044,53,2055,108915,2,48358,12091,1,102797336,102797336,18133,6044,12089,6044,0,1,6046,169234,0.169234
6544,53,2055,108915,2,52358,13091,1,111229336,111229336,19633,6544,13089,6544,0,1,6546,182573,0.182573
7044,53,2055,108915,2,56358,14091,1,119661336,119661336,21133,7044,14089,7044,0,1,7046,195357,0.195357
39,43,2541,109263,2,318,81,1,1680312,1680312,118,39,79,39,0,1,41,6223,0.006223
539,43,2541,109263,2,4318,1081,1,12016312,12016312,1618,539,1079,539,0,1,541,26708,0.026708
1039,43,2541,109263,2,8318,2081,1,22352312,22352312,3118,1039,2079,1039,0,1,1041,15949,0.015949
1539,43,2541,109263,2,12318,3081,1,32688312,32688312,4618,1539,3079,1539,0,1,1541,2249,0.002249
2039,43,2541,109263,2,16318,4081,1,43024312,43024312,6118,2039,4079,2039,0,1,2041,3852,0.003852
2539,43,2541,109263,2,20318,5081,1,53360312,53360312,7618,2539,5079,2539,0,1,2541,4753,0.004753
3039,43,2541,109263,2,24318,6081,1,63696312,63696312,9118,3039,6079,3039,0,1,3041,39404,0.039404
3539,43,2541,109263,2,28318,7081,1,74032312,74032312,10618,3539,7079,3539,0,1,3541,111762,0.111762
4039,43,2541,109263,2,32318,8081,1,84368312,84368312,12118,4039,8079,4039,0,1,4041,44916,0.044916
4539,43,2541,109263,2,36318,9081,1,94704312,94704312,13618,4539,9079,4539,0,1,4541,32043,0.032043
5039,43,2541,109263,2,40318,10081,1,105040312,105040312,15118,5039,10079,5039,0,1,5041,151820,0.15182
5539,43,2541,109263,2,44318,11081,1,115376312,115376312,16618,5539,11079,5539,0,1,5541,12024,0.012024
6039,43,2541,109263,2,48318,12081,1,125712312,125712312,18118,6039,12079,6039,0,1,6041,177205,0.177205
6539,43,2541,109263,2,52318,13081,1,136048312,136048312,19618,6539,13079,6539,0,1,6541,189765,0.189765
7039,43,2541,109263,2,56318,14081,1,146384312,146384312,21118,7039,14079,7039,0,1,7041,206376,0.206376
55,305,365,111325,2,446,113,1,1185400,1185400,166,55,111,55,0,1,57,3896,0.003896
455,305,365,111325,2,3646,913,1,3329400,3329400,1366,455,911,455,0,1,457,13753,0.013753
855,305,365,111325,2,6846,1713,1,5473400,5473400,2566,855,1711,855,0,1,857,22987,0.022987
1255,305,365,111325,2,10046,2513,1,7617400,7617400,3766,1255,2511,1255,0,1,1257,32738,0.032738
1655,305,365,111325,2,13246,3313,1,9761400,9761400,4966,1655,3311,1655,0,1,1657,43115,0.043115
2055,305,365,111325,2,16446,4113,1,11905400,11905400,6166,2055,4111,2055,0,1,2057,51981,0.051981
2455,305,365,111325,2,19646,4913,1,14049400,14049400,7366,2455,4911,2455,0,1,2457,61709,0.061709
2855,305,365,111325,2,22846,5713,1,16193400,16193400,8566,2855,5711,2855,0,1,2857,72258,0.072258
3255,305,365,111325,2,26046,6513,1,18337400,18337400,9766,3255,6511,3255,0,1,3257,80788,0.080788
3655,305,365,111325,2,29246,7313,1,20481400,20481400,10966,3655,7311,3655,0,1,3657,90654,0.090654
4055,305,365,111325,2,32446,8113,1,22625400,22625400,12166,4055,8111,4055,0,1,4057,54084,0.054084
4455,305,365,111325,2,35646,8913,1,24769400,24769400,13366,4455,8911,4455,0,1,4457,110400,0.1104
4855,305,365,111325,2,38846,9713,1,26913400,26913400,14566,4855,9711,4855,0,1,4857,120406,0.120406
5255,305,365,111325,2,42046,10513,1,29057400,29057400,15766,5255,10511,5255,0,1,5257,20083,0.020083
5655,305,365,111325,2,45246,11313,1,31201400,31201400,16966,5655,11311,5655,0,1,5657,35948,0.035948
6055,305,365,111325,2,48446,12113,1,33345400,33345400,18166,6055,12111,6055,0,1,6057,43628,0.043628
6455,305,365,111325,2,51646,12913,1,35489400,35489400,19366,6455,12911,6455,0,1,6457,159037,0.159037
6855,305,365,111325,2,54846,13713,1,37633400,37633400,20566,6855,13711,6855,0,1,6857,168923,0.168923
40,2800,40,112000,2,326,83,1,1804800,1804800,121,40,81,40,0,1,42,14910,0.01491
440,2800,40,112000,2,3526,883,1,10892800,10892800,1321,440,881,440,0,1,442,15160,0.01516
840,2800,40,112000,2,6726,1683,1,19980800,19980800,2521,840,1681,840,0,1,842,28106,0.028106
1240,2800,40,112000,2,9926,2483,1,29068800,29068800,3721,1240,2481,1240,0,1,1242,39234,0.039234
1640,2800,40,112000,2,13126,3283,1,38156800,38156800,4921,1640,3281,1640,0,1,1642,51162,0.051162
2040,2800,40,112000,2,16326,4083,1,47244800,47244800,6121,2040,4081,2040,0,1,2042,68424,0.068424
2440,2800,40,112000,2,19526,4883,1,56332800,56332800,7321,2440,4881,2440,0,1,2442,75686,0.075686
2840,2800,40,112000,2,22726,5683,1,65420800,65420800,8521,2840,5681,2840,0,1,2842,92241,0.092241
3240,2800,40,112000,2,25926,6483,1,74508800,74508800,9721,3240,6481,3240,0,1,3242,98236,0.098236
3640,2800,40,112000,2,29126,7283,1,83596800,83596800,10921,3640,7281,3640,0,1,3642,122351,0.122351
4040,2800,40,112000,2,32326,8083,1,92684800,92684800,12121,4040,8081,4040,0,1,4042,123156,0.123156
4440,2800,40,112000,2,35526,8883,1,101772800,101772800,13321,4440,8881,4440,0,1,4442,130183,0.130183
4840,2800,40,112000,2,38726,9683,1,110860800,110860800,14521,4840,9681,4840,0,1,4842,55598,0.055598
5240,2800,40,112000,2,41926,10483,1,119948800,119948800,15721,5240,10481,5240,0,1,5242,150168,0.150168
5640,2800,40,112000,2,45126,11283,1,129036800,129036800,16921,5640,11281,5640,0,1,5642,172333,0.172333
6040,2800,40,112000,2,48326,12083,1,138124800,138124800,18121,6040,12081,6040,0,1,6042,185448,0.185448
6440,2800,40,112000,2,51526,12883,1,147212800,147212800,19321,6440,12881,6440,0,1,6442,195014,0.195014
6840,2800,40,112000,2,54726,13683,1,156300800,156300800,20521,6840,13681,6840,0,1,6842,207479,0.207479
39,2793,41,114513,2,318,81,1,1800312,1800312,118,39,79,39,0,1,41,13746,0.013746
539,2793,41,114513,2,4318,1081,1,13136312,13136312,1618,539,1079,539,0,1,541,19005,0.019005
1039,2793,41,114513,2,8318,2081,1,24472312,24472312,3118,1039,2079,1039,0,1,1041,33678,0.033678
1539,2793,41,114513,2,12318,3081,1,35808312,35808312,4618,1539,3079,1539,0,1,1541,48039,0.048039
2039,2793,41,114513,2,16318,4081,1,47144312,47144312,6118,2039,4079,2039,0,1,2041,62812,0.062812
2539,2793,41,114513,2,20318,5081,1,58480312,58480312,7618,2539,5079,2539,0,1,2541,78342,0.078342
3039,2793,41,114513,2,24318,6081,1,69816312,69816312,9118,3039,6079,3039,0,1,3041,91995,0.091995
3539,2793,41,114513,2,28318,7081,1,81152312,81152312,10618,3539,7079,3539,0,1,3541,106615,0.106615
4039,2793,41,114513,2,32318,8081,1,92488312,92488312,12118,4039,8079,4039,0,1,4041,123351,0.123351
4539,2793,41,114513,2,36318,9081,1,103824312,103824312,13618,4539,9079,4539,0,1,4541,137111,0.137111
5039,2793,41,114513,2,40318,10081,1,115160312,115160312,15118,5039,10079,5039,0,1,5041,162155,0.162155
5539,2793,41,114513,2,44318,11081,1,126496312,126496312,16618,5539,11079,5539,0,1,5541,173357,0.173357
6039,2793,41,114513,2,48318,12081,1,137832312,137832312,18118,6039,12079,6039,0,1,6041,185214,0.185214
6539,2793,41,114513,2,52318,13081,1,149168312,149168312,19618,6539,13079,6539,0,1,6541,210176,0.210176
7039,2793,41,114513,2,56318,14081,1,160504312,160504312,21118,7039,14079,7039,0,1,7041,209635,0.209635
55,1805,65,117325,2,446,113,1,1761400,1761400,166,55,111,55,0,1,57,11366,0.011366
455,1805,65,117325,2,3646,913,1,7745400,7745400,1366,455,911,455,0,1,457,15846,0.015846
855,1805,65,117325,2,6846,1713,1,13729400,13729400,2566,855,1711,855,0,1,857,27269,0.027269
1255,1805,65,117325,2,10046,2513,1,19713400,19713400,3766,1255,2511,1255,0,1,1257,38761,0.038761
1655,1805,65,117325,2,13246,3313,1,25697400,25697400,4966,1655,3311,1655,0,1,1657,51399,0.051399
2055,1805,65,117325,2,16446,4113,1,31681400,31681400,6166,2055,4111,2055,0,1,2057,61475,0.061475
2455,1805,65,117325,2,19646,4913,1,37665400,37665400,7366,2455,4911,2455,0,1,2457,72050,0.07205
2855,1805,65,117325,2,22846,5713,1,43649400,43649400,8566,2855,5711,2855,0,1,2857,86329,0.086329
3255,1805,65,117325,2,26046,6513,1,49633400,49633400,9766,3255,6511,3255,0,1,3257,95504,0.095504
3655,1805,65,117325,2,29246,7313,1,55617400,55617400,10966,3655,7311,3655,0,1,3657,108111,0.108111
4055,1805,65,117325,2,32446,8113,1,61601400,61601400,12166,4055,8111,4055,0,1,4057,115951,0.115951
4455,1805,65,117325,2,35646,8913,1,67585400,67585400,13366,4455,8911,4455,0,1,4457,127270,0.12727
4855,1805,65,117325,2,38846,9713,1,73569400,73569400,14566,4855,9711,4855,0,1,4857,138892,0.138892
5255,1805,65,117325,2,42046,10513,1,79553400,79553400,15766,5255,10511,5255,0,1,5257,147689,0.147689
5655,1805,65,117325,2,45246,11313,1,85537400,85537400,16966,5655,11311,5655,0,1,5657,148944,0.148944
6055,1805,65,117325,2,48446,12113,1,91521400,91521400,18166,6055,12111,6055,0,1,6057,175735,0.175735
6455,1805,65,117325,2,51646,12913,1,97505400,97505400,19366,6455,12911,6455,0,1,6457,6315,0.006315
6855,1805,65,117325,2,54846,13713,1,103489400,103489400,20566,6855,13711,6855,0,1,6857,187429,0.187429
55,55,2165,119075,2,446,113,1,1929400,1929400,166,55,111,55,0,1,57,5944,0.005944
455,55,2165,119075,2,3646,913,1,9033400,9033400,1366,455,911,455,0,1,457,2330,0.00233
855,55,2165,119075,2,6846,1713,1,16137400,16137400,2566,855,1711,855,0,1,857,19917,0.019917
1255,55,2165,119075,2,10046,2513,1,23241400,23241400,3766,1255,2511,1255,0,1,1257,39563,0.039563
1655,55,2165,119075,2,13246,3313,1,30345400,30345400,4966,1655,3311,1655,0,1,1657,2042,0.002042
2055,55,2165,119075,2,16446,4113,1,37449400,37449400,6166,2055,4111,2055,0,1,2057,64627,0.064627
2455,55,2165,119075,2,19646,4913,1,44553400,44553400,7366,2455,4911,2455,0,1,2457,74125,0.074125
2855,55,2165,119075,2,22846,5713,1,51657400,51657400,8566,2855,5711,2855,0,1,2857,33502,0.033502
3255,55,2165,119075,2,26046,6513,1,58761400,58761400,9766,3255,6511,3255,0,1,3257,98303,0.098303
3655,55,2165,119075,2,29246,7313,1,65865400,65865400,10966,3655,7311,3655,0,1,3657,47149,0.047149
4055,55,2165,119075,2,32446,8113,1,72969400,72969400,12166,4055,8111,4055,0,1,4057,119425,0.119425
4455,55,2165,119075,2,35646,8913,1,80073400,80073400,13366,4455,8911,4455,0,1,4457,130581,0.130581
4855,55,2165,119075,2,38846,9713,1,87177400,87177400,14566,4855,9711,4855,0,1,4857,150696,0.150696
5255,55,2165,119075,2,42046,10513,1,94281400,94281400,15766,5255,10511,5255,0,1,5257,7903,0.007903
5655,55,2165,119075,2,45246,11313,1,101385400,101385400,16966,5655,11311,5655,0,1,5657,171550,0.17155
6055,55,2165,119075,2,48446,12113,1,108489400,108489400,18166,6055,12111,6055,0,1,6057,184062,0.184062
6455,55,2165,119075,2,51646,12913,1,115593400,115593400,19366,6455,12911,6455,0,1,6457,188869,0.188869
6855,55,2165,119075,2,54846,13713,1,122697400,122697400,20566,6855,13711,6855,0,1,6857,169022,0.169022
35,40,3045,121800,2,286,73,1,1838200,1838200,106,35,71,35,0,1,37,5634,0.005634
535,40,3045,121800,2,4286,1073,1,14178200,14178200,1606,535,1071,535,0,1,537,27911,0.027911
1035,40,3045,121800,2,8286,2073,1,26518200,26518200,3106,1035,2071,1035,0,1,1037,8490,0.00849
1535,40,3045,121800,2,12286,3073,1,38858200,38858200,4606,1535,3071,1535,0,1,1537,51132,0.051132
2035,40,3045,121800,2,16286,4073,1,51198200,51198200,6106,2035,4071,2035,0,1,2037,66280,0.06628
2535,40,3045,121800,2,20286,5073,1,63538200,63538200,7606,2535,5071,2535,0,1,2537,81740,0.08174
3035,40,3045,121800,2,24286,6073,1,75878200,75878200,9106,3035,6071,3035,0,1,3037,97671,0.097671
3535,40,3045,121800,2,28286,7073,1,88218200,88218200,10606,3535,7071,3535,0,1,3537,122762,0.122762
4035,40,3045,121800,2,32286,8073,1,100558200,100558200,12106,4035,8071,4035,0,1,4037,142818,0.142818
4535,40,3045,121800,2,36286,9073,1,112898200,112898200,13606,4535,9071,4535,0,1,4537,142079,0.142079
5035,40,3045,121800,2,40286,10073,1,125238200,125238200,15106,5035,10071,5035,0,1,5037,157279,0.157279
5535,40,3045,121800,2,44286,11073,1,137578200,137578200,16606,5535,11071,5535,0,1,5537,172176,0.172176
6035,40,3045,121800,2,48286,12073,1,149918200,149918200,18106,6035,12071,6035,0,1,6037,188142,0.188142
6535,40,3045,121800,2,52286,13073,1,162258200,162258200,19606,6535,13071,6535,0,1,6537,202629,0.202629
7035,40,3045,121800,2,56286,14073,1,174598200,174598200,21106,7035,14071,7035,0,1,7037,218549,0.218549
40,3050,40,122000,2,326,83,1,1964800,1964800,121,40,81,40,0,1,42,1284,0.001284
40,50,2440,122000,2,326,83,1,1772800,1772800,121,40,81,40,0,1,42,5810,0.00581
440,50,2440,122000,2,3526,883,1,9740800,9740800,1321,440,881,440,0,1,442,3600,0.0036
840,50,2440,122000,2,6726,1683,1,17708800,17708800,2521,840,1681,840,0,1,842,17781,0.017781
1240,50,2440,122000,2,9926,2483,1,25676800,25676800,3721,1240,2481,1240,0,1,1242,2348,0.002348
1640,50,2440,122000,2,13126,3283,1,33644800,33644800,4921,1640,3281,1640,0,1,1642,25917,0.025917
440,3050,40,122000,2,3526,883,1,11852800,11852800,1321,440,881,440,0,1,442,820,0.00082
2040,50,2440,122000,2,16326,4083,1,41612800,41612800,6121,2040,4081,2040,0,1,2042,68464,0.068464
2440,50,2440,122000,2,19526,4883,1,49580800,49580800,7321,2440,4881,2440,0,1,2442,74218,0.074218
2840,50,2440,122000,2,22726,5683,1,57548800,57548800,8521,2840,5681,2840,0,1,2842,87407,0.087407
3240,50,2440,122000,2,25926,6483,1,65516800,65516800,9721,3240,6481,3240,0,1,3242,98625,0.098625
3640,50,2440,122000,2,29126,7283,1,73484800,73484800,10921,3640,7281,3640,0,1,3642,111723,0.111723
4040,50,2440,122000,2,32326,8083,1,81452800,81452800,12121,4040,8081,4040,0,1,4042,57481,0.057481
4440,50,2440,122000,2,35526,8883,1,89420800,89420800,13321,4440,8881,4440,0,1,4442,133575,0.133575
840,3050,40,122000,2,6726,1683,1,21740800,21740800,2521,840,1681,840,0,1,842,30519,0.030519
4840,50,2440,122000,2,38726,9683,1,97388800,97388800,14521,4840,9681,4840,0,1,4842,136527,0.136527
5240,50,2440,122000,2,41926,10483,1,105356800,105356800,15721,5240,10481,5240,0,1,5242,157326,0.157326
5640,50,2440,122000,2,45126,11283,1,113324800,113324800,16921,5640,11281,5640,0,1,5642,9484,0.009484
6040,50,2440,122000,2,48326,12083,1,121292800,121292800,18121,6040,12081,6040,0,1,6042,180104,0.180104
6440,50,2440,122000,2,51526,12883,1,129260800,129260800,19321,6440,12881,6440,0,1,6442,32734,0.032734
6840,50,2440,122000,2,54726,13683,1,137228800,137228800,20521,6840,13681,6840,0,1,6842,191106,0.191106
1240,3050,40,122000,2,9926,2483,1,31628800,31628800,3721,1240,2481,1240,0,1,1242,32561,0.032561
1640,3050,40,122000,2,13126,3283,1,41516800,41516800,4921,1640,3281,1640,0,1,1642,59594,0.059594
2040,3050,40,122000,2,16326,4083,1,51404800,51404800,6121,2040,4081,2040,0,1,2042,69982,0.069982
2440,3050,40,122000,2,19526,4883,1,61292800,61292800,7321,2440,4881,2440,0,1,2442,84655,0.084655
2840,3050,40,122000,2,22726,5683,1,71180800,71180800,8521,2840,5681,2840,0,1,2842,94957,0.094957
3240,3050,40,122000,2,25926,6483,1,81068800,81068800,9721,3240,6481,3240,0,1,3242,100577,0.100577
3640,3050,40,122000,2,29126,7283,1,90956800,90956800,10921,3640,7281,3640,0,1,3642,115840,0.11584
4040,3050,40,122000,2,32326,8083,1,100844800,100844800,12121,4040,8081,4040,0,1,4042,124008,0.124008
4440,3050,40,122000,2,35526,8883,1,110732800,110732800,13321,4440,8881,4440,0,1,4442,138364,0.138364
4840,3050,40,122000,2,38726,9683,1,120620800,120620800,14521,4840,9681,4840,0,1,4842,153124,0.153124
5240,3050,40,122000,2,41926,10483,1,130508800,130508800,15721,5240,10481,5240,0,1,5242,163112,0.163112
5640,3050,40,122000,2,45126,11283,1,140396800,140396800,16921,5640,11281,5640,0,1,5642,191032,0.191032
6040,3050,40,122000,2,48326,12083,1,150284800,150284800,18121,6040,12081,6040,0,1,6042,190679,0.190679
6440,3050,40,122000,2,51526,12883,1,160172800,160172800,19321,6440,12881,6440,0,1,6442,207155,0.207155
6840,3050,40,122000,2,54726,13683,1,170060800,170060800,20521,6840,13681,6840,0,1,6842,209616,0.209616
44,2253,55,123915,2,358,91,1,1803736,1803736,133,44,89,44,0,1,46,3600,0.0036
544,2253,55,123915,2,4358,1091,1,11035736,11035736,1633,544,1089,544,0,1,546,17380,0.01738
1044,2253,55,123915,2,8358,2091,1,20267736,20267736,3133,1044,2089,1044,0,1,1046,32533,0.032533
1544,2253,55,123915,2,12358,3091,1,29499736,29499736,4633,1544,3089,1544,0,1,1546,47811,0.047811
2044,2253,55,123915,2,16358,4091,1,38731736,38731736,6133,2044,4089,2044,0,1,2046,60361,0.060361
2544,2253,55,123915,2,20358,5091,1,47963736,47963736,7633,2544,5089,2544,0,1,2546,75684,0.075684
3044,2253,55,123915,2,24358,6091,1,57195736,57195736,9133,3044,6089,3044,0,1,3046,88830,0.08883
3544,2253,55,123915,2,28358,7091,1,66427736,66427736,10633,3544,7089,3544,0,1,3546,105919,0.105919
4044,2253,55,123915,2,32358,8091,1,75659736,75659736,12133,4044,8089,4044,0,1,4046,116604,0.116604
4544,2253,55,123915,2,36358,9091,1,84891736,84891736,13633,4544,9089,4544,0,1,4546,130725,0.130725
5044,2253,55,123915,2,40358,10091,1,94123736,94123736,15133,5044,10089,5044,0,1,5046,150415,0.150415
5544,2253,55,123915,2,44358,11091,1,103355736,103355736,16633,5544,11089,5544,0,1,5546,163483,0.163483
6044,2253,55,123915,2,48358,12091,1,112587736,112587736,18133,6044,12089,6044,0,1,6046,177323,0.177323
6544,2253,55,123915,2,52358,13091,1,121819736,121819736,19633,6544,13089,6544,0,1,6546,181478,0.181478
7044,2253,55,123915,2,56358,14091,1,131051736,131051736,21133,7044,14089,7044,0,1,7046,207783,0.207783
39,43,3041,130763,2,318,81,1,2008312,2008312,118,39,79,39,0,1,41,1802,0.001802
539,43,3041,130763,2,4318,1081,1,14344312,14344312,1618,539,1079,539,0,1,541,5070,0.00507
1039,43,3041,130763,2,8318,2081,1,26680312,26680312,3118,1039,2079,1039,0,1,1041,41863,0.041863
1539,43,3041,130763,2,12318,3081,1,39016312,39016312,4618,1539,3079,1539,0,1,1541,54415,0.054415
2039,43,3041,130763,2,16318,4081,1,51352312,51352312,6118,2039,4079,2039,0,1,2041,43203,0.043203
2539,43,3041,130763,2,20318,5081,1,63688312,63688312,7618,2539,5079,2539,0,1,2541,5543,0.005543
3039,43,3041,130763,2,24318,6081,1,76024312,76024312,9118,3039,6079,3039,0,1,3041,26130,0.02613
3539,43,3041,130763,2,28318,7081,1,88360312,88360312,10618,3539,7079,3539,0,1,3541,44769,0.044769
4039,43,3041,130763,2,32318,8081,1,100696312,100696312,12118,4039,8079,4039,0,1,4041,33614,0.033614
4539,43,3041,130763,2,36318,9081,1,113032312,113032312,13618,4539,9079,4539,0,1,4541,151763,0.151763
5039,43,3041,130763,2,40318,10081,1,125368312,125368312,15118,5039,10079,5039,0,1,5041,170488,0.170488
5539,43,3041,130763,2,44318,11081,1,137704312,137704312,16618,5539,11079,5539,0,1,5541,191132,0.191132
6039,43,3041,130763,2,48318,12081,1,150040312,150040312,18118,6039,12079,6039,0,1,6041,196915,0.196915
6539,43,3041,130763,2,52318,13081,1,162376312,162376312,19618,6539,13079,6539,0,1,6541,214314,0.214314
7039,43,3041,130763,2,56318,14081,1,174712312,174712312,21118,7039,14079,7039,0,1,7041,202376,0.202376
40,3300,40,132000,2,326,83,1,2124800,2124800,121,40,81,40,0,1,42,18735,0.018735
440,3300,40,132000,2,3526,883,1,12812800,12812800,1321,440,881,440,0,1,442,18701,0.018701
840,3300,40,132000,2,6726,1683,1,23500800,23500800,2521,840,1681,840,0,1,842,30891,0.030891
1240,3300,40,132000,2,9926,2483,1,34188800,34188800,3721,1240,2481,1240,0,1,1242,41660,0.04166
1640,3300,40,132000,2,13126,3283,1,44876800,44876800,4921,1640,3281,1640,0,1,1642,55594,0.055594
2040,3300,40,132000,2,16326,4083,1,55564800,55564800,6121,2040,4081,2040,0,1,2042,71323,0.071323
2440,3300,40,132000,2,19526,4883,1,66252800,66252800,7321,2440,4881,2440,0,1,2442,83627,0.083627
2840,3300,40,132000,2,22726,5683,1,76940800,76940800,8521,2840,5681,2840,0,1,2842,99226,0.099226
3240,3300,40,132000,2,25926,6483,1,87628800,87628800,9721,3240,6481,3240,0,1,3242,105964,0.105964
3640,3300,40,132000,2,29126,7283,1,98316800,98316800,10921,3640,7281,3640,0,1,3642,132601,0.132601
4040,3300,40,132000,2,32326,8083,1,109004800,109004800,12121,4040,8081,4040,0,1,4042,143400,0.1434
4440,3300,40,132000,2,35526,8883,1,119692800,119692800,13321,4440,8881,4440,0,1,4442,150703,0.150703
4840,3300,40,132000,2,38726,9683,1,130380800,130380800,14521,4840,9681,4840,0,1,4842,100281,0.100281
5240,3300,40,132000,2,41926,10483,1,141068800,141068800,15721,5240,10481,5240,0,1,5242,179179,0.179179
5640,3300,40,132000,2,45126,11283,1,151756800,151756800,16921,5640,11281,5640,0,1,5642,29434,0.029434
6040,3300,40,132000,2,48326,12083,1,162444800,162444800,18121,6040,12081,6040,0,1,6042,38200,0.0382
6440,3300,40,132000,2,51526,12883,1,173132800,173132800,19321,6440,12881,6440,0,1,6442,97301,0.097301
6840,3300,40,132000,2,54726,13683,1,183820800,183820800,20521,6840,13681,6840,0,1,6842,220570,0.22057
55,2055,65,133575,2,446,113,1,2001400,2001400,166,55,111,55,0,1,57,380,0.00038
455,2055,65,133575,2,3646,913,1,8785400,8785400,1366,455,911,455,0,1,457,16796,0.016796
855,2055,65,133575,2,6846,1713,1,15569400,15569400,2566,855,1711,855,0,1,857,29937,0.029937
1255,2055,65,133575,2,10046,2513,1,22353400,22353400,3766,1255,2511,1255,0,1,1257,41926,0.041926
1655,2055,65,133575,2,13246,3313,1,29137400,29137400,4966,1655,3311,1655,0,1,1657,55920,0.05592
2055,2055,65,133575,2,16446,4113,1,35921400,35921400,6166,2055,4111,2055,0,1,2057,66130,0.06613
2455,2055,65,133575,2,19646,4913,1,42705400,42705400,7366,2455,4911,2455,0,1,2457,80257,0.080257
2855,2055,65,133575,2,22846,5713,1,49489400,49489400,8566,2855,5711,2855,0,1,2857,90177,0.090177
3255,2055,65,133575,2,26046,6513,1,56273400,56273400,9766,3255,6511,3255,0,1,3257,111004,0.111004
3655,2055,65,133575,2,29246,7313,1,63057400,63057400,10966,3655,7311,3655,0,1,3657,114486,0.114486
4055,2055,65,133575,2,32446,8113,1,69841400,69841400,12166,4055,8111,4055,0,1,4057,127870,0.12787
4455,2055,65,133575,2,35646,8913,1,76625400,76625400,13366,4455,8911,4455,0,1,4457,139739,0.139739
4855,2055,65,133575,2,38846,9713,1,83409400,83409400,14566,4855,9711,4855,0,1,4857,152631,0.152631
5255,2055,65,133575,2,42046,10513,1,90193400,90193400,15766,5255,10511,5255,0,1,5257,163839,0.163839
5655,2055,65,133575,2,45246,11313,1,96977400,96977400,16966,5655,11311,5655,0,1,5657,22727,0.022727
6055,2055,65,133575,2,48446,12113,1,103761400,103761400,18166,6055,12111,6055,0,1,6057,188669,0.188669
6455,2055,65,133575,2,51646,12913,1,110545400,110545400,19366,6455,12911,6455,0,1,6457,37576,0.037576
6855,2055,65,133575,2,54846,13713,1,117329400,117329400,20566,6855,13711,6855,0,1,6857,212280,0.21228
44,53,2555,135415,2,358,91,1,2001336,2001336,133,44,89,44,0,1,46,6569,0.006569
544,53,2555,135415,2,4358,1091,1,12433336,12433336,1633,544,1089,544,0,1,546,664,0.000664
1044,53,2555,135415,2,8358,2091,1,22865336,22865336,3133,1044,2089,1044,0,1,1046,39098,0.039098
1544,53,2555,135415,2,12358,3091,1,33297336,33297336,4633,1544,3089,1544,0,1,1546,15416,0.015416
2044,53,2555,135415,2,16358,4091,1,43729336,43729336,6133,2044,4089,2044,0,1,2046,4693,0.004693
2544,53,2555,135415,2,20358,5091,1,54161336,54161336,7633,2544,5089,2544,0,1,2546,45900,0.0459
3044,53,2555,135415,2,24358,6091,1,64593336,64593336,9133,3044,6089,3044,0,1,3046,10438,0.010438
3544,53,2555,135415,2,28358,7091,1,75025336,75025336,10633,3544,7089,3544,0,1,3546,79372,0.079372
4044,53,2555,135415,2,32358,8091,1,85457336,85457336,12133,4044,8089,4044,0,1,4046,59258,0.059258
4544,53,2555,135415,2,36358,9091,1,95889336,95889336,13633,4544,9089,4544,0,1,4546,154755,0.154755
5044,53,2555,135415,2,40358,10091,1,106321336,106321336,15133,5044,10089,5044,0,1,5046,170846,0.170846
5544,53,2555,135415,2,44358,11091,1,116753336,116753336,16633,5544,11089,5544,0,1,5546,47346,0.047346
6044,53,2555,135415,2,48358,12091,1,127185336,127185336,18133,6044,12089,6044,0,1,6046,93093,0.093093
6544,53,2555,135415,2,52358,13091,1,137617336,137617336,19633,6544,13089,6544,0,1,6546,46830,0.04683
7044,53,2555,135415,2,56358,14091,1,148049336,148049336,21133,7044,14089,7044,0,1,7046,17500,0.0175
55,55,2465,135575,2,446,113,1,2193400,2193400,166,55,111,55,0,1,57,5419,0.005419
455,55,2465,135575,2,3646,913,1,10257400,10257400,1366,455,911,455,0,1,457,10384,0.010384
855,55,2465,135575,2,6846,1713,1,18321400,18321400,2566,855,1711,855,0,1,857,32111,0.032111
1255,55,2465,135575,2,10046,2513,1,26385400,26385400,3766,1255,2511,1255,0,1,1257,47296,0.047296
1655,55,2465,135575,2,13246,3313,1,34449400,34449400,4966,1655,3311,1655,0,1,1657,23605,0.023605
2055,55,2465,135575,2,16446,4113,1,42513400,42513400,6166,2055,4111,2055,0,1,2057,73120,0.07312
2455,55,2465,135575,2,19646,4913,1,50577400,50577400,7366,2455,4911,2455,0,1,2457,4376,0.004376
2855,55,2465,135575,2,22846,5713,1,58641400,58641400,8566,2855,5711,2855,0,1,2857,46247,0.046247
3255,55,2465,135575,2,26046,6513,1,66705400,66705400,9766,3255,6511,3255,0,1,3257,58288,0.058288
3655,55,2465,135575,2,29246,7313,1,74769400,74769400,10966,3655,7311,3655,0,1,3657,112122,0.112122
4055,55,2465,135575,2,32446,8113,1,82833400,82833400,12166,4055,8111,4055,0,1,4057,138104,0.138104
4455,55,2465,135575,2,35646,8913,1,90897400,90897400,13366,4455,8911,4455,0,1,4457,151967,0.151967
4855,55,2465,135575,2,38846,9713,1,98961400,98961400,14566,4855,9711,4855,0,1,4857,169179,0.169179
5255,55,2465,135575,2,42046,10513,1,107025400,107025400,15766,5255,10511,5255,0,1,5257,177282,0.177282
5655,55,2465,135575,2,45246,11313,1,115089400,115089400,16966,5655,11311,5655,0,1,5657,215224,0.215224
6055,55,2465,135575,2,48446,12113,1,123153400,123153400,18166,6055,12111,6055,0,1,6057,155607,0.155607
6455,55,2465,135575,2,51646,12913,1,131217400,131217400,19366,6455,12911,6455,0,1,6457,167089,0.167089
6855,55,2465,135575,2,54846,13713,1,139281400,139281400,20566,6855,13711,6855,0,1,6857,54816,0.054816
40,50,2740,137000,2,326,83,1,1988800,1988800,121,40,81,40,0,1,42,5898,0.005898
440,50,2740,137000,2,3526,883,1,10916800,10916800,1321,440,881,440,0,1,442,26839,0.026839
840,50,2740,137000,2,6726,1683,1,19844800,19844800,2521,840,1681,840,0,1,842,7470,0.00747
1240,50,2740,137000,2,9926,2483,1,28772800,28772800,3721,1240,2481,1240,0,1,1242,20846,0.020846
1640,50,2740,137000,2,13126,3283,1,37700800,37700800,4921,1640,3281,1640,0,1,1642,59678,0.059678
2040,50,2740,137000,2,16326,4083,1,46628800,46628800,6121,2040,4081,2040,0,1,2042,4102,0.004102
2440,50,2740,137000,2,19526,4883,1,55556800,55556800,7321,2440,4881,2440,0,1,2442,4208,0.004208
2840,50,2740,137000,2,22726,5683,1,64484800,64484800,8521,2840,5681,2840,0,1,2842,100418,0.100418
3240,50,2740,137000,2,25926,6483,1,73412800,73412800,9721,3240,6481,3240,0,1,3242,7184,0.007184
3640,50,2740,137000,2,29126,7283,1,82340800,82340800,10921,3640,7281,3640,0,1,3642,74986,0.074986
4040,50,2740,137000,2,32326,8083,1,91268800,91268800,12121,4040,8081,4040,0,1,4042,6963,0.006963
4440,50,2740,137000,2,35526,8883,1,100196800,100196800,13321,4440,8881,4440,0,1,4442,101418,0.101418
4840,50,2740,137000,2,38726,9683,1,109124800,109124800,14521,4840,9681,4840,0,1,4842,9148,0.009148
5240,50,2740,137000,2,41926,10483,1,118052800,118052800,15721,5240,10481,5240,0,1,5242,68467,0.068467
5640,50,2740,137000,2,45126,11283,1,126980800,126980800,16921,5640,11281,5640,0,1,5642,36305,0.036305
6040,50,2740,137000,2,48326,12083,1,135908800,135908800,18121,6040,12081,6040,0,1,6042,65020,0.06502
6440,50,2740,137000,2,51526,12883,1,144836800,144836800,19321,6440,12881,6440,0,1,6442,56639,0.056639
6840,50,2740,137000,2,54726,13683,1,153764800,153764800,20521,6840,13681,6840,0,1,6842,235488,0.235488
39,3343,41,137063,2,318,81,1,2152312,2152312,118,39,79,39,0,1,41,1561,0.001561
539,3343,41,137063,2,4318,1081,1,15688312,15688312,1618,539,1079,539,0,1,541,20917,0.020917
1039,3343,41,137063,2,8318,2081,1,29224312,29224312,3118,1039,2079,1039,0,1,1041,41969,0.041969
1539,3343,41,137063,2,12318,3081,1,42760312,42760312,4618,1539,3079,1539,0,1,1541,59819,0.059819
2039,3343,41,137063,2,16318,4081,1,56296312,56296312,6118,2039,4079,2039,0,1,2041,3034,0.003034
2539,3343,41,137063,2,20318,5081,1,69832312,69832312,7618,2539,5079,2539,0,1,2541,12506,0.012506
3039,3343,41,137063,2,24318,6081,1,83368312,83368312,9118,3039,6079,3039,0,1,3041,115613,0.115613
3539,3343,41,137063,2,28318,7081,1,96904312,96904312,10618,3539,7079,3539,0,1,3541,133541,0.133541
4039,3343,41,137063,2,32318,8081,1,110440312,110440312,12118,4039,8079,4039,0,1,4041,148573,0.148573
4539,3343,41,137063,2,36318,9081,1,123976312,123976312,13618,4539,9079,4539,0,1,4541,179656,0.179656
5039,3343,41,137063,2,40318,10081,1,137512312,137512312,15118,5039,10079,5039,0,1,5041,135372,0.135372
5539,3343,41,137063,2,44318,11081,1,151048312,151048312,16618,5539,11079,5539,0,1,5541,134851,0.134851
6039,3343,41,137063,2,48318,12081,1,164584312,164584312,18118,6039,12079,6039,0,1,6041,93475,0.093475
6539,3343,41,137063,2,52318,13081,1,178120312,178120312,19618,6539,13079,6539,0,1,6541,235497,0.235497
7039,3343,41,137063,2,56318,14081,1,191656312,191656312,21118,7039,14079,7039,0,1,7041,39482,0.039482
35,40,3545,141800,2,286,73,1,2138200,2138200,106,35,71,35,0,1,37,6214,0.006214
535,40,3545,141800,2,4286,1073,1,16478200,16478200,1606,535,1071,535,0,1,537,27135,0.027135
1035,40,3545,141800,2,8286,2073,1,30818200,30818200,3106,1035,2071,1035,0,1,1037,14801,0.014801
1535,40,3545,141800,2,12286,3073,1,45158200,45158200,4606,1535,3071,1535,0,1,1537,21818,0.021818
2035,40,3545,141800,2,16286,4073,1,59498200,59498200,6106,2035,4071,2035,0,1,2037,77372,0.077372
2535,40,3545,141800,2,20286,5073,1,73838200,73838200,7606,2535,5071,2535,0,1,2537,95833,0.095833
3035,40,3545,141800,2,24286,6073,1,88178200,88178200,9106,3035,6071,3035,0,1,3037,114683,0.114683
3535,40,3545,141800,2,28286,7073,1,102518200,102518200,10606,3535,7071,3535,0,1,3537,138216,0.138216
4035,40,3545,141800,2,32286,8073,1,116858200,116858200,12106,4035,8071,4035,0,1,4037,166667,0.166667
4535,40,3545,141800,2,36286,9073,1,131198200,131198200,13606,4535,9071,4535,0,1,4537,152248,0.152248
5035,40,3545,141800,2,40286,10073,1,145538200,145538200,15106,5035,10071,5035,0,1,5037,183739,0.183739
5535,40,3545,141800,2,44286,11073,1,159878200,159878200,16606,5535,11071,5535,0,1,5537,202258,0.202258
6035,40,3545,141800,2,48286,12073,1,174218200,174218200,18106,6035,12071,6035,0,1,6037,220631,0.220631
6535,40,3545,141800,2,52286,13073,1,188558200,188558200,19606,6535,13071,6535,0,1,6537,238210,0.23821
7035,40,3545,141800,2,56286,14073,1,202898200,202898200,21106,7035,14071,7035,0,1,7037,257374,0.257374
40,3550,40,142000,2,326,83,1,2284800,2284800,121,40,81,40,0,1,42,19348,0.019348
440,3550,40,142000,2,3526,883,1,13772800,13772800,1321,440,881,440,0,1,442,18730,0.01873
840,3550,40,142000,2,6726,1683,1,25260800,25260800,2521,840,1681,840,0,1,842,34132,0.034132
1240,3550,40,142000,2,9926,2483,1,36748800,36748800,3721,1240,2481,1240,0,1,1242,48522,0.048522
1640,3550,40,142000,2,13126,3283,1,48236800,48236800,4921,1640,3281,1640,0,1,1642,68384,0.068384
2040,3550,40,142000,2,16326,4083,1,59724800,59724800,6121,2040,4081,2040,0,1,2042,77201,0.077201
2440,3550,40,142000,2,19526,4883,1,71212800,71212800,7321,2440,4881,2440,0,1,2442,91994,0.091994
2840,3550,40,142000,2,22726,5683,1,82700800,82700800,8521,2840,5681,2840,0,1,2842,107088,0.107088
3240,3550,40,142000,2,25926,6483,1,94188800,94188800,9721,3240,6481,3240,0,1,3242,124554,0.124554
3640,3550,40,142000,2,29126,7283,1,105676800,105676800,10921,3640,7281,3640,0,1,3642,137780,0.13778
4040,3550,40,142000,2,32326,8083,1,117164800,117164800,12121,4040,8081,4040,0,1,4042,18520,0.01852
4440,3550,40,142000,2,35526,8883,1,128652800,128652800,13321,4440,8881,4440,0,1,4442,162382,0.162382
4840,3550,40,142000,2,38726,9683,1,140140800,140140800,14521,4840,9681,4840,0,1,4842,180172,0.180172
5240,3550,40,142000,2,41926,10483,1,151628800,151628800,15721,5240,10481,5240,0,1,5242,2943,0.002943
5640,3550,40,142000,2,45126,11283,1,163116800,163116800,16921,5640,11281,5640,0,1,5642,186875,0.186875
6040,3550,40,142000,2,48326,12083,1,174604800,174604800,18121,6040,12081,6040,0,1,6042,225227,0.225227
6440,3550,40,142000,2,51526,12883,1,186092800,186092800,19321,6440,12881,6440,0,1,6442,88447,0.088447
6840,3550,40,142000,2,54726,13683,1,197580800,197580800,20521,6840,13681,6840,0,1,6842,253321,0.253321
55,2305,65,149825,2,446,113,1,2241400,2241400,166,55,111,55,0,1,57,13781,0.013781
455,2305,65,149825,2,3646,913,1,9825400,9825400,1366,455,911,455,0,1,457,17867,0.017867
855,2305,65,149825,2,6846,1713,1,17409400,17409400,2566,855,1711,855,0,1,857,30896,0.030896
1255,2305,65,149825,2,10046,2513,1,24993400,24993400,3766,1255,2511,1255,0,1,1257,44075,0.044075
1655,2305,65,149825,2,13246,3313,1,32577400,32577400,4966,1655,3311,1655,0,1,1657,56997,0.056997
2055,2305,65,149825,2,16446,4113,1,40161400,40161400,6166,2055,4111,2055,0,1,2057,72318,0.072318
2455,2305,65,149825,2,19646,4913,1,47745400,47745400,7366,2455,4911,2455,0,1,2457,83950,0.08395
2855,2305,65,149825,2,22846,5713,1,55329400,55329400,8566,2855,5711,2855,0,1,2857,98878,0.098878
3255,2305,65,149825,2,26046,6513,1,62913400,62913400,9766,3255,6511,3255,0,1,3257,111592,0.111592
3655,2305,65,149825,2,29246,7313,1,70497400,70497400,10966,3655,7311,3655,0,1,3657,127001,0.127001
4055,2305,65,149825,2,32446,8113,1,78081400,78081400,12166,4055,8111,4055,0,1,4057,140445,0.140445
4455,2305,65,149825,2,35646,8913,1,85665400,85665400,13366,4455,8911,4455,0,1,4457,152773,0.152773
4855,2305,65,149825,2,38846,9713,1,93249400,93249400,14566,4855,9711,4855,0,1,4857,76617,0.076617
5255,2305,65,149825,2,42046,10513,1,100833400,100833400,15766,5255,10511,5255,0,1,5257,182781,0.182781
5655,2305,65,149825,2,45246,11313,1,108417400,108417400,16966,5655,11311,5655,0,1,5657,195673,0.195673
6055,2305,65,149825,2,48446,12113,1,116001400,116001400,18166,6055,12111,6055,0,1,6057,207616,0.207616
6455,2305,65,149825,2,51646,12913,1,123585400,123585400,19366,6455,12911,6455,0,1,6457,229122,0.229122
6855,2305,65,149825,2,54846,13713,1,131169400,131169400,20566,6855,13711,6855,0,1,6857,68115,0.068115
35,3340,45,150300,2,286,73,1,2150200,2150200,106,35,71,35,0,1,37,9847,0.009847
535,3340,45,150300,2,4286,1073,1,15690200,15690200,1606,535,1071,535,0,1,537,23073,0.023073
1035,3340,45,150300,2,8286,2073,1,29230200,29230200,3106,1035,2071,1035,0,1,1037,43232,0.043232
1535,3340,45,150300,2,12286,3073,1,42770200,42770200,4606,1535,3071,1535,0,1,1537,60427,0.060427
2035,3340,45,150300,2,16286,4073,1,56310200,56310200,6106,2035,4071,2035,0,1,2037,78199,0.078199
40,50,3040,152000,2,326,83,1,2204800,2204800,121,40,81,40,0,1,42,2977,0.002977
440,50,3040,152000,2,3526,883,1,12092800,12092800,1321,440,881,440,0,1,442,1770,0.00177
840,50,3040,152000,2,6726,1683,1,21980800,21980800,2521,840,1681,840,0,1,842,2112,0.002112
1240,50,3040,152000,2,9926,2483,1,31868800,31868800,3721,1240,2481,1240,0,1,1242,6410,0.00641
1640,50,3040,152000,2,13126,3283,1,41756800,41756800,4921,1640,3281,1640,0,1,1642,36048,0.036048
2040,50,3040,152000,2,16326,4083,1,51644800,51644800,6121,2040,4081,2040,0,1,2042,37178,0.037178
2440,50,3040,152000,2,19526,4883,1,61532800,61532800,7321,2440,4881,2440,0,1,2442,93883,0.093883
2840,50,3040,152000,2,22726,5683,1,71420800,71420800,8521,2840,5681,2840,0,1,2842,8197,0.008197
3240,50,3040,152000,2,25926,6483,1,81308800,81308800,9721,3240,6481,3240,0,1,3242,66444,0.066444
3640,50,3040,152000,2,29126,7283,1,91196800,91196800,10921,3640,7281,3640,0,1,3642,74768,0.074768
4040,50,3040,152000,2,32326,8083,1,101084800,101084800,12121,4040,8081,4040,0,1,4042,8555,0.008555
4440,50,3040,152000,2,35526,8883,1,110972800,110972800,13321,4440,8881,4440,0,1,4442,160674,0.160674
4840,50,3040,152000,2,38726,9683,1,120860800,120860800,14521,4840,9681,4840,0,1,4842,175618,0.175618
5240,50,3040,152000,2,41926,10483,1,130748800,130748800,15721,5240,10481,5240,0,1,5242,47657,0.047657
5640,50,3040,152000,2,45126,11283,1,140636800,140636800,16921,5640,11281,5640,0,1,5642,202957,0.202957
6040,50,3040,152000,2,48326,12083,1,150524800,150524800,18121,6040,12081,6040,0,1,6042,26369,0.026369
6440,50,3040,152000,2,51526,12883,1,160412800,160412800,19321,6440,12881,6440,0,1,6442,229358,0.229358
6840,50,3040,152000,2,54726,13683,1,170300800,170300800,20521,6840,13681,6840,0,1,6842,244723,0.244723
40,3800,40,152000,2,326,83,1,2444800,2444800,121,40,81,40,0,1,42,20738,0.020738
440,3800,40,152000,2,3526,883,1,14732800,14732800,1321,440,881,440,0,1,442,19882,0.019882
840,3800,40,152000,2,6726,1683,1,27020800,27020800,2521,840,1681,840,0,1,842,35921,0.035921
1240,3800,40,152000,2,9926,2483,1,39308800,39308800,3721,1240,2481,1240,0,1,1242,52245,0.052245
1640,3800,40,152000,2,13126,3283,1,51596800,51596800,4921,1640,3281,1640,0,1,1642,65492,0.065492
2040,3800,40,152000,2,16326,4083,1,63884800,63884800,6121,2040,4081,2040,0,1,2042,84006,0.084006
2440,3800,40,152000,2,19526,4883,1,76172800,76172800,7321,2440,4881,2440,0,1,2442,101681,0.101681
2840,3800,40,152000,2,22726,5683,1,88460800,88460800,8521,2840,5681,2840,0,1,2842,119063,0.119063
3240,3800,40,152000,2,25926,6483,1,100748800,100748800,9721,3240,6481,3240,0,1,3242,125736,0.125736
3640,3800,40,152000,2,29126,7283,1,113036800,113036800,10921,3640,7281,3640,0,1,3642,144777,0.144777
4040,3800,40,152000,2,32326,8083,1,125324800,125324800,12121,4040,8081,4040,0,1,4042,161740,0.16174
4440,3800,40,152000,2,35526,8883,1,137612800,137612800,13321,4440,8881,4440,0,1,4442,169528,0.169528
4840,3800,40,152000,2,38726,9683,1,149900800,149900800,14521,4840,9681,4840,0,1,4842,196997,0.196997
5240,3800,40,152000,2,41926,10483,1,162188800,162188800,15721,5240,10481,5240,0,1,5242,206225,0.206225
5640,3800,40,152000,2,45126,11283,1,174476800,174476800,16921,5640,11281,5640,0,1,5642,220692,0.220692
6040,3800,40,152000,2,48326,12083,1,186764800,186764800,18121,6040,12081,6040,0,1,6042,235641,0.235641
6440,3800,40,152000,2,51526,12883,1,199052800,199052800,19321,6440,12881,6440,0,1,6442,253338,0.253338
6840,3800,40,152000,2,54726,13683,1,211340800,211340800,20521,6840,13681,6840,0,1,6842,277499,0.277499
55,55,2765,152075,2,446,113,1,2457400,2457400,166,55,111,55,0,1,57,7985,0.007985
455,55,2765,152075,2,3646,913,1,11481400,11481400,1366,455,911,455,0,1,457,15317,0.015317
855,55,2765,152075,2,6846,1713,1,20505400,20505400,2566,855,1711,855,0,1,857,11108,0.011108
1255,55,2765,152075,2,10046,2513,1,29529400,29529400,3766,1255,2511,1255,0,1,1257,45559,0.045559
1655,55,2765,152075,2,13246,3313,1,38553400,38553400,4966,1655,3311,1655,0,1,1657,2249,0.002249
2055,55,2765,152075,2,16446,4113,1,47577400,47577400,6166,2055,4111,2055,0,1,2057,24334,0.024334
2455,55,2765,152075,2,19646,4913,1,56601400,56601400,7366,2455,4911,2455,0,1,2457,92426,0.092426
2855,55,2765,152075,2,22846,5713,1,65625400,65625400,8566,2855,5711,2855,0,1,2857,83554,0.083554
3255,55,2765,152075,2,26046,6513,1,74649400,74649400,9766,3255,6511,3255,0,1,3257,67572,0.067572
3655,55,2765,152075,2,29246,7313,1,83673400,83673400,10966,3655,7311,3655,0,1,3657,50281,0.050281
4055,55,2765,152075,2,32446,8113,1,92697400,92697400,12166,4055,8111,4055,0,1,4057,84208,0.084208
4455,55,2765,152075,2,35646,8913,1,101721400,101721400,13366,4455,8911,4455,0,1,4457,101015,0.101015
4855,55,2765,152075,2,38846,9713,1,110745400,110745400,14566,4855,9711,4855,0,1,4857,33111,0.033111
5255,55,2765,152075,2,42046,10513,1,119769400,119769400,15766,5255,10511,5255,0,1,5257,190410,0.19041
5655,55,2765,152075,2,45246,11313,1,128793400,128793400,16966,5655,11311,5655,0,1,5657,12879,0.012879
6055,55,2765,152075,2,48446,12113,1,137817400,137817400,18166,6055,12111,6055,0,1,6057,218157,0.218157
6455,55,2765,152075,2,51646,12913,1,146841400,146841400,19366,6455,12911,6455,0,1,6457,61944,0.061944
6855,55,2765,152075,2,54846,13713,1,155865400,155865400,20566,6855,13711,6855,0,1,6857,154471,0.154471
39,43,3541,152263,2,318,81,1,2336312,2336312,118,39,79,39,0,1,41,7148,0.007148
539,43,3541,152263,2,4318,1081,1,16672312,16672312,1618,539,1079,539,0,1,541,16114,0.016114
1039,43,3541,152263,2,8318,2081,1,31008312,31008312,3118,1039,2079,1039,0,1,1041,31675,0.031675
1539,43,3541,152263,2,12318,3081,1,45344312,45344312,4618,1539,3079,1539,0,1,1541,16247,0.016247
2039,43,3541,152263,2,16318,4081,1,59680312,59680312,6118,2039,4079,2039,0,1,2041,77592,0.077592
2539,43,3541,152263,2,20318,5081,1,74016312,74016312,7618,2539,5079,2539,0,1,2541,18312,0.018312
3039,43,3541,152263,2,24318,6081,1,88352312,88352312,9118,3039,6079,3039,0,1,3041,74129,0.074129
3539,43,3541,152263,2,28318,7081,1,102688312,102688312,10618,3539,7079,3539,0,1,3541,142501,0.142501
4039,43,3541,152263,2,32318,8081,1,117024312,117024312,12118,4039,8079,4039,0,1,4041,162213,0.162213
4539,43,3541,152263,2,36318,9081,1,131360312,131360312,13618,4539,9079,4539,0,1,4541,158425,0.158425
5039,43,3541,152263,2,40318,10081,1,145696312,145696312,15118,5039,10079,5039,0,1,5041,142246,0.142246
5539,43,3541,152263,2,44318,11081,1,160032312,160032312,16618,5539,11079,5539,0,1,5541,211797,0.211797
6039,43,3541,152263,2,48318,12081,1,174368312,174368312,18118,6039,12079,6039,0,1,6041,107184,0.107184
6539,43,3541,152263,2,52318,13081,1,188704312,188704312,19618,6539,13079,6539,0,1,6541,133152,0.133152
7039,43,3541,152263,2,56318,14081,1,203040312,203040312,21118,7039,14079,7039,0,1,7041,270035,0.270035
44,2803,55,154165,2,358,91,1,2239336,2239336,133,44,89,44,0,1,46,14628,0.014628
544,2803,55,154165,2,4358,1091,1,13671336,13671336,1633,544,1089,544,0,1,546,21999,0.021999
1044,2803,55,154165,2,8358,2091,1,25103336,25103336,3133,1044,2089,1044,0,1,1046,39452,0.039452
1544,2803,55,154165,2,12358,3091,1,36535336,36535336,4633,1544,3089,1544,0,1,1546,56691,0.056691
2044,2803,55,154165,2,16358,4091,1,47967336,47967336,6133,2044,4089,2044,0,1,2046,75054,0.075054
2544,2803,55,154165,2,20358,5091,1,59399336,59399336,7633,2544,5089,2544,0,1,2546,92932,0.092932
3044,2803,55,154165,2,24358,6091,1,70831336,70831336,9133,3044,6089,3044,0,1,3046,108290,0.10829
3544,2803,55,154165,2,28358,7091,1,82263336,82263336,10633,3544,7089,3544,0,1,3546,125878,0.125878
4044,2803,55,154165,2,32358,8091,1,93695336,93695336,12133,4044,8089,4044,0,1,4046,143007,0.143007
4544,2803,55,154165,2,36358,9091,1,105127336,105127336,13633,4544,9089,4544,0,1,4546,161413,0.161413
5044,2803,55,154165,2,40358,10091,1,116559336,116559336,15133,5044,10089,5044,0,1,5046,182232,0.182232
5544,2803,55,154165,2,44358,11091,1,127991336,127991336,16633,5544,11089,5544,0,1,5546,44339,0.044339
6044,2803,55,154165,2,48358,12091,1,139423336,139423336,18133,6044,12089,6044,0,1,6046,212382,0.212382
6544,2803,55,154165,2,52358,13091,1,150855336,150855336,19633,6544,13089,6544,0,1,6546,234186,0.234186
7044,2803,55,154165,2,56358,14091,1,162287336,162287336,21133,7044,14089,7044,0,1,7046,250737,0.250737
39,3893,41,159613,2,318,81,1,2504312,2504312,118,39,79,39,0,1,41,20236,0.020236
539,3893,41,159613,2,4318,1081,1,18240312,18240312,1618,539,1079,539,0,1,541,25491,0.025491
1039,3893,41,159613,2,8318,2081,1,33976312,33976312,3118,1039,2079,1039,0,1,1041,46942,0.046942
1539,3893,41,159613,2,12318,3081,1,49712312,49712312,4618,1539,3079,1539,0,1,1541,66143,0.066143
2039,3893,41,159613,2,16318,4081,1,65448312,65448312,6118,2039,4079,2039,0,1,2041,21171,0.021171
2539,3893,41,159613,2,20318,5081,1,81184312,81184312,7618,2539,5079,2539,0,1,2541,105977,0.105977
3039,3893,41,159613,2,24318,6081,1,96920312,96920312,9118,3039,6079,3039,0,1,3041,123643,0.123643
3539,3893,41,159613,2,28318,7081,1,112656312,112656312,10618,3539,7079,3539,0,1,3541,143353,0.143353
4039,3893,41,159613,2,32318,8081,1,128392312,128392312,12118,4039,8079,4039,0,1,4041,158372,0.158372
4539,3893,41,159613,2,36318,9081,1,144128312,144128312,13618,4539,9079,4539,0,1,4541,189928,0.189928
5039,3893,41,159613,2,40318,10081,1,159864312,159864312,15118,5039,10079,5039,0,1,5041,203291,0.203291
5539,3893,41,159613,2,44318,11081,1,175600312,175600312,16618,5539,11079,5539,0,1,5541,240264,0.240264
6039,3893,41,159613,2,48318,12081,1,191336312,191336312,18118,6039,12079,6039,0,1,6041,29089,0.029089
6539,3893,41,159613,2,52318,13081,1,207072312,207072312,19618,6539,13079,6539,0,1,6541,275219,0.275219
7039,3893,41,159613,2,56318,14081,1,222808312,222808312,21118,7039,14079,7039,0,1,7041,289464,0.289464
35,40,4045,161800,2,286,73,1,2438200,2438200,106,35,71,35,0,1,37,5275,0.005275
535,40,4045,161800,2,4286,1073,1,18778200,18778200,1606,535,1071,535,0,1,537,13103,0.013103
1035,40,4045,161800,2,8286,2073,1,35118200,35118200,3106,1035,2071,1035,0,1,1037,49633,0.049633
1535,40,4045,161800,2,12286,3073,1,51458200,51458200,4606,1535,3071,1535,0,1,1537,69204,0.069204
2035,40,4045,161800,2,16286,4073,1,67798200,67798200,6106,2035,4071,2035,0,1,2037,88851,0.088851
2535,40,4045,161800,2,20286,5073,1,84138200,84138200,7606,2535,5071,2535,0,1,2537,109319,0.109319
3035,40,4045,161800,2,24286,6073,1,100478200,100478200,9106,3035,6071,3035,0,1,3037,27576,0.027576
3535,40,4045,161800,2,28286,7073,1,116818200,116818200,10606,3535,7071,3535,0,1,3537,157603,0.157603
4035,40,4045,161800,2,32286,8073,1,133158200,133158200,12106,4035,8071,4035,0,1,4037,39684,0.039684
4535,40,4045,161800,2,36286,9073,1,149498200,149498200,13606,4535,9071,4535,0,1,4537,59995,0.059995
5035,40,4045,161800,2,40286,10073,1,165838200,165838200,15106,5035,10071,5035,0,1,5037,211407,0.211407
5535,40,4045,161800,2,44286,11073,1,182178200,182178200,16606,5535,11071,5535,0,1,5537,230806,0.230806
6035,40,4045,161800,2,48286,12073,1,198518200,198518200,18106,6035,12071,6035,0,1,6037,253096,0.253096
6535,40,4045,161800,2,52286,13073,1,214858200,214858200,19606,6535,13071,6535,0,1,6537,157560,0.15756
7035,40,4045,161800,2,56286,14073,1,231198200,231198200,21106,7035,14071,7035,0,1,7037,292491,0.292491
44,53,3055,161915,2,358,91,1,2389336,2389336,133,44,89,44,0,1,46,1639,0.001639
544,53,3055,161915,2,4358,1091,1,14821336,14821336,1633,544,1089,544,0,1,546,11211,0.011211
1044,53,3055,161915,2,8358,2091,1,27253336,27253336,3133,1044,2089,1044,0,1,1046,9634,0.009634
1544,53,3055,161915,2,12358,3091,1,39685336,39685336,4633,1544,3089,1544,0,1,1546,16139,0.016139
2044,53,3055,161915,2,16358,4091,1,52117336,52117336,6133,2044,4089,2044,0,1,2046,12850,0.01285
2544,53,3055,161915,2,20358,5091,1,64549336,64549336,7633,2544,5089,2544,0,1,2546,84349,0.084349
3044,53,3055,161915,2,24358,6091,1,76981336,76981336,9133,3044,6089,3044,0,1,3046,123515,0.123515
3544,53,3055,161915,2,28358,7091,1,89413336,89413336,10633,3544,7089,3544,0,1,3546,43635,0.043635
4044,53,3055,161915,2,32358,8091,1,101845336,101845336,12133,4044,8089,4044,0,1,4046,162169,0.162169
4544,53,3055,161915,2,36358,9091,1,114277336,114277336,13633,4544,9089,4544,0,1,4546,180783,0.180783
5044,53,3055,161915,2,40358,10091,1,126709336,126709336,15133,5044,10089,5044,0,1,5046,199918,0.199918
5544,53,3055,161915,2,44358,11091,1,139141336,139141336,16633,5544,11089,5544,0,1,5546,170175,0.170175
6044,53,3055,161915,2,48358,12091,1,151573336,151573336,18133,6044,12089,6044,0,1,6046,242657,0.242657
6544,53,3055,161915,2,52358,13091,1,164005336,164005336,19633,6544,13089,6544,0,1,6546,8544,0.008544
7044,53,3055,161915,2,56358,14091,1,176437336,176437336,21133,7044,14089,7044,0,1,7046,281054,0.281054
40,4050,40,162000,2,326,83,1,2604800,2604800,121,40,81,40,0,1,42,5477,0.005477
440,4050,40,162000,2,3526,883,1,15692800,15692800,1321,440,881,440,0,1,442,22864,0.022864
840,4050,40,162000,2,6726,1683,1,28780800,28780800,2521,840,1681,840,0,1,842,36822,0.036822
1240,4050,40,162000,2,9926,2483,1,41868800,41868800,3721,1240,2481,1240,0,1,1242,57265,0.057265
1640,4050,40,162000,2,13126,3283,1,54956800,54956800,4921,1640,3281,1640,0,1,1642,69968,0.069968
2040,4050,40,162000,2,16326,4083,1,68044800,68044800,6121,2040,4081,2040,0,1,2042,84977,0.084977
2440,4050,40,162000,2,19526,4883,1,81132800,81132800,7321,2440,4881,2440,0,1,2442,102445,0.102445
2840,4050,40,162000,2,22726,5683,1,94220800,94220800,8521,2840,5681,2840,0,1,2842,119275,0.119275
3240,4050,40,162000,2,25926,6483,1,107308800,107308800,9721,3240,6481,3240,0,1,3242,135664,0.135664
3640,4050,40,162000,2,29126,7283,1,120396800,120396800,10921,3640,7281,3640,0,1,3642,98178,0.098178
4040,4050,40,162000,2,32326,8083,1,133484800,133484800,12121,4040,8081,4040,0,1,4042,111997,0.111997
4440,4050,40,162000,2,35526,8883,1,146572800,146572800,13321,4440,8881,4440,0,1,4442,183389,0.183389
4840,4050,40,162000,2,38726,9683,1,159660800,159660800,14521,4840,9681,4840,0,1,4842,214663,0.214663
5240,4050,40,162000,2,41926,10483,1,172748800,172748800,15721,5240,10481,5240,0,1,5242,215221,0.215221
5640,4050,40,162000,2,45126,11283,1,185836800,185836800,16921,5640,11281,5640,0,1,5642,246249,0.246249
6040,4050,40,162000,2,48326,12083,1,198924800,198924800,18121,6040,12081,6040,0,1,6042,247550,0.24755
6440,4050,40,162000,2,51526,12883,1,212012800,212012800,19321,6440,12881,6440,0,1,6442,11800,0.0118
6840,4050,40,162000,2,54726,13683,1,225100800,225100800,20521,6840,13681,6840,0,1,6842,269504,0.269504
55,2555,65,166075,2,446,113,1,2481400,2481400,166,55,111,55,0,1,57,15498,0.015498
455,2555,65,166075,2,3646,913,1,10865400,10865400,1366,455,911,455,0,1,457,3848,0.003848
855,2555,65,166075,2,6846,1713,1,19249400,19249400,2566,855,1711,855,0,1,857,35551,0.035551
1255,2555,65,166075,2,10046,2513,1,27633400,27633400,3766,1255,2511,1255,0,1,1257,52525,0.052525
1655,2555,65,166075,2,13246,3313,1,36017400,36017400,4966,1655,3311,1655,0,1,1657,66593,0.066593
2055,2555,65,166075,2,16446,4113,1,44401400,44401400,6166,2055,4111,2055,0,1,2057,80793,0.080793
2455,2555,65,166075,2,19646,4913,1,52785400,52785400,7366,2455,4911,2455,0,1,2457,96374,0.096374
2855,2555,65,166075,2,22846,5713,1,61169400,61169400,8566,2855,5711,2855,0,1,2857,116334,0.116334
3255,2555,65,166075,2,26046,6513,1,69553400,69553400,9766,3255,6511,3255,0,1,3257,127286,0.127286
3655,2555,65,166075,2,29246,7313,1,77937400,77937400,10966,3655,7311,3655,0,1,3657,89763,0.089763
4055,2555,65,166075,2,32446,8113,1,86321400,86321400,12166,4055,8111,4055,0,1,4057,165297,0.165297
4455,2555,65,166075,2,35646,8913,1,94705400,94705400,13366,4455,8911,4455,0,1,4457,170584,0.170584
4855,2555,65,166075,2,38846,9713,1,103089400,103089400,14566,4855,9711,4855,0,1,4857,190430,0.19043
5255,2555,65,166075,2,42046,10513,1,111473400,111473400,15766,5255,10511,5255,0,1,5257,177251,0.177251
5655,2555,65,166075,2,45246,11313,1,119857400,119857400,16966,5655,11311,5655,0,1,5657,228330,0.22833
6055,2555,65,166075,2,48446,12113,1,128241400,128241400,18166,6055,12111,6055,0,1,6057,118321,0.118321
6455,2555,65,166075,2,51646,12913,1,136625400,136625400,19366,6455,12911,6455,0,1,6457,245321,0.245321
6855,2555,65,166075,2,54846,13713,1,145009400,145009400,20566,6855,13711,6855,0,1,6857,215814,0.215814
40,50,3340,167000,2,326,83,1,2420800,2420800,121,40,81,40,0,1,42,580,0.00058
440,50,3340,167000,2,3526,883,1,13268800,13268800,1321,440,881,440,0,1,442,24846,0.024846
840,50,3340,167000,2,6726,1683,1,24116800,24116800,2521,840,1681,840,0,1,842,33388,0.033388
1240,50,3340,167000,2,9926,2483,1,34964800,34964800,3721,1240,2481,1240,0,1,1242,54086,0.054086
1640,50,3340,167000,2,13126,3283,1,45812800,45812800,4921,1640,3281,1640,0,1,1642,4279,0.004279
2040,50,3340,167000,2,16326,4083,1,56660800,56660800,6121,2040,4081,2040,0,1,2042,48923,0.048923
2440,50,3340,167000,2,19526,4883,1,67508800,67508800,7321,2440,4881,2440,0,1,2442,5024,0.005024
2840,50,3340,167000,2,22726,5683,1,78356800,78356800,8521,2840,5681,2840,0,1,2842,119048,0.119048
3240,50,3340,167000,2,25926,6483,1,89204800,89204800,9721,3240,6481,3240,0,1,3242,107907,0.107907
3640,50,3340,167000,2,29126,7283,1,100052800,100052800,10921,3640,7281,3640,0,1,3642,72408,0.072408
4040,50,3340,167000,2,32326,8083,1,110900800,110900800,12121,4040,8081,4040,0,1,4042,34672,0.034672
4440,50,3340,167000,2,35526,8883,1,121748800,121748800,13321,4440,8881,4440,0,1,4442,124311,0.124311
4840,50,3340,167000,2,38726,9683,1,132596800,132596800,14521,4840,9681,4840,0,1,4842,199448,0.199448
5240,50,3340,167000,2,41926,10483,1,143444800,143444800,15721,5240,10481,5240,0,1,5242,58180,0.05818
5640,50,3340,167000,2,45126,11283,1,154292800,154292800,16921,5640,11281,5640,0,1,5642,232546,0.232546
6040,50,3340,167000,2,48326,12083,1,165140800,165140800,18121,6040,12081,6040,0,1,6042,66712,0.066712
6440,50,3340,167000,2,51526,12883,1,175988800,175988800,19321,6440,12881,6440,0,1,6442,131244,0.131244
6840,50,3340,167000,2,54726,13683,1,186836800,186836800,20521,6840,13681,6840,0,1,6842,17507,0.017507
55,55,3065,168575,2,446,113,1,2721400,2721400,166,55,111,55,0,1,57,967,0.000967
455,55,3065,168575,2,3646,913,1,12705400,12705400,1366,455,911,455,0,1,457,9523,0.009523
855,55,3065,168575,2,6846,1713,1,22689400,22689400,2566,855,1711,855,0,1,857,2162,0.002162
1255,55,3065,168575,2,10046,2513,1,32673400,32673400,3766,1255,2511,1255,0,1,1257,19084,0.019084
1655,55,3065,168575,2,13246,3313,1,42657400,42657400,4966,1655,3311,1655,0,1,1657,71921,0.071921
2055,55,3065,168575,2,16446,4113,1,52641400,52641400,6166,2055,4111,2055,0,1,2057,93303,0.093303
2455,55,3065,168575,2,19646,4913,1,62625400,62625400,7366,2455,4911,2455,0,1,2457,10183,0.010183
2855,55,3065,168575,2,22846,5713,1,72609400,72609400,8566,2855,5711,2855,0,1,2857,36673,0.036673
3255,55,3065,168575,2,26046,6513,1,82593400,82593400,9766,3255,6511,3255,0,1,3257,32253,0.032253
3655,55,3065,168575,2,29246,7313,1,92577400,92577400,10966,3655,7311,3655,0,1,3657,150412,0.150412
4055,55,3065,168575,2,32446,8113,1,102561400,102561400,12166,4055,8111,4055,0,1,4057,166565,0.166565
4455,55,3065,168575,2,35646,8913,1,112545400,112545400,13366,4455,8911,4455,0,1,4457,93293,0.093293
4855,55,3065,168575,2,38846,9713,1,122529400,122529400,14566,4855,9711,4855,0,1,4857,107219,0.107219
5255,55,3065,168575,2,42046,10513,1,132513400,132513400,15766,5255,10511,5255,0,1,5257,214673,0.214673
5655,55,3065,168575,2,45246,11313,1,142497400,142497400,16966,5655,11311,5655,0,1,5657,247944,0.247944
6055,55,3065,168575,2,48446,12113,1,152481400,152481400,18166,6055,12111,6055,0,1,6057,149377,0.149377
6455,55,3065,168575,2,51646,12913,1,162465400,162465400,19366,6455,12911,6455,0,1,6457,66711,0.066711
6855,55,3065,168575,2,54846,13713,1,172449400,172449400,20566,6855,13711,6855,0,1,6857,279703,0.279703
40,4300,40,172000,2,326,83,1,2764800,2764800,121,40,81,40,0,1,42,23315,0.023315
440,4300,40,172000,2,3526,883,1,16652800,16652800,1321,440,881,440,0,1,442,22177,0.022177
840,4300,40,172000,2,6726,1683,1,30540800,30540800,2521,840,1681,840,0,1,842,43665,0.043665
1240,4300,40,172000,2,9926,2483,1,44428800,44428800,3721,1240,2481,1240,0,1,1242,59836,0.059836
1640,4300,40,172000,2,13126,3283,1,58316800,58316800,4921,1640,3281,1640,0,1,1642,73460,0.07346
2040,4300,40,172000,2,16326,4083,1,72204800,72204800,6121,2040,4081,2040,0,1,2042,93504,0.093504
2440,4300,40,172000,2,19526,4883,1,86092800,86092800,7321,2440,4881,2440,0,1,2442,113958,0.113958
2840,4300,40,172000,2,22726,5683,1,99980800,99980800,8521,2840,5681,2840,0,1,2842,129841,0.129841
3240,4300,40,172000,2,25926,6483,1,113868800,113868800,9721,3240,6481,3240,0,1,3242,138789,0.138789
3640,4300,40,172000,2,29126,7283,1,127756800,127756800,10921,3640,7281,3640,0,1,3642,157735,0.157735
4040,4300,40,172000,2,32326,8083,1,141644800,141644800,12121,4040,8081,4040,0,1,4042,188757,0.188757
4440,4300,40,172000,2,35526,8883,1,155532800,155532800,13321,4440,8881,4440,0,1,4442,203282,0.203282
4840,4300,40,172000,2,38726,9683,1,169420800,169420800,14521,4840,9681,4840,0,1,4842,206070,0.20607
5240,4300,40,172000,2,41926,10483,1,183308800,183308800,15721,5240,10481,5240,0,1,5242,225068,0.225068
5640,4300,40,172000,2,45126,11283,1,197196800,197196800,16921,5640,11281,5640,0,1,5642,259293,0.259293
6040,4300,40,172000,2,48326,12083,1,211084800,211084800,18121,6040,12081,6040,0,1,6042,279012,0.279012
6440,4300,40,172000,2,51526,12883,1,224972800,224972800,19321,6440,12881,6440,0,1,6442,299726,0.299726
6840,4300,40,172000,2,54726,13683,1,238860800,238860800,20521,6840,13681,6840,0,1,6842,312111,0.312111
39,43,4041,173763,2,318,81,1,2664312,2664312,118,39,79,39,0,1,41,281,0.000281
539,43,4041,173763,2,4318,1081,1,19000312,19000312,1618,539,1079,539,0,1,541,15182,0.015182
1039,43,4041,173763,2,8318,2081,1,35336312,35336312,3118,1039,2079,1039,0,1,1041,26493,0.026493
1539,43,4041,173763,2,12318,3081,1,51672312,51672312,4618,1539,3079,1539,0,1,1541,8756,0.008756
2039,43,4041,173763,2,16318,4081,1,68008312,68008312,6118,2039,4079,2039,0,1,2041,5911,0.005911
2539,43,4041,173763,2,20318,5081,1,84344312,84344312,7618,2539,5079,2539,0,1,2541,117303,0.117303
3039,43,4041,173763,2,24318,6081,1,100680312,100680312,9118,3039,6079,3039,0,1,3041,12866,0.012866
3539,43,4041,173763,2,28318,7081,1,117016312,117016312,10618,3539,7079,3539,0,1,3541,128825,0.128825
4039,43,4041,173763,2,32318,8081,1,133352312,133352312,12118,4039,8079,4039,0,1,4041,35907,0.035907
4539,43,4041,173763,2,36318,9081,1,149688312,149688312,13618,4539,9079,4539,0,1,4541,201772,0.201772
5039,43,4041,173763,2,40318,10081,1,166024312,166024312,15118,5039,10079,5039,0,1,5041,117115,0.117115
5539,43,4041,173763,2,44318,11081,1,182360312,182360312,16618,5539,11079,5539,0,1,5541,243860,0.24386
6039,43,4041,173763,2,48318,12081,1,198696312,198696312,18118,6039,12079,6039,0,1,6041,147837,0.147837
6539,43,4041,173763,2,52318,13081,1,215032312,215032312,19618,6539,13079,6539,0,1,6541,156130,0.15613
7039,43,4041,173763,2,56318,14081,1,231368312,231368312,21118,7039,14079,7039,0,1,7041,310648,0.310648
35,40,4545,181800,2,286,73,1,2738200,2738200,106,35,71,35,0,1,37,7575,0.007575
535,40,4545,181800,2,4286,1073,1,21078200,21078200,1606,535,1071,535,0,1,537,36456,0.036456
1035,40,4545,181800,2,8286,2073,1,39418200,39418200,3106,1035,2071,1035,0,1,1037,47313,0.047313
1535,40,4545,181800,2,12286,3073,1,57758200,57758200,4606,1535,3071,1535,0,1,1537,73556,0.073556
2035,40,4545,181800,2,16286,4073,1,76098200,76098200,6106,2035,4071,2035,0,1,2037,12745,0.012745
2535,40,4545,181800,2,20286,5073,1,94438200,94438200,7606,2535,5071,2535,0,1,2537,76193,0.076193
3035,40,4545,181800,2,24286,6073,1,112778200,112778200,9106,3035,6071,3035,0,1,3037,142046,0.142046
3535,40,4545,181800,2,28286,7073,1,131118200,131118200,10606,3535,7071,3535,0,1,3537,124078,0.124078
4035,40,4545,181800,2,32286,8073,1,149458200,149458200,12106,4035,8071,4035,0,1,4037,183207,0.183207
4535,40,4545,181800,2,36286,9073,1,167798200,167798200,13606,4535,9071,4535,0,1,4537,205908,0.205908
5035,40,4545,181800,2,40286,10073,1,186138200,186138200,15106,5035,10071,5035,0,1,5037,69867,0.069867
5535,40,4545,181800,2,44286,11073,1,204478200,204478200,16606,5535,11071,5535,0,1,5537,151373,0.151373
6035,40,4545,181800,2,48286,12073,1,222818200,222818200,18106,6035,12071,6035,0,1,6037,273335,0.273335
6535,40,4545,181800,2,52286,13073,1,241158200,241158200,19606,6535,13071,6535,0,1,6537,294510,0.29451
7035,40,4545,181800,2,56286,14073,1,259498200,259498200,21106,7035,14071,7035,0,1,7037,22444,0.022444
40,50,3640,182000,2,326,83,1,2636800,2636800,121,40,81,40,0,1,42,3072,0.003072
440,50,3640,182000,2,3526,883,1,14444800,14444800,1321,440,881,440,0,1,442,11513,0.011513
840,50,3640,182000,2,6726,1683,1,26252800,26252800,2521,840,1681,840,0,1,842,1732,0.001732
1240,50,3640,182000,2,9926,2483,1,38060800,38060800,3721,1240,2481,1240,0,1,1242,6284,0.006284
1640,50,3640,182000,2,13126,3283,1,49868800,49868800,4921,1640,3281,1640,0,1,1642,33058,0.033058
2040,50,3640,182000,2,16326,4083,1,61676800,61676800,6121,2040,4081,2040,0,1,2042,11707,0.011707
2440,50,3640,182000,2,19526,4883,1,73484800,73484800,7321,2440,4881,2440,0,1,2442,25404,0.025404
2840,50,3640,182000,2,22726,5683,1,85292800,85292800,8521,2840,5681,2840,0,1,2842,124894,0.124894
3240,50,3640,182000,2,25926,6483,1,97100800,97100800,9721,3240,6481,3240,0,1,3242,141125,0.141125
3640,50,3640,182000,2,29126,7283,1,108908800,108908800,10921,3640,7281,3640,0,1,3642,173077,0.173077
4040,50,3640,182000,2,32326,8083,1,120716800,120716800,12121,4040,8081,4040,0,1,4042,179752,0.179752
4440,50,3640,182000,2,35526,8883,1,132524800,132524800,13321,4440,8881,4440,0,1,4442,191722,0.191722
4840,50,3640,182000,2,38726,9683,1,144332800,144332800,14521,4840,9681,4840,0,1,4842,99734,0.099734
5240,50,3640,182000,2,41926,10483,1,156140800,156140800,15721,5240,10481,5240,0,1,5242,216255,0.216255
5640,50,3640,182000,2,45126,11283,1,167948800,167948800,16921,5640,11281,5640,0,1,5642,244016,0.244016
6040,50,3640,182000,2,48326,12083,1,179756800,179756800,18121,6040,12081,6040,0,1,6042,19059,0.019059
6440,50,3640,182000,2,51526,12883,1,191564800,191564800,19321,6440,12881,6440,0,1,6442,92595,0.092595
6840,50,3640,182000,2,54726,13683,1,203372800,203372800,20521,6840,13681,6840,0,1,6842,103851,0.103851
40,4550,40,182000,2,326,83,1,2924800,2924800,121,40,81,40,0,1,42,24621,0.024621
440,4550,40,182000,2,3526,883,1,17612800,17612800,1321,440,881,440,0,1,442,24364,0.024364
840,4550,40,182000,2,6726,1683,1,32300800,32300800,2521,840,1681,840,0,1,842,42640,0.04264
1240,4550,40,182000,2,9926,2483,1,46988800,46988800,3721,1240,2481,1240,0,1,1242,62133,0.062133
1640,4550,40,182000,2,13126,3283,1,61676800,61676800,4921,1640,3281,1640,0,1,1642,73149,0.073149
2040,4550,40,182000,2,16326,4083,1,76364800,76364800,6121,2040,4081,2040,0,1,2042,90429,0.090429
2440,4550,40,182000,2,19526,4883,1,91052800,91052800,7321,2440,4881,2440,0,1,2442,108147,0.108147
2840,4550,40,182000,2,22726,5683,1,105740800,105740800,8521,2840,5681,2840,0,1,2842,124748,0.124748
3240,4550,40,182000,2,25926,6483,1,120428800,120428800,9721,3240,6481,3240,0,1,3242,157220,0.15722
3640,4550,40,182000,2,29126,7283,1,135116800,135116800,10921,3640,7281,3640,0,1,3642,160365,0.160365
4040,4550,40,182000,2,32326,8083,1,149804800,149804800,12121,4040,8081,4040,0,1,4042,192186,0.192186
4440,4550,40,182000,2,35526,8883,1,164492800,164492800,13321,4440,8881,4440,0,1,4442,192307,0.192307
4840,4550,40,182000,2,38726,9683,1,179180800,179180800,14521,4840,9681,4840,0,1,4842,233520,0.23352
5240,4550,40,182000,2,41926,10483,1,193868800,193868800,15721,5240,10481,5240,0,1,5242,245362,0.245362
5640,4550,40,182000,2,45126,11283,1,208556800,208556800,16921,5640,11281,5640,0,1,5642,264121,0.264121
6040,4550,40,182000,2,48326,12083,1,223244800,223244800,18121,6040,12081,6040,0,1,6042,289306,0.289306
6440,4550,40,182000,2,51526,12883,1,237932800,237932800,19321,6440,12881,6440,0,1,6442,287038,0.287038
6840,4550,40,182000,2,54726,13683,1,252620800,252620800,20521,6840,13681,6840,0,1,6842,330106,0.330106
39,4443,41,182163,2,318,81,1,2856312,2856312,118,39,79,39,0,1,41,159,0.000159
539,4443,41,182163,2,4318,1081,1,20792312,20792312,1618,539,1079,539,0,1,541,28417,0.028417
1039,4443,41,182163,2,8318,2081,1,38728312,38728312,3118,1039,2079,1039,0,1,1041,47668,0.047668
1539,4443,41,182163,2,12318,3081,1,56664312,56664312,4618,1539,3079,1539,0,1,1541,69074,0.069074
2039,4443,41,182163,2,16318,4081,1,74600312,74600312,6118,2039,4079,2039,0,1,2041,32592,0.032592
2539,4443,41,182163,2,20318,5081,1,92536312,92536312,7618,2539,5079,2539,0,1,2541,120954,0.120954
3039,4443,41,182163,2,24318,6081,1,110472312,110472312,9118,3039,6079,3039,0,1,3041,133166,0.133166
3539,4443,41,182163,2,28318,7081,1,128408312,128408312,10618,3539,7079,3539,0,1,3541,165412,0.165412
4039,4443,41,182163,2,32318,8081,1,146344312,146344312,12118,4039,8079,4039,0,1,4041,179718,0.179718
4539,4443,41,182163,2,36318,9081,1,164280312,164280312,13618,4539,9079,4539,0,1,4541,220933,0.220933
5039,4443,41,182163,2,40318,10081,1,182216312,182216312,15118,5039,10079,5039,0,1,5041,236284,0.236284
5539,4443,41,182163,2,44318,11081,1,200152312,200152312,16618,5539,11079,5539,0,1,5541,249170,0.24917
6039,4443,41,182163,2,48318,12081,1,218088312,218088312,18118,6039,12079,6039,0,1,6041,270470,0.27047
6539,4443,41,182163,2,52318,13081,1,236024312,236024312,19618,6539,13079,6539,0,1,6541,312406,0.312406
7039,4443,41,182163,2,56318,14081,1,253960312,253960312,21118,7039,14079,7039,0,1,7041,327374,0.327374
55,2805,65,182325,2,446,113,1,2721400,2721400,166,55,111,55,0,1,57,17063,0.017063
455,2805,65,182325,2,3646,913,1,11905400,11905400,1366,455,911,455,0,1,457,20865,0.020865
855,2805,65,182325,2,6846,1713,1,21089400,21089400,2566,855,1711,855,0,1,857,36240,0.03624
1255,2805,65,182325,2,10046,2513,1,30273400,30273400,3766,1255,2511,1255,0,1,1257,52027,0.052027
1655,2805,65,182325,2,13246,3313,1,39457400,39457400,4966,1655,3311,1655,0,1,1657,68053,0.068053
2055,2805,65,182325,2,16446,4113,1,48641400,48641400,6166,2055,4111,2055,0,1,2057,83854,0.083854
2455,2805,65,182325,2,19646,4913,1,57825400,57825400,7366,2455,4911,2455,0,1,2457,98893,0.098893
2855,2805,65,182325,2,22846,5713,1,67009400,67009400,8566,2855,5711,2855,0,1,2857,113946,0.113946
3255,2805,65,182325,2,26046,6513,1,76193400,76193400,9766,3255,6511,3255,0,1,3257,130452,0.130452
3655,2805,65,182325,2,29246,7313,1,85377400,85377400,10966,3655,7311,3655,0,1,3657,146382,0.146382
4055,2805,65,182325,2,32446,8113,1,94561400,94561400,12166,4055,8111,4055,0,1,4057,161595,0.161595
4455,2805,65,182325,2,35646,8913,1,103745400,103745400,13366,4455,8911,4455,0,1,4457,178303,0.178303
4855,2805,65,182325,2,38846,9713,1,112929400,112929400,14566,4855,9711,4855,0,1,4857,205389,0.205389
5255,2805,65,182325,2,42046,10513,1,122113400,122113400,15766,5255,10511,5255,0,1,5257,213572,0.213572
5655,2805,65,182325,2,45246,11313,1,131297400,131297400,16966,5655,11311,5655,0,1,5657,228333,0.228333
6055,2805,65,182325,2,48446,12113,1,140481400,140481400,18166,6055,12111,6055,0,1,6057,255410,0.25541
6455,2805,65,182325,2,51646,12913,1,149665400,149665400,19366,6455,12911,6455,0,1,6457,263780,0.26378
6855,2805,65,182325,2,54846,13713,1,158849400,158849400,20566,6855,13711,6855,0,1,6857,277351,0.277351
44,3353,55,184415,2,358,91,1,2674936,2674936,133,44,89,44,0,1,46,3256,0.003256
544,3353,55,184415,2,4358,1091,1,16306936,16306936,1633,544,1089,544,0,1,546,26117,0.026117
1044,3353,55,184415,2,8358,2091,1,29938936,29938936,3133,1044,2089,1044,0,1,1046,47270,0.04727
1544,3353,55,184415,2,12358,3091,1,43570936,43570936,4633,1544,3089,1544,0,1,1546,68465,0.068465
2044,3353,55,184415,2,16358,4091,1,57202936,57202936,6133,2044,4089,2044,0,1,2046,38706,0.038706
2544,3353,55,184415,2,20358,5091,1,70834936,70834936,7633,2544,5089,2544,0,1,2546,110918,0.110918
3044,3353,55,184415,2,24358,6091,1,84466936,84466936,9133,3044,6089,3044,0,1,3046,140037,0.140037
3544,3353,55,184415,2,28358,7091,1,98098936,98098936,10633,3544,7089,3544,0,1,3546,157847,0.157847
4044,3353,55,184415,2,32358,8091,1,111730936,111730936,12133,4044,8089,4044,0,1,4046,172054,0.172054
4544,3353,55,184415,2,36358,9091,1,125362936,125362936,13633,4544,9089,4544,0,1,4546,188584,0.188584
5044,3353,55,184415,2,40358,10091,1,138994936,138994936,15133,5044,10089,5044,0,1,5046,228964,0.228964
5544,3353,55,184415,2,44358,11091,1,152626936,152626936,16633,5544,11089,5544,0,1,5546,233538,0.233538
6044,3353,55,184415,2,48358,12091,1,166258936,166258936,18133,6044,12089,6044,0,1,6046,255760,0.25576
6544,3353,55,184415,2,52358,13091,1,179890936,179890936,19633,6544,13089,6544,0,1,6546,281070,0.28107
7044,3353,55,184415,2,56358,14091,1,193522936,193522936,21133,7044,14089,7044,0,1,7046,301491,0.301491
55,55,3365,185075,2,446,113,1,2985400,2985400,166,55,111,55,0,1,57,891,0.000891
455,55,3365,185075,2,3646,913,1,13929400,13929400,1366,455,911,455,0,1,457,30092,0.030092
855,55,3365,185075,2,6846,1713,1,24873400,24873400,2566,855,1711,855,0,1,857,42845,0.042845
1255,55,3365,185075,2,10046,2513,1,35817400,35817400,3766,1255,2511,1255,0,1,1257,43400,0.0434
1655,55,3365,185075,2,13246,3313,1,46761400,46761400,4966,1655,3311,1655,0,1,1657,66519,0.066519
2055,55,3365,185075,2,16446,4113,1,57705400,57705400,6166,2055,4111,2055,0,1,2057,36342,0.036342
2455,55,3365,185075,2,19646,4913,1,68649400,68649400,7366,2455,4911,2455,0,1,2457,15318,0.015318
2855,55,3365,185075,2,22846,5713,1,79593400,79593400,8566,2855,5711,2855,0,1,2857,7990,0.00799
3255,55,3365,185075,2,26046,6513,1,90537400,90537400,9766,3255,6511,3255,0,1,3257,143710,0.14371
3655,55,3365,185075,2,29246,7313,1,101481400,101481400,10966,3655,7311,3655,0,1,3657,160802,0.160802
4055,55,3365,185075,2,32446,8113,1,112425400,112425400,12166,4055,8111,4055,0,1,4057,60857,0.060857
4455,55,3365,185075,2,35646,8913,1,123369400,123369400,13366,4455,8911,4455,0,1,4457,195008,0.195008
4855,55,3365,185075,2,38846,9713,1,134313400,134313400,14566,4855,9711,4855,0,1,4857,212514,0.212514
5255,55,3365,185075,2,42046,10513,1,145257400,145257400,15766,5255,10511,5255,0,1,5257,31340,0.03134
5655,55,3365,185075,2,45246,11313,1,156201400,156201400,16966,5655,11311,5655,0,1,5657,248729,0.248729
6055,55,3365,185075,2,48446,12113,1,167145400,167145400,18166,6055,12111,6055,0,1,6057,138601,0.138601
6455,55,3365,185075,2,51646,12913,1,178089400,178089400,19366,6455,12911,6455,0,1,6457,282728,0.282728
6855,55,3365,185075,2,54846,13713,1,189033400,189033400,20566,6855,13711,6855,0,1,6857,118218,0.118218
40,550,340,187000,2,326,83,1,1780800,1780800,121,40,81,40,0,1,42,4824,0.004824
440,550,340,187000,2,3526,883,1,4628800,4628800,1321,440,881,440,0,1,442,19667,0.019667
840,550,340,187000,2,6726,1683,1,7476800,7476800,2521,840,1681,840,0,1,842,34594,0.034594
1240,550,340,187000,2,9926,2483,1,10324800,10324800,3721,1240,2481,1240,0,1,1242,7195,0.007195
1640,550,340,187000,2,13126,3283,1,13172800,13172800,4921,1640,3281,1640,0,1,1642,65267,0.065267
2040,550,340,187000,2,16326,4083,1,16020800,16020800,6121,2040,4081,2040,0,1,2042,78638,0.078638
2440,550,340,187000,2,19526,4883,1,18868800,18868800,7321,2440,4881,2440,0,1,2442,94401,0.094401
2840,550,340,187000,2,22726,5683,1,21716800,21716800,8521,2840,5681,2840,0,1,2842,109485,0.109485
3240,550,340,187000,2,25926,6483,1,24564800,24564800,9721,3240,6481,3240,0,1,3242,125919,0.125919
3640,550,340,187000,2,29126,7283,1,27412800,27412800,10921,3640,7281,3640,0,1,3642,138948,0.138948
4040,550,340,187000,2,32326,8083,1,30260800,30260800,12121,4040,8081,4040,0,1,4042,153268,0.153268
4440,550,340,187000,2,35526,8883,1,33108800,33108800,13321,4440,8881,4440,0,1,4442,168647,0.168647
4840,550,340,187000,2,38726,9683,1,35956800,35956800,14521,4840,9681,4840,0,1,4842,184689,0.184689
5240,550,340,187000,2,41926,10483,1,38804800,38804800,15721,5240,10481,5240,0,1,5242,200525,0.200525
5640,550,340,187000,2,45126,11283,1,41652800,41652800,16921,5640,11281,5640,0,1,5642,214655,0.214655
6040,550,340,187000,2,48326,12083,1,44500800,44500800,18121,6040,12081,6040,0,1,6042,149342,0.149342
6440,550,340,187000,2,51526,12883,1,47348800,47348800,19321,6440,12881,6440,0,1,6442,13602,0.013602
6840,550,340,187000,2,54726,13683,1,50196800,50196800,20521,6840,13681,6840,0,1,6842,262642,0.262642
44,53,3555,188415,2,358,91,1,2777336,2777336,133,44,89,44,0,1,46,8828,0.008828
544,53,3555,188415,2,4358,1091,1,17209336,17209336,1633,544,1089,544,0,1,546,17083,0.017083
1044,53,3555,188415,2,8358,2091,1,31641336,31641336,3133,1044,2089,1044,0,1,1046,33485,0.033485
1544,53,3555,188415,2,12358,3091,1,46073336,46073336,4633,1544,3089,1544,0,1,1546,49091,0.049091
2044,53,3555,188415,2,16358,4091,1,60505336,60505336,6133,2044,4089,2044,0,1,2046,12440,0.01244
2544,53,3555,188415,2,20358,5091,1,74937336,74937336,7633,2544,5089,2544,0,1,2546,119563,0.119563
3044,53,3555,188415,2,24358,6091,1,89369336,89369336,9133,3044,6089,3044,0,1,3046,7514,0.007514
3544,53,3555,188415,2,28358,7091,1,103801336,103801336,10633,3544,7089,3544,0,1,3546,11448,0.011448
4044,53,3555,188415,2,32358,8091,1,118233336,118233336,12133,4044,8089,4044,0,1,4046,50626,0.050626
4544,53,3555,188415,2,36358,9091,1,132665336,132665336,13633,4544,9089,4544,0,1,4546,207519,0.207519
5044,53,3555,188415,2,40358,10091,1,147097336,147097336,15133,5044,10089,5044,0,1,5046,174891,0.174891
5544,53,3555,188415,2,44358,11091,1,161529336,161529336,16633,5544,11089,5544,0,1,5546,68742,0.068742
6044,53,3555,188415,2,48358,12091,1,175961336,175961336,18133,6044,12089,6044,0,1,6046,267244,0.267244
6544,53,3555,188415,2,52358,13091,1,190393336,190393336,19633,6544,13089,6544,0,1,6546,302895,0.302895
7044,53,3555,188415,2,56358,14091,1,204825336,204825336,21133,7044,14089,7044,0,1,7046,16956,0.016956
40,300,640,192000,2,326,83,1,1836800,1836800,121,40,81,40,0,1,42,4782,0.004782
440,300,640,192000,2,3526,883,1,4844800,4844800,1321,440,881,440,0,1,442,19940,0.01994
840,300,640,192000,2,6726,1683,1,7852800,7852800,2521,840,1681,840,0,1,842,35490,0.03549
1240,300,640,192000,2,9926,2483,1,10860800,10860800,3721,1240,2481,1240,0,1,1242,50418,0.050418
1640,300,640,192000,2,13126,3283,1,13868800,13868800,4921,1640,3281,1640,0,1,1642,65834,0.065834
2040,300,640,192000,2,16326,4083,1,16876800,16876800,6121,2040,4081,2040,0,1,2042,81303,0.081303
2440,300,640,192000,2,19526,4883,1,19884800,19884800,7321,2440,4881,2440,0,1,2442,96773,0.096773
2840,300,640,192000,2,22726,5683,1,22892800,22892800,8521,2840,5681,2840,0,1,2842,110249,0.110249
3240,300,640,192000,2,25926,6483,1,25900800,25900800,9721,3240,6481,3240,0,1,3242,125897,0.125897
3640,300,640,192000,2,29126,7283,1,28908800,28908800,10921,3640,7281,3640,0,1,3642,73157,0.073157
4040,300,640,192000,2,32326,8083,1,31916800,31916800,12121,4040,8081,4040,0,1,4042,134272,0.134272
4440,300,640,192000,2,35526,8883,1,34924800,34924800,13321,4440,8881,4440,0,1,4442,170803,0.170803
4840,300,640,192000,2,38726,9683,1,37932800,37932800,14521,4840,9681,4840,0,1,4842,43207,0.043207
5240,300,640,192000,2,41926,10483,1,40940800,40940800,15721,5240,10481,5240,0,1,5242,93461,0.093461
5640,300,640,192000,2,45126,11283,1,43948800,43948800,16921,5640,11281,5640,0,1,5642,5988,0.005988
6040,300,640,192000,2,48326,12083,1,46956800,46956800,18121,6040,12081,6040,0,1,6042,59877,0.059877
6440,300,640,192000,2,51526,12883,1,49964800,49964800,19321,6440,12881,6440,0,1,6442,251470,0.25147
6840,300,640,192000,2,54726,13683,1,52972800,52972800,20521,6840,13681,6840,0,1,6842,77158,0.077158
40,4800,40,192000,2,326,83,1,3084800,3084800,121,40,81,40,0,1,42,28525,0.028525
440,4800,40,192000,2,3526,883,1,18572800,18572800,1321,440,881,440,0,1,442,25470,0.02547
840,4800,40,192000,2,6726,1683,1,34060800,34060800,2521,840,1681,840,0,1,842,44754,0.044754
1240,4800,40,192000,2,9926,2483,1,49548800,49548800,3721,1240,2481,1240,0,1,1242,64780,0.06478
1640,4800,40,192000,2,13126,3283,1,65036800,65036800,4921,1640,3281,1640,0,1,1642,88262,0.088262
2040,4800,40,192000,2,16326,4083,1,80524800,80524800,6121,2040,4081,2040,0,1,2042,102809,0.102809
2440,4800,40,192000,2,19526,4883,1,96012800,96012800,7321,2440,4881,2440,0,1,2442,18961,0.018961
2840,4800,40,192000,2,22726,5683,1,111500800,111500800,8521,2840,5681,2840,0,1,2842,141127,0.141127
3240,4800,40,192000,2,25926,6483,1,126988800,126988800,9721,3240,6481,3240,0,1,3242,161152,0.161152
3640,4800,40,192000,2,29126,7283,1,142476800,142476800,10921,3640,7281,3640,0,1,3642,183917,0.183917
4040,4800,40,192000,2,32326,8083,1,157964800,157964800,12121,4040,8081,4040,0,1,4042,59620,0.05962
4440,4800,40,192000,2,35526,8883,1,173452800,173452800,13321,4440,8881,4440,0,1,4442,229421,0.229421
4840,4800,40,192000,2,38726,9683,1,188940800,188940800,14521,4840,9681,4840,0,1,4842,249290,0.24929
5240,4800,40,192000,2,41926,10483,1,204428800,204428800,15721,5240,10481,5240,0,1,5242,259564,0.259564
5640,4800,40,192000,2,45126,11283,1,219916800,219916800,16921,5640,11281,5640,0,1,5642,265550,0.26555
6040,4800,40,192000,2,48326,12083,1,235404800,235404800,18121,6040,12081,6040,0,1,6042,289745,0.289745
6440,4800,40,192000,2,51526,12883,1,250892800,250892800,19321,6440,12881,6440,0,1,6442,307430,0.30743
6840,4800,40,192000,2,54726,13683,1,266380800,266380800,20521,6840,13681,6840,0,1,6842,363696,0.363696
39,43,4541,195263,2,318,81,1,2992312,2992312,118,39,79,39,0,1,41,7392,0.007392
539,43,4541,195263,2,4318,1081,1,21328312,21328312,1618,539,1079,539,0,1,541,38606,0.038606
1039,43,4541,195263,2,8318,2081,1,39664312,39664312,3118,1039,2079,1039,0,1,1041,11247,0.011247
1539,43,4541,195263,2,12318,3081,1,58000312,58000312,4618,1539,3079,1539,0,1,1541,39511,0.039511
2039,43,4541,195263,2,16318,4081,1,76336312,76336312,6118,2039,4079,2039,0,1,2041,69733,0.069733
2539,43,4541,195263,2,20318,5081,1,94672312,94672312,7618,2539,5079,2539,0,1,2541,27689,0.027689
3039,43,4541,195263,2,24318,6081,1,113008312,113008312,9118,3039,6079,3039,0,1,3041,71826,0.071826
3539,43,4541,195263,2,28318,7081,1,131344312,131344312,10618,3539,7079,3539,0,1,3541,117276,0.117276
4039,43,4541,195263,2,32318,8081,1,149680312,149680312,12118,4039,8079,4039,0,1,4041,29752,0.029752
4539,43,4541,195263,2,36318,9081,1,168016312,168016312,13618,4539,9079,4539,0,1,4541,230550,0.23055
5039,43,4541,195263,2,40318,10081,1,186352312,186352312,15118,5039,10079,5039,0,1,5041,52875,0.052875
5539,43,4541,195263,2,44318,11081,1,204688312,204688312,16618,5539,11079,5539,0,1,5541,244973,0.244973
6039,43,4541,195263,2,48318,12081,1,223024312,223024312,18118,6039,12079,6039,0,1,6041,297754,0.297754
6539,43,4541,195263,2,52318,13081,1,241360312,241360312,19618,6539,13079,6539,0,1,6541,19939,0.019939
7039,43,4541,195263,2,56318,14081,1,259696312,259696312,21118,7039,14079,7039,0,1,7041,90362,0.090362
40,50,3940,197000,2,326,83,1,2852800,2852800,121,40,81,40,0,1,42,2772,0.002772
440,50,3940,197000,2,3526,883,1,15620800,15620800,1321,440,881,440,0,1,442,34001,0.034001
840,50,3940,197000,2,6726,1683,1,28388800,28388800,2521,840,1681,840,0,1,842,5272,0.005272
1240,50,3940,197000,2,9926,2483,1,41156800,41156800,3721,1240,2481,1240,0,1,1242,21554,0.021554
1640,50,3940,197000,2,13126,3283,1,53924800,53924800,4921,1640,3281,1640,0,1,1642,33056,0.033056
2040,50,3940,197000,2,16326,4083,1,66692800,66692800,6121,2040,4081,2040,0,1,2042,19683,0.019683
2440,50,3940,197000,2,19526,4883,1,79460800,79460800,7321,2440,4881,2440,0,1,2442,118663,0.118663
2840,50,3940,197000,2,22726,5683,1,92228800,92228800,8521,2840,5681,2840,0,1,2842,18064,0.018064
3240,50,3940,197000,2,25926,6483,1,104996800,104996800,9721,3240,6481,3240,0,1,3242,83788,0.083788
3640,50,3940,197000,2,29126,7283,1,117764800,117764800,10921,3640,7281,3640,0,1,3642,96242,0.096242
4040,50,3940,197000,2,32326,8083,1,130532800,130532800,12121,4040,8081,4040,0,1,4042,198282,0.198282
4440,50,3940,197000,2,35526,8883,1,143300800,143300800,13321,4440,8881,4440,0,1,4442,11930,0.01193
4840,50,3940,197000,2,38726,9683,1,156068800,156068800,14521,4840,9681,4840,0,1,4842,206011,0.206011
5240,50,3940,197000,2,41926,10483,1,168836800,168836800,15721,5240,10481,5240,0,1,5242,194644,0.194644
5640,50,3940,197000,2,45126,11283,1,181604800,181604800,16921,5640,11281,5640,0,1,5642,27834,0.027834
6040,50,3940,197000,2,48326,12083,1,194372800,194372800,18121,6040,12081,6040,0,1,6042,183191,0.183191
6440,50,3940,197000,2,51526,12883,1,207140800,207140800,19321,6440,12881,6440,0,1,6442,231244,0.231244
6840,50,3940,197000,2,54726,13683,1,219908800,219908800,20521,6840,13681,6840,0,1,6842,340107,0.340107
35,4400,45,198000,2,286,73,1,2828600,2828600,106,35,71,35,0,1,37,15579,0.015579
535,4400,45,198000,2,4286,1073,1,20608600,20608600,1606,535,1071,535,0,1,537,30790,0.03079
1035,4400,45,198000,2,8286,2073,1,38388600,38388600,3106,1035,2071,1035,0,1,1037,54419,0.054419
1535,4400,45,198000,2,12286,3073,1,56168600,56168600,4606,1535,3071,1535,0,1,1537,80596,0.080596
2035,4400,45,198000,2,16286,4073,1,73948600,73948600,6106,2035,4071,2035,0,1,2037,103353,0.103353
2535,4400,45,198000,2,20286,5073,1,91728600,91728600,7606,2535,5071,2535,0,1,2537,134244,0.134244
3035,4400,45,198000,2,24286,6073,1,109508600,109508600,9106,3035,6071,3035,0,1,3037,146847,0.146847
3535,4400,45,198000,2,28286,7073,1,127288600,127288600,10606,3535,7071,3535,0,1,3537,176087,0.176087
4035,4400,45,198000,2,32286,8073,1,145068600,145068600,12106,4035,8071,4035,0,1,4037,193436,0.193436
4535,4400,45,198000,2,36286,9073,1,162848600,162848600,13606,4535,9071,4535,0,1,4537,217797,0.217797
5035,4400,45,198000,2,40286,10073,1,180628600,180628600,15106,5035,10071,5035,0,1,5037,250962,0.250962
5535,4400,45,198000,2,44286,11073,1,198408600,198408600,16606,5535,11071,5535,0,1,5537,287642,0.287642
6035,4400,45,198000,2,48286,12073,1,216188600,216188600,18106,6035,12071,6035,0,1,6037,305872,0.305872
6535,4400,45,198000,2,52286,13073,1,233968600,233968600,19606,6535,13071,6535,0,1,6537,62615,0.062615
7035,4400,45,198000,2,56286,14073,1,251748600,251748600,21106,7035,14071,7035,0,1,7037,359069,0.359069
55,3055,65,198575,2,446,113,1,2961400,2961400,166,55,111,55,0,1,57,1203,0.001203
455,3055,65,198575,2,3646,913,1,12945400,12945400,1366,455,911,455,0,1,457,8520,0.00852
855,3055,65,198575,2,6846,1713,1,22929400,22929400,2566,855,1711,855,0,1,857,22574,0.022574
1255,3055,65,198575,2,10046,2513,1,32913400,32913400,3766,1255,2511,1255,0,1,1257,3781,0.003781
1655,3055,65,198575,2,13246,3313,1,42897400,42897400,4966,1655,3311,1655,0,1,1657,81315,0.081315
2055,3055,65,198575,2,16446,4113,1,52881400,52881400,6166,2055,4111,2055,0,1,2057,94252,0.094252
2455,3055,65,198575,2,19646,4913,1,62865400,62865400,7366,2455,4911,2455,0,1,2457,114697,0.114697
2855,3055,65,198575,2,22846,5713,1,72849400,72849400,8566,2855,5711,2855,0,1,2857,98533,0.098533
3255,3055,65,198575,2,26046,6513,1,82833400,82833400,9766,3255,6511,3255,0,1,3257,145616,0.145616
3655,3055,65,198575,2,29246,7313,1,92817400,92817400,10966,3655,7311,3655,0,1,3657,100046,0.100046
4055,3055,65,198575,2,32446,8113,1,102801400,102801400,12166,4055,8111,4055,0,1,4057,186971,0.186971
4455,3055,65,198575,2,35646,8913,1,112785400,112785400,13366,4455,8911,4455,0,1,4457,202912,0.202912
4855,3055,65,198575,2,38846,9713,1,122769400,122769400,14566,4855,9711,4855,0,1,4857,76658,0.076658
5255,3055,65,198575,2,42046,10513,1,132753400,132753400,15766,5255,10511,5255,0,1,5257,239554,0.239554
5655,3055,65,198575,2,45246,11313,1,142737400,142737400,16966,5655,11311,5655,0,1,5657,256058,0.256058
6055,3055,65,198575,2,48446,12113,1,152721400,152721400,18166,6055,12111,6055,0,1,6057,273610,0.27361
6455,3055,65,198575,2,51646,12913,1,162705400,162705400,19366,6455,12911,6455,0,1,6457,294077,0.294077
6855,3055,65,198575,2,54846,13713,1,172689400,172689400,20566,6855,13711,6855,0,1,6857,46806,0.046806
35,4440,45,199800,2,286,73,1,2854200,2854200,106,35,71,35,0,1,37,14656,0.014656
535,4440,45,199800,2,4286,1073,1,20794200,20794200,1606,535,1071,535,0,1,537,29228,0.029228
1035,4440,45,199800,2,8286,2073,1,38734200,38734200,3106,1035,2071,1035,0,1,1037,78070,0.07807
1535,4440,45,199800,2,12286,3073,1,56674200,56674200,4606,1535,3071,1535,0,1,1537,78927,0.078927
2035,4440,45,199800,2,16286,4073,1,74614200,74614200,6106,2035,4071,2035,0,1,2037,103363,0.103363
55,55,3665,201575,2,446,113,1,3249400,3249400,166,55,111,55,0,1,57,2148,0.002148
455,55,3665,201575,2,3646,913,1,15153400,15153400,1366,455,911,455,0,1,457,3217,0.003217
855,55,3665,201575,2,6846,1713,1,27057400,27057400,2566,855,1711,855,0,1,857,16758,0.016758
1255,55,3665,201575,2,10046,2513,1,38961400,38961400,3766,1255,2511,1255,0,1,1257,5660,0.00566
1655,55,3665,201575,2,13246,3313,1,50865400,50865400,4966,1655,3311,1655,0,1,1657,3916,0.003916
2055,55,3665,201575,2,16446,4113,1,62769400,62769400,6166,2055,4111,2055,0,1,2057,24978,0.024978
2455,55,3665,201575,2,19646,4913,1,74673400,74673400,7366,2455,4911,2455,0,1,2457,100122,0.100122
2855,55,3665,201575,2,22846,5713,1,86577400,86577400,8566,2855,5711,2855,0,1,2857,57818,0.057818
3255,55,3665,201575,2,26046,6513,1,98481400,98481400,9766,3255,6511,3255,0,1,3257,156256,0.156256
3655,55,3665,201575,2,29246,7313,1,110385400,110385400,10966,3655,7311,3655,0,1,3657,46948,0.046948
4055,55,3665,201575,2,32446,8113,1,122289400,122289400,12166,4055,8111,4055,0,1,4057,194545,0.194545
4455,55,3665,201575,2,35646,8913,1,134193400,134193400,13366,4455,8911,4455,0,1,4457,35556,0.035556
4855,55,3665,201575,2,38846,9713,1,146097400,146097400,14566,4855,9711,4855,0,1,4857,231837,0.231837
5255,55,3665,201575,2,42046,10513,1,158001400,158001400,15766,5255,10511,5255,0,1,5257,131315,0.131315
5655,55,3665,201575,2,45246,11313,1,169905400,169905400,16966,5655,11311,5655,0,1,5657,58098,0.058098
6055,55,3665,201575,2,48446,12113,1,181809400,181809400,18166,6055,12111,6055,0,1,6057,51191,0.051191
6455,55,3665,201575,2,51646,12913,1,193713400,193713400,19366,6455,12911,6455,0,1,6457,248392,0.248392
6855,55,3665,201575,2,54846,13713,1,205617400,205617400,20566,6855,13711,6855,0,1,6857,326552,0.326552
35,40,5045,201800,2,286,73,1,3038200,3038200,106,35,71,35,0,1,37,8788,0.008788
535,40,5045,201800,2,4286,1073,1,23378200,23378200,1606,535,1071,535,0,1,537,29711,0.029711
1035,40,5045,201800,2,8286,2073,1,43718200,43718200,3106,1035,2071,1035,0,1,1037,59277,0.059277
1535,40,5045,201800,2,12286,3073,1,64058200,64058200,4606,1535,3071,1535,0,1,1537,7763,0.007763
2035,40,5045,201800,2,16286,4073,1,84398200,84398200,6106,2035,4071,2035,0,1,2037,106727,0.106727
2535,40,5045,201800,2,20286,5073,1,104738200,104738200,7606,2535,5071,2535,0,1,2537,132243,0.132243
3035,40,5045,201800,2,24286,6073,1,125078200,125078200,9106,3035,6071,3035,0,1,3037,156129,0.156129
3535,40,5045,201800,2,28286,7073,1,145418200,145418200,10606,3535,7071,3535,0,1,3537,180582,0.180582
4035,40,5045,201800,2,32286,8073,1,165758200,165758200,12106,4035,8071,4035,0,1,4037,204430,0.20443
4535,40,5045,201800,2,36286,9073,1,186098200,186098200,13606,4535,9071,4535,0,1,4537,115229,0.115229
5035,40,5045,201800,2,40286,10073,1,206438200,206438200,15106,5035,10071,5035,0,1,5037,254433,0.254433
5535,40,5045,201800,2,44286,11073,1,226778200,226778200,16606,5535,11071,5535,0,1,5537,278750,0.27875
6035,40,5045,201800,2,48286,12073,1,247118200,247118200,18106,6035,12071,6035,0,1,6037,304845,0.304845
6535,40,5045,201800,2,52286,13073,1,267458200,267458200,19606,6535,13071,6535,0,1,6537,329345,0.329345
7035,40,5045,201800,2,56286,14073,1,287798200,287798200,21106,7035,14071,7035,0,1,7037,359068,0.359068
40,5050,40,202000,2,326,83,1,3244800,3244800,121,40,81,40,0,1,42,3009,0.003009
440,5050,40,202000,2,3526,883,1,19532800,19532800,1321,440,881,440,0,1,442,3798,0.003798
840,5050,40,202000,2,6726,1683,1,35820800,35820800,2521,840,1681,840,0,1,842,18291,0.018291
1240,5050,40,202000,2,9926,2483,1,52108800,52108800,3721,1240,2481,1240,0,1,1242,55262,0.055262
1640,5050,40,202000,2,13126,3283,1,68396800,68396800,4921,1640,3281,1640,0,1,1642,85984,0.085984
2040,5050,40,202000,2,16326,4083,1,84684800,84684800,6121,2040,4081,2040,0,1,2042,105387,0.105387
2440,5050,40,202000,2,19526,4883,1,100972800,100972800,7321,2440,4881,2440,0,1,2442,123714,0.123714
2840,5050,40,202000,2,22726,5683,1,117260800,117260800,8521,2840,5681,2840,0,1,2842,155245,0.155245
3240,5050,40,202000,2,25926,6483,1,133548800,133548800,9721,3240,6481,3240,0,1,3242,159531,0.159531
3640,5050,40,202000,2,29126,7283,1,149836800,149836800,10921,3640,7281,3640,0,1,3642,178772,0.178772
4040,5050,40,202000,2,32326,8083,1,166124800,166124800,12121,4040,8081,4040,0,1,4042,217677,0.217677
4440,5050,40,202000,2,35526,8883,1,182412800,182412800,13321,4440,8881,4440,0,1,4442,225311,0.225311
4840,5050,40,202000,2,38726,9683,1,198700800,198700800,14521,4840,9681,4840,0,1,4842,260675,0.260675
5240,5050,40,202000,2,41926,10483,1,214988800,214988800,15721,5240,10481,5240,0,1,5242,259648,0.259648
5640,5050,40,202000,2,45126,11283,1,231276800,231276800,16921,5640,11281,5640,0,1,5642,275459,0.275459
6040,5050,40,202000,2,48326,12083,1,247564800,247564800,18121,6040,12081,6040,0,1,6042,295569,0.295569
6440,5050,40,202000,2,51526,12883,1,263852800,263852800,19321,6440,12881,6440,0,1,6442,335858,0.335858
6840,5050,40,202000,2,54726,13683,1,280140800,280140800,20521,6840,13681,6840,0,1,6842,146450,0.14645
55,555,365,202575,2,446,113,1,2025400,2025400,166,55,111,55,0,1,57,9598,0.009598
455,555,365,202575,2,3646,913,1,4969400,4969400,1366,455,911,455,0,1,457,22489,0.022489
855,555,365,202575,2,6846,1713,1,7913400,7913400,2566,855,1711,855,0,1,857,36581,0.036581
1255,555,365,202575,2,10046,2513,1,10857400,10857400,3766,1255,2511,1255,0,1,1257,5043,0.005043
1655,555,365,202575,2,13246,3313,1,13801400,13801400,4966,1655,3311,1655,0,1,1657,67826,0.067826
2055,555,365,202575,2,16446,4113,1,16745400,16745400,6166,2055,4111,2055,0,1,2057,84199,0.084199
2455,555,365,202575,2,19646,4913,1,19689400,19689400,7366,2455,4911,2455,0,1,2457,100531,0.100531
2855,555,365,202575,2,22846,5713,1,22633400,22633400,8566,2855,5711,2855,0,1,2857,115515,0.115515
3255,555,365,202575,2,26046,6513,1,25577400,25577400,9766,3255,6511,3255,0,1,3257,133806,0.133806
3655,555,365,202575,2,29246,7313,1,28521400,28521400,10966,3655,7311,3655,0,1,3657,149098,0.149098
4055,555,365,202575,2,32446,8113,1,31465400,31465400,12166,4055,8111,4055,0,1,4057,163491,0.163491
4455,555,365,202575,2,35646,8913,1,34409400,34409400,13366,4455,8911,4455,0,1,4457,128477,0.128477
4855,555,365,202575,2,38846,9713,1,37353400,37353400,14566,4855,9711,4855,0,1,4857,197554,0.197554
5255,555,365,202575,2,42046,10513,1,40297400,40297400,15766,5255,10511,5255,0,1,5257,213308,0.213308
5655,555,365,202575,2,45246,11313,1,43241400,43241400,16966,5655,11311,5655,0,1,5657,228762,0.228762
6055,555,365,202575,2,48446,12113,1,46185400,46185400,18166,6055,12111,6055,0,1,6057,9637,0.009637
6455,555,365,202575,2,51646,12913,1,49129400,49129400,19366,6455,12911,6455,0,1,6457,261990,0.26199
6855,555,365,202575,2,54846,13713,1,52073400,52073400,20566,6855,13711,6855,0,1,6857,279954,0.279954
55,305,665,202825,2,446,113,1,2049400,2049400,166,55,111,55,0,1,57,5736,0.005736
455,305,665,202825,2,3646,913,1,5153400,5153400,1366,455,911,455,0,1,457,21095,0.021095
855,305,665,202825,2,6846,1713,1,8257400,8257400,2566,855,1711,855,0,1,857,1959,0.001959
1255,305,665,202825,2,10046,2513,1,11361400,11361400,3766,1255,2511,1255,0,1,1257,53264,0.053264
1655,305,665,202825,2,13246,3313,1,14465400,14465400,4966,1655,3311,1655,0,1,1657,70154,0.070154
2055,305,665,202825,2,16446,4113,1,17569400,17569400,6166,2055,4111,2055,0,1,2057,85503,0.085503
2455,305,665,202825,2,19646,4913,1,20673400,20673400,7366,2455,4911,2455,0,1,2457,102230,0.10223
2855,305,665,202825,2,22846,5713,1,23777400,23777400,8566,2855,5711,2855,0,1,2857,118523,0.118523
3255,305,665,202825,2,26046,6513,1,26881400,26881400,9766,3255,6511,3255,0,1,3257,2487,0.002487
3655,305,665,202825,2,29246,7313,1,29985400,29985400,10966,3655,7311,3655,0,1,3657,150927,0.150927
4055,305,665,202825,2,32446,8113,1,33089400,33089400,12166,4055,8111,4055,0,1,4057,23118,0.023118
4455,305,665,202825,2,35646,8913,1,36193400,36193400,13366,4455,8911,4455,0,1,4457,183444,0.183444
4855,305,665,202825,2,38846,9713,1,39297400,39297400,14566,4855,9711,4855,0,1,4857,198674,0.198674
5255,305,665,202825,2,42046,10513,1,42401400,42401400,15766,5255,10511,5255,0,1,5257,215492,0.215492
5655,305,665,202825,2,45246,11313,1,45505400,45505400,16966,5655,11311,5655,0,1,5657,231836,0.231836
6055,305,665,202825,2,48446,12113,1,48609400,48609400,18166,6055,12111,6055,0,1,6057,248958,0.248958
6455,305,665,202825,2,51646,12913,1,51713400,51713400,19366,6455,12911,6455,0,1,6457,265430,0.26543
6855,305,665,202825,2,54846,13713,1,54817400,54817400,20566,6855,13711,6855,0,1,6857,38817,0.038817
39,4993,41,204713,2,318,81,1,3208312,3208312,118,39,79,39,0,1,41,26372,0.026372
539,4993,41,204713,2,4318,1081,1,23344312,23344312,1618,539,1079,539,0,1,541,29402,0.029402
1039,4993,41,204713,2,8318,2081,1,43480312,43480312,3118,1039,2079,1039,0,1,1041,53484,0.053484
1539,4993,41,204713,2,12318,3081,1,63616312,63616312,4618,1539,3079,1539,0,1,1541,82482,0.082482
2039,4993,41,204713,2,16318,4081,1,83752312,83752312,6118,2039,4079,2039,0,1,2041,105216,0.105216
2539,4993,41,204713,2,20318,5081,1,103888312,103888312,7618,2539,5079,2539,0,1,2541,126269,0.126269
3039,4993,41,204713,2,24318,6081,1,124024312,124024312,9118,3039,6079,3039,0,1,3041,149085,0.149085
3539,4993,41,204713,2,28318,7081,1,144160312,144160312,10618,3539,7079,3539,0,1,3541,176631,0.176631
4039,4993,41,204713,2,32318,8081,1,164296312,164296312,12118,4039,8079,4039,0,1,4041,202299,0.202299
4539,4993,41,204713,2,36318,9081,1,184432312,184432312,13618,4539,9079,4539,0,1,4541,245972,0.245972
5039,4993,41,204713,2,40318,10081,1,204568312,204568312,15118,5039,10079,5039,0,1,5041,247809,0.247809
5539,4993,41,204713,2,44318,11081,1,224704312,224704312,16618,5539,11079,5539,0,1,5541,271470,0.27147
6039,4993,41,204713,2,48318,12081,1,244840312,244840312,18118,6039,12079,6039,0,1,6041,306466,0.306466
6539,4993,41,204713,2,52318,13081,1,264976312,264976312,19618,6539,13079,6539,0,1,6541,324242,0.324242
7039,4993,41,204713,2,56318,14081,1,285112312,285112312,21118,7039,14079,7039,0,1,7041,363824,0.363824
40,50,4240,212000,2,326,83,1,3068800,3068800,121,40,81,40,0,1,42,8643,0.008643
440,50,4240,212000,2,3526,883,1,16796800,16796800,1321,440,881,440,0,1,442,10298,0.010298
840,50,4240,212000,2,6726,1683,1,30524800,30524800,2521,840,1681,840,0,1,842,48323,0.048323
1240,50,4240,212000,2,9926,2483,1,44252800,44252800,3721,1240,2481,1240,0,1,1242,64806,0.064806
1640,50,4240,212000,2,13126,3283,1,57980800,57980800,4921,1640,3281,1640,0,1,1642,75189,0.075189
2040,50,4240,212000,2,16326,4083,1,71708800,71708800,6121,2040,4081,2040,0,1,2042,46101,0.046101
2440,50,4240,212000,2,19526,4883,1,85436800,85436800,7321,2440,4881,2440,0,1,2442,124822,0.124822
2840,50,4240,212000,2,22726,5683,1,99164800,99164800,8521,2840,5681,2840,0,1,2842,112090,0.11209
3240,50,4240,212000,2,25926,6483,1,112892800,112892800,9721,3240,6481,3240,0,1,3242,180896,0.180896
3640,50,4240,212000,2,29126,7283,1,126620800,126620800,10921,3640,7281,3640,0,1,3642,184865,0.184865
4040,50,4240,212000,2,32326,8083,1,140348800,140348800,12121,4040,8081,4040,0,1,4042,204388,0.204388
4440,50,4240,212000,2,35526,8883,1,154076800,154076800,13321,4440,8881,4440,0,1,4442,221425,0.221425
4840,50,4240,212000,2,38726,9683,1,167804800,167804800,14521,4840,9681,4840,0,1,4842,144158,0.144158
5240,50,4240,212000,2,41926,10483,1,181532800,181532800,15721,5240,10481,5240,0,1,5242,49721,0.049721
5640,50,4240,212000,2,45126,11283,1,195260800,195260800,16921,5640,11281,5640,0,1,5642,294413,0.294413
6040,50,4240,212000,2,48326,12083,1,208988800,208988800,18121,6040,12081,6040,0,1,6042,205673,0.205673
6440,50,4240,212000,2,51526,12883,1,222716800,222716800,19321,6440,12881,6440,0,1,6442,152861,0.152861
6840,50,4240,212000,2,54726,13683,1,236444800,236444800,20521,6840,13681,6840,0,1,6842,59373,0.059373
40,5300,40,212000,2,326,83,1,3404800,3404800,121,40,81,40,0,1,42,29114,0.029114
440,5300,40,212000,2,3526,883,1,20492800,20492800,1321,440,881,440,0,1,442,27406,0.027406
840,5300,40,212000,2,6726,1683,1,37580800,37580800,2521,840,1681,840,0,1,842,49304,0.049304
1240,5300,40,212000,2,9926,2483,1,54668800,54668800,3721,1240,2481,1240,0,1,1242,8047,0.008047
1640,5300,40,212000,2,13126,3283,1,71756800,71756800,4921,1640,3281,1640,0,1,1642,92848,0.092848
2040,5300,40,212000,2,16326,4083,1,88844800,88844800,6121,2040,4081,2040,0,1,2042,121802,0.121802
2440,5300,40,212000,2,19526,4883,1,105932800,105932800,7321,2440,4881,2440,0,1,2442,137513,0.137513
2840,5300,40,212000,2,22726,5683,1,123020800,123020800,8521,2840,5681,2840,0,1,2842,5542,0.005542
3240,5300,40,212000,2,25926,6483,1,140108800,140108800,9721,3240,6481,3240,0,1,3242,167935,0.167935
3640,5300,40,212000,2,29126,7283,1,157196800,157196800,10921,3640,7281,3640,0,1,3642,184934,0.184934
4040,5300,40,212000,2,32326,8083,1,174284800,174284800,12121,4040,8081,4040,0,1,4042,208930,0.20893
4440,5300,40,212000,2,35526,8883,1,191372800,191372800,13321,4440,8881,4440,0,1,4442,174650,0.17465
4840,5300,40,212000,2,38726,9683,1,208460800,208460800,14521,4840,9681,4840,0,1,4842,253905,0.253905
5240,5300,40,212000,2,41926,10483,1,225548800,225548800,15721,5240,10481,5240,0,1,5242,288115,0.288115
5640,5300,40,212000,2,45126,11283,1,242636800,242636800,16921,5640,11281,5640,0,1,5642,310972,0.310972
6040,5300,40,212000,2,48326,12083,1,259724800,259724800,18121,6040,12081,6040,0,1,6042,330858,0.330858
6440,5300,40,212000,2,51526,12883,1,276812800,276812800,19321,6440,12881,6440,0,1,6442,352913,0.352913
6840,5300,40,212000,2,54726,13683,1,293900800,293900800,20521,6840,13681,6840,0,1,6842,391771,0.391771
44,3903,55,214665,2,358,91,1,3110536,3110536,133,44,89,44,0,1,46,21450,0.02145
544,3903,55,214665,2,4358,1091,1,18942536,18942536,1633,544,1089,544,0,1,546,31358,0.031358
1044,3903,55,214665,2,8358,2091,1,34774536,34774536,3133,1044,2089,1044,0,1,1046,55679,0.055679
1544,3903,55,214665,2,12358,3091,1,50606536,50606536,4633,1544,3089,1544,0,1,1546,83676,0.083676
2044,3903,55,214665,2,16358,4091,1,66438536,66438536,6133,2044,4089,2044,0,1,2046,109618,0.109618
2544,3903,55,214665,2,20358,5091,1,82270536,82270536,7633,2544,5089,2544,0,1,2546,137916,0.137916
3044,3903,55,214665,2,24358,6091,1,98102536,98102536,9133,3044,6089,3044,0,1,3046,171666,0.171666
3544,3903,55,214665,2,28358,7091,1,113934536,113934536,10633,3544,7089,3544,0,1,3546,180923,0.180923
4044,3903,55,214665,2,32358,8091,1,129766536,129766536,12133,4044,8089,4044,0,1,4046,211314,0.211314
4544,3903,55,214665,2,36358,9091,1,145598536,145598536,13633,4544,9089,4544,0,1,4546,230548,0.230548
5044,3903,55,214665,2,40358,10091,1,161430536,161430536,15133,5044,10089,5044,0,1,5046,263276,0.263276
5544,3903,55,214665,2,44358,11091,1,177262536,177262536,16633,5544,11089,5544,0,1,5546,277020,0.27702
6044,3903,55,214665,2,48358,12091,1,193094536,193094536,18133,6044,12089,6044,0,1,6046,300580,0.30058
6544,3903,55,214665,2,52358,13091,1,208926536,208926536,19633,6544,13089,6544,0,1,6546,343547,0.343547
7044,3903,55,214665,2,56358,14091,1,224758536,224758536,21133,7044,14089,7044,0,1,7046,350954,0.350954
55,3305,65,214825,2,446,113,1,3201400,3201400,166,55,111,55,0,1,57,20150,0.02015
455,3305,65,214825,2,3646,913,1,13985400,13985400,1366,455,911,455,0,1,457,27400,0.0274
855,3305,65,214825,2,6846,1713,1,24769400,24769400,2566,855,1711,855,0,1,857,47925,0.047925
1255,3305,65,214825,2,10046,2513,1,35553400,35553400,3766,1255,2511,1255,0,1,1257,65798,0.065798
1655,3305,65,214825,2,13246,3313,1,46337400,46337400,4966,1655,3311,1655,0,1,1657,84505,0.084505
2055,3305,65,214825,2,16446,4113,1,57121400,57121400,6166,2055,4111,2055,0,1,2057,106329,0.106329
2455,3305,65,214825,2,19646,4913,1,67905400,67905400,7366,2455,4911,2455,0,1,2457,125944,0.125944
2855,3305,65,214825,2,22846,5713,1,78689400,78689400,8566,2855,5711,2855,0,1,2857,142801,0.142801
3255,3305,65,214825,2,26046,6513,1,89473400,89473400,9766,3255,6511,3255,0,1,3257,188771,0.188771
3655,3305,65,214825,2,29246,7313,1,100257400,100257400,10966,3655,7311,3655,0,1,3657,178581,0.178581
4055,3305,65,214825,2,32446,8113,1,111041400,111041400,12166,4055,8111,4055,0,1,4057,187845,0.187845
4455,3305,65,214825,2,35646,8913,1,121825400,121825400,13366,4455,8911,4455,0,1,4457,224673,0.224673
4855,3305,65,214825,2,38846,9713,1,132609400,132609400,14566,4855,9711,4855,0,1,4857,239920,0.23992
5255,3305,65,214825,2,42046,10513,1,143393400,143393400,15766,5255,10511,5255,0,1,5257,257476,0.257476
5655,3305,65,214825,2,45246,11313,1,154177400,154177400,16966,5655,11311,5655,0,1,5657,288383,0.288383
6055,3305,65,214825,2,48446,12113,1,164961400,164961400,18166,6055,12111,6055,0,1,6057,298430,0.29843
6455,3305,65,214825,2,51646,12913,1,175745400,175745400,19366,6455,12911,6455,0,1,6457,313559,0.313559
6855,3305,65,214825,2,54846,13713,1,186529400,186529400,20566,6855,13711,6855,0,1,6857,330944,0.330944
44,53,4055,214915,2,358,91,1,3165336,3165336,133,44,89,44,0,1,46,255,0.000255
544,53,4055,214915,2,4358,1091,1,19597336,19597336,1633,544,1089,544,0,1,546,30410,0.03041
1044,53,4055,214915,2,8358,2091,1,36029336,36029336,3133,1044,2089,1044,0,1,1046,2492,0.002492
1544,53,4055,214915,2,12358,3091,1,52461336,52461336,4633,1544,3089,1544,0,1,1546,89151,0.089151
2044,53,4055,214915,2,16358,4091,1,68893336,68893336,6133,2044,4089,2044,0,1,2046,39439,0.039439
2544,53,4055,214915,2,20358,5091,1,85325336,85325336,7633,2544,5089,2544,0,1,2546,9568,0.009568
3044,53,4055,214915,2,24358,6091,1,101757336,101757336,9133,3044,6089,3044,0,1,3046,28607,0.028607
3544,53,4055,214915,2,28358,7091,1,118189336,118189336,10633,3544,7089,3544,0,1,3546,53156,0.053156
4044,53,4055,214915,2,32358,8091,1,134621336,134621336,12133,4044,8089,4044,0,1,4046,67739,0.067739
4544,53,4055,214915,2,36358,9091,1,151053336,151053336,13633,4544,9089,4544,0,1,4546,145975,0.145975
5044,53,4055,214915,2,40358,10091,1,167485336,167485336,15133,5044,10089,5044,0,1,5046,125614,0.125614
5544,53,4055,214915,2,44358,11091,1,183917336,183917336,16633,5544,11089,5544,0,1,5546,277689,0.277689
6044,53,4055,214915,2,48358,12091,1,200349336,200349336,18133,6044,12089,6044,0,1,6046,312348,0.312348
6544,53,4055,214915,2,52358,13091,1,216781336,216781336,19633,6544,13089,6544,0,1,6546,338146,0.338146
7044,53,4055,214915,2,56358,14091,1,233213336,233213336,21133,7044,14089,7044,0,1,7046,364430,0.36443
39,43,5041,216763,2,318,81,1,3320312,3320312,118,39,79,39,0,1,41,8367,0.008367
539,43,5041,216763,2,4318,1081,1,23656312,23656312,1618,539,1079,539,0,1,541,4059,0.004059
1039,43,5041,216763,2,8318,2081,1,43992312,43992312,3118,1039,2079,1039,0,1,1041,39714,0.039714
1539,43,5041,216763,2,12318,3081,1,64328312,64328312,4618,1539,3079,1539,0,1,1541,76991,0.076991
2039,43,5041,216763,2,16318,4081,1,84664312,84664312,6118,2039,4079,2039,0,1,2041,31928,0.031928
2539,43,5041,216763,2,20318,5081,1,105000312,105000312,7618,2539,5079,2539,0,1,2541,23104,0.023104
3039,43,5041,216763,2,24318,6081,1,125336312,125336312,9118,3039,6079,3039,0,1,3041,36234,0.036234
3539,43,5041,216763,2,28318,7081,1,145672312,145672312,10618,3539,7079,3539,0,1,3541,105478,0.105478
4039,43,5041,216763,2,32318,8081,1,166008312,166008312,12118,4039,8079,4039,0,1,4041,90636,0.090636
4539,43,5041,216763,2,36318,9081,1,186344312,186344312,13618,4539,9079,4539,0,1,4541,173547,0.173547
5039,43,5041,216763,2,40318,10081,1,206680312,206680312,15118,5039,10079,5039,0,1,5041,99180,0.09918
5539,43,5041,216763,2,44318,11081,1,227016312,227016312,16618,5539,11079,5539,0,1,5541,204481,0.204481
6039,43,5041,216763,2,48318,12081,1,247352312,247352312,18118,6039,12079,6039,0,1,6041,58830,0.05883
6539,43,5041,216763,2,52318,13081,1,267688312,267688312,19618,6539,13079,6539,0,1,6541,361416,0.361416
7039,43,5041,216763,2,56318,14081,1,288024312,288024312,21118,7039,14079,7039,0,1,7041,68241,0.068241
55,55,3965,218075,2,446,113,1,3513400,3513400,166,55,111,55,0,1,57,5456,0.005456
455,55,3965,218075,2,3646,913,1,16377400,16377400,1366,455,911,455,0,1,457,2050,0.00205
855,55,3965,218075,2,6846,1713,1,29241400,29241400,2566,855,1711,855,0,1,857,21990,0.02199
1255,55,3965,218075,2,10046,2513,1,42105400,42105400,3766,1255,2511,1255,0,1,1257,36042,0.036042
1655,55,3965,218075,2,13246,3313,1,54969400,54969400,4966,1655,3311,1655,0,1,1657,8340,0.00834
2055,55,3965,218075,2,16446,4113,1,67833400,67833400,6166,2055,4111,2055,0,1,2057,99773,0.099773
2455,55,3965,218075,2,19646,4913,1,80697400,80697400,7366,2455,4911,2455,0,1,2457,63913,0.063913
2855,55,3965,218075,2,22846,5713,1,93561400,93561400,8566,2855,5711,2855,0,1,2857,78941,0.078941
3255,55,3965,218075,2,26046,6513,1,106425400,106425400,9766,3255,6511,3255,0,1,3257,10897,0.010897
3655,55,3965,218075,2,29246,7313,1,119289400,119289400,10966,3655,7311,3655,0,1,3657,144436,0.144436
4055,55,3965,218075,2,32446,8113,1,132153400,132153400,12166,4055,8111,4055,0,1,4057,71701,0.071701
4455,55,3965,218075,2,35646,8913,1,145017400,145017400,13366,4455,8911,4455,0,1,4457,232634,0.232634
4855,55,3965,218075,2,38846,9713,1,157881400,157881400,14566,4855,9711,4855,0,1,4857,253920,0.25392
5255,55,3965,218075,2,42046,10513,1,170745400,170745400,15766,5255,10511,5255,0,1,5257,152115,0.152115
5655,55,3965,218075,2,45246,11313,1,183609400,183609400,16966,5655,11311,5655,0,1,5657,311663,0.311663
6055,55,3965,218075,2,48446,12113,1,196473400,196473400,18166,6055,12111,6055,0,1,6057,125344,0.125344
6455,55,3965,218075,2,51646,12913,1,209337400,209337400,19366,6455,12911,6455,0,1,6457,336067,0.336067
6855,55,3965,218075,2,54846,13713,1,222201400,222201400,20566,6855,13711,6855,0,1,6857,356624,0.356624
35,40,5545,221800,2,286,73,1,3338200,3338200,106,35,71,35,0,1,37,8175,0.008175
535,40,5545,221800,2,4286,1073,1,25678200,25678200,1606,535,1071,535,0,1,537,9921,0.009921
1035,40,5545,221800,2,8286,2073,1,48018200,48018200,3106,1035,2071,1035,0,1,1037,62612,0.062612
1535,40,5545,221800,2,12286,3073,1,70358200,70358200,4606,1535,3071,1535,0,1,1537,90548,0.090548
2035,40,5545,221800,2,16286,4073,1,92698200,92698200,6106,2035,4071,2035,0,1,2037,118176,0.118176
2535,40,5545,221800,2,20286,5073,1,115038200,115038200,7606,2535,5071,2535,0,1,2537,146059,0.146059
3035,40,5545,221800,2,24286,6073,1,137378200,137378200,9106,3035,6071,3035,0,1,3037,115138,0.115138
3535,40,5545,221800,2,28286,7073,1,159718200,159718200,10606,3535,7071,3535,0,1,3537,200566,0.200566
4035,40,5545,221800,2,32286,8073,1,182058200,182058200,12106,4035,8071,4035,0,1,4037,225427,0.225427
4535,40,5545,221800,2,36286,9073,1,204398200,204398200,13606,4535,9071,4535,0,1,4537,254208,0.254208
5035,40,5545,221800,2,40286,10073,1,226738200,226738200,15106,5035,10071,5035,0,1,5037,280822,0.280822
5535,40,5545,221800,2,44286,11073,1,249078200,249078200,16606,5535,11071,5535,0,1,5537,309260,0.30926
6035,40,5545,221800,2,48286,12073,1,271418200,271418200,18106,6035,12071,6035,0,1,6037,179687,0.179687
6535,40,5545,221800,2,52286,13073,1,293758200,293758200,19606,6535,13071,6535,0,1,6537,318114,0.318114
7035,40,5545,221800,2,56286,14073,1,316098200,316098200,21106,7035,14071,7035,0,1,7037,392363,0.392363
40,5550,40,222000,2,326,83,1,3564800,3564800,121,40,81,40,0,1,42,29799,0.029799
440,5550,40,222000,2,3526,883,1,21452800,21452800,1321,440,881,440,0,1,442,29858,0.029858
840,5550,40,222000,2,6726,1683,1,39340800,39340800,2521,840,1681,840,0,1,842,49473,0.049473
1240,5550,40,222000,2,9926,2483,1,57228800,57228800,3721,1240,2481,1240,0,1,1242,74901,0.074901
1640,5550,40,222000,2,13126,3283,1,75116800,75116800,4921,1640,3281,1640,0,1,1642,92877,0.092877
2040,5550,40,222000,2,16326,4083,1,93004800,93004800,6121,2040,4081,2040,0,1,2042,111890,0.11189
2440,5550,40,222000,2,19526,4883,1,110892800,110892800,7321,2440,4881,2440,0,1,2442,131666,0.131666
2840,5550,40,222000,2,22726,5683,1,128780800,128780800,8521,2840,5681,2840,0,1,2842,153785,0.153785
3240,5550,40,222000,2,25926,6483,1,146668800,146668800,9721,3240,6481,3240,0,1,3242,180106,0.180106
3640,5550,40,222000,2,29126,7283,1,164556800,164556800,10921,3640,7281,3640,0,1,3642,197252,0.197252
4040,5550,40,222000,2,32326,8083,1,182444800,182444800,12121,4040,8081,4040,0,1,4042,102254,0.102254
4440,5550,40,222000,2,35526,8883,1,200332800,200332800,13321,4440,8881,4440,0,1,4442,244751,0.244751
4840,5550,40,222000,2,38726,9683,1,218220800,218220800,14521,4840,9681,4840,0,1,4842,263533,0.263533
5240,5550,40,222000,2,41926,10483,1,236108800,236108800,15721,5240,10481,5240,0,1,5242,293356,0.293356
5640,5550,40,222000,2,45126,11283,1,253996800,253996800,16921,5640,11281,5640,0,1,5642,308243,0.308243
6040,5550,40,222000,2,48326,12083,1,271884800,271884800,18121,6040,12081,6040,0,1,6042,326312,0.326312
6440,5550,40,222000,2,51526,12883,1,289772800,289772800,19321,6440,12881,6440,0,1,6442,378889,0.378889
6840,5550,40,222000,2,54726,13683,1,307660800,307660800,20521,6840,13681,6840,0,1,6842,110613,0.110613
35,4950,45,222750,2,286,73,1,3180600,3180600,106,35,71,35,0,1,37,2742,0.002742
535,4950,45,222750,2,4286,1073,1,23160600,23160600,1606,535,1071,535,0,1,537,34829,0.034829
1035,4950,45,222750,2,8286,2073,1,43140600,43140600,3106,1035,2071,1035,0,1,1037,58373,0.058373
1535,4950,45,222750,2,12286,3073,1,63120600,63120600,4606,1535,3071,1535,0,1,1537,89632,0.089632
2035,4950,45,222750,2,16286,4073,1,83100600,83100600,6106,2035,4071,2035,0,1,2037,117725,0.117725
2535,4950,45,222750,2,20286,5073,1,103080600,103080600,7606,2535,5071,2535,0,1,2537,149470,0.14947
3035,4950,45,222750,2,24286,6073,1,123060600,123060600,9106,3035,6071,3035,0,1,3037,164826,0.164826
3535,4950,45,222750,2,28286,7073,1,143040600,143040600,10606,3535,7071,3535,0,1,3537,203326,0.203326
4035,4950,45,222750,2,32286,8073,1,163020600,163020600,12106,4035,8071,4035,0,1,4037,219768,0.219768
4535,4950,45,222750,2,36286,9073,1,183000600,183000600,13606,4535,9071,4535,0,1,4537,270137,0.270137
5035,4950,45,222750,2,40286,10073,1,202980600,202980600,15106,5035,10071,5035,0,1,5037,270750,0.27075
5535,4950,45,222750,2,44286,11073,1,222960600,222960600,16606,5535,11071,5535,0,1,5537,314133,0.314133
6035,4950,45,222750,2,48286,12073,1,242940600,242940600,18106,6035,12071,6035,0,1,6037,334183,0.334183
6535,4950,45,222750,2,52286,13073,1,262920600,262920600,19606,6535,13071,6535,0,1,6537,349930,0.34993
7035,4950,45,222750,2,56286,14073,1,282900600,282900600,21106,7035,14071,7035,0,1,7037,385332,0.385332
40,50,4540,227000,2,326,83,1,3284800,3284800,121,40,81,40,0,1,42,2604,0.002604
440,50,4540,227000,2,3526,883,1,17972800,17972800,1321,440,881,440,0,1,442,17769,0.017769
840,50,4540,227000,2,6726,1683,1,32660800,32660800,2521,840,1681,840,0,1,842,2232,0.002232
1240,50,4540,227000,2,9926,2483,1,47348800,47348800,3721,1240,2481,1240,0,1,1242,4051,0.004051
1640,50,4540,227000,2,13126,3283,1,62036800,62036800,4921,1640,3281,1640,0,1,1642,100468,0.100468
2040,50,4540,227000,2,16326,4083,1,76724800,76724800,6121,2040,4081,2040,0,1,2042,5444,0.005444
2440,50,4540,227000,2,19526,4883,1,91412800,91412800,7321,2440,4881,2440,0,1,2442,7689,0.007689
2840,50,4540,227000,2,22726,5683,1,106100800,106100800,8521,2840,5681,2840,0,1,2842,29555,0.029555
3240,50,4540,227000,2,25926,6483,1,120788800,120788800,9721,3240,6481,3240,0,1,3242,194167,0.194167
3640,50,4540,227000,2,29126,7283,1,135476800,135476800,10921,3640,7281,3640,0,1,3642,67104,0.067104
4040,50,4540,227000,2,32326,8083,1,150164800,150164800,12121,4040,8081,4040,0,1,4042,48085,0.048085
4440,50,4540,227000,2,35526,8883,1,164852800,164852800,13321,4440,8881,4440,0,1,4442,137251,0.137251
4840,50,4540,227000,2,38726,9683,1,179540800,179540800,14521,4840,9681,4840,0,1,4842,66561,0.066561
5240,50,4540,227000,2,41926,10483,1,194228800,194228800,15721,5240,10481,5240,0,1,5242,112949,0.112949
5640,50,4540,227000,2,45126,11283,1,208916800,208916800,16921,5640,11281,5640,0,1,5642,196825,0.196825
6040,50,4540,227000,2,48326,12083,1,223604800,223604800,18121,6040,12081,6040,0,1,6042,18580,0.01858
6440,50,4540,227000,2,51526,12883,1,238292800,238292800,19321,6440,12881,6440,0,1,6442,112928,0.112928
6840,50,4540,227000,2,54726,13683,1,252980800,252980800,20521,6840,13681,6840,0,1,6842,55594,0.055594
39,5543,41,227263,2,318,81,1,3560312,3560312,118,39,79,39,0,1,41,4236,0.004236
539,5543,41,227263,2,4318,1081,1,25896312,25896312,1618,539,1079,539,0,1,541,8409,0.008409
1039,5543,41,227263,2,8318,2081,1,48232312,48232312,3118,1039,2079,1039,0,1,1041,61582,0.061582
1539,5543,41,227263,2,12318,3081,1,70568312,70568312,4618,1539,3079,1539,0,1,1541,60516,0.060516
2039,5543,41,227263,2,16318,4081,1,92904312,92904312,6118,2039,4079,2039,0,1,2041,99690,0.09969
2539,5543,41,227263,2,20318,5081,1,115240312,115240312,7618,2539,5079,2539,0,1,2541,141729,0.141729
3039,5543,41,227263,2,24318,6081,1,137576312,137576312,9118,3039,6079,3039,0,1,3041,167238,0.167238
3539,5543,41,227263,2,28318,7081,1,159912312,159912312,10618,3539,7079,3539,0,1,3541,210509,0.210509
4039,5543,41,227263,2,32318,8081,1,182248312,182248312,12118,4039,8079,4039,0,1,4041,245518,0.245518
4539,5543,41,227263,2,36318,9081,1,204584312,204584312,13618,4539,9079,4539,0,1,4541,11104,0.011104
5039,5543,41,227263,2,40318,10081,1,226920312,226920312,15118,5039,10079,5039,0,1,5041,282630,0.28263
5539,5543,41,227263,2,44318,11081,1,249256312,249256312,16618,5539,11079,5539,0,1,5541,307552,0.307552
6039,5543,41,227263,2,48318,12081,1,271592312,271592312,18118,6039,12079,6039,0,1,6041,332664,0.332664
6539,5543,41,227263,2,52318,13081,1,293928312,293928312,19618,6539,13079,6539,0,1,6541,392823,0.392823
7039,5543,41,227263,2,56318,14081,1,316264312,316264312,21118,7039,14079,7039,0,1,7041,420010,0.42001
55,3555,65,231075,2,446,113,1,3441400,3441400,166,55,111,55,0,1,57,22374,0.022374
455,3555,65,231075,2,3646,913,1,15025400,15025400,1366,455,911,455,0,1,457,27418,0.027418
855,3555,65,231075,2,6846,1713,1,26609400,26609400,2566,855,1711,855,0,1,857,46803,0.046803
1255,3555,65,231075,2,10046,2513,1,38193400,38193400,3766,1255,2511,1255,0,1,1257,66337,0.066337
1655,3555,65,231075,2,13246,3313,1,49777400,49777400,4966,1655,3311,1655,0,1,1657,89102,0.089102
2055,3555,65,231075,2,16446,4113,1,61361400,61361400,6166,2055,4111,2055,0,1,2057,106095,0.106095
2455,3555,65,231075,2,19646,4913,1,72945400,72945400,7366,2455,4911,2455,0,1,2457,129444,0.129444
2855,3555,65,231075,2,22846,5713,1,84529400,84529400,8566,2855,5711,2855,0,1,2857,147813,0.147813
3255,3555,65,231075,2,26046,6513,1,96113400,96113400,9766,3255,6511,3255,0,1,3257,173670,0.17367
3655,3555,65,231075,2,29246,7313,1,107697400,107697400,10966,3655,7311,3655,0,1,3657,185747,0.185747
4055,3555,65,231075,2,32446,8113,1,119281400,119281400,12166,4055,8111,4055,0,1,4057,35138,0.035138
4455,3555,65,231075,2,35646,8913,1,130865400,130865400,13366,4455,8911,4455,0,1,4457,236445,0.236445
4855,3555,65,231075,2,38846,9713,1,142449400,142449400,14566,4855,9711,4855,0,1,4857,248814,0.248814
5255,3555,65,231075,2,42046,10513,1,154033400,154033400,15766,5255,10511,5255,0,1,5257,269189,0.269189
5655,3555,65,231075,2,45246,11313,1,165617400,165617400,16966,5655,11311,5655,0,1,5657,297579,0.297579
6055,3555,65,231075,2,48446,12113,1,177201400,177201400,18166,6055,12111,6055,0,1,6057,308648,0.308648
6455,3555,65,231075,2,51646,12913,1,188785400,188785400,19366,6455,12911,6455,0,1,6457,161426,0.161426
6855,3555,65,231075,2,54846,13713,1,200369400,200369400,20566,6855,13711,6855,0,1,6857,332399,0.332399
40,5800,40,232000,2,326,83,1,3724800,3724800,121,40,81,40,0,1,42,236,0.000236
440,5800,40,232000,2,3526,883,1,22412800,22412800,1321,440,881,440,0,1,442,24135,0.024135
840,5800,40,232000,2,6726,1683,1,41100800,41100800,2521,840,1681,840,0,1,842,5274,0.005274
1240,5800,40,232000,2,9926,2483,1,59788800,59788800,3721,1240,2481,1240,0,1,1242,73208,0.073208
1640,5800,40,232000,2,13126,3283,1,78476800,78476800,4921,1640,3281,1640,0,1,1642,93975,0.093975
2040,5800,40,232000,2,16326,4083,1,97164800,97164800,6121,2040,4081,2040,0,1,2042,115157,0.115157
2440,5800,40,232000,2,19526,4883,1,115852800,115852800,7321,2440,4881,2440,0,1,2442,138298,0.138298
2840,5800,40,232000,2,22726,5683,1,134540800,134540800,8521,2840,5681,2840,0,1,2842,161053,0.161053
3240,5800,40,232000,2,25926,6483,1,153228800,153228800,9721,3240,6481,3240,0,1,3242,180659,0.180659
3640,5800,40,232000,2,29126,7283,1,171916800,171916800,10921,3640,7281,3640,0,1,3642,229736,0.229736
4040,5800,40,232000,2,32326,8083,1,190604800,190604800,12121,4040,8081,4040,0,1,4042,225028,0.225028
4440,5800,40,232000,2,35526,8883,1,209292800,209292800,13321,4440,8881,4440,0,1,4442,246557,0.246557
4840,5800,40,232000,2,38726,9683,1,227980800,227980800,14521,4840,9681,4840,0,1,4842,240395,0.240395
5240,5800,40,232000,2,41926,10483,1,246668800,246668800,15721,5240,10481,5240,0,1,5242,307326,0.307326
5640,5800,40,232000,2,45126,11283,1,265356800,265356800,16921,5640,11281,5640,0,1,5642,300422,0.300422
6040,5800,40,232000,2,48326,12083,1,284044800,284044800,18121,6040,12081,6040,0,1,6042,337838,0.337838
6440,5800,40,232000,2,51526,12883,1,302732800,302732800,19321,6440,12881,6440,0,1,6442,361259,0.361259
6840,5800,40,232000,2,54726,13683,1,321420800,321420800,20521,6840,13681,6840,0,1,6842,381791,0.381791
55,55,4265,234575,2,446,113,1,3777400,3777400,166,55,111,55,0,1,57,362,0.000362
455,55,4265,234575,2,3646,913,1,17601400,17601400,1366,455,911,455,0,1,457,35568,0.035568
855,55,4265,234575,2,6846,1713,1,31425400,31425400,2566,855,1711,855,0,1,857,52001,0.052001
1255,55,4265,234575,2,10046,2513,1,45249400,45249400,3766,1255,2511,1255,0,1,1257,72813,0.072813
1655,55,4265,234575,2,13246,3313,1,59073400,59073400,4966,1655,3311,1655,0,1,1657,5174,0.005174
2055,55,4265,234575,2,16446,4113,1,72897400,72897400,6166,2055,4111,2055,0,1,2057,118277,0.118277
2455,55,4265,234575,2,19646,4913,1,86721400,86721400,7366,2455,4911,2455,0,1,2457,74446,0.074446
2855,55,4265,234575,2,22846,5713,1,100545400,100545400,8566,2855,5711,2855,0,1,2857,8832,0.008832
3255,55,4265,234575,2,26046,6513,1,114369400,114369400,9766,3255,6511,3255,0,1,3257,163715,0.163715
3655,55,4265,234575,2,29246,7313,1,128193400,128193400,10966,3655,7311,3655,0,1,3657,183879,0.183879
4055,55,4265,234575,2,32446,8113,1,142017400,142017400,12166,4055,8111,4055,0,1,4057,219828,0.219828
4455,55,4265,234575,2,35646,8913,1,155841400,155841400,13366,4455,8911,4455,0,1,4457,91485,0.091485
4855,55,4265,234575,2,38846,9713,1,169665400,169665400,14566,4855,9711,4855,0,1,4857,88254,0.088254
5255,55,4265,234575,2,42046,10513,1,183489400,183489400,15766,5255,10511,5255,0,1,5257,221734,0.221734
5655,55,4265,234575,2,45246,11313,1,197313400,197313400,16966,5655,11311,5655,0,1,5657,319186,0.319186
6055,55,4265,234575,2,48446,12113,1,211137400,211137400,18166,6055,12111,6055,0,1,6057,40836,0.040836
6455,55,4265,234575,2,51646,12913,1,224961400,224961400,19366,6455,12911,6455,0,1,6457,279552,0.279552
6855,55,4265,234575,2,54846,13713,1,238785400,238785400,20566,6855,13711,6855,0,1,6857,102536,0.102536
39,43,5541,238263,2,318,81,1,3648312,3648312,118,39,79,39,0,1,41,7622,0.007622
539,43,5541,238263,2,4318,1081,1,25984312,25984312,1618,539,1079,539,0,1,541,18198,0.018198
1039,43,5541,238263,2,8318,2081,1,48320312,48320312,3118,1039,2079,1039,0,1,1041,47009,0.047009
1539,43,5541,238263,2,12318,3081,1,70656312,70656312,4618,1539,3079,1539,0,1,1541,8282,0.008282
2039,43,5541,238263,2,16318,4081,1,92992312,92992312,6118,2039,4079,2039,0,1,2041,71805,0.071805
2539,43,5541,238263,2,20318,5081,1,115328312,115328312,7618,2539,5079,2539,0,1,2541,96443,0.096443
3039,43,5541,238263,2,24318,6081,1,137664312,137664312,9118,3039,6079,3039,0,1,3041,62412,0.062412
3539,43,5541,238263,2,28318,7081,1,160000312,160000312,10618,3539,7079,3539,0,1,3541,51985,0.051985
4039,43,5541,238263,2,32318,8081,1,182336312,182336312,12118,4039,8079,4039,0,1,4041,247584,0.247584
4539,43,5541,238263,2,36318,9081,1,204672312,204672312,13618,4539,9079,4539,0,1,4541,24817,0.024817
5039,43,5541,238263,2,40318,10081,1,227008312,227008312,15118,5039,10079,5039,0,1,5041,303207,0.303207
5539,43,5541,238263,2,44318,11081,1,249344312,249344312,16618,5539,11079,5539,0,1,5541,128657,0.128657
6039,43,5541,238263,2,48318,12081,1,271680312,271680312,18118,6039,12079,6039,0,1,6041,359233,0.359233
6539,43,5541,238263,2,52318,13081,1,294016312,294016312,19618,6539,13079,6539,0,1,6541,84110,0.08411
7039,43,5541,238263,2,56318,14081,1,316352312,316352312,21118,7039,14079,7039,0,1,7041,188064,0.188064
44,53,4555,241415,2,358,91,1,3553336,3553336,133,44,89,44,0,1,46,10044,0.010044
544,53,4555,241415,2,4358,1091,1,21985336,21985336,1633,544,1089,544,0,1,546,3256,0.003256
1044,53,4555,241415,2,8358,2091,1,40417336,40417336,3133,1044,2089,1044,0,1,1046,14511,0.014511
1544,53,4555,241415,2,12358,3091,1,58849336,58849336,4633,1544,3089,1544,0,1,1546,15991,0.015991
2044,53,4555,241415,2,16358,4091,1,77281336,77281336,6133,2044,4089,2044,0,1,2046,7412,0.007412
2544,53,4555,241415,2,20358,5091,1,95713336,95713336,7633,2544,5089,2544,0,1,2546,45260,0.04526
3044,53,4555,241415,2,24358,6091,1,114145336,114145336,9133,3044,6089,3044,0,1,3046,8849,0.008849
3544,53,4555,241415,2,28358,7091,1,132577336,132577336,10633,3544,7089,3544,0,1,3546,156277,0.156277
4044,53,4555,241415,2,32358,8091,1,151009336,151009336,12133,4044,8089,4044,0,1,4046,235042,0.235042
4544,53,4555,241415,2,36358,9091,1,169441336,169441336,13633,4544,9089,4544,0,1,4546,101807,0.101807
5044,53,4555,241415,2,40358,10091,1,187873336,187873336,15133,5044,10089,5044,0,1,5046,52882,0.052882
5544,53,4555,241415,2,44358,11091,1,206305336,206305336,16633,5544,11089,5544,0,1,5546,225006,0.225006
6044,53,4555,241415,2,48358,12091,1,224737336,224737336,18133,6044,12089,6044,0,1,6046,183133,0.183133
6544,53,4555,241415,2,52358,13091,1,243169336,243169336,19633,6544,13089,6544,0,1,6546,133968,0.133968
7044,53,4555,241415,2,56358,14091,1,261601336,261601336,21133,7044,14089,7044,0,1,7046,405846,0.405846
35,40,6045,241800,2,286,73,1,3638200,3638200,106,35,71,35,0,1,37,8886,0.008886
535,40,6045,241800,2,4286,1073,1,27978200,27978200,1606,535,1071,535,0,1,537,47920,0.04792
1035,40,6045,241800,2,8286,2073,1,52318200,52318200,3106,1035,2071,1035,0,1,1037,68351,0.068351
1535,40,6045,241800,2,12286,3073,1,76658200,76658200,4606,1535,3071,1535,0,1,1537,98493,0.098493
2035,40,6045,241800,2,16286,4073,1,100998200,100998200,6106,2035,4071,2035,0,1,2037,128985,0.128985
2535,40,6045,241800,2,20286,5073,1,125338200,125338200,7606,2535,5071,2535,0,1,2537,32807,0.032807
3035,40,6045,241800,2,24286,6073,1,149678200,149678200,9106,3035,6071,3035,0,1,3037,188895,0.188895
3535,40,6045,241800,2,28286,7073,1,174018200,174018200,10606,3535,7071,3535,0,1,3537,94903,0.094903
4035,40,6045,241800,2,32286,8073,1,198358200,198358200,12106,4035,8071,4035,0,1,4037,85940,0.08594
4535,40,6045,241800,2,36286,9073,1,222698200,222698200,13606,4535,9071,4535,0,1,4537,184198,0.184198
5035,40,6045,241800,2,40286,10073,1,247038200,247038200,15106,5035,10071,5035,0,1,5037,76900,0.0769
5535,40,6045,241800,2,44286,11073,1,271378200,271378200,16606,5535,11071,5535,0,1,5537,337222,0.337222
6035,40,6045,241800,2,48286,12073,1,295718200,295718200,18106,6035,12071,6035,0,1,6037,299047,0.299047
6535,40,6045,241800,2,52286,13073,1,320058200,320058200,19606,6535,13071,6535,0,1,6537,422329,0.422329
7035,40,6045,241800,2,56286,14073,1,344398200,344398200,21106,7035,14071,7035,0,1,7037,431251,0.431251
40,50,4840,242000,2,326,83,1,3500800,3500800,121,40,81,40,0,1,42,9490,0.00949
440,50,4840,242000,2,3526,883,1,19148800,19148800,1321,440,881,440,0,1,442,7635,0.007635
840,50,4840,242000,2,6726,1683,1,34796800,34796800,2521,840,1681,840,0,1,842,16553,0.016553
1240,50,4840,242000,2,9926,2483,1,50444800,50444800,3721,1240,2481,1240,0,1,1242,22751,0.022751
1640,50,4840,242000,2,13126,3283,1,66092800,66092800,4921,1640,3281,1640,0,1,1642,5824,0.005824
2040,50,4840,242000,2,16326,4083,1,81740800,81740800,6121,2040,4081,2040,0,1,2042,81594,0.081594
2440,50,4840,242000,2,19526,4883,1,97388800,97388800,7321,2440,4881,2440,0,1,2442,126073,0.126073
2840,50,4840,242000,2,22726,5683,1,113036800,113036800,8521,2840,5681,2840,0,1,2842,168727,0.168727
3240,50,4840,242000,2,25926,6483,1,128684800,128684800,9721,3240,6481,3240,0,1,3242,12402,0.012402
3640,50,4840,242000,2,29126,7283,1,144332800,144332800,10921,3640,7281,3640,0,1,3642,116381,0.116381
4040,50,4840,242000,2,32326,8083,1,159980800,159980800,12121,4040,8081,4040,0,1,4042,103813,0.103813
4440,50,4840,242000,2,35526,8883,1,175628800,175628800,13321,4440,8881,4440,0,1,4442,12762,0.012762
4840,50,4840,242000,2,38726,9683,1,191276800,191276800,14521,4840,9681,4840,0,1,4842,202091,0.202091
5240,50,4840,242000,2,41926,10483,1,206924800,206924800,15721,5240,10481,5240,0,1,5242,76780,0.07678
5640,50,4840,242000,2,45126,11283,1,222572800,222572800,16921,5640,11281,5640,0,1,5642,89209,0.089209
6040,50,4840,242000,2,48326,12083,1,238220800,238220800,18121,6040,12081,6040,0,1,6042,208505,0.208505
6440,50,4840,242000,2,51526,12883,1,253868800,253868800,19321,6440,12881,6440,0,1,6442,152705,0.152705
6840,50,4840,242000,2,54726,13683,1,269516800,269516800,20521,6840,13681,6840,0,1,6842,398658,0.398658
40,6050,40,242000,2,326,83,1,3884800,3884800,121,40,81,40,0,1,42,32464,0.032464
440,6050,40,242000,2,3526,883,1,23372800,23372800,1321,440,881,440,0,1,442,29176,0.029176
840,6050,40,242000,2,6726,1683,1,42860800,42860800,2521,840,1681,840,0,1,842,52894,0.052894
1240,6050,40,242000,2,9926,2483,1,62348800,62348800,3721,1240,2481,1240,0,1,1242,77222,0.077222
1640,6050,40,242000,2,13126,3283,1,81836800,81836800,4921,1640,3281,1640,0,1,1642,100349,0.100349
2040,6050,40,242000,2,16326,4083,1,101324800,101324800,6121,2040,4081,2040,0,1,2042,124010,0.12401
2440,6050,40,242000,2,19526,4883,1,120812800,120812800,7321,2440,4881,2440,0,1,2442,149882,0.149882
2840,6050,40,242000,2,22726,5683,1,140300800,140300800,8521,2840,5681,2840,0,1,2842,187843,0.187843
3240,6050,40,242000,2,25926,6483,1,159788800,159788800,9721,3240,6481,3240,0,1,3242,118200,0.1182
3640,6050,40,242000,2,29126,7283,1,179276800,179276800,10921,3640,7281,3640,0,1,3642,204379,0.204379
4040,6050,40,242000,2,32326,8083,1,198764800,198764800,12121,4040,8081,4040,0,1,4042,240867,0.240867
4440,6050,40,242000,2,35526,8883,1,218252800,218252800,13321,4440,8881,4440,0,1,4442,287800,0.2878
4840,6050,40,242000,2,38726,9683,1,237740800,237740800,14521,4840,9681,4840,0,1,4842,311858,0.311858
5240,6050,40,242000,2,41926,10483,1,257228800,257228800,15721,5240,10481,5240,0,1,5242,335576,0.335576
5640,6050,40,242000,2,45126,11283,1,276716800,276716800,16921,5640,11281,5640,0,1,5642,362404,0.362404
6040,6050,40,242000,2,48326,12083,1,296204800,296204800,18121,6040,12081,6040,0,1,6042,380937,0.380937
6440,6050,40,242000,2,51526,12883,1,315692800,315692800,19321,6440,12881,6440,0,1,6442,395682,0.395682
6840,6050,40,242000,2,54726,13683,1,335180800,335180800,20521,6840,13681,6840,0,1,6842,433654,0.433654
44,4453,55,244915,2,358,91,1,3546136,3546136,133,44,89,44,0,1,46,1830,0.00183
544,4453,55,244915,2,4358,1091,1,21578136,21578136,1633,544,1089,544,0,1,546,33998,0.033998
1044,4453,55,244915,2,8358,2091,1,39610136,39610136,3133,1044,2089,1044,0,1,1046,63787,0.063787
1544,4453,55,244915,2,12358,3091,1,57642136,57642136,4633,1544,3089,1544,0,1,1546,90779,0.090779
2044,4453,55,244915,2,16358,4091,1,75674136,75674136,6133,2044,4089,2044,0,1,2046,123072,0.123072
2544,4453,55,244915,2,20358,5091,1,93706136,93706136,7633,2544,5089,2544,0,1,2546,144161,0.144161
3044,4453,55,244915,2,24358,6091,1,111738136,111738136,9133,3044,6089,3044,0,1,3046,179026,0.179026
3544,4453,55,244915,2,28358,7091,1,129770136,129770136,10633,3544,7089,3544,0,1,3546,215307,0.215307
4044,4453,55,244915,2,32358,8091,1,147802136,147802136,12133,4044,8089,4044,0,1,4046,228938,0.228938
4544,4453,55,244915,2,36358,9091,1,165834136,165834136,13633,4544,9089,4544,0,1,4546,255978,0.255978
5044,4453,55,244915,2,40358,10091,1,183866136,183866136,15133,5044,10089,5044,0,1,5046,305687,0.305687
5544,4453,55,244915,2,44358,11091,1,201898136,201898136,16633,5544,11089,5544,0,1,5546,336648,0.336648
6044,4453,55,244915,2,48358,12091,1,219930136,219930136,18133,6044,12089,6044,0,1,6046,368159,0.368159
6544,4453,55,244915,2,52358,13091,1,237962136,237962136,19633,6544,13089,6544,0,1,6546,372925,0.372925
7044,4453,55,244915,2,56358,14091,1,255994136,255994136,21133,7044,14089,7044,0,1,7046,409564,0.409564
55,3805,65,247325,2,446,113,1,3681400,3681400,166,55,111,55,0,1,57,23271,0.023271
455,3805,65,247325,2,3646,913,1,16065400,16065400,1366,455,911,455,0,1,457,31521,0.031521
855,3805,65,247325,2,6846,1713,1,28449400,28449400,2566,855,1711,855,0,1,857,51572,0.051572
1255,3805,65,247325,2,10046,2513,1,40833400,40833400,3766,1255,2511,1255,0,1,1257,80488,0.080488
1655,3805,65,247325,2,13246,3313,1,53217400,53217400,4966,1655,3311,1655,0,1,1657,99117,0.099117
2055,3805,65,247325,2,16446,4113,1,65601400,65601400,6166,2055,4111,2055,0,1,2057,117258,0.117258
2455,3805,65,247325,2,19646,4913,1,77985400,77985400,7366,2455,4911,2455,0,1,2457,141600,0.1416
2855,3805,65,247325,2,22846,5713,1,90369400,90369400,8566,2855,5711,2855,0,1,2857,161094,0.161094
3255,3805,65,247325,2,26046,6513,1,102753400,102753400,9766,3255,6511,3255,0,1,3257,178077,0.178077
3655,3805,65,247325,2,29246,7313,1,115137400,115137400,10966,3655,7311,3655,0,1,3657,27405,0.027405
4055,3805,65,247325,2,32446,8113,1,127521400,127521400,12166,4055,8111,4055,0,1,4057,223935,0.223935
4455,3805,65,247325,2,35646,8913,1,139905400,139905400,13366,4455,8911,4455,0,1,4457,244144,0.244144
4855,3805,65,247325,2,38846,9713,1,152289400,152289400,14566,4855,9711,4855,0,1,4857,148866,0.148866
5255,3805,65,247325,2,42046,10513,1,164673400,164673400,15766,5255,10511,5255,0,1,5257,304009,0.304009
5655,3805,65,247325,2,45246,11313,1,177057400,177057400,16966,5655,11311,5655,0,1,5657,312724,0.312724
6055,3805,65,247325,2,48446,12113,1,189441400,189441400,18166,6055,12111,6055,0,1,6057,148119,0.148119
6455,3805,65,247325,2,51646,12913,1,201825400,201825400,19366,6455,12911,6455,0,1,6457,359802,0.359802
6855,3805,65,247325,2,54846,13713,1,214209400,214209400,20566,6855,13711,6855,0,1,6857,378049,0.378049
35,5500,45,247500,2,286,73,1,3532600,3532600,106,35,71,35,0,1,37,2814,0.002814
535,5500,45,247500,2,4286,1073,1,25712600,25712600,1606,535,1071,535,0,1,537,35573,0.035573
1035,5500,45,247500,2,8286,2073,1,47892600,47892600,3106,1035,2071,1035,0,1,1037,59343,0.059343
1535,5500,45,247500,2,12286,3073,1,70072600,70072600,4606,1535,3071,1535,0,1,1537,96929,0.096929
2035,5500,45,247500,2,16286,4073,1,92252600,92252600,6106,2035,4071,2035,0,1,2037,132127,0.132127
2535,5500,45,247500,2,20286,5073,1,114432600,114432600,7606,2535,5071,2535,0,1,2537,155720,0.15572
3035,5500,45,247500,2,24286,6073,1,136612600,136612600,9106,3035,6071,3035,0,1,3037,182123,0.182123
3535,5500,45,247500,2,28286,7073,1,158792600,158792600,10606,3535,7071,3535,0,1,3537,230420,0.23042
4035,5500,45,247500,2,32286,8073,1,180972600,180972600,12106,4035,8071,4035,0,1,4037,239114,0.239114
4535,5500,45,247500,2,36286,9073,1,203152600,203152600,13606,4535,9071,4535,0,1,4537,281094,0.281094
5035,5500,45,247500,2,40286,10073,1,225332600,225332600,15106,5035,10071,5035,0,1,5037,325856,0.325856
5535,5500,45,247500,2,44286,11073,1,247512600,247512600,16606,5535,11071,5535,0,1,5537,327292,0.327292
6035,5500,45,247500,2,48286,12073,1,269692600,269692600,18106,6035,12071,6035,0,1,6037,359515,0.359515
6535,5500,45,247500,2,52286,13073,1,291872600,291872600,19606,6535,13071,6535,0,1,6537,412614,0.412614
7035,5500,45,247500,2,56286,14073,1,314052600,314052600,21106,7035,14071,7035,0,1,7037,419934,0.419934
35,5540,45,249300,2,286,73,1,3558200,3558200,106,35,71,35,0,1,37,14409,0.014409
535,5540,45,249300,2,4286,1073,1,25898200,25898200,1606,535,1071,535,0,1,537,34500,0.0345
1035,5540,45,249300,2,8286,2073,1,48238200,48238200,3106,1035,2071,1035,0,1,1037,67808,0.067808
1535,5540,45,249300,2,12286,3073,1,70578200,70578200,4606,1535,3071,1535,0,1,1537,96866,0.096866
39,6093,41,249813,2,318,81,1,3912312,3912312,118,39,79,39,0,1,41,282,0.000282
539,6093,41,249813,2,4318,1081,1,28448312,28448312,1618,539,1079,539,0,1,541,39328,0.039328
1039,6093,41,249813,2,8318,2081,1,52984312,52984312,3118,1039,2079,1039,0,1,1041,64847,0.064847
1539,6093,41,249813,2,12318,3081,1,77520312,77520312,4618,1539,3079,1539,0,1,1541,96878,0.096878
2039,6093,41,249813,2,16318,4081,1,102056312,102056312,6118,2039,4079,2039,0,1,2041,127934,0.127934
2539,6093,41,249813,2,20318,5081,1,126592312,126592312,7618,2539,5079,2539,0,1,2541,172023,0.172023
3039,6093,41,249813,2,24318,6081,1,151128312,151128312,9118,3039,6079,3039,0,1,3041,184116,0.184116
3539,6093,41,249813,2,28318,7081,1,175664312,175664312,10618,3539,7079,3539,0,1,3541,67814,0.067814
4039,6093,41,249813,2,32318,8081,1,200200312,200200312,12118,4039,8079,4039,0,1,4041,246381,0.246381
4539,6093,41,249813,2,36318,9081,1,224736312,224736312,13618,4539,9079,4539,0,1,4541,290991,0.290991
5039,6093,41,249813,2,40318,10081,1,249272312,249272312,15118,5039,10079,5039,0,1,5041,310185,0.310185
5539,6093,41,249813,2,44318,11081,1,273808312,273808312,16618,5539,11079,5539,0,1,5541,337632,0.337632
6039,6093,41,249813,2,48318,12081,1,298344312,298344312,18118,6039,12079,6039,0,1,6041,403303,0.403303
6539,6093,41,249813,2,52318,13081,1,322880312,322880312,19618,6539,13079,6539,0,1,6541,420939,0.420939
7039,6093,41,249813,2,56318,14081,1,347416312,347416312,21118,7039,14079,7039,0,1,7041,469772,0.469772
55,55,4565,251075,2,446,113,1,4041400,4041400,166,55,111,55,0,1,57,2146,0.002146
455,55,4565,251075,2,3646,913,1,18825400,18825400,1366,455,911,455,0,1,457,13008,0.013008
855,55,4565,251075,2,6846,1713,1,33609400,33609400,2566,855,1711,855,0,1,857,3000,0.003
1255,55,4565,251075,2,10046,2513,1,48393400,48393400,3766,1255,2511,1255,0,1,1257,11510,0.01151
1655,55,4565,251075,2,13246,3313,1,63177400,63177400,4966,1655,3311,1655,0,1,1657,22280,0.02228
2055,55,4565,251075,2,16446,4113,1,77961400,77961400,6166,2055,4111,2055,0,1,2057,126838,0.126838
2455,55,4565,251075,2,19646,4913,1,92745400,92745400,7366,2455,4911,2455,0,1,2457,78706,0.078706
2855,55,4565,251075,2,22846,5713,1,107529400,107529400,8566,2855,5711,2855,0,1,2857,31312,0.031312
3255,55,4565,251075,2,26046,6513,1,122313400,122313400,9766,3255,6511,3255,0,1,3257,30145,0.030145
3655,55,4565,251075,2,29246,7313,1,137097400,137097400,10966,3655,7311,3655,0,1,3657,67490,0.06749
4055,55,4565,251075,2,32446,8113,1,151881400,151881400,12166,4055,8111,4055,0,1,4057,241135,0.241135
4455,55,4565,251075,2,35646,8913,1,166665400,166665400,13366,4455,8911,4455,0,1,4457,263807,0.263807
4855,55,4565,251075,2,38846,9713,1,181449400,181449400,14566,4855,9711,4855,0,1,4857,83821,0.083821
5255,55,4565,251075,2,42046,10513,1,196233400,196233400,15766,5255,10511,5255,0,1,5257,17685,0.017685
5655,55,4565,251075,2,45246,11313,1,211017400,211017400,16966,5655,11311,5655,0,1,5657,267274,0.267274
6055,55,4565,251075,2,48446,12113,1,225801400,225801400,18166,6055,12111,6055,0,1,6057,232505,0.232505
6455,55,4565,251075,2,51646,12913,1,240585400,240585400,19366,6455,12911,6455,0,1,6457,381487,0.381487
6855,55,4565,251075,2,54846,13713,1,255369400,255369400,20566,6855,13711,6855,0,1,6857,216073,0.216073
40,6300,40,252000,2,326,83,1,4044800,4044800,121,40,81,40,0,1,42,33750,0.03375
440,6300,40,252000,2,3526,883,1,24332800,24332800,1321,440,881,440,0,1,442,30594,0.030594
840,6300,40,252000,2,6726,1683,1,44620800,44620800,2521,840,1681,840,0,1,842,55718,0.055718
1240,6300,40,252000,2,9926,2483,1,64908800,64908800,3721,1240,2481,1240,0,1,1242,79500,0.0795
1640,6300,40,252000,2,13126,3283,1,85196800,85196800,4921,1640,3281,1640,0,1,1642,102175,0.102175
2040,6300,40,252000,2,16326,4083,1,105484800,105484800,6121,2040,4081,2040,0,1,2042,124480,0.12448
2440,6300,40,252000,2,19526,4883,1,125772800,125772800,7321,2440,4881,2440,0,1,2442,47904,0.047904
2840,6300,40,252000,2,22726,5683,1,146060800,146060800,8521,2840,5681,2840,0,1,2842,172838,0.172838
3240,6300,40,252000,2,25926,6483,1,166348800,166348800,9721,3240,6481,3240,0,1,3242,198327,0.198327
3640,6300,40,252000,2,29126,7283,1,186636800,186636800,10921,3640,7281,3640,0,1,3642,234544,0.234544
4040,6300,40,252000,2,32326,8083,1,206924800,206924800,12121,4040,8081,4040,0,1,4042,256844,0.256844
4440,6300,40,252000,2,35526,8883,1,227212800,227212800,13321,4440,8881,4440,0,1,4442,290290,0.29029
4840,6300,40,252000,2,38726,9683,1,247500800,247500800,14521,4840,9681,4840,0,1,4842,295961,0.295961
5240,6300,40,252000,2,41926,10483,1,267788800,267788800,15721,5240,10481,5240,0,1,5242,319239,0.319239
5640,6300,40,252000,2,45126,11283,1,288076800,288076800,16921,5640,11281,5640,0,1,5642,346508,0.346508
6040,6300,40,252000,2,48326,12083,1,308364800,308364800,18121,6040,12081,6040,0,1,6042,384762,0.384762
6440,6300,40,252000,2,51526,12883,1,328652800,328652800,19321,6440,12881,6440,0,1,6442,400282,0.400282
6840,6300,40,252000,2,54726,13683,1,348940800,348940800,20521,6840,13681,6840,0,1,6842,456668,0.456668
40,50,5140,257000,2,326,83,1,3716800,3716800,121,40,81,40,0,1,42,9703,0.009703
440,50,5140,257000,2,3526,883,1,20324800,20324800,1321,440,881,440,0,1,442,16858,0.016858
840,50,5140,257000,2,6726,1683,1,36932800,36932800,2521,840,1681,840,0,1,842,25724,0.025724
1240,50,5140,257000,2,9926,2483,1,53540800,53540800,3721,1240,2481,1240,0,1,1242,18601,0.018601
1640,50,5140,257000,2,13126,3283,1,70148800,70148800,4921,1640,3281,1640,0,1,1642,13677,0.013677
2040,50,5140,257000,2,16326,4083,1,86756800,86756800,6121,2040,4081,2040,0,1,2042,35817,0.035817
2440,50,5140,257000,2,19526,4883,1,103364800,103364800,7321,2440,4881,2440,0,1,2442,16846,0.016846
2840,50,5140,257000,2,22726,5683,1,119972800,119972800,8521,2840,5681,2840,0,1,2842,16233,0.016233
3240,50,5140,257000,2,25926,6483,1,136580800,136580800,9721,3240,6481,3240,0,1,3242,74308,0.074308
3640,50,5140,257000,2,29126,7283,1,153188800,153188800,10921,3640,7281,3640,0,1,3642,63242,0.063242
4040,50,5140,257000,2,32326,8083,1,169796800,169796800,12121,4040,8081,4040,0,1,4042,201361,0.201361
4440,50,5140,257000,2,35526,8883,1,186404800,186404800,13321,4440,8881,4440,0,1,4442,132726,0.132726
4840,50,5140,257000,2,38726,9683,1,203012800,203012800,14521,4840,9681,4840,0,1,4842,105061,0.105061
5240,50,5140,257000,2,41926,10483,1,219620800,219620800,15721,5240,10481,5240,0,1,5242,310084,0.310084
5640,50,5140,257000,2,45126,11283,1,236228800,236228800,16921,5640,11281,5640,0,1,5642,344945,0.344945
6040,50,5140,257000,2,48326,12083,1,252836800,252836800,18121,6040,12081,6040,0,1,6042,105468,0.105468
6440,50,5140,257000,2,51526,12883,1,269444800,269444800,19321,6440,12881,6440,0,1,6442,396946,0.396946
6840,50,5140,257000,2,54726,13683,1,286052800,286052800,20521,6840,13681,6840,0,1,6842,140060,0.14006
39,43,6041,259763,2,318,81,1,3976312,3976312,118,39,79,39,0,1,41,337,0.000337
539,43,6041,259763,2,4318,1081,1,28312312,28312312,1618,539,1079,539,0,1,541,3003,0.003003
1039,43,6041,259763,2,8318,2081,1,52648312,52648312,3118,1039,2079,1039,0,1,1041,20195,0.020195
1539,43,6041,259763,2,12318,3081,1,76984312,76984312,4618,1539,3079,1539,0,1,1541,35158,0.035158
2039,43,6041,259763,2,16318,4081,1,101320312,101320312,6118,2039,4079,2039,0,1,2041,3200,0.0032
2539,43,6041,259763,2,20318,5081,1,125656312,125656312,7618,2539,5079,2539,0,1,2541,97974,0.097974
3039,43,6041,259763,2,24318,6081,1,149992312,149992312,9118,3039,6079,3039,0,1,3041,203687,0.203687
3539,43,6041,259763,2,28318,7081,1,174328312,174328312,10618,3539,7079,3539,0,1,3541,51940,0.05194
4039,43,6041,259763,2,32318,8081,1,198664312,198664312,12118,4039,8079,4039,0,1,4041,124708,0.124708
4539,43,6041,259763,2,36318,9081,1,223000312,223000312,13618,4539,9079,4539,0,1,4541,62267,0.062267
5039,43,6041,259763,2,40318,10081,1,247336312,247336312,15118,5039,10079,5039,0,1,5041,95240,0.09524
5539,43,6041,259763,2,44318,11081,1,271672312,271672312,16618,5539,11079,5539,0,1,5541,358259,0.358259
6039,43,6041,259763,2,48318,12081,1,296008312,296008312,18118,6039,12079,6039,0,1,6041,62302,0.062302
6539,43,6041,259763,2,52318,13081,1,320344312,320344312,19618,6539,13079,6539,0,1,6541,422310,0.42231
7039,43,6041,259763,2,56318,14081,1,344680312,344680312,21118,7039,14079,7039,0,1,7041,456181,0.456181
35,40,6545,261800,2,286,73,1,3938200,3938200,106,35,71,35,0,1,37,9288,0.009288
535,40,6545,261800,2,4286,1073,1,30278200,30278200,1606,535,1071,535,0,1,537,37995,0.037995
1035,40,6545,261800,2,8286,2073,1,56618200,56618200,3106,1035,2071,1035,0,1,1037,66049,0.066049
1535,40,6545,261800,2,12286,3073,1,82958200,82958200,4606,1535,3071,1535,0,1,1537,29281,0.029281
2035,40,6545,261800,2,16286,4073,1,109298200,109298200,6106,2035,4071,2035,0,1,2037,132731,0.132731
2535,40,6545,261800,2,20286,5073,1,135638200,135638200,7606,2535,5071,2535,0,1,2537,132000,0.132
3035,40,6545,261800,2,24286,6073,1,161978200,161978200,9106,3035,6071,3035,0,1,3037,61980,0.06198
3535,40,6545,261800,2,28286,7073,1,188318200,188318200,10606,3535,7071,3535,0,1,3537,234510,0.23451
4035,40,6545,261800,2,32286,8073,1,214658200,214658200,12106,4035,8071,4035,0,1,4037,265508,0.265508
4535,40,6545,261800,2,36286,9073,1,240998200,240998200,13606,4535,9071,4535,0,1,4537,298844,0.298844
5035,40,6545,261800,2,40286,10073,1,267338200,267338200,15106,5035,10071,5035,0,1,5037,332457,0.332457
5535,40,6545,261800,2,44286,11073,1,293678200,293678200,16606,5535,11071,5535,0,1,5537,328368,0.328368
6035,40,6545,261800,2,48286,12073,1,320018200,320018200,18106,6035,12071,6035,0,1,6037,319243,0.319243
6535,40,6545,261800,2,52286,13073,1,346358200,346358200,19606,6535,13071,6535,0,1,6537,183554,0.183554
7035,40,6545,261800,2,56286,14073,1,372698200,372698200,21106,7035,14071,7035,0,1,7037,301148,0.301148
40,6550,40,262000,2,326,83,1,4204800,4204800,121,40,81,40,0,1,42,403,0.000403
440,6550,40,262000,2,3526,883,1,25292800,25292800,1321,440,881,440,0,1,442,1029,0.001029
840,6550,40,262000,2,6726,1683,1,46380800,46380800,2521,840,1681,840,0,1,842,61425,0.061425
1240,6550,40,262000,2,9926,2483,1,67468800,67468800,3721,1240,2481,1240,0,1,1242,81335,0.081335
1640,6550,40,262000,2,13126,3283,1,88556800,88556800,4921,1640,3281,1640,0,1,1642,106341,0.106341
2040,6550,40,262000,2,16326,4083,1,109644800,109644800,6121,2040,4081,2040,0,1,2042,20708,0.020708
2440,6550,40,262000,2,19526,4883,1,130732800,130732800,7321,2440,4881,2440,0,1,2442,160126,0.160126
2840,6550,40,262000,2,22726,5683,1,151820800,151820800,8521,2840,5681,2840,0,1,2842,180226,0.180226
3240,6550,40,262000,2,25926,6483,1,172908800,172908800,9721,3240,6481,3240,0,1,3242,203067,0.203067
3640,6550,40,262000,2,29126,7283,1,193996800,193996800,10921,3640,7281,3640,0,1,3642,230838,0.230838
4040,6550,40,262000,2,32326,8083,1,215084800,215084800,12121,4040,8081,4040,0,1,4042,96075,0.096075
4440,6550,40,262000,2,35526,8883,1,236172800,236172800,13321,4440,8881,4440,0,1,4442,258145,0.258145
4840,6550,40,262000,2,38726,9683,1,257260800,257260800,14521,4840,9681,4840,0,1,4842,288181,0.288181
5240,6550,40,262000,2,41926,10483,1,278348800,278348800,15721,5240,10481,5240,0,1,5242,78612,0.078612
5640,6550,40,262000,2,45126,11283,1,299436800,299436800,16921,5640,11281,5640,0,1,5642,135351,0.135351
6040,6550,40,262000,2,48326,12083,1,320524800,320524800,18121,6040,12081,6040,0,1,6042,344514,0.344514
6440,6550,40,262000,2,51526,12883,1,341612800,341612800,19321,6440,12881,6440,0,1,6442,410191,0.410191
6840,6550,40,262000,2,54726,13683,1,362700800,362700800,20521,6840,13681,6840,0,1,6842,14658,0.014658
55,4055,65,263575,2,446,113,1,3921400,3921400,166,55,111,55,0,1,57,6980,0.00698
455,4055,65,263575,2,3646,913,1,17105400,17105400,1366,455,911,455,0,1,457,16708,0.016708
855,4055,65,263575,2,6846,1713,1,30289400,30289400,2566,855,1711,855,0,1,857,50849,0.050849
1255,4055,65,263575,2,10046,2513,1,43473400,43473400,3766,1255,2511,1255,0,1,1257,74522,0.074522
1655,4055,65,263575,2,13246,3313,1,56657400,56657400,4966,1655,3311,1655,0,1,1657,96165,0.096165
2055,4055,65,263575,2,16446,4113,1,69841400,69841400,6166,2055,4111,2055,0,1,2057,109509,0.109509
2455,4055,65,263575,2,19646,4913,1,83025400,83025400,7366,2455,4911,2455,0,1,2457,142651,0.142651
2855,4055,65,263575,2,22846,5713,1,96209400,96209400,8566,2855,5711,2855,0,1,2857,166302,0.166302
3255,4055,65,263575,2,26046,6513,1,109393400,109393400,9766,3255,6511,3255,0,1,3257,49181,0.049181
3655,4055,65,263575,2,29246,7313,1,122577400,122577400,10966,3655,7311,3655,0,1,3657,117948,0.117948
4055,4055,65,263575,2,32446,8113,1,135761400,135761400,12166,4055,8111,4055,0,1,4057,193567,0.193567
4455,4055,65,263575,2,35646,8913,1,148945400,148945400,13366,4455,8911,4455,0,1,4457,260663,0.260663
4855,4055,65,263575,2,38846,9713,1,162129400,162129400,14566,4855,9711,4855,0,1,4857,298869,0.298869
5255,4055,65,263575,2,42046,10513,1,175313400,175313400,15766,5255,10511,5255,0,1,5257,320484,0.320484
5655,4055,65,263575,2,45246,11313,1,188497400,188497400,16966,5655,11311,5655,0,1,5657,352926,0.352926
6055,4055,65,263575,2,48446,12113,1,201681400,201681400,18166,6055,12111,6055,0,1,6057,355049,0.355049
6455,4055,65,263575,2,51646,12913,1,214865400,214865400,19366,6455,12911,6455,0,1,6457,382171,0.382171
6855,4055,65,263575,2,54846,13713,1,228049400,228049400,20566,6855,13711,6855,0,1,6857,404853,0.404853
55,55,4865,267575,2,446,113,1,4305400,4305400,166,55,111,55,0,1,57,853,0.000853
455,55,4865,267575,2,3646,913,1,20049400,20049400,1366,455,911,455,0,1,457,39256,0.039256
855,55,4865,267575,2,6846,1713,1,35793400,35793400,2566,855,1711,855,0,1,857,25067,0.025067
1255,55,4865,267575,2,10046,2513,1,51537400,51537400,3766,1255,2511,1255,0,1,1257,35498,0.035498
1655,55,4865,267575,2,13246,3313,1,67281400,67281400,4966,1655,3311,1655,0,1,1657,24451,0.024451
2055,55,4865,267575,2,16446,4113,1,83025400,83025400,6166,2055,4111,2055,0,1,2057,34997,0.034997
2455,55,4865,267575,2,19646,4913,1,98769400,98769400,7366,2455,4911,2455,0,1,2457,59544,0.059544
2855,55,4865,267575,2,22846,5713,1,114513400,114513400,8566,2855,5711,2855,0,1,2857,11178,0.011178
3255,55,4865,267575,2,26046,6513,1,130257400,130257400,9766,3255,6511,3255,0,1,3257,28230,0.02823
3655,55,4865,267575,2,29246,7313,1,146001400,146001400,10966,3655,7311,3655,0,1,3657,174244,0.174244
4055,55,4865,267575,2,32446,8113,1,161745400,161745400,12166,4055,8111,4055,0,1,4057,32166,0.032166
4455,55,4865,267575,2,35646,8913,1,177489400,177489400,13366,4455,8911,4455,0,1,4457,90228,0.090228
4855,55,4865,267575,2,38846,9713,1,193233400,193233400,14566,4855,9711,4855,0,1,4857,241163,0.241163
5255,55,4865,267575,2,42046,10513,1,208977400,208977400,15766,5255,10511,5255,0,1,5257,19802,0.019802
5655,55,4865,267575,2,45246,11313,1,224721400,224721400,16966,5655,11311,5655,0,1,5657,110875,0.110875
6055,55,4865,267575,2,48446,12113,1,240465400,240465400,18166,6055,12111,6055,0,1,6057,333260,0.33326
6455,55,4865,267575,2,51646,12913,1,256209400,256209400,19366,6455,12911,6455,0,1,6457,203397,0.203397
6855,55,4865,267575,2,54846,13713,1,271953400,271953400,20566,6855,13711,6855,0,1,6857,130380,0.13038
44,53,5055,267915,2,358,91,1,3941336,3941336,133,44,89,44,0,1,46,9876,0.009876
544,53,5055,267915,2,4358,1091,1,24373336,24373336,1633,544,1089,544,0,1,546,3066,0.003066
1044,53,5055,267915,2,8358,2091,1,44805336,44805336,3133,1044,2089,1044,0,1,1046,3904,0.003904
1544,53,5055,267915,2,12358,3091,1,65237336,65237336,4633,1544,3089,1544,0,1,1546,5478,0.005478
2044,53,5055,267915,2,16358,4091,1,85669336,85669336,6133,2044,4089,2044,0,1,2046,94893,0.094893
2544,53,5055,267915,2,20358,5091,1,106101336,106101336,7633,2544,5089,2544,0,1,2546,61981,0.061981
3044,53,5055,267915,2,24358,6091,1,126533336,126533336,9133,3044,6089,3044,0,1,3046,106021,0.106021
3544,53,5055,267915,2,28358,7091,1,146965336,146965336,10633,3544,7089,3544,0,1,3546,126208,0.126208
4044,53,5055,267915,2,32358,8091,1,167397336,167397336,12133,4044,8089,4044,0,1,4046,178454,0.178454
4544,53,5055,267915,2,36358,9091,1,187829336,187829336,13633,4544,9089,4544,0,1,4546,267695,0.267695
5044,53,5055,267915,2,40358,10091,1,208261336,208261336,15133,5044,10089,5044,0,1,5046,291741,0.291741
5544,53,5055,267915,2,44358,11091,1,228693336,228693336,16633,5544,11089,5544,0,1,5546,28284,0.028284
6044,53,5055,267915,2,48358,12091,1,249125336,249125336,18133,6044,12089,6044,0,1,6046,61305,0.061305
6544,53,5055,267915,2,52358,13091,1,269557336,269557336,19633,6544,13089,6544,0,1,6546,185925,0.185925
7044,53,5055,267915,2,56358,14091,1,289989336,289989336,21133,7044,14089,7044,0,1,7046,181583,0.181583
40,50,5440,272000,2,326,83,1,3932800,3932800,121,40,81,40,0,1,42,10311,0.010311
440,50,5440,272000,2,3526,883,1,21500800,21500800,1321,440,881,440,0,1,442,15832,0.015832
840,50,5440,272000,2,6726,1683,1,39068800,39068800,2521,840,1681,840,0,1,842,8238,0.008238
1240,50,5440,272000,2,9926,2483,1,56636800,56636800,3721,1240,2481,1240,0,1,1242,6563,0.006563
1640,50,5440,272000,2,13126,3283,1,74204800,74204800,4921,1640,3281,1640,0,1,1642,112856,0.112856
2040,50,5440,272000,2,16326,4083,1,91772800,91772800,6121,2040,4081,2040,0,1,2042,7674,0.007674
2440,50,5440,272000,2,19526,4883,1,109340800,109340800,7321,2440,4881,2440,0,1,2442,147689,0.147689
2840,50,5440,272000,2,22726,5683,1,126908800,126908800,8521,2840,5681,2840,0,1,2842,133902,0.133902
3240,50,5440,272000,2,25926,6483,1,144476800,144476800,9721,3240,6481,3240,0,1,3242,89948,0.089948
3640,50,5440,272000,2,29126,7283,1,162044800,162044800,10921,3640,7281,3640,0,1,3642,87973,0.087973
4040,50,5440,272000,2,32326,8083,1,179612800,179612800,12121,4040,8081,4040,0,1,4042,85901,0.085901
4440,50,5440,272000,2,35526,8883,1,197180800,197180800,13321,4440,8881,4440,0,1,4442,286168,0.286168
4840,50,5440,272000,2,38726,9683,1,214748800,214748800,14521,4840,9681,4840,0,1,4842,17757,0.017757
5240,50,5440,272000,2,41926,10483,1,232316800,232316800,15721,5240,10481,5240,0,1,5242,29312,0.029312
5640,50,5440,272000,2,45126,11283,1,249884800,249884800,16921,5640,11281,5640,0,1,5642,216285,0.216285
6040,50,5440,272000,2,48326,12083,1,267452800,267452800,18121,6040,12081,6040,0,1,6042,388088,0.388088
6440,50,5440,272000,2,51526,12883,1,285020800,285020800,19321,6440,12881,6440,0,1,6442,412948,0.412948
6840,50,5440,272000,2,54726,13683,1,302588800,302588800,20521,6840,13681,6840,0,1,6842,170543,0.170543
40,800,340,272000,2,326,83,1,2540800,2540800,121,40,81,40,0,1,42,6102,0.006102
440,800,340,272000,2,3526,883,1,6188800,6188800,1321,440,881,440,0,1,442,28049,0.028049
840,800,340,272000,2,6726,1683,1,9836800,9836800,2521,840,1681,840,0,1,842,47910,0.04791
1240,800,340,272000,2,9926,2483,1,13484800,13484800,3721,1240,2481,1240,0,1,1242,10874,0.010874
1640,800,340,272000,2,13126,3283,1,17132800,17132800,4921,1640,3281,1640,0,1,1642,88779,0.088779
2040,800,340,272000,2,16326,4083,1,20780800,20780800,6121,2040,4081,2040,0,1,2042,112141,0.112141
2440,800,340,272000,2,19526,4883,1,24428800,24428800,7321,2440,4881,2440,0,1,2442,135258,0.135258
2840,800,340,272000,2,22726,5683,1,28076800,28076800,8521,2840,5681,2840,0,1,2842,152582,0.152582
3240,800,340,272000,2,25926,6483,1,31724800,31724800,9721,3240,6481,3240,0,1,3242,113519,0.113519
3640,800,340,272000,2,29126,7283,1,35372800,35372800,10921,3640,7281,3640,0,1,3642,140725,0.140725
4040,800,340,272000,2,32326,8083,1,39020800,39020800,12121,4040,8081,4040,0,1,4042,219643,0.219643
4440,800,340,272000,2,35526,8883,1,42668800,42668800,13321,4440,8881,4440,0,1,4442,242735,0.242735
4840,800,340,272000,2,38726,9683,1,46316800,46316800,14521,4840,9681,4840,0,1,4842,262277,0.262277
5240,800,340,272000,2,41926,10483,1,49964800,49964800,15721,5240,10481,5240,0,1,5242,284747,0.284747
5640,800,340,272000,2,45126,11283,1,53612800,53612800,16921,5640,11281,5640,0,1,5642,70030,0.07003
6040,800,340,272000,2,48326,12083,1,57260800,57260800,18121,6040,12081,6040,0,1,6042,329519,0.329519
6440,800,340,272000,2,51526,12883,1,60908800,60908800,19321,6440,12881,6440,0,1,6442,14012,0.014012
6840,800,340,272000,2,54726,13683,1,64556800,64556800,20521,6840,13681,6840,0,1,6842,372157,0.372157
40,6800,40,272000,2,326,83,1,4364800,4364800,121,40,81,40,0,1,42,38037,0.038037
440,6800,40,272000,2,3526,883,1,26252800,26252800,1321,440,881,440,0,1,442,34432,0.034432
840,6800,40,272000,2,6726,1683,1,48140800,48140800,2521,840,1681,840,0,1,842,61322,0.061322
1240,6800,40,272000,2,9926,2483,1,70028800,70028800,3721,1240,2481,1240,0,1,1242,88943,0.088943
1640,6800,40,272000,2,13126,3283,1,91916800,91916800,4921,1640,3281,1640,0,1,1642,112097,0.112097
2040,6800,40,272000,2,16326,4083,1,113804800,113804800,6121,2040,4081,2040,0,1,2042,138043,0.138043
2440,6800,40,272000,2,19526,4883,1,135692800,135692800,7321,2440,4881,2440,0,1,2442,59158,0.059158
2840,6800,40,272000,2,22726,5683,1,157580800,157580800,8521,2840,5681,2840,0,1,2842,189111,0.189111
3240,6800,40,272000,2,25926,6483,1,179468800,179468800,9721,3240,6481,3240,0,1,3242,237547,0.237547
3640,6800,40,272000,2,29126,7283,1,201356800,201356800,10921,3640,7281,3640,0,1,3642,257160,0.25716
4040,6800,40,272000,2,32326,8083,1,223244800,223244800,12121,4040,8081,4040,0,1,4042,287292,0.287292
4440,6800,40,272000,2,35526,8883,1,245132800,245132800,13321,4440,8881,4440,0,1,4442,319880,0.31988
4840,6800,40,272000,2,38726,9683,1,267020800,267020800,14521,4840,9681,4840,0,1,4842,348921,0.348921
5240,6800,40,272000,2,41926,10483,1,288908800,288908800,15721,5240,10481,5240,0,1,5242,366594,0.366594
5640,6800,40,272000,2,45126,11283,1,310796800,310796800,16921,5640,11281,5640,0,1,5642,395556,0.395556
6040,6800,40,272000,2,48326,12083,1,332684800,332684800,18121,6040,12081,6040,0,1,6042,433680,0.43368
6440,6800,40,272000,2,51526,12883,1,354572800,354572800,19321,6440,12881,6440,0,1,6442,454715,0.454715
6840,6800,40,272000,2,54726,13683,1,376460800,376460800,20521,6840,13681,6840,0,1,6842,473165,0.473165
35,6050,45,272250,2,286,73,1,3884600,3884600,106,35,71,35,0,1,37,682,0.000682
535,6050,45,272250,2,4286,1073,1,28264600,28264600,1606,535,1071,535,0,1,537,15627,0.015627
1035,6050,45,272250,2,8286,2073,1,52644600,52644600,3106,1035,2071,1035,0,1,1037,82191,0.082191
1535,6050,45,272250,2,12286,3073,1,77024600,77024600,4606,1535,3071,1535,0,1,1537,105657,0.105657
2035,6050,45,272250,2,16286,4073,1,101404600,101404600,6106,2035,4071,2035,0,1,2037,145859,0.145859
2535,6050,45,272250,2,20286,5073,1,125784600,125784600,7606,2535,5071,2535,0,1,2537,170717,0.170717
3035,6050,45,272250,2,24286,6073,1,150164600,150164600,9106,3035,6071,3035,0,1,3037,194917,0.194917
3535,6050,45,272250,2,28286,7073,1,174544600,174544600,10606,3535,7071,3535,0,1,3537,250637,0.250637
4035,6050,45,272250,2,32286,8073,1,198924600,198924600,12106,4035,8071,4035,0,1,4037,274841,0.274841
4535,6050,45,272250,2,36286,9073,1,223304600,223304600,13606,4535,9071,4535,0,1,4537,295542,0.295542
5035,6050,45,272250,2,40286,10073,1,247684600,247684600,15106,5035,10071,5035,0,1,5037,350490,0.35049
5535,6050,45,272250,2,44286,11073,1,272064600,272064600,16606,5535,11071,5535,0,1,5537,369168,0.369168
6035,6050,45,272250,2,48286,12073,1,296444600,296444600,18106,6035,12071,6035,0,1,6037,389960,0.38996
6535,6050,45,272250,2,52286,13073,1,320824600,320824600,19606,6535,13071,6535,0,1,6537,424069,0.424069
7035,6050,45,272250,2,56286,14073,1,345204600,345204600,21106,7035,14071,7035,0,1,7037,461944,0.461944
39,6643,41,272363,2,318,81,1,4264312,4264312,118,39,79,39,0,1,41,465,0.000465
539,6643,41,272363,2,4318,1081,1,31000312,31000312,1618,539,1079,539,0,1,541,39771,0.039771
1039,6643,41,272363,2,8318,2081,1,57736312,57736312,3118,1039,2079,1039,0,1,1041,2646,0.002646
1539,6643,41,272363,2,12318,3081,1,84472312,84472312,4618,1539,3079,1539,0,1,1541,24384,0.024384
2039,6643,41,272363,2,16318,4081,1,111208312,111208312,6118,2039,4079,2039,0,1,2041,138552,0.138552
2539,6643,41,272363,2,20318,5081,1,137944312,137944312,7618,2539,5079,2539,0,1,2541,183938,0.183938
3039,6643,41,272363,2,24318,6081,1,164680312,164680312,9118,3039,6079,3039,0,1,3041,222481,0.222481
3539,6643,41,272363,2,28318,7081,1,191416312,191416312,10618,3539,7079,3539,0,1,3541,237945,0.237945
4039,6643,41,272363,2,32318,8081,1,218152312,218152312,12118,4039,8079,4039,0,1,4041,274346,0.274346
4539,6643,41,272363,2,36318,9081,1,244888312,244888312,13618,4539,9079,4539,0,1,4541,322046,0.322046
5039,6643,41,272363,2,40318,10081,1,271624312,271624312,15118,5039,10079,5039,0,1,5041,353781,0.353781
5539,6643,41,272363,2,44318,11081,1,298360312,298360312,16618,5539,11079,5539,0,1,5541,398392,0.398392
6039,6643,41,272363,2,48318,12081,1,325096312,325096312,18118,6039,12079,6039,0,1,6041,116134,0.116134
6539,6643,41,272363,2,52318,13081,1,351832312,351832312,19618,6539,13079,6539,0,1,6541,462499,0.462499
7039,6643,41,272363,2,56318,14081,1,378568312,378568312,21118,7039,14079,7039,0,1,7041,471407,0.471407
35,6090,45,274050,2,286,73,1,3910200,3910200,106,35,71,35,0,1,37,958,0.000958
535,6090,45,274050,2,4286,1073,1,28450200,28450200,1606,535,1071,535,0,1,537,40527,0.040527
1035,6090,45,274050,2,8286,2073,1,52990200,52990200,3106,1035,2071,1035,0,1,1037,70233,0.070233
1535,6090,45,274050,2,12286,3073,1,77530200,77530200,4606,1535,3071,1535,0,1,1537,110874,0.110874
44,5003,55,275165,2,358,91,1,3981736,3981736,133,44,89,44,0,1,46,27545,0.027545
544,5003,55,275165,2,4358,1091,1,24213736,24213736,1633,544,1089,544,0,1,546,39383,0.039383
1044,5003,55,275165,2,8358,2091,1,44445736,44445736,3133,1044,2089,1044,0,1,1046,72257,0.072257
1544,5003,55,275165,2,12358,3091,1,64677736,64677736,4633,1544,3089,1544,0,1,1546,101487,0.101487
2044,5003,55,275165,2,16358,4091,1,84909736,84909736,6133,2044,4089,2044,0,1,2046,134581,0.134581
2544,5003,55,275165,2,20358,5091,1,105141736,105141736,7633,2544,5089,2544,0,1,2546,165056,0.165056
3044,5003,55,275165,2,24358,6091,1,125373736,125373736,9133,3044,6089,3044,0,1,3046,202165,0.202165
3544,5003,55,275165,2,28358,7091,1,145605736,145605736,10633,3544,7089,3544,0,1,3546,238586,0.238586
4044,5003,55,275165,2,32358,8091,1,165837736,165837736,12133,4044,8089,4044,0,1,4046,262100,0.2621
4544,5003,55,275165,2,36358,9091,1,186069736,186069736,13633,4544,9089,4544,0,1,4546,297719,0.297719
5044,5003,55,275165,2,40358,10091,1,206301736,206301736,15133,5044,10089,5044,0,1,5046,338937,0.338937
5544,5003,55,275165,2,44358,11091,1,226533736,226533736,16633,5544,11089,5544,0,1,5546,355234,0.355234
6044,5003,55,275165,2,48358,12091,1,246765736,246765736,18133,6044,12089,6044,0,1,6046,382247,0.382247
6544,5003,55,275165,2,52358,13091,1,266997736,266997736,19633,6544,13089,6544,0,1,6546,450515,0.450515
7044,5003,55,275165,2,56358,14091,1,287229736,287229736,21133,7044,14089,7044,0,1,7046,438794,0.438794
55,4305,65,279825,2,446,113,1,4161400,4161400,166,55,111,55,0,1,57,28875,0.028875
455,4305,65,279825,2,3646,913,1,18145400,18145400,1366,455,911,455,0,1,457,30870,0.03087
855,4305,65,279825,2,6846,1713,1,32129400,32129400,2566,855,1711,855,0,1,857,54613,0.054613
1255,4305,65,279825,2,10046,2513,1,46113400,46113400,3766,1255,2511,1255,0,1,1257,83131,0.083131
1655,4305,65,279825,2,13246,3313,1,60097400,60097400,4966,1655,3311,1655,0,1,1657,103757,0.103757
2055,4305,65,279825,2,16446,4113,1,74081400,74081400,6166,2055,4111,2055,0,1,2057,134627,0.134627
2455,4305,65,279825,2,19646,4913,1,88065400,88065400,7366,2455,4911,2455,0,1,2457,157471,0.157471
2855,4305,65,279825,2,22846,5713,1,102049400,102049400,8566,2855,5711,2855,0,1,2857,157835,0.157835
3255,4305,65,279825,2,26046,6513,1,116033400,116033400,9766,3255,6511,3255,0,1,3257,200473,0.200473
3655,4305,65,279825,2,29246,7313,1,130017400,130017400,10966,3655,7311,3655,0,1,3657,237321,0.237321
4055,4305,65,279825,2,32446,8113,1,144001400,144001400,12166,4055,8111,4055,0,1,4057,256014,0.256014
4455,4305,65,279825,2,35646,8913,1,157985400,157985400,13366,4455,8911,4455,0,1,4457,272807,0.272807
4855,4305,65,279825,2,38846,9713,1,171969400,171969400,14566,4855,9711,4855,0,1,4857,307617,0.307617
5255,4305,65,279825,2,42046,10513,1,185953400,185953400,15766,5255,10511,5255,0,1,5257,336112,0.336112
5655,4305,65,279825,2,45246,11313,1,199937400,199937400,16966,5655,11311,5655,0,1,5657,369979,0.369979
6055,4305,65,279825,2,48446,12113,1,213921400,213921400,18166,6055,12111,6055,0,1,6057,391064,0.391064
6455,4305,65,279825,2,51646,12913,1,227905400,227905400,19366,6455,12911,6455,0,1,6457,419900,0.4199
6855,4305,65,279825,2,54846,13713,1,241889400,241889400,20566,6855,13711,6855,0,1,6857,434626,0.434626
39,43,6541,281263,2,318,81,1,4304312,4304312,118,39,79,39,0,1,41,9396,0.009396
539,43,6541,281263,2,4318,1081,1,30640312,30640312,1618,539,1079,539,0,1,541,4462,0.004462
1039,43,6541,281263,2,8318,2081,1,56976312,56976312,3118,1039,2079,1039,0,1,1041,21747,0.021747
1539,43,6541,281263,2,12318,3081,1,83312312,83312312,4618,1539,3079,1539,0,1,1541,6998,0.006998
2039,43,6541,281263,2,16318,4081,1,109648312,109648312,6118,2039,4079,2039,0,1,2041,138220,0.13822
2539,43,6541,281263,2,20318,5081,1,135984312,135984312,7618,2539,5079,2539,0,1,2541,186458,0.186458
3039,43,6541,281263,2,24318,6081,1,162320312,162320312,9118,3039,6079,3039,0,1,3041,95479,0.095479
3539,43,6541,281263,2,28318,7081,1,188656312,188656312,10618,3539,7079,3539,0,1,3541,251871,0.251871
4039,43,6541,281263,2,32318,8081,1,214992312,214992312,12118,4039,8079,4039,0,1,4041,47082,0.047082
4539,43,6541,281263,2,36318,9081,1,241328312,241328312,13618,4539,9079,4539,0,1,4541,322263,0.322263
5039,43,6541,281263,2,40318,10081,1,267664312,267664312,15118,5039,10079,5039,0,1,5041,353351,0.353351
5539,43,6541,281263,2,44318,11081,1,294000312,294000312,16618,5539,11079,5539,0,1,5541,167346,0.167346
6039,43,6541,281263,2,48318,12081,1,320336312,320336312,18118,6039,12079,6039,0,1,6041,282792,0.282792
6539,43,6541,281263,2,52318,13081,1,346672312,346672312,19618,6539,13079,6539,0,1,6541,318619,0.318619
7039,43,6541,281263,2,56318,14081,1,373008312,373008312,21118,7039,14079,7039,0,1,7041,237997,0.237997
35,40,7045,281800,2,286,73,1,4238200,4238200,106,35,71,35,0,1,37,7210,0.00721
535,40,7045,281800,2,4286,1073,1,32578200,32578200,1606,535,1071,535,0,1,537,14917,0.014917
1035,40,7045,281800,2,8286,2073,1,60918200,60918200,3106,1035,2071,1035,0,1,1037,77515,0.077515
1535,40,7045,281800,2,12286,3073,1,89258200,89258200,4606,1535,3071,1535,0,1,1537,112423,0.112423
2035,40,7045,281800,2,16286,4073,1,117598200,117598200,6106,2035,4071,2035,0,1,2037,147233,0.147233
2535,40,7045,281800,2,20286,5073,1,145938200,145938200,7606,2535,5071,2535,0,1,2537,181086,0.181086
3035,40,7045,281800,2,24286,6073,1,174278200,174278200,9106,3035,6071,3035,0,1,3037,215983,0.215983
3535,40,7045,281800,2,28286,7073,1,202618200,202618200,10606,3535,7071,3535,0,1,3537,279242,0.279242
4035,40,7045,281800,2,32286,8073,1,230958200,230958200,12106,4035,8071,4035,0,1,4037,283667,0.283667
4535,40,7045,281800,2,36286,9073,1,259298200,259298200,13606,4535,9071,4535,0,1,4537,242210,0.24221
5035,40,7045,281800,2,40286,10073,1,287638200,287638200,15106,5035,10071,5035,0,1,5037,353981,0.353981
5535,40,7045,281800,2,44286,11073,1,315978200,315978200,16606,5535,11071,5535,0,1,5537,388561,0.388561
6035,40,7045,281800,2,48286,12073,1,344318200,344318200,18106,6035,12071,6035,0,1,6037,239151,0.239151
6535,40,7045,281800,2,52286,13073,1,372658200,372658200,19606,6535,13071,6535,0,1,6537,457248,0.457248
7035,40,7045,281800,2,56286,14073,1,400998200,400998200,21106,7035,14071,7035,0,1,7037,494568,0.494568
40,300,940,282000,2,326,83,1,2652800,2652800,121,40,81,40,0,1,42,6381,0.006381
440,300,940,282000,2,3526,883,1,6620800,6620800,1321,440,881,440,0,1,442,27605,0.027605
840,300,940,282000,2,6726,1683,1,10588800,10588800,2521,840,1681,840,0,1,842,2740,0.00274
1240,300,940,282000,2,9926,2483,1,14556800,14556800,3721,1240,2481,1240,0,1,1242,71937,0.071937
1640,300,940,282000,2,13126,3283,1,18524800,18524800,4921,1640,3281,1640,0,1,1642,93606,0.093606
2040,300,940,282000,2,16326,4083,1,22492800,22492800,6121,2040,4081,2040,0,1,2042,116307,0.116307
2440,300,940,282000,2,19526,4883,1,26460800,26460800,7321,2440,4881,2440,0,1,2442,138296,0.138296
2840,300,940,282000,2,22726,5683,1,30428800,30428800,8521,2840,5681,2840,0,1,2842,160069,0.160069
3240,300,940,282000,2,25926,6483,1,34396800,34396800,9721,3240,6481,3240,0,1,3242,182227,0.182227
3640,300,940,282000,2,29126,7283,1,38364800,38364800,10921,3640,7281,3640,0,1,3642,208058,0.208058
4040,300,940,282000,2,32326,8083,1,42332800,42332800,12121,4040,8081,4040,0,1,4042,69239,0.069239
4440,300,940,282000,2,35526,8883,1,46300800,46300800,13321,4440,8881,4440,0,1,4442,249064,0.249064
4840,300,940,282000,2,38726,9683,1,50268800,50268800,14521,4840,9681,4840,0,1,4842,275764,0.275764
5240,300,940,282000,2,41926,10483,1,54236800,54236800,15721,5240,10481,5240,0,1,5242,182334,0.182334
5640,300,940,282000,2,45126,11283,1,58204800,58204800,16921,5640,11281,5640,0,1,5642,318559,0.318559
6040,300,940,282000,2,48326,12083,1,62172800,62172800,18121,6040,12081,6040,0,1,6042,339739,0.339739
6440,300,940,282000,2,51526,12883,1,66140800,66140800,19321,6440,12881,6440,0,1,6442,362384,0.362384
6840,300,940,282000,2,54726,13683,1,70108800,70108800,20521,6840,13681,6840,0,1,6842,385575,0.385575
40,7050,40,282000,2,326,83,1,4524800,4524800,121,40,81,40,0,1,42,37443,0.037443
440,7050,40,282000,2,3526,883,1,27212800,27212800,1321,440,881,440,0,1,442,32761,0.032761
840,7050,40,282000,2,6726,1683,1,49900800,49900800,2521,840,1681,840,0,1,842,63309,0.063309
1240,7050,40,282000,2,9926,2483,1,72588800,72588800,3721,1240,2481,1240,0,1,1242,91441,0.091441
1640,7050,40,282000,2,13126,3283,1,95276800,95276800,4921,1640,3281,1640,0,1,1642,111971,0.111971
2040,7050,40,282000,2,16326,4083,1,117964800,117964800,6121,2040,4081,2040,0,1,2042,139057,0.139057
2440,7050,40,282000,2,19526,4883,1,140652800,140652800,7321,2440,4881,2440,0,1,2442,183421,0.183421
2840,7050,40,282000,2,22726,5683,1,163340800,163340800,8521,2840,5681,2840,0,1,2842,209717,0.209717
3240,7050,40,282000,2,25926,6483,1,186028800,186028800,9721,3240,6481,3240,0,1,3242,221710,0.22171
3640,7050,40,282000,2,29126,7283,1,208716800,208716800,10921,3640,7281,3640,0,1,3642,246572,0.246572
4040,7050,40,282000,2,32326,8083,1,231404800,231404800,12121,4040,8081,4040,0,1,4042,286317,0.286317
4440,7050,40,282000,2,35526,8883,1,254092800,254092800,13321,4440,8881,4440,0,1,4442,320809,0.320809
4840,7050,40,282000,2,38726,9683,1,276780800,276780800,14521,4840,9681,4840,0,1,4842,354930,0.35493
5240,7050,40,282000,2,41926,10483,1,299468800,299468800,15721,5240,10481,5240,0,1,5242,360500,0.3605
5640,7050,40,282000,2,45126,11283,1,322156800,322156800,16921,5640,11281,5640,0,1,5642,384703,0.384703
6040,7050,40,282000,2,48326,12083,1,344844800,344844800,18121,6040,12081,6040,0,1,6042,412759,0.412759
6440,7050,40,282000,2,51526,12883,1,367532800,367532800,19321,6440,12881,6440,0,1,6442,464153,0.464153
6840,7050,40,282000,2,54726,13683,1,390220800,390220800,20521,6840,13681,6840,0,1,6842,493069,0.493069
55,55,5165,284075,2,446,113,1,4569400,4569400,166,55,111,55,0,1,57,12228,0.012228
455,55,5165,284075,2,3646,913,1,21273400,21273400,1366,455,911,455,0,1,457,11779,0.011779
855,55,5165,284075,2,6846,1713,1,37977400,37977400,2566,855,1711,855,0,1,857,29273,0.029273
1255,55,5165,284075,2,10046,2513,1,54681400,54681400,3766,1255,2511,1255,0,1,1257,3911,0.003911
1655,55,5165,284075,2,13246,3313,1,71385400,71385400,4966,1655,3311,1655,0,1,1657,122647,0.122647
2055,55,5165,284075,2,16446,4113,1,88089400,88089400,6166,2055,4111,2055,0,1,2057,7436,0.007436
2455,55,5165,284075,2,19646,4913,1,104793400,104793400,7366,2455,4911,2455,0,1,2457,166612,0.166612
2855,55,5165,284075,2,22846,5713,1,121497400,121497400,8566,2855,5711,2855,0,1,2857,109732,0.109732
3255,55,5165,284075,2,26046,6513,1,138201400,138201400,9766,3255,6511,3255,0,1,3257,92260,0.09226
3655,55,5165,284075,2,29246,7313,1,154905400,154905400,10966,3655,7311,3655,0,1,3657,42164,0.042164
4055,55,5165,284075,2,32446,8113,1,171609400,171609400,12166,4055,8111,4055,0,1,4057,47587,0.047587
4455,55,5165,284075,2,35646,8913,1,188313400,188313400,13366,4455,8911,4455,0,1,4457,15571,0.015571
4855,55,5165,284075,2,38846,9713,1,205017400,205017400,14566,4855,9711,4855,0,1,4857,133587,0.133587
5255,55,5165,284075,2,42046,10513,1,221721400,221721400,15766,5255,10511,5255,0,1,5257,350811,0.350811
5655,55,5165,284075,2,45246,11313,1,238425400,238425400,16966,5655,11311,5655,0,1,5657,241253,0.241253
6055,55,5165,284075,2,48446,12113,1,255129400,255129400,18166,6055,12111,6055,0,1,6057,58274,0.058274
6455,55,5165,284075,2,51646,12913,1,271833400,271833400,19366,6455,12911,6455,0,1,6457,62574,0.062574
6855,55,5165,284075,2,54846,13713,1,288537400,288537400,20566,6855,13711,6855,0,1,6857,457519,0.457519
40,50,5740,287000,2,326,83,1,4148800,4148800,121,40,81,40,0,1,42,6794,0.006794
440,50,5740,287000,2,3526,883,1,22676800,22676800,1321,440,881,440,0,1,442,6495,0.006495
840,50,5740,287000,2,6726,1683,1,41204800,41204800,2521,840,1681,840,0,1,842,14254,0.014254
1240,50,5740,287000,2,9926,2483,1,59732800,59732800,3721,1240,2481,1240,0,1,1242,11196,0.011196
1640,50,5740,287000,2,13126,3283,1,78260800,78260800,4921,1640,3281,1640,0,1,1642,116970,0.11697
2040,50,5740,287000,2,16326,4083,1,96788800,96788800,6121,2040,4081,2040,0,1,2042,52485,0.052485
2440,50,5740,287000,2,19526,4883,1,115316800,115316800,7321,2440,4881,2440,0,1,2442,29952,0.029952
2840,50,5740,287000,2,22726,5683,1,133844800,133844800,8521,2840,5681,2840,0,1,2842,116773,0.116773
3240,50,5740,287000,2,25926,6483,1,152372800,152372800,9721,3240,6481,3240,0,1,3242,223856,0.223856
3640,50,5740,287000,2,29126,7283,1,170900800,170900800,10921,3640,7281,3640,0,1,3642,19218,0.019218
4040,50,5740,287000,2,32326,8083,1,189428800,189428800,12121,4040,8081,4040,0,1,4042,154981,0.154981
4440,50,5740,287000,2,35526,8883,1,207956800,207956800,13321,4440,8881,4440,0,1,4442,98612,0.098612
4840,50,5740,287000,2,38726,9683,1,226484800,226484800,14521,4840,9681,4840,0,1,4842,46604,0.046604
5240,50,5740,287000,2,41926,10483,1,245012800,245012800,15721,5240,10481,5240,0,1,5242,159239,0.159239
5640,50,5740,287000,2,45126,11283,1,263540800,263540800,16921,5640,11281,5640,0,1,5642,21757,0.021757
6040,50,5740,287000,2,48326,12083,1,282068800,282068800,18121,6040,12081,6040,0,1,6042,135202,0.135202
6440,50,5740,287000,2,51526,12883,1,300596800,300596800,19321,6440,12881,6440,0,1,6442,94501,0.094501
6840,50,5740,287000,2,54726,13683,1,319124800,319124800,20521,6840,13681,6840,0,1,6842,465901,0.465901
55,805,365,293825,2,446,113,1,2865400,2865400,166,55,111,55,0,1,57,7328,0.007328
455,805,365,293825,2,3646,913,1,6609400,6609400,1366,455,911,455,0,1,457,29269,0.029269
855,805,365,293825,2,6846,1713,1,10353400,10353400,2566,855,1711,855,0,1,857,54473,0.054473
1255,805,365,293825,2,10046,2513,1,14097400,14097400,3766,1255,2511,1255,0,1,1257,75191,0.075191
1655,805,365,293825,2,13246,3313,1,17841400,17841400,4966,1655,3311,1655,0,1,1657,98514,0.098514
2055,805,365,293825,2,16446,4113,1,21585400,21585400,6166,2055,4111,2055,0,1,2057,120570,0.12057
2455,805,365,293825,2,19646,4913,1,25329400,25329400,7366,2455,4911,2455,0,1,2457,145204,0.145204
2855,805,365,293825,2,22846,5713,1,29073400,29073400,8566,2855,5711,2855,0,1,2857,168409,0.168409
3255,805,365,293825,2,26046,6513,1,32817400,32817400,9766,3255,6511,3255,0,1,3257,193343,0.193343
3655,805,365,293825,2,29246,7313,1,36561400,36561400,10966,3655,7311,3655,0,1,3657,214151,0.214151
4055,805,365,293825,2,32446,8113,1,40305400,40305400,12166,4055,8111,4055,0,1,4057,238260,0.23826
4455,805,365,293825,2,35646,8913,1,44049400,44049400,13366,4455,8911,4455,0,1,4457,260883,0.260883
4855,805,365,293825,2,38846,9713,1,47793400,47793400,14566,4855,9711,4855,0,1,4857,286447,0.286447
5255,805,365,293825,2,42046,10513,1,51537400,51537400,15766,5255,10511,5255,0,1,5257,308042,0.308042
5655,805,365,293825,2,45246,11313,1,55281400,55281400,16966,5655,11311,5655,0,1,5657,332851,0.332851
6055,805,365,293825,2,48446,12113,1,59025400,59025400,18166,6055,12111,6055,0,1,6057,356497,0.356497
6455,805,365,293825,2,51646,12913,1,62769400,62769400,19366,6455,12911,6455,0,1,6457,380478,0.380478
6855,805,365,293825,2,54846,13713,1,66513400,66513400,20566,6855,13711,6855,0,1,6857,409235,0.409235
55,305,965,294325,2,446,113,1,2913400,2913400,166,55,111,55,0,1,57,7545,0.007545
455,305,965,294325,2,3646,913,1,6977400,6977400,1366,455,911,455,0,1,457,30237,0.030237
855,305,965,294325,2,6846,1713,1,11041400,11041400,2566,855,1711,855,0,1,857,53317,0.053317
1255,305,965,294325,2,10046,2513,1,15105400,15105400,3766,1255,2511,1255,0,1,1257,77300,0.0773
1655,305,965,294325,2,13246,3313,1,19169400,19169400,4966,1655,3311,1655,0,1,1657,100382,0.100382
2055,305,965,294325,2,16446,4113,1,23233400,23233400,6166,2055,4111,2055,0,1,2057,19988,0.019988
2455,305,965,294325,2,19646,4913,1,27297400,27297400,7366,2455,4911,2455,0,1,2457,150175,0.150175
2855,305,965,294325,2,22846,5713,1,31361400,31361400,8566,2855,5711,2855,0,1,2857,7743,0.007743
3255,305,965,294325,2,26046,6513,1,35425400,35425400,9766,3255,6511,3255,0,1,3257,193794,0.193794
3655,305,965,294325,2,29246,7313,1,39489400,39489400,10966,3655,7311,3655,0,1,3657,71113,0.071113
4055,305,965,294325,2,32446,8113,1,43553400,43553400,12166,4055,8111,4055,0,1,4057,107418,0.107418
4455,305,965,294325,2,35646,8913,1,47617400,47617400,13366,4455,8911,4455,0,1,4457,132289,0.132289
4855,305,965,294325,2,38846,9713,1,51681400,51681400,14566,4855,9711,4855,0,1,4857,290257,0.290257
5255,305,965,294325,2,42046,10513,1,55745400,55745400,15766,5255,10511,5255,0,1,5257,313139,0.313139
5655,305,965,294325,2,45246,11313,1,59809400,59809400,16966,5655,11311,5655,0,1,5657,338940,0.33894
6055,305,965,294325,2,48446,12113,1,63873400,63873400,18166,6055,12111,6055,0,1,6057,361447,0.361447
6455,305,965,294325,2,51646,12913,1,67937400,67937400,19366,6455,12911,6455,0,1,6457,27776,0.027776
6855,305,965,294325,2,54846,13713,1,72001400,72001400,20566,6855,13711,6855,0,1,6857,411908,0.411908
44,53,5555,294415,2,358,91,1,4329336,4329336,133,44,89,44,0,1,46,2583,0.002583
544,53,5555,294415,2,4358,1091,1,26761336,26761336,1633,544,1089,544,0,1,546,3422,0.003422
1044,53,5555,294415,2,8358,2091,1,49193336,49193336,3133,1044,2089,1044,0,1,1046,4114,0.004114
1544,53,5555,294415,2,12358,3091,1,71625336,71625336,4633,1544,3089,1544,0,1,1546,5994,0.005994
2044,53,5555,294415,2,16358,4091,1,94057336,94057336,6133,2044,4089,2044,0,1,2046,56580,0.05658
2544,53,5555,294415,2,20358,5091,1,116489336,116489336,7633,2544,5089,2544,0,1,2546,71312,0.071312
3044,53,5555,294415,2,24358,6091,1,138921336,138921336,9133,3044,6089,3044,0,1,3046,34352,0.034352
3544,53,5555,294415,2,28358,7091,1,161353336,161353336,10633,3544,7089,3544,0,1,3546,82817,0.082817
4044,53,5555,294415,2,32358,8091,1,183785336,183785336,12133,4044,8089,4044,0,1,4046,196773,0.196773
4544,53,5555,294415,2,36358,9091,1,206217336,206217336,13633,4544,9089,4544,0,1,4546,48377,0.048377
5044,53,5555,294415,2,40358,10091,1,228649336,228649336,15133,5044,10089,5044,0,1,5046,351648,0.351648
5544,53,5555,294415,2,44358,11091,1,251081336,251081336,16633,5544,11089,5544,0,1,5546,386674,0.386674
6044,53,5555,294415,2,48358,12091,1,273513336,273513336,18133,6044,12089,6044,0,1,6046,268115,0.268115
6544,53,5555,294415,2,52358,13091,1,295945336,295945336,19633,6544,13089,6544,0,1,6546,79325,0.079325
7044,53,5555,294415,2,56358,14091,1,318377336,318377336,21133,7044,14089,7044,0,1,7046,490924,0.490924
55,4555,65,296075,2,446,113,1,4401400,4401400,166,55,111,55,0,1,57,27755,0.027755
455,4555,65,296075,2,3646,913,1,19185400,19185400,1366,455,911,455,0,1,457,35253,0.035253
855,4555,65,296075,2,6846,1713,1,33969400,33969400,2566,855,1711,855,0,1,857,62559,0.062559
1255,4555,65,296075,2,10046,2513,1,48753400,48753400,3766,1255,2511,1255,0,1,1257,88958,0.088958
1655,4555,65,296075,2,13246,3313,1,63537400,63537400,4966,1655,3311,1655,0,1,1657,114205,0.114205
2055,4555,65,296075,2,16446,4113,1,78321400,78321400,6166,2055,4111,2055,0,1,2057,136684,0.136684
2455,4555,65,296075,2,19646,4913,1,93105400,93105400,7366,2455,4911,2455,0,1,2457,162086,0.162086
2855,4555,65,296075,2,22846,5713,1,107889400,107889400,8566,2855,5711,2855,0,1,2857,187834,0.187834
3255,4555,65,296075,2,26046,6513,1,122673400,122673400,9766,3255,6511,3255,0,1,3257,212824,0.212824
3655,4555,65,296075,2,29246,7313,1,137457400,137457400,10966,3655,7311,3655,0,1,3657,251930,0.25193
4055,4555,65,296075,2,32446,8113,1,152241400,152241400,12166,4055,8111,4055,0,1,4057,265621,0.265621
4455,4555,65,296075,2,35646,8913,1,167025400,167025400,13366,4455,8911,4455,0,1,4457,290068,0.290068
4855,4555,65,296075,2,38846,9713,1,181809400,181809400,14566,4855,9711,4855,0,1,4857,337184,0.337184
5255,4555,65,296075,2,42046,10513,1,196593400,196593400,15766,5255,10511,5255,0,1,5257,367751,0.367751
5655,4555,65,296075,2,45246,11313,1,211377400,211377400,16966,5655,11311,5655,0,1,5657,1014,0.001014
6055,4555,65,296075,2,48446,12113,1,226161400,226161400,18166,6055,12111,6055,0,1,6057,398951,0.398951
6455,4555,65,296075,2,51646,12913,1,240945400,240945400,19366,6455,12911,6455,0,1,6457,426055,0.426055
6855,4555,65,296075,2,54846,13713,1,255729400,255729400,20566,6855,13711,6855,0,1,6857,452063,0.452063
35,6600,45,297000,2,286,73,1,4236600,4236600,106,35,71,35,0,1,37,188,0.000188
535,6600,45,297000,2,4286,1073,1,30816600,30816600,1606,535,1071,535,0,1,537,40696,0.040696
1035,6600,45,297000,2,8286,2073,1,57396600,57396600,3106,1035,2071,1035,0,1,1037,75710,0.07571
1535,6600,45,297000,2,12286,3073,1,83976600,83976600,4606,1535,3071,1535,0,1,1537,7317,0.007317
2035,6600,45,297000,2,16286,4073,1,110556600,110556600,6106,2035,4071,2035,0,1,2037,147797,0.147797
2535,6600,45,297000,2,20286,5073,1,137136600,137136600,7606,2535,5071,2535,0,1,2537,180928,0.180928
3035,6600,45,297000,2,24286,6073,1,163716600,163716600,9106,3035,6071,3035,0,1,3037,140779,0.140779
3535,6600,45,297000,2,28286,7073,1,190296600,190296600,10606,3535,7071,3535,0,1,3537,172213,0.172213
4035,6600,45,297000,2,32286,8073,1,216876600,216876600,12106,4035,8071,4035,0,1,4037,174708,0.174708
4535,6600,45,297000,2,36286,9073,1,243456600,243456600,13606,4535,9071,4535,0,1,4537,324963,0.324963
5035,6600,45,297000,2,40286,10073,1,270036600,270036600,15106,5035,10071,5035,0,1,5037,356700,0.3567
5535,6600,45,297000,2,44286,11073,1,296616600,296616600,16606,5535,11071,5535,0,1,5537,385469,0.385469
6035,6600,45,297000,2,48286,12073,1,323196600,323196600,18106,6035,12071,6035,0,1,6037,466002,0.466002
6535,6600,45,297000,2,52286,13073,1,349776600,349776600,19606,6535,13071,6535,0,1,6537,456299,0.456299
7035,6600,45,297000,2,56286,14073,1,376356600,376356600,21106,7035,14071,7035,0,1,7037,542362,0.542362
55,55,5465,300575,2,446,113,1,4833400,4833400,166,55,111,55,0,1,57,996,0.000996
455,55,5465,300575,2,3646,913,1,22497400,22497400,1366,455,911,455,0,1,457,14988,0.014988
855,55,5465,300575,2,6846,1713,1,40161400,40161400,2566,855,1711,855,0,1,857,14288,0.014288
1255,55,5465,300575,2,10046,2513,1,57825400,57825400,3766,1255,2511,1255,0,1,1257,39612,0.039612
1655,55,5465,300575,2,13246,3313,1,75489400,75489400,4966,1655,3311,1655,0,1,1657,8774,0.008774
2055,55,5465,300575,2,16446,4113,1,93153400,93153400,6166,2055,4111,2055,0,1,2057,129922,0.129922
2455,55,5465,300575,2,19646,4913,1,110817400,110817400,7366,2455,4911,2455,0,1,2457,86998,0.086998
2855,55,5465,300575,2,22846,5713,1,128481400,128481400,8566,2855,5711,2855,0,1,2857,205168,0.205168
3255,55,5465,300575,2,26046,6513,1,146145400,146145400,9766,3255,6511,3255,0,1,3257,40624,0.040624
3655,55,5465,300575,2,29246,7313,1,163809400,163809400,10966,3655,7311,3655,0,1,3657,116235,0.116235
4055,55,5465,300575,2,32446,8113,1,181473400,181473400,12166,4055,8111,4055,0,1,4057,139731,0.139731
4455,55,5465,300575,2,35646,8913,1,199137400,199137400,13366,4455,8911,4455,0,1,4457,318357,0.318357
4855,55,5465,300575,2,38846,9713,1,216801400,216801400,14566,4855,9711,4855,0,1,4857,213811,0.213811
5255,55,5465,300575,2,42046,10513,1,234465400,234465400,15766,5255,10511,5255,0,1,5257,27773,0.027773
5655,55,5465,300575,2,45246,11313,1,252129400,252129400,16966,5655,11311,5655,0,1,5657,399675,0.399675
6055,55,5465,300575,2,48446,12113,1,269793400,269793400,18166,6055,12111,6055,0,1,6057,430726,0.430726
6455,55,5465,300575,2,51646,12913,1,287457400,287457400,19366,6455,12911,6455,0,1,6457,60645,0.060645
6855,55,5465,300575,2,54846,13713,1,305121400,305121400,20566,6855,13711,6855,0,1,6857,473706,0.473706
40,50,6040,302000,2,326,83,1,4364800,4364800,121,40,81,40,0,1,42,2712,0.002712
440,50,6040,302000,2,3526,883,1,23852800,23852800,1321,440,881,440,0,1,442,3985,0.003985
840,50,6040,302000,2,6726,1683,1,43340800,43340800,2521,840,1681,840,0,1,842,43409,0.043409
1240,50,6040,302000,2,9926,2483,1,62828800,62828800,3721,1240,2481,1240,0,1,1242,15114,0.015114
1640,50,6040,302000,2,13126,3283,1,82316800,82316800,4921,1640,3281,1640,0,1,1642,36255,0.036255
2040,50,6040,302000,2,16326,4083,1,101804800,101804800,6121,2040,4081,2040,0,1,2042,71805,0.071805
2440,50,6040,302000,2,19526,4883,1,121292800,121292800,7321,2440,4881,2440,0,1,2442,63445,0.063445
2840,50,6040,302000,2,22726,5683,1,140780800,140780800,8521,2840,5681,2840,0,1,2842,49331,0.049331
3240,50,6040,302000,2,25926,6483,1,160268800,160268800,9721,3240,6481,3240,0,1,3242,131950,0.13195
3640,50,6040,302000,2,29126,7283,1,179756800,179756800,10921,3640,7281,3640,0,1,3642,99247,0.099247
4040,50,6040,302000,2,32326,8083,1,199244800,199244800,12121,4040,8081,4040,0,1,4042,25465,0.025465
4440,50,6040,302000,2,35526,8883,1,218732800,218732800,13321,4440,8881,4440,0,1,4442,316736,0.316736
4840,50,6040,302000,2,38726,9683,1,238220800,238220800,14521,4840,9681,4840,0,1,4842,270669,0.270669
5240,50,6040,302000,2,41926,10483,1,257708800,257708800,15721,5240,10481,5240,0,1,5242,69122,0.069122
5640,50,6040,302000,2,45126,11283,1,277196800,277196800,16921,5640,11281,5640,0,1,5642,403586,0.403586
6040,50,6040,302000,2,48326,12083,1,296684800,296684800,18121,6040,12081,6040,0,1,6042,431002,0.431002
6440,50,6040,302000,2,51526,12883,1,316172800,316172800,19321,6440,12881,6440,0,1,6442,100610,0.10061
6840,50,6040,302000,2,54726,13683,1,335660800,335660800,20521,6840,13681,6840,0,1,6842,236080,0.23608
39,43,7041,302763,2,318,81,1,4632312,4632312,118,39,79,39,0,1,41,10319,0.010319
539,43,7041,302763,2,4318,1081,1,32968312,32968312,1618,539,1079,539,0,1,541,33196,0.033196
1039,43,7041,302763,2,8318,2081,1,61304312,61304312,3118,1039,2079,1039,0,1,1041,17812,0.017812
1539,43,7041,302763,2,12318,3081,1,89640312,89640312,4618,1539,3079,1539,0,1,1541,13991,0.013991
2039,43,7041,302763,2,16318,4081,1,117976312,117976312,6118,2039,4079,2039,0,1,2041,96249,0.096249
2539,43,7041,302763,2,20318,5081,1,146312312,146312312,7618,2539,5079,2539,0,1,2541,142341,0.142341
3039,43,7041,302763,2,24318,6081,1,174648312,174648312,9118,3039,6079,3039,0,1,3041,67581,0.067581
3539,43,7041,302763,2,28318,7081,1,202984312,202984312,10618,3539,7079,3539,0,1,3541,88347,0.088347
4039,43,7041,302763,2,32318,8081,1,231320312,231320312,12118,4039,8079,4039,0,1,4041,311503,0.311503
4539,43,7041,302763,2,36318,9081,1,259656312,259656312,13618,4539,9079,4539,0,1,4541,21415,0.021415
5039,43,7041,302763,2,40318,10081,1,287992312,287992312,15118,5039,10079,5039,0,1,5041,24605,0.024605
5539,43,7041,302763,2,44318,11081,1,316328312,316328312,16618,5539,11079,5539,0,1,5541,26856,0.026856
6039,43,7041,302763,2,48318,12081,1,344664312,344664312,18118,6039,12079,6039,0,1,6041,108942,0.108942
6539,43,7041,302763,2,52318,13081,1,373000312,373000312,19618,6539,13079,6539,0,1,6541,192616,0.192616
7039,43,7041,302763,2,56318,14081,1,401336312,401336312,21118,7039,14079,7039,0,1,7041,374933,0.374933
44,5553,55,305415,2,358,91,1,4417336,4417336,133,44,89,44,0,1,46,501,0.000501
544,5553,55,305415,2,4358,1091,1,26849336,26849336,1633,544,1089,544,0,1,546,15069,0.015069
1044,5553,55,305415,2,8358,2091,1,49281336,49281336,3133,1044,2089,1044,0,1,1046,53188,0.053188
1544,5553,55,305415,2,12358,3091,1,71713336,71713336,4633,1544,3089,1544,0,1,1546,53081,0.053081
2044,5553,55,305415,2,16358,4091,1,94145336,94145336,6133,2044,4089,2044,0,1,2046,131839,0.131839
2544,5553,55,305415,2,20358,5091,1,116577336,116577336,7633,2544,5089,2544,0,1,2546,175557,0.175557
3044,5553,55,305415,2,24358,6091,1,139009336,139009336,9133,3044,6089,3044,0,1,3046,208721,0.208721
3544,5553,55,305415,2,28358,7091,1,161441336,161441336,10633,3544,7089,3544,0,1,3546,248969,0.248969
4044,5553,55,305415,2,32358,8091,1,183873336,183873336,12133,4044,8089,4044,0,1,4046,283346,0.283346
4544,5553,55,305415,2,36358,9091,1,206305336,206305336,13633,4544,9089,4544,0,1,4546,338346,0.338346
5044,5553,55,305415,2,40358,10091,1,228737336,228737336,15133,5044,10089,5044,0,1,5046,351690,0.35169
5544,5553,55,305415,2,44358,11091,1,251169336,251169336,16633,5544,11089,5544,0,1,5546,411803,0.411803
6044,5553,55,305415,2,48358,12091,1,273601336,273601336,18133,6044,12089,6044,0,1,6046,419208,0.419208
6544,5553,55,305415,2,52358,13091,1,296033336,296033336,19633,6544,13089,6544,0,1,6546,480901,0.480901
7044,5553,55,305415,2,56358,14091,1,318465336,318465336,21133,7044,14089,7044,0,1,7046,522606,0.522606
55,4805,65,312325,2,446,113,1,4641400,4641400,166,55,111,55,0,1,57,28580,0.02858
455,4805,65,312325,2,3646,913,1,20225400,20225400,1366,455,911,455,0,1,457,37328,0.037328
855,4805,65,312325,2,6846,1713,1,35809400,35809400,2566,855,1711,855,0,1,857,63631,0.063631
1255,4805,65,312325,2,10046,2513,1,51393400,51393400,3766,1255,2511,1255,0,1,1257,94981,0.094981
1655,4805,65,312325,2,13246,3313,1,66977400,66977400,4966,1655,3311,1655,0,1,1657,114539,0.114539
2055,4805,65,312325,2,16446,4113,1,82561400,82561400,6166,2055,4111,2055,0,1,2057,139045,0.139045
2455,4805,65,312325,2,19646,4913,1,98145400,98145400,7366,2455,4911,2455,0,1,2457,168817,0.168817
2855,4805,65,312325,2,22846,5713,1,113729400,113729400,8566,2855,5711,2855,0,1,2857,196234,0.196234
3255,4805,65,312325,2,26046,6513,1,129313400,129313400,9766,3255,6511,3255,0,1,3257,232150,0.23215
3655,4805,65,312325,2,29246,7313,1,144897400,144897400,10966,3655,7311,3655,0,1,3657,247594,0.247594
4055,4805,65,312325,2,32446,8113,1,160481400,160481400,12166,4055,8111,4055,0,1,4057,276541,0.276541
4455,4805,65,312325,2,35646,8913,1,176065400,176065400,13366,4455,8911,4455,0,1,4457,303363,0.303363
4855,4805,65,312325,2,38846,9713,1,191649400,191649400,14566,4855,9711,4855,0,1,4857,336136,0.336136
5255,4805,65,312325,2,42046,10513,1,207233400,207233400,15766,5255,10511,5255,0,1,5257,358425,0.358425
5655,4805,65,312325,2,45246,11313,1,222817400,222817400,16966,5655,11311,5655,0,1,5657,401857,0.401857
6055,4805,65,312325,2,48446,12113,1,238401400,238401400,18166,6055,12111,6055,0,1,6057,24462,0.024462
6455,4805,65,312325,2,51646,12913,1,253985400,253985400,19366,6455,12911,6455,0,1,6457,441830,0.44183
6855,4805,65,312325,2,54846,13713,1,269569400,269569400,20566,6855,13711,6855,0,1,6857,505229,0.505229
40,50,6340,317000,2,326,83,1,4580800,4580800,121,40,81,40,0,1,42,9137,0.009137
440,50,6340,317000,2,3526,883,1,25028800,25028800,1321,440,881,440,0,1,442,45697,0.045697
840,50,6340,317000,2,6726,1683,1,45476800,45476800,2521,840,1681,840,0,1,842,25718,0.025718
1240,50,6340,317000,2,9926,2483,1,65924800,65924800,3721,1240,2481,1240,0,1,1242,8359,0.008359
1640,50,6340,317000,2,13126,3283,1,86372800,86372800,4921,1640,3281,1640,0,1,1642,32565,0.032565
2040,50,6340,317000,2,16326,4083,1,106820800,106820800,6121,2040,4081,2040,0,1,2042,69018,0.069018
2440,50,6340,317000,2,19526,4883,1,127268800,127268800,7321,2440,4881,2440,0,1,2442,29538,0.029538
2840,50,6340,317000,2,22726,5683,1,147716800,147716800,8521,2840,5681,2840,0,1,2842,69289,0.069289
3240,50,6340,317000,2,25926,6483,1,168164800,168164800,9721,3240,6481,3240,0,1,3242,82305,0.082305
3640,50,6340,317000,2,29126,7283,1,188612800,188612800,10921,3640,7281,3640,0,1,3642,153315,0.153315
4040,50,6340,317000,2,32326,8083,1,209060800,209060800,12121,4040,8081,4040,0,1,4042,304052,0.304052
4440,50,6340,317000,2,35526,8883,1,229508800,229508800,13321,4440,8881,4440,0,1,4442,66767,0.066767
4840,50,6340,317000,2,38726,9683,1,249956800,249956800,14521,4840,9681,4840,0,1,4842,264071,0.264071
5240,50,6340,317000,2,41926,10483,1,270404800,270404800,15721,5240,10481,5240,0,1,5242,165815,0.165815
5640,50,6340,317000,2,45126,11283,1,290852800,290852800,16921,5640,11281,5640,0,1,5642,402463,0.402463
6040,50,6340,317000,2,48326,12083,1,311300800,311300800,18121,6040,12081,6040,0,1,6042,230583,0.230583
6440,50,6340,317000,2,51526,12883,1,331748800,331748800,19321,6440,12881,6440,0,1,6442,485755,0.485755
6840,50,6340,317000,2,54726,13683,1,352196800,352196800,20521,6840,13681,6840,0,1,6842,233510,0.23351
55,55,5765,317075,2,446,113,1,5097400,5097400,166,55,111,55,0,1,57,962,0.000962
455,55,5765,317075,2,3646,913,1,23721400,23721400,1366,455,911,455,0,1,457,3690,0.00369
855,55,5765,317075,2,6846,1713,1,42345400,42345400,2566,855,1711,855,0,1,857,62841,0.062841
1255,55,5765,317075,2,10046,2513,1,60969400,60969400,3766,1255,2511,1255,0,1,1257,7109,0.007109
1655,55,5765,317075,2,13246,3313,1,79593400,79593400,4966,1655,3311,1655,0,1,1657,6743,0.006743
2055,55,5765,317075,2,16446,4113,1,98217400,98217400,6166,2055,4111,2055,0,1,2057,32893,0.032893
2455,55,5765,317075,2,19646,4913,1,116841400,116841400,7366,2455,4911,2455,0,1,2457,22644,0.022644
2855,55,5765,317075,2,22846,5713,1,135465400,135465400,8566,2855,5711,2855,0,1,2857,116053,0.116053
3255,55,5765,317075,2,26046,6513,1,154089400,154089400,9766,3255,6511,3255,0,1,3257,244244,0.244244
3655,55,5765,317075,2,29246,7313,1,172713400,172713400,10966,3655,7311,3655,0,1,3657,87746,0.087746
4055,55,5765,317075,2,32446,8113,1,191337400,191337400,12166,4055,8111,4055,0,1,4057,303312,0.303312
4455,55,5765,317075,2,35646,8913,1,209961400,209961400,13366,4455,8911,4455,0,1,4457,22520,0.02252
4855,55,5765,317075,2,38846,9713,1,228585400,228585400,14566,4855,9711,4855,0,1,4857,362798,0.362798
5255,55,5765,317075,2,42046,10513,1,247209400,247209400,15766,5255,10511,5255,0,1,5257,278937,0.278937
5655,55,5765,317075,2,45246,11313,1,265833400,265833400,16966,5655,11311,5655,0,1,5657,384375,0.384375
6055,55,5765,317075,2,48446,12113,1,284457400,284457400,18166,6055,12111,6055,0,1,6057,453383,0.453383
6455,55,5765,317075,2,51646,12913,1,303081400,303081400,19366,6455,12911,6455,0,1,6457,54110,0.05411
6855,55,5765,317075,2,54846,13713,1,321705400,321705400,20566,6855,13711,6855,0,1,6857,248497,0.248497
39,593,541,320813,2,318,81,1,2920312,2920312,118,39,79,39,0,1,41,7144,0.007144
539,593,541,320813,2,4318,1081,1,7456312,7456312,1618,539,1079,539,0,1,541,36933,0.036933
1039,593,541,320813,2,8318,2081,1,11992312,11992312,3118,1039,2079,1039,0,1,1041,69770,0.06977
1539,593,541,320813,2,12318,3081,1,16528312,16528312,4618,1539,3079,1539,0,1,1541,99839,0.099839
2039,593,541,320813,2,16318,4081,1,21064312,21064312,6118,2039,4079,2039,0,1,2041,38945,0.038945
2539,593,541,320813,2,20318,5081,1,25600312,25600312,7618,2539,5079,2539,0,1,2541,4313,0.004313
3039,593,541,320813,2,24318,6081,1,30136312,30136312,9118,3039,6079,3039,0,1,3041,85646,0.085646
3539,593,541,320813,2,28318,7081,1,34672312,34672312,10618,3539,7079,3539,0,1,3541,223049,0.223049
4039,593,541,320813,2,32318,8081,1,39208312,39208312,12118,4039,8079,4039,0,1,4041,232892,0.232892
4539,593,541,320813,2,36318,9081,1,43744312,43744312,13618,4539,9079,4539,0,1,4541,107691,0.107691
5039,593,541,320813,2,40318,10081,1,48280312,48280312,15118,5039,10079,5039,0,1,5041,322213,0.322213
5539,593,541,320813,2,44318,11081,1,52816312,52816312,16618,5539,11079,5539,0,1,5541,352757,0.352757
6039,593,541,320813,2,48318,12081,1,57352312,57352312,18118,6039,12079,6039,0,1,6041,103673,0.103673
6539,593,541,320813,2,52318,13081,1,61888312,61888312,19618,6539,13079,6539,0,1,6541,416580,0.41658
7039,593,541,320813,2,56318,14081,1,66424312,66424312,21118,7039,14079,7039,0,1,7041,453497,0.453497
44,53,6055,320915,2,358,91,1,4717336,4717336,133,44,89,44,0,1,46,3270,0.00327
544,53,6055,320915,2,4358,1091,1,29149336,29149336,1633,544,1089,544,0,1,546,15701,0.015701
1044,53,6055,320915,2,8358,2091,1,53581336,53581336,3133,1044,2089,1044,0,1,1046,5050,0.00505
1544,53,6055,320915,2,12358,3091,1,78013336,78013336,4633,1544,3089,1544,0,1,1546,62810,0.06281
2044,53,6055,320915,2,16358,4091,1,102445336,102445336,6133,2044,4089,2044,0,1,2046,23978,0.023978
2544,53,6055,320915,2,20358,5091,1,126877336,126877336,7633,2544,5089,2544,0,1,2546,3747,0.003747
3044,53,6055,320915,2,24358,6091,1,151309336,151309336,9133,3044,6089,3044,0,1,3046,109377,0.109377
3544,53,6055,320915,2,28358,7091,1,175741336,175741336,10633,3544,7089,3544,0,1,3546,28583,0.028583
4044,53,6055,320915,2,32358,8091,1,200173336,200173336,12133,4044,8089,4044,0,1,4046,181311,0.181311
4544,53,6055,320915,2,36358,9091,1,224605336,224605336,13633,4544,9089,4544,0,1,4546,216073,0.216073
5044,53,6055,320915,2,40358,10091,1,249037336,249037336,15133,5044,10089,5044,0,1,5046,322429,0.322429
5544,53,6055,320915,2,44358,11091,1,273469336,273469336,16633,5544,11089,5544,0,1,5546,65171,0.065171
6044,53,6055,320915,2,48358,12091,1,297901336,297901336,18133,6044,12089,6044,0,1,6046,132429,0.132429
6544,53,6055,320915,2,52358,13091,1,322333336,322333336,19633,6544,13089,6544,0,1,6546,495674,0.495674
7044,53,6055,320915,2,56358,14091,1,346765336,346765336,21133,7044,14089,7044,0,1,7046,29316,0.029316
35,590,545,321550,2,286,73,1,2890200,2890200,106,35,71,35,0,1,37,2652,0.002652
535,590,545,321550,2,4286,1073,1,7430200,7430200,1606,535,1071,535,0,1,537,30835,0.030835
1035,590,545,321550,2,8286,2073,1,11970200,11970200,3106,1035,2071,1035,0,1,1037,38495,0.038495
1535,590,545,321550,2,12286,3073,1,16510200,16510200,4606,1535,3071,1535,0,1,1537,83954,0.083954
2035,590,545,321550,2,16286,4073,1,21050200,21050200,6106,2035,4071,2035,0,1,2037,134170,0.13417
2535,590,545,321550,2,20286,5073,1,25590200,25590200,7606,2535,5071,2535,0,1,2537,164982,0.164982
3035,590,545,321550,2,24286,6073,1,30130200,30130200,9106,3035,6071,3035,0,1,3037,198896,0.198896
3535,590,545,321550,2,28286,7073,1,34670200,34670200,10606,3535,7071,3535,0,1,3537,225915,0.225915
4035,590,545,321550,2,32286,8073,1,39210200,39210200,12106,4035,8071,4035,0,1,4037,263316,0.263316
4535,590,545,321550,2,36286,9073,1,43750200,43750200,13606,4535,9071,4535,0,1,4537,298857,0.298857
5035,590,545,321550,2,40286,10073,1,48290200,48290200,15106,5035,10071,5035,0,1,5037,329653,0.329653
5535,590,545,321550,2,44286,11073,1,52830200,52830200,16606,5535,11071,5535,0,1,5537,356907,0.356907
6035,590,545,321550,2,48286,12073,1,57370200,57370200,18106,6035,12071,6035,0,1,6037,393075,0.393075
6535,590,545,321550,2,52286,13073,1,61910200,61910200,19606,6535,13071,6535,0,1,6537,434050,0.43405
7035,590,545,321550,2,56286,14073,1,66450200,66450200,21106,7035,14071,7035,0,1,7037,458810,0.45881
55,5055,65,328575,2,446,113,1,4881400,4881400,166,55,111,55,0,1,57,873,0.000873
455,5055,65,328575,2,3646,913,1,21265400,21265400,1366,455,911,455,0,1,457,20413,0.020413
855,5055,65,328575,2,6846,1713,1,37649400,37649400,2566,855,1711,855,0,1,857,10630,0.01063
1255,5055,65,328575,2,10046,2513,1,54033400,54033400,3766,1255,2511,1255,0,1,1257,99993,0.099993
1655,5055,65,328575,2,13246,3313,1,70417400,70417400,4966,1655,3311,1655,0,1,1657,124239,0.124239
2055,5055,65,328575,2,16446,4113,1,86801400,86801400,6166,2055,4111,2055,0,1,2057,139401,0.139401
2455,5055,65,328575,2,19646,4913,1,103185400,103185400,7366,2455,4911,2455,0,1,2457,180090,0.18009
2855,5055,65,328575,2,22846,5713,1,119569400,119569400,8566,2855,5711,2855,0,1,2857,207646,0.207646
3255,5055,65,328575,2,26046,6513,1,135953400,135953400,9766,3255,6511,3255,0,1,3257,81330,0.08133
3655,5055,65,328575,2,29246,7313,1,152337400,152337400,10966,3655,7311,3655,0,1,3657,235851,0.235851
4055,5055,65,328575,2,32446,8113,1,168721400,168721400,12166,4055,8111,4055,0,1,4057,296416,0.296416
4455,5055,65,328575,2,35646,8913,1,185105400,185105400,13366,4455,8911,4455,0,1,4457,139724,0.139724
4855,5055,65,328575,2,38846,9713,1,201489400,201489400,14566,4855,9711,4855,0,1,4857,354629,0.354629
5255,5055,65,328575,2,42046,10513,1,217873400,217873400,15766,5255,10511,5255,0,1,5257,399656,0.399656
5655,5055,65,328575,2,45246,11313,1,234257400,234257400,16966,5655,11311,5655,0,1,5657,46531,0.046531
6055,5055,65,328575,2,48446,12113,1,250641400,250641400,18166,6055,12111,6055,0,1,6057,462128,0.462128
6455,5055,65,328575,2,51646,12913,1,267025400,267025400,19366,6455,12911,6455,0,1,6457,421665,0.421665
6855,5055,65,328575,2,54846,13713,1,283409400,283409400,20566,6855,13711,6855,0,1,6857,512178,0.512178
40,50,6640,332000,2,326,83,1,4796800,4796800,121,40,81,40,0,1,42,1401,0.001401
440,50,6640,332000,2,3526,883,1,26204800,26204800,1321,440,881,440,0,1,442,16599,0.016599
840,50,6640,332000,2,6726,1683,1,47612800,47612800,2521,840,1681,840,0,1,842,4129,0.004129
1240,50,6640,332000,2,9926,2483,1,69020800,69020800,3721,1240,2481,1240,0,1,1242,32858,0.032858
1640,50,6640,332000,2,13126,3283,1,90428800,90428800,4921,1640,3281,1640,0,1,1642,18378,0.018378
2040,50,6640,332000,2,16326,4083,1,111836800,111836800,6121,2040,4081,2040,0,1,2042,9283,0.009283
2440,50,6640,332000,2,19526,4883,1,133244800,133244800,7321,2440,4881,2440,0,1,2442,23740,0.02374
2840,50,6640,332000,2,22726,5683,1,154652800,154652800,8521,2840,5681,2840,0,1,2842,78010,0.07801
3240,50,6640,332000,2,25926,6483,1,176060800,176060800,9721,3240,6481,3240,0,1,3242,183841,0.183841
3640,50,6640,332000,2,29126,7283,1,197468800,197468800,10921,3640,7281,3640,0,1,3642,281888,0.281888
4040,50,6640,332000,2,32326,8083,1,218876800,218876800,12121,4040,8081,4040,0,1,4042,74512,0.074512
4440,50,6640,332000,2,35526,8883,1,240284800,240284800,13321,4440,8881,4440,0,1,4442,156258,0.156258
4840,50,6640,332000,2,38726,9683,1,261692800,261692800,14521,4840,9681,4840,0,1,4842,65851,0.065851
5240,50,6640,332000,2,41926,10483,1,283100800,283100800,15721,5240,10481,5240,0,1,5242,405782,0.405782
5640,50,6640,332000,2,45126,11283,1,304508800,304508800,16921,5640,11281,5640,0,1,5642,50231,0.050231
6040,50,6640,332000,2,48326,12083,1,325916800,325916800,18121,6040,12081,6040,0,1,6042,406707,0.406707
6440,50,6640,332000,2,51526,12883,1,347324800,347324800,19321,6440,12881,6440,0,1,6442,79965,0.079965
6840,50,6640,332000,2,54726,13683,1,368732800,368732800,20521,6840,13681,6840,0,1,6842,234827,0.234827
55,55,6065,333575,2,446,113,1,5361400,5361400,166,55,111,55,0,1,57,4663,0.004663
455,55,6065,333575,2,3646,913,1,24945400,24945400,1366,455,911,455,0,1,457,31782,0.031782
855,55,6065,333575,2,6846,1713,1,44529400,44529400,2566,855,1711,855,0,1,857,15430,0.01543
1255,55,6065,333575,2,10046,2513,1,64113400,64113400,3766,1255,2511,1255,0,1,1257,49146,0.049146
1655,55,6065,333575,2,13246,3313,1,83697400,83697400,4966,1655,3311,1655,0,1,1657,44959,0.044959
2055,55,6065,333575,2,16446,4113,1,103281400,103281400,6166,2055,4111,2055,0,1,2057,93841,0.093841
2455,55,6065,333575,2,19646,4913,1,122865400,122865400,7366,2455,4911,2455,0,1,2457,11878,0.011878
2855,55,6065,333575,2,22846,5713,1,142449400,142449400,8566,2855,5711,2855,0,1,2857,64976,0.064976
3255,55,6065,333575,2,26046,6513,1,162033400,162033400,9766,3255,6511,3255,0,1,3257,55349,0.055349
3655,55,6065,333575,2,29246,7313,1,181617400,181617400,10966,3655,7311,3655,0,1,3657,154389,0.154389
4055,55,6065,333575,2,32446,8113,1,201201400,201201400,12166,4055,8111,4055,0,1,4057,257836,0.257836
4455,55,6065,333575,2,35646,8913,1,220785400,220785400,13366,4455,8911,4455,0,1,4457,137483,0.137483
4855,55,6065,333575,2,38846,9713,1,240369400,240369400,14566,4855,9711,4855,0,1,4857,345073,0.345073
5255,55,6065,333575,2,42046,10513,1,259953400,259953400,15766,5255,10511,5255,0,1,5257,146885,0.146885
5655,55,6065,333575,2,45246,11313,1,279537400,279537400,16966,5655,11311,5655,0,1,5657,249020,0.24902
6055,55,6065,333575,2,48446,12113,1,299121400,299121400,18166,6055,12111,6055,0,1,6057,347941,0.347941
6455,55,6065,333575,2,51646,12913,1,318705400,318705400,19366,6455,12911,6455,0,1,6457,506416,0.506416
6855,55,6065,333575,2,54846,13713,1,338289400,338289400,20566,6855,13711,6855,0,1,6857,62551,0.062551
44,603,555,334665,2,358,91,1,3084936,3084936,133,44,89,44,0,1,46,7698,0.007698
544,603,555,334665,2,4358,1091,1,7716936,7716936,1633,544,1089,544,0,1,546,37890,0.03789
1044,603,555,334665,2,8358,2091,1,12348936,12348936,3133,1044,2089,1044,0,1,1046,69891,0.069891
1544,603,555,334665,2,12358,3091,1,16980936,16980936,4633,1544,3089,1544,0,1,1546,85402,0.085402
2044,603,555,334665,2,16358,4091,1,21612936,21612936,6133,2044,4089,2044,0,1,2046,43491,0.043491
2544,603,555,334665,2,20358,5091,1,26244936,26244936,7633,2544,5089,2544,0,1,2546,121085,0.121085
3044,603,555,334665,2,24358,6091,1,30876936,30876936,9133,3044,6089,3044,0,1,3046,201221,0.201221
3544,603,555,334665,2,28358,7091,1,35508936,35508936,10633,3544,7089,3544,0,1,3546,234946,0.234946
4044,603,555,334665,2,32358,8091,1,40140936,40140936,12133,4044,8089,4044,0,1,4046,265198,0.265198
4544,603,555,334665,2,36358,9091,1,44772936,44772936,13633,4544,9089,4544,0,1,4546,298722,0.298722
5044,603,555,334665,2,40358,10091,1,49404936,49404936,15133,5044,10089,5044,0,1,5046,331236,0.331236
5544,603,555,334665,2,44358,11091,1,54036936,54036936,16633,5544,11089,5544,0,1,5546,365782,0.365782
6044,603,555,334665,2,48358,12091,1,58668936,58668936,18133,6044,12089,6044,0,1,6046,235705,0.235705
6544,603,555,334665,2,52358,13091,1,63300936,63300936,19633,6544,13089,6544,0,1,6546,432460,0.43246
7044,603,555,334665,2,56358,14091,1,67932936,67932936,21133,7044,14089,7044,0,1,7046,464976,0.464976
44,6103,55,335665,2,358,91,1,4852936,4852936,133,44,89,44,0,1,46,236,0.000236
544,6103,55,335665,2,4358,1091,1,29484936,29484936,1633,544,1089,544,0,1,546,43860,0.04386
1044,6103,55,335665,2,8358,2091,1,54116936,54116936,3133,1044,2089,1044,0,1,1046,2791,0.002791
1544,6103,55,335665,2,12358,3091,1,78748936,78748936,4633,1544,3089,1544,0,1,1546,116576,0.116576
2044,6103,55,335665,2,16358,4091,1,103380936,103380936,6133,2044,4089,2044,0,1,2046,155045,0.155045
2544,6103,55,335665,2,20358,5091,1,128012936,128012936,7633,2544,5089,2544,0,1,2546,193319,0.193319
3044,6103,55,335665,2,24358,6091,1,152644936,152644936,9133,3044,6089,3044,0,1,3046,230315,0.230315
3544,6103,55,335665,2,28358,7091,1,177276936,177276936,10633,3544,7089,3544,0,1,3546,268976,0.268976
4044,6103,55,335665,2,32358,8091,1,201908936,201908936,12133,4044,8089,4044,0,1,4046,302188,0.302188
4544,6103,55,335665,2,36358,9091,1,226540936,226540936,13633,4544,9089,4544,0,1,4546,342654,0.342654
5044,6103,55,335665,2,40358,10091,1,251172936,251172936,15133,5044,10089,5044,0,1,5046,379383,0.379383
5544,6103,55,335665,2,44358,11091,1,275804936,275804936,16633,5544,11089,5544,0,1,5546,439006,0.439006
6044,6103,55,335665,2,48358,12091,1,300436936,300436936,18133,6044,12089,6044,0,1,6046,10577,0.010577
6544,6103,55,335665,2,52358,13091,1,325068936,325068936,19633,6544,13089,6544,0,1,6546,532960,0.53296
7044,6103,55,335665,2,56358,14091,1,349700936,349700936,21133,7044,14089,7044,0,1,7046,552678,0.552678
55,5305,65,344825,2,446,113,1,5121400,5121400,166,55,111,55,0,1,57,31479,0.031479
455,5305,65,344825,2,3646,913,1,22305400,22305400,1366,455,911,455,0,1,457,39262,0.039262
855,5305,65,344825,2,6846,1713,1,39489400,39489400,2566,855,1711,855,0,1,857,68992,0.068992
1255,5305,65,344825,2,10046,2513,1,56673400,56673400,3766,1255,2511,1255,0,1,1257,22585,0.022585
1655,5305,65,344825,2,13246,3313,1,73857400,73857400,4966,1655,3311,1655,0,1,1657,133918,0.133918
2055,5305,65,344825,2,16446,4113,1,91041400,91041400,6166,2055,4111,2055,0,1,2057,168476,0.168476
2455,5305,65,344825,2,19646,4913,1,108225400,108225400,7366,2455,4911,2455,0,1,2457,189442,0.189442
2855,5305,65,344825,2,22846,5713,1,125409400,125409400,8566,2855,5711,2855,0,1,2857,229709,0.229709
3255,5305,65,344825,2,26046,6513,1,142593400,142593400,9766,3255,6511,3255,0,1,3257,249278,0.249278
3655,5305,65,344825,2,29246,7313,1,159777400,159777400,10966,3655,7311,3655,0,1,3657,277727,0.277727
4055,5305,65,344825,2,32446,8113,1,176961400,176961400,12166,4055,8111,4055,0,1,4057,308599,0.308599
4455,5305,65,344825,2,35646,8913,1,194145400,194145400,13366,4455,8911,4455,0,1,4457,340071,0.340071
4855,5305,65,344825,2,38846,9713,1,211329400,211329400,14566,4855,9711,4855,0,1,4857,19850,0.01985
5255,5305,65,344825,2,42046,10513,1,228513400,228513400,15766,5255,10511,5255,0,1,5257,384902,0.384902
5655,5305,65,344825,2,45246,11313,1,245697400,245697400,16966,5655,11311,5655,0,1,5657,431328,0.431328
6055,5305,65,344825,2,48446,12113,1,262881400,262881400,18166,6055,12111,6055,0,1,6057,478349,0.478349
6455,5305,65,344825,2,51646,12913,1,280065400,280065400,19366,6455,12911,6455,0,1,6457,495092,0.495092
6855,5305,65,344825,2,54846,13713,1,297249400,297249400,20566,6855,13711,6855,0,1,6857,565263,0.565263
40,50,6940,347000,2,326,83,1,5012800,5012800,121,40,81,40,0,1,42,925,0.000925
440,50,6940,347000,2,3526,883,1,27380800,27380800,1321,440,881,440,0,1,442,26354,0.026354
840,50,6940,347000,2,6726,1683,1,49748800,49748800,2521,840,1681,840,0,1,842,77083,0.077083
1240,50,6940,347000,2,9926,2483,1,72116800,72116800,3721,1240,2481,1240,0,1,1242,26027,0.026027
1640,50,6940,347000,2,13126,3283,1,94484800,94484800,4921,1640,3281,1640,0,1,1642,7913,0.007913
2040,50,6940,347000,2,16326,4083,1,116852800,116852800,6121,2040,4081,2040,0,1,2042,45109,0.045109
2440,50,6940,347000,2,19526,4883,1,139220800,139220800,7321,2440,4881,2440,0,1,2442,42415,0.042415
2840,50,6940,347000,2,22726,5683,1,161588800,161588800,8521,2840,5681,2840,0,1,2842,173699,0.173699
3240,50,6940,347000,2,25926,6483,1,183956800,183956800,9721,3240,6481,3240,0,1,3242,97603,0.097603
3640,50,6940,347000,2,29126,7283,1,206324800,206324800,10921,3640,7281,3640,0,1,3642,139483,0.139483
4040,50,6940,347000,2,32326,8083,1,228692800,228692800,12121,4040,8081,4040,0,1,4042,153549,0.153549
4440,50,6940,347000,2,35526,8883,1,251060800,251060800,13321,4440,8881,4440,0,1,4442,39789,0.039789
4840,50,6940,347000,2,38726,9683,1,273428800,273428800,14521,4840,9681,4840,0,1,4842,114546,0.114546
5240,50,6940,347000,2,41926,10483,1,295796800,295796800,15721,5240,10481,5240,0,1,5242,176997,0.176997
5640,50,6940,347000,2,45126,11283,1,318164800,318164800,16921,5640,11281,5640,0,1,5642,361807,0.361807
6040,50,6940,347000,2,48326,12083,1,340532800,340532800,18121,6040,12081,6040,0,1,6042,283855,0.283855
6440,50,6940,347000,2,51526,12883,1,362900800,362900800,19321,6440,12881,6440,0,1,6442,166138,0.166138
6840,50,6940,347000,2,54726,13683,1,385268800,385268800,20521,6840,13681,6840,0,1,6842,376285,0.376285
44,53,6555,347415,2,358,91,1,5105336,5105336,133,44,89,44,0,1,46,13979,0.013979
544,53,6555,347415,2,4358,1091,1,31537336,31537336,1633,544,1089,544,0,1,546,4326,0.004326
1044,53,6555,347415,2,8358,2091,1,57969336,57969336,3133,1044,2089,1044,0,1,1046,9535,0.009535
1544,53,6555,347415,2,12358,3091,1,84401336,84401336,4633,1544,3089,1544,0,1,1546,11975,0.011975
2044,53,6555,347415,2,16358,4091,1,110833336,110833336,6133,2044,4089,2044,0,1,2046,83237,0.083237
2544,53,6555,347415,2,20358,5091,1,137265336,137265336,7633,2544,5089,2544,0,1,2546,11352,0.011352
3044,53,6555,347415,2,24358,6091,1,163697336,163697336,9133,3044,6089,3044,0,1,3046,15461,0.015461
3544,53,6555,347415,2,28358,7091,1,190129336,190129336,10633,3544,7089,3544,0,1,3546,107407,0.107407
4044,53,6555,347415,2,32358,8091,1,216561336,216561336,12133,4044,8089,4044,0,1,4046,20352,0.020352
4544,53,6555,347415,2,36358,9091,1,242993336,242993336,13633,4544,9089,4544,0,1,4546,106187,0.106187
5044,53,6555,347415,2,40358,10091,1,269425336,269425336,15133,5044,10089,5044,0,1,5046,367259,0.367259
5544,53,6555,347415,2,44358,11091,1,295857336,295857336,16633,5544,11089,5544,0,1,5546,54831,0.054831
6044,53,6555,347415,2,48358,12091,1,322289336,322289336,18133,6044,12089,6044,0,1,6046,51171,0.051171
6544,53,6555,347415,2,52358,13091,1,348721336,348721336,19633,6544,13089,6544,0,1,6546,217162,0.217162
7044,53,6555,347415,2,56358,14091,1,375153336,375153336,21133,7044,14089,7044,0,1,7046,480097,0.480097
55,55,6365,350075,2,446,113,1,5625400,5625400,166,55,111,55,0,1,57,7126,0.007126
455,55,6365,350075,2,3646,913,1,26169400,26169400,1366,455,911,455,0,1,457,2483,0.002483
855,55,6365,350075,2,6846,1713,1,46713400,46713400,2566,855,1711,855,0,1,857,12771,0.012771
1255,55,6365,350075,2,10046,2513,1,67257400,67257400,3766,1255,2511,1255,0,1,1257,46775,0.046775
1655,55,6365,350075,2,13246,3313,1,87801400,87801400,4966,1655,3311,1655,0,1,1657,7870,0.00787
2055,55,6365,350075,2,16446,4113,1,108345400,108345400,6166,2055,4111,2055,0,1,2057,142843,0.142843
2455,55,6365,350075,2,19646,4913,1,128889400,128889400,7366,2455,4911,2455,0,1,2457,115000,0.115
2855,55,6365,350075,2,22846,5713,1,149433400,149433400,8566,2855,5711,2855,0,1,2857,27872,0.027872
3255,55,6365,350075,2,26046,6513,1,169977400,169977400,9766,3255,6511,3255,0,1,3257,251053,0.251053
3655,55,6365,350075,2,29246,7313,1,190521400,190521400,10966,3655,7311,3655,0,1,3657,112953,0.112953
4055,55,6365,350075,2,32446,8113,1,211065400,211065400,12166,4055,8111,4055,0,1,4057,243851,0.243851
4455,55,6365,350075,2,35646,8913,1,231609400,231609400,13366,4455,8911,4455,0,1,4457,119494,0.119494
4855,55,6365,350075,2,38846,9713,1,252153400,252153400,14566,4855,9711,4855,0,1,4857,69076,0.069076
5255,55,6365,350075,2,42046,10513,1,272697400,272697400,15766,5255,10511,5255,0,1,5257,63091,0.063091
5655,55,6365,350075,2,45246,11313,1,293241400,293241400,16966,5655,11311,5655,0,1,5657,104180,0.10418
6055,55,6365,350075,2,48446,12113,1,313785400,313785400,18166,6055,12111,6055,0,1,6057,106019,0.106019
6455,55,6365,350075,2,51646,12913,1,334329400,334329400,19366,6455,12911,6455,0,1,6457,216644,0.216644
6855,55,6365,350075,2,54846,13713,1,354873400,354873400,20566,6855,13711,6855,0,1,6857,78126,0.078126
40,550,640,352000,2,326,83,1,3196800,3196800,121,40,81,40,0,1,42,7630,0.00763
440,550,640,352000,2,3526,883,1,7004800,7004800,1321,440,881,440,0,1,442,33772,0.033772
840,550,640,352000,2,6726,1683,1,10812800,10812800,2521,840,1681,840,0,1,842,59950,0.05995
1240,550,640,352000,2,9926,2483,1,14620800,14620800,3721,1240,2481,1240,0,1,1242,86269,0.086269
1640,550,640,352000,2,13126,3283,1,18428800,18428800,4921,1640,3281,1640,0,1,1642,114544,0.114544
2040,550,640,352000,2,16326,4083,1,22236800,22236800,6121,2040,4081,2040,0,1,2042,137325,0.137325
2440,550,640,352000,2,19526,4883,1,26044800,26044800,7321,2440,4881,2440,0,1,2442,164864,0.164864
2840,550,640,352000,2,22726,5683,1,29852800,29852800,8521,2840,5681,2840,0,1,2842,129193,0.129193
3240,550,640,352000,2,25926,6483,1,33660800,33660800,9721,3240,6481,3240,0,1,3242,107450,0.10745
3640,550,640,352000,2,29126,7283,1,37468800,37468800,10921,3640,7281,3640,0,1,3642,244924,0.244924
4040,550,640,352000,2,32326,8083,1,41276800,41276800,12121,4040,8081,4040,0,1,4042,271435,0.271435
4440,550,640,352000,2,35526,8883,1,45084800,45084800,13321,4440,8881,4440,0,1,4442,298556,0.298556
4840,550,640,352000,2,38726,9683,1,48892800,48892800,14521,4840,9681,4840,0,1,4842,323366,0.323366
5240,550,640,352000,2,41926,10483,1,52700800,52700800,15721,5240,10481,5240,0,1,5242,351480,0.35148
5640,550,640,352000,2,45126,11283,1,56508800,56508800,16921,5640,11281,5640,0,1,5642,379608,0.379608
6040,550,640,352000,2,48326,12083,1,60316800,60316800,18121,6040,12081,6040,0,1,6042,281156,0.281156
6440,550,640,352000,2,51526,12883,1,64124800,64124800,19321,6440,12881,6440,0,1,6442,433131,0.433131
6840,550,640,352000,2,54726,13683,1,67932800,67932800,20521,6840,13681,6840,0,1,6842,459078,0.459078
40,1050,340,357000,2,326,83,1,3300800,3300800,121,40,81,40,0,1,42,941,0.000941
440,1050,340,357000,2,3526,883,1,7748800,7748800,1321,440,881,440,0,1,442,8496,0.008496
840,1050,340,357000,2,6726,1683,1,12196800,12196800,2521,840,1681,840,0,1,842,32189,0.032189
1240,1050,340,357000,2,9926,2483,1,16644800,16644800,3721,1240,2481,1240,0,1,1242,32754,0.032754
1640,1050,340,357000,2,13126,3283,1,21092800,21092800,4921,1640,3281,1640,0,1,1642,1994,0.001994
2040,1050,340,357000,2,16326,4083,1,25540800,25540800,6121,2040,4081,2040,0,1,2042,141491,0.141491
2440,1050,340,357000,2,19526,4883,1,29988800,29988800,7321,2440,4881,2440,0,1,2442,171926,0.171926
2840,1050,340,357000,2,22726,5683,1,34436800,34436800,8521,2840,5681,2840,0,1,2842,199482,0.199482
3240,1050,340,357000,2,25926,6483,1,38884800,38884800,9721,3240,6481,3240,0,1,3242,227480,0.22748
3640,1050,340,357000,2,29126,7283,1,43332800,43332800,10921,3640,7281,3640,0,1,3642,254546,0.254546
4040,1050,340,357000,2,32326,8083,1,47780800,47780800,12121,4040,8081,4040,0,1,4042,213068,0.213068
4440,1050,340,357000,2,35526,8883,1,52228800,52228800,13321,4440,8881,4440,0,1,4442,149459,0.149459
4840,1050,340,357000,2,38726,9683,1,56676800,56676800,14521,4840,9681,4840,0,1,4842,339495,0.339495
5240,1050,340,357000,2,41926,10483,1,61124800,61124800,15721,5240,10481,5240,0,1,5242,137169,0.137169
5640,1050,340,357000,2,45126,11283,1,65572800,65572800,16921,5640,11281,5640,0,1,5642,399401,0.399401
6040,1050,340,357000,2,48326,12083,1,70020800,70020800,18121,6040,12081,6040,0,1,6042,38452,0.038452
6440,1050,340,357000,2,51526,12883,1,74468800,74468800,19321,6440,12881,6440,0,1,6442,460113,0.460113
6840,1050,340,357000,2,54726,13683,1,78916800,78916800,20521,6840,13681,6840,0,1,6842,188736,0.188736
55,5555,65,361075,2,446,113,1,5361400,5361400,166,55,111,55,0,1,57,23069,0.023069
455,5555,65,361075,2,3646,913,1,23345400,23345400,1366,455,911,455,0,1,457,39478,0.039478
855,5555,65,361075,2,6846,1713,1,41329400,41329400,2566,855,1711,855,0,1,857,73161,0.073161
1255,5555,65,361075,2,10046,2513,1,59313400,59313400,3766,1255,2511,1255,0,1,1257,105744,0.105744
1655,5555,65,361075,2,13246,3313,1,77297400,77297400,4966,1655,3311,1655,0,1,1657,73690,0.07369
2055,5555,65,361075,2,16446,4113,1,95281400,95281400,6166,2055,4111,2055,0,1,2057,167466,0.167466
2455,5555,65,361075,2,19646,4913,1,113265400,113265400,7366,2455,4911,2455,0,1,2457,207968,0.207968
2855,5555,65,361075,2,22846,5713,1,131249400,131249400,8566,2855,5711,2855,0,1,2857,26255,0.026255
3255,5555,65,361075,2,26046,6513,1,149233400,149233400,9766,3255,6511,3255,0,1,3257,264080,0.26408
3655,5555,65,361075,2,29246,7313,1,167217400,167217400,10966,3655,7311,3655,0,1,3657,294891,0.294891
4055,5555,65,361075,2,32446,8113,1,185201400,185201400,12166,4055,8111,4055,0,1,4057,327940,0.32794
4455,5555,65,361075,2,35646,8913,1,203185400,203185400,13366,4455,8911,4455,0,1,4457,374981,0.374981
4855,5555,65,361075,2,38846,9713,1,221169400,221169400,14566,4855,9711,4855,0,1,4857,410004,0.410004
5255,5555,65,361075,2,42046,10513,1,239153400,239153400,15766,5255,10511,5255,0,1,5257,186314,0.186314
5655,5555,65,361075,2,45246,11313,1,257137400,257137400,16966,5655,11311,5655,0,1,5657,90925,0.090925
6055,5555,65,361075,2,48446,12113,1,275121400,275121400,18166,6055,12111,6055,0,1,6057,500688,0.500688
6455,5555,65,361075,2,51646,12913,1,293105400,293105400,19366,6455,12911,6455,0,1,6457,516530,0.51653
6855,5555,65,361075,2,54846,13713,1,311089400,311089400,20566,6855,13711,6855,0,1,6857,294290,0.29429
44,6653,55,365915,2,358,91,1,5288536,5288536,133,44,89,44,0,1,46,319,0.000319
544,6653,55,365915,2,4358,1091,1,32120536,32120536,1633,544,1089,544,0,1,546,42588,0.042588
1044,6653,55,365915,2,8358,2091,1,58952536,58952536,3133,1044,2089,1044,0,1,1046,43825,0.043825
1544,6653,55,365915,2,12358,3091,1,85784536,85784536,4633,1544,3089,1544,0,1,1546,126321,0.126321
2044,6653,55,365915,2,16358,4091,1,112616536,112616536,6133,2044,4089,2044,0,1,2046,172884,0.172884
2544,6653,55,365915,2,20358,5091,1,139448536,139448536,7633,2544,5089,2544,0,1,2546,212234,0.212234
3044,6653,55,365915,2,24358,6091,1,166280536,166280536,9133,3044,6089,3044,0,1,3046,222254,0.222254
3544,6653,55,365915,2,28358,7091,1,193112536,193112536,10633,3544,7089,3544,0,1,3546,299333,0.299333
4044,6653,55,365915,2,32358,8091,1,219944536,219944536,12133,4044,8089,4044,0,1,4046,334711,0.334711
4544,6653,55,365915,2,36358,9091,1,246776536,246776536,13633,4544,9089,4544,0,1,4546,376807,0.376807
5044,6653,55,365915,2,40358,10091,1,273608536,273608536,15133,5044,10089,5044,0,1,5046,290000,0.29
5544,6653,55,365915,2,44358,11091,1,300440536,300440536,16633,5544,11089,5544,0,1,5546,490901,0.490901
6044,6653,55,365915,2,48358,12091,1,327272536,327272536,18133,6044,12089,6044,0,1,6046,509376,0.509376
6544,6653,55,365915,2,52358,13091,1,354104536,354104536,19633,6544,13089,6544,0,1,6546,547886,0.547886
7044,6653,55,365915,2,56358,14091,1,380936536,380936536,21133,7044,14089,7044,0,1,7046,594326,0.594326
55,55,6665,366575,2,446,113,1,5889400,5889400,166,55,111,55,0,1,57,14008,0.014008
455,55,6665,366575,2,3646,913,1,27393400,27393400,1366,455,911,455,0,1,457,10838,0.010838
855,55,6665,366575,2,6846,1713,1,48897400,48897400,2566,855,1711,855,0,1,857,4109,0.004109
1255,55,6665,366575,2,10046,2513,1,70401400,70401400,3766,1255,2511,1255,0,1,1257,10079,0.010079
1655,55,6665,366575,2,13246,3313,1,91905400,91905400,4966,1655,3311,1655,0,1,1657,16183,0.016183
2055,55,6665,366575,2,16446,4113,1,113409400,113409400,6166,2055,4111,2055,0,1,2057,9368,0.009368
2455,55,6665,366575,2,19646,4913,1,134913400,134913400,7366,2455,4911,2455,0,1,2457,40538,0.040538
2855,55,6665,366575,2,22846,5713,1,156417400,156417400,8566,2855,5711,2855,0,1,2857,248518,0.248518
3255,55,6665,366575,2,26046,6513,1,177921400,177921400,9766,3255,6511,3255,0,1,3257,22016,0.022016
3655,55,6665,366575,2,29246,7313,1,199425400,199425400,10966,3655,7311,3655,0,1,3657,315377,0.315377
4055,55,6665,366575,2,32446,8113,1,220929400,220929400,12166,4055,8111,4055,0,1,4057,43210,0.04321
4455,55,6665,366575,2,35646,8913,1,242433400,242433400,13366,4455,8911,4455,0,1,4457,22186,0.022186
4855,55,6665,366575,2,38846,9713,1,263937400,263937400,14566,4855,9711,4855,0,1,4857,417984,0.417984
5255,55,6665,366575,2,42046,10513,1,285441400,285441400,15766,5255,10511,5255,0,1,5257,453092,0.453092
5655,55,6665,366575,2,45246,11313,1,306945400,306945400,16966,5655,11311,5655,0,1,5657,125430,0.12543
6055,55,6665,366575,2,48446,12113,1,328449400,328449400,18166,6055,12111,6055,0,1,6057,50940,0.05094
6455,55,6665,366575,2,51646,12913,1,349953400,349953400,19366,6455,12911,6455,0,1,6457,279474,0.279474
6855,55,6665,366575,2,54846,13713,1,371457400,371457400,20566,6855,13711,6855,0,1,6857,89502,0.089502
55,555,665,369075,2,446,113,1,3489400,3489400,166,55,111,55,0,1,57,9078,0.009078
455,555,665,369075,2,3646,913,1,7393400,7393400,1366,455,911,455,0,1,457,37711,0.037711
855,555,665,369075,2,6846,1713,1,11297400,11297400,2566,855,1711,855,0,1,857,64945,0.064945
1255,555,665,369075,2,10046,2513,1,15201400,15201400,3766,1255,2511,1255,0,1,1257,92565,0.092565
1655,555,665,369075,2,13246,3313,1,19105400,19105400,4966,1655,3311,1655,0,1,1657,123358,0.123358
2055,555,665,369075,2,16446,4113,1,23009400,23009400,6166,2055,4111,2055,0,1,2057,88280,0.08828
2455,555,665,369075,2,19646,4913,1,26913400,26913400,7366,2455,4911,2455,0,1,2457,180556,0.180556
2855,555,665,369075,2,22846,5713,1,30817400,30817400,8566,2855,5711,2855,0,1,2857,208284,0.208284
3255,555,665,369075,2,26046,6513,1,34721400,34721400,9766,3255,6511,3255,0,1,3257,239723,0.239723
3655,555,665,369075,2,29246,7313,1,38625400,38625400,10966,3655,7311,3655,0,1,3657,266387,0.266387
4055,555,665,369075,2,32446,8113,1,42529400,42529400,12166,4055,8111,4055,0,1,4057,296747,0.296747
4455,555,665,369075,2,35646,8913,1,46433400,46433400,13366,4455,8911,4455,0,1,4457,325777,0.325777
4855,555,665,369075,2,38846,9713,1,50337400,50337400,14566,4855,9711,4855,0,1,4857,294666,0.294666
5255,555,665,369075,2,42046,10513,1,54241400,54241400,15766,5255,10511,5255,0,1,5257,384701,0.384701
5655,555,665,369075,2,45246,11313,1,58145400,58145400,16966,5655,11311,5655,0,1,5657,415038,0.415038
6055,555,665,369075,2,48446,12113,1,62049400,62049400,18166,6055,12111,6055,0,1,6057,448752,0.448752
6455,555,665,369075,2,51646,12913,1,65953400,65953400,19366,6455,12911,6455,0,1,6457,475010,0.47501
6855,555,665,369075,2,54846,13713,1,69857400,69857400,20566,6855,13711,6855,0,1,6857,504188,0.504188
40,300,1240,372000,2,326,83,1,3468800,3468800,121,40,81,40,0,1,42,7966,0.007966
440,300,1240,372000,2,3526,883,1,8396800,8396800,1321,440,881,440,0,1,442,36079,0.036079
840,300,1240,372000,2,6726,1683,1,13324800,13324800,2521,840,1681,840,0,1,842,66386,0.066386
1240,300,1240,372000,2,9926,2483,1,18252800,18252800,3721,1240,2481,1240,0,1,1242,64225,0.064225
1640,300,1240,372000,2,13126,3283,1,23180800,23180800,4921,1640,3281,1640,0,1,1642,122373,0.122373
2040,300,1240,372000,2,16326,4083,1,28108800,28108800,6121,2040,4081,2040,0,1,2042,150298,0.150298
2440,300,1240,372000,2,19526,4883,1,33036800,33036800,7321,2440,4881,2440,0,1,2442,103514,0.103514
2840,300,1240,372000,2,22726,5683,1,37964800,37964800,8521,2840,5681,2840,0,1,2842,118208,0.118208
3240,300,1240,372000,2,25926,6483,1,42892800,42892800,9721,3240,6481,3240,0,1,3242,46470,0.04647
3640,300,1240,372000,2,29126,7283,1,47820800,47820800,10921,3640,7281,3640,0,1,3642,123822,0.123822
4040,300,1240,372000,2,32326,8083,1,52748800,52748800,12121,4040,8081,4040,0,1,4042,297650,0.29765
4440,300,1240,372000,2,35526,8883,1,57676800,57676800,13321,4440,8881,4440,0,1,4442,325225,0.325225
4840,300,1240,372000,2,38726,9683,1,62604800,62604800,14521,4840,9681,4840,0,1,4842,355896,0.355896
5240,300,1240,372000,2,41926,10483,1,67532800,67532800,15721,5240,10481,5240,0,1,5242,136814,0.136814
5640,300,1240,372000,2,45126,11283,1,72460800,72460800,16921,5640,11281,5640,0,1,5642,145530,0.14553
6040,300,1240,372000,2,48326,12083,1,77388800,77388800,18121,6040,12081,6040,0,1,6042,445007,0.445007
6440,300,1240,372000,2,51526,12883,1,82316800,82316800,19321,6440,12881,6440,0,1,6442,475596,0.475596
6840,300,1240,372000,2,54726,13683,1,87244800,87244800,20521,6840,13681,6840,0,1,6842,68451,0.068451
44,53,7055,373915,2,358,91,1,5493336,5493336,133,44,89,44,0,1,46,312,0.000312
544,53,7055,373915,2,4358,1091,1,33925336,33925336,1633,544,1089,544,0,1,546,6893,0.006893
1044,53,7055,373915,2,8358,2091,1,62357336,62357336,3133,1044,2089,1044,0,1,1046,5533,0.005533
1544,53,7055,373915,2,12358,3091,1,90789336,90789336,4633,1544,3089,1544,0,1,1546,65687,0.065687
2044,53,7055,373915,2,16358,4091,1,119221336,119221336,6133,2044,4089,2044,0,1,2046,178206,0.178206
2544,53,7055,373915,2,20358,5091,1,147653336,147653336,7633,2544,5089,2544,0,1,2546,38427,0.038427
3044,53,7055,373915,2,24358,6091,1,176085336,176085336,9133,3044,6089,3044,0,1,3046,39184,0.039184
3544,53,7055,373915,2,28358,7091,1,204517336,204517336,10633,3544,7089,3544,0,1,3546,82460,0.08246
4044,53,7055,373915,2,32358,8091,1,232949336,232949336,12133,4044,8089,4044,0,1,4046,78438,0.078438
4544,53,7055,373915,2,36358,9091,1,261381336,261381336,13633,4544,9089,4544,0,1,4546,367284,0.367284
5044,53,7055,373915,2,40358,10091,1,289813336,289813336,15133,5044,10089,5044,0,1,5046,310254,0.310254
5544,53,7055,373915,2,44358,11091,1,318245336,318245336,16633,5544,11089,5544,0,1,5546,41894,0.041894
6044,53,7055,373915,2,48358,12091,1,346677336,346677336,18133,6044,12089,6044,0,1,6046,24910,0.02491
6544,53,7055,373915,2,52358,13091,1,375109336,375109336,19633,6544,13089,6544,0,1,6546,536797,0.536797
7044,53,7055,373915,2,56358,14091,1,403541336,403541336,21133,7044,14089,7044,0,1,7046,155204,0.155204
55,5805,65,377325,2,446,113,1,5601400,5601400,166,55,111,55,0,1,57,1198,0.001198
455,5805,65,377325,2,3646,913,1,24385400,24385400,1366,455,911,455,0,1,457,19152,0.019152
855,5805,65,377325,2,6846,1713,1,43169400,43169400,2566,855,1711,855,0,1,857,25712,0.025712
1255,5805,65,377325,2,10046,2513,1,61953400,61953400,3766,1255,2511,1255,0,1,1257,97777,0.097777
1655,5805,65,377325,2,13246,3313,1,80737400,80737400,4966,1655,3311,1655,0,1,1657,142062,0.142062
2055,5805,65,377325,2,16446,4113,1,99521400,99521400,6166,2055,4111,2055,0,1,2057,173241,0.173241
2455,5805,65,377325,2,19646,4913,1,118305400,118305400,7366,2455,4911,2455,0,1,2457,206574,0.206574
2855,5805,65,377325,2,22846,5713,1,137089400,137089400,8566,2855,5711,2855,0,1,2857,238053,0.238053
3255,5805,65,377325,2,26046,6513,1,155873400,155873400,9766,3255,6511,3255,0,1,3257,178925,0.178925
3655,5805,65,377325,2,29246,7313,1,174657400,174657400,10966,3655,7311,3655,0,1,3657,307449,0.307449
4055,5805,65,377325,2,32446,8113,1,193441400,193441400,12166,4055,8111,4055,0,1,4057,337171,0.337171
4455,5805,65,377325,2,35646,8913,1,212225400,212225400,13366,4455,8911,4455,0,1,4457,48423,0.048423
4855,5805,65,377325,2,38846,9713,1,231009400,231009400,14566,4855,9711,4855,0,1,4857,114408,0.114408
5255,5805,65,377325,2,42046,10513,1,249793400,249793400,15766,5255,10511,5255,0,1,5257,456902,0.456902
5655,5805,65,377325,2,45246,11313,1,268577400,268577400,16966,5655,11311,5655,0,1,5657,489748,0.489748
6055,5805,65,377325,2,48446,12113,1,287361400,287361400,18166,6055,12111,6055,0,1,6057,539205,0.539205
6455,5805,65,377325,2,51646,12913,1,306145400,306145400,19366,6455,12911,6455,0,1,6457,7537,0.007537
6855,5805,65,377325,2,54846,13713,1,324929400,324929400,20566,6855,13711,6855,0,1,6857,81325,0.081325
55,55,6965,383075,2,446,113,1,6153400,6153400,166,55,111,55,0,1,57,12384,0.012384
455,55,6965,383075,2,3646,913,1,28617400,28617400,1366,455,911,455,0,1,457,50010,0.05001
855,55,6965,383075,2,6846,1713,1,51081400,51081400,2566,855,1711,855,0,1,857,8093,0.008093
1255,55,6965,383075,2,10046,2513,1,73545400,73545400,3766,1255,2511,1255,0,1,1257,65656,0.065656
1655,55,6965,383075,2,13246,3313,1,96009400,96009400,4966,1655,3311,1655,0,1,1657,14631,0.014631
2055,55,6965,383075,2,16446,4113,1,118473400,118473400,6166,2055,4111,2055,0,1,2057,69928,0.069928
2455,55,6965,383075,2,19646,4913,1,140937400,140937400,7366,2455,4911,2455,0,1,2457,32630,0.03263
2855,55,6965,383075,2,22846,5713,1,163401400,163401400,8566,2855,5711,2855,0,1,2857,20340,0.02034
3255,55,6965,383075,2,26046,6513,1,185865400,185865400,9766,3255,6511,3255,0,1,3257,191055,0.191055
3655,55,6965,383075,2,29246,7313,1,208329400,208329400,10966,3655,7311,3655,0,1,3657,330278,0.330278
4055,55,6965,383075,2,32446,8113,1,230793400,230793400,12166,4055,8111,4055,0,1,4057,62180,0.06218
4455,55,6965,383075,2,35646,8913,1,253257400,253257400,13366,4455,8911,4455,0,1,4457,23646,0.023646
4855,55,6965,383075,2,38846,9713,1,275721400,275721400,14566,4855,9711,4855,0,1,4857,348527,0.348527
5255,55,6965,383075,2,42046,10513,1,298185400,298185400,15766,5255,10511,5255,0,1,5257,133989,0.133989
5655,55,6965,383075,2,45246,11313,1,320649400,320649400,16966,5655,11311,5655,0,1,5657,82780,0.08278
6055,55,6965,383075,2,48446,12113,1,343113400,343113400,18166,6055,12111,6055,0,1,6057,361520,0.36152
6455,55,6965,383075,2,51646,12913,1,365577400,365577400,19366,6455,12911,6455,0,1,6457,576219,0.576219
6855,55,6965,383075,2,54846,13713,1,388041400,388041400,20566,6855,13711,6855,0,1,6857,448648,0.448648
55,1055,365,385075,2,446,113,1,3705400,3705400,166,55,111,55,0,1,57,469,0.000469
455,1055,365,385075,2,3646,913,1,8249400,8249400,1366,455,911,455,0,1,457,319,0.000319
855,1055,365,385075,2,6846,1713,1,12793400,12793400,2566,855,1711,855,0,1,857,68172,0.068172
1255,1055,365,385075,2,10046,2513,1,17337400,17337400,3766,1255,2511,1255,0,1,1257,99674,0.099674
1655,1055,365,385075,2,13246,3313,1,21881400,21881400,4966,1655,3311,1655,0,1,1657,24171,0.024171
2055,1055,365,385075,2,16446,4113,1,26425400,26425400,6166,2055,4111,2055,0,1,2057,21034,0.021034
2455,1055,365,385075,2,19646,4913,1,30969400,30969400,7366,2455,4911,2455,0,1,2457,186043,0.186043
2855,1055,365,385075,2,22846,5713,1,35513400,35513400,8566,2855,5711,2855,0,1,2857,218229,0.218229
3255,1055,365,385075,2,26046,6513,1,40057400,40057400,9766,3255,6511,3255,0,1,3257,252744,0.252744
3655,1055,365,385075,2,29246,7313,1,44601400,44601400,10966,3655,7311,3655,0,1,3657,279914,0.279914
4055,1055,365,385075,2,32446,8113,1,49145400,49145400,12166,4055,8111,4055,0,1,4057,11431,0.011431
4455,1055,365,385075,2,35646,8913,1,53689400,53689400,13366,4455,8911,4455,0,1,4457,239452,0.239452
4855,1055,365,385075,2,38846,9713,1,58233400,58233400,14566,4855,9711,4855,0,1,4857,42243,0.042243
5255,1055,365,385075,2,42046,10513,1,62777400,62777400,15766,5255,10511,5255,0,1,5257,314878,0.314878
5655,1055,365,385075,2,45246,11313,1,67321400,67321400,16966,5655,11311,5655,0,1,5657,175107,0.175107
6055,1055,365,385075,2,48446,12113,1,71865400,71865400,18166,6055,12111,6055,0,1,6057,468980,0.46898
6455,1055,365,385075,2,51646,12913,1,76409400,76409400,19366,6455,12911,6455,0,1,6457,375082,0.375082
6855,1055,365,385075,2,54846,13713,1,80953400,80953400,20566,6855,13711,6855,0,1,6857,188519,0.188519
55,305,1265,385825,2,446,113,1,3777400,3777400,166,55,111,55,0,1,57,9398,0.009398
455,305,1265,385825,2,3646,913,1,8801400,8801400,1366,455,911,455,0,1,457,39028,0.039028
855,305,1265,385825,2,6846,1713,1,13825400,13825400,2566,855,1711,855,0,1,857,64991,0.064991
1255,305,1265,385825,2,10046,2513,1,18849400,18849400,3766,1255,2511,1255,0,1,1257,63409,0.063409
1655,305,1265,385825,2,13246,3313,1,23873400,23873400,4966,1655,3311,1655,0,1,1657,129096,0.129096
2055,305,1265,385825,2,16446,4113,1,28897400,28897400,6166,2055,4111,2055,0,1,2057,159485,0.159485
2455,305,1265,385825,2,19646,4913,1,33921400,33921400,7366,2455,4911,2455,0,1,2457,194054,0.194054
2855,305,1265,385825,2,22846,5713,1,38945400,38945400,8566,2855,5711,2855,0,1,2857,223635,0.223635
3255,305,1265,385825,2,26046,6513,1,43969400,43969400,9766,3255,6511,3255,0,1,3257,251912,0.251912
3655,305,1265,385825,2,29246,7313,1,48993400,48993400,10966,3655,7311,3655,0,1,3657,284642,0.284642
4055,305,1265,385825,2,32446,8113,1,54017400,54017400,12166,4055,8111,4055,0,1,4057,132340,0.13234
4455,305,1265,385825,2,35646,8913,1,59041400,59041400,13366,4455,8911,4455,0,1,4457,344169,0.344169
4855,305,1265,385825,2,38846,9713,1,64065400,64065400,14566,4855,9711,4855,0,1,4857,373652,0.373652
5255,305,1265,385825,2,42046,10513,1,69089400,69089400,15766,5255,10511,5255,0,1,5257,83193,0.083193
5655,305,1265,385825,2,45246,11313,1,74113400,74113400,16966,5655,11311,5655,0,1,5657,226143,0.226143
6055,305,1265,385825,2,48446,12113,1,79137400,79137400,18166,6055,12111,6055,0,1,6057,65059,0.065059
6455,305,1265,385825,2,51646,12913,1,84161400,84161400,19366,6455,12911,6455,0,1,6457,501201,0.501201
6855,305,1265,385825,2,54846,13713,1,89185400,89185400,20566,6855,13711,6855,0,1,6857,530299,0.530299
55,6055,65,393575,2,446,113,1,5841400,5841400,166,55,111,55,0,1,57,36271,0.036271
455,6055,65,393575,2,3646,913,1,25425400,25425400,1366,455,911,455,0,1,457,42876,0.042876
855,6055,65,393575,2,6846,1713,1,45009400,45009400,2566,855,1711,855,0,1,857,77262,0.077262
1255,6055,65,393575,2,10046,2513,1,64593400,64593400,3766,1255,2511,1255,0,1,1257,110068,0.110068
1655,6055,65,393575,2,13246,3313,1,84177400,84177400,4966,1655,3311,1655,0,1,1657,144114,0.144114
2055,6055,65,393575,2,16446,4113,1,103761400,103761400,6166,2055,4111,2055,0,1,2057,179590,0.17959
2455,6055,65,393575,2,19646,4913,1,123345400,123345400,7366,2455,4911,2455,0,1,2457,213255,0.213255
2855,6055,65,393575,2,22846,5713,1,142929400,142929400,8566,2855,5711,2855,0,1,2857,246390,0.24639
3255,6055,65,393575,2,26046,6513,1,162513400,162513400,9766,3255,6511,3255,0,1,3257,290512,0.290512
3655,6055,65,393575,2,29246,7313,1,182097400,182097400,10966,3655,7311,3655,0,1,3657,113908,0.113908
4055,6055,65,393575,2,32446,8113,1,201681400,201681400,12166,4055,8111,4055,0,1,4057,354708,0.354708
4455,6055,65,393575,2,35646,8913,1,221265400,221265400,13366,4455,8911,4455,0,1,4457,106991,0.106991
4855,6055,65,393575,2,38846,9713,1,240849400,240849400,14566,4855,9711,4855,0,1,4857,447718,0.447718
5255,6055,65,393575,2,42046,10513,1,260433400,260433400,15766,5255,10511,5255,0,1,5257,488609,0.488609
5655,6055,65,393575,2,45246,11313,1,280017400,280017400,16966,5655,11311,5655,0,1,5657,494818,0.494818
6055,6055,65,393575,2,48446,12113,1,299601400,299601400,18166,6055,12111,6055,0,1,6057,531094,0.531094
6455,6055,65,393575,2,51646,12913,1,319185400,319185400,19366,6455,12911,6455,0,1,6457,54440,0.05444
6855,6055,65,393575,2,54846,13713,1,338769400,338769400,20566,6855,13711,6855,0,1,6857,603082,0.603082
55,6305,65,409825,2,446,113,1,6081400,6081400,166,55,111,55,0,1,57,37725,0.037725
455,6305,65,409825,2,3646,913,1,26465400,26465400,1366,455,911,455,0,1,457,45434,0.045434
855,6305,65,409825,2,6846,1713,1,46849400,46849400,2566,855,1711,855,0,1,857,83700,0.0837
1255,6305,65,409825,2,10046,2513,1,67233400,67233400,3766,1255,2511,1255,0,1,1257,117844,0.117844
1655,6305,65,409825,2,13246,3313,1,87617400,87617400,4966,1655,3311,1655,0,1,1657,157871,0.157871
2055,6305,65,409825,2,16446,4113,1,108001400,108001400,6166,2055,4111,2055,0,1,2057,189554,0.189554
2455,6305,65,409825,2,19646,4913,1,128385400,128385400,7366,2455,4911,2455,0,1,2457,236193,0.236193
2855,6305,65,409825,2,22846,5713,1,148769400,148769400,8566,2855,5711,2855,0,1,2857,27520,0.02752
3255,6305,65,409825,2,26046,6513,1,169153400,169153400,9766,3255,6511,3255,0,1,3257,292795,0.292795
3655,6305,65,409825,2,29246,7313,1,189537400,189537400,10966,3655,7311,3655,0,1,3657,335979,0.335979
4055,6305,65,409825,2,32446,8113,1,209921400,209921400,12166,4055,8111,4055,0,1,4057,377872,0.377872
4455,6305,65,409825,2,35646,8913,1,230305400,230305400,13366,4455,8911,4455,0,1,4457,418821,0.418821
4855,6305,65,409825,2,38846,9713,1,250689400,250689400,14566,4855,9711,4855,0,1,4857,259715,0.259715
5255,6305,65,409825,2,42046,10513,1,271073400,271073400,15766,5255,10511,5255,0,1,5257,283093,0.283093
5655,6305,65,409825,2,45246,11313,1,291457400,291457400,16966,5655,11311,5655,0,1,5657,523323,0.523323
6055,6305,65,409825,2,48446,12113,1,311841400,311841400,18166,6055,12111,6055,0,1,6057,366037,0.366037
6455,6305,65,409825,2,51646,12913,1,332225400,332225400,19366,6455,12911,6455,0,1,6457,616905,0.616905
6855,6305,65,409825,2,54846,13713,1,352609400,352609400,20566,6855,13711,6855,0,1,6857,633250,0.63325
55,6555,65,426075,2,446,113,1,6321400,6321400,166,55,111,55,0,1,57,544,0.000544
455,6555,65,426075,2,3646,913,1,27505400,27505400,1366,455,911,455,0,1,457,14326,0.014326
855,6555,65,426075,2,6846,1713,1,48689400,48689400,2566,855,1711,855,0,1,857,87380,0.08738
1255,6555,65,426075,2,10046,2513,1,69873400,69873400,3766,1255,2511,1255,0,1,1257,4079,0.004079
1655,6555,65,426075,2,13246,3313,1,91057400,91057400,4966,1655,3311,1655,0,1,1657,161301,0.161301
2055,6555,65,426075,2,16446,4113,1,112241400,112241400,6166,2055,4111,2055,0,1,2057,197086,0.197086
2455,6555,65,426075,2,19646,4913,1,133425400,133425400,7366,2455,4911,2455,0,1,2457,233866,0.233866
2855,6555,65,426075,2,22846,5713,1,154609400,154609400,8566,2855,5711,2855,0,1,2857,7664,0.007664
3255,6555,65,426075,2,26046,6513,1,175793400,175793400,9766,3255,6511,3255,0,1,3257,306500,0.3065
3655,6555,65,426075,2,29246,7313,1,196977400,196977400,10966,3655,7311,3655,0,1,3657,343263,0.343263
4055,6555,65,426075,2,32446,8113,1,218161400,218161400,12166,4055,8111,4055,0,1,4057,391407,0.391407
4455,6555,65,426075,2,35646,8913,1,239345400,239345400,13366,4455,8911,4455,0,1,4457,162357,0.162357
4855,6555,65,426075,2,38846,9713,1,260529400,260529400,14566,4855,9711,4855,0,1,4857,482030,0.48203
5255,6555,65,426075,2,42046,10513,1,281713400,281713400,15766,5255,10511,5255,0,1,5257,520554,0.520554
5655,6555,65,426075,2,45246,11313,1,302897400,302897400,16966,5655,11311,5655,0,1,5657,223938,0.223938
6055,6555,65,426075,2,48446,12113,1,324081400,324081400,18166,6055,12111,6055,0,1,6057,116645,0.116645
6455,6555,65,426075,2,51646,12913,1,345265400,345265400,19366,6455,12911,6455,0,1,6457,621329,0.621329
6855,6555,65,426075,2,54846,13713,1,366449400,366449400,20566,6855,13711,6855,0,1,6857,661425,0.661425
40,1300,340,442000,2,326,83,1,4060800,4060800,121,40,81,40,0,1,42,10716,0.010716
440,1300,340,442000,2,3526,883,1,9308800,9308800,1321,440,881,440,0,1,442,41186,0.041186
840,1300,340,442000,2,6726,1683,1,14556800,14556800,2521,840,1681,840,0,1,842,76940,0.07694
1240,1300,340,442000,2,9926,2483,1,19804800,19804800,3721,1240,2481,1240,0,1,1242,111134,0.111134
1640,1300,340,442000,2,13126,3283,1,25052800,25052800,4921,1640,3281,1640,0,1,1642,142291,0.142291
2040,1300,340,442000,2,16326,4083,1,30300800,30300800,6121,2040,4081,2040,0,1,2042,173996,0.173996
2440,1300,340,442000,2,19526,4883,1,35548800,35548800,7321,2440,4881,2440,0,1,2442,210292,0.210292
2840,1300,340,442000,2,22726,5683,1,40796800,40796800,8521,2840,5681,2840,0,1,2842,14865,0.014865
3240,1300,340,442000,2,25926,6483,1,46044800,46044800,9721,3240,6481,3240,0,1,3242,280549,0.280549
3640,1300,340,442000,2,29126,7283,1,51292800,51292800,10921,3640,7281,3640,0,1,3642,315706,0.315706
4040,1300,340,442000,2,32326,8083,1,56540800,56540800,12121,4040,8081,4040,0,1,4042,357794,0.357794
4440,1300,340,442000,2,35526,8883,1,61788800,61788800,13321,4440,8881,4440,0,1,4442,260214,0.260214
4840,1300,340,442000,2,38726,9683,1,67036800,67036800,14521,4840,9681,4840,0,1,4842,176459,0.176459
5240,1300,340,442000,2,41926,10483,1,72284800,72284800,15721,5240,10481,5240,0,1,5242,459449,0.459449
5640,1300,340,442000,2,45126,11283,1,77532800,77532800,16921,5640,11281,5640,0,1,5642,502735,0.502735
6040,1300,340,442000,2,48326,12083,1,82780800,82780800,18121,6040,12081,6040,0,1,6042,538869,0.538869
6440,1300,340,442000,2,51526,12883,1,88028800,88028800,19321,6440,12881,6440,0,1,6442,575676,0.575676
6840,1300,340,442000,2,54726,13683,1,93276800,93276800,20521,6840,13681,6840,0,1,6842,314720,0.31472
55,6805,65,442325,2,446,113,1,6561400,6561400,166,55,111,55,0,1,57,40028,0.040028
455,6805,65,442325,2,3646,913,1,28545400,28545400,1366,455,911,455,0,1,457,49792,0.049792
855,6805,65,442325,2,6846,1713,1,50529400,50529400,2566,855,1711,855,0,1,857,87328,0.087328
1255,6805,65,442325,2,10046,2513,1,72513400,72513400,3766,1255,2511,1255,0,1,1257,122923,0.122923
1655,6805,65,442325,2,13246,3313,1,94497400,94497400,4966,1655,3311,1655,0,1,1657,159231,0.159231
2055,6805,65,442325,2,16446,4113,1,116481400,116481400,6166,2055,4111,2055,0,1,2057,195049,0.195049
2455,6805,65,442325,2,19646,4913,1,138465400,138465400,7366,2455,4911,2455,0,1,2457,240722,0.240722
2855,6805,65,442325,2,22846,5713,1,160449400,160449400,8566,2855,5711,2855,0,1,2857,279030,0.27903
3255,6805,65,442325,2,26046,6513,1,182433400,182433400,9766,3255,6511,3255,0,1,3257,315912,0.315912
3655,6805,65,442325,2,29246,7313,1,204417400,204417400,10966,3655,7311,3655,0,1,3657,355210,0.35521
4055,6805,65,442325,2,32446,8113,1,226401400,226401400,12166,4055,8111,4055,0,1,4057,395221,0.395221
4455,6805,65,442325,2,35646,8913,1,248385400,248385400,13366,4455,8911,4455,0,1,4457,433197,0.433197
4855,6805,65,442325,2,38846,9713,1,270369400,270369400,14566,4855,9711,4855,0,1,4857,472840,0.47284
5255,6805,65,442325,2,42046,10513,1,292353400,292353400,15766,5255,10511,5255,0,1,5257,517785,0.517785
5655,6805,65,442325,2,45246,11313,1,314337400,314337400,16966,5655,11311,5655,0,1,5657,587041,0.587041
6055,6805,65,442325,2,48446,12113,1,336321400,336321400,18166,6055,12111,6055,0,1,6057,335291,0.335291
6455,6805,65,442325,2,51646,12913,1,358305400,358305400,19366,6455,12911,6455,0,1,6457,645482,0.645482
6855,6805,65,442325,2,54846,13713,1,380289400,380289400,20566,6855,13711,6855,0,1,6857,711589,0.711589
55,7055,65,458575,2,446,113,1,6801400,6801400,166,55,111,55,0,1,57,41193,0.041193
455,7055,65,458575,2,3646,913,1,29585400,29585400,1366,455,911,455,0,1,457,51930,0.05193
855,7055,65,458575,2,6846,1713,1,52369400,52369400,2566,855,1711,855,0,1,857,97381,0.097381
1255,7055,65,458575,2,10046,2513,1,75153400,75153400,3766,1255,2511,1255,0,1,1257,127573,0.127573
1655,7055,65,458575,2,13246,3313,1,97937400,97937400,4966,1655,3311,1655,0,1,1657,165215,0.165215
2055,7055,65,458575,2,16446,4113,1,120721400,120721400,6166,2055,4111,2055,0,1,2057,206353,0.206353
2455,7055,65,458575,2,19646,4913,1,143505400,143505400,7366,2455,4911,2455,0,1,2457,247600,0.2476
2855,7055,65,458575,2,22846,5713,1,166289400,166289400,8566,2855,5711,2855,0,1,2857,290941,0.290941
3255,7055,65,458575,2,26046,6513,1,189073400,189073400,9766,3255,6511,3255,0,1,3257,335114,0.335114
3655,7055,65,458575,2,29246,7313,1,211857400,211857400,10966,3655,7311,3655,0,1,3657,392368,0.392368
4055,7055,65,458575,2,32446,8113,1,234641400,234641400,12166,4055,8111,4055,0,1,4057,411436,0.411436
4455,7055,65,458575,2,35646,8913,1,257425400,257425400,13366,4455,8911,4455,0,1,4457,461047,0.461047
4855,7055,65,458575,2,38846,9713,1,280209400,280209400,14566,4855,9711,4855,0,1,4857,523981,0.523981
5255,7055,65,458575,2,42046,10513,1,302993400,302993400,15766,5255,10511,5255,0,1,5257,535702,0.535702
5655,7055,65,458575,2,45246,11313,1,325777400,325777400,16966,5655,11311,5655,0,1,5657,601813,0.601813
6055,7055,65,458575,2,48446,12113,1,348561400,348561400,18166,6055,12111,6055,0,1,6057,625377,0.625377
6455,7055,65,458575,2,51646,12913,1,371345400,371345400,19366,6455,12911,6455,0,1,6457,731417,0.731417
6855,7055,65,458575,2,54846,13713,1,394129400,394129400,20566,6855,13711,6855,0,1,6857,731560,0.73156
40,300,1540,462000,2,326,83,1,4284800,4284800,121,40,81,40,0,1,42,9639,0.009639
440,300,1540,462000,2,3526,883,1,10172800,10172800,1321,440,881,440,0,1,442,44712,0.044712
840,300,1540,462000,2,6726,1683,1,16060800,16060800,2521,840,1681,840,0,1,842,84526,0.084526
1240,300,1540,462000,2,9926,2483,1,21948800,21948800,3721,1240,2481,1240,0,1,1242,115949,0.115949
1640,300,1540,462000,2,13126,3283,1,27836800,27836800,4921,1640,3281,1640,0,1,1642,152079,0.152079
2040,300,1540,462000,2,16326,4083,1,33724800,33724800,6121,2040,4081,2040,0,1,2042,134601,0.134601
2440,300,1540,462000,2,19526,4883,1,39612800,39612800,7321,2440,4881,2440,0,1,2442,223799,0.223799
2840,300,1540,462000,2,22726,5683,1,45500800,45500800,8521,2840,5681,2840,0,1,2842,259798,0.259798
3240,300,1540,462000,2,25926,6483,1,51388800,51388800,9721,3240,6481,3240,0,1,3242,21363,0.021363
3640,300,1540,462000,2,29126,7283,1,57276800,57276800,10921,3640,7281,3640,0,1,3642,337256,0.337256
4040,300,1540,462000,2,32326,8083,1,63164800,63164800,12121,4040,8081,4040,0,1,4042,44624,0.044624
4440,300,1540,462000,2,35526,8883,1,69052800,69052800,13321,4440,8881,4440,0,1,4442,257014,0.257014
4840,300,1540,462000,2,38726,9683,1,74940800,74940800,14521,4840,9681,4840,0,1,4842,442700,0.4427
5240,300,1540,462000,2,41926,10483,1,80828800,80828800,15721,5240,10481,5240,0,1,5242,479234,0.479234
5640,300,1540,462000,2,45126,11283,1,86716800,86716800,16921,5640,11281,5640,0,1,5642,518989,0.518989
6040,300,1540,462000,2,48326,12083,1,92604800,92604800,18121,6040,12081,6040,0,1,6042,68943,0.068943
6440,300,1540,462000,2,51526,12883,1,98492800,98492800,19321,6440,12881,6440,0,1,6442,80760,0.08076
6840,300,1540,462000,2,54726,13683,1,104380800,104380800,20521,6840,13681,6840,0,1,6842,24742,0.024742
55,1305,365,476325,2,446,113,1,4545400,4545400,166,55,111,55,0,1,57,10691,0.010691
455,1305,365,476325,2,3646,913,1,9889400,9889400,1366,455,911,455,0,1,457,46338,0.046338
855,1305,365,476325,2,6846,1713,1,15233400,15233400,2566,855,1711,855,0,1,857,84296,0.084296
1255,1305,365,476325,2,10046,2513,1,20577400,20577400,3766,1255,2511,1255,0,1,1257,120229,0.120229
1655,1305,365,476325,2,13246,3313,1,25921400,25921400,4966,1655,3311,1655,0,1,1657,159225,0.159225
2055,1305,365,476325,2,16446,4113,1,31265400,31265400,6166,2055,4111,2055,0,1,2057,198573,0.198573
2455,1305,365,476325,2,19646,4913,1,36609400,36609400,7366,2455,4911,2455,0,1,2457,230734,0.230734
2855,1305,365,476325,2,22846,5713,1,41953400,41953400,8566,2855,5711,2855,0,1,2857,270026,0.270026
3255,1305,365,476325,2,26046,6513,1,47297400,47297400,9766,3255,6511,3255,0,1,3257,309646,0.309646
3655,1305,365,476325,2,29246,7313,1,52641400,52641400,10966,3655,7311,3655,0,1,3657,52102,0.052102
4055,1305,365,476325,2,32446,8113,1,57985400,57985400,12166,4055,8111,4055,0,1,4057,385070,0.38507
4455,1305,365,476325,2,35646,8913,1,63329400,63329400,13366,4455,8911,4455,0,1,4457,425094,0.425094
4855,1305,365,476325,2,38846,9713,1,68673400,68673400,14566,4855,9711,4855,0,1,4857,464729,0.464729
5255,1305,365,476325,2,42046,10513,1,74017400,74017400,15766,5255,10511,5255,0,1,5257,502629,0.502629
5655,1305,365,476325,2,45246,11313,1,79361400,79361400,16966,5655,11311,5655,0,1,5657,541740,0.54174
6055,1305,365,476325,2,48446,12113,1,84705400,84705400,18166,6055,12111,6055,0,1,6057,584423,0.584423
6455,1305,365,476325,2,51646,12913,1,90049400,90049400,19366,6455,12911,6455,0,1,6457,296267,0.296267
6855,1305,365,476325,2,54846,13713,1,95393400,95393400,20566,6855,13711,6855,0,1,6857,359758,0.359758
55,305,1565,477325,2,446,113,1,4641400,4641400,166,55,111,55,0,1,57,11724,0.011724
455,305,1565,477325,2,3646,913,1,10625400,10625400,1366,455,911,455,0,1,457,12622,0.012622
855,305,1565,477325,2,6846,1713,1,16609400,16609400,2566,855,1711,855,0,1,857,2940,0.00294
1255,305,1565,477325,2,10046,2513,1,22593400,22593400,3766,1255,2511,1255,0,1,1257,43167,0.043167
1655,305,1565,477325,2,13246,3313,1,28577400,28577400,4966,1655,3311,1655,0,1,1657,159898,0.159898
2055,305,1565,477325,2,16446,4113,1,34561400,34561400,6166,2055,4111,2055,0,1,2057,197429,0.197429
2455,305,1565,477325,2,19646,4913,1,40545400,40545400,7366,2455,4911,2455,0,1,2457,236388,0.236388
2855,305,1565,477325,2,22846,5713,1,46529400,46529400,8566,2855,5711,2855,0,1,2857,278136,0.278136
3255,305,1565,477325,2,26046,6513,1,52513400,52513400,9766,3255,6511,3255,0,1,3257,312219,0.312219
3655,305,1565,477325,2,29246,7313,1,58497400,58497400,10966,3655,7311,3655,0,1,3657,350198,0.350198
4055,305,1565,477325,2,32446,8113,1,64481400,64481400,12166,4055,8111,4055,0,1,4057,390034,0.390034
4455,305,1565,477325,2,35646,8913,1,70465400,70465400,13366,4455,8911,4455,0,1,4457,427816,0.427816
4855,305,1565,477325,2,38846,9713,1,76449400,76449400,14566,4855,9711,4855,0,1,4857,303979,0.303979
5255,305,1565,477325,2,42046,10513,1,82433400,82433400,15766,5255,10511,5255,0,1,5257,501699,0.501699
5655,305,1565,477325,2,45246,11313,1,88417400,88417400,16966,5655,11311,5655,0,1,5657,282685,0.282685
6055,305,1565,477325,2,48446,12113,1,94401400,94401400,18166,6055,12111,6055,0,1,6057,331921,0.331921
6455,305,1565,477325,2,51646,12913,1,100385400,100385400,19366,6455,12911,6455,0,1,6457,141695,0.141695
6855,305,1565,477325,2,54846,13713,1,106369400,106369400,20566,6855,13711,6855,0,1,6857,96943,0.096943
40,800,640,512000,2,326,83,1,4556800,4556800,121,40,81,40,0,1,42,10135,0.010135
440,800,640,512000,2,3526,883,1,9164800,9164800,1321,440,881,440,0,1,442,47526,0.047526
840,800,640,512000,2,6726,1683,1,13772800,13772800,2521,840,1681,840,0,1,842,7281,0.007281
1240,800,640,512000,2,9926,2483,1,18380800,18380800,3721,1240,2481,1240,0,1,1242,125002,0.125002
1640,800,640,512000,2,13126,3283,1,22988800,22988800,4921,1640,3281,1640,0,1,1642,159353,0.159353
2040,800,640,512000,2,16326,4083,1,27596800,27596800,6121,2040,4081,2040,0,1,2042,202016,0.202016
2440,800,640,512000,2,19526,4883,1,32204800,32204800,7321,2440,4881,2440,0,1,2442,154921,0.154921
2840,800,640,512000,2,22726,5683,1,36812800,36812800,8521,2840,5681,2840,0,1,2842,8673,0.008673
3240,800,640,512000,2,25926,6483,1,41420800,41420800,9721,3240,6481,3240,0,1,3242,312209,0.312209
3640,800,640,512000,2,29126,7283,1,46028800,46028800,10921,3640,7281,3640,0,1,3642,350152,0.350152
4040,800,640,512000,2,32326,8083,1,50636800,50636800,12121,4040,8081,4040,0,1,4042,9413,0.009413
4440,800,640,512000,2,35526,8883,1,55244800,55244800,13321,4440,8881,4440,0,1,4442,432102,0.432102
4840,800,640,512000,2,38726,9683,1,59852800,59852800,14521,4840,9681,4840,0,1,4842,175395,0.175395
5240,800,640,512000,2,41926,10483,1,64460800,64460800,15721,5240,10481,5240,0,1,5242,506169,0.506169
5640,800,640,512000,2,45126,11283,1,69068800,69068800,16921,5640,11281,5640,0,1,5642,543519,0.543519
6040,800,640,512000,2,48326,12083,1,73676800,73676800,18121,6040,12081,6040,0,1,6042,15774,0.015774
6440,800,640,512000,2,51526,12883,1,78284800,78284800,19321,6440,12881,6440,0,1,6442,365875,0.365875
6840,800,640,512000,2,54726,13683,1,82892800,82892800,20521,6840,13681,6840,0,1,6842,662316,0.662316
40,550,940,517000,2,326,83,1,4612800,4612800,121,40,81,40,0,1,42,10987,0.010987
440,550,940,517000,2,3526,883,1,9380800,9380800,1321,440,881,440,0,1,442,48516,0.048516
840,550,940,517000,2,6726,1683,1,14148800,14148800,2521,840,1681,840,0,1,842,87652,0.087652
1240,550,940,517000,2,9926,2483,1,18916800,18916800,3721,1240,2481,1240,0,1,1242,127200,0.1272
1640,550,940,517000,2,13126,3283,1,23684800,23684800,4921,1640,3281,1640,0,1,1642,169132,0.169132
2040,550,940,517000,2,16326,4083,1,28452800,28452800,6121,2040,4081,2040,0,1,2042,205811,0.205811
2440,550,940,517000,2,19526,4883,1,33220800,33220800,7321,2440,4881,2440,0,1,2442,245564,0.245564
2840,550,940,517000,2,22726,5683,1,37988800,37988800,8521,2840,5681,2840,0,1,2842,286030,0.28603
3240,550,940,517000,2,25926,6483,1,42756800,42756800,9721,3240,6481,3240,0,1,3242,326838,0.326838
3640,550,940,517000,2,29126,7283,1,47524800,47524800,10921,3640,7281,3640,0,1,3642,368080,0.36808
4040,550,940,517000,2,32326,8083,1,52292800,52292800,12121,4040,8081,4040,0,1,4042,380767,0.380767
4440,550,940,517000,2,35526,8883,1,57060800,57060800,13321,4440,8881,4440,0,1,4442,446390,0.44639
4840,550,940,517000,2,38726,9683,1,61828800,61828800,14521,4840,9681,4840,0,1,4842,303178,0.303178
5240,550,940,517000,2,41926,10483,1,66596800,66596800,15721,5240,10481,5240,0,1,5242,526288,0.526288
5640,550,940,517000,2,45126,11283,1,71364800,71364800,16921,5640,11281,5640,0,1,5642,207756,0.207756
6040,550,940,517000,2,48326,12083,1,76132800,76132800,18121,6040,12081,6040,0,1,6042,380598,0.380598
6440,550,940,517000,2,51526,12883,1,80900800,80900800,19321,6440,12881,6440,0,1,6442,225058,0.225058
6840,550,940,517000,2,54726,13683,1,85668800,85668800,20521,6840,13681,6840,0,1,6842,689310,0.68931
40,1550,340,527000,2,326,83,1,4820800,4820800,121,40,81,40,0,1,42,11379,0.011379
440,1550,340,527000,2,3526,883,1,10868800,10868800,1321,440,881,440,0,1,442,49032,0.049032
840,1550,340,527000,2,6726,1683,1,16916800,16916800,2521,840,1681,840,0,1,842,91987,0.091987
1240,1550,340,527000,2,9926,2483,1,22964800,22964800,3721,1240,2481,1240,0,1,1242,132495,0.132495
1640,1550,340,527000,2,13126,3283,1,29012800,29012800,4921,1640,3281,1640,0,1,1642,175161,0.175161
2040,1550,340,527000,2,16326,4083,1,35060800,35060800,6121,2040,4081,2040,0,1,2042,213482,0.213482
2440,1550,340,527000,2,19526,4883,1,41108800,41108800,7321,2440,4881,2440,0,1,2442,251341,0.251341
2840,1550,340,527000,2,22726,5683,1,47156800,47156800,8521,2840,5681,2840,0,1,2842,294589,0.294589
3240,1550,340,527000,2,25926,6483,1,53204800,53204800,9721,3240,6481,3240,0,1,3242,334324,0.334324
3640,1550,340,527000,2,29126,7283,1,59252800,59252800,10921,3640,7281,3640,0,1,3642,134157,0.134157
4040,1550,340,527000,2,32326,8083,1,65300800,65300800,12121,4040,8081,4040,0,1,4042,421507,0.421507
4440,1550,340,527000,2,35526,8883,1,71348800,71348800,13321,4440,8881,4440,0,1,4442,220789,0.220789
4840,1550,340,527000,2,38726,9683,1,77396800,77396800,14521,4840,9681,4840,0,1,4842,506124,0.506124
5240,1550,340,527000,2,41926,10483,1,83444800,83444800,15721,5240,10481,5240,0,1,5242,551287,0.551287
5640,1550,340,527000,2,45126,11283,1,89492800,89492800,16921,5640,11281,5640,0,1,5642,595470,0.59547
6040,1550,340,527000,2,48326,12083,1,95540800,95540800,18121,6040,12081,6040,0,1,6042,644374,0.644374
6440,1550,340,527000,2,51526,12883,1,101588800,101588800,19321,6440,12881,6440,0,1,6442,683775,0.683775
6840,1550,340,527000,2,54726,13683,1,107636800,107636800,20521,6840,13681,6840,0,1,6842,722145,0.722145
55,805,665,535325,2,446,113,1,4929400,4929400,166,55,111,55,0,1,57,11997,0.011997
455,805,665,535325,2,3646,913,1,9633400,9633400,1366,455,911,455,0,1,457,50878,0.050878
855,805,665,535325,2,6846,1713,1,14337400,14337400,2566,855,1711,855,0,1,857,94061,0.094061
1255,805,665,535325,2,10046,2513,1,19041400,19041400,3766,1255,2511,1255,0,1,1257,96362,0.096362
1655,805,665,535325,2,13246,3313,1,23745400,23745400,4966,1655,3311,1655,0,1,1657,175970,0.17597
2055,805,665,535325,2,16446,4113,1,28449400,28449400,6166,2055,4111,2055,0,1,2057,215790,0.21579
2455,805,665,535325,2,19646,4913,1,33153400,33153400,7366,2455,4911,2455,0,1,2457,257798,0.257798
2855,805,665,535325,2,22846,5713,1,37857400,37857400,8566,2855,5711,2855,0,1,2857,299167,0.299167
3255,805,665,535325,2,26046,6513,1,42561400,42561400,9766,3255,6511,3255,0,1,3257,341015,0.341015
3655,805,665,535325,2,29246,7313,1,47265400,47265400,10966,3655,7311,3655,0,1,3657,184349,0.184349
4055,805,665,535325,2,32446,8113,1,51969400,51969400,12166,4055,8111,4055,0,1,4057,427411,0.427411
4455,805,665,535325,2,35646,8913,1,56673400,56673400,13366,4455,8911,4455,0,1,4457,185395,0.185395
4855,805,665,535325,2,38846,9713,1,61377400,61377400,14566,4855,9711,4855,0,1,4857,511975,0.511975
5255,805,665,535325,2,42046,10513,1,66081400,66081400,15766,5255,10511,5255,0,1,5257,449397,0.449397
5655,805,665,535325,2,45246,11313,1,70785400,70785400,16966,5655,11311,5655,0,1,5657,281885,0.281885
6055,805,665,535325,2,48446,12113,1,75489400,75489400,18166,6055,12111,6055,0,1,6057,289064,0.289064
6455,805,665,535325,2,51646,12913,1,80193400,80193400,19366,6455,12911,6455,0,1,6457,682341,0.682341
6855,805,665,535325,2,54846,13713,1,84897400,84897400,20566,6855,13711,6855,0,1,6857,725203,0.725203
55,555,965,535575,2,446,113,1,4953400,4953400,166,55,111,55,0,1,57,12551,0.012551
455,555,965,535575,2,3646,913,1,9817400,9817400,1366,455,911,455,0,1,457,52221,0.052221
855,555,965,535575,2,6846,1713,1,14681400,14681400,2566,855,1711,855,0,1,857,92861,0.092861
1255,555,965,535575,2,10046,2513,1,19545400,19545400,3766,1255,2511,1255,0,1,1257,134606,0.134606
1655,555,965,535575,2,13246,3313,1,24409400,24409400,4966,1655,3311,1655,0,1,1657,176559,0.176559
2055,555,965,535575,2,16446,4113,1,29273400,29273400,6166,2055,4111,2055,0,1,2057,218129,0.218129
2455,555,965,535575,2,19646,4913,1,34137400,34137400,7366,2455,4911,2455,0,1,2457,258457,0.258457
2855,555,965,535575,2,22846,5713,1,39001400,39001400,8566,2855,5711,2855,0,1,2857,300265,0.300265
3255,555,965,535575,2,26046,6513,1,43865400,43865400,9766,3255,6511,3255,0,1,3257,161299,0.161299
3655,555,965,535575,2,29246,7313,1,48729400,48729400,10966,3655,7311,3655,0,1,3657,386246,0.386246
4055,555,965,535575,2,32446,8113,1,53593400,53593400,12166,4055,8111,4055,0,1,4057,89429,0.089429
4455,555,965,535575,2,35646,8913,1,58457400,58457400,13366,4455,8911,4455,0,1,4457,444022,0.444022
4855,555,965,535575,2,38846,9713,1,63321400,63321400,14566,4855,9711,4855,0,1,4857,515955,0.515955
5255,555,965,535575,2,42046,10513,1,68185400,68185400,15766,5255,10511,5255,0,1,5257,556039,0.556039
5655,555,965,535575,2,45246,11313,1,73049400,73049400,16966,5655,11311,5655,0,1,5657,19376,0.019376
6055,555,965,535575,2,48446,12113,1,77913400,77913400,18166,6055,12111,6055,0,1,6057,99798,0.099798
6455,555,965,535575,2,51646,12913,1,82777400,82777400,19366,6455,12911,6455,0,1,6457,476251,0.476251
6855,555,965,535575,2,54846,13713,1,87641400,87641400,20566,6855,13711,6855,0,1,6857,392911,0.392911
40,300,1840,552000,2,326,83,1,5100800,5100800,121,40,81,40,0,1,42,11043,0.011043
440,300,1840,552000,2,3526,883,1,11948800,11948800,1321,440,881,440,0,1,442,52046,0.052046
840,300,1840,552000,2,6726,1683,1,18796800,18796800,2521,840,1681,840,0,1,842,94456,0.094456
1240,300,1840,552000,2,9926,2483,1,25644800,25644800,3721,1240,2481,1240,0,1,1242,134926,0.134926
1640,300,1840,552000,2,13126,3283,1,32492800,32492800,4921,1640,3281,1640,0,1,1642,160189,0.160189
2040,300,1840,552000,2,16326,4083,1,39340800,39340800,6121,2040,4081,2040,0,1,2042,87860,0.08786
2440,300,1840,552000,2,19526,4883,1,46188800,46188800,7321,2440,4881,2440,0,1,2442,265188,0.265188
2840,300,1840,552000,2,22726,5683,1,53036800,53036800,8521,2840,5681,2840,0,1,2842,302037,0.302037
3240,300,1840,552000,2,25926,6483,1,59884800,59884800,9721,3240,6481,3240,0,1,3242,48045,0.048045
3640,300,1840,552000,2,29126,7283,1,66732800,66732800,10921,3640,7281,3640,0,1,3642,389607,0.389607
4040,300,1840,552000,2,32326,8083,1,73580800,73580800,12121,4040,8081,4040,0,1,4042,108832,0.108832
4440,300,1840,552000,2,35526,8883,1,80428800,80428800,13321,4440,8881,4440,0,1,4442,207310,0.20731
4840,300,1840,552000,2,38726,9683,1,87276800,87276800,14521,4840,9681,4840,0,1,4842,514775,0.514775
5240,300,1840,552000,2,41926,10483,1,94124800,94124800,15721,5240,10481,5240,0,1,5242,266862,0.266862
5640,300,1840,552000,2,45126,11283,1,100972800,100972800,16921,5640,11281,5640,0,1,5642,601889,0.601889
6040,300,1840,552000,2,48326,12083,1,107820800,107820800,18121,6040,12081,6040,0,1,6042,645165,0.645165
6440,300,1840,552000,2,51526,12883,1,114668800,114668800,19321,6440,12881,6440,0,1,6442,685511,0.685511
6840,300,1840,552000,2,54726,13683,1,121516800,121516800,20521,6840,13681,6840,0,1,6842,29042,0.029042
55,1555,365,567575,2,446,113,1,5385400,5385400,166,55,111,55,0,1,57,13040,0.01304
455,1555,365,567575,2,3646,913,1,11529400,11529400,1366,455,911,455,0,1,457,54538,0.054538
855,1555,365,567575,2,6846,1713,1,17673400,17673400,2566,855,1711,855,0,1,857,100528,0.100528
1255,1555,365,567575,2,10046,2513,1,23817400,23817400,3766,1255,2511,1255,0,1,1257,140733,0.140733
1655,1555,365,567575,2,13246,3313,1,29961400,29961400,4966,1655,3311,1655,0,1,1657,185194,0.185194
2055,1555,365,567575,2,16446,4113,1,36105400,36105400,6166,2055,4111,2055,0,1,2057,231236,0.231236
2455,1555,365,567575,2,19646,4913,1,42249400,42249400,7366,2455,4911,2455,0,1,2457,275798,0.275798
2855,1555,365,567575,2,22846,5713,1,48393400,48393400,8566,2855,5711,2855,0,1,2857,320612,0.320612
3255,1555,365,567575,2,26046,6513,1,54537400,54537400,9766,3255,6511,3255,0,1,3257,367100,0.3671
3655,1555,365,567575,2,29246,7313,1,60681400,60681400,10966,3655,7311,3655,0,1,3657,412748,0.412748
4055,1555,365,567575,2,32446,8113,1,66825400,66825400,12166,4055,8111,4055,0,1,4057,459729,0.459729
4455,1555,365,567575,2,35646,8913,1,72969400,72969400,13366,4455,8911,4455,0,1,4457,506234,0.506234
4855,1555,365,567575,2,38846,9713,1,79113400,79113400,14566,4855,9711,4855,0,1,4857,1825,0.001825
5255,1555,365,567575,2,42046,10513,1,85257400,85257400,15766,5255,10511,5255,0,1,5257,602586,0.602586
5655,1555,365,567575,2,45246,11313,1,91401400,91401400,16966,5655,11311,5655,0,1,5657,10871,0.010871
6055,1555,365,567575,2,48446,12113,1,97545400,97545400,18166,6055,12111,6055,0,1,6057,709326,0.709326
6455,1555,365,567575,2,51646,12913,1,103689400,103689400,19366,6455,12911,6455,0,1,6457,765434,0.765434
6855,1555,365,567575,2,54846,13713,1,109833400,109833400,20566,6855,13711,6855,0,1,6857,792599,0.792599
55,305,1865,568825,2,446,113,1,5505400,5505400,166,55,111,55,0,1,57,13310,0.01331
455,305,1865,568825,2,3646,913,1,12449400,12449400,1366,455,911,455,0,1,457,58792,0.058792
855,305,1865,568825,2,6846,1713,1,19393400,19393400,2566,855,1711,855,0,1,857,100514,0.100514
1255,305,1865,568825,2,10046,2513,1,26337400,26337400,3766,1255,2511,1255,0,1,1257,148635,0.148635
1655,305,1865,568825,2,13246,3313,1,33281400,33281400,4966,1655,3311,1655,0,1,1657,189250,0.18925
2055,305,1865,568825,2,16446,4113,1,40225400,40225400,6166,2055,4111,2055,0,1,2057,73792,0.073792
2455,305,1865,568825,2,19646,4913,1,47169400,47169400,7366,2455,4911,2455,0,1,2457,252562,0.252562
2855,305,1865,568825,2,22846,5713,1,54113400,54113400,8566,2855,5711,2855,0,1,2857,324737,0.324737
3255,305,1865,568825,2,26046,6513,1,61057400,61057400,9766,3255,6511,3255,0,1,3257,227818,0.227818
3655,305,1865,568825,2,29246,7313,1,68001400,68001400,10966,3655,7311,3655,0,1,3657,418044,0.418044
4055,305,1865,568825,2,32446,8113,1,74945400,74945400,12166,4055,8111,4055,0,1,4057,463161,0.463161
4455,305,1865,568825,2,35646,8913,1,81889400,81889400,13366,4455,8911,4455,0,1,4457,32420,0.03242
4855,305,1865,568825,2,38846,9713,1,88833400,88833400,14566,4855,9711,4855,0,1,4857,59265,0.059265
5255,305,1865,568825,2,42046,10513,1,95777400,95777400,15766,5255,10511,5255,0,1,5257,380577,0.380577
5655,305,1865,568825,2,45246,11313,1,102721400,102721400,16966,5655,11311,5655,0,1,5657,7616,0.007616
6055,305,1865,568825,2,48446,12113,1,109665400,109665400,18166,6055,12111,6055,0,1,6057,601231,0.601231
6455,305,1865,568825,2,51646,12913,1,116609400,116609400,19366,6455,12911,6455,0,1,6457,383890,0.38389
6855,305,1865,568825,2,54846,13713,1,123553400,123553400,20566,6855,13711,6855,0,1,6857,337380,0.33738
40,1800,340,612000,2,326,83,1,5580800,5580800,121,40,81,40,0,1,42,12400,0.0124
440,1800,340,612000,2,3526,883,1,12428800,12428800,1321,440,881,440,0,1,442,58185,0.058185
840,1800,340,612000,2,6726,1683,1,19276800,19276800,2521,840,1681,840,0,1,842,104297,0.104297
1240,1800,340,612000,2,9926,2483,1,26124800,26124800,3721,1240,2481,1240,0,1,1242,146862,0.146862
1640,1800,340,612000,2,13126,3283,1,32972800,32972800,4921,1640,3281,1640,0,1,1642,198604,0.198604
2040,1800,340,612000,2,16326,4083,1,39820800,39820800,6121,2040,4081,2040,0,1,2042,246569,0.246569
2440,1800,340,612000,2,19526,4883,1,46668800,46668800,7321,2440,4881,2440,0,1,2442,295112,0.295112
2840,1800,340,612000,2,22726,5683,1,53516800,53516800,8521,2840,5681,2840,0,1,2842,32753,0.032753
3240,1800,340,612000,2,25926,6483,1,60364800,60364800,9721,3240,6481,3240,0,1,3242,196044,0.196044
3640,1800,340,612000,2,29126,7283,1,67212800,67212800,10921,3640,7281,3640,0,1,3642,437071,0.437071
4040,1800,340,612000,2,32326,8083,1,74060800,74060800,12121,4040,8081,4040,0,1,4042,330287,0.330287
4440,1800,340,612000,2,35526,8883,1,80908800,80908800,13321,4440,8881,4440,0,1,4442,540300,0.5403
4840,1800,340,612000,2,38726,9683,1,87756800,87756800,14521,4840,9681,4840,0,1,4842,591293,0.591293
5240,1800,340,612000,2,41926,10483,1,94604800,94604800,15721,5240,10481,5240,0,1,5242,644621,0.644621
5640,1800,340,612000,2,45126,11283,1,101452800,101452800,16921,5640,11281,5640,0,1,5642,624939,0.624939
6040,1800,340,612000,2,48326,12083,1,108300800,108300800,18121,6040,12081,6040,0,1,6042,764067,0.764067
6440,1800,340,612000,2,51526,12883,1,115148800,115148800,19321,6440,12881,6440,0,1,6442,798705,0.798705
6840,1800,340,612000,2,54726,13683,1,121996800,121996800,20521,6840,13681,6840,0,1,6842,841567,0.841567
35,590,1045,616550,2,286,73,1,5390200,5390200,106,35,71,35,0,1,37,2289,0.002289
535,590,1045,616550,2,4286,1073,1,11930200,11930200,1606,535,1071,535,0,1,537,6008,0.006008
1035,590,1045,616550,2,8286,2073,1,18470200,18470200,3106,1035,2071,1035,0,1,1037,2039,0.002039
1535,590,1045,616550,2,12286,3073,1,25010200,25010200,4606,1535,3071,1535,0,1,1537,14908,0.014908
2035,590,1045,616550,2,16286,4073,1,31550200,31550200,6106,2035,4071,2035,0,1,2037,70691,0.070691
2535,590,1045,616550,2,20286,5073,1,38090200,38090200,7606,2535,5071,2535,0,1,2537,312533,0.312533
3035,590,1045,616550,2,24286,6073,1,44630200,44630200,9106,3035,6071,3035,0,1,3037,374140,0.37414
3535,590,1045,616550,2,28286,7073,1,51170200,51170200,10606,3535,7071,3535,0,1,3537,438846,0.438846
4035,590,1045,616550,2,32286,8073,1,57710200,57710200,12106,4035,8071,4035,0,1,4037,502791,0.502791
4535,590,1045,616550,2,36286,9073,1,64250200,64250200,13606,4535,9071,4535,0,1,4537,566908,0.566908
5035,590,1045,616550,2,40286,10073,1,70790200,70790200,15106,5035,10071,5035,0,1,5037,635868,0.635868
5535,590,1045,616550,2,44286,11073,1,77330200,77330200,16606,5535,11071,5535,0,1,5537,697837,0.697837
6035,590,1045,616550,2,48286,12073,1,83870200,83870200,18106,6035,12071,6035,0,1,6037,760850,0.76085
6535,590,1045,616550,2,52286,13073,1,90410200,90410200,19606,6535,13071,6535,0,1,6537,837279,0.837279
7035,590,1045,616550,2,56286,14073,1,96950200,96950200,21106,7035,14071,7035,0,1,7037,886435,0.886435
39,593,1041,617313,2,318,81,1,5448312,5448312,118,39,79,39,0,1,41,12470,0.01247
539,593,1041,617313,2,4318,1081,1,11984312,11984312,1618,539,1079,539,0,1,541,70058,0.070058
1039,593,1041,617313,2,8318,2081,1,18520312,18520312,3118,1039,2079,1039,0,1,1041,130011,0.130011
1539,593,1041,617313,2,12318,3081,1,25056312,25056312,4618,1539,3079,1539,0,1,1541,115293,0.115293
2039,593,1041,617313,2,16318,4081,1,31592312,31592312,6118,2039,4079,2039,0,1,2041,245705,0.245705
2539,593,1041,617313,2,20318,5081,1,38128312,38128312,7618,2539,5079,2539,0,1,2541,161763,0.161763
3039,593,1041,617313,2,24318,6081,1,44664312,44664312,9118,3039,6079,3039,0,1,3041,365738,0.365738
3539,593,1041,617313,2,28318,7081,1,51200312,51200312,10618,3539,7079,3539,0,1,3541,40799,0.040799
4039,593,1041,617313,2,32318,8081,1,57736312,57736312,12118,4039,8079,4039,0,1,4041,9401,0.009401
4539,593,1041,617313,2,36318,9081,1,64272312,64272312,13618,4539,9079,4539,0,1,4541,550562,0.550562
5039,593,1041,617313,2,40318,10081,1,70808312,70808312,15118,5039,10079,5039,0,1,5041,610248,0.610248
5539,593,1041,617313,2,44318,11081,1,77344312,77344312,16618,5539,11079,5539,0,1,5541,138054,0.138054
6039,593,1041,617313,2,48318,12081,1,83880312,83880312,18118,6039,12079,6039,0,1,6041,52184,0.052184
6539,593,1041,617313,2,52318,13081,1,90416312,90416312,19618,6539,13079,6539,0,1,6541,467555,0.467555
7039,593,1041,617313,2,56318,14081,1,96952312,96952312,21118,7039,14079,7039,0,1,7041,863028,0.863028
39,1143,541,618363,2,318,81,1,5472312,5472312,118,39,79,39,0,1,41,3888,0.003888
539,1143,541,618363,2,4318,1081,1,12208312,12208312,1618,539,1079,539,0,1,541,32477,0.032477
1039,1143,541,618363,2,8318,2081,1,18944312,18944312,3118,1039,2079,1039,0,1,1041,1419,0.001419
1539,1143,541,618363,2,12318,3081,1,25680312,25680312,4618,1539,3079,1539,0,1,1541,73774,0.073774
2039,1143,541,618363,2,16318,4081,1,32416312,32416312,6118,2039,4079,2039,0,1,2041,106541,0.106541
2539,1143,541,618363,2,20318,5081,1,39152312,39152312,7618,2539,5079,2539,0,1,2541,309874,0.309874
3039,1143,541,618363,2,24318,6081,1,45888312,45888312,9118,3039,6079,3039,0,1,3041,374602,0.374602
3539,1143,541,618363,2,28318,7081,1,52624312,52624312,10618,3539,7079,3539,0,1,3541,307852,0.307852
4039,1143,541,618363,2,32318,8081,1,59360312,59360312,12118,4039,8079,4039,0,1,4041,498200,0.4982
4539,1143,541,618363,2,36318,9081,1,66096312,66096312,13618,4539,9079,4539,0,1,4541,562356,0.562356
5039,1143,541,618363,2,40318,10081,1,72832312,72832312,15118,5039,10079,5039,0,1,5041,527020,0.52702
5539,1143,541,618363,2,44318,11081,1,79568312,79568312,16618,5539,11079,5539,0,1,5541,688949,0.688949
6039,1143,541,618363,2,48318,12081,1,86304312,86304312,18118,6039,12079,6039,0,1,6041,436964,0.436964
6539,1143,541,618363,2,52318,13081,1,93040312,93040312,19618,6539,13079,6539,0,1,6541,814198,0.814198
7039,1143,541,618363,2,56318,14081,1,99776312,99776312,21118,7039,14079,7039,0,1,7041,875357,0.875357
35,1140,545,621300,2,286,73,1,5442200,5442200,106,35,71,35,0,1,37,22893,0.022893
535,1140,545,621300,2,4286,1073,1,12182200,12182200,1606,535,1071,535,0,1,537,69299,0.069299
1035,1140,545,621300,2,8286,2073,1,18922200,18922200,3106,1035,2071,1035,0,1,1037,126373,0.126373
1535,1140,545,621300,2,12286,3073,1,25662200,25662200,4606,1535,3071,1535,0,1,1537,187879,0.187879
2035,1140,545,621300,2,16286,4073,1,32402200,32402200,6106,2035,4071,2035,0,1,2037,248645,0.248645
2535,1140,545,621300,2,20286,5073,1,39142200,39142200,7606,2535,5071,2535,0,1,2537,303955,0.303955
3035,1140,545,621300,2,24286,6073,1,45882200,45882200,9106,3035,6071,3035,0,1,3037,371904,0.371904
3535,1140,545,621300,2,28286,7073,1,52622200,52622200,10606,3535,7071,3535,0,1,3537,423077,0.423077
4035,1140,545,621300,2,32286,8073,1,59362200,59362200,12106,4035,8071,4035,0,1,4037,484672,0.484672
44,603,1055,636165,2,358,91,1,5672936,5672936,133,44,89,44,0,1,46,13016,0.013016
544,603,1055,636165,2,4358,1091,1,12304936,12304936,1633,544,1089,544,0,1,546,71810,0.07181
1044,603,1055,636165,2,8358,2091,1,18936936,18936936,3133,1044,2089,1044,0,1,1046,56542,0.056542
1544,603,1055,636165,2,12358,3091,1,25568936,25568936,4633,1544,3089,1544,0,1,1546,192894,0.192894
2044,603,1055,636165,2,16358,4091,1,32200936,32200936,6133,2044,4089,2044,0,1,2046,211193,0.211193
2544,603,1055,636165,2,20358,5091,1,38832936,38832936,7633,2544,5089,2544,0,1,2546,318424,0.318424
3044,603,1055,636165,2,24358,6091,1,45464936,45464936,9133,3044,6089,3044,0,1,3046,378457,0.378457
3544,603,1055,636165,2,28358,7091,1,52096936,52096936,10633,3544,7089,3544,0,1,3546,440487,0.440487
4044,603,1055,636165,2,32358,8091,1,58728936,58728936,12133,4044,8089,4044,0,1,4046,506220,0.50622
4544,603,1055,636165,2,36358,9091,1,65360936,65360936,13633,4544,9089,4544,0,1,4546,313522,0.313522
5044,603,1055,636165,2,40358,10091,1,71992936,71992936,15133,5044,10089,5044,0,1,5046,330503,0.330503
5544,603,1055,636165,2,44358,11091,1,78624936,78624936,16633,5544,11089,5544,0,1,5546,692092,0.692092
6044,603,1055,636165,2,48358,12091,1,85256936,85256936,18133,6044,12089,6044,0,1,6046,137530,0.13753
6544,603,1055,636165,2,52358,13091,1,91888936,91888936,19633,6544,13089,6544,0,1,6546,207015,0.207015
7044,603,1055,636165,2,56358,14091,1,98520936,98520936,21133,7044,14089,7044,0,1,7046,635053,0.635053
44,1153,555,639915,2,358,91,1,5720536,5720536,133,44,89,44,0,1,46,6180,0.00618
544,1153,555,639915,2,4358,1091,1,12552536,12552536,1633,544,1089,544,0,1,546,15711,0.015711
1044,1153,555,639915,2,8358,2091,1,19384536,19384536,3133,1044,2089,1044,0,1,1046,44412,0.044412
1544,1153,555,639915,2,12358,3091,1,26216536,26216536,4633,1544,3089,1544,0,1,1546,9688,0.009688
2044,1153,555,639915,2,16358,4091,1,33048536,33048536,6133,2044,4089,2044,0,1,2046,24802,0.024802
2544,1153,555,639915,2,20358,5091,1,39880536,39880536,7633,2544,5089,2544,0,1,2546,139246,0.139246
3044,1153,555,639915,2,24358,6091,1,46712536,46712536,9133,3044,6089,3044,0,1,3046,384815,0.384815
3544,1153,555,639915,2,28358,7091,1,53544536,53544536,10633,3544,7089,3544,0,1,3546,449710,0.44971
4044,1153,555,639915,2,32358,8091,1,60376536,60376536,12133,4044,8089,4044,0,1,4046,512508,0.512508
4544,1153,555,639915,2,36358,9091,1,67208536,67208536,13633,4544,9089,4544,0,1,4546,581016,0.581016
5044,1153,555,639915,2,40358,10091,1,74040536,74040536,15133,5044,10089,5044,0,1,5046,211738,0.211738
5544,1153,555,639915,2,44358,11091,1,80872536,80872536,16633,5544,11089,5544,0,1,5546,654876,0.654876
6044,1153,555,639915,2,48358,12091,1,87704536,87704536,18133,6044,12089,6044,0,1,6046,469994,0.469994
6544,1153,555,639915,2,52358,13091,1,94536536,94536536,19633,6544,13089,6544,0,1,6546,842066,0.842066
7044,1153,555,639915,2,56358,14091,1,101368536,101368536,21133,7044,14089,7044,0,1,7046,924324,0.924324
40,300,2140,642000,2,326,83,1,5916800,5916800,121,40,81,40,0,1,42,12786,0.012786
440,300,2140,642000,2,3526,883,1,13724800,13724800,1321,440,881,440,0,1,442,61258,0.061258
840,300,2140,642000,2,6726,1683,1,21532800,21532800,2521,840,1681,840,0,1,842,113606,0.113606
1240,300,2140,642000,2,9926,2483,1,29340800,29340800,3721,1240,2481,1240,0,1,1242,160475,0.160475
1640,300,2140,642000,2,13126,3283,1,37148800,37148800,4921,1640,3281,1640,0,1,1642,210201,0.210201
2040,300,2140,642000,2,16326,4083,1,44956800,44956800,6121,2040,4081,2040,0,1,2042,272264,0.272264
2440,300,2140,642000,2,19526,4883,1,52764800,52764800,7321,2440,4881,2440,0,1,2442,63875,0.063875
2840,300,2140,642000,2,22726,5683,1,60572800,60572800,8521,2840,5681,2840,0,1,2842,57483,0.057483
3240,300,2140,642000,2,25926,6483,1,68380800,68380800,9721,3240,6481,3240,0,1,3242,412855,0.412855
3640,300,2140,642000,2,29126,7283,1,76188800,76188800,10921,3640,7281,3640,0,1,3642,28336,0.028336
4040,300,2140,642000,2,32326,8083,1,83996800,83996800,12121,4040,8081,4040,0,1,4042,334099,0.334099
4440,300,2140,642000,2,35526,8883,1,91804800,91804800,13321,4440,8881,4440,0,1,4442,11144,0.011144
4840,300,2140,642000,2,38726,9683,1,99612800,99612800,14521,4840,9681,4840,0,1,4842,33249,0.033249
5240,300,2140,642000,2,41926,10483,1,107420800,107420800,15721,5240,10481,5240,0,1,5242,89900,0.0899
5640,300,2140,642000,2,45126,11283,1,115228800,115228800,16921,5640,11281,5640,0,1,5642,258786,0.258786
6040,300,2140,642000,2,48326,12083,1,123036800,123036800,18121,6040,12081,6040,0,1,6042,356580,0.35658
6440,300,2140,642000,2,51526,12883,1,130844800,130844800,19321,6440,12881,6440,0,1,6442,261545,0.261545
6840,300,2140,642000,2,54726,13683,1,138652800,138652800,20521,6840,13681,6840,0,1,6842,865280,0.86528
55,1805,365,658825,2,446,113,1,6225400,6225400,166,55,111,55,0,1,57,15233,0.015233
455,1805,365,658825,2,3646,913,1,13169400,13169400,1366,455,911,455,0,1,457,64967,0.064967
855,1805,365,658825,2,6846,1713,1,20113400,20113400,2566,855,1711,855,0,1,857,114884,0.114884
1255,1805,365,658825,2,10046,2513,1,27057400,27057400,3766,1255,2511,1255,0,1,1257,167940,0.16794
1655,1805,365,658825,2,13246,3313,1,34001400,34001400,4966,1655,3311,1655,0,1,1657,39481,0.039481
2055,1805,365,658825,2,16446,4113,1,40945400,40945400,6166,2055,4111,2055,0,1,2057,265971,0.265971
2455,1805,365,658825,2,19646,4913,1,47889400,47889400,7366,2455,4911,2455,0,1,2457,51479,0.051479
2855,1805,365,658825,2,22846,5713,1,54833400,54833400,8566,2855,5711,2855,0,1,2857,376749,0.376749
3255,1805,365,658825,2,26046,6513,1,61777400,61777400,9766,3255,6511,3255,0,1,3257,412389,0.412389
3655,1805,365,658825,2,29246,7313,1,68721400,68721400,10966,3655,7311,3655,0,1,3657,480322,0.480322
4055,1805,365,658825,2,32446,8113,1,75665400,75665400,12166,4055,8111,4055,0,1,4057,537914,0.537914
4455,1805,365,658825,2,35646,8913,1,82609400,82609400,13366,4455,8911,4455,0,1,4457,589574,0.589574
4855,1805,365,658825,2,38846,9713,1,89553400,89553400,14566,4855,9711,4855,0,1,4857,645772,0.645772
5255,1805,365,658825,2,42046,10513,1,96497400,96497400,15766,5255,10511,5255,0,1,5257,700015,0.700015
5655,1805,365,658825,2,45246,11313,1,103441400,103441400,16966,5655,11311,5655,0,1,5657,8587,0.008587
6055,1805,365,658825,2,48446,12113,1,110385400,110385400,18166,6055,12111,6055,0,1,6057,814394,0.814394
6455,1805,365,658825,2,51646,12913,1,117329400,117329400,19366,6455,12911,6455,0,1,6457,705649,0.705649
6855,1805,365,658825,2,54846,13713,1,124273400,124273400,20566,6855,13711,6855,0,1,6857,918446,0.918446
55,305,2165,660325,2,446,113,1,6369400,6369400,166,55,111,55,0,1,57,15774,0.015774
455,305,2165,660325,2,3646,913,1,14273400,14273400,1366,455,911,455,0,1,457,68181,0.068181
855,305,2165,660325,2,6846,1713,1,22177400,22177400,2566,855,1711,855,0,1,857,95933,0.095933
1255,305,2165,660325,2,10046,2513,1,30081400,30081400,3766,1255,2511,1255,0,1,1257,170790,0.17079
1655,305,2165,660325,2,13246,3313,1,37985400,37985400,4966,1655,3311,1655,0,1,1657,219278,0.219278
2055,305,2165,660325,2,16446,4113,1,45889400,45889400,6166,2055,4111,2055,0,1,2057,272045,0.272045
2455,305,2165,660325,2,19646,4913,1,53793400,53793400,7366,2455,4911,2455,0,1,2457,324102,0.324102
2855,305,2165,660325,2,22846,5713,1,61697400,61697400,8566,2855,5711,2855,0,1,2857,204318,0.204318
3255,305,2165,660325,2,26046,6513,1,69601400,69601400,9766,3255,6511,3255,0,1,3257,27317,0.027317
3655,305,2165,660325,2,29246,7313,1,77505400,77505400,10966,3655,7311,3655,0,1,3657,89182,0.089182
4055,305,2165,660325,2,32446,8113,1,85409400,85409400,12166,4055,8111,4055,0,1,4057,533597,0.533597
4455,305,2165,660325,2,35646,8913,1,93313400,93313400,13366,4455,8911,4455,0,1,4457,584398,0.584398
4855,305,2165,660325,2,38846,9713,1,101217400,101217400,14566,4855,9711,4855,0,1,4857,29924,0.029924
5255,305,2165,660325,2,42046,10513,1,109121400,109121400,15766,5255,10511,5255,0,1,5257,120283,0.120283
5655,305,2165,660325,2,45246,11313,1,117025400,117025400,16966,5655,11311,5655,0,1,5657,325776,0.325776
6055,305,2165,660325,2,48446,12113,1,124929400,124929400,18166,6055,12111,6055,0,1,6057,650629,0.650629
6455,305,2165,660325,2,51646,12913,1,132833400,132833400,19366,6455,12911,6455,0,1,6457,848644,0.848644
6855,305,2165,660325,2,54846,13713,1,140737400,140737400,20566,6855,13711,6855,0,1,6857,899863,0.899863
40,1050,640,672000,2,326,83,1,5916800,5916800,121,40,81,40,0,1,42,635,0.000635
440,1050,640,672000,2,3526,883,1,11324800,11324800,1321,440,881,440,0,1,442,13912,0.013912
840,1050,640,672000,2,6726,1683,1,16732800,16732800,2521,840,1681,840,0,1,842,109787,0.109787
1240,1050,640,672000,2,9926,2483,1,22140800,22140800,3721,1240,2481,1240,0,1,1242,84209,0.084209
1640,1050,640,672000,2,13126,3283,1,27548800,27548800,4921,1640,3281,1640,0,1,1642,15164,0.015164
2040,1050,640,672000,2,16326,4083,1,32956800,32956800,6121,2040,4081,2040,0,1,2042,254474,0.254474
2440,1050,640,672000,2,19526,4883,1,38364800,38364800,7321,2440,4881,2440,0,1,2442,246120,0.24612
2840,1050,640,672000,2,22726,5683,1,43772800,43772800,8521,2840,5681,2840,0,1,2842,79907,0.079907
3240,1050,640,672000,2,25926,6483,1,49180800,49180800,9721,3240,6481,3240,0,1,3242,318833,0.318833
3640,1050,640,672000,2,29126,7283,1,54588800,54588800,10921,3640,7281,3640,0,1,3642,423716,0.423716
4040,1050,640,672000,2,32326,8083,1,59996800,59996800,12121,4040,8081,4040,0,1,4042,74602,0.074602
4440,1050,640,672000,2,35526,8883,1,65404800,65404800,13321,4440,8881,4440,0,1,4442,123098,0.123098
4840,1050,640,672000,2,38726,9683,1,70812800,70812800,14521,4840,9681,4840,0,1,4842,119458,0.119458
5240,1050,640,672000,2,41926,10483,1,76220800,76220800,15721,5240,10481,5240,0,1,5242,227143,0.227143
5640,1050,640,672000,2,45126,11283,1,81628800,81628800,16921,5640,11281,5640,0,1,5642,440885,0.440885
6040,1050,640,672000,2,48326,12083,1,87036800,87036800,18121,6040,12081,6040,0,1,6042,223553,0.223553
6440,1050,640,672000,2,51526,12883,1,92444800,92444800,19321,6440,12881,6440,0,1,6442,833984,0.833984
6840,1050,640,672000,2,54726,13683,1,97852800,97852800,20521,6840,13681,6840,0,1,6842,245283,0.245283
40,550,1240,682000,2,326,83,1,6028800,6028800,121,40,81,40,0,1,42,13461,0.013461
440,550,1240,682000,2,3526,883,1,11756800,11756800,1321,440,881,440,0,1,442,63515,0.063515
840,550,1240,682000,2,6726,1683,1,17484800,17484800,2521,840,1681,840,0,1,842,114596,0.114596
1240,550,1240,682000,2,9926,2483,1,23212800,23212800,3721,1240,2481,1240,0,1,1242,166017,0.166017
1640,550,1240,682000,2,13126,3283,1,28940800,28940800,4921,1640,3281,1640,0,1,1642,220570,0.22057
2040,550,1240,682000,2,16326,4083,1,34668800,34668800,6121,2040,4081,2040,0,1,2042,269276,0.269276
2440,550,1240,682000,2,19526,4883,1,40396800,40396800,7321,2440,4881,2440,0,1,2442,320407,0.320407
2840,550,1240,682000,2,22726,5683,1,46124800,46124800,8521,2840,5681,2840,0,1,2842,289711,0.289711
3240,550,1240,682000,2,25926,6483,1,51852800,51852800,9721,3240,6481,3240,0,1,3242,427815,0.427815
3640,550,1240,682000,2,29126,7283,1,57580800,57580800,10921,3640,7281,3640,0,1,3642,488826,0.488826
4040,550,1240,682000,2,32326,8083,1,63308800,63308800,12121,4040,8081,4040,0,1,4042,531136,0.531136
4440,550,1240,682000,2,35526,8883,1,69036800,69036800,13321,4440,8881,4440,0,1,4442,480937,0.480937
4840,550,1240,682000,2,38726,9683,1,74764800,74764800,14521,4840,9681,4840,0,1,4842,634432,0.634432
5240,550,1240,682000,2,41926,10483,1,80492800,80492800,15721,5240,10481,5240,0,1,5242,215774,0.215774
5640,550,1240,682000,2,45126,11283,1,86220800,86220800,16921,5640,11281,5640,0,1,5642,457733,0.457733
6040,550,1240,682000,2,48326,12083,1,91948800,91948800,18121,6040,12081,6040,0,1,6042,305541,0.305541
6440,550,1240,682000,2,51526,12883,1,97676800,97676800,19321,6440,12881,6440,0,1,6442,112681,0.112681
6840,550,1240,682000,2,54726,13683,1,103404800,103404800,20521,6840,13681,6840,0,1,6842,900806,0.900806
40,2050,340,697000,2,326,83,1,6340800,6340800,121,40,81,40,0,1,42,5506,0.005506
440,2050,340,697000,2,3526,883,1,13988800,13988800,1321,440,881,440,0,1,442,62753,0.062753
840,2050,340,697000,2,6726,1683,1,21636800,21636800,2521,840,1681,840,0,1,842,113802,0.113802
1240,2050,340,697000,2,9926,2483,1,29284800,29284800,3721,1240,2481,1240,0,1,1242,53650,0.05365
1640,2050,340,697000,2,13126,3283,1,36932800,36932800,4921,1640,3281,1640,0,1,1642,91595,0.091595
2040,2050,340,697000,2,16326,4083,1,44580800,44580800,6121,2040,4081,2040,0,1,2042,246242,0.246242
2440,2050,340,697000,2,19526,4883,1,52228800,52228800,7321,2440,4881,2440,0,1,2442,39475,0.039475
2840,2050,340,697000,2,22726,5683,1,59876800,59876800,8521,2840,5681,2840,0,1,2842,384949,0.384949
3240,2050,340,697000,2,25926,6483,1,67524800,67524800,9721,3240,6481,3240,0,1,3242,135260,0.13526
3640,2050,340,697000,2,29126,7283,1,75172800,75172800,10921,3640,7281,3640,0,1,3642,222700,0.2227
4040,2050,340,697000,2,32326,8083,1,82820800,82820800,12121,4040,8081,4040,0,1,4042,131769,0.131769
4440,2050,340,697000,2,35526,8883,1,90468800,90468800,13321,4440,8881,4440,0,1,4442,610967,0.610967
4840,2050,340,697000,2,38726,9683,1,98116800,98116800,14521,4840,9681,4840,0,1,4842,666198,0.666198
5240,2050,340,697000,2,41926,10483,1,105764800,105764800,15721,5240,10481,5240,0,1,5242,665652,0.665652
5640,2050,340,697000,2,45126,11283,1,113412800,113412800,16921,5640,11281,5640,0,1,5642,667474,0.667474
6040,2050,340,697000,2,48326,12083,1,121060800,121060800,18121,6040,12081,6040,0,1,6042,276562,0.276562
6440,2050,340,697000,2,51526,12883,1,128708800,128708800,19321,6440,12881,6440,0,1,6442,887278,0.887278
6840,2050,340,697000,2,54726,13683,1,136356800,136356800,20521,6840,13681,6840,0,1,6842,36597,0.036597
55,1055,665,701575,2,446,113,1,6369400,6369400,166,55,111,55,0,1,57,3314,0.003314
455,1055,665,701575,2,3646,913,1,11873400,11873400,1366,455,911,455,0,1,457,2647,0.002647
855,1055,665,701575,2,6846,1713,1,17377400,17377400,2566,855,1711,855,0,1,857,13927,0.013927
1255,1055,665,701575,2,10046,2513,1,22881400,22881400,3766,1255,2511,1255,0,1,1257,133052,0.133052
1655,1055,665,701575,2,13246,3313,1,28385400,28385400,4966,1655,3311,1655,0,1,1657,75468,0.075468
2055,1055,665,701575,2,16446,4113,1,33889400,33889400,6166,2055,4111,2055,0,1,2057,95677,0.095677
2455,1055,665,701575,2,19646,4913,1,39393400,39393400,7366,2455,4911,2455,0,1,2457,96691,0.096691
2855,1055,665,701575,2,22846,5713,1,44897400,44897400,8566,2855,5711,2855,0,1,2857,2536,0.002536
3255,1055,665,701575,2,26046,6513,1,50401400,50401400,9766,3255,6511,3255,0,1,3257,457516,0.457516
3655,1055,665,701575,2,29246,7313,1,55905400,55905400,10966,3655,7311,3655,0,1,3657,419104,0.419104
4055,1055,665,701575,2,32446,8113,1,61409400,61409400,12166,4055,8111,4055,0,1,4057,240609,0.240609
4455,1055,665,701575,2,35646,8913,1,66913400,66913400,13366,4455,8911,4455,0,1,4457,397380,0.39738
4855,1055,665,701575,2,38846,9713,1,72417400,72417400,14566,4855,9711,4855,0,1,4857,178437,0.178437
5255,1055,665,701575,2,42046,10513,1,77921400,77921400,15766,5255,10511,5255,0,1,5257,495465,0.495465
5655,1055,665,701575,2,45246,11313,1,83425400,83425400,16966,5655,11311,5655,0,1,5657,798259,0.798259
6055,1055,665,701575,2,48446,12113,1,88929400,88929400,18166,6055,12111,6055,0,1,6057,567980,0.56798
6455,1055,665,701575,2,51646,12913,1,94433400,94433400,19366,6455,12911,6455,0,1,6457,912958,0.912958
6855,1055,665,701575,2,54846,13713,1,99937400,99937400,20566,6855,13711,6855,0,1,6857,480332,0.480332
55,555,1265,702075,2,446,113,1,6417400,6417400,166,55,111,55,0,1,57,15710,0.01571
455,555,1265,702075,2,3646,913,1,12241400,12241400,1366,455,911,455,0,1,457,68040,0.06804
855,555,1265,702075,2,6846,1713,1,18065400,18065400,2566,855,1711,855,0,1,857,121481,0.121481
1255,555,1265,702075,2,10046,2513,1,23889400,23889400,3766,1255,2511,1255,0,1,1257,55080,0.05508
1655,555,1265,702075,2,13246,3313,1,29713400,29713400,4966,1655,3311,1655,0,1,1657,228999,0.228999
2055,555,1265,702075,2,16446,4113,1,35537400,35537400,6166,2055,4111,2055,0,1,2057,285497,0.285497
2455,555,1265,702075,2,19646,4913,1,41361400,41361400,7366,2455,4911,2455,0,1,2457,340134,0.340134
2855,555,1265,702075,2,22846,5713,1,47185400,47185400,8566,2855,5711,2855,0,1,2857,215595,0.215595
3255,555,1265,702075,2,26046,6513,1,53009400,53009400,9766,3255,6511,3255,0,1,3257,150972,0.150972
3655,555,1265,702075,2,29246,7313,1,58833400,58833400,10966,3655,7311,3655,0,1,3657,503513,0.503513
4055,555,1265,702075,2,32446,8113,1,64657400,64657400,12166,4055,8111,4055,0,1,4057,244614,0.244614
4455,555,1265,702075,2,35646,8913,1,70481400,70481400,13366,4455,8911,4455,0,1,4457,614670,0.61467
4855,555,1265,702075,2,38846,9713,1,76305400,76305400,14566,4855,9711,4855,0,1,4857,60783,0.060783
5255,555,1265,702075,2,42046,10513,1,82129400,82129400,15766,5255,10511,5255,0,1,5257,720636,0.720636
5655,555,1265,702075,2,45246,11313,1,87953400,87953400,16966,5655,11311,5655,0,1,5657,620938,0.620938
6055,555,1265,702075,2,48446,12113,1,93777400,93777400,18166,6055,12111,6055,0,1,6057,350584,0.350584
6455,555,1265,702075,2,51646,12913,1,99601400,99601400,19366,6455,12911,6455,0,1,6457,370267,0.370267
6855,555,1265,702075,2,54846,13713,1,105425400,105425400,20566,6855,13711,6855,0,1,6857,275388,0.275388
40,300,2440,732000,2,326,83,1,6732800,6732800,121,40,81,40,0,1,42,14327,0.014327
440,300,2440,732000,2,3526,883,1,15500800,15500800,1321,440,881,440,0,1,442,69247,0.069247
840,300,2440,732000,2,6726,1683,1,24268800,24268800,2521,840,1681,840,0,1,842,126078,0.126078
1240,300,2440,732000,2,9926,2483,1,33036800,33036800,3721,1240,2481,1240,0,1,1242,59138,0.059138
1640,300,2440,732000,2,13126,3283,1,41804800,41804800,4921,1640,3281,1640,0,1,1642,39128,0.039128
2040,300,2440,732000,2,16326,4083,1,50572800,50572800,6121,2040,4081,2040,0,1,2042,287497,0.287497
2440,300,2440,732000,2,19526,4883,1,59340800,59340800,7321,2440,4881,2440,0,1,2442,348300,0.3483
2840,300,2440,732000,2,22726,5683,1,68108800,68108800,8521,2840,5681,2840,0,1,2842,112028,0.112028
3240,300,2440,732000,2,25926,6483,1,76876800,76876800,9721,3240,6481,3240,0,1,3242,74120,0.07412
3640,300,2440,732000,2,29126,7283,1,85644800,85644800,10921,3640,7281,3640,0,1,3642,280138,0.280138
4040,300,2440,732000,2,32326,8083,1,94412800,94412800,12121,4040,8081,4040,0,1,4042,576626,0.576626
4440,300,2440,732000,2,35526,8883,1,103180800,103180800,13321,4440,8881,4440,0,1,4442,441790,0.44179
4840,300,2440,732000,2,38726,9683,1,111948800,111948800,14521,4840,9681,4840,0,1,4842,177932,0.177932
5240,300,2440,732000,2,41926,10483,1,120716800,120716800,15721,5240,10481,5240,0,1,5242,619776,0.619776
5640,300,2440,732000,2,45126,11283,1,129484800,129484800,16921,5640,11281,5640,0,1,5642,70215,0.070215
6040,300,2440,732000,2,48326,12083,1,138252800,138252800,18121,6040,12081,6040,0,1,6042,158954,0.158954
6440,300,2440,732000,2,51526,12883,1,147020800,147020800,19321,6440,12881,6440,0,1,6442,919409,0.919409
6840,300,2440,732000,2,54726,13683,1,155788800,155788800,20521,6840,13681,6840,0,1,6842,14527,0.014527
55,2055,365,750075,2,446,113,1,7065400,7065400,166,55,111,55,0,1,57,2754,0.002754
455,2055,365,750075,2,3646,913,1,14809400,14809400,1366,455,911,455,0,1,457,21391,0.021391
855,2055,365,750075,2,6846,1713,1,22553400,22553400,2566,855,1711,855,0,1,857,59430,0.05943
1255,2055,365,750075,2,10046,2513,1,30297400,30297400,3766,1255,2511,1255,0,1,1257,109450,0.10945
1655,2055,365,750075,2,13246,3313,1,38041400,38041400,4966,1655,3311,1655,0,1,1657,244306,0.244306
2055,2055,365,750075,2,16446,4113,1,45785400,45785400,6166,2055,4111,2055,0,1,2057,223996,0.223996
2455,2055,365,750075,2,19646,4913,1,53529400,53529400,7366,2455,4911,2455,0,1,2457,71540,0.07154
2855,2055,365,750075,2,22846,5713,1,61273400,61273400,8566,2855,5711,2855,0,1,2857,83938,0.083938
3255,2055,365,750075,2,26046,6513,1,69017400,69017400,9766,3255,6511,3255,0,1,3257,477168,0.477168
3655,2055,365,750075,2,29246,7313,1,76761400,76761400,10966,3655,7311,3655,0,1,3657,310442,0.310442
4055,2055,365,750075,2,32446,8113,1,84505400,84505400,12166,4055,8111,4055,0,1,4057,131777,0.131777
4455,2055,365,750075,2,35646,8913,1,92249400,92249400,13366,4455,8911,4455,0,1,4457,510299,0.510299
4855,2055,365,750075,2,38846,9713,1,99993400,99993400,14566,4855,9711,4855,0,1,4857,713446,0.713446
5255,2055,365,750075,2,42046,10513,1,107737400,107737400,15766,5255,10511,5255,0,1,5257,505686,0.505686
5655,2055,365,750075,2,45246,11313,1,115481400,115481400,16966,5655,11311,5655,0,1,5657,396644,0.396644
6055,2055,365,750075,2,48446,12113,1,123225400,123225400,18166,6055,12111,6055,0,1,6057,887505,0.887505
6455,2055,365,750075,2,51646,12913,1,130969400,130969400,19366,6455,12911,6455,0,1,6457,109208,0.109208
6855,2055,365,750075,2,54846,13713,1,138713400,138713400,20566,6855,13711,6855,0,1,6857,1006782,1.006782
55,305,2465,751825,2,446,113,1,7233400,7233400,166,55,111,55,0,1,57,17627,0.017627
455,305,2465,751825,2,3646,913,1,16097400,16097400,1366,455,911,455,0,1,457,75659,0.075659
855,305,2465,751825,2,6846,1713,1,24961400,24961400,2566,855,1711,855,0,1,857,132398,0.132398
1255,305,2465,751825,2,10046,2513,1,33825400,33825400,3766,1255,2511,1255,0,1,1257,19704,0.019704
1655,305,2465,751825,2,13246,3313,1,42689400,42689400,4966,1655,3311,1655,0,1,1657,53860,0.05386
2055,305,2465,751825,2,16446,4113,1,51553400,51553400,6166,2055,4111,2055,0,1,2057,308751,0.308751
2455,305,2465,751825,2,19646,4913,1,60417400,60417400,7366,2455,4911,2455,0,1,2457,174640,0.17464
2855,305,2465,751825,2,22846,5713,1,69281400,69281400,8566,2855,5711,2855,0,1,2857,163667,0.163667
3255,305,2465,751825,2,26046,6513,1,78145400,78145400,9766,3255,6511,3255,0,1,3257,489909,0.489909
3655,305,2465,751825,2,29246,7313,1,87009400,87009400,10966,3655,7311,3655,0,1,3657,257993,0.257993
4055,305,2465,751825,2,32446,8113,1,95873400,95873400,12166,4055,8111,4055,0,1,4057,576023,0.576023
4455,305,2465,751825,2,35646,8913,1,104737400,104737400,13366,4455,8911,4455,0,1,4457,439077,0.439077
4855,305,2465,751825,2,38846,9713,1,113601400,113601400,14566,4855,9711,4855,0,1,4857,650143,0.650143
5255,305,2465,751825,2,42046,10513,1,122465400,122465400,15766,5255,10511,5255,0,1,5257,59975,0.059975
5655,305,2465,751825,2,45246,11313,1,131329400,131329400,16966,5655,11311,5655,0,1,5657,78767,0.078767
6055,305,2465,751825,2,48446,12113,1,140193400,140193400,18166,6055,12111,6055,0,1,6057,464272,0.464272
6455,305,2465,751825,2,51646,12913,1,149057400,149057400,19366,6455,12911,6455,0,1,6457,506556,0.506556
6855,305,2465,751825,2,54846,13713,1,157921400,157921400,20566,6855,13711,6855,0,1,6857,511995,0.511995
40,800,940,752000,2,326,83,1,6572800,6572800,121,40,81,40,0,1,42,14456,0.014456
440,800,940,752000,2,3526,883,1,12140800,12140800,1321,440,881,440,0,1,442,70117,0.070117
840,800,940,752000,2,6726,1683,1,17708800,17708800,2521,840,1681,840,0,1,842,127063,0.127063
1240,800,940,752000,2,9926,2483,1,23276800,23276800,3721,1240,2481,1240,0,1,1242,186482,0.186482
1640,800,940,752000,2,13126,3283,1,28844800,28844800,4921,1640,3281,1640,0,1,1642,239726,0.239726
2040,800,940,752000,2,16326,4083,1,34412800,34412800,6121,2040,4081,2040,0,1,2042,299743,0.299743
2440,800,940,752000,2,19526,4883,1,39980800,39980800,7321,2440,4881,2440,0,1,2442,355497,0.355497
2840,800,940,752000,2,22726,5683,1,45548800,45548800,8521,2840,5681,2840,0,1,2842,311690,0.31169
3240,800,940,752000,2,25926,6483,1,51116800,51116800,9721,3240,6481,3240,0,1,3242,347682,0.347682
3640,800,940,752000,2,29126,7283,1,56684800,56684800,10921,3640,7281,3640,0,1,3642,529809,0.529809
4040,800,940,752000,2,32326,8083,1,62252800,62252800,12121,4040,8081,4040,0,1,4042,209272,0.209272
4440,800,940,752000,2,35526,8883,1,67820800,67820800,13321,4440,8881,4440,0,1,4442,646827,0.646827
4840,800,940,752000,2,38726,9683,1,73388800,73388800,14521,4840,9681,4840,0,1,4842,520025,0.520025
5240,800,940,752000,2,41926,10483,1,78956800,78956800,15721,5240,10481,5240,0,1,5242,18777,0.018777
5640,800,940,752000,2,45126,11283,1,84524800,84524800,16921,5640,11281,5640,0,1,5642,818749,0.818749
6040,800,940,752000,2,48326,12083,1,90092800,90092800,18121,6040,12081,6040,0,1,6042,885772,0.885772
6440,800,940,752000,2,51526,12883,1,95660800,95660800,19321,6440,12881,6440,0,1,6442,546550,0.54655
6840,800,940,752000,2,54726,13683,1,101228800,101228800,20521,6840,13681,6840,0,1,6842,995566,0.995566
55,805,965,776825,2,446,113,1,6993400,6993400,166,55,111,55,0,1,57,17034,0.017034
455,805,965,776825,2,3646,913,1,12657400,12657400,1366,455,911,455,0,1,457,74191,0.074191
855,805,965,776825,2,6846,1713,1,18321400,18321400,2566,855,1711,855,0,1,857,37916,0.037916
1255,805,965,776825,2,10046,2513,1,23985400,23985400,3766,1255,2511,1255,0,1,1257,192201,0.192201
1655,805,965,776825,2,13246,3313,1,29649400,29649400,4966,1655,3311,1655,0,1,1657,252861,0.252861
2055,805,965,776825,2,16446,4113,1,35313400,35313400,6166,2055,4111,2055,0,1,2057,43242,0.043242
2455,805,965,776825,2,19646,4913,1,40977400,40977400,7366,2455,4911,2455,0,1,2457,381971,0.381971
2855,805,965,776825,2,22846,5713,1,46641400,46641400,8566,2855,5711,2855,0,1,2857,218394,0.218394
3255,805,965,776825,2,26046,6513,1,52305400,52305400,9766,3255,6511,3255,0,1,3257,151070,0.15107
3655,805,965,776825,2,29246,7313,1,57969400,57969400,10966,3655,7311,3655,0,1,3657,559097,0.559097
4055,805,965,776825,2,32446,8113,1,63633400,63633400,12166,4055,8111,4055,0,1,4057,618540,0.61854
4455,805,965,776825,2,35646,8913,1,69297400,69297400,13366,4455,8911,4455,0,1,4457,679383,0.679383
4855,805,965,776825,2,38846,9713,1,74961400,74961400,14566,4855,9711,4855,0,1,4857,193423,0.193423
5255,805,965,776825,2,42046,10513,1,80625400,80625400,15766,5255,10511,5255,0,1,5257,801630,0.80163
5655,805,965,776825,2,45246,11313,1,86289400,86289400,16966,5655,11311,5655,0,1,5657,506421,0.506421
6055,805,965,776825,2,48446,12113,1,91953400,91953400,18166,6055,12111,6055,0,1,6057,248102,0.248102
6455,805,965,776825,2,51646,12913,1,97617400,97617400,19366,6455,12911,6455,0,1,6457,260176,0.260176
6855,805,965,776825,2,54846,13713,1,103281400,103281400,20566,6855,13711,6855,0,1,6857,625282,0.625282
40,2300,340,782000,2,326,83,1,7100800,7100800,121,40,81,40,0,1,42,15478,0.015478
440,2300,340,782000,2,3526,883,1,15548800,15548800,1321,440,881,440,0,1,442,71912,0.071912
840,2300,340,782000,2,6726,1683,1,23996800,23996800,2521,840,1681,840,0,1,842,131107,0.131107
1240,2300,340,782000,2,9926,2483,1,32444800,32444800,3721,1240,2481,1240,0,1,1242,187972,0.187972
1640,2300,340,782000,2,13126,3283,1,40892800,40892800,4921,1640,3281,1640,0,1,1642,251679,0.251679
2040,2300,340,782000,2,16326,4083,1,49340800,49340800,6121,2040,4081,2040,0,1,2042,311060,0.31106
2440,2300,340,782000,2,19526,4883,1,57788800,57788800,7321,2440,4881,2440,0,1,2442,373595,0.373595
2840,2300,340,782000,2,22726,5683,1,66236800,66236800,8521,2840,5681,2840,0,1,2842,432388,0.432388
3240,2300,340,782000,2,25926,6483,1,74684800,74684800,9721,3240,6481,3240,0,1,3242,495328,0.495328
3640,2300,340,782000,2,29126,7283,1,83132800,83132800,10921,3640,7281,3640,0,1,3642,554001,0.554001
4040,2300,340,782000,2,32326,8083,1,91580800,91580800,12121,4040,8081,4040,0,1,4042,615097,0.615097
4440,2300,340,782000,2,35526,8883,1,100028800,100028800,13321,4440,8881,4440,0,1,4442,678344,0.678344
4840,2300,340,782000,2,38726,9683,1,108476800,108476800,14521,4840,9681,4840,0,1,4842,750385,0.750385
5240,2300,340,782000,2,41926,10483,1,116924800,116924800,15721,5240,10481,5240,0,1,5242,799910,0.79991
5640,2300,340,782000,2,45126,11283,1,125372800,125372800,16921,5640,11281,5640,0,1,5642,864291,0.864291
6040,2300,340,782000,2,48326,12083,1,133820800,133820800,18121,6040,12081,6040,0,1,6042,929523,0.929523
6440,2300,340,782000,2,51526,12883,1,142268800,142268800,19321,6440,12881,6440,0,1,6442,18514,0.018514
6840,2300,340,782000,2,54726,13683,1,150716800,150716800,20521,6840,13681,6840,0,1,6842,486074,0.486074
40,300,2740,822000,2,326,83,1,7548800,7548800,121,40,81,40,0,1,42,16057,0.016057
440,300,2740,822000,2,3526,883,1,17276800,17276800,1321,440,881,440,0,1,442,78170,0.07817
840,300,2740,822000,2,6726,1683,1,27004800,27004800,2521,840,1681,840,0,1,842,141737,0.141737
1240,300,2740,822000,2,9926,2483,1,36732800,36732800,3721,1240,2481,1240,0,1,1242,113355,0.113355
1640,300,2740,822000,2,13126,3283,1,46460800,46460800,4921,1640,3281,1640,0,1,1642,242971,0.242971
2040,300,2740,822000,2,16326,4083,1,56188800,56188800,6121,2040,4081,2040,0,1,2042,12252,0.012252
2440,300,2740,822000,2,19526,4883,1,65916800,65916800,7321,2440,4881,2440,0,1,2442,396505,0.396505
2840,300,2740,822000,2,22726,5683,1,75644800,75644800,8521,2840,5681,2840,0,1,2842,148775,0.148775
3240,300,2740,822000,2,25926,6483,1,85372800,85372800,9721,3240,6481,3240,0,1,3242,525024,0.525024
3640,300,2740,822000,2,29126,7283,1,95100800,95100800,10921,3640,7281,3640,0,1,3642,371224,0.371224
4040,300,2740,822000,2,32326,8083,1,104828800,104828800,12121,4040,8081,4040,0,1,4042,112948,0.112948
4440,300,2740,822000,2,35526,8883,1,114556800,114556800,13321,4440,8881,4440,0,1,4442,715888,0.715888
4840,300,2740,822000,2,38726,9683,1,124284800,124284800,14521,4840,9681,4840,0,1,4842,459797,0.459797
5240,300,2740,822000,2,41926,10483,1,134012800,134012800,15721,5240,10481,5240,0,1,5242,261091,0.261091
5640,300,2740,822000,2,45126,11283,1,143740800,143740800,16921,5640,11281,5640,0,1,5642,913034,0.913034
6040,300,2740,822000,2,48326,12083,1,153468800,153468800,18121,6040,12081,6040,0,1,6042,270688,0.270688
6440,300,2740,822000,2,51526,12883,1,163196800,163196800,19321,6440,12881,6440,0,1,6442,1042784,1.042784
6840,300,2740,822000,2,54726,13683,1,172924800,172924800,20521,6840,13681,6840,0,1,6842,1111371,1.111371
40,1300,640,832000,2,326,83,1,7276800,7276800,121,40,81,40,0,1,42,16073,0.016073
440,1300,640,832000,2,3526,883,1,13484800,13484800,1321,440,881,440,0,1,442,7525,0.007525
840,1300,640,832000,2,6726,1683,1,19692800,19692800,2521,840,1681,840,0,1,842,133646,0.133646
1240,1300,640,832000,2,9926,2483,1,25900800,25900800,3721,1240,2481,1240,0,1,1242,198595,0.198595
1640,1300,640,832000,2,13126,3283,1,32108800,32108800,4921,1640,3281,1640,0,1,1642,260301,0.260301
2040,1300,640,832000,2,16326,4083,1,38316800,38316800,6121,2040,4081,2040,0,1,2042,306349,0.306349
2440,1300,640,832000,2,19526,4883,1,44524800,44524800,7321,2440,4881,2440,0,1,2442,388299,0.388299
2840,1300,640,832000,2,22726,5683,1,50732800,50732800,8521,2840,5681,2840,0,1,2842,453662,0.453662
3240,1300,640,832000,2,25926,6483,1,56940800,56940800,9721,3240,6481,3240,0,1,3242,379824,0.379824
3640,1300,640,832000,2,29126,7283,1,63148800,63148800,10921,3640,7281,3640,0,1,3642,595884,0.595884
4040,1300,640,832000,2,32326,8083,1,69356800,69356800,12121,4040,8081,4040,0,1,4042,650105,0.650105
4440,1300,640,832000,2,35526,8883,1,75564800,75564800,13321,4440,8881,4440,0,1,4442,352636,0.352636
4840,1300,640,832000,2,38726,9683,1,81772800,81772800,14521,4840,9681,4840,0,1,4842,783244,0.783244
5240,1300,640,832000,2,41926,10483,1,87980800,87980800,15721,5240,10481,5240,0,1,5242,852055,0.852055
5640,1300,640,832000,2,45126,11283,1,94188800,94188800,16921,5640,11281,5640,0,1,5642,500364,0.500364
6040,1300,640,832000,2,48326,12083,1,100396800,100396800,18121,6040,12081,6040,0,1,6042,63416,0.063416
6440,1300,640,832000,2,51526,12883,1,106604800,106604800,19321,6440,12881,6440,0,1,6442,843414,0.843414
6840,1300,640,832000,2,54726,13683,1,112812800,112812800,20521,6840,13681,6840,0,1,6842,1096350,1.09635
55,2305,365,841325,2,446,113,1,7905400,7905400,166,55,111,55,0,1,57,18379,0.018379
455,2305,365,841325,2,3646,913,1,16449400,16449400,1366,455,911,455,0,1,457,77897,0.077897
855,2305,365,841325,2,6846,1713,1,24993400,24993400,2566,855,1711,855,0,1,857,141284,0.141284
1255,2305,365,841325,2,10046,2513,1,33537400,33537400,3766,1255,2511,1255,0,1,1257,206383,0.206383
1655,2305,365,841325,2,13246,3313,1,42081400,42081400,4966,1655,3311,1655,0,1,1657,270576,0.270576
2055,2305,365,841325,2,16446,4113,1,50625400,50625400,6166,2055,4111,2055,0,1,2057,165987,0.165987
2455,2305,365,841325,2,19646,4913,1,59169400,59169400,7366,2455,4911,2455,0,1,2457,403078,0.403078
2855,2305,365,841325,2,22846,5713,1,67713400,67713400,8566,2855,5711,2855,0,1,2857,471014,0.471014
3255,2305,365,841325,2,26046,6513,1,76257400,76257400,9766,3255,6511,3255,0,1,3257,535868,0.535868
3655,2305,365,841325,2,29246,7313,1,84801400,84801400,10966,3655,7311,3655,0,1,3657,601718,0.601718
4055,2305,365,841325,2,32446,8113,1,93345400,93345400,12166,4055,8111,4055,0,1,4057,667820,0.66782
4455,2305,365,841325,2,35646,8913,1,101889400,101889400,13366,4455,8911,4455,0,1,4457,734915,0.734915
4855,2305,365,841325,2,38846,9713,1,110433400,110433400,14566,4855,9711,4855,0,1,4857,233688,0.233688
5255,2305,365,841325,2,42046,10513,1,118977400,118977400,15766,5255,10511,5255,0,1,5257,869790,0.86979
5655,2305,365,841325,2,45246,11313,1,127521400,127521400,16966,5655,11311,5655,0,1,5657,925628,0.925628
6055,2305,365,841325,2,48446,12113,1,136065400,136065400,18166,6055,12111,6055,0,1,6057,1003995,1.003995
6455,2305,365,841325,2,51646,12913,1,144609400,144609400,19366,6455,12911,6455,0,1,6457,1076499,1.076499
6855,2305,365,841325,2,54846,13713,1,153153400,153153400,20566,6855,13711,6855,0,1,6857,330879,0.330879
55,305,2765,843325,2,446,113,1,8097400,8097400,166,55,111,55,0,1,57,21227,0.021227
455,305,2765,843325,2,3646,913,1,17921400,17921400,1366,455,911,455,0,1,457,83606,0.083606
855,305,2765,843325,2,6846,1713,1,27745400,27745400,2566,855,1711,855,0,1,857,148175,0.148175
1255,305,2765,843325,2,10046,2513,1,37569400,37569400,3766,1255,2511,1255,0,1,1257,214760,0.21476
1655,305,2765,843325,2,13246,3313,1,47393400,47393400,4966,1655,3311,1655,0,1,1657,280082,0.280082
2055,305,2765,843325,2,16446,4113,1,57217400,57217400,6166,2055,4111,2055,0,1,2057,75174,0.075174
2455,305,2765,843325,2,19646,4913,1,67041400,67041400,7366,2455,4911,2455,0,1,2457,180542,0.180542
2855,305,2765,843325,2,22846,5713,1,76865400,76865400,8566,2855,5711,2855,0,1,2857,174890,0.17489
3255,305,2765,843325,2,26046,6513,1,86689400,86689400,9766,3255,6511,3255,0,1,3257,545704,0.545704
3655,305,2765,843325,2,29246,7313,1,96513400,96513400,10966,3655,7311,3655,0,1,3657,11883,0.011883
4055,305,2765,843325,2,32446,8113,1,106337400,106337400,12166,4055,8111,4055,0,1,4057,41407,0.041407
4455,305,2765,843325,2,35646,8913,1,116161400,116161400,13366,4455,8911,4455,0,1,4457,8802,0.008802
4855,305,2765,843325,2,38846,9713,1,125985400,125985400,14566,4855,9711,4855,0,1,4857,469329,0.469329
5255,305,2765,843325,2,42046,10513,1,135809400,135809400,15766,5255,10511,5255,0,1,5257,721525,0.721525
5655,305,2765,843325,2,45246,11313,1,145633400,145633400,16966,5655,11311,5655,0,1,5657,403706,0.403706
6055,305,2765,843325,2,48446,12113,1,155457400,155457400,18166,6055,12111,6055,0,1,6057,64952,0.064952
6455,305,2765,843325,2,51646,12913,1,165281400,165281400,19366,6455,12911,6455,0,1,6457,105071,0.105071
6855,305,2765,843325,2,54846,13713,1,175105400,175105400,20566,6855,13711,6855,0,1,6857,440091,0.440091
40,550,1540,847000,2,326,83,1,7444800,7444800,121,40,81,40,0,1,42,16404,0.016404
440,550,1540,847000,2,3526,883,1,14132800,14132800,1321,440,881,440,0,1,442,8589,0.008589
840,550,1540,847000,2,6726,1683,1,20820800,20820800,2521,840,1681,840,0,1,842,142865,0.142865
1240,550,1540,847000,2,9926,2483,1,27508800,27508800,3721,1240,2481,1240,0,1,1242,7090,0.00709
1640,550,1540,847000,2,13126,3283,1,34196800,34196800,4921,1640,3281,1640,0,1,1642,36582,0.036582
2040,550,1540,847000,2,16326,4083,1,40884800,40884800,6121,2040,4081,2040,0,1,2042,337122,0.337122
2440,550,1540,847000,2,19526,4883,1,47572800,47572800,7321,2440,4881,2440,0,1,2442,400937,0.400937
2840,550,1540,847000,2,22726,5683,1,54260800,54260800,8521,2840,5681,2840,0,1,2842,287789,0.287789
3240,550,1540,847000,2,25926,6483,1,60948800,60948800,9721,3240,6481,3240,0,1,3242,315028,0.315028
3640,550,1540,847000,2,29126,7283,1,67636800,67636800,10921,3640,7281,3640,0,1,3642,353131,0.353131
4040,550,1540,847000,2,32326,8083,1,74324800,74324800,12121,4040,8081,4040,0,1,4042,664066,0.664066
4440,550,1540,847000,2,35526,8883,1,81012800,81012800,13321,4440,8881,4440,0,1,4442,318706,0.318706
4840,550,1540,847000,2,38726,9683,1,87700800,87700800,14521,4840,9681,4840,0,1,4842,50283,0.050283
5240,550,1540,847000,2,41926,10483,1,94388800,94388800,15721,5240,10481,5240,0,1,5242,857995,0.857995
5640,550,1540,847000,2,45126,11283,1,101076800,101076800,16921,5640,11281,5640,0,1,5642,926200,0.9262
6040,550,1540,847000,2,48326,12083,1,107764800,107764800,18121,6040,12081,6040,0,1,6042,352160,0.35216
6440,550,1540,847000,2,51526,12883,1,114452800,114452800,19321,6440,12881,6440,0,1,6442,81353,0.081353
6840,550,1540,847000,2,54726,13683,1,121140800,121140800,20521,6840,13681,6840,0,1,6842,1122696,1.122696
40,2550,340,867000,2,326,83,1,7860800,7860800,121,40,81,40,0,1,42,17810,0.01781
440,2550,340,867000,2,3526,883,1,17108800,17108800,1321,440,881,440,0,1,442,79547,0.079547
840,2550,340,867000,2,6726,1683,1,26356800,26356800,2521,840,1681,840,0,1,842,142943,0.142943
1240,2550,340,867000,2,9926,2483,1,35604800,35604800,3721,1240,2481,1240,0,1,1242,209775,0.209775
1640,2550,340,867000,2,13126,3283,1,44852800,44852800,4921,1640,3281,1640,0,1,1642,277840,0.27784
2040,2550,340,867000,2,16326,4083,1,54100800,54100800,6121,2040,4081,2040,0,1,2042,344273,0.344273
2440,2550,340,867000,2,19526,4883,1,63348800,63348800,7321,2440,4881,2440,0,1,2442,408920,0.40892
2840,2550,340,867000,2,22726,5683,1,72596800,72596800,8521,2840,5681,2840,0,1,2842,484348,0.484348
3240,2550,340,867000,2,25926,6483,1,81844800,81844800,9721,3240,6481,3240,0,1,3242,546458,0.546458
3640,2550,340,867000,2,29126,7283,1,91092800,91092800,10921,3640,7281,3640,0,1,3642,625981,0.625981
4040,2550,340,867000,2,32326,8083,1,100340800,100340800,12121,4040,8081,4040,0,1,4042,681497,0.681497
4440,2550,340,867000,2,35526,8883,1,109588800,109588800,13321,4440,8881,4440,0,1,4442,751083,0.751083
4840,2550,340,867000,2,38726,9683,1,118836800,118836800,14521,4840,9681,4840,0,1,4842,716903,0.716903
5240,2550,340,867000,2,41926,10483,1,128084800,128084800,15721,5240,10481,5240,0,1,5242,893557,0.893557
5640,2550,340,867000,2,45126,11283,1,137332800,137332800,16921,5640,11281,5640,0,1,5642,956968,0.956968
6040,2550,340,867000,2,48326,12083,1,146580800,146580800,18121,6040,12081,6040,0,1,6042,182097,0.182097
6440,2550,340,867000,2,51526,12883,1,155828800,155828800,19321,6440,12881,6440,0,1,6442,1092746,1.092746
6840,2550,340,867000,2,54726,13683,1,165076800,165076800,20521,6840,13681,6840,0,1,6842,1162934,1.162934
55,1305,665,867825,2,446,113,1,7809400,7809400,166,55,111,55,0,1,57,18176,0.018176
455,1305,665,867825,2,3646,913,1,14113400,14113400,1366,455,911,455,0,1,457,81477,0.081477
855,1305,665,867825,2,6846,1713,1,20417400,20417400,2566,855,1711,855,0,1,857,149831,0.149831
1255,1305,665,867825,2,10046,2513,1,26721400,26721400,3766,1255,2511,1255,0,1,1257,214936,0.214936
1655,1305,665,867825,2,13246,3313,1,33025400,33025400,4966,1655,3311,1655,0,1,1657,282832,0.282832
2055,1305,665,867825,2,16446,4113,1,39329400,39329400,6166,2055,4111,2055,0,1,2057,353544,0.353544
2455,1305,665,867825,2,19646,4913,1,45633400,45633400,7366,2455,4911,2455,0,1,2457,125318,0.125318
2855,1305,665,867825,2,22846,5713,1,51937400,51937400,8566,2855,5711,2855,0,1,2857,496416,0.496416
3255,1305,665,867825,2,26046,6513,1,58241400,58241400,9766,3255,6511,3255,0,1,3257,70210,0.07021
3655,1305,665,867825,2,29246,7313,1,64545400,64545400,10966,3655,7311,3655,0,1,3657,103543,0.103543
4055,1305,665,867825,2,32446,8113,1,70849400,70849400,12166,4055,8111,4055,0,1,4057,707834,0.707834
4455,1305,665,867825,2,35646,8913,1,77153400,77153400,13366,4455,8911,4455,0,1,4457,775145,0.775145
4855,1305,665,867825,2,38846,9713,1,83457400,83457400,14566,4855,9711,4855,0,1,4857,844521,0.844521
5255,1305,665,867825,2,42046,10513,1,89761400,89761400,15766,5255,10511,5255,0,1,5257,912312,0.912312
5655,1305,665,867825,2,45246,11313,1,96065400,96065400,16966,5655,11311,5655,0,1,5657,979584,0.979584
6055,1305,665,867825,2,48446,12113,1,102369400,102369400,18166,6055,12111,6055,0,1,6057,763081,0.763081
6455,1305,665,867825,2,51646,12913,1,108673400,108673400,19366,6455,12911,6455,0,1,6457,1116361,1.116361
6855,1305,665,867825,2,54846,13713,1,114977400,114977400,20566,6855,13711,6855,0,1,6857,1197418,1.197418
55,555,1565,868575,2,446,113,1,7881400,7881400,166,55,111,55,0,1,57,19171,0.019171
455,555,1565,868575,2,3646,913,1,14665400,14665400,1366,455,911,455,0,1,457,83865,0.083865
855,555,1565,868575,2,6846,1713,1,21449400,21449400,2566,855,1711,855,0,1,857,5545,0.005545
1255,555,1565,868575,2,10046,2513,1,28233400,28233400,3766,1255,2511,1255,0,1,1257,218991,0.218991
1655,555,1565,868575,2,13246,3313,1,35017400,35017400,4966,1655,3311,1655,0,1,1657,177910,0.17791
2055,555,1565,868575,2,16446,4113,1,41801400,41801400,6166,2055,4111,2055,0,1,2057,353683,0.353683
2455,555,1565,868575,2,19646,4913,1,48585400,48585400,7366,2455,4911,2455,0,1,2457,34991,0.034991
2855,555,1565,868575,2,22846,5713,1,55369400,55369400,8566,2855,5711,2855,0,1,2857,489955,0.489955
3255,555,1565,868575,2,26046,6513,1,62153400,62153400,9766,3255,6511,3255,0,1,3257,564094,0.564094
3655,555,1565,868575,2,29246,7313,1,68937400,68937400,10966,3655,7311,3655,0,1,3657,290962,0.290962
4055,555,1565,868575,2,32446,8113,1,75721400,75721400,12166,4055,8111,4055,0,1,4057,196636,0.196636
4455,555,1565,868575,2,35646,8913,1,82505400,82505400,13366,4455,8911,4455,0,1,4457,757772,0.757772
4855,555,1565,868575,2,38846,9713,1,89289400,89289400,14566,4855,9711,4855,0,1,4857,826623,0.826623
5255,555,1565,868575,2,42046,10513,1,96073400,96073400,15766,5255,10511,5255,0,1,5257,829687,0.829687
5655,555,1565,868575,2,45246,11313,1,102857400,102857400,16966,5655,11311,5655,0,1,5657,510755,0.510755
6055,555,1565,868575,2,48446,12113,1,109641400,109641400,18166,6055,12111,6055,0,1,6057,130892,0.130892
6455,555,1565,868575,2,51646,12913,1,116425400,116425400,19366,6455,12911,6455,0,1,6457,322389,0.322389
6855,555,1565,868575,2,54846,13713,1,123209400,123209400,20566,6855,13711,6855,0,1,6857,986826,0.986826
35,590,1545,911550,2,286,73,1,7890200,7890200,106,35,71,35,0,1,37,1390,0.00139
535,590,1545,911550,2,4286,1073,1,16430200,16430200,1606,535,1071,535,0,1,537,2083,0.002083
1035,590,1545,911550,2,8286,2073,1,24970200,24970200,3106,1035,2071,1035,0,1,1037,10833,0.010833
1535,590,1545,911550,2,12286,3073,1,33510200,33510200,4606,1535,3071,1535,0,1,1537,130707,0.130707
2035,590,1545,911550,2,16286,4073,1,42050200,42050200,6106,2035,4071,2035,0,1,2037,76635,0.076635
2535,590,1545,911550,2,20286,5073,1,50590200,50590200,7606,2535,5071,2535,0,1,2537,469892,0.469892
3035,590,1545,911550,2,24286,6073,1,59130200,59130200,9106,3035,6071,3035,0,1,3037,559661,0.559661
3535,590,1545,911550,2,28286,7073,1,67670200,67670200,10606,3535,7071,3535,0,1,3537,651725,0.651725
4035,590,1545,911550,2,32286,8073,1,76210200,76210200,12106,4035,8071,4035,0,1,4037,747296,0.747296
4535,590,1545,911550,2,36286,9073,1,84750200,84750200,13606,4535,9071,4535,0,1,4537,840642,0.840642
5035,590,1545,911550,2,40286,10073,1,93290200,93290200,15106,5035,10071,5035,0,1,5037,931866,0.931866
5535,590,1545,911550,2,44286,11073,1,101830200,101830200,16606,5535,11071,5535,0,1,5537,1021359,1.021359
6035,590,1545,911550,2,48286,12073,1,110370200,110370200,18106,6035,12071,6035,0,1,6037,1117145,1.117145
6535,590,1545,911550,2,52286,13073,1,118910200,118910200,19606,6535,13071,6535,0,1,6537,1230046,1.230046
7035,590,1545,911550,2,56286,14073,1,127450200,127450200,21106,7035,14071,7035,0,1,7037,1300383,1.300383
40,300,3040,912000,2,326,83,1,8364800,8364800,121,40,81,40,0,1,42,17995,0.017995
440,300,3040,912000,2,3526,883,1,19052800,19052800,1321,440,881,440,0,1,442,34251,0.034251
840,300,3040,912000,2,6726,1683,1,29740800,29740800,2521,840,1681,840,0,1,842,152715,0.152715
1240,300,3040,912000,2,9926,2483,1,40428800,40428800,3721,1240,2481,1240,0,1,1242,220383,0.220383
1640,300,3040,912000,2,13126,3283,1,51116800,51116800,4921,1640,3281,1640,0,1,1642,290707,0.290707
2040,300,3040,912000,2,16326,4083,1,61804800,61804800,6121,2040,4081,2040,0,1,2042,303861,0.303861
2440,300,3040,912000,2,19526,4883,1,72492800,72492800,7321,2440,4881,2440,0,1,2442,15426,0.015426
2840,300,3040,912000,2,22726,5683,1,83180800,83180800,8521,2840,5681,2840,0,1,2842,24364,0.024364
3240,300,3040,912000,2,25926,6483,1,93868800,93868800,9721,3240,6481,3240,0,1,3242,236820,0.23682
3640,300,3040,912000,2,29126,7283,1,104556800,104556800,10921,3640,7281,3640,0,1,3642,107789,0.107789
4040,300,3040,912000,2,32326,8083,1,115244800,115244800,12121,4040,8081,4040,0,1,4042,702132,0.702132
4440,300,3040,912000,2,35526,8883,1,125932800,125932800,13321,4440,8881,4440,0,1,4442,39065,0.039065
4840,300,3040,912000,2,38726,9683,1,136620800,136620800,14521,4840,9681,4840,0,1,4842,476048,0.476048
5240,300,3040,912000,2,41926,10483,1,147308800,147308800,15721,5240,10481,5240,0,1,5242,725712,0.725712
5640,300,3040,912000,2,45126,11283,1,157996800,157996800,16921,5640,11281,5640,0,1,5642,549292,0.549292
6040,300,3040,912000,2,48326,12083,1,168684800,168684800,18121,6040,12081,6040,0,1,6042,1053899,1.053899
6440,300,3040,912000,2,51526,12883,1,179372800,179372800,19321,6440,12881,6440,0,1,6442,512035,0.512035
6840,300,3040,912000,2,54726,13683,1,190060800,190060800,20521,6840,13681,6840,0,1,6842,640506,0.640506
39,593,1541,913813,2,318,81,1,7976312,7976312,118,39,79,39,0,1,41,17876,0.017876
539,593,1541,913813,2,4318,1081,1,16512312,16512312,1618,539,1079,539,0,1,541,95716,0.095716
1039,593,1541,913813,2,8318,2081,1,25048312,25048312,3118,1039,2079,1039,0,1,1041,37205,0.037205
1539,593,1541,913813,2,12318,3081,1,33584312,33584312,4618,1539,3079,1539,0,1,1541,275118,0.275118
2039,593,1541,913813,2,16318,4081,1,42120312,42120312,6118,2039,4079,2039,0,1,2041,363018,0.363018
2539,593,1541,913813,2,20318,5081,1,50656312,50656312,7618,2539,5079,2539,0,1,2541,220409,0.220409
3039,593,1541,913813,2,24318,6081,1,59192312,59192312,9118,3039,6079,3039,0,1,3041,24203,0.024203
3539,593,1541,913813,2,28318,7081,1,67728312,67728312,10618,3539,7079,3539,0,1,3541,572144,0.572144
4039,593,1541,913813,2,32318,8081,1,76264312,76264312,12118,4039,8079,4039,0,1,4041,68863,0.068863
4539,593,1541,913813,2,36318,9081,1,84800312,84800312,13618,4539,9079,4539,0,1,4541,73181,0.073181
5039,593,1541,913813,2,40318,10081,1,93336312,93336312,15118,5039,10079,5039,0,1,5041,8436,0.008436
5539,593,1541,913813,2,44318,11081,1,101872312,101872312,16618,5539,11079,5539,0,1,5541,104726,0.104726
6039,593,1541,913813,2,48318,12081,1,110408312,110408312,18118,6039,12079,6039,0,1,6041,143783,0.143783
6539,593,1541,913813,2,52318,13081,1,118944312,118944312,19618,6539,13079,6539,0,1,6541,543482,0.543482
7039,593,1541,913813,2,56318,14081,1,127480312,127480312,21118,7039,14079,7039,0,1,7041,1261829,1.261829
39,1693,541,915913,2,318,81,1,8024312,8024312,118,39,79,39,0,1,41,17557,0.017557
539,1693,541,915913,2,4318,1081,1,16960312,16960312,1618,539,1079,539,0,1,541,103383,0.103383
1039,1693,541,915913,2,8318,2081,1,25896312,25896312,3118,1039,2079,1039,0,1,1041,192439,0.192439
1539,1693,541,915913,2,12318,3081,1,34832312,34832312,4618,1539,3079,1539,0,1,1541,281498,0.281498
2039,1693,541,915913,2,16318,4081,1,43768312,43768312,6118,2039,4079,2039,0,1,2041,368126,0.368126
2539,1693,541,915913,2,20318,5081,1,52704312,52704312,7618,2539,5079,2539,0,1,2541,459606,0.459606
3039,1693,541,915913,2,24318,6081,1,61640312,61640312,9118,3039,6079,3039,0,1,3041,554331,0.554331
3539,1693,541,915913,2,28318,7081,1,70576312,70576312,10618,3539,7079,3539,0,1,3541,653116,0.653116
4039,1693,541,915913,2,32318,8081,1,79512312,79512312,12118,4039,8079,4039,0,1,4041,739270,0.73927
4539,1693,541,915913,2,36318,9081,1,88448312,88448312,13618,4539,9079,4539,0,1,4541,834387,0.834387
5039,1693,541,915913,2,40318,10081,1,97384312,97384312,15118,5039,10079,5039,0,1,5041,929382,0.929382
5539,1693,541,915913,2,44318,11081,1,106320312,106320312,16618,5539,11079,5539,0,1,5541,1015930,1.01593
6039,1693,541,915913,2,48318,12081,1,115256312,115256312,18118,6039,12079,6039,0,1,6041,1107255,1.107255
6539,1693,541,915913,2,52318,13081,1,124192312,124192312,19618,6539,13079,6539,0,1,6541,197012,0.197012
7039,1693,541,915913,2,56318,14081,1,133128312,133128312,21118,7039,14079,7039,0,1,7041,1308153,1.308153
55,2555,365,932575,2,446,113,1,8745400,8745400,166,55,111,55,0,1,57,20065,0.020065
455,2555,365,932575,2,3646,913,1,18089400,18089400,1366,455,911,455,0,1,457,88019,0.088019
855,2555,365,932575,2,6846,1713,1,27433400,27433400,2566,855,1711,855,0,1,857,156262,0.156262
1255,2555,365,932575,2,10046,2513,1,36777400,36777400,3766,1255,2511,1255,0,1,1257,229429,0.229429
1655,2555,365,932575,2,13246,3313,1,46121400,46121400,4966,1655,3311,1655,0,1,1657,302487,0.302487
2055,2555,365,932575,2,16446,4113,1,55465400,55465400,6166,2055,4111,2055,0,1,2057,294052,0.294052
2455,2555,365,932575,2,19646,4913,1,64809400,64809400,7366,2455,4911,2455,0,1,2457,446970,0.44697
2855,2555,365,932575,2,22846,5713,1,74153400,74153400,8566,2855,5711,2855,0,1,2857,526814,0.526814
3255,2555,365,932575,2,26046,6513,1,83497400,83497400,9766,3255,6511,3255,0,1,3257,593558,0.593558
3655,2555,365,932575,2,29246,7313,1,92841400,92841400,10966,3655,7311,3655,0,1,3657,674545,0.674545
4055,2555,365,932575,2,32446,8113,1,102185400,102185400,12166,4055,8111,4055,0,1,4057,24572,0.024572
4455,2555,365,932575,2,35646,8913,1,111529400,111529400,13366,4455,8911,4455,0,1,4457,661997,0.661997
4855,2555,365,932575,2,38846,9713,1,120873400,120873400,14566,4855,9711,4855,0,1,4857,889031,0.889031
5255,2555,365,932575,2,42046,10513,1,130217400,130217400,15766,5255,10511,5255,0,1,5257,956945,0.956945
5655,2555,365,932575,2,45246,11313,1,139561400,139561400,16966,5655,11311,5655,0,1,5657,195896,0.195896
6055,2555,365,932575,2,48446,12113,1,148905400,148905400,18166,6055,12111,6055,0,1,6057,1107415,1.107415
6455,2555,365,932575,2,51646,12913,1,158249400,158249400,19366,6455,12911,6455,0,1,6457,1175365,1.175365
6855,2555,365,932575,2,54846,13713,1,167593400,167593400,20566,6855,13711,6855,0,1,6857,686068,0.686068
55,305,3065,934825,2,446,113,1,8961400,8961400,166,55,111,55,0,1,57,21243,0.021243
455,305,3065,934825,2,3646,913,1,19745400,19745400,1366,455,911,455,0,1,457,3506,0.003506
855,305,3065,934825,2,6846,1713,1,30529400,30529400,2566,855,1711,855,0,1,857,26561,0.026561
1255,305,3065,934825,2,10046,2513,1,41313400,41313400,3766,1255,2511,1255,0,1,1257,127435,0.127435
1655,305,3065,934825,2,13246,3313,1,52097400,52097400,4966,1655,3311,1655,0,1,1657,296053,0.296053
2055,305,3065,934825,2,16446,4113,1,62881400,62881400,6166,2055,4111,2055,0,1,2057,111152,0.111152
2455,305,3065,934825,2,19646,4913,1,73665400,73665400,7366,2455,4911,2455,0,1,2457,205207,0.205207
2855,305,3065,934825,2,22846,5713,1,84449400,84449400,8566,2855,5711,2855,0,1,2857,374823,0.374823
3255,305,3065,934825,2,26046,6513,1,95233400,95233400,9766,3255,6511,3255,0,1,3257,605131,0.605131
3655,305,3065,934825,2,29246,7313,1,106017400,106017400,10966,3655,7311,3655,0,1,3657,203258,0.203258
4055,305,3065,934825,2,32446,8113,1,116801400,116801400,12166,4055,8111,4055,0,1,4057,8905,0.008905
4455,305,3065,934825,2,35646,8913,1,127585400,127585400,13366,4455,8911,4455,0,1,4457,828179,0.828179
4855,305,3065,934825,2,38846,9713,1,138369400,138369400,14566,4855,9711,4855,0,1,4857,231098,0.231098
5255,305,3065,934825,2,42046,10513,1,149153400,149153400,15766,5255,10511,5255,0,1,5257,320261,0.320261
5655,305,3065,934825,2,45246,11313,1,159937400,159937400,16966,5655,11311,5655,0,1,5657,259385,0.259385
6055,305,3065,934825,2,48446,12113,1,170721400,170721400,18166,6055,12111,6055,0,1,6057,183643,0.183643
6455,305,3065,934825,2,51646,12913,1,181505400,181505400,19366,6455,12911,6455,0,1,6457,273708,0.273708
6855,305,3065,934825,2,54846,13713,1,192289400,192289400,20566,6855,13711,6855,0,1,6857,1271364,1.271364
44,603,1555,937665,2,358,91,1,8260936,8260936,133,44,89,44,0,1,46,18547,0.018547
544,603,1555,937665,2,4358,1091,1,16892936,16892936,1633,544,1089,544,0,1,546,22040,0.02204
1044,603,1555,937665,2,8358,2091,1,25524936,25524936,3133,1044,2089,1044,0,1,1046,81288,0.081288
1544,603,1555,937665,2,12358,3091,1,34156936,34156936,4633,1544,3089,1544,0,1,1546,148458,0.148458
2044,603,1555,937665,2,16358,4091,1,42788936,42788936,6133,2044,4089,2044,0,1,2046,374046,0.374046
2544,603,1555,937665,2,20358,5091,1,51420936,51420936,7633,2544,5089,2544,0,1,2546,3348,0.003348
3044,603,1555,937665,2,24358,6091,1,60052936,60052936,9133,3044,6089,3044,0,1,3046,369656,0.369656
3544,603,1555,937665,2,28358,7091,1,68684936,68684936,10633,3544,7089,3544,0,1,3546,119369,0.119369
4044,603,1555,937665,2,32358,8091,1,77316936,77316936,12133,4044,8089,4044,0,1,4046,742467,0.742467
4544,603,1555,937665,2,36358,9091,1,85948936,85948936,13633,4544,9089,4544,0,1,4546,143210,0.14321
5044,603,1555,937665,2,40358,10091,1,94580936,94580936,15133,5044,10089,5044,0,1,5046,353910,0.35391
5544,603,1555,937665,2,44358,11091,1,103212936,103212936,16633,5544,11089,5544,0,1,5546,919314,0.919314
6044,603,1555,937665,2,48358,12091,1,111844936,111844936,18133,6044,12089,6044,0,1,6046,416458,0.416458
6544,603,1555,937665,2,52358,13091,1,120476936,120476936,19633,6544,13089,6544,0,1,6546,172271,0.172271
7044,603,1555,937665,2,56358,14091,1,129108936,129108936,21133,7044,14089,7044,0,1,7046,85850,0.08585
44,1703,555,945165,2,358,91,1,8356136,8356136,133,44,89,44,0,1,46,18484,0.018484
544,1703,555,945165,2,4358,1091,1,17388136,17388136,1633,544,1089,544,0,1,546,104929,0.104929
1044,1703,555,945165,2,8358,2091,1,26420136,26420136,3133,1044,2089,1044,0,1,1046,196181,0.196181
1544,1703,555,945165,2,12358,3091,1,35452136,35452136,4633,1544,3089,1544,0,1,1546,285132,0.285132
2044,1703,555,945165,2,16358,4091,1,44484136,44484136,6133,2044,4089,2044,0,1,2046,379485,0.379485
2544,1703,555,945165,2,20358,5091,1,53516136,53516136,7633,2544,5089,2544,0,1,2546,471865,0.471865
3044,1703,555,945165,2,24358,6091,1,62548136,62548136,9133,3044,6089,3044,0,1,3046,275861,0.275861
3544,1703,555,945165,2,28358,7091,1,71580136,71580136,10633,3544,7089,3544,0,1,3546,351880,0.35188
4044,1703,555,945165,2,32358,8091,1,80612136,80612136,12133,4044,8089,4044,0,1,4046,14588,0.014588
4544,1703,555,945165,2,36358,9091,1,89644136,89644136,13633,4544,9089,4544,0,1,4546,849768,0.849768
5044,1703,555,945165,2,40358,10091,1,98676136,98676136,15133,5044,10089,5044,0,1,5046,958120,0.95812
5544,1703,555,945165,2,44358,11091,1,107708136,107708136,16633,5544,11089,5544,0,1,5546,580206,0.580206
6044,1703,555,945165,2,48358,12091,1,116740136,116740136,18133,6044,12089,6044,0,1,6046,647011,0.647011
6544,1703,555,945165,2,52358,13091,1,125772136,125772136,19633,6544,13089,6544,0,1,6546,1230273,1.230273
7044,1703,555,945165,2,56358,14091,1,134804136,134804136,21133,7044,14089,7044,0,1,7046,1331173,1.331173
40,2800,340,952000,2,326,83,1,8620800,8620800,121,40,81,40,0,1,42,17519,0.017519
440,2800,340,952000,2,3526,883,1,18668800,18668800,1321,440,881,440,0,1,442,85887,0.085887
840,2800,340,952000,2,6726,1683,1,28716800,28716800,2521,840,1681,840,0,1,842,163169,0.163169
1240,2800,340,952000,2,9926,2483,1,38764800,38764800,3721,1240,2481,1240,0,1,1242,228460,0.22846
1640,2800,340,952000,2,13126,3283,1,48812800,48812800,4921,1640,3281,1640,0,1,1642,302327,0.302327
2040,2800,340,952000,2,16326,4083,1,58860800,58860800,6121,2040,4081,2040,0,1,2042,381797,0.381797
2440,2800,340,952000,2,19526,4883,1,68908800,68908800,7321,2440,4881,2440,0,1,2442,454045,0.454045
2840,2800,340,952000,2,22726,5683,1,78956800,78956800,8521,2840,5681,2840,0,1,2842,529246,0.529246
3240,2800,340,952000,2,25926,6483,1,89004800,89004800,9721,3240,6481,3240,0,1,3242,600633,0.600633
3640,2800,340,952000,2,29126,7283,1,99052800,99052800,10921,3640,7281,3640,0,1,3642,393176,0.393176
4040,2800,340,952000,2,32326,8083,1,109100800,109100800,12121,4040,8081,4040,0,1,4042,754375,0.754375
4440,2800,340,952000,2,35526,8883,1,119148800,119148800,13321,4440,8881,4440,0,1,4442,828456,0.828456
4840,2800,340,952000,2,38726,9683,1,129196800,129196800,14521,4840,9681,4840,0,1,4842,904649,0.904649
5240,2800,340,952000,2,41926,10483,1,139244800,139244800,15721,5240,10481,5240,0,1,5242,444683,0.444683
5640,2800,340,952000,2,45126,11283,1,149292800,149292800,16921,5640,11281,5640,0,1,5642,701883,0.701883
6040,2800,340,952000,2,48326,12083,1,159340800,159340800,18121,6040,12081,6040,0,1,6042,1131497,1.131497
6440,2800,340,952000,2,51526,12883,1,169388800,169388800,19321,6440,12881,6440,0,1,6442,1203828,1.203828
6840,2800,340,952000,2,54726,13683,1,179436800,179436800,20521,6840,13681,6840,0,1,6842,401843,0.401843
40,1050,940,987000,2,326,83,1,8532800,8532800,121,40,81,40,0,1,42,813,0.000813
440,1050,940,987000,2,3526,883,1,14900800,14900800,1321,440,881,440,0,1,442,1427,0.001427
840,1050,940,987000,2,6726,1683,1,21268800,21268800,2521,840,1681,840,0,1,842,8555,0.008555
1240,1050,940,987000,2,9926,2483,1,27636800,27636800,3721,1240,2481,1240,0,1,1242,50680,0.05068
1640,1050,940,987000,2,13126,3283,1,34004800,34004800,4921,1640,3281,1640,0,1,1642,201882,0.201882
2040,1050,940,987000,2,16326,4083,1,40372800,40372800,6121,2040,4081,2040,0,1,2042,99450,0.09945
2440,1050,940,987000,2,19526,4883,1,46740800,46740800,7321,2440,4881,2440,0,1,2442,317556,0.317556
2840,1050,940,987000,2,22726,5683,1,53108800,53108800,8521,2840,5681,2840,0,1,2842,503710,0.50371
3240,1050,940,987000,2,25926,6483,1,59476800,59476800,9721,3240,6481,3240,0,1,3242,298705,0.298705
3640,1050,940,987000,2,29126,7283,1,65844800,65844800,10921,3640,7281,3640,0,1,3642,515732,0.515732
4040,1050,940,987000,2,32326,8083,1,72212800,72212800,12121,4040,8081,4040,0,1,4042,88231,0.088231
4440,1050,940,987000,2,35526,8883,1,78580800,78580800,13321,4440,8881,4440,0,1,4442,350753,0.350753
4840,1050,940,987000,2,38726,9683,1,84948800,84948800,14521,4840,9681,4840,0,1,4842,622045,0.622045
5240,1050,940,987000,2,41926,10483,1,91316800,91316800,15721,5240,10481,5240,0,1,5242,1027837,1.027837
5640,1050,940,987000,2,45126,11283,1,97684800,97684800,16921,5640,11281,5640,0,1,5642,211138,0.211138
6040,1050,940,987000,2,48326,12083,1,104052800,104052800,18121,6040,12081,6040,0,1,6042,47706,0.047706
6440,1050,940,987000,2,51526,12883,1,110420800,110420800,19321,6440,12881,6440,0,1,6442,11455,0.011455
6840,1050,940,987000,2,54726,13683,1,116788800,116788800,20521,6840,13681,6840,0,1,6842,183556,0.183556
40,800,1240,992000,2,326,83,1,8588800,8588800,121,40,81,40,0,1,42,18491,0.018491
440,800,1240,992000,2,3526,883,1,15116800,15116800,1321,440,881,440,0,1,442,91420,0.09142
840,800,1240,992000,2,6726,1683,1,21644800,21644800,2521,840,1681,840,0,1,842,168986,0.168986
1240,800,1240,992000,2,9926,2483,1,28172800,28172800,3721,1240,2481,1240,0,1,1242,240281,0.240281
1640,800,1240,992000,2,13126,3283,1,34700800,34700800,4921,1640,3281,1640,0,1,1642,313207,0.313207
2040,800,1240,992000,2,16326,4083,1,41228800,41228800,6121,2040,4081,2040,0,1,2042,390391,0.390391
2440,800,1240,992000,2,19526,4883,1,47756800,47756800,7321,2440,4881,2440,0,1,2442,463697,0.463697
2840,800,1240,992000,2,22726,5683,1,54284800,54284800,8521,2840,5681,2840,0,1,2842,539384,0.539384
3240,800,1240,992000,2,25926,6483,1,60812800,60812800,9721,3240,6481,3240,0,1,3242,379674,0.379674
3640,800,1240,992000,2,29126,7283,1,67340800,67340800,10921,3640,7281,3640,0,1,3642,237230,0.23723
4040,800,1240,992000,2,32326,8083,1,73868800,73868800,12121,4040,8081,4040,0,1,4042,211687,0.211687
4440,800,1240,992000,2,35526,8883,1,80396800,80396800,13321,4440,8881,4440,0,1,4442,758368,0.758368
4840,800,1240,992000,2,38726,9683,1,86924800,86924800,14521,4840,9681,4840,0,1,4842,917800,0.9178
5240,800,1240,992000,2,41926,10483,1,93452800,93452800,15721,5240,10481,5240,0,1,5242,12463,0.012463
5640,800,1240,992000,2,45126,11283,1,99980800,99980800,16921,5640,11281,5640,0,1,5642,383259,0.383259
6040,800,1240,992000,2,48326,12083,1,106508800,106508800,18121,6040,12081,6040,0,1,6042,419960,0.41996
6440,800,1240,992000,2,51526,12883,1,113036800,113036800,19321,6440,12881,6440,0,1,6442,707269,0.707269
6840,800,1240,992000,2,54726,13683,1,119564800,119564800,20521,6840,13681,6840,0,1,6842,1302601,1.302601
40,1550,640,992000,2,326,83,1,8636800,8636800,121,40,81,40,0,1,42,19277,0.019277
440,1550,640,992000,2,3526,883,1,15644800,15644800,1321,440,881,440,0,1,442,88191,0.088191
840,1550,640,992000,2,6726,1683,1,22652800,22652800,2521,840,1681,840,0,1,842,162856,0.162856
1240,1550,640,992000,2,9926,2483,1,29660800,29660800,3721,1240,2481,1240,0,1,1242,232769,0.232769
1640,1550,640,992000,2,13126,3283,1,36668800,36668800,4921,1640,3281,1640,0,1,1642,30651,0.030651
2040,1550,640,992000,2,16326,4083,1,43676800,43676800,6121,2040,4081,2040,0,1,2042,386473,0.386473
2440,1550,640,992000,2,19526,4883,1,50684800,50684800,7321,2440,4881,2440,0,1,2442,335343,0.335343
2840,1550,640,992000,2,22726,5683,1,57692800,57692800,8521,2840,5681,2840,0,1,2842,373707,0.373707
3240,1550,640,992000,2,25926,6483,1,64700800,64700800,9721,3240,6481,3240,0,1,3242,617762,0.617762
3640,1550,640,992000,2,29126,7283,1,71708800,71708800,10921,3640,7281,3640,0,1,3642,695039,0.695039
4040,1550,640,992000,2,32326,8083,1,78716800,78716800,12121,4040,8081,4040,0,1,4042,767417,0.767417
4440,1550,640,992000,2,35526,8883,1,85724800,85724800,13321,4440,8881,4440,0,1,4442,872916,0.872916
4840,1550,640,992000,2,38726,9683,1,92732800,92732800,14521,4840,9681,4840,0,1,4842,763785,0.763785
5240,1550,640,992000,2,41926,10483,1,99740800,99740800,15721,5240,10481,5240,0,1,5242,476664,0.476664
5640,1550,640,992000,2,45126,11283,1,106748800,106748800,16921,5640,11281,5640,0,1,5642,1075643,1.075643
6040,1550,640,992000,2,48326,12083,1,113756800,113756800,18121,6040,12081,6040,0,1,6042,1152452,1.152452
6440,1550,640,992000,2,51526,12883,1,120764800,120764800,19321,6440,12881,6440,0,1,6442,201345,0.201345
6840,1550,640,992000,2,54726,13683,1,127772800,127772800,20521,6840,13681,6840,0,1,6842,1295950,1.29595
40,300,3340,1002000,2,326,83,1,9180800,9180800,121,40,81,40,0,1,42,19905,0.019905
440,300,3340,1002000,2,3526,883,1,20828800,20828800,1321,440,881,440,0,1,442,94887,0.094887
840,300,3340,1002000,2,6726,1683,1,32476800,32476800,2521,840,1681,840,0,1,842,83579,0.083579
1240,300,3340,1002000,2,9926,2483,1,44124800,44124800,3721,1240,2481,1240,0,1,1242,147420,0.14742
1640,300,3340,1002000,2,13126,3283,1,55772800,55772800,4921,1640,3281,1640,0,1,1642,20250,0.02025
2040,300,3340,1002000,2,16326,4083,1,67420800,67420800,6121,2040,4081,2040,0,1,2042,404057,0.404057
2440,300,3340,1002000,2,19526,4883,1,79068800,79068800,7321,2440,4881,2440,0,1,2442,480803,0.480803
2840,300,3340,1002000,2,22726,5683,1,90716800,90716800,8521,2840,5681,2840,0,1,2842,558822,0.558822
3240,300,3340,1002000,2,25926,6483,1,102364800,102364800,9721,3240,6481,3240,0,1,3242,616008,0.616008
3640,300,3340,1002000,2,29126,7283,1,114012800,114012800,10921,3640,7281,3640,0,1,3642,573820,0.57382
4040,300,3340,1002000,2,32326,8083,1,125660800,125660800,12121,4040,8081,4040,0,1,4042,253447,0.253447
4440,300,3340,1002000,2,35526,8883,1,137308800,137308800,13321,4440,8881,4440,0,1,4442,79388,0.079388
4840,300,3340,1002000,2,38726,9683,1,148956800,148956800,14521,4840,9681,4840,0,1,4842,149644,0.149644
5240,300,3340,1002000,2,41926,10483,1,160604800,160604800,15721,5240,10481,5240,0,1,5242,224750,0.22475
5640,300,3340,1002000,2,45126,11283,1,172252800,172252800,16921,5640,11281,5640,0,1,5642,749748,0.749748
6040,300,3340,1002000,2,48326,12083,1,183900800,183900800,18121,6040,12081,6040,0,1,6042,109459,0.109459
6440,300,3340,1002000,2,51526,12883,1,195548800,195548800,19321,6440,12881,6440,0,1,6442,645809,0.645809
6840,300,3340,1002000,2,54726,13683,1,207196800,207196800,20521,6840,13681,6840,0,1,6842,238905,0.238905
40,550,1840,1012000,2,326,83,1,8860800,8860800,121,40,81,40,0,1,42,19079,0.019079
440,550,1840,1012000,2,3526,883,1,16508800,16508800,1321,440,881,440,0,1,442,95020,0.09502
840,550,1840,1012000,2,6726,1683,1,24156800,24156800,2521,840,1681,840,0,1,842,7644,0.007644
1240,550,1840,1012000,2,9926,2483,1,31804800,31804800,3721,1240,2481,1240,0,1,1242,102265,0.102265
1640,550,1840,1012000,2,13126,3283,1,39452800,39452800,4921,1640,3281,1640,0,1,1642,322400,0.3224
2040,550,1840,1012000,2,16326,4083,1,47100800,47100800,6121,2040,4081,2040,0,1,2042,393161,0.393161
2440,550,1840,1012000,2,19526,4883,1,54748800,54748800,7321,2440,4881,2440,0,1,2442,469645,0.469645
2840,550,1840,1012000,2,22726,5683,1,62396800,62396800,8521,2840,5681,2840,0,1,2842,158261,0.158261
3240,550,1840,1012000,2,25926,6483,1,70044800,70044800,9721,3240,6481,3240,0,1,3242,621007,0.621007
3640,550,1840,1012000,2,29126,7283,1,77692800,77692800,10921,3640,7281,3640,0,1,3642,649722,0.649722
4040,550,1840,1012000,2,32326,8083,1,85340800,85340800,12121,4040,8081,4040,0,1,4042,772394,0.772394
4440,550,1840,1012000,2,35526,8883,1,92988800,92988800,13321,4440,8881,4440,0,1,4442,367115,0.367115
4840,550,1840,1012000,2,38726,9683,1,100636800,100636800,14521,4840,9681,4840,0,1,4842,922515,0.922515
5240,550,1840,1012000,2,41926,10483,1,108284800,108284800,15721,5240,10481,5240,0,1,5242,965030,0.96503
5640,550,1840,1012000,2,45126,11283,1,115932800,115932800,16921,5640,11281,5640,0,1,5642,479234,0.479234
6040,550,1840,1012000,2,48326,12083,1,123580800,123580800,18121,6040,12081,6040,0,1,6042,1149621,1.149621
6440,550,1840,1012000,2,51526,12883,1,131228800,131228800,19321,6440,12881,6440,0,1,6442,1226723,1.226723
6840,550,1840,1012000,2,54726,13683,1,138876800,138876800,20521,6840,13681,6840,0,1,6842,1039704,1.039704
55,1055,965,1018075,2,446,113,1,9033400,9033400,166,55,111,55,0,1,57,3025,0.003025
455,1055,965,1018075,2,3646,913,1,15497400,15497400,1366,455,911,455,0,1,457,2881,0.002881
855,1055,965,1018075,2,6846,1713,1,21961400,21961400,2566,855,1711,855,0,1,857,175339,0.175339
1255,1055,965,1018075,2,10046,2513,1,28425400,28425400,3766,1255,2511,1255,0,1,1257,10016,0.010016
1655,1055,965,1018075,2,13246,3313,1,34889400,34889400,4966,1655,3311,1655,0,1,1657,54970,0.05497
2055,1055,965,1018075,2,16446,4113,1,41353400,41353400,6166,2055,4111,2055,0,1,2057,30303,0.030303
2455,1055,965,1018075,2,19646,4913,1,47817400,47817400,7366,2455,4911,2455,0,1,2457,374745,0.374745
2855,1055,965,1018075,2,22846,5713,1,54281400,54281400,8566,2855,5711,2855,0,1,2857,158368,0.158368
3255,1055,965,1018075,2,26046,6513,1,60745400,60745400,9766,3255,6511,3255,0,1,3257,660420,0.66042
3655,1055,965,1018075,2,29246,7313,1,67209400,67209400,10966,3655,7311,3655,0,1,3657,417578,0.417578
4055,1055,965,1018075,2,32446,8113,1,73673400,73673400,12166,4055,8111,4055,0,1,4057,823294,0.823294
4455,1055,965,1018075,2,35646,8913,1,80137400,80137400,13366,4455,8911,4455,0,1,4457,285283,0.285283
4855,1055,965,1018075,2,38846,9713,1,86601400,86601400,14566,4855,9711,4855,0,1,4857,173357,0.173357
5255,1055,965,1018075,2,42046,10513,1,93065400,93065400,15766,5255,10511,5255,0,1,5257,45441,0.045441
5655,1055,965,1018075,2,45246,11313,1,99529400,99529400,16966,5655,11311,5655,0,1,5657,501673,0.501673
6055,1055,965,1018075,2,48446,12113,1,105993400,105993400,18166,6055,12111,6055,0,1,6057,11400,0.0114
6455,1055,965,1018075,2,51646,12913,1,112457400,112457400,19366,6455,12911,6455,0,1,6457,1106783,1.106783
6855,1055,965,1018075,2,54846,13713,1,118921400,118921400,20566,6855,13711,6855,0,1,6857,419554,0.419554
55,805,1265,1018325,2,446,113,1,9057400,9057400,166,55,111,55,0,1,57,21997,0.021997
455,805,1265,1018325,2,3646,913,1,15681400,15681400,1366,455,911,455,0,1,457,97259,0.097259
855,805,1265,1018325,2,6846,1713,1,22305400,22305400,2566,855,1711,855,0,1,857,177118,0.177118
1255,805,1265,1018325,2,10046,2513,1,28929400,28929400,3766,1255,2511,1255,0,1,1257,253034,0.253034
1655,805,1265,1018325,2,13246,3313,1,35553400,35553400,4966,1655,3311,1655,0,1,1657,334451,0.334451
2055,805,1265,1018325,2,16446,4113,1,42177400,42177400,6166,2055,4111,2055,0,1,2057,410391,0.410391
2455,805,1265,1018325,2,19646,4913,1,48801400,48801400,7366,2455,4911,2455,0,1,2457,490246,0.490246
2855,805,1265,1018325,2,22846,5713,1,55425400,55425400,8566,2855,5711,2855,0,1,2857,569358,0.569358
3255,805,1265,1018325,2,26046,6513,1,62049400,62049400,9766,3255,6511,3255,0,1,3257,647665,0.647665
3655,805,1265,1018325,2,29246,7313,1,68673400,68673400,10966,3655,7311,3655,0,1,3657,158441,0.158441
4055,805,1265,1018325,2,32446,8113,1,75297400,75297400,12166,4055,8111,4055,0,1,4057,34466,0.034466
4455,805,1265,1018325,2,35646,8913,1,81921400,81921400,13366,4455,8911,4455,0,1,4457,884016,0.884016
4855,805,1265,1018325,2,38846,9713,1,88545400,88545400,14566,4855,9711,4855,0,1,4857,963901,0.963901
5255,805,1265,1018325,2,42046,10513,1,95169400,95169400,15766,5255,10511,5255,0,1,5257,568761,0.568761
5655,805,1265,1018325,2,45246,11313,1,101793400,101793400,16966,5655,11311,5655,0,1,5657,444409,0.444409
6055,805,1265,1018325,2,48446,12113,1,108417400,108417400,18166,6055,12111,6055,0,1,6057,270325,0.270325
6455,805,1265,1018325,2,51646,12913,1,115041400,115041400,19366,6455,12911,6455,0,1,6457,1282485,1.282485
6855,805,1265,1018325,2,54846,13713,1,121665400,121665400,20566,6855,13711,6855,0,1,6857,299668,0.299668
55,2805,365,1023825,2,446,113,1,9585400,9585400,166,55,111,55,0,1,57,21914,0.021914
455,2805,365,1023825,2,3646,913,1,19729400,19729400,1366,455,911,455,0,1,457,94427,0.094427
855,2805,365,1023825,2,6846,1713,1,29873400,29873400,2566,855,1711,855,0,1,857,171197,0.171197
1255,2805,365,1023825,2,10046,2513,1,40017400,40017400,3766,1255,2511,1255,0,1,1257,253093,0.253093
1655,2805,365,1023825,2,13246,3313,1,50161400,50161400,4966,1655,3311,1655,0,1,1657,334597,0.334597
2055,2805,365,1023825,2,16446,4113,1,60305400,60305400,6166,2055,4111,2055,0,1,2057,285641,0.285641
2455,2805,365,1023825,2,19646,4913,1,70449400,70449400,7366,2455,4911,2455,0,1,2457,488969,0.488969
2855,2805,365,1023825,2,22846,5713,1,80593400,80593400,8566,2855,5711,2855,0,1,2857,567768,0.567768
3255,2805,365,1023825,2,26046,6513,1,90737400,90737400,9766,3255,6511,3255,0,1,3257,648589,0.648589
3655,2805,365,1023825,2,29246,7313,1,100881400,100881400,10966,3655,7311,3655,0,1,3657,727364,0.727364
4055,2805,365,1023825,2,32446,8113,1,111025400,111025400,12166,4055,8111,4055,0,1,4057,807563,0.807563
4455,2805,365,1023825,2,35646,8913,1,121169400,121169400,13366,4455,8911,4455,0,1,4457,887288,0.887288
4855,2805,365,1023825,2,38846,9713,1,131313400,131313400,14566,4855,9711,4855,0,1,4857,972276,0.972276
5255,2805,365,1023825,2,42046,10513,1,141457400,141457400,15766,5255,10511,5255,0,1,5257,1050432,1.050432
5655,2805,365,1023825,2,45246,11313,1,151601400,151601400,16966,5655,11311,5655,0,1,5657,536166,0.536166
6055,2805,365,1023825,2,48446,12113,1,161745400,161745400,18166,6055,12111,6055,0,1,6057,297965,0.297965
6455,2805,365,1023825,2,51646,12913,1,171889400,171889400,19366,6455,12911,6455,0,1,6457,1299673,1.299673
6855,2805,365,1023825,2,54846,13713,1,182033400,182033400,20566,6855,13711,6855,0,1,6857,1370250,1.37025
55,305,3365,1026325,2,446,113,1,9825400,9825400,166,55,111,55,0,1,57,23187,0.023187
455,305,3365,1026325,2,3646,913,1,21569400,21569400,1366,455,911,455,0,1,457,101577,0.101577
855,305,3365,1026325,2,6846,1713,1,33313400,33313400,2566,855,1711,855,0,1,857,179913,0.179913
1255,305,3365,1026325,2,10046,2513,1,45057400,45057400,3766,1255,2511,1255,0,1,1257,23672,0.023672
1655,305,3365,1026325,2,13246,3313,1,56801400,56801400,4966,1655,3311,1655,0,1,1657,137573,0.137573
2055,305,3365,1026325,2,16446,4113,1,68545400,68545400,6166,2055,4111,2055,0,1,2057,31931,0.031931
2455,305,3365,1026325,2,19646,4913,1,80289400,80289400,7366,2455,4911,2455,0,1,2457,502204,0.502204
2855,305,3365,1026325,2,22846,5713,1,92033400,92033400,8566,2855,5711,2855,0,1,2857,583408,0.583408
3255,305,3365,1026325,2,26046,6513,1,103777400,103777400,9766,3255,6511,3255,0,1,3257,19215,0.019215
3655,305,3365,1026325,2,29246,7313,1,115521400,115521400,10966,3655,7311,3655,0,1,3657,275370,0.27537
4055,305,3365,1026325,2,32446,8113,1,127265400,127265400,12166,4055,8111,4055,0,1,4057,681558,0.681558
4455,305,3365,1026325,2,35646,8913,1,139009400,139009400,13366,4455,8911,4455,0,1,4457,278742,0.278742
4855,305,3365,1026325,2,38846,9713,1,150753400,150753400,14566,4855,9711,4855,0,1,4857,605817,0.605817
5255,305,3365,1026325,2,42046,10513,1,162497400,162497400,15766,5255,10511,5255,0,1,5257,874952,0.874952
5655,305,3365,1026325,2,45246,11313,1,174241400,174241400,16966,5655,11311,5655,0,1,5657,559634,0.559634
6055,305,3365,1026325,2,48446,12113,1,185985400,185985400,18166,6055,12111,6055,0,1,6057,618429,0.618429
6455,305,3365,1026325,2,51646,12913,1,197729400,197729400,19366,6455,12911,6455,0,1,6457,219299,0.219299
6855,305,3365,1026325,2,54846,13713,1,209473400,209473400,20566,6855,13711,6855,0,1,6857,244501,0.244501
55,1555,665,1034075,2,446,113,1,9249400,9249400,166,55,111,55,0,1,57,22449,0.022449
455,1555,665,1034075,2,3646,913,1,16353400,16353400,1366,455,911,455,0,1,457,98916,0.098916
855,1555,665,1034075,2,6846,1713,1,23457400,23457400,2566,855,1711,855,0,1,857,175983,0.175983
1255,1555,665,1034075,2,10046,2513,1,30561400,30561400,3766,1255,2511,1255,0,1,1257,255913,0.255913
1655,1555,665,1034075,2,13246,3313,1,37665400,37665400,4966,1655,3311,1655,0,1,1657,341140,0.34114
2055,1555,665,1034075,2,16446,4113,1,44769400,44769400,6166,2055,4111,2055,0,1,2057,422776,0.422776
2455,1555,665,1034075,2,19646,4913,1,51873400,51873400,7366,2455,4911,2455,0,1,2457,506073,0.506073
2855,1555,665,1034075,2,22846,5713,1,58977400,58977400,8566,2855,5711,2855,0,1,2857,519195,0.519195
3255,1555,665,1034075,2,26046,6513,1,66081400,66081400,9766,3255,6511,3255,0,1,3257,241212,0.241212
3655,1555,665,1034075,2,29246,7313,1,73185400,73185400,10966,3655,7311,3655,0,1,3657,299289,0.299289
4055,1555,665,1034075,2,32446,8113,1,80289400,80289400,12166,4055,8111,4055,0,1,4057,331076,0.331076
4455,1555,665,1034075,2,35646,8913,1,87393400,87393400,13366,4455,8911,4455,0,1,4457,920185,0.920185
4855,1555,665,1034075,2,38846,9713,1,94497400,94497400,14566,4855,9711,4855,0,1,4857,282228,0.282228
5255,1555,665,1034075,2,42046,10513,1,101601400,101601400,15766,5255,10511,5255,0,1,5257,1094843,1.094843
5655,1555,665,1034075,2,45246,11313,1,108705400,108705400,16966,5655,11311,5655,0,1,5657,244796,0.244796
6055,1555,665,1034075,2,48446,12113,1,115809400,115809400,18166,6055,12111,6055,0,1,6057,1294397,1.294397
6455,1555,665,1034075,2,51646,12913,1,122913400,122913400,19366,6455,12911,6455,0,1,6457,1336244,1.336244
6855,1555,665,1034075,2,54846,13713,1,130017400,130017400,20566,6855,13711,6855,0,1,6857,422673,0.422673
55,555,1865,1035075,2,446,113,1,9345400,9345400,166,55,111,55,0,1,57,22860,0.02286
455,555,1865,1035075,2,3646,913,1,17089400,17089400,1366,455,911,455,0,1,457,99751,0.099751
855,555,1865,1035075,2,6846,1713,1,24833400,24833400,2566,855,1711,855,0,1,857,177575,0.177575
1255,555,1865,1035075,2,10046,2513,1,32577400,32577400,3766,1255,2511,1255,0,1,1257,260485,0.260485
1655,555,1865,1035075,2,13246,3313,1,40321400,40321400,4966,1655,3311,1655,0,1,1657,141739,0.141739
2055,555,1865,1035075,2,16446,4113,1,48065400,48065400,6166,2055,4111,2055,0,1,2057,418087,0.418087
2455,555,1865,1035075,2,19646,4913,1,55809400,55809400,7366,2455,4911,2455,0,1,2457,399366,0.399366
2855,555,1865,1035075,2,22846,5713,1,63553400,63553400,8566,2855,5711,2855,0,1,2857,578367,0.578367
3255,555,1865,1035075,2,26046,6513,1,71297400,71297400,9766,3255,6511,3255,0,1,3257,664178,0.664178
3655,555,1865,1035075,2,29246,7313,1,79041400,79041400,10966,3655,7311,3655,0,1,3657,590998,0.590998
4055,555,1865,1035075,2,32446,8113,1,86785400,86785400,12166,4055,8111,4055,0,1,4057,327647,0.327647
4455,555,1865,1035075,2,35646,8913,1,94529400,94529400,13366,4455,8911,4455,0,1,4457,57096,0.057096
4855,555,1865,1035075,2,38846,9713,1,102273400,102273400,14566,4855,9711,4855,0,1,4857,446186,0.446186
5255,555,1865,1035075,2,42046,10513,1,110017400,110017400,15766,5255,10511,5255,0,1,5257,667079,0.667079
5655,555,1865,1035075,2,45246,11313,1,117761400,117761400,16966,5655,11311,5655,0,1,5657,1143294,1.143294
6055,555,1865,1035075,2,48446,12113,1,125505400,125505400,18166,6055,12111,6055,0,1,6057,1225738,1.225738
6455,555,1865,1035075,2,51646,12913,1,133249400,133249400,19366,6455,12911,6455,0,1,6457,920601,0.920601
6855,555,1865,1035075,2,54846,13713,1,140993400,140993400,20566,6855,13711,6855,0,1,6857,375019,0.375019
40,3050,340,1037000,2,326,83,1,9380800,9380800,121,40,81,40,0,1,42,3738,0.003738
440,3050,340,1037000,2,3526,883,1,20228800,20228800,1321,440,881,440,0,1,442,22120,0.02212
840,3050,340,1037000,2,6726,1683,1,31076800,31076800,2521,840,1681,840,0,1,842,176588,0.176588
1240,3050,340,1037000,2,9926,2483,1,41924800,41924800,3721,1240,2481,1240,0,1,1242,251451,0.251451
1640,3050,340,1037000,2,13126,3283,1,52772800,52772800,4921,1640,3281,1640,0,1,1642,101743,0.101743
2040,3050,340,1037000,2,16326,4083,1,63620800,63620800,6121,2040,4081,2040,0,1,2042,420236,0.420236
2440,3050,340,1037000,2,19526,4883,1,74468800,74468800,7321,2440,4881,2440,0,1,2442,505400,0.5054
2840,3050,340,1037000,2,22726,5683,1,85316800,85316800,8521,2840,5681,2840,0,1,2842,471952,0.471952
3240,3050,340,1037000,2,25926,6483,1,96164800,96164800,9721,3240,6481,3240,0,1,3242,23581,0.023581
3640,3050,340,1037000,2,29126,7283,1,107012800,107012800,10921,3640,7281,3640,0,1,3642,703209,0.703209
4040,3050,340,1037000,2,32326,8083,1,117860800,117860800,12121,4040,8081,4040,0,1,4042,36051,0.036051
4440,3050,340,1037000,2,35526,8883,1,128708800,128708800,13321,4440,8881,4440,0,1,4442,563012,0.563012
4840,3050,340,1037000,2,38726,9683,1,139556800,139556800,14521,4840,9681,4840,0,1,4842,61373,0.061373
5240,3050,340,1037000,2,41926,10483,1,150404800,150404800,15721,5240,10481,5240,0,1,5242,1082676,1.082676
5640,3050,340,1037000,2,45126,11283,1,161252800,161252800,16921,5640,11281,5640,0,1,5642,1137746,1.137746
6040,3050,340,1037000,2,48326,12083,1,172100800,172100800,18121,6040,12081,6040,0,1,6042,80234,0.080234
6440,3050,340,1037000,2,51526,12883,1,182948800,182948800,19321,6440,12881,6440,0,1,6442,296459,0.296459
6840,3050,340,1037000,2,54726,13683,1,193796800,193796800,20521,6840,13681,6840,0,1,6842,51707,0.051707
40,300,3640,1092000,2,326,83,1,9996800,9996800,121,40,81,40,0,1,42,21436,0.021436
440,300,3640,1092000,2,3526,883,1,22604800,22604800,1321,440,881,440,0,1,442,102758,0.102758
840,300,3640,1092000,2,6726,1683,1,35212800,35212800,2521,840,1681,840,0,1,842,185036,0.185036
1240,300,3640,1092000,2,9926,2483,1,47820800,47820800,3721,1240,2481,1240,0,1,1242,6596,0.006596
1640,300,3640,1092000,2,13126,3283,1,60428800,60428800,4921,1640,3281,1640,0,1,1642,120428,0.120428
2040,300,3640,1092000,2,16326,4083,1,73036800,73036800,6121,2040,4081,2040,0,1,2042,416176,0.416176
2440,300,3640,1092000,2,19526,4883,1,85644800,85644800,7321,2440,4881,2440,0,1,2442,79476,0.079476
2840,300,3640,1092000,2,22726,5683,1,98252800,98252800,8521,2840,5681,2840,0,1,2842,231666,0.231666
3240,300,3640,1092000,2,25926,6483,1,110860800,110860800,9721,3240,6481,3240,0,1,3242,688093,0.688093
3640,300,3640,1092000,2,29126,7283,1,123468800,123468800,10921,3640,7281,3640,0,1,3642,197545,0.197545
4040,300,3640,1092000,2,32326,8083,1,136076800,136076800,12121,4040,8081,4040,0,1,4042,647917,0.647917
4440,300,3640,1092000,2,35526,8883,1,148684800,148684800,13321,4440,8881,4440,0,1,4442,652640,0.65264
4840,300,3640,1092000,2,38726,9683,1,161292800,161292800,14521,4840,9681,4840,0,1,4842,219374,0.219374
5240,300,3640,1092000,2,41926,10483,1,173900800,173900800,15721,5240,10481,5240,0,1,5242,452837,0.452837
5640,300,3640,1092000,2,45126,11283,1,186508800,186508800,16921,5640,11281,5640,0,1,5642,1197661,1.197661
6040,300,3640,1092000,2,48326,12083,1,199116800,199116800,18121,6040,12081,6040,0,1,6042,203838,0.203838
6440,300,3640,1092000,2,51526,12883,1,211724800,211724800,19321,6440,12881,6440,0,1,6442,147145,0.147145
6840,300,3640,1092000,2,54726,13683,1,224332800,224332800,20521,6840,13681,6840,0,1,6842,1450594,1.450594
55,3055,365,1115075,2,446,113,1,10425400,10425400,166,55,111,55,0,1,57,297,0.000297
455,3055,365,1115075,2,3646,913,1,21369400,21369400,1366,455,911,455,0,1,457,107206,0.107206
855,3055,365,1115075,2,6846,1713,1,32313400,32313400,2566,855,1711,855,0,1,857,190074,0.190074
1255,3055,365,1115075,2,10046,2513,1,43257400,43257400,3766,1255,2511,1255,0,1,1257,20377,0.020377
1655,3055,365,1115075,2,13246,3313,1,54201400,54201400,4966,1655,3311,1655,0,1,1657,4595,0.004595
2055,3055,365,1115075,2,16446,4113,1,65145400,65145400,6166,2055,4111,2055,0,1,2057,382477,0.382477
2455,3055,365,1115075,2,19646,4913,1,76089400,76089400,7366,2455,4911,2455,0,1,2457,543711,0.543711
2855,3055,365,1115075,2,22846,5713,1,87033400,87033400,8566,2855,5711,2855,0,1,2857,240530,0.24053
3255,3055,365,1115075,2,26046,6513,1,97977400,97977400,9766,3255,6511,3255,0,1,3257,416595,0.416595
3655,3055,365,1115075,2,29246,7313,1,108921400,108921400,10966,3655,7311,3655,0,1,3657,10527,0.010527
4055,3055,365,1115075,2,32446,8113,1,119865400,119865400,12166,4055,8111,4055,0,1,4057,912454,0.912454
4455,3055,365,1115075,2,35646,8913,1,130809400,130809400,13366,4455,8911,4455,0,1,4457,1006409,1.006409
4855,3055,365,1115075,2,38846,9713,1,141753400,141753400,14566,4855,9711,4855,0,1,4857,1127304,1.127304
5255,3055,365,1115075,2,42046,10513,1,152697400,152697400,15766,5255,10511,5255,0,1,5257,1192380,1.19238
5655,3055,365,1115075,2,45246,11313,1,163641400,163641400,16966,5655,11311,5655,0,1,5657,243292,0.243292
6055,3055,365,1115075,2,48446,12113,1,174585400,174585400,18166,6055,12111,6055,0,1,6057,148424,0.148424
6455,3055,365,1115075,2,51646,12913,1,185529400,185529400,19366,6455,12911,6455,0,1,6457,371578,0.371578
6855,3055,365,1115075,2,54846,13713,1,196473400,196473400,20566,6855,13711,6855,0,1,6857,978502,0.978502
55,305,3665,1117825,2,446,113,1,10689400,10689400,166,55,111,55,0,1,57,25124,0.025124
455,305,3665,1117825,2,3646,913,1,23393400,23393400,1366,455,911,455,0,1,457,109719,0.109719
855,305,3665,1117825,2,6846,1713,1,36097400,36097400,2566,855,1711,855,0,1,857,43322,0.043322
1255,305,3665,1117825,2,10046,2513,1,48801400,48801400,3766,1255,2511,1255,0,1,1257,212242,0.212242
1655,305,3665,1117825,2,13246,3313,1,61505400,61505400,4966,1655,3311,1655,0,1,1657,273062,0.273062
2055,305,3665,1117825,2,16446,4113,1,74209400,74209400,6166,2055,4111,2055,0,1,2057,321574,0.321574
2455,305,3665,1117825,2,19646,4913,1,86913400,86913400,7366,2455,4911,2455,0,1,2457,120885,0.120885
2855,305,3665,1117825,2,22846,5713,1,99617400,99617400,8566,2855,5711,2855,0,1,2857,173391,0.173391
3255,305,3665,1117825,2,26046,6513,1,112321400,112321400,9766,3255,6511,3255,0,1,3257,490084,0.490084
3655,305,3665,1117825,2,29246,7313,1,125025400,125025400,10966,3655,7311,3655,0,1,3657,323770,0.32377
4055,305,3665,1117825,2,32446,8113,1,137729400,137729400,12166,4055,8111,4055,0,1,4057,680623,0.680623
4455,305,3665,1117825,2,35646,8913,1,150433400,150433400,13366,4455,8911,4455,0,1,4457,280893,0.280893
4855,305,3665,1117825,2,38846,9713,1,163137400,163137400,14566,4855,9711,4855,0,1,4857,790236,0.790236
5255,305,3665,1117825,2,42046,10513,1,175841400,175841400,15766,5255,10511,5255,0,1,5257,470102,0.470102
5655,305,3665,1117825,2,45246,11313,1,188545400,188545400,16966,5655,11311,5655,0,1,5657,557669,0.557669
6055,305,3665,1117825,2,48446,12113,1,201249400,201249400,18166,6055,12111,6055,0,1,6057,160998,0.160998
6455,305,3665,1117825,2,51646,12913,1,213953400,213953400,19366,6455,12911,6455,0,1,6457,324352,0.324352
6855,305,3665,1117825,2,54846,13713,1,226657400,226657400,20566,6855,13711,6855,0,1,6857,561591,0.561591
40,3300,340,1122000,2,326,83,1,10140800,10140800,121,40,81,40,0,1,42,21078,0.021078
440,3300,340,1122000,2,3526,883,1,21788800,21788800,1321,440,881,440,0,1,442,106385,0.106385
840,3300,340,1122000,2,6726,1683,1,33436800,33436800,2521,840,1681,840,0,1,842,186016,0.186016
1240,3300,340,1122000,2,9926,2483,1,45084800,45084800,3721,1240,2481,1240,0,1,1242,272486,0.272486
1640,3300,340,1122000,2,13126,3283,1,56732800,56732800,4921,1640,3281,1640,0,1,1642,361817,0.361817
2040,3300,340,1122000,2,16326,4083,1,68380800,68380800,6121,2040,4081,2040,0,1,2042,18788,0.018788
2440,3300,340,1122000,2,19526,4883,1,80028800,80028800,7321,2440,4881,2440,0,1,2442,542855,0.542855
2840,3300,340,1122000,2,22726,5683,1,91676800,91676800,8521,2840,5681,2840,0,1,2842,630337,0.630337
3240,3300,340,1122000,2,25926,6483,1,103324800,103324800,9721,3240,6481,3240,0,1,3242,721141,0.721141
3640,3300,340,1122000,2,29126,7283,1,114972800,114972800,10921,3640,7281,3640,0,1,3642,815639,0.815639
4040,3300,340,1122000,2,32326,8083,1,126620800,126620800,12121,4040,8081,4040,0,1,4042,908495,0.908495
4440,3300,340,1122000,2,35526,8883,1,138268800,138268800,13321,4440,8881,4440,0,1,4442,1000319,1.000319
4840,3300,340,1122000,2,38726,9683,1,149916800,149916800,14521,4840,9681,4840,0,1,4842,1091006,1.091006
5240,3300,340,1122000,2,41926,10483,1,161564800,161564800,15721,5240,10481,5240,0,1,5242,813481,0.813481
5640,3300,340,1122000,2,45126,11283,1,173212800,173212800,16921,5640,11281,5640,0,1,5642,1260030,1.26003
6040,3300,340,1122000,2,48326,12083,1,184860800,184860800,18121,6040,12081,6040,0,1,6042,1355612,1.355612
6440,3300,340,1122000,2,51526,12883,1,196508800,196508800,19321,6440,12881,6440,0,1,6442,318549,0.318549
6840,3300,340,1122000,2,54726,13683,1,208156800,208156800,20521,6840,13681,6840,0,1,6842,1531083,1.531083
40,1800,640,1152000,2,326,83,1,9996800,9996800,121,40,81,40,0,1,42,21815,0.021815
440,1800,640,1152000,2,3526,883,1,17804800,17804800,1321,440,881,440,0,1,442,105539,0.105539
840,1800,640,1152000,2,6726,1683,1,25612800,25612800,2521,840,1681,840,0,1,842,188071,0.188071
1240,1800,640,1152000,2,9926,2483,1,33420800,33420800,3721,1240,2481,1240,0,1,1242,272304,0.272304
1640,1800,640,1152000,2,13126,3283,1,41228800,41228800,4921,1640,3281,1640,0,1,1642,360024,0.360024
2040,1800,640,1152000,2,16326,4083,1,49036800,49036800,6121,2040,4081,2040,0,1,2042,449889,0.449889
2440,1800,640,1152000,2,19526,4883,1,56844800,56844800,7321,2440,4881,2440,0,1,2442,538468,0.538468
2840,1800,640,1152000,2,22726,5683,1,64652800,64652800,8521,2840,5681,2840,0,1,2842,628412,0.628412
3240,1800,640,1152000,2,25926,6483,1,72460800,72460800,9721,3240,6481,3240,0,1,3242,6982,0.006982
3640,1800,640,1152000,2,29126,7283,1,80268800,80268800,10921,3640,7281,3640,0,1,3642,800770,0.80077
4040,1800,640,1152000,2,32326,8083,1,88076800,88076800,12121,4040,8081,4040,0,1,4042,891650,0.89165
4440,1800,640,1152000,2,35526,8883,1,95884800,95884800,13321,4440,8881,4440,0,1,4442,983406,0.983406
4840,1800,640,1152000,2,38726,9683,1,103692800,103692800,14521,4840,9681,4840,0,1,4842,1065484,1.065484
5240,1800,640,1152000,2,41926,10483,1,111500800,111500800,15721,5240,10481,5240,0,1,5242,459584,0.459584
5640,1800,640,1152000,2,45126,11283,1,119308800,119308800,16921,5640,11281,5640,0,1,5642,855207,0.855207
6040,1800,640,1152000,2,48326,12083,1,127116800,127116800,18121,6040,12081,6040,0,1,6042,116144,0.116144
6440,1800,640,1152000,2,51526,12883,1,134924800,134924800,19321,6440,12881,6440,0,1,6442,1427926,1.427926
6840,1800,640,1152000,2,54726,13683,1,142732800,142732800,20521,6840,13681,6840,0,1,6842,499136,0.499136
40,550,2140,1177000,2,326,83,1,10276800,10276800,121,40,81,40,0,1,42,22284,0.022284
440,550,2140,1177000,2,3526,883,1,18884800,18884800,1321,440,881,440,0,1,442,110114,0.110114
840,550,2140,1177000,2,6726,1683,1,27492800,27492800,2521,840,1681,840,0,1,842,169659,0.169659
1240,550,2140,1177000,2,9926,2483,1,36100800,36100800,3721,1240,2481,1240,0,1,1242,286171,0.286171
1640,550,2140,1177000,2,13126,3283,1,44708800,44708800,4921,1640,3281,1640,0,1,1642,32006,0.032006
2040,550,2140,1177000,2,16326,4083,1,53316800,53316800,6121,2040,4081,2040,0,1,2042,293412,0.293412
2440,550,2140,1177000,2,19526,4883,1,61924800,61924800,7321,2440,4881,2440,0,1,2442,10972,0.010972
2840,550,2140,1177000,2,22726,5683,1,70532800,70532800,8521,2840,5681,2840,0,1,2842,600080,0.60008
3240,550,2140,1177000,2,25926,6483,1,79140800,79140800,9721,3240,6481,3240,0,1,3242,34250,0.03425
3640,550,2140,1177000,2,29126,7283,1,87748800,87748800,10921,3640,7281,3640,0,1,3642,828251,0.828251
4040,550,2140,1177000,2,32326,8083,1,96356800,96356800,12121,4040,8081,4040,0,1,4042,267488,0.267488
4440,550,2140,1177000,2,35526,8883,1,104964800,104964800,13321,4440,8881,4440,0,1,4442,263470,0.26347
4840,550,2140,1177000,2,38726,9683,1,113572800,113572800,14521,4840,9681,4840,0,1,4842,404046,0.404046
5240,550,2140,1177000,2,41926,10483,1,122180800,122180800,15721,5240,10481,5240,0,1,5242,910231,0.910231
5640,550,2140,1177000,2,45126,11283,1,130788800,130788800,16921,5640,11281,5640,0,1,5642,1282454,1.282454
6040,550,2140,1177000,2,48326,12083,1,139396800,139396800,18121,6040,12081,6040,0,1,6042,923556,0.923556
6440,550,2140,1177000,2,51526,12883,1,148004800,148004800,19321,6440,12881,6440,0,1,6442,830385,0.830385
6840,550,2140,1177000,2,54726,13683,1,156612800,156612800,20521,6840,13681,6840,0,1,6842,1551599,1.551599
40,300,3940,1182000,2,326,83,1,10812800,10812800,121,40,81,40,0,1,42,23145,0.023145
440,300,3940,1182000,2,3526,883,1,24380800,24380800,1321,440,881,440,0,1,442,111195,0.111195
840,300,3940,1182000,2,6726,1683,1,37948800,37948800,2521,840,1681,840,0,1,842,201720,0.20172
1240,300,3940,1182000,2,9926,2483,1,51516800,51516800,3721,1240,2481,1240,0,1,1242,143062,0.143062
1640,300,3940,1182000,2,13126,3283,1,65084800,65084800,4921,1640,3281,1640,0,1,1642,183502,0.183502
2040,300,3940,1182000,2,16326,4083,1,78652800,78652800,6121,2040,4081,2040,0,1,2042,475737,0.475737
2440,300,3940,1182000,2,19526,4883,1,92220800,92220800,7321,2440,4881,2440,0,1,2442,150996,0.150996
2840,300,3940,1182000,2,22726,5683,1,105788800,105788800,8521,2840,5681,2840,0,1,2842,159531,0.159531
3240,300,3940,1182000,2,25926,6483,1,119356800,119356800,9721,3240,6481,3240,0,1,3242,254937,0.254937
3640,300,3940,1182000,2,29126,7283,1,132924800,132924800,10921,3640,7281,3640,0,1,3642,365198,0.365198
4040,300,3940,1182000,2,32326,8083,1,146492800,146492800,12121,4040,8081,4040,0,1,4042,239878,0.239878
4440,300,3940,1182000,2,35526,8883,1,160060800,160060800,13321,4440,8881,4440,0,1,4442,586855,0.586855
4840,300,3940,1182000,2,38726,9683,1,173628800,173628800,14521,4840,9681,4840,0,1,4842,770265,0.770265
5240,300,3940,1182000,2,41926,10483,1,187196800,187196800,15721,5240,10481,5240,0,1,5242,1105907,1.105907
5640,300,3940,1182000,2,45126,11283,1,200764800,200764800,16921,5640,11281,5640,0,1,5642,15607,0.015607
6040,300,3940,1182000,2,48326,12083,1,214332800,214332800,18121,6040,12081,6040,0,1,6042,1399939,1.399939
6440,300,3940,1182000,2,51526,12883,1,227900800,227900800,19321,6440,12881,6440,0,1,6442,117324,0.117324
6840,300,3940,1182000,2,54726,13683,1,241468800,241468800,20521,6840,13681,6840,0,1,6842,585098,0.585098
39,1143,1041,1189863,2,318,81,1,10200312,10200312,118,39,79,39,0,1,41,9027,0.009027
539,1143,1041,1189863,2,4318,1081,1,18936312,18936312,1618,539,1079,539,0,1,541,18995,0.018995
1039,1143,1041,1189863,2,8318,2081,1,27672312,27672312,3118,1039,2079,1039,0,1,1041,35866,0.035866
1539,1143,1041,1189863,2,12318,3081,1,36408312,36408312,4618,1539,3079,1539,0,1,1541,2665,0.002665
2039,1143,1041,1189863,2,16318,4081,1,45144312,45144312,6118,2039,4079,2039,0,1,2041,119034,0.119034
2539,1143,1041,1189863,2,20318,5081,1,53880312,53880312,7618,2539,5079,2539,0,1,2541,143787,0.143787
3039,1143,1041,1189863,2,24318,6081,1,62616312,62616312,9118,3039,6079,3039,0,1,3041,274888,0.274888
3539,1143,1041,1189863,2,28318,7081,1,71352312,71352312,10618,3539,7079,3539,0,1,3541,78933,0.078933
4039,1143,1041,1189863,2,32318,8081,1,80088312,80088312,12118,4039,8079,4039,0,1,4041,320438,0.320438
4539,1143,1041,1189863,2,36318,9081,1,88824312,88824312,13618,4539,9079,4539,0,1,4541,396060,0.39606
5039,1143,1041,1189863,2,40318,10081,1,97560312,97560312,15118,5039,10079,5039,0,1,5041,291417,0.291417
5539,1143,1041,1189863,2,44318,11081,1,106296312,106296312,16618,5539,11079,5539,0,1,5541,239100,0.2391
6039,1143,1041,1189863,2,48318,12081,1,115032312,115032312,18118,6039,12079,6039,0,1,6041,1442454,1.442454
6539,1143,1041,1189863,2,52318,13081,1,123768312,123768312,19618,6539,13079,6539,0,1,6541,1552505,1.552505
7039,1143,1041,1189863,2,56318,14081,1,132504312,132504312,21118,7039,14079,7039,0,1,7041,1671943,1.671943
35,1140,1045,1191300,2,286,73,1,10142200,10142200,106,35,71,35,0,1,37,30202,0.030202
535,1140,1045,1191300,2,4286,1073,1,18882200,18882200,1606,535,1071,535,0,1,537,131530,0.13153
1035,1140,1045,1191300,2,8286,2073,1,27622200,27622200,3106,1035,2071,1035,0,1,1037,248683,0.248683
1535,1140,1045,1191300,2,12286,3073,1,36362200,36362200,4606,1535,3071,1535,0,1,1537,358128,0.358128
2035,1140,1045,1191300,2,16286,4073,1,45102200,45102200,6106,2035,4071,2035,0,1,2037,467653,0.467653
2535,1140,1045,1191300,2,20286,5073,1,53842200,53842200,7606,2535,5071,2535,0,1,2537,582883,0.582883
3035,1140,1045,1191300,2,24286,6073,1,62582200,62582200,9106,3035,6071,3035,0,1,3037,701289,0.701289
3535,1140,1045,1191300,2,28286,7073,1,71322200,71322200,10606,3535,7071,3535,0,1,3537,811722,0.811722
4035,1140,1045,1191300,2,32286,8073,1,80062200,80062200,12106,4035,8071,4035,0,1,4037,927944,0.927944
55,1805,665,1200325,2,446,113,1,10689400,10689400,166,55,111,55,0,1,57,26877,0.026877
455,1805,665,1200325,2,3646,913,1,18593400,18593400,1366,455,911,455,0,1,457,114265,0.114265
855,1805,665,1200325,2,6846,1713,1,26497400,26497400,2566,855,1711,855,0,1,857,204548,0.204548
1255,1805,665,1200325,2,10046,2513,1,34401400,34401400,3766,1255,2511,1255,0,1,1257,299493,0.299493
1655,1805,665,1200325,2,13246,3313,1,42305400,42305400,4966,1655,3311,1655,0,1,1657,396429,0.396429
2055,1805,665,1200325,2,16446,4113,1,50209400,50209400,6166,2055,4111,2055,0,1,2057,492187,0.492187
2455,1805,665,1200325,2,19646,4913,1,58113400,58113400,7366,2455,4911,2455,0,1,2457,259898,0.259898
2855,1805,665,1200325,2,22846,5713,1,66017400,66017400,8566,2855,5711,2855,0,1,2857,103959,0.103959
3255,1805,665,1200325,2,26046,6513,1,73921400,73921400,9766,3255,6511,3255,0,1,3257,116554,0.116554
3655,1805,665,1200325,2,29246,7313,1,81825400,81825400,10966,3655,7311,3655,0,1,3657,876979,0.876979
4055,1805,665,1200325,2,32446,8113,1,89729400,89729400,12166,4055,8111,4055,0,1,4057,46284,0.046284
4455,1805,665,1200325,2,35646,8913,1,97633400,97633400,13366,4455,8911,4455,0,1,4457,460426,0.460426
4855,1805,665,1200325,2,38846,9713,1,105537400,105537400,14566,4855,9711,4855,0,1,4857,1161388,1.161388
5255,1805,665,1200325,2,42046,10513,1,113441400,113441400,15766,5255,10511,5255,0,1,5257,997099,0.997099
5655,1805,665,1200325,2,45246,11313,1,121345400,121345400,16966,5655,11311,5655,0,1,5657,479546,0.479546
6055,1805,665,1200325,2,48446,12113,1,129249400,129249400,18166,6055,12111,6055,0,1,6057,542540,0.54254
6455,1805,665,1200325,2,51646,12913,1,137153400,137153400,19366,6455,12911,6455,0,1,6457,1214858,1.214858
6855,1805,665,1200325,2,54846,13713,1,145057400,145057400,20566,6855,13711,6855,0,1,6857,1479499,1.479499
55,555,2165,1201575,2,446,113,1,10809400,10809400,166,55,111,55,0,1,57,26234,0.026234
455,555,2165,1201575,2,3646,913,1,19513400,19513400,1366,455,911,455,0,1,457,115508,0.115508
855,555,2165,1201575,2,6846,1713,1,28217400,28217400,2566,855,1711,855,0,1,857,206953,0.206953
1255,555,2165,1201575,2,10046,2513,1,36921400,36921400,3766,1255,2511,1255,0,1,1257,300588,0.300588
1655,555,2165,1201575,2,13246,3313,1,45625400,45625400,4966,1655,3311,1655,0,1,1657,394605,0.394605
2055,555,2165,1201575,2,16446,4113,1,54329400,54329400,6166,2055,4111,2055,0,1,2057,85037,0.085037
2455,555,2165,1201575,2,19646,4913,1,63033400,63033400,7366,2455,4911,2455,0,1,2457,336892,0.336892
2855,555,2165,1201575,2,22846,5713,1,71737400,71737400,8566,2855,5711,2855,0,1,2857,672026,0.672026
3255,555,2165,1201575,2,26046,6513,1,80441400,80441400,9766,3255,6511,3255,0,1,3257,762244,0.762244
3655,555,2165,1201575,2,29246,7313,1,89145400,89145400,10966,3655,7311,3655,0,1,3657,164239,0.164239
4055,555,2165,1201575,2,32446,8113,1,97849400,97849400,12166,4055,8111,4055,0,1,4057,908442,0.908442
4455,555,2165,1201575,2,35646,8913,1,106553400,106553400,13366,4455,8911,4455,0,1,4457,55046,0.055046
4855,555,2165,1201575,2,38846,9713,1,115257400,115257400,14566,4855,9711,4855,0,1,4857,1137432,1.137432
5255,555,2165,1201575,2,42046,10513,1,123961400,123961400,15766,5255,10511,5255,0,1,5257,1110763,1.110763
5655,555,2165,1201575,2,45246,11313,1,132665400,132665400,16966,5655,11311,5655,0,1,5657,188281,0.188281
6055,555,2165,1201575,2,48446,12113,1,141369400,141369400,18166,6055,12111,6055,0,1,6057,141685,0.141685
6455,555,2165,1201575,2,51646,12913,1,150073400,150073400,19366,6455,12911,6455,0,1,6457,52593,0.052593
6855,555,2165,1201575,2,54846,13713,1,158777400,158777400,20566,6855,13711,6855,0,1,6857,359098,0.359098
55,3305,365,1206325,2,446,113,1,11265400,11265400,166,55,111,55,0,1,57,25356,0.025356
455,3305,365,1206325,2,3646,913,1,23009400,23009400,1366,455,911,455,0,1,457,114346,0.114346
855,3305,365,1206325,2,6846,1713,1,34753400,34753400,2566,855,1711,855,0,1,857,6766,0.006766
1255,3305,365,1206325,2,10046,2513,1,46497400,46497400,3766,1255,2511,1255,0,1,1257,295908,0.295908
1655,3305,365,1206325,2,13246,3313,1,58241400,58241400,4966,1655,3311,1655,0,1,1657,394903,0.394903
2055,3305,365,1206325,2,16446,4113,1,69985400,69985400,6166,2055,4111,2055,0,1,2057,493072,0.493072
2455,3305,365,1206325,2,19646,4913,1,81729400,81729400,7366,2455,4911,2455,0,1,2457,592838,0.592838
2855,3305,365,1206325,2,22846,5713,1,93473400,93473400,8566,2855,5711,2855,0,1,2857,695363,0.695363
3255,3305,365,1206325,2,26046,6513,1,105217400,105217400,9766,3255,6511,3255,0,1,3257,787607,0.787607
3655,3305,365,1206325,2,29246,7313,1,116961400,116961400,10966,3655,7311,3655,0,1,3657,884695,0.884695
4055,3305,365,1206325,2,32446,8113,1,128705400,128705400,12166,4055,8111,4055,0,1,4057,119480,0.11948
4455,3305,365,1206325,2,35646,8913,1,140449400,140449400,13366,4455,8911,4455,0,1,4457,878358,0.878358
4855,3305,365,1206325,2,38846,9713,1,152193400,152193400,14566,4855,9711,4855,0,1,4857,1055595,1.055595
5255,3305,365,1206325,2,42046,10513,1,163937400,163937400,15766,5255,10511,5255,0,1,5257,1312564,1.312564
5655,3305,365,1206325,2,45246,11313,1,175681400,175681400,16966,5655,11311,5655,0,1,5657,454983,0.454983
6055,3305,365,1206325,2,48446,12113,1,187425400,187425400,18166,6055,12111,6055,0,1,6057,1224632,1.224632
6455,3305,365,1206325,2,51646,12913,1,199169400,199169400,19366,6455,12911,6455,0,1,6457,1566610,1.56661
6855,3305,365,1206325,2,54846,13713,1,210913400,210913400,20566,6855,13711,6855,0,1,6857,1294208,1.294208
35,590,2045,1206550,2,286,73,1,10390200,10390200,106,35,71,35,0,1,37,2898,0.002898
535,590,2045,1206550,2,4286,1073,1,20930200,20930200,1606,535,1071,535,0,1,537,6569,0.006569
1035,590,2045,1206550,2,8286,2073,1,31470200,31470200,3106,1035,2071,1035,0,1,1037,71788,0.071788
1535,590,2045,1206550,2,12286,3073,1,42010200,42010200,4606,1535,3071,1535,0,1,1537,113850,0.11385
2035,590,2045,1206550,2,16286,4073,1,52550200,52550200,6106,2035,4071,2035,0,1,2037,181936,0.181936
2535,590,2045,1206550,2,20286,5073,1,63090200,63090200,7606,2535,5071,2535,0,1,2537,611992,0.611992
3035,590,2045,1206550,2,24286,6073,1,73630200,73630200,9106,3035,6071,3035,0,1,3037,741554,0.741554
3535,590,2045,1206550,2,28286,7073,1,84170200,84170200,10606,3535,7071,3535,0,1,3537,862176,0.862176
4035,590,2045,1206550,2,32286,8073,1,94710200,94710200,12106,4035,8071,4035,0,1,4037,981910,0.98191
4535,590,2045,1206550,2,36286,9073,1,105250200,105250200,13606,4535,9071,4535,0,1,4537,1106003,1.106003
5035,590,2045,1206550,2,40286,10073,1,115790200,115790200,15106,5035,10071,5035,0,1,5037,1228247,1.228247
5535,590,2045,1206550,2,44286,11073,1,126330200,126330200,16606,5535,11071,5535,0,1,5537,1352031,1.352031
6035,590,2045,1206550,2,48286,12073,1,136870200,136870200,18106,6035,12071,6035,0,1,6037,1473553,1.473553
6535,590,2045,1206550,2,52286,13073,1,147410200,147410200,19606,6535,13071,6535,0,1,6537,1621015,1.621015
7035,590,2045,1206550,2,56286,14073,1,157950200,157950200,21106,7035,14071,7035,0,1,7037,1716376,1.716376
40,3550,340,1207000,2,326,83,1,10900800,10900800,121,40,81,40,0,1,42,21936,0.021936
440,3550,340,1207000,2,3526,883,1,23348800,23348800,1321,440,881,440,0,1,442,108857,0.108857
840,3550,340,1207000,2,6726,1683,1,35796800,35796800,2521,840,1681,840,0,1,842,201825,0.201825
1240,3550,340,1207000,2,9926,2483,1,48244800,48244800,3721,1240,2481,1240,0,1,1242,291599,0.291599
1640,3550,340,1207000,2,13126,3283,1,60692800,60692800,4921,1640,3281,1640,0,1,1642,391696,0.391696
2040,3550,340,1207000,2,16326,4083,1,73140800,73140800,6121,2040,4081,2040,0,1,2042,483051,0.483051
2440,3550,340,1207000,2,19526,4883,1,85588800,85588800,7321,2440,4881,2440,0,1,2442,580721,0.580721
2840,3550,340,1207000,2,22726,5683,1,98036800,98036800,8521,2840,5681,2840,0,1,2842,677519,0.677519
3240,3550,340,1207000,2,25926,6483,1,110484800,110484800,9721,3240,6481,3240,0,1,3242,775353,0.775353
3640,3550,340,1207000,2,29126,7283,1,122932800,122932800,10921,3640,7281,3640,0,1,3642,872702,0.872702
4040,3550,340,1207000,2,32326,8083,1,135380800,135380800,12121,4040,8081,4040,0,1,4042,337401,0.337401
4440,3550,340,1207000,2,35526,8883,1,147828800,147828800,13321,4440,8881,4440,0,1,4442,1067553,1.067553
4840,3550,340,1207000,2,38726,9683,1,160276800,160276800,14521,4840,9681,4840,0,1,4842,801600,0.8016
5240,3550,340,1207000,2,41926,10483,1,172724800,172724800,15721,5240,10481,5240,0,1,5242,502828,0.502828
5640,3550,340,1207000,2,45126,11283,1,185172800,185172800,16921,5640,11281,5640,0,1,5642,193368,0.193368
6040,3550,340,1207000,2,48326,12083,1,197620800,197620800,18121,6040,12081,6040,0,1,6042,1458102,1.458102
6440,3550,340,1207000,2,51526,12883,1,210068800,210068800,19321,6440,12881,6440,0,1,6442,1553506,1.553506
6840,3550,340,1207000,2,54726,13683,1,222516800,222516800,20521,6840,13681,6840,0,1,6842,1651421,1.651421
55,305,3965,1209325,2,446,113,1,11553400,11553400,166,55,111,55,0,1,57,26998,0.026998
455,305,3965,1209325,2,3646,913,1,25217400,25217400,1366,455,911,455,0,1,457,118537,0.118537
855,305,3965,1209325,2,6846,1713,1,38881400,38881400,2566,855,1711,855,0,1,857,211106,0.211106
1255,305,3965,1209325,2,10046,2513,1,52545400,52545400,3766,1255,2511,1255,0,1,1257,186430,0.18643
1655,305,3965,1209325,2,13246,3313,1,66209400,66209400,4966,1655,3311,1655,0,1,1657,189286,0.189286
2055,305,3965,1209325,2,16446,4113,1,79873400,79873400,6166,2055,4111,2055,0,1,2057,494521,0.494521
2455,305,3965,1209325,2,19646,4913,1,93537400,93537400,7366,2455,4911,2455,0,1,2457,120674,0.120674
2855,305,3965,1209325,2,22846,5713,1,107201400,107201400,8566,2855,5711,2855,0,1,2857,409718,0.409718
3255,305,3965,1209325,2,26046,6513,1,120865400,120865400,9766,3255,6511,3255,0,1,3257,474761,0.474761
3655,305,3965,1209325,2,29246,7313,1,134529400,134529400,10966,3655,7311,3655,0,1,3657,473595,0.473595
4055,305,3965,1209325,2,32446,8113,1,148193400,148193400,12166,4055,8111,4055,0,1,4057,197877,0.197877
4455,305,3965,1209325,2,35646,8913,1,161857400,161857400,13366,4455,8911,4455,0,1,4457,201874,0.201874
4855,305,3965,1209325,2,38846,9713,1,175521400,175521400,14566,4855,9711,4855,0,1,4857,92224,0.092224
5255,305,3965,1209325,2,42046,10513,1,189185400,189185400,15766,5255,10511,5255,0,1,5257,38926,0.038926
5655,305,3965,1209325,2,45246,11313,1,202849400,202849400,16966,5655,11311,5655,0,1,5657,941590,0.94159
6055,305,3965,1209325,2,48446,12113,1,216513400,216513400,18166,6055,12111,6055,0,1,6057,1374390,1.37439
6455,305,3965,1209325,2,51646,12913,1,230177400,230177400,19366,6455,12911,6455,0,1,6457,822604,0.822604
6855,305,3965,1209325,2,54846,13713,1,243841400,243841400,20566,6855,13711,6855,0,1,6857,132742,0.132742
39,593,2041,1210313,2,318,81,1,10504312,10504312,118,39,79,39,0,1,41,23285,0.023285
539,593,2041,1210313,2,4318,1081,1,21040312,21040312,1618,539,1079,539,0,1,541,134636,0.134636
1039,593,2041,1210313,2,8318,2081,1,31576312,31576312,3118,1039,2079,1039,0,1,1041,90188,0.090188
1539,593,2041,1210313,2,12318,3081,1,42112312,42112312,4618,1539,3079,1539,0,1,1541,363215,0.363215
2039,593,2041,1210313,2,16318,4081,1,52648312,52648312,6118,2039,4079,2039,0,1,2041,46482,0.046482
2539,593,2041,1210313,2,20318,5081,1,63184312,63184312,7618,2539,5079,2539,0,1,2541,36018,0.036018
3039,593,2041,1210313,2,24318,6081,1,73720312,73720312,9118,3039,6079,3039,0,1,3041,355185,0.355185
3539,593,2041,1210313,2,28318,7081,1,84256312,84256312,10618,3539,7079,3539,0,1,3541,474637,0.474637
4039,593,2041,1210313,2,32318,8081,1,94792312,94792312,12118,4039,8079,4039,0,1,4041,476354,0.476354
4539,593,2041,1210313,2,36318,9081,1,105328312,105328312,13618,4539,9079,4539,0,1,4541,193769,0.193769
5039,593,2041,1210313,2,40318,10081,1,115864312,115864312,15118,5039,10079,5039,0,1,5041,642983,0.642983
5539,593,2041,1210313,2,44318,11081,1,126400312,126400312,16618,5539,11079,5539,0,1,5541,73441,0.073441
6039,593,2041,1210313,2,48318,12081,1,136936312,136936312,18118,6039,12079,6039,0,1,6041,351086,0.351086
6539,593,2041,1210313,2,52318,13081,1,147472312,147472312,19618,6539,13079,6539,0,1,6541,337701,0.337701
7039,593,2041,1210313,2,56318,14081,1,158008312,158008312,21118,7039,14079,7039,0,1,7041,1411872,1.411872
39,2243,541,1213463,2,318,81,1,10576312,10576312,118,39,79,39,0,1,41,4683,0.004683
539,2243,541,1213463,2,4318,1081,1,21712312,21712312,1618,539,1079,539,0,1,541,1562,0.001562
1039,2243,541,1213463,2,8318,2081,1,32848312,32848312,3118,1039,2079,1039,0,1,1041,1844,0.001844
1539,2243,541,1213463,2,12318,3081,1,43984312,43984312,4618,1539,3079,1539,0,1,1541,134640,0.13464
2039,2243,541,1213463,2,16318,4081,1,55120312,55120312,6118,2039,4079,2039,0,1,2041,92829,0.092829
2539,2243,541,1213463,2,20318,5081,1,66256312,66256312,7618,2539,5079,2539,0,1,2541,254531,0.254531
3039,2243,541,1213463,2,24318,6081,1,77392312,77392312,9118,3039,6079,3039,0,1,3041,593161,0.593161
3539,2243,541,1213463,2,28318,7081,1,88528312,88528312,10618,3539,7079,3539,0,1,3541,837821,0.837821
4039,2243,541,1213463,2,32318,8081,1,99664312,99664312,12118,4039,8079,4039,0,1,4041,958649,0.958649
4539,2243,541,1213463,2,36318,9081,1,110800312,110800312,13618,4539,9079,4539,0,1,4541,1077972,1.077972
5039,2243,541,1213463,2,40318,10081,1,121936312,121936312,15118,5039,10079,5039,0,1,5041,950507,0.950507
5539,2243,541,1213463,2,44318,11081,1,133072312,133072312,16618,5539,11079,5539,0,1,5541,40535,0.040535
6039,2243,541,1213463,2,48318,12081,1,144208312,144208312,18118,6039,12079,6039,0,1,6041,1432693,1.432693
6539,2243,541,1213463,2,52318,13081,1,155344312,155344312,19618,6539,13079,6539,0,1,6541,1321958,1.321958
7039,2243,541,1213463,2,56318,14081,1,166480312,166480312,21118,7039,14079,7039,0,1,7041,509422,0.509422
44,1153,1055,1216415,2,358,91,1,10508536,10508536,133,44,89,44,0,1,46,7086,0.007086
544,1153,1055,1216415,2,4358,1091,1,19340536,19340536,1633,544,1089,544,0,1,546,3684,0.003684
1044,1153,1055,1216415,2,8358,2091,1,28172536,28172536,3133,1044,2089,1044,0,1,1046,45670,0.04567
1544,1153,1055,1216415,2,12358,3091,1,37004536,37004536,4633,1544,3089,1544,0,1,1546,93736,0.093736
2044,1153,1055,1216415,2,16358,4091,1,45836536,45836536,6133,2044,4089,2044,0,1,2046,141284,0.141284
2544,1153,1055,1216415,2,20358,5091,1,54668536,54668536,7633,2544,5089,2544,0,1,2546,615328,0.615328
3044,1153,1055,1216415,2,24358,6091,1,63500536,63500536,9133,3044,6089,3044,0,1,3046,735906,0.735906
3544,1153,1055,1216415,2,28358,7091,1,72332536,72332536,10633,3544,7089,3544,0,1,3546,454700,0.4547
4044,1153,1055,1216415,2,32358,8091,1,81164536,81164536,12133,4044,8089,4044,0,1,4046,25802,0.025802
4544,1153,1055,1216415,2,36358,9091,1,89996536,89996536,13633,4544,9089,4544,0,1,4546,202163,0.202163
5044,1153,1055,1216415,2,40358,10091,1,98828536,98828536,15133,5044,10089,5044,0,1,5046,269552,0.269552
5544,1153,1055,1216415,2,44358,11091,1,107660536,107660536,16633,5544,11089,5544,0,1,5546,250973,0.250973
6044,1153,1055,1216415,2,48358,12091,1,116492536,116492536,18133,6044,12089,6044,0,1,6046,1051129,1.051129
6544,1153,1055,1216415,2,52358,13091,1,125324536,125324536,19633,6544,13089,6544,0,1,6546,1596925,1.596925
7044,1153,1055,1216415,2,56358,14091,1,134156536,134156536,21133,7044,14089,7044,0,1,7046,204557,0.204557
35,2240,545,1220800,2,286,73,1,10546200,10546200,106,35,71,35,0,1,37,35348,0.035348
535,2240,545,1220800,2,4286,1073,1,21686200,21686200,1606,535,1071,535,0,1,537,130645,0.130645
1035,2240,545,1220800,2,8286,2073,1,32826200,32826200,3106,1035,2071,1035,0,1,1037,250303,0.250303
1535,2240,545,1220800,2,12286,3073,1,43966200,43966200,4606,1535,3071,1535,0,1,1537,362473,0.362473
2035,2240,545,1220800,2,16286,4073,1,55106200,55106200,6106,2035,4071,2035,0,1,2037,485065,0.485065
2535,2240,545,1220800,2,20286,5073,1,66246200,66246200,7606,2535,5071,2535,0,1,2537,595262,0.595262
40,1300,940,1222000,2,326,83,1,10492800,10492800,121,40,81,40,0,1,42,22933,0.022933
440,1300,940,1222000,2,3526,883,1,17660800,17660800,1321,440,881,440,0,1,442,111584,0.111584
840,1300,940,1222000,2,6726,1683,1,24828800,24828800,2521,840,1681,840,0,1,842,204451,0.204451
1240,1300,940,1222000,2,9926,2483,1,31996800,31996800,3721,1240,2481,1240,0,1,1242,300402,0.300402
1640,1300,940,1222000,2,13126,3283,1,39164800,39164800,4921,1640,3281,1640,0,1,1642,403079,0.403079
2040,1300,940,1222000,2,16326,4083,1,46332800,46332800,6121,2040,4081,2040,0,1,2042,3708,0.003708
2440,1300,940,1222000,2,19526,4883,1,53500800,53500800,7321,2440,4881,2440,0,1,2442,102886,0.102886
2840,1300,940,1222000,2,22726,5683,1,60668800,60668800,8521,2840,5681,2840,0,1,2842,145590,0.14559
3240,1300,940,1222000,2,25926,6483,1,67836800,67836800,9721,3240,6481,3240,0,1,3242,787962,0.787962
3640,1300,940,1222000,2,29126,7283,1,75004800,75004800,10921,3640,7281,3640,0,1,3642,882609,0.882609
4040,1300,940,1222000,2,32326,8083,1,82172800,82172800,12121,4040,8081,4040,0,1,4042,6286,0.006286
4440,1300,940,1222000,2,35526,8883,1,89340800,89340800,13321,4440,8881,4440,0,1,4442,522109,0.522109
4840,1300,940,1222000,2,38726,9683,1,96508800,96508800,14521,4840,9681,4840,0,1,4842,1173733,1.173733
5240,1300,940,1222000,2,41926,10483,1,103676800,103676800,15721,5240,10481,5240,0,1,5242,1275138,1.275138
5640,1300,940,1222000,2,45126,11283,1,110844800,110844800,16921,5640,11281,5640,0,1,5642,316755,0.316755
6040,1300,940,1222000,2,48326,12083,1,118012800,118012800,18121,6040,12081,6040,0,1,6042,617113,0.617113
6440,1300,940,1222000,2,51526,12883,1,125180800,125180800,19321,6440,12881,6440,0,1,6442,34671,0.034671
6840,1300,940,1222000,2,54726,13683,1,132348800,132348800,20521,6840,13681,6840,0,1,6842,239179,0.239179
40,800,1540,1232000,2,326,83,1,10604800,10604800,121,40,81,40,0,1,42,22932,0.022932
440,800,1540,1232000,2,3526,883,1,18092800,18092800,1321,440,881,440,0,1,442,113992,0.113992
840,800,1540,1232000,2,6726,1683,1,25580800,25580800,2521,840,1681,840,0,1,842,206158,0.206158
1240,800,1540,1232000,2,9926,2483,1,33068800,33068800,3721,1240,2481,1240,0,1,1242,299367,0.299367
1640,800,1540,1232000,2,13126,3283,1,40556800,40556800,4921,1640,3281,1640,0,1,1642,273776,0.273776
2040,800,1540,1232000,2,16326,4083,1,48044800,48044800,6121,2040,4081,2040,0,1,2042,486797,0.486797
2440,800,1540,1232000,2,19526,4883,1,55532800,55532800,7321,2440,4881,2440,0,1,2442,579193,0.579193
2840,800,1540,1232000,2,22726,5683,1,63020800,63020800,8521,2840,5681,2840,0,1,2842,674557,0.674557
3240,800,1540,1232000,2,25926,6483,1,70508800,70508800,9721,3240,6481,3240,0,1,3242,299545,0.299545
3640,800,1540,1232000,2,29126,7283,1,77996800,77996800,10921,3640,7281,3640,0,1,3642,182463,0.182463
4040,800,1540,1232000,2,32326,8083,1,85484800,85484800,12121,4040,8081,4040,0,1,4042,274566,0.274566
4440,800,1540,1232000,2,35526,8883,1,92972800,92972800,13321,4440,8881,4440,0,1,4442,858062,0.858062
4840,800,1540,1232000,2,38726,9683,1,100460800,100460800,14521,4840,9681,4840,0,1,4842,1145894,1.145894
5240,800,1540,1232000,2,41926,10483,1,107948800,107948800,15721,5240,10481,5240,0,1,5242,31075,0.031075
5640,800,1540,1232000,2,45126,11283,1,115436800,115436800,16921,5640,11281,5640,0,1,5642,33809,0.033809
6040,800,1540,1232000,2,48326,12083,1,122924800,122924800,18121,6040,12081,6040,0,1,6042,996947,0.996947
6440,800,1540,1232000,2,51526,12883,1,130412800,130412800,19321,6440,12881,6440,0,1,6442,380176,0.380176
6840,800,1540,1232000,2,54726,13683,1,137900800,137900800,20521,6840,13681,6840,0,1,6842,23845,0.023845
44,603,2055,1239165,2,358,91,1,10848936,10848936,133,44,89,44,0,1,46,24197,0.024197
544,603,2055,1239165,2,4358,1091,1,21480936,21480936,1633,544,1089,544,0,1,546,85328,0.085328
1044,603,2055,1239165,2,8358,2091,1,32112936,32112936,3133,1044,2089,1044,0,1,1046,155908,0.155908
1544,603,2055,1239165,2,12358,3091,1,42744936,42744936,4633,1544,3089,1544,0,1,1546,201744,0.201744
2044,603,2055,1239165,2,16358,4091,1,53376936,53376936,6133,2044,4089,2044,0,1,2046,369103,0.369103
2544,603,2055,1239165,2,20358,5091,1,64008936,64008936,7633,2544,5089,2544,0,1,2546,278355,0.278355
3044,603,2055,1239165,2,24358,6091,1,74640936,74640936,9133,3044,6089,3044,0,1,3046,157245,0.157245
3544,603,2055,1239165,2,28358,7091,1,85272936,85272936,10633,3544,7089,3544,0,1,3546,93046,0.093046
4044,603,2055,1239165,2,32358,8091,1,95904936,95904936,12133,4044,8089,4044,0,1,4046,115255,0.115255
4544,603,2055,1239165,2,36358,9091,1,106536936,106536936,13633,4544,9089,4544,0,1,4546,500343,0.500343
5044,603,2055,1239165,2,40358,10091,1,117168936,117168936,15133,5044,10089,5044,0,1,5046,1214824,1.214824
5544,603,2055,1239165,2,44358,11091,1,127800936,127800936,16633,5544,11089,5544,0,1,5546,550604,0.550604
6044,603,2055,1239165,2,48358,12091,1,138432936,138432936,18133,6044,12089,6044,0,1,6046,1107890,1.10789
6544,603,2055,1239165,2,52358,13091,1,149064936,149064936,19633,6544,13089,6544,0,1,6546,1574967,1.574967
7044,603,2055,1239165,2,56358,14091,1,159696936,159696936,21133,7044,14089,7044,0,1,7046,300100,0.3001
44,2253,555,1250415,2,358,91,1,10991736,10991736,133,44,89,44,0,1,46,6220,0.00622
544,2253,555,1250415,2,4358,1091,1,22223736,22223736,1633,544,1089,544,0,1,546,8351,0.008351
1044,2253,555,1250415,2,8358,2091,1,33455736,33455736,3133,1044,2089,1044,0,1,1046,13341,0.013341
1544,2253,555,1250415,2,12358,3091,1,44687736,44687736,4633,1544,3089,1544,0,1,1546,126567,0.126567
2044,2253,555,1250415,2,16358,4091,1,55919736,55919736,6133,2044,4089,2044,0,1,2046,57744,0.057744
2544,2253,555,1250415,2,20358,5091,1,67151736,67151736,7633,2544,5089,2544,0,1,2546,254715,0.254715
3044,2253,555,1250415,2,24358,6091,1,78383736,78383736,9133,3044,6089,3044,0,1,3046,733514,0.733514
3544,2253,555,1250415,2,28358,7091,1,89615736,89615736,10633,3544,7089,3544,0,1,3546,618708,0.618708
4044,2253,555,1250415,2,32358,8091,1,100847736,100847736,12133,4044,8089,4044,0,1,4046,971594,0.971594
4544,2253,555,1250415,2,36358,9091,1,112079736,112079736,13633,4544,9089,4544,0,1,4546,956521,0.956521
5044,2253,555,1250415,2,40358,10091,1,123311736,123311736,15133,5044,10089,5044,0,1,5046,1226398,1.226398
5544,2253,555,1250415,2,44358,11091,1,134543736,134543736,16633,5544,11089,5544,0,1,5546,1380613,1.380613
6044,2253,555,1250415,2,48358,12091,1,145775736,145775736,18133,6044,12089,6044,0,1,6046,355603,0.355603
6544,2253,555,1250415,2,52358,13091,1,157007736,157007736,19633,6544,13089,6544,0,1,6546,797347,0.797347
7044,2253,555,1250415,2,56358,14091,1,168239736,168239736,21133,7044,14089,7044,0,1,7046,1220326,1.220326
55,1305,965,1259325,2,446,113,1,11073400,11073400,166,55,111,55,0,1,57,25864,0.025864
455,1305,965,1259325,2,3646,913,1,18337400,18337400,1366,455,911,455,0,1,457,118461,0.118461
855,1305,965,1259325,2,6846,1713,1,25601400,25601400,2566,855,1711,855,0,1,857,91702,0.091702
1255,1305,965,1259325,2,10046,2513,1,32865400,32865400,3766,1255,2511,1255,0,1,1257,317135,0.317135
1655,1305,965,1259325,2,13246,3313,1,40129400,40129400,4966,1655,3311,1655,0,1,1657,418955,0.418955
2055,1305,965,1259325,2,16446,4113,1,47393400,47393400,6166,2055,4111,2055,0,1,2057,515432,0.515432
2455,1305,965,1259325,2,19646,4913,1,54657400,54657400,7366,2455,4911,2455,0,1,2457,35601,0.035601
2855,1305,965,1259325,2,22846,5713,1,61921400,61921400,8566,2855,5711,2855,0,1,2857,414038,0.414038
3255,1305,965,1259325,2,26046,6513,1,69185400,69185400,9766,3255,6511,3255,0,1,3257,718847,0.718847
3655,1305,965,1259325,2,29246,7313,1,76449400,76449400,10966,3655,7311,3655,0,1,3657,916056,0.916056
4055,1305,965,1259325,2,32446,8113,1,83713400,83713400,12166,4055,8111,4055,0,1,4057,1016794,1.016794
4455,1305,965,1259325,2,35646,8913,1,90977400,90977400,13366,4455,8911,4455,0,1,4457,1115175,1.115175
4855,1305,965,1259325,2,38846,9713,1,98241400,98241400,14566,4855,9711,4855,0,1,4857,936680,0.93668
5255,1305,965,1259325,2,42046,10513,1,105505400,105505400,15766,5255,10511,5255,0,1,5257,1318116,1.318116
5655,1305,965,1259325,2,45246,11313,1,112769400,112769400,16966,5655,11311,5655,0,1,5657,233872,0.233872
6055,1305,965,1259325,2,48446,12113,1,120033400,120033400,18166,6055,12111,6055,0,1,6057,262877,0.262877
6455,1305,965,1259325,2,51646,12913,1,127297400,127297400,19366,6455,12911,6455,0,1,6457,142686,0.142686
6855,1305,965,1259325,2,54846,13713,1,134561400,134561400,20566,6855,13711,6855,0,1,6857,1335510,1.33551
55,805,1565,1259825,2,446,113,1,11121400,11121400,166,55,111,55,0,1,57,26840,0.02684
455,805,1565,1259825,2,3646,913,1,18705400,18705400,1366,455,911,455,0,1,457,119901,0.119901
855,805,1565,1259825,2,6846,1713,1,26289400,26289400,2566,855,1711,855,0,1,857,219057,0.219057
1255,805,1565,1259825,2,10046,2513,1,33873400,33873400,3766,1255,2511,1255,0,1,1257,218636,0.218636
1655,805,1565,1259825,2,13246,3313,1,41457400,41457400,4966,1655,3311,1655,0,1,1657,379286,0.379286
2055,805,1565,1259825,2,16446,4113,1,49041400,49041400,6166,2055,4111,2055,0,1,2057,507468,0.507468
2455,805,1565,1259825,2,19646,4913,1,56625400,56625400,7366,2455,4911,2455,0,1,2457,604874,0.604874
2855,805,1565,1259825,2,22846,5713,1,64209400,64209400,8566,2855,5711,2855,0,1,2857,699233,0.699233
3255,805,1565,1259825,2,26046,6513,1,71793400,71793400,9766,3255,6511,3255,0,1,3257,366458,0.366458
3655,805,1565,1259825,2,29246,7313,1,79377400,79377400,10966,3655,7311,3655,0,1,3657,56537,0.056537
4055,805,1565,1259825,2,32446,8113,1,86961400,86961400,12166,4055,8111,4055,0,1,4057,881671,0.881671
4455,805,1565,1259825,2,35646,8913,1,94545400,94545400,13366,4455,8911,4455,0,1,4457,1096896,1.096896
4855,805,1565,1259825,2,38846,9713,1,102129400,102129400,14566,4855,9711,4855,0,1,4857,250682,0.250682
5255,805,1565,1259825,2,42046,10513,1,109713400,109713400,15766,5255,10511,5255,0,1,5257,1283552,1.283552
5655,805,1565,1259825,2,45246,11313,1,117297400,117297400,16966,5655,11311,5655,0,1,5657,703003,0.703003
6055,805,1565,1259825,2,48446,12113,1,124881400,124881400,18166,6055,12111,6055,0,1,6057,1479417,1.479417
6455,805,1565,1259825,2,51646,12913,1,132465400,132465400,19366,6455,12911,6455,0,1,6457,456354,0.456354
6855,805,1565,1259825,2,54846,13713,1,140049400,140049400,20566,6855,13711,6855,0,1,6857,833698,0.833698
40,300,4240,1272000,2,326,83,1,11628800,11628800,121,40,81,40,0,1,42,24408,0.024408
440,300,4240,1272000,2,3526,883,1,26156800,26156800,1321,440,881,440,0,1,442,71120,0.07112
840,300,4240,1272000,2,6726,1683,1,40684800,40684800,2521,840,1681,840,0,1,842,213038,0.213038
1240,300,4240,1272000,2,9926,2483,1,55212800,55212800,3721,1240,2481,1240,0,1,1242,272993,0.272993
1640,300,4240,1272000,2,13126,3283,1,69740800,69740800,4921,1640,3281,1640,0,1,1642,5045,0.005045
2040,300,4240,1272000,2,16326,4083,1,84268800,84268800,6121,2040,4081,2040,0,1,2042,305826,0.305826
2440,300,4240,1272000,2,19526,4883,1,98796800,98796800,7321,2440,4881,2440,0,1,2442,594275,0.594275
2840,300,4240,1272000,2,22726,5683,1,113324800,113324800,8521,2840,5681,2840,0,1,2842,485959,0.485959
3240,300,4240,1272000,2,25926,6483,1,127852800,127852800,9721,3240,6481,3240,0,1,3242,569007,0.569007
3640,300,4240,1272000,2,29126,7283,1,142380800,142380800,10921,3640,7281,3640,0,1,3642,525871,0.525871
4040,300,4240,1272000,2,32326,8083,1,156908800,156908800,12121,4040,8081,4040,0,1,4042,133959,0.133959
4440,300,4240,1272000,2,35526,8883,1,171436800,171436800,13321,4440,8881,4440,0,1,4442,268993,0.268993
4840,300,4240,1272000,2,38726,9683,1,185964800,185964800,14521,4840,9681,4840,0,1,4842,176309,0.176309
5240,300,4240,1272000,2,41926,10483,1,200492800,200492800,15721,5240,10481,5240,0,1,5242,405647,0.405647
5640,300,4240,1272000,2,45126,11283,1,215020800,215020800,16921,5640,11281,5640,0,1,5642,16651,0.016651
6040,300,4240,1272000,2,48326,12083,1,229548800,229548800,18121,6040,12081,6040,0,1,6042,519504,0.519504
6440,300,4240,1272000,2,51526,12883,1,244076800,244076800,19321,6440,12881,6440,0,1,6442,714548,0.714548
6840,300,4240,1272000,2,54726,13683,1,258604800,258604800,20521,6840,13681,6840,0,1,6842,214813,0.214813
40,3800,340,1292000,2,326,83,1,11660800,11660800,121,40,81,40,0,1,42,23815,0.023815
440,3800,340,1292000,2,3526,883,1,24908800,24908800,1321,440,881,440,0,1,442,120232,0.120232
840,3800,340,1292000,2,6726,1683,1,38156800,38156800,2521,840,1681,840,0,1,842,212766,0.212766
1240,3800,340,1292000,2,9926,2483,1,51404800,51404800,3721,1240,2481,1240,0,1,1242,316052,0.316052
1640,3800,340,1292000,2,13126,3283,1,64652800,64652800,4921,1640,3281,1640,0,1,1642,417744,0.417744
2040,3800,340,1292000,2,16326,4083,1,77900800,77900800,6121,2040,4081,2040,0,1,2042,522891,0.522891
2440,3800,340,1292000,2,19526,4883,1,91148800,91148800,7321,2440,4881,2440,0,1,2442,273839,0.273839
2840,3800,340,1292000,2,22726,5683,1,104396800,104396800,8521,2840,5681,2840,0,1,2842,485109,0.485109
3240,3800,340,1292000,2,25926,6483,1,117644800,117644800,9721,3240,6481,3240,0,1,3242,508300,0.5083
3640,3800,340,1292000,2,29126,7283,1,130892800,130892800,10921,3640,7281,3640,0,1,3642,405936,0.405936
4040,3800,340,1292000,2,32326,8083,1,144140800,144140800,12121,4040,8081,4040,0,1,4042,1058765,1.058765
4440,3800,340,1292000,2,35526,8883,1,157388800,157388800,13321,4440,8881,4440,0,1,4442,1148154,1.148154
4840,3800,340,1292000,2,38726,9683,1,170636800,170636800,14521,4840,9681,4840,0,1,4842,224105,0.224105
5240,3800,340,1292000,2,41926,10483,1,183884800,183884800,15721,5240,10481,5240,0,1,5242,594241,0.594241
5640,3800,340,1292000,2,45126,11283,1,197132800,197132800,16921,5640,11281,5640,0,1,5642,1481292,1.481292
6040,3800,340,1292000,2,48326,12083,1,210380800,210380800,18121,6040,12081,6040,0,1,6042,627483,0.627483
6440,3800,340,1292000,2,51526,12883,1,223628800,223628800,19321,6440,12881,6440,0,1,6442,736748,0.736748
6840,3800,340,1292000,2,54726,13683,1,236876800,236876800,20521,6840,13681,6840,0,1,6842,856500,0.8565
55,3555,365,1297575,2,446,113,1,12105400,12105400,166,55,111,55,0,1,57,26503,0.026503
455,3555,365,1297575,2,3646,913,1,24649400,24649400,1366,455,911,455,0,1,457,125297,0.125297
855,3555,365,1297575,2,6846,1713,1,37193400,37193400,2566,855,1711,855,0,1,857,216749,0.216749
1255,3555,365,1297575,2,10046,2513,1,49737400,49737400,3766,1255,2511,1255,0,1,1257,319457,0.319457
1655,3555,365,1297575,2,13246,3313,1,62281400,62281400,4966,1655,3311,1655,0,1,1657,426238,0.426238
2055,3555,365,1297575,2,16446,4113,1,74825400,74825400,6166,2055,4111,2055,0,1,2057,530736,0.530736
2455,3555,365,1297575,2,19646,4913,1,87369400,87369400,7366,2455,4911,2455,0,1,2457,423651,0.423651
2855,3555,365,1297575,2,22846,5713,1,99913400,99913400,8566,2855,5711,2855,0,1,2857,746267,0.746267
3255,3555,365,1297575,2,26046,6513,1,112457400,112457400,9766,3255,6511,3255,0,1,3257,843475,0.843475
3655,3555,365,1297575,2,29246,7313,1,125001400,125001400,10966,3655,7311,3655,0,1,3657,960214,0.960214
4055,3555,365,1297575,2,32446,8113,1,137545400,137545400,12166,4055,8111,4055,0,1,4057,1059525,1.059525
4455,3555,365,1297575,2,35646,8913,1,150089400,150089400,13366,4455,8911,4455,0,1,4457,170356,0.170356
4855,3555,365,1297575,2,38846,9713,1,162633400,162633400,14566,4855,9711,4855,0,1,4857,1270310,1.27031
5255,3555,365,1297575,2,42046,10513,1,175177400,175177400,15766,5255,10511,5255,0,1,5257,53543,0.053543
5655,3555,365,1297575,2,45246,11313,1,187721400,187721400,16966,5655,11311,5655,0,1,5657,1477988,1.477988
6055,3555,365,1297575,2,48446,12113,1,200265400,200265400,18166,6055,12111,6055,0,1,6057,1333635,1.333635
6455,3555,365,1297575,2,51646,12913,1,212809400,212809400,19366,6455,12911,6455,0,1,6457,1691567,1.691567
6855,3555,365,1297575,2,54846,13713,1,225353400,225353400,20566,6855,13711,6855,0,1,6857,1809258,1.809258
55,305,4265,1300825,2,446,113,1,12417400,12417400,166,55,111,55,0,1,57,29033,0.029033
455,305,4265,1300825,2,3646,913,1,27041400,27041400,1366,455,911,455,0,1,457,127417,0.127417
855,305,4265,1300825,2,6846,1713,1,41665400,41665400,2566,855,1711,855,0,1,857,91802,0.091802
1255,305,4265,1300825,2,10046,2513,1,56289400,56289400,3766,1255,2511,1255,0,1,1257,136799,0.136799
1655,305,4265,1300825,2,13246,3313,1,70913400,70913400,4966,1655,3311,1655,0,1,1657,430170,0.43017
2055,305,4265,1300825,2,16446,4113,1,85537400,85537400,6166,2055,4111,2055,0,1,2057,154221,0.154221
2455,305,4265,1300825,2,19646,4913,1,100161400,100161400,7366,2455,4911,2455,0,1,2457,634217,0.634217
2855,305,4265,1300825,2,22846,5713,1,114785400,114785400,8566,2855,5711,2855,0,1,2857,32692,0.032692
3255,305,4265,1300825,2,26046,6513,1,129409400,129409400,9766,3255,6511,3255,0,1,3257,74037,0.074037
3655,305,4265,1300825,2,29246,7313,1,144033400,144033400,10966,3655,7311,3655,0,1,3657,940348,0.940348
4055,305,4265,1300825,2,32446,8113,1,158657400,158657400,12166,4055,8111,4055,0,1,4057,618035,0.618035
4455,305,4265,1300825,2,35646,8913,1,173281400,173281400,13366,4455,8911,4455,0,1,4457,288592,0.288592
4855,305,4265,1300825,2,38846,9713,1,187905400,187905400,14566,4855,9711,4855,0,1,4857,153803,0.153803
5255,305,4265,1300825,2,42046,10513,1,202529400,202529400,15766,5255,10511,5255,0,1,5257,404178,0.404178
5655,305,4265,1300825,2,45246,11313,1,217153400,217153400,16966,5655,11311,5655,0,1,5657,526488,0.526488
6055,305,4265,1300825,2,48446,12113,1,231777400,231777400,18166,6055,12111,6055,0,1,6057,554978,0.554978
6455,305,4265,1300825,2,51646,12913,1,246401400,246401400,19366,6455,12911,6455,0,1,6457,674803,0.674803
6855,305,4265,1300825,2,54846,13713,1,261025400,261025400,20566,6855,13711,6855,0,1,6857,202823,0.202823
40,1050,1240,1302000,2,326,83,1,11148800,11148800,121,40,81,40,0,1,42,4529,0.004529
440,1050,1240,1302000,2,3526,883,1,18476800,18476800,1321,440,881,440,0,1,442,11205,0.011205
840,1050,1240,1302000,2,6726,1683,1,25804800,25804800,2521,840,1681,840,0,1,842,39223,0.039223
1240,1050,1240,1302000,2,9926,2483,1,33132800,33132800,3721,1240,2481,1240,0,1,1242,58240,0.05824
1640,1050,1240,1302000,2,13126,3283,1,40460800,40460800,4921,1640,3281,1640,0,1,1642,99391,0.099391
2040,1050,1240,1302000,2,16326,4083,1,47788800,47788800,6121,2040,4081,2040,0,1,2042,51635,0.051635
2440,1050,1240,1302000,2,19526,4883,1,55116800,55116800,7321,2440,4881,2440,0,1,2442,13890,0.01389
2840,1050,1240,1302000,2,22726,5683,1,62444800,62444800,8521,2840,5681,2840,0,1,2842,11800,0.0118
3240,1050,1240,1302000,2,25926,6483,1,69772800,69772800,9721,3240,6481,3240,0,1,3242,367416,0.367416
3640,1050,1240,1302000,2,29126,7283,1,77100800,77100800,10921,3640,7281,3640,0,1,3642,59148,0.059148
4040,1050,1240,1302000,2,32326,8083,1,84428800,84428800,12121,4040,8081,4040,0,1,4042,75334,0.075334
4440,1050,1240,1302000,2,35526,8883,1,91756800,91756800,13321,4440,8881,4440,0,1,4442,84184,0.084184
4840,1050,1240,1302000,2,38726,9683,1,99084800,99084800,14521,4840,9681,4840,0,1,4842,128023,0.128023
5240,1050,1240,1302000,2,41926,10483,1,106412800,106412800,15721,5240,10481,5240,0,1,5242,823201,0.823201
5640,1050,1240,1302000,2,45126,11283,1,113740800,113740800,16921,5640,11281,5640,0,1,5642,84864,0.084864
6040,1050,1240,1302000,2,48326,12083,1,121068800,121068800,18121,6040,12081,6040,0,1,6042,768667,0.768667
6440,1050,1240,1302000,2,51526,12883,1,128396800,128396800,19321,6440,12881,6440,0,1,6442,28018,0.028018
6840,1050,1240,1302000,2,54726,13683,1,135724800,135724800,20521,6840,13681,6840,0,1,6842,470075,0.470075
40,2050,640,1312000,2,326,83,1,11356800,11356800,121,40,81,40,0,1,42,1826,0.001826
440,2050,640,1312000,2,3526,883,1,19964800,19964800,1321,440,881,440,0,1,442,20409,0.020409
840,2050,640,1312000,2,6726,1683,1,28572800,28572800,2521,840,1681,840,0,1,842,52836,0.052836
1240,2050,640,1312000,2,9926,2483,1,37180800,37180800,3721,1240,2481,1240,0,1,1242,5077,0.005077
1640,2050,640,1312000,2,13126,3283,1,45788800,45788800,4921,1640,3281,1640,0,1,1642,13267,0.013267
2040,2050,640,1312000,2,16326,4083,1,54396800,54396800,6121,2040,4081,2040,0,1,2042,79908,0.079908
2440,2050,640,1312000,2,19526,4883,1,63004800,63004800,7321,2440,4881,2440,0,1,2442,425749,0.425749
2840,2050,640,1312000,2,22726,5683,1,71612800,71612800,8521,2840,5681,2840,0,1,2842,160048,0.160048
3240,2050,640,1312000,2,25926,6483,1,80220800,80220800,9721,3240,6481,3240,0,1,3242,129337,0.129337
3640,2050,640,1312000,2,29126,7283,1,88828800,88828800,10921,3640,7281,3640,0,1,3642,23396,0.023396
4040,2050,640,1312000,2,32326,8083,1,97436800,97436800,12121,4040,8081,4040,0,1,4042,70334,0.070334
4440,2050,640,1312000,2,35526,8883,1,106044800,106044800,13321,4440,8881,4440,0,1,4442,389480,0.38948
4840,2050,640,1312000,2,38726,9683,1,114652800,114652800,14521,4840,9681,4840,0,1,4842,359804,0.359804
5240,2050,640,1312000,2,41926,10483,1,123260800,123260800,15721,5240,10481,5240,0,1,5242,272562,0.272562
5640,2050,640,1312000,2,45126,11283,1,131868800,131868800,16921,5640,11281,5640,0,1,5642,311148,0.311148
6040,2050,640,1312000,2,48326,12083,1,140476800,140476800,18121,6040,12081,6040,0,1,6042,314017,0.314017
6440,2050,640,1312000,2,51526,12883,1,149084800,149084800,19321,6440,12881,6440,0,1,6442,1269515,1.269515
6840,2050,640,1312000,2,54726,13683,1,157692800,157692800,20521,6840,13681,6840,0,1,6842,597295,0.597295
55,1055,1265,1334575,2,446,113,1,11697400,11697400,166,55,111,55,0,1,57,5329,0.005329
455,1055,1265,1334575,2,3646,913,1,19121400,19121400,1366,455,911,455,0,1,457,7160,0.00716
855,1055,1265,1334575,2,6846,1713,1,26545400,26545400,2566,855,1711,855,0,1,857,14780,0.01478
1255,1055,1265,1334575,2,10046,2513,1,33969400,33969400,3766,1255,2511,1255,0,1,1257,37141,0.037141
1655,1055,1265,1334575,2,13246,3313,1,41393400,41393400,4966,1655,3311,1655,0,1,1657,9124,0.009124
2055,1055,1265,1334575,2,16446,4113,1,48817400,48817400,6166,2055,4111,2055,0,1,2057,35386,0.035386
2455,1055,1265,1334575,2,19646,4913,1,56241400,56241400,7366,2455,4911,2455,0,1,2457,39289,0.039289
2855,1055,1265,1334575,2,22846,5713,1,63665400,63665400,8566,2855,5711,2855,0,1,2857,207737,0.207737
3255,1055,1265,1334575,2,26046,6513,1,71089400,71089400,9766,3255,6511,3255,0,1,3257,156985,0.156985
3655,1055,1265,1334575,2,29246,7313,1,78513400,78513400,10966,3655,7311,3655,0,1,3657,168429,0.168429
4055,1055,1265,1334575,2,32446,8113,1,85937400,85937400,12166,4055,8111,4055,0,1,4057,339983,0.339983
4455,1055,1265,1334575,2,35646,8913,1,93361400,93361400,13366,4455,8911,4455,0,1,4457,334437,0.334437
4855,1055,1265,1334575,2,38846,9713,1,100785400,100785400,14566,4855,9711,4855,0,1,4857,837435,0.837435
5255,1055,1265,1334575,2,42046,10513,1,108209400,108209400,15766,5255,10511,5255,0,1,5257,188173,0.188173
5655,1055,1265,1334575,2,45246,11313,1,115633400,115633400,16966,5655,11311,5655,0,1,5657,1495605,1.495605
6055,1055,1265,1334575,2,48446,12113,1,123057400,123057400,18166,6055,12111,6055,0,1,6057,459570,0.45957
6455,1055,1265,1334575,2,51646,12913,1,130481400,130481400,19366,6455,12911,6455,0,1,6457,1690347,1.690347
6855,1055,1265,1334575,2,54846,13713,1,137905400,137905400,20566,6855,13711,6855,0,1,6857,627202,0.627202
40,550,2440,1342000,2,326,83,1,11692800,11692800,121,40,81,40,0,1,42,25162,0.025162
440,550,2440,1342000,2,3526,883,1,21260800,21260800,1321,440,881,440,0,1,442,124144,0.124144
840,550,2440,1342000,2,6726,1683,1,30828800,30828800,2521,840,1681,840,0,1,842,227737,0.227737
1240,550,2440,1342000,2,9926,2483,1,40396800,40396800,3721,1240,2481,1240,0,1,1242,324444,0.324444
1640,550,2440,1342000,2,13126,3283,1,49964800,49964800,4921,1640,3281,1640,0,1,1642,430826,0.430826
2040,550,2440,1342000,2,16326,4083,1,59532800,59532800,6121,2040,4081,2040,0,1,2042,525618,0.525618
2440,550,2440,1342000,2,19526,4883,1,69100800,69100800,7321,2440,4881,2440,0,1,2442,522929,0.522929
2840,550,2440,1342000,2,22726,5683,1,78668800,78668800,8521,2840,5681,2840,0,1,2842,730785,0.730785
3240,550,2440,1342000,2,25926,6483,1,88236800,88236800,9721,3240,6481,3240,0,1,3242,833088,0.833088
3640,550,2440,1342000,2,29126,7283,1,97804800,97804800,10921,3640,7281,3640,0,1,3642,644522,0.644522
4040,550,2440,1342000,2,32326,8083,1,107372800,107372800,12121,4040,8081,4040,0,1,4042,653572,0.653572
4440,550,2440,1342000,2,35526,8883,1,116940800,116940800,13321,4440,8881,4440,0,1,4442,622495,0.622495
4840,550,2440,1342000,2,38726,9683,1,126508800,126508800,14521,4840,9681,4840,0,1,4842,1220626,1.220626
5240,550,2440,1342000,2,41926,10483,1,136076800,136076800,15721,5240,10481,5240,0,1,5242,1320533,1.320533
5640,550,2440,1342000,2,45126,11283,1,145644800,145644800,16921,5640,11281,5640,0,1,5642,1444317,1.444317
6040,550,2440,1342000,2,48326,12083,1,155212800,155212800,18121,6040,12081,6040,0,1,6042,239175,0.239175
6440,550,2440,1342000,2,51526,12883,1,164780800,164780800,19321,6440,12881,6440,0,1,6442,1648263,1.648263
6840,550,2440,1342000,2,54726,13683,1,174348800,174348800,20521,6840,13681,6840,0,1,6842,479185,0.479185
40,300,4540,1362000,2,326,83,1,12444800,12444800,121,40,81,40,0,1,42,26484,0.026484
440,300,4540,1362000,2,3526,883,1,27932800,27932800,1321,440,881,440,0,1,442,69944,0.069944
840,300,4540,1362000,2,6726,1683,1,43420800,43420800,2521,840,1681,840,0,1,842,236930,0.23693
1240,300,4540,1362000,2,9926,2483,1,58908800,58908800,3721,1240,2481,1240,0,1,1242,9127,0.009127
1640,300,4540,1362000,2,13126,3283,1,74396800,74396800,4921,1640,3281,1640,0,1,1642,106524,0.106524
2040,300,4540,1362000,2,16326,4083,1,89884800,89884800,6121,2040,4081,2040,0,1,2042,256016,0.256016
2440,300,4540,1362000,2,19526,4883,1,105372800,105372800,7321,2440,4881,2440,0,1,2442,357614,0.357614
2840,300,4540,1362000,2,22726,5683,1,120860800,120860800,8521,2840,5681,2840,0,1,2842,545084,0.545084
3240,300,4540,1362000,2,25926,6483,1,136348800,136348800,9721,3240,6481,3240,0,1,3242,865576,0.865576
3640,300,4540,1362000,2,29126,7283,1,151836800,151836800,10921,3640,7281,3640,0,1,3642,240220,0.24022
4040,300,4540,1362000,2,32326,8083,1,167324800,167324800,12121,4040,8081,4040,0,1,4042,1077166,1.077166
4440,300,4540,1362000,2,35526,8883,1,182812800,182812800,13321,4440,8881,4440,0,1,4442,599186,0.599186
4840,300,4540,1362000,2,38726,9683,1,198300800,198300800,14521,4840,9681,4840,0,1,4842,750523,0.750523
5240,300,4540,1362000,2,41926,10483,1,213788800,213788800,15721,5240,10481,5240,0,1,5242,38753,0.038753
5640,300,4540,1362000,2,45126,11283,1,229276800,229276800,16921,5640,11281,5640,0,1,5642,287488,0.287488
6040,300,4540,1362000,2,48326,12083,1,244764800,244764800,18121,6040,12081,6040,0,1,6042,40715,0.040715
6440,300,4540,1362000,2,51526,12883,1,260252800,260252800,19321,6440,12881,6440,0,1,6442,449458,0.449458
6840,300,4540,1362000,2,54726,13683,1,275740800,275740800,20521,6840,13681,6840,0,1,6842,1822501,1.822501
55,2055,665,1366575,2,446,113,1,12129400,12129400,166,55,111,55,0,1,57,3638,0.003638
455,2055,665,1366575,2,3646,913,1,20833400,20833400,1366,455,911,455,0,1,457,36717,0.036717
855,2055,665,1366575,2,6846,1713,1,29537400,29537400,2566,855,1711,855,0,1,857,55478,0.055478
1255,2055,665,1366575,2,10046,2513,1,38241400,38241400,3766,1255,2511,1255,0,1,1257,96460,0.09646
1655,2055,665,1366575,2,13246,3313,1,46945400,46945400,4966,1655,3311,1655,0,1,1657,179787,0.179787
2055,2055,665,1366575,2,16446,4113,1,55649400,55649400,6166,2055,4111,2055,0,1,2057,56239,0.056239
2455,2055,665,1366575,2,19646,4913,1,64353400,64353400,7366,2455,4911,2455,0,1,2457,76394,0.076394
2855,2055,665,1366575,2,22846,5713,1,73057400,73057400,8566,2855,5711,2855,0,1,2857,52081,0.052081
3255,2055,665,1366575,2,26046,6513,1,81761400,81761400,9766,3255,6511,3255,0,1,3257,23187,0.023187
3655,2055,665,1366575,2,29246,7313,1,90465400,90465400,10966,3655,7311,3655,0,1,3657,230480,0.23048
4055,2055,665,1366575,2,32446,8113,1,99169400,99169400,12166,4055,8111,4055,0,1,4057,294008,0.294008
4455,2055,665,1366575,2,35646,8913,1,107873400,107873400,13366,4455,8911,4455,0,1,4457,90516,0.090516
4855,2055,665,1366575,2,38846,9713,1,116577400,116577400,14566,4855,9711,4855,0,1,4857,1274846,1.274846
5255,2055,665,1366575,2,42046,10513,1,125281400,125281400,15766,5255,10511,5255,0,1,5257,103807,0.103807
5655,2055,665,1366575,2,45246,11313,1,133985400,133985400,16966,5655,11311,5655,0,1,5657,21298,0.021298
6055,2055,665,1366575,2,48446,12113,1,142689400,142689400,18166,6055,12111,6055,0,1,6057,727385,0.727385
6455,2055,665,1366575,2,51646,12913,1,151393400,151393400,19366,6455,12911,6455,0,1,6457,1477345,1.477345
6855,2055,665,1366575,2,54846,13713,1,160097400,160097400,20566,6855,13711,6855,0,1,6857,1015551,1.015551
55,555,2465,1368075,2,446,113,1,12273400,12273400,166,55,111,55,0,1,57,29514,0.029514
455,555,2465,1368075,2,3646,913,1,21937400,21937400,1366,455,911,455,0,1,457,131251,0.131251
855,555,2465,1368075,2,6846,1713,1,31601400,31601400,2566,855,1711,855,0,1,857,235336,0.235336
1255,555,2465,1368075,2,10046,2513,1,41265400,41265400,3766,1255,2511,1255,0,1,1257,340856,0.340856
1655,555,2465,1368075,2,13246,3313,1,50929400,50929400,4966,1655,3311,1655,0,1,1657,446160,0.44616
2055,555,2465,1368075,2,16446,4113,1,60593400,60593400,6166,2055,4111,2055,0,1,2057,552831,0.552831
2455,555,2465,1368075,2,19646,4913,1,70257400,70257400,7366,2455,4911,2455,0,1,2457,509655,0.509655
2855,555,2465,1368075,2,22846,5713,1,79921400,79921400,8566,2855,5711,2855,0,1,2857,389958,0.389958
3255,555,2465,1368075,2,26046,6513,1,89585400,89585400,9766,3255,6511,3255,0,1,3257,429619,0.429619
3655,555,2465,1368075,2,29246,7313,1,99249400,99249400,10966,3655,7311,3655,0,1,3657,311554,0.311554
4055,555,2465,1368075,2,32446,8113,1,108913400,108913400,12166,4055,8111,4055,0,1,4057,597456,0.597456
4455,555,2465,1368075,2,35646,8913,1,118577400,118577400,13366,4455,8911,4455,0,1,4457,35882,0.035882
4855,555,2465,1368075,2,38846,9713,1,128241400,128241400,14566,4855,9711,4855,0,1,4857,1176627,1.176627
5255,555,2465,1368075,2,42046,10513,1,137905400,137905400,15766,5255,10511,5255,0,1,5257,1299013,1.299013
5655,555,2465,1368075,2,45246,11313,1,147569400,147569400,16966,5655,11311,5655,0,1,5657,647757,0.647757
6055,555,2465,1368075,2,48446,12113,1,157233400,157233400,18166,6055,12111,6055,0,1,6057,11419,0.011419
6455,555,2465,1368075,2,51646,12913,1,166897400,166897400,19366,6455,12911,6455,0,1,6457,1398519,1.398519
6855,555,2465,1368075,2,54846,13713,1,176561400,176561400,20566,6855,13711,6855,0,1,6857,1064781,1.064781
40,4050,340,1377000,2,326,83,1,12420800,12420800,121,40,81,40,0,1,42,3557,0.003557
440,4050,340,1377000,2,3526,883,1,26468800,26468800,1321,440,881,440,0,1,442,17176,0.017176
840,4050,340,1377000,2,6726,1683,1,40516800,40516800,2521,840,1681,840,0,1,842,170884,0.170884
1240,4050,340,1377000,2,9926,2483,1,54564800,54564800,3721,1240,2481,1240,0,1,1242,76396,0.076396
1640,4050,340,1377000,2,13126,3283,1,68612800,68612800,4921,1640,3281,1640,0,1,1642,435810,0.43581
2040,4050,340,1377000,2,16326,4083,1,82660800,82660800,6121,2040,4081,2040,0,1,2042,173344,0.173344
2440,4050,340,1377000,2,19526,4883,1,96708800,96708800,7321,2440,4881,2440,0,1,2442,647366,0.647366
2840,4050,340,1377000,2,22726,5683,1,110756800,110756800,8521,2840,5681,2840,0,1,2842,426947,0.426947
3240,4050,340,1377000,2,25926,6483,1,124804800,124804800,9721,3240,6481,3240,0,1,3242,467597,0.467597
3640,4050,340,1377000,2,29126,7283,1,138852800,138852800,10921,3640,7281,3640,0,1,3642,267193,0.267193
4040,4050,340,1377000,2,32326,8083,1,152900800,152900800,12121,4040,8081,4040,0,1,4042,544640,0.54464
4440,4050,340,1377000,2,35526,8883,1,166948800,166948800,13321,4440,8881,4440,0,1,4442,14537,0.014537
4840,4050,340,1377000,2,38726,9683,1,180996800,180996800,14521,4840,9681,4840,0,1,4842,307732,0.307732
5240,4050,340,1377000,2,41926,10483,1,195044800,195044800,15721,5240,10481,5240,0,1,5242,474608,0.474608
5640,4050,340,1377000,2,45126,11283,1,209092800,209092800,16921,5640,11281,5640,0,1,5642,1530100,1.5301
6040,4050,340,1377000,2,48326,12083,1,223140800,223140800,18121,6040,12081,6040,0,1,6042,497184,0.497184
6440,4050,340,1377000,2,51526,12883,1,237188800,237188800,19321,6440,12881,6440,0,1,6442,344380,0.34438
6840,4050,340,1377000,2,54726,13683,1,251236800,251236800,20521,6840,13681,6840,0,1,6842,1856616,1.856616
55,3805,365,1388825,2,446,113,1,12945400,12945400,166,55,111,55,0,1,57,29470,0.02947
455,3805,365,1388825,2,3646,913,1,26289400,26289400,1366,455,911,455,0,1,457,132249,0.132249
855,3805,365,1388825,2,6846,1713,1,39633400,39633400,2566,855,1711,855,0,1,857,232620,0.23262
1255,3805,365,1388825,2,10046,2513,1,52977400,52977400,3766,1255,2511,1255,0,1,1257,351214,0.351214
1655,3805,365,1388825,2,13246,3313,1,66321400,66321400,4966,1655,3311,1655,0,1,1657,457742,0.457742
2055,3805,365,1388825,2,16446,4113,1,79665400,79665400,6166,2055,4111,2055,0,1,2057,571540,0.57154
2455,3805,365,1388825,2,19646,4913,1,93009400,93009400,7366,2455,4911,2455,0,1,2457,682829,0.682829
2855,3805,365,1388825,2,22846,5713,1,106353400,106353400,8566,2855,5711,2855,0,1,2857,795117,0.795117
3255,3805,365,1388825,2,26046,6513,1,119697400,119697400,9766,3255,6511,3255,0,1,3257,308118,0.308118
3655,3805,365,1388825,2,29246,7313,1,133041400,133041400,10966,3655,7311,3655,0,1,3657,1031399,1.031399
4055,3805,365,1388825,2,32446,8113,1,146385400,146385400,12166,4055,8111,4055,0,1,4057,1136766,1.136766
4455,3805,365,1388825,2,35646,8913,1,159729400,159729400,13366,4455,8911,4455,0,1,4457,1244117,1.244117
4855,3805,365,1388825,2,38846,9713,1,173073400,173073400,14566,4855,9711,4855,0,1,4857,1356288,1.356288
5255,3805,365,1388825,2,42046,10513,1,186417400,186417400,15766,5255,10511,5255,0,1,5257,834788,0.834788
5655,3805,365,1388825,2,45246,11313,1,199761400,199761400,16966,5655,11311,5655,0,1,5657,1582285,1.582285
6055,3805,365,1388825,2,48446,12113,1,213105400,213105400,18166,6055,12111,6055,0,1,6057,109032,0.109032
6455,3805,365,1388825,2,51646,12913,1,226449400,226449400,19366,6455,12911,6455,0,1,6457,1806114,1.806114
6855,3805,365,1388825,2,54846,13713,1,239793400,239793400,20566,6855,13711,6855,0,1,6857,9442,0.009442
55,305,4565,1392325,2,446,113,1,13281400,13281400,166,55,111,55,0,1,57,30870,0.03087
455,305,4565,1392325,2,3646,913,1,28865400,28865400,1366,455,911,455,0,1,457,11891,0.011891
855,305,4565,1392325,2,6846,1713,1,44449400,44449400,2566,855,1711,855,0,1,857,242572,0.242572
1255,305,4565,1392325,2,10046,2513,1,60033400,60033400,3766,1255,2511,1255,0,1,1257,262305,0.262305
1655,305,4565,1392325,2,13246,3313,1,75617400,75617400,4966,1655,3311,1655,0,1,1657,460053,0.460053
2055,305,4565,1392325,2,16446,4113,1,91201400,91201400,6166,2055,4111,2055,0,1,2057,571801,0.571801
2455,305,4565,1392325,2,19646,4913,1,106785400,106785400,7366,2455,4911,2455,0,1,2457,226161,0.226161
2855,305,4565,1392325,2,22846,5713,1,122369400,122369400,8566,2855,5711,2855,0,1,2857,46831,0.046831
3255,305,4565,1392325,2,26046,6513,1,137953400,137953400,9766,3255,6511,3255,0,1,3257,189896,0.189896
3655,305,4565,1392325,2,29246,7313,1,153537400,153537400,10966,3655,7311,3655,0,1,3657,397353,0.397353
4055,305,4565,1392325,2,32446,8113,1,169121400,169121400,12166,4055,8111,4055,0,1,4057,315322,0.315322
4455,305,4565,1392325,2,35646,8913,1,184705400,184705400,13366,4455,8911,4455,0,1,4457,471731,0.471731
4855,305,4565,1392325,2,38846,9713,1,200289400,200289400,14566,4855,9711,4855,0,1,4857,404327,0.404327
5255,305,4565,1392325,2,42046,10513,1,215873400,215873400,15766,5255,10511,5255,0,1,5257,640388,0.640388
5655,305,4565,1392325,2,45246,11313,1,231457400,231457400,16966,5655,11311,5655,0,1,5657,17995,0.017995
6055,305,4565,1392325,2,48446,12113,1,247041400,247041400,18166,6055,12111,6055,0,1,6057,368924,0.368924
6455,305,4565,1392325,2,51646,12913,1,262625400,262625400,19366,6455,12911,6455,0,1,6457,861856,0.861856
6855,305,4565,1392325,2,54846,13713,1,278209400,278209400,20566,6855,13711,6855,0,1,6857,1319753,1.319753
40,300,4840,1452000,2,326,83,1,13260800,13260800,121,40,81,40,0,1,42,27962,0.027962
440,300,4840,1452000,2,3526,883,1,29708800,29708800,1321,440,881,440,0,1,442,16532,0.016532
840,300,4840,1452000,2,6726,1683,1,46156800,46156800,2521,840,1681,840,0,1,842,15492,0.015492
1240,300,4840,1452000,2,9926,2483,1,62604800,62604800,3721,1240,2481,1240,0,1,1242,100603,0.100603
1640,300,4840,1452000,2,13126,3283,1,79052800,79052800,4921,1640,3281,1640,0,1,1642,468297,0.468297
2040,300,4840,1452000,2,16326,4083,1,95500800,95500800,6121,2040,4081,2040,0,1,2042,313081,0.313081
2440,300,4840,1452000,2,19526,4883,1,111948800,111948800,7321,2440,4881,2440,0,1,2442,258681,0.258681
2840,300,4840,1452000,2,22726,5683,1,128396800,128396800,8521,2840,5681,2840,0,1,2842,130982,0.130982
3240,300,4840,1452000,2,25926,6483,1,144844800,144844800,9721,3240,6481,3240,0,1,3242,282535,0.282535
3640,300,4840,1452000,2,29126,7283,1,161292800,161292800,10921,3640,7281,3640,0,1,3642,91181,0.091181
4040,300,4840,1452000,2,32326,8083,1,177740800,177740800,12121,4040,8081,4040,0,1,4042,535152,0.535152
4440,300,4840,1452000,2,35526,8883,1,194188800,194188800,13321,4440,8881,4440,0,1,4442,175873,0.175873
4840,300,4840,1452000,2,38726,9683,1,210636800,210636800,14521,4840,9681,4840,0,1,4842,144238,0.144238
5240,300,4840,1452000,2,41926,10483,1,227084800,227084800,15721,5240,10481,5240,0,1,5242,233399,0.233399
5640,300,4840,1452000,2,45126,11283,1,243532800,243532800,16921,5640,11281,5640,0,1,5642,22018,0.022018
6040,300,4840,1452000,2,48326,12083,1,259980800,259980800,18121,6040,12081,6040,0,1,6042,742361,0.742361
6440,300,4840,1452000,2,51526,12883,1,276428800,276428800,19321,6440,12881,6440,0,1,6442,953451,0.953451
6840,300,4840,1452000,2,54726,13683,1,292876800,292876800,20521,6840,13681,6840,0,1,6842,956978,0.956978
40,1550,940,1457000,2,326,83,1,12452800,12452800,121,40,81,40,0,1,42,27843,0.027843
440,1550,940,1457000,2,3526,883,1,20420800,20420800,1321,440,881,440,0,1,442,133622,0.133622
840,1550,940,1457000,2,6726,1683,1,28388800,28388800,2521,840,1681,840,0,1,842,245271,0.245271
1240,1550,940,1457000,2,9926,2483,1,36356800,36356800,3721,1240,2481,1240,0,1,1242,361339,0.361339
1640,1550,940,1457000,2,13126,3283,1,44324800,44324800,4921,1640,3281,1640,0,1,1642,236212,0.236212
2040,1550,940,1457000,2,16326,4083,1,52292800,52292800,6121,2040,4081,2040,0,1,2042,592739,0.592739
2440,1550,940,1457000,2,19526,4883,1,60260800,60260800,7321,2440,4881,2440,0,1,2442,700869,0.700869
2840,1550,940,1457000,2,22726,5683,1,68228800,68228800,8521,2840,5681,2840,0,1,2842,814453,0.814453
3240,1550,940,1457000,2,25926,6483,1,76196800,76196800,9721,3240,6481,3240,0,1,3242,929636,0.929636
3640,1550,940,1457000,2,29126,7283,1,84164800,84164800,10921,3640,7281,3640,0,1,3642,1046878,1.046878
4040,1550,940,1457000,2,32326,8083,1,92132800,92132800,12121,4040,8081,4040,0,1,4042,865221,0.865221
4440,1550,940,1457000,2,35526,8883,1,100100800,100100800,13321,4440,8881,4440,0,1,4442,1273114,1.273114
4840,1550,940,1457000,2,38726,9683,1,108068800,108068800,14521,4840,9681,4840,0,1,4842,700468,0.700468
5240,1550,940,1457000,2,41926,10483,1,116036800,116036800,15721,5240,10481,5240,0,1,5242,527010,0.52701
5640,1550,940,1457000,2,45126,11283,1,124004800,124004800,16921,5640,11281,5640,0,1,5642,1156997,1.156997
6040,1550,940,1457000,2,48326,12083,1,131972800,131972800,18121,6040,12081,6040,0,1,6042,740963,0.740963
6440,1550,940,1457000,2,51526,12883,1,139940800,139940800,19321,6440,12881,6440,0,1,6442,1857084,1.857084
6840,1550,940,1457000,2,54726,13683,1,147908800,147908800,20521,6840,13681,6840,0,1,6842,474918,0.474918
40,4300,340,1462000,2,326,83,1,13180800,13180800,121,40,81,40,0,1,42,27245,0.027245
440,4300,340,1462000,2,3526,883,1,28028800,28028800,1321,440,881,440,0,1,442,132740,0.13274
840,4300,340,1462000,2,6726,1683,1,42876800,42876800,2521,840,1681,840,0,1,842,240640,0.24064
1240,4300,340,1462000,2,9926,2483,1,57724800,57724800,3721,1240,2481,1240,0,1,1242,352693,0.352693
1640,4300,340,1462000,2,13126,3283,1,72572800,72572800,4921,1640,3281,1640,0,1,1642,465096,0.465096
2040,4300,340,1462000,2,16326,4083,1,87420800,87420800,6121,2040,4081,2040,0,1,2042,405951,0.405951
2440,4300,340,1462000,2,19526,4883,1,102268800,102268800,7321,2440,4881,2440,0,1,2442,698318,0.698318
2840,4300,340,1462000,2,22726,5683,1,117116800,117116800,8521,2840,5681,2840,0,1,2842,473795,0.473795
3240,4300,340,1462000,2,25926,6483,1,131964800,131964800,9721,3240,6481,3240,0,1,3242,915310,0.91531
3640,4300,340,1462000,2,29126,7283,1,146812800,146812800,10921,3640,7281,3640,0,1,3642,356964,0.356964
4040,4300,340,1462000,2,32326,8083,1,161660800,161660800,12121,4040,8081,4040,0,1,4042,925859,0.925859
4440,4300,340,1462000,2,35526,8883,1,176508800,176508800,13321,4440,8881,4440,0,1,4442,130639,0.130639
4840,4300,340,1462000,2,38726,9683,1,191356800,191356800,14521,4840,9681,4840,0,1,4842,264814,0.264814
5240,4300,340,1462000,2,41926,10483,1,206204800,206204800,15721,5240,10481,5240,0,1,5242,1484889,1.484889
5640,4300,340,1462000,2,45126,11283,1,221052800,221052800,16921,5640,11281,5640,0,1,5642,209875,0.209875
6040,4300,340,1462000,2,48326,12083,1,235900800,235900800,18121,6040,12081,6040,0,1,6042,287326,0.287326
6440,4300,340,1462000,2,51526,12883,1,250748800,250748800,19321,6440,12881,6440,0,1,6442,240710,0.24071
6840,4300,340,1462000,2,54726,13683,1,265596800,265596800,20521,6840,13681,6840,0,1,6842,1963667,1.963667
40,800,1840,1472000,2,326,83,1,12620800,12620800,121,40,81,40,0,1,42,26681,0.026681
440,800,1840,1472000,2,3526,883,1,21068800,21068800,1321,440,881,440,0,1,442,90894,0.090894
840,800,1840,1472000,2,6726,1683,1,29516800,29516800,2521,840,1681,840,0,1,842,239307,0.239307
1240,800,1840,1472000,2,9926,2483,1,37964800,37964800,3721,1240,2481,1240,0,1,1242,348708,0.348708
1640,800,1840,1472000,2,13126,3283,1,46412800,46412800,4921,1640,3281,1640,0,1,1642,301120,0.30112
2040,800,1840,1472000,2,16326,4083,1,54860800,54860800,6121,2040,4081,2040,0,1,2042,567033,0.567033
2440,800,1840,1472000,2,19526,4883,1,63308800,63308800,7321,2440,4881,2440,0,1,2442,677092,0.677092
2840,800,1840,1472000,2,22726,5683,1,71756800,71756800,8521,2840,5681,2840,0,1,2842,220508,0.220508
3240,800,1840,1472000,2,25926,6483,1,80204800,80204800,9721,3240,6481,3240,0,1,3242,57107,0.057107
3640,800,1840,1472000,2,29126,7283,1,88652800,88652800,10921,3640,7281,3640,0,1,3642,1002735,1.002735
4040,800,1840,1472000,2,32326,8083,1,97100800,97100800,12121,4040,8081,4040,0,1,4042,564250,0.56425
4440,800,1840,1472000,2,35526,8883,1,105548800,105548800,13321,4440,8881,4440,0,1,4442,944006,0.944006
4840,800,1840,1472000,2,38726,9683,1,113996800,113996800,14521,4840,9681,4840,0,1,4842,1314634,1.314634
5240,800,1840,1472000,2,41926,10483,1,122444800,122444800,15721,5240,10481,5240,0,1,5242,757412,0.757412
5640,800,1840,1472000,2,45126,11283,1,130892800,130892800,16921,5640,11281,5640,0,1,5642,189695,0.189695
6040,800,1840,1472000,2,48326,12083,1,139340800,139340800,18121,6040,12081,6040,0,1,6042,1666798,1.666798
6440,800,1840,1472000,2,51526,12883,1,147788800,147788800,19321,6440,12881,6440,0,1,6442,875508,0.875508
6840,800,1840,1472000,2,54726,13683,1,156236800,156236800,20521,6840,13681,6840,0,1,6842,826783,0.826783
40,2300,640,1472000,2,326,83,1,12716800,12716800,121,40,81,40,0,1,42,27221,0.027221
440,2300,640,1472000,2,3526,883,1,22124800,22124800,1321,440,881,440,0,1,442,130932,0.130932
840,2300,640,1472000,2,6726,1683,1,31532800,31532800,2521,840,1681,840,0,1,842,235891,0.235891
1240,2300,640,1472000,2,9926,2483,1,40940800,40940800,3721,1240,2481,1240,0,1,1242,343844,0.343844
1640,2300,640,1472000,2,13126,3283,1,50348800,50348800,4921,1640,3281,1640,0,1,1642,53301,0.053301
2040,2300,640,1472000,2,16326,4083,1,59756800,59756800,6121,2040,4081,2040,0,1,2042,561707,0.561707
2440,2300,640,1472000,2,19526,4883,1,69164800,69164800,7321,2440,4881,2440,0,1,2442,674351,0.674351
2840,2300,640,1472000,2,22726,5683,1,78572800,78572800,8521,2840,5681,2840,0,1,2842,782198,0.782198
3240,2300,640,1472000,2,25926,6483,1,87980800,87980800,9721,3240,6481,3240,0,1,3242,896813,0.896813
3640,2300,640,1472000,2,29126,7283,1,97388800,97388800,10921,3640,7281,3640,0,1,3642,325598,0.325598
4040,2300,640,1472000,2,32326,8083,1,106796800,106796800,12121,4040,8081,4040,0,1,4042,1112928,1.112928
4440,2300,640,1472000,2,35526,8883,1,116204800,116204800,13321,4440,8881,4440,0,1,4442,1229626,1.229626
4840,2300,640,1472000,2,38726,9683,1,125612800,125612800,14521,4840,9681,4840,0,1,4842,167740,0.16774
5240,2300,640,1472000,2,41926,10483,1,135020800,135020800,15721,5240,10481,5240,0,1,5242,1436954,1.436954
5640,2300,640,1472000,2,45126,11283,1,144428800,144428800,16921,5640,11281,5640,0,1,5642,871760,0.87176
6040,2300,640,1472000,2,48326,12083,1,153836800,153836800,18121,6040,12081,6040,0,1,6042,949495,0.949495
6440,2300,640,1472000,2,51526,12883,1,163244800,163244800,19321,6440,12881,6440,0,1,6442,1209732,1.209732
6840,2300,640,1472000,2,54726,13683,1,172652800,172652800,20521,6840,13681,6840,0,1,6842,1107673,1.107673
55,4055,365,1480075,2,446,113,1,13785400,13785400,166,55,111,55,0,1,57,8022,0.008022
455,4055,365,1480075,2,3646,913,1,27929400,27929400,1366,455,911,455,0,1,457,5017,0.005017
855,4055,365,1480075,2,6846,1713,1,42073400,42073400,2566,855,1711,855,0,1,857,120716,0.120716
1255,4055,365,1480075,2,10046,2513,1,56217400,56217400,3766,1255,2511,1255,0,1,1257,4420,0.00442
1655,4055,365,1480075,2,13246,3313,1,70361400,70361400,4966,1655,3311,1655,0,1,1657,33752,0.033752
2055,4055,365,1480075,2,16446,4113,1,84505400,84505400,6166,2055,4111,2055,0,1,2057,161520,0.16152
2455,4055,365,1480075,2,19646,4913,1,98649400,98649400,7366,2455,4911,2455,0,1,2457,447533,0.447533
2855,4055,365,1480075,2,22846,5713,1,112793400,112793400,8566,2855,5711,2855,0,1,2857,825571,0.825571
3255,4055,365,1480075,2,26046,6513,1,126937400,126937400,9766,3255,6511,3255,0,1,3257,268494,0.268494
3655,4055,365,1480075,2,29246,7313,1,141081400,141081400,10966,3655,7311,3655,0,1,3657,15731,0.015731
4055,4055,365,1480075,2,32446,8113,1,155225400,155225400,12166,4055,8111,4055,0,1,4057,510712,0.510712
4455,4055,365,1480075,2,35646,8913,1,169369400,169369400,13366,4455,8911,4455,0,1,4457,531840,0.53184
4855,4055,365,1480075,2,38846,9713,1,183513400,183513400,14566,4855,9711,4855,0,1,4857,54782,0.054782
5255,4055,365,1480075,2,42046,10513,1,197657400,197657400,15766,5255,10511,5255,0,1,5257,721831,0.721831
5655,4055,365,1480075,2,45246,11313,1,211801400,211801400,16966,5655,11311,5655,0,1,5657,1005753,1.005753
6055,4055,365,1480075,2,48446,12113,1,225945400,225945400,18166,6055,12111,6055,0,1,6057,1753334,1.753334
6455,4055,365,1480075,2,51646,12913,1,240089400,240089400,19366,6455,12911,6455,0,1,6457,1327646,1.327646
6855,4055,365,1480075,2,54846,13713,1,254233400,254233400,20566,6855,13711,6855,0,1,6857,812051,0.812051
55,305,4865,1483825,2,446,113,1,14145400,14145400,166,55,111,55,0,1,57,33050,0.03305
455,305,4865,1483825,2,3646,913,1,30689400,30689400,1366,455,911,455,0,1,457,145178,0.145178
855,305,4865,1483825,2,6846,1713,1,47233400,47233400,2566,855,1711,855,0,1,857,260285,0.260285
1255,305,4865,1483825,2,10046,2513,1,63777400,63777400,3766,1255,2511,1255,0,1,1257,31190,0.03119
1655,305,4865,1483825,2,13246,3313,1,80321400,80321400,4966,1655,3311,1655,0,1,1657,152860,0.15286
2055,305,4865,1483825,2,16446,4113,1,96865400,96865400,6166,2055,4111,2055,0,1,2057,54977,0.054977
2455,305,4865,1483825,2,19646,4913,1,113409400,113409400,7366,2455,4911,2455,0,1,2457,382476,0.382476
2855,305,4865,1483825,2,22846,5713,1,129953400,129953400,8566,2855,5711,2855,0,1,2857,68459,0.068459
3255,305,4865,1483825,2,26046,6513,1,146497400,146497400,9766,3255,6511,3255,0,1,3257,82647,0.082647
3655,305,4865,1483825,2,29246,7313,1,163041400,163041400,10966,3655,7311,3655,0,1,3657,399866,0.399866
4055,305,4865,1483825,2,32446,8113,1,179585400,179585400,12166,4055,8111,4055,0,1,4057,1030101,1.030101
4455,305,4865,1483825,2,35646,8913,1,196129400,196129400,13366,4455,8911,4455,0,1,4457,51062,0.051062
4855,305,4865,1483825,2,38846,9713,1,212673400,212673400,14566,4855,9711,4855,0,1,4857,1424842,1.424842
5255,305,4865,1483825,2,42046,10513,1,229217400,229217400,15766,5255,10511,5255,0,1,5257,236175,0.236175
5655,305,4865,1483825,2,45246,11313,1,245761400,245761400,16966,5655,11311,5655,0,1,5657,1663441,1.663441
6055,305,4865,1483825,2,48446,12113,1,262305400,262305400,18166,6055,12111,6055,0,1,6057,1270882,1.270882
6455,305,4865,1483825,2,51646,12913,1,278849400,278849400,19366,6455,12911,6455,0,1,6457,680948,0.680948
6855,305,4865,1483825,2,54846,13713,1,295393400,295393400,20566,6855,13711,6855,0,1,6857,191534,0.191534
55,1555,965,1500575,2,446,113,1,13113400,13113400,166,55,111,55,0,1,57,31743,0.031743
455,1555,965,1500575,2,3646,913,1,21177400,21177400,1366,455,911,455,0,1,457,143394,0.143394
855,1555,965,1500575,2,6846,1713,1,29241400,29241400,2566,855,1711,855,0,1,857,259723,0.259723
1255,1555,965,1500575,2,10046,2513,1,37305400,37305400,3766,1255,2511,1255,0,1,1257,381192,0.381192
1655,1555,965,1500575,2,13246,3313,1,45369400,45369400,4966,1655,3311,1655,0,1,1657,497755,0.497755
2055,1555,965,1500575,2,16446,4113,1,53433400,53433400,6166,2055,4111,2055,0,1,2057,612617,0.612617
2455,1555,965,1500575,2,19646,4913,1,61497400,61497400,7366,2455,4911,2455,0,1,2457,732934,0.732934
2855,1555,965,1500575,2,22846,5713,1,69561400,69561400,8566,2855,5711,2855,0,1,2857,842577,0.842577
3255,1555,965,1500575,2,26046,6513,1,77625400,77625400,9766,3255,6511,3255,0,1,3257,970906,0.970906
3655,1555,965,1500575,2,29246,7313,1,85689400,85689400,10966,3655,7311,3655,0,1,3657,18438,0.018438
4055,1555,965,1500575,2,32446,8113,1,93753400,93753400,12166,4055,8111,4055,0,1,4057,1204118,1.204118
4455,1555,965,1500575,2,35646,8913,1,101817400,101817400,13366,4455,8911,4455,0,1,4457,1324535,1.324535
4855,1555,965,1500575,2,38846,9713,1,109881400,109881400,14566,4855,9711,4855,0,1,4857,24938,0.024938
5255,1555,965,1500575,2,42046,10513,1,117945400,117945400,15766,5255,10511,5255,0,1,5257,1470488,1.470488
5655,1555,965,1500575,2,45246,11313,1,126009400,126009400,16966,5655,11311,5655,0,1,5657,257525,0.257525
6055,1555,965,1500575,2,48446,12113,1,134073400,134073400,18166,6055,12111,6055,0,1,6057,1803470,1.80347
6455,1555,965,1500575,2,51646,12913,1,142137400,142137400,19366,6455,12911,6455,0,1,6457,264037,0.264037
6855,1555,965,1500575,2,54846,13713,1,150201400,150201400,20566,6855,13711,6855,0,1,6857,1413810,1.41381
55,805,1865,1501325,2,446,113,1,13185400,13185400,166,55,111,55,0,1,57,32302,0.032302
455,805,1865,1501325,2,3646,913,1,21729400,21729400,1366,455,911,455,0,1,457,143491,0.143491
855,805,1865,1501325,2,6846,1713,1,30273400,30273400,2566,855,1711,855,0,1,857,258346,0.258346
1255,805,1865,1501325,2,10046,2513,1,38817400,38817400,3766,1255,2511,1255,0,1,1257,373519,0.373519
1655,805,1865,1501325,2,13246,3313,1,47361400,47361400,4966,1655,3311,1655,0,1,1657,488854,0.488854
2055,805,1865,1501325,2,16446,4113,1,55905400,55905400,6166,2055,4111,2055,0,1,2057,360423,0.360423
2455,805,1865,1501325,2,19646,4913,1,64449400,64449400,7366,2455,4911,2455,0,1,2457,264242,0.264242
2855,805,1865,1501325,2,22846,5713,1,72993400,72993400,8566,2855,5711,2855,0,1,2857,832932,0.832932
3255,805,1865,1501325,2,26046,6513,1,81537400,81537400,9766,3255,6511,3255,0,1,3257,17413,0.017413
3655,805,1865,1501325,2,29246,7313,1,90081400,90081400,10966,3655,7311,3655,0,1,3657,631848,0.631848
4055,805,1865,1501325,2,32446,8113,1,98625400,98625400,12166,4055,8111,4055,0,1,4057,1181109,1.181109
4455,805,1865,1501325,2,35646,8913,1,107169400,107169400,13366,4455,8911,4455,0,1,4457,879483,0.879483
4855,805,1865,1501325,2,38846,9713,1,115713400,115713400,14566,4855,9711,4855,0,1,4857,918982,0.918982
5255,805,1865,1501325,2,42046,10513,1,124257400,124257400,15766,5255,10511,5255,0,1,5257,563218,0.563218
5655,805,1865,1501325,2,45246,11313,1,132801400,132801400,16966,5655,11311,5655,0,1,5657,1645741,1.645741
6055,805,1865,1501325,2,48446,12113,1,141345400,141345400,18166,6055,12111,6055,0,1,6057,1760714,1.760714
6455,805,1865,1501325,2,51646,12913,1,149889400,149889400,19366,6455,12911,6455,0,1,6457,1589427,1.589427
6855,805,1865,1501325,2,54846,13713,1,158433400,158433400,20566,6855,13711,6855,0,1,6857,1991898,1.991898
35,590,2545,1501550,2,286,73,1,12890200,12890200,106,35,71,35,0,1,37,4959,0.004959
535,590,2545,1501550,2,4286,1073,1,25430200,25430200,1606,535,1071,535,0,1,537,9803,0.009803
1035,590,2545,1501550,2,8286,2073,1,37970200,37970200,3106,1035,2071,1035,0,1,1037,102369,0.102369
1535,590,2545,1501550,2,12286,3073,1,50510200,50510200,4606,1535,3071,1535,0,1,1537,95619,0.095619
2035,590,2545,1501550,2,16286,4073,1,63050200,63050200,6106,2035,4071,2035,0,1,2037,127260,0.12726
2535,590,2545,1501550,2,20286,5073,1,75590200,75590200,7606,2535,5071,2535,0,1,2537,771077,0.771077
3035,590,2545,1501550,2,24286,6073,1,88130200,88130200,9106,3035,6071,3035,0,1,3037,916427,0.916427
3535,590,2545,1501550,2,28286,7073,1,100670200,100670200,10606,3535,7071,3535,0,1,3537,1064898,1.064898
4035,590,2545,1501550,2,32286,8073,1,113210200,113210200,12106,4035,8071,4035,0,1,4037,1220557,1.220557
4535,590,2545,1501550,2,36286,9073,1,125750200,125750200,13606,4535,9071,4535,0,1,4537,1375047,1.375047
5035,590,2545,1501550,2,40286,10073,1,138290200,138290200,15106,5035,10071,5035,0,1,5037,1542833,1.542833
5535,590,2545,1501550,2,44286,11073,1,150830200,150830200,16606,5535,11071,5535,0,1,5537,1676870,1.67687
6035,590,2545,1501550,2,48286,12073,1,163370200,163370200,18106,6035,12071,6035,0,1,6037,1832207,1.832207
6535,590,2545,1501550,2,52286,13073,1,175910200,175910200,19606,6535,13071,6535,0,1,6537,1991390,1.99139
7035,590,2545,1501550,2,56286,14073,1,188450200,188450200,21106,7035,14071,7035,0,1,7037,2130463,2.130463
39,593,2541,1506813,2,318,81,1,13032312,13032312,118,39,79,39,0,1,41,28915,0.028915
539,593,2541,1506813,2,4318,1081,1,25568312,25568312,1618,539,1079,539,0,1,541,167259,0.167259
1039,593,2541,1506813,2,8318,2081,1,38104312,38104312,3118,1039,2079,1039,0,1,1041,308213,0.308213
1539,593,2541,1506813,2,12318,3081,1,50640312,50640312,4618,1539,3079,1539,0,1,1541,52969,0.052969
2039,593,2541,1506813,2,16318,4081,1,63176312,63176312,6118,2039,4079,2039,0,1,2041,147478,0.147478
2539,593,2541,1506813,2,20318,5081,1,75712312,75712312,7618,2539,5079,2539,0,1,2541,744259,0.744259
3039,593,2541,1506813,2,24318,6081,1,88248312,88248312,9118,3039,6079,3039,0,1,3041,892080,0.89208
3539,593,2541,1506813,2,28318,7081,1,100784312,100784312,10618,3539,7079,3539,0,1,3541,575263,0.575263
4039,593,2541,1506813,2,32318,8081,1,113320312,113320312,12118,4039,8079,4039,0,1,4041,225331,0.225331
4539,593,2541,1506813,2,36318,9081,1,125856312,125856312,13618,4539,9079,4539,0,1,4541,1326771,1.326771
5039,593,2541,1506813,2,40318,10081,1,138392312,138392312,15118,5039,10079,5039,0,1,5041,795955,0.795955
5539,593,2541,1506813,2,44318,11081,1,150928312,150928312,16618,5539,11079,5539,0,1,5541,1616698,1.616698
6039,593,2541,1506813,2,48318,12081,1,163464312,163464312,18118,6039,12079,6039,0,1,6041,157020,0.15702
6539,593,2541,1506813,2,52318,13081,1,176000312,176000312,19618,6539,13079,6539,0,1,6541,907333,0.907333
7039,593,2541,1506813,2,56318,14081,1,188536312,188536312,21118,7039,14079,7039,0,1,7041,1112907,1.112907
40,550,2740,1507000,2,326,83,1,13108800,13108800,121,40,81,40,0,1,42,28834,0.028834
440,550,2740,1507000,2,3526,883,1,23636800,23636800,1321,440,881,440,0,1,442,139346,0.139346
840,550,2740,1507000,2,6726,1683,1,34164800,34164800,2521,840,1681,840,0,1,842,253110,0.25311
1240,550,2740,1507000,2,9926,2483,1,44692800,44692800,3721,1240,2481,1240,0,1,1242,372606,0.372606
1640,550,2740,1507000,2,13126,3283,1,55220800,55220800,4921,1640,3281,1640,0,1,1642,151466,0.151466
2040,550,2740,1507000,2,16326,4083,1,65748800,65748800,6121,2040,4081,2040,0,1,2042,153989,0.153989
2440,550,2740,1507000,2,19526,4883,1,76276800,76276800,7321,2440,4881,2440,0,1,2442,236349,0.236349
2840,550,2740,1507000,2,22726,5683,1,86804800,86804800,8521,2840,5681,2840,0,1,2842,827838,0.827838
3240,550,2740,1507000,2,25926,6483,1,97332800,97332800,9721,3240,6481,3240,0,1,3242,748235,0.748235
3640,550,2740,1507000,2,29126,7283,1,107860800,107860800,10921,3640,7281,3640,0,1,3642,1057327,1.057327
4040,550,2740,1507000,2,32326,8083,1,118388800,118388800,12121,4040,8081,4040,0,1,4042,12965,0.012965
4440,550,2740,1507000,2,35526,8883,1,128916800,128916800,13321,4440,8881,4440,0,1,4442,58718,0.058718
4840,550,2740,1507000,2,38726,9683,1,139444800,139444800,14521,4840,9681,4840,0,1,4842,1399949,1.399949
5240,550,2740,1507000,2,41926,10483,1,149972800,149972800,15721,5240,10481,5240,0,1,5242,992919,0.992919
5640,550,2740,1507000,2,45126,11283,1,160500800,160500800,16921,5640,11281,5640,0,1,5642,1101928,1.101928
6040,550,2740,1507000,2,48326,12083,1,171028800,171028800,18121,6040,12081,6040,0,1,6042,186265,0.186265
6440,550,2740,1507000,2,51526,12883,1,181556800,181556800,19321,6440,12881,6440,0,1,6442,399146,0.399146
6840,550,2740,1507000,2,54726,13683,1,192084800,192084800,20521,6840,13681,6840,0,1,6842,1568477,1.568477
39,2793,541,1511013,2,318,81,1,13128312,13128312,118,39,79,39,0,1,41,26784,0.026784
539,2793,541,1511013,2,4318,1081,1,26464312,26464312,1618,539,1079,539,0,1,541,164453,0.164453
1039,2793,541,1511013,2,8318,2081,1,39800312,39800312,3118,1039,2079,1039,0,1,1041,310626,0.310626
1539,2793,541,1511013,2,12318,3081,1,53136312,53136312,4618,1539,3079,1539,0,1,1541,453585,0.453585
2039,2793,541,1511013,2,16318,4081,1,66472312,66472312,6118,2039,4079,2039,0,1,2041,600291,0.600291
2539,2793,541,1511013,2,20318,5081,1,79808312,79808312,7618,2539,5079,2539,0,1,2541,747398,0.747398
3039,2793,541,1511013,2,24318,6081,1,93144312,93144312,9118,3039,6079,3039,0,1,3041,674087,0.674087
3539,2793,541,1511013,2,28318,7081,1,106480312,106480312,10618,3539,7079,3539,0,1,3541,518408,0.518408
4039,2793,541,1511013,2,32318,8081,1,119816312,119816312,12118,4039,8079,4039,0,1,4041,129292,0.129292
4539,2793,541,1511013,2,36318,9081,1,133152312,133152312,13618,4539,9079,4539,0,1,4541,1337271,1.337271
5039,2793,541,1511013,2,40318,10081,1,146488312,146488312,15118,5039,10079,5039,0,1,5041,1407885,1.407885
5539,2793,541,1511013,2,44318,11081,1,159824312,159824312,16618,5539,11079,5539,0,1,5541,1662326,1.662326
6039,2793,541,1511013,2,48318,12081,1,173160312,173160312,18118,6039,12079,6039,0,1,6041,1790834,1.790834
6539,2793,541,1511013,2,52318,13081,1,186496312,186496312,19618,6539,13079,6539,0,1,6541,392919,0.392919
7039,2793,541,1511013,2,56318,14081,1,199832312,199832312,21118,7039,14079,7039,0,1,7041,2080460,2.08046
55,2305,665,1532825,2,446,113,1,13569400,13569400,166,55,111,55,0,1,57,32144,0.032144
455,2305,665,1532825,2,3646,913,1,23073400,23073400,1366,455,911,455,0,1,457,142072,0.142072
855,2305,665,1532825,2,6846,1713,1,32577400,32577400,2566,855,1711,855,0,1,857,257596,0.257596
1255,2305,665,1532825,2,10046,2513,1,42081400,42081400,3766,1255,2511,1255,0,1,1257,376749,0.376749
1655,2305,665,1532825,2,13246,3313,1,51585400,51585400,4966,1655,3311,1655,0,1,1657,489437,0.489437
2055,2305,665,1532825,2,16446,4113,1,61089400,61089400,6166,2055,4111,2055,0,1,2057,609323,0.609323
2455,2305,665,1532825,2,19646,4913,1,70593400,70593400,7366,2455,4911,2455,0,1,2457,728362,0.728362
2855,2305,665,1532825,2,22846,5713,1,80097400,80097400,8566,2855,5711,2855,0,1,2857,843107,0.843107
3255,2305,665,1532825,2,26046,6513,1,89601400,89601400,9766,3255,6511,3255,0,1,3257,13183,0.013183
3655,2305,665,1532825,2,29246,7313,1,99105400,99105400,10966,3655,7311,3655,0,1,3657,782990,0.78299
4055,2305,665,1532825,2,32446,8113,1,108609400,108609400,12166,4055,8111,4055,0,1,4057,484676,0.484676
4455,2305,665,1532825,2,35646,8913,1,118113400,118113400,13366,4455,8911,4455,0,1,4457,1153335,1.153335
4855,2305,665,1532825,2,38846,9713,1,127617400,127617400,14566,4855,9711,4855,0,1,4857,727274,0.727274
5255,2305,665,1532825,2,42046,10513,1,137121400,137121400,15766,5255,10511,5255,0,1,5257,9235,0.009235
5655,2305,665,1532825,2,45246,11313,1,146625400,146625400,16966,5655,11311,5655,0,1,5657,871400,0.8714
6055,2305,665,1532825,2,48446,12113,1,156129400,156129400,18166,6055,12111,6055,0,1,6057,273007,0.273007
6455,2305,665,1532825,2,51646,12913,1,165633400,165633400,19366,6455,12911,6455,0,1,6457,1138769,1.138769
6855,2305,665,1532825,2,54846,13713,1,175137400,175137400,20566,6855,13711,6855,0,1,6857,69778,0.069778
55,555,2765,1534575,2,446,113,1,13737400,13737400,166,55,111,55,0,1,57,33223,0.033223
455,555,2765,1534575,2,3646,913,1,24361400,24361400,1366,455,911,455,0,1,457,148785,0.148785
855,555,2765,1534575,2,6846,1713,1,34985400,34985400,2566,855,1711,855,0,1,857,263028,0.263028
1255,555,2765,1534575,2,10046,2513,1,45609400,45609400,3766,1255,2511,1255,0,1,1257,322276,0.322276
1655,555,2765,1534575,2,13246,3313,1,56233400,56233400,4966,1655,3311,1655,0,1,1657,501740,0.50174
2055,555,2765,1534575,2,16446,4113,1,66857400,66857400,6166,2055,4111,2055,0,1,2057,524576,0.524576
2455,555,2765,1534575,2,19646,4913,1,77481400,77481400,7366,2455,4911,2455,0,1,2457,99337,0.099337
2855,555,2765,1534575,2,22846,5713,1,88105400,88105400,8566,2855,5711,2855,0,1,2857,856601,0.856601
3255,555,2765,1534575,2,26046,6513,1,98729400,98729400,9766,3255,6511,3255,0,1,3257,973566,0.973566
3655,555,2765,1534575,2,29246,7313,1,109353400,109353400,10966,3655,7311,3655,0,1,3657,1042603,1.042603
4055,555,2765,1534575,2,32446,8113,1,119977400,119977400,12166,4055,8111,4055,0,1,4057,95731,0.095731
4455,555,2765,1534575,2,35646,8913,1,130601400,130601400,13366,4455,8911,4455,0,1,4457,755208,0.755208
4855,555,2765,1534575,2,38846,9713,1,141225400,141225400,14566,4855,9711,4855,0,1,4857,390843,0.390843
5255,555,2765,1534575,2,42046,10513,1,151849400,151849400,15766,5255,10511,5255,0,1,5257,1566803,1.566803
5655,555,2765,1534575,2,45246,11313,1,162473400,162473400,16966,5655,11311,5655,0,1,5657,446362,0.446362
6055,555,2765,1534575,2,48446,12113,1,173097400,173097400,18166,6055,12111,6055,0,1,6057,76341,0.076341
6455,555,2765,1534575,2,51646,12913,1,183721400,183721400,19366,6455,12911,6455,0,1,6457,1925356,1.925356
6855,555,2765,1534575,2,54846,13713,1,194345400,194345400,20566,6855,13711,6855,0,1,6857,1774566,1.774566
44,603,2555,1540665,2,358,91,1,13436936,13436936,133,44,89,44,0,1,46,30460,0.03046
544,603,2555,1540665,2,4358,1091,1,26068936,26068936,1633,544,1089,544,0,1,546,172277,0.172277
1044,603,2555,1540665,2,8358,2091,1,38700936,38700936,3133,1044,2089,1044,0,1,1046,317909,0.317909
1544,603,2555,1540665,2,12358,3091,1,51332936,51332936,4633,1544,3089,1544,0,1,1546,467512,0.467512
2044,603,2555,1540665,2,16358,4091,1,63964936,63964936,6133,2044,4089,2044,0,1,2046,427481,0.427481
2544,603,2555,1540665,2,20358,5091,1,76596936,76596936,7633,2544,5089,2544,0,1,2546,239478,0.239478
3044,603,2555,1540665,2,24358,6091,1,89228936,89228936,9133,3044,6089,3044,0,1,3046,211955,0.211955
3544,603,2555,1540665,2,28358,7091,1,101860936,101860936,10633,3544,7089,3544,0,1,3546,578515,0.578515
4044,603,2555,1540665,2,32358,8091,1,114492936,114492936,12133,4044,8089,4044,0,1,4046,431609,0.431609
4544,603,2555,1540665,2,36358,9091,1,127124936,127124936,13633,4544,9089,4544,0,1,4546,40661,0.040661
5044,603,2555,1540665,2,40358,10091,1,139756936,139756936,15133,5044,10089,5044,0,1,5046,414556,0.414556
5544,603,2555,1540665,2,44358,11091,1,152388936,152388936,16633,5544,11089,5544,0,1,5546,309131,0.309131
6044,603,2555,1540665,2,48358,12091,1,165020936,165020936,18133,6044,12089,6044,0,1,6046,45810,0.04581
6544,603,2555,1540665,2,52358,13091,1,177652936,177652936,19633,6544,13089,6544,0,1,6546,215803,0.215803
7044,603,2555,1540665,2,56358,14091,1,190284936,190284936,21133,7044,14089,7044,0,1,7046,614180,0.61418
40,300,5140,1542000,2,326,83,1,14076800,14076800,121,40,81,40,0,1,42,29585,0.029585
440,300,5140,1542000,2,3526,883,1,31484800,31484800,1321,440,881,440,0,1,442,144733,0.144733
840,300,5140,1542000,2,6726,1683,1,48892800,48892800,2521,840,1681,840,0,1,842,134653,0.134653
1240,300,5140,1542000,2,9926,2483,1,66300800,66300800,3721,1240,2481,1240,0,1,1242,83026,0.083026
1640,300,5140,1542000,2,13126,3283,1,83708800,83708800,4921,1640,3281,1640,0,1,1642,500998,0.500998
2040,300,5140,1542000,2,16326,4083,1,101116800,101116800,6121,2040,4081,2040,0,1,2042,28107,0.028107
2440,300,5140,1542000,2,19526,4883,1,118524800,118524800,7321,2440,4881,2440,0,1,2442,738923,0.738923
2840,300,5140,1542000,2,22726,5683,1,135932800,135932800,8521,2840,5681,2840,0,1,2842,859141,0.859141
3240,300,5140,1542000,2,25926,6483,1,153340800,153340800,9721,3240,6481,3240,0,1,3242,137573,0.137573
3640,300,5140,1542000,2,29126,7283,1,170748800,170748800,10921,3640,7281,3640,0,1,3642,380263,0.380263
4040,300,5140,1542000,2,32326,8083,1,188156800,188156800,12121,4040,8081,4040,0,1,4042,102354,0.102354
4440,300,5140,1542000,2,35526,8883,1,205564800,205564800,13321,4440,8881,4440,0,1,4442,601421,0.601421
4840,300,5140,1542000,2,38726,9683,1,222972800,222972800,14521,4840,9681,4840,0,1,4842,139192,0.139192
5240,300,5140,1542000,2,41926,10483,1,240380800,240380800,15721,5240,10481,5240,0,1,5242,732624,0.732624
5640,300,5140,1542000,2,45126,11283,1,257788800,257788800,16921,5640,11281,5640,0,1,5642,659936,0.659936
6040,300,5140,1542000,2,48326,12083,1,275196800,275196800,18121,6040,12081,6040,0,1,6042,872918,0.872918
6440,300,5140,1542000,2,51526,12883,1,292604800,292604800,19321,6440,12881,6440,0,1,6442,587622,0.587622
6840,300,5140,1542000,2,54726,13683,1,310012800,310012800,20521,6840,13681,6840,0,1,6842,340932,0.340932
40,4550,340,1547000,2,326,83,1,13940800,13940800,121,40,81,40,0,1,42,29286,0.029286
440,4550,340,1547000,2,3526,883,1,29588800,29588800,1321,440,881,440,0,1,442,139231,0.139231
840,4550,340,1547000,2,6726,1683,1,45236800,45236800,2521,840,1681,840,0,1,842,254971,0.254971
1240,4550,340,1547000,2,9926,2483,1,60884800,60884800,3721,1240,2481,1240,0,1,1242,374402,0.374402
1640,4550,340,1547000,2,13126,3283,1,76532800,76532800,4921,1640,3281,1640,0,1,1642,486462,0.486462
2040,4550,340,1547000,2,16326,4083,1,92180800,92180800,6121,2040,4081,2040,0,1,2042,50950,0.05095
2440,4550,340,1547000,2,19526,4883,1,107828800,107828800,7321,2440,4881,2440,0,1,2442,725959,0.725959
2840,4550,340,1547000,2,22726,5683,1,123476800,123476800,8521,2840,5681,2840,0,1,2842,846428,0.846428
3240,4550,340,1547000,2,25926,6483,1,139124800,139124800,9721,3240,6481,3240,0,1,3242,161579,0.161579
3640,4550,340,1547000,2,29126,7283,1,154772800,154772800,10921,3640,7281,3640,0,1,3642,356481,0.356481
4040,4550,340,1547000,2,32326,8083,1,170420800,170420800,12121,4040,8081,4040,0,1,4042,1223712,1.223712
4440,4550,340,1547000,2,35526,8883,1,186068800,186068800,13321,4440,8881,4440,0,1,4442,1324893,1.324893
4840,4550,340,1547000,2,38726,9683,1,201716800,201716800,14521,4840,9681,4840,0,1,4842,1459080,1.45908
5240,4550,340,1547000,2,41926,10483,1,217364800,217364800,15721,5240,10481,5240,0,1,5242,1583752,1.583752
5640,4550,340,1547000,2,45126,11283,1,233012800,233012800,16921,5640,11281,5640,0,1,5642,1705223,1.705223
6040,4550,340,1547000,2,48326,12083,1,248660800,248660800,18121,6040,12081,6040,0,1,6042,1816434,1.816434
6440,4550,340,1547000,2,51526,12883,1,264308800,264308800,19321,6440,12881,6440,0,1,6442,1781614,1.781614
6840,4550,340,1547000,2,54726,13683,1,279956800,279956800,20521,6840,13681,6840,0,1,6842,708702,0.708702
44,2803,555,1555665,2,358,91,1,13627336,13627336,133,44,89,44,0,1,46,29419,0.029419
544,2803,555,1555665,2,4358,1091,1,27059336,27059336,1633,544,1089,544,0,1,546,171142,0.171142
1044,2803,555,1555665,2,8358,2091,1,40491336,40491336,3133,1044,2089,1044,0,1,1046,322321,0.322321
1544,2803,555,1555665,2,12358,3091,1,53923336,53923336,4633,1544,3089,1544,0,1,1546,467053,0.467053
2044,2803,555,1555665,2,16358,4091,1,67355336,67355336,6133,2044,4089,2044,0,1,2046,76701,0.076701
2544,2803,555,1555665,2,20358,5091,1,80787336,80787336,7633,2544,5089,2544,0,1,2546,765105,0.765105
3044,2803,555,1555665,2,24358,6091,1,94219336,94219336,9133,3044,6089,3044,0,1,3046,863261,0.863261
3544,2803,555,1555665,2,28358,7091,1,107651336,107651336,10633,3544,7089,3544,0,1,3546,699392,0.699392
4044,2803,555,1555665,2,32358,8091,1,121083336,121083336,12133,4044,8089,4044,0,1,4046,29922,0.029922
4544,2803,555,1555665,2,36358,9091,1,134515336,134515336,13633,4544,9089,4544,0,1,4546,1360588,1.360588
5044,2803,555,1555665,2,40358,10091,1,147947336,147947336,15133,5044,10089,5044,0,1,5046,1203767,1.203767
5544,2803,555,1555665,2,44358,11091,1,161379336,161379336,16633,5544,11089,5544,0,1,5546,35746,0.035746
6044,2803,555,1555665,2,48358,12091,1,174811336,174811336,18133,6044,12089,6044,0,1,6046,1347211,1.347211
6544,2803,555,1555665,2,52358,13091,1,188243336,188243336,19633,6544,13089,6544,0,1,6546,1236544,1.236544
7044,2803,555,1555665,2,56358,14091,1,201675336,201675336,21133,7044,14089,7044,0,1,7046,203986,0.203986
55,4305,365,1571325,2,446,113,1,14625400,14625400,166,55,111,55,0,1,57,34923,0.034923
455,4305,365,1571325,2,3646,913,1,29569400,29569400,1366,455,911,455,0,1,457,143572,0.143572
855,4305,365,1571325,2,6846,1713,1,44513400,44513400,2566,855,1711,855,0,1,857,262798,0.262798
1255,4305,365,1571325,2,10046,2513,1,59457400,59457400,3766,1255,2511,1255,0,1,1257,380532,0.380532
1655,4305,365,1571325,2,13246,3313,1,74401400,74401400,4966,1655,3311,1655,0,1,1657,510469,0.510469
2055,4305,365,1571325,2,16446,4113,1,89345400,89345400,6166,2055,4111,2055,0,1,2057,2255,0.002255
2455,4305,365,1571325,2,19646,4913,1,104289400,104289400,7366,2455,4911,2455,0,1,2457,753840,0.75384
2855,4305,365,1571325,2,22846,5713,1,119233400,119233400,8566,2855,5711,2855,0,1,2857,336477,0.336477
3255,4305,365,1571325,2,26046,6513,1,134177400,134177400,9766,3255,6511,3255,0,1,3257,996687,0.996687
3655,4305,365,1571325,2,29246,7313,1,149121400,149121400,10966,3655,7311,3655,0,1,3657,632607,0.632607
4055,4305,365,1571325,2,32446,8113,1,164065400,164065400,12166,4055,8111,4055,0,1,4057,907857,0.907857
4455,4305,365,1571325,2,35646,8913,1,179009400,179009400,13366,4455,8911,4455,0,1,4457,1364924,1.364924
4855,4305,365,1571325,2,38846,9713,1,193953400,193953400,14566,4855,9711,4855,0,1,4857,1028439,1.028439
5255,4305,365,1571325,2,42046,10513,1,208897400,208897400,15766,5255,10511,5255,0,1,5257,997759,0.997759
5655,4305,365,1571325,2,45246,11313,1,223841400,223841400,16966,5655,11311,5655,0,1,5657,670632,0.670632
6055,4305,365,1571325,2,48446,12113,1,238785400,238785400,18166,6055,12111,6055,0,1,6057,602353,0.602353
6455,4305,365,1571325,2,51646,12913,1,253729400,253729400,19366,6455,12911,6455,0,1,6457,2028788,2.028788
6855,4305,365,1571325,2,54846,13713,1,268673400,268673400,20566,6855,13711,6855,0,1,6857,2112325,2.112325
55,305,5165,1575325,2,446,113,1,15009400,15009400,166,55,111,55,0,1,57,34765,0.034765
455,305,5165,1575325,2,3646,913,1,32513400,32513400,1366,455,911,455,0,1,457,153635,0.153635
855,305,5165,1575325,2,6846,1713,1,50017400,50017400,2566,855,1711,855,0,1,857,274359,0.274359
1255,305,5165,1575325,2,10046,2513,1,67521400,67521400,3766,1255,2511,1255,0,1,1257,403292,0.403292
1655,305,5165,1575325,2,13246,3313,1,85025400,85025400,4966,1655,3311,1655,0,1,1657,6214,0.006214
2055,305,5165,1575325,2,16446,4113,1,102529400,102529400,6166,2055,4111,2055,0,1,2057,323359,0.323359
2455,305,5165,1575325,2,19646,4913,1,120033400,120033400,7366,2455,4911,2455,0,1,2457,35708,0.035708
2855,305,5165,1575325,2,22846,5713,1,137537400,137537400,8566,2855,5711,2855,0,1,2857,597145,0.597145
3255,305,5165,1575325,2,26046,6513,1,155041400,155041400,9766,3255,6511,3255,0,1,3257,88100,0.0881
3655,305,5165,1575325,2,29246,7313,1,172545400,172545400,10966,3655,7311,3655,0,1,3657,160812,0.160812
4055,305,5165,1575325,2,32446,8113,1,190049400,190049400,12166,4055,8111,4055,0,1,4057,302616,0.302616
4455,305,5165,1575325,2,35646,8913,1,207553400,207553400,13366,4455,8911,4455,0,1,4457,301092,0.301092
4855,305,5165,1575325,2,38846,9713,1,225057400,225057400,14566,4855,9711,4855,0,1,4857,55650,0.05565
5255,305,5165,1575325,2,42046,10513,1,242561400,242561400,15766,5255,10511,5255,0,1,5257,755466,0.755466
5655,305,5165,1575325,2,45246,11313,1,260065400,260065400,16966,5655,11311,5655,0,1,5657,1095691,1.095691
6055,305,5165,1575325,2,48446,12113,1,277569400,277569400,18166,6055,12111,6055,0,1,6057,24331,0.024331
6455,305,5165,1575325,2,51646,12913,1,295073400,295073400,19366,6455,12911,6455,0,1,6457,368617,0.368617
6855,305,5165,1575325,2,54846,13713,1,312577400,312577400,20566,6855,13711,6855,0,1,6857,940828,0.940828
40,1300,1240,1612000,2,326,83,1,13708800,13708800,121,40,81,40,0,1,42,31964,0.031964
440,1300,1240,1612000,2,3526,883,1,21836800,21836800,1321,440,881,440,0,1,442,147400,0.1474
840,1300,1240,1612000,2,6726,1683,1,29964800,29964800,2521,840,1681,840,0,1,842,136351,0.136351
1240,1300,1240,1612000,2,9926,2483,1,38092800,38092800,3721,1240,2481,1240,0,1,1242,137031,0.137031
1640,1300,1240,1612000,2,13126,3283,1,46220800,46220800,4921,1640,3281,1640,0,1,1642,275726,0.275726
2040,1300,1240,1612000,2,16326,4083,1,54348800,54348800,6121,2040,4081,2040,0,1,2042,379514,0.379514
2440,1300,1240,1612000,2,19526,4883,1,62476800,62476800,7321,2440,4881,2440,0,1,2442,103713,0.103713
2840,1300,1240,1612000,2,22726,5683,1,70604800,70604800,8521,2840,5681,2840,0,1,2842,895814,0.895814
3240,1300,1240,1612000,2,25926,6483,1,78732800,78732800,9721,3240,6481,3240,0,1,3242,656225,0.656225
3640,1300,1240,1612000,2,29126,7283,1,86860800,86860800,10921,3640,7281,3640,0,1,3642,502204,0.502204
4040,1300,1240,1612000,2,32326,8083,1,94988800,94988800,12121,4040,8081,4040,0,1,4042,1277829,1.277829
4440,1300,1240,1612000,2,35526,8883,1,103116800,103116800,13321,4440,8881,4440,0,1,4442,530520,0.53052
4840,1300,1240,1612000,2,38726,9683,1,111244800,111244800,14521,4840,9681,4840,0,1,4842,343750,0.34375
5240,1300,1240,1612000,2,41926,10483,1,119372800,119372800,15721,5240,10481,5240,0,1,5242,260149,0.260149
5640,1300,1240,1612000,2,45126,11283,1,127500800,127500800,16921,5640,11281,5640,0,1,5642,1770778,1.770778
6040,1300,1240,1612000,2,48326,12083,1,135628800,135628800,18121,6040,12081,6040,0,1,6042,1891334,1.891334
6440,1300,1240,1612000,2,51526,12883,1,143756800,143756800,19321,6440,12881,6440,0,1,6442,864860,0.86486
6840,1300,1240,1612000,2,54726,13683,1,151884800,151884800,20521,6840,13681,6840,0,1,6842,413862,0.413862
40,1050,1540,1617000,2,326,83,1,13764800,13764800,121,40,81,40,0,1,42,7295,0.007295
440,1050,1540,1617000,2,3526,883,1,22052800,22052800,1321,440,881,440,0,1,442,19014,0.019014
840,1050,1540,1617000,2,6726,1683,1,30340800,30340800,2521,840,1681,840,0,1,842,57382,0.057382
1240,1050,1540,1617000,2,9926,2483,1,38628800,38628800,3721,1240,2481,1240,0,1,1242,82528,0.082528
1640,1050,1540,1617000,2,13126,3283,1,46916800,46916800,4921,1640,3281,1640,0,1,1642,376,0.000376
2040,1050,1540,1617000,2,16326,4083,1,55204800,55204800,6121,2040,4081,2040,0,1,2042,284674,0.284674
2440,1050,1540,1617000,2,19526,4883,1,63492800,63492800,7321,2440,4881,2440,0,1,2442,199942,0.199942
2840,1050,1540,1617000,2,22726,5683,1,71780800,71780800,8521,2840,5681,2840,0,1,2842,475589,0.475589
3240,1050,1540,1617000,2,25926,6483,1,80068800,80068800,9721,3240,6481,3240,0,1,3242,561481,0.561481
3640,1050,1540,1617000,2,29126,7283,1,88356800,88356800,10921,3640,7281,3640,0,1,3642,208289,0.208289
4040,1050,1540,1617000,2,32326,8083,1,96644800,96644800,12121,4040,8081,4040,0,1,4042,252101,0.252101
4440,1050,1540,1617000,2,35526,8883,1,104932800,104932800,13321,4440,8881,4440,0,1,4442,714717,0.714717
4840,1050,1540,1617000,2,38726,9683,1,113220800,113220800,14521,4840,9681,4840,0,1,4842,199068,0.199068
5240,1050,1540,1617000,2,41926,10483,1,121508800,121508800,15721,5240,10481,5240,0,1,5242,360474,0.360474
5640,1050,1540,1617000,2,45126,11283,1,129796800,129796800,16921,5640,11281,5640,0,1,5642,1788785,1.788785
6040,1050,1540,1617000,2,48326,12083,1,138084800,138084800,18121,6040,12081,6040,0,1,6042,527467,0.527467
6440,1050,1540,1617000,2,51526,12883,1,146372800,146372800,19321,6440,12881,6440,0,1,6442,881396,0.881396
6840,1050,1540,1617000,2,54726,13683,1,154660800,154660800,20521,6840,13681,6840,0,1,6842,169376,0.169376
40,300,5440,1632000,2,326,83,1,14892800,14892800,121,40,81,40,0,1,42,30843,0.030843
440,300,5440,1632000,2,3526,883,1,33260800,33260800,1321,440,881,440,0,1,442,148334,0.148334
840,300,5440,1632000,2,6726,1683,1,51628800,51628800,2521,840,1681,840,0,1,842,3543,0.003543
1240,300,5440,1632000,2,9926,2483,1,69996800,69996800,3721,1240,2481,1240,0,1,1242,393773,0.393773
1640,300,5440,1632000,2,13126,3283,1,88364800,88364800,4921,1640,3281,1640,0,1,1642,176302,0.176302
2040,300,5440,1632000,2,16326,4083,1,106732800,106732800,6121,2040,4081,2040,0,1,2042,240772,0.240772
2440,300,5440,1632000,2,19526,4883,1,125100800,125100800,7321,2440,4881,2440,0,1,2442,54348,0.054348
2840,300,5440,1632000,2,22726,5683,1,143468800,143468800,8521,2840,5681,2840,0,1,2842,10769,0.010769
3240,300,5440,1632000,2,25926,6483,1,161836800,161836800,9721,3240,6481,3240,0,1,3242,757400,0.7574
3640,300,5440,1632000,2,29126,7283,1,180204800,180204800,10921,3640,7281,3640,0,1,3642,398480,0.39848
4040,300,5440,1632000,2,32326,8083,1,198572800,198572800,12121,4040,8081,4040,0,1,4042,423035,0.423035
4440,300,5440,1632000,2,35526,8883,1,216940800,216940800,13321,4440,8881,4440,0,1,4442,1119519,1.119519
4840,300,5440,1632000,2,38726,9683,1,235308800,235308800,14521,4840,9681,4840,0,1,4842,425515,0.425515
5240,300,5440,1632000,2,41926,10483,1,253676800,253676800,15721,5240,10481,5240,0,1,5242,641283,0.641283
5640,300,5440,1632000,2,45126,11283,1,272044800,272044800,16921,5640,11281,5640,0,1,5642,615788,0.615788
6040,300,5440,1632000,2,48326,12083,1,290412800,290412800,18121,6040,12081,6040,0,1,6042,767407,0.767407
6440,300,5440,1632000,2,51526,12883,1,308780800,308780800,19321,6440,12881,6440,0,1,6442,250417,0.250417
6840,300,5440,1632000,2,54726,13683,1,327148800,327148800,20521,6840,13681,6840,0,1,6842,857593,0.857593
40,2550,640,1632000,2,326,83,1,14076800,14076800,121,40,81,40,0,1,42,30650,0.03065
440,2550,640,1632000,2,3526,883,1,24284800,24284800,1321,440,881,440,0,1,442,146009,0.146009
840,2550,640,1632000,2,6726,1683,1,34492800,34492800,2521,840,1681,840,0,1,842,260938,0.260938
1240,2550,640,1632000,2,9926,2483,1,44700800,44700800,3721,1240,2481,1240,0,1,1242,379646,0.379646
1640,2550,640,1632000,2,13126,3283,1,54908800,54908800,4921,1640,3281,1640,0,1,1642,500679,0.500679
2040,2550,640,1632000,2,16326,4083,1,65116800,65116800,6121,2040,4081,2040,0,1,2042,205870,0.20587
2440,2550,640,1632000,2,19526,4883,1,75324800,75324800,7321,2440,4881,2440,0,1,2442,741717,0.741717
2840,2550,640,1632000,2,22726,5683,1,85532800,85532800,8521,2840,5681,2840,0,1,2842,876024,0.876024
3240,2550,640,1632000,2,25926,6483,1,95740800,95740800,9721,3240,6481,3240,0,1,3242,26656,0.026656
3640,2550,640,1632000,2,29126,7283,1,105948800,105948800,10921,3640,7281,3640,0,1,3642,1106453,1.106453
4040,2550,640,1632000,2,32326,8083,1,116156800,116156800,12121,4040,8081,4040,0,1,4042,1227461,1.227461
4440,2550,640,1632000,2,35526,8883,1,126364800,126364800,13321,4440,8881,4440,0,1,4442,1288577,1.288577
4840,2550,640,1632000,2,38726,9683,1,136572800,136572800,14521,4840,9681,4840,0,1,4842,1475471,1.475471
5240,2550,640,1632000,2,41926,10483,1,146780800,146780800,15721,5240,10481,5240,0,1,5242,585784,0.585784
5640,2550,640,1632000,2,45126,11283,1,156988800,156988800,16921,5640,11281,5640,0,1,5642,1461999,1.461999
6040,2550,640,1632000,2,48326,12083,1,167196800,167196800,18121,6040,12081,6040,0,1,6042,1833830,1.83383
6440,2550,640,1632000,2,51526,12883,1,177404800,177404800,19321,6440,12881,6440,0,1,6442,187829,0.187829
6840,2550,640,1632000,2,54726,13683,1,187612800,187612800,20521,6840,13681,6840,0,1,6842,2082837,2.082837
40,4800,340,1632000,2,326,83,1,14700800,14700800,121,40,81,40,0,1,42,33586,0.033586
440,4800,340,1632000,2,3526,883,1,31148800,31148800,1321,440,881,440,0,1,442,145784,0.145784
840,4800,340,1632000,2,6726,1683,1,47596800,47596800,2521,840,1681,840,0,1,842,266850,0.26685
1240,4800,340,1632000,2,9926,2483,1,64044800,64044800,3721,1240,2481,1240,0,1,1242,391129,0.391129
1640,4800,340,1632000,2,13126,3283,1,80492800,80492800,4921,1640,3281,1640,0,1,1642,282656,0.282656
2040,4800,340,1632000,2,16326,4083,1,96940800,96940800,6121,2040,4081,2040,0,1,2042,642549,0.642549
2440,4800,340,1632000,2,19526,4883,1,113388800,113388800,7321,2440,4881,2440,0,1,2442,788606,0.788606
2840,4800,340,1632000,2,22726,5683,1,129836800,129836800,8521,2840,5681,2840,0,1,2842,896701,0.896701
3240,4800,340,1632000,2,25926,6483,1,146284800,146284800,9721,3240,6481,3240,0,1,3242,1028190,1.02819
3640,4800,340,1632000,2,29126,7283,1,162732800,162732800,10921,3640,7281,3640,0,1,3642,1152090,1.15209
4040,4800,340,1632000,2,32326,8083,1,179180800,179180800,12121,4040,8081,4040,0,1,4042,564607,0.564607
4440,4800,340,1632000,2,35526,8883,1,195628800,195628800,13321,4440,8881,4440,0,1,4442,851610,0.85161
4840,4800,340,1632000,2,38726,9683,1,212076800,212076800,14521,4840,9681,4840,0,1,4842,1549585,1.549585
5240,4800,340,1632000,2,41926,10483,1,228524800,228524800,15721,5240,10481,5240,0,1,5242,1666610,1.66661
5640,4800,340,1632000,2,45126,11283,1,244972800,244972800,16921,5640,11281,5640,0,1,5642,1780836,1.780836
6040,4800,340,1632000,2,48326,12083,1,261420800,261420800,18121,6040,12081,6040,0,1,6042,1902621,1.902621
6440,4800,340,1632000,2,51526,12883,1,277868800,277868800,19321,6440,12881,6440,0,1,6442,2029830,2.02983
6840,4800,340,1632000,2,54726,13683,1,294316800,294316800,20521,6840,13681,6840,0,1,6842,2192699,2.192699
55,1305,1265,1650825,2,446,113,1,14337400,14337400,166,55,111,55,0,1,57,34090,0.03409
455,1305,1265,1650825,2,3646,913,1,22561400,22561400,1366,455,911,455,0,1,457,158860,0.15886
855,1305,1265,1650825,2,6846,1713,1,30785400,30785400,2566,855,1711,855,0,1,857,108889,0.108889
1255,1305,1265,1650825,2,10046,2513,1,39009400,39009400,3766,1255,2511,1255,0,1,1257,417821,0.417821
1655,1305,1265,1650825,2,13246,3313,1,47233400,47233400,4966,1655,3311,1655,0,1,1657,91259,0.091259
2055,1305,1265,1650825,2,16446,4113,1,55457400,55457400,6166,2055,4111,2055,0,1,2057,676344,0.676344
2455,1305,1265,1650825,2,19646,4913,1,63681400,63681400,7366,2455,4911,2455,0,1,2457,809750,0.80975
2855,1305,1265,1650825,2,22846,5713,1,71905400,71905400,8566,2855,5711,2855,0,1,2857,771245,0.771245
3255,1305,1265,1650825,2,26046,6513,1,80129400,80129400,9766,3255,6511,3255,0,1,3257,1064787,1.064787
3655,1305,1265,1650825,2,29246,7313,1,88353400,88353400,10966,3655,7311,3655,0,1,3657,1193395,1.193395
4055,1305,1265,1650825,2,32446,8113,1,96577400,96577400,12166,4055,8111,4055,0,1,4057,12067,0.012067
4455,1305,1265,1650825,2,35646,8913,1,104801400,104801400,13366,4455,8911,4455,0,1,4457,1455780,1.45578
4855,1305,1265,1650825,2,38846,9713,1,113025400,113025400,14566,4855,9711,4855,0,1,4857,1587276,1.587276
5255,1305,1265,1650825,2,42046,10513,1,121249400,121249400,15766,5255,10511,5255,0,1,5257,1710006,1.710006
5655,1305,1265,1650825,2,45246,11313,1,129473400,129473400,16966,5655,11311,5655,0,1,5657,1433297,1.433297
6055,1305,1265,1650825,2,48446,12113,1,137697400,137697400,18166,6055,12111,6055,0,1,6057,261402,0.261402
6455,1305,1265,1650825,2,51646,12913,1,145921400,145921400,19366,6455,12911,6455,0,1,6457,1838802,1.838802
6855,1305,1265,1650825,2,54846,13713,1,154145400,154145400,20566,6855,13711,6855,0,1,6857,953795,0.953795
55,1055,1565,1651075,2,446,113,1,14361400,14361400,166,55,111,55,0,1,57,7334,0.007334
455,1055,1565,1651075,2,3646,913,1,22745400,22745400,1366,455,911,455,0,1,457,22221,0.022221
855,1055,1565,1651075,2,6846,1713,1,31129400,31129400,2566,855,1711,855,0,1,857,21490,0.02149
1255,1055,1565,1651075,2,10046,2513,1,39513400,39513400,3766,1255,2511,1255,0,1,1257,60223,0.060223
1655,1055,1565,1651075,2,13246,3313,1,47897400,47897400,4966,1655,3311,1655,0,1,1657,90376,0.090376
2055,1055,1565,1651075,2,16446,4113,1,56281400,56281400,6166,2055,4111,2055,0,1,2057,143626,0.143626
2455,1055,1565,1651075,2,19646,4913,1,64665400,64665400,7366,2455,4911,2455,0,1,2457,330315,0.330315
2855,1055,1565,1651075,2,22846,5713,1,73049400,73049400,8566,2855,5711,2855,0,1,2857,444273,0.444273
3255,1055,1565,1651075,2,26046,6513,1,81433400,81433400,9766,3255,6511,3255,0,1,3257,906764,0.906764
3655,1055,1565,1651075,2,29246,7313,1,89817400,89817400,10966,3655,7311,3655,0,1,3657,108812,0.108812
4055,1055,1565,1651075,2,32446,8113,1,98201400,98201400,12166,4055,8111,4055,0,1,4057,501733,0.501733
4455,1055,1565,1651075,2,35646,8913,1,106585400,106585400,13366,4455,8911,4455,0,1,4457,548838,0.548838
4855,1055,1565,1651075,2,38846,9713,1,114969400,114969400,14566,4855,9711,4855,0,1,4857,728653,0.728653
5255,1055,1565,1651075,2,42046,10513,1,123353400,123353400,15766,5255,10511,5255,0,1,5257,996189,0.996189
5655,1055,1565,1651075,2,45246,11313,1,131737400,131737400,16966,5655,11311,5655,0,1,5657,1444233,1.444233
6055,1055,1565,1651075,2,48446,12113,1,140121400,140121400,18166,6055,12111,6055,0,1,6057,101794,0.101794
6455,1055,1565,1651075,2,51646,12913,1,148505400,148505400,19366,6455,12911,6455,0,1,6457,357292,0.357292
6855,1055,1565,1651075,2,54846,13713,1,156889400,156889400,20566,6855,13711,6855,0,1,6857,38509,0.038509
55,4555,365,1662575,2,446,113,1,15465400,15465400,166,55,111,55,0,1,57,34551,0.034551
455,4555,365,1662575,2,3646,913,1,31209400,31209400,1366,455,911,455,0,1,457,156401,0.156401
855,4555,365,1662575,2,6846,1713,1,46953400,46953400,2566,855,1711,855,0,1,857,282709,0.282709
1255,4555,365,1662575,2,10046,2513,1,62697400,62697400,3766,1255,2511,1255,0,1,1257,410749,0.410749
1655,4555,365,1662575,2,13246,3313,1,78441400,78441400,4966,1655,3311,1655,0,1,1657,12352,0.012352
2055,4555,365,1662575,2,16446,4113,1,94185400,94185400,6166,2055,4111,2055,0,1,2057,647789,0.647789
2455,4555,365,1662575,2,19646,4913,1,109929400,109929400,7366,2455,4911,2455,0,1,2457,794994,0.794994
2855,4555,365,1662575,2,22846,5713,1,125673400,125673400,8566,2855,5711,2855,0,1,2857,924001,0.924001
3255,4555,365,1662575,2,26046,6513,1,141417400,141417400,9766,3255,6511,3255,0,1,3257,1053169,1.053169
3655,4555,365,1662575,2,29246,7313,1,157161400,157161400,10966,3655,7311,3655,0,1,3657,15119,0.015119
4055,4555,365,1662575,2,32446,8113,1,172905400,172905400,12166,4055,8111,4055,0,1,4057,1005132,1.005132
4455,4555,365,1662575,2,35646,8913,1,188649400,188649400,13366,4455,8911,4455,0,1,4457,1438851,1.438851
4855,4555,365,1662575,2,38846,9713,1,204393400,204393400,14566,4855,9711,4855,0,1,4857,1010839,1.010839
5255,4555,365,1662575,2,42046,10513,1,220137400,220137400,15766,5255,10511,5255,0,1,5257,387136,0.387136
5655,4555,365,1662575,2,45246,11313,1,235881400,235881400,16966,5655,11311,5655,0,1,5657,1842661,1.842661
6055,4555,365,1662575,2,48446,12113,1,251625400,251625400,18166,6055,12111,6055,0,1,6057,1111230,1.11123
6455,4555,365,1662575,2,51646,12913,1,267369400,267369400,19366,6455,12911,6455,0,1,6457,459591,0.459591
6855,4555,365,1662575,2,54846,13713,1,283113400,283113400,20566,6855,13711,6855,0,1,6857,1680988,1.680988
55,305,5465,1666825,2,446,113,1,15873400,15873400,166,55,111,55,0,1,57,36588,0.036588
455,305,5465,1666825,2,3646,913,1,34337400,34337400,1366,455,911,455,0,1,457,103267,0.103267
855,305,5465,1666825,2,6846,1713,1,52801400,52801400,2566,855,1711,855,0,1,857,183206,0.183206
1255,305,5465,1666825,2,10046,2513,1,71265400,71265400,3766,1255,2511,1255,0,1,1257,398878,0.398878
1655,305,5465,1666825,2,13246,3313,1,89729400,89729400,4966,1655,3311,1655,0,1,1657,124399,0.124399
2055,305,5465,1666825,2,16446,4113,1,108193400,108193400,6166,2055,4111,2055,0,1,2057,103090,0.10309
2455,305,5465,1666825,2,19646,4913,1,126657400,126657400,7366,2455,4911,2455,0,1,2457,822678,0.822678
2855,305,5465,1666825,2,22846,5713,1,145121400,145121400,8566,2855,5711,2855,0,1,2857,506689,0.506689
3255,305,5465,1666825,2,26046,6513,1,163585400,163585400,9766,3255,6511,3255,0,1,3257,344814,0.344814
3655,305,5465,1666825,2,29246,7313,1,182049400,182049400,10966,3655,7311,3655,0,1,3657,59577,0.059577
4055,305,5465,1666825,2,32446,8113,1,200513400,200513400,12166,4055,8111,4055,0,1,4057,436990,0.43699
4455,305,5465,1666825,2,35646,8913,1,218977400,218977400,13366,4455,8911,4455,0,1,4457,344835,0.344835
4855,305,5465,1666825,2,38846,9713,1,237441400,237441400,14566,4855,9711,4855,0,1,4857,240195,0.240195
5255,305,5465,1666825,2,42046,10513,1,255905400,255905400,15766,5255,10511,5255,0,1,5257,1459163,1.459163
5655,305,5465,1666825,2,45246,11313,1,274369400,274369400,16966,5655,11311,5655,0,1,5657,412310,0.41231
6055,305,5465,1666825,2,48446,12113,1,292833400,292833400,18166,6055,12111,6055,0,1,6057,288224,0.288224
6455,305,5465,1666825,2,51646,12913,1,311297400,311297400,19366,6455,12911,6455,0,1,6457,1027873,1.027873
6855,305,5465,1666825,2,54846,13713,1,329761400,329761400,20566,6855,13711,6855,0,1,6857,341946,0.341946
40,550,3040,1672000,2,326,83,1,14524800,14524800,121,40,81,40,0,1,42,31146,0.031146
440,550,3040,1672000,2,3526,883,1,26012800,26012800,1321,440,881,440,0,1,442,150635,0.150635
840,550,3040,1672000,2,6726,1683,1,37500800,37500800,2521,840,1681,840,0,1,842,273078,0.273078
1240,550,3040,1672000,2,9926,2483,1,48988800,48988800,3721,1240,2481,1240,0,1,1242,400318,0.400318
1640,550,3040,1672000,2,13126,3283,1,60476800,60476800,4921,1640,3281,1640,0,1,1642,521058,0.521058
2040,550,3040,1672000,2,16326,4083,1,71964800,71964800,6121,2040,4081,2040,0,1,2042,130658,0.130658
2440,550,3040,1672000,2,19526,4883,1,83452800,83452800,7321,2440,4881,2440,0,1,2442,767753,0.767753
2840,550,3040,1672000,2,22726,5683,1,94940800,94940800,8521,2840,5681,2840,0,1,2842,893523,0.893523
3240,550,3040,1672000,2,25926,6483,1,106428800,106428800,9721,3240,6481,3240,0,1,3242,1016785,1.016785
3640,550,3040,1672000,2,29126,7283,1,117916800,117916800,10921,3640,7281,3640,0,1,3642,1143278,1.143278
4040,550,3040,1672000,2,32326,8083,1,129404800,129404800,12121,4040,8081,4040,0,1,4042,234826,0.234826
4440,550,3040,1672000,2,35526,8883,1,140892800,140892800,13321,4440,8881,4440,0,1,4442,604024,0.604024
4840,550,3040,1672000,2,38726,9683,1,152380800,152380800,14521,4840,9681,4840,0,1,4842,781827,0.781827
5240,550,3040,1672000,2,41926,10483,1,163868800,163868800,15721,5240,10481,5240,0,1,5242,1640321,1.640321
5640,550,3040,1672000,2,45126,11283,1,175356800,175356800,16921,5640,11281,5640,0,1,5642,143059,0.143059
6040,550,3040,1672000,2,48326,12083,1,186844800,186844800,18121,6040,12081,6040,0,1,6042,955339,0.955339
6440,550,3040,1672000,2,51526,12883,1,198332800,198332800,19321,6440,12881,6440,0,1,6442,639257,0.639257
6840,550,3040,1672000,2,54726,13683,1,209820800,209820800,20521,6840,13681,6840,0,1,6842,274444,0.274444
40,1800,940,1692000,2,326,83,1,14412800,14412800,121,40,81,40,0,1,42,32208,0.032208
440,1800,940,1692000,2,3526,883,1,23180800,23180800,1321,440,881,440,0,1,442,156356,0.156356
840,1800,940,1692000,2,6726,1683,1,31948800,31948800,2521,840,1681,840,0,1,842,200825,0.200825
1240,1800,940,1692000,2,9926,2483,1,40716800,40716800,3721,1240,2481,1240,0,1,1242,420473,0.420473
1640,1800,940,1692000,2,13126,3283,1,49484800,49484800,4921,1640,3281,1640,0,1,1642,555661,0.555661
2040,1800,940,1692000,2,16326,4083,1,58252800,58252800,6121,2040,4081,2040,0,1,2042,682697,0.682697
2440,1800,940,1692000,2,19526,4883,1,67020800,67020800,7321,2440,4881,2440,0,1,2442,815272,0.815272
2840,1800,940,1692000,2,22726,5683,1,75788800,75788800,8521,2840,5681,2840,0,1,2842,799874,0.799874
3240,1800,940,1692000,2,25926,6483,1,84556800,84556800,9721,3240,6481,3240,0,1,3242,61708,0.061708
3640,1800,940,1692000,2,29126,7283,1,93324800,93324800,10921,3640,7281,3640,0,1,3642,414857,0.414857
4040,1800,940,1692000,2,32326,8083,1,102092800,102092800,12121,4040,8081,4040,0,1,4042,854919,0.854919
4440,1800,940,1692000,2,35526,8883,1,110860800,110860800,13321,4440,8881,4440,0,1,4442,1478266,1.478266
4840,1800,940,1692000,2,38726,9683,1,119628800,119628800,14521,4840,9681,4840,0,1,4842,1477118,1.477118
5240,1800,940,1692000,2,41926,10483,1,128396800,128396800,15721,5240,10481,5240,0,1,5242,1740192,1.740192
5640,1800,940,1692000,2,45126,11283,1,137164800,137164800,16921,5640,11281,5640,0,1,5642,1872943,1.872943
6040,1800,940,1692000,2,48326,12083,1,145932800,145932800,18121,6040,12081,6040,0,1,6042,317607,0.317607
6440,1800,940,1692000,2,51526,12883,1,154700800,154700800,19321,6440,12881,6440,0,1,6442,1802622,1.802622
6840,1800,940,1692000,2,54726,13683,1,163468800,163468800,20521,6840,13681,6840,0,1,6842,1196446,1.196446
55,2555,665,1699075,2,446,113,1,15009400,15009400,166,55,111,55,0,1,57,35202,0.035202
455,2555,665,1699075,2,3646,913,1,25313400,25313400,1366,455,911,455,0,1,457,158282,0.158282
855,2555,665,1699075,2,6846,1713,1,35617400,35617400,2566,855,1711,855,0,1,857,286810,0.28681
1255,2555,665,1699075,2,10046,2513,1,45921400,45921400,3766,1255,2511,1255,0,1,1257,415714,0.415714
1655,2555,665,1699075,2,13246,3313,1,56225400,56225400,4966,1655,3311,1655,0,1,1657,140811,0.140811
2055,2555,665,1699075,2,16446,4113,1,66529400,66529400,6166,2055,4111,2055,0,1,2057,673328,0.673328
2455,2555,665,1699075,2,19646,4913,1,76833400,76833400,7366,2455,4911,2455,0,1,2457,245631,0.245631
2855,2555,665,1699075,2,22846,5713,1,87137400,87137400,8566,2855,5711,2855,0,1,2857,956998,0.956998
3255,2555,665,1699075,2,26046,6513,1,97441400,97441400,9766,3255,6511,3255,0,1,3257,143462,0.143462
3655,2555,665,1699075,2,29246,7313,1,107745400,107745400,10966,3655,7311,3655,0,1,3657,1201632,1.201632
4055,2555,665,1699075,2,32446,8113,1,118049400,118049400,12166,4055,8111,4055,0,1,4057,1342416,1.342416
4455,2555,665,1699075,2,35646,8913,1,128353400,128353400,13366,4455,8911,4455,0,1,4457,1450878,1.450878
4855,2555,665,1699075,2,38846,9713,1,138657400,138657400,14566,4855,9711,4855,0,1,4857,1587248,1.587248
5255,2555,665,1699075,2,42046,10513,1,148961400,148961400,15766,5255,10511,5255,0,1,5257,1710066,1.710066
5655,2555,665,1699075,2,45246,11313,1,159265400,159265400,16966,5655,11311,5655,0,1,5657,1851771,1.851771
6055,2555,665,1699075,2,48446,12113,1,169569400,169569400,18166,6055,12111,6055,0,1,6057,1972350,1.97235
6455,2555,665,1699075,2,51646,12913,1,179873400,179873400,19366,6455,12911,6455,0,1,6457,434035,0.434035
6855,2555,665,1699075,2,54846,13713,1,190177400,190177400,20566,6855,13711,6855,0,1,6857,809098,0.809098
55,555,3065,1701075,2,446,113,1,15201400,15201400,166,55,111,55,0,1,57,36473,0.036473
455,555,3065,1701075,2,3646,913,1,26785400,26785400,1366,455,911,455,0,1,457,165567,0.165567
855,555,3065,1701075,2,6846,1713,1,38369400,38369400,2566,855,1711,855,0,1,857,94902,0.094902
1255,555,3065,1701075,2,10046,2513,1,49953400,49953400,3766,1255,2511,1255,0,1,1257,422651,0.422651
1655,555,3065,1701075,2,13246,3313,1,61537400,61537400,4966,1655,3311,1655,0,1,1657,176865,0.176865
2055,555,3065,1701075,2,16446,4113,1,73121400,73121400,6166,2055,4111,2055,0,1,2057,368639,0.368639
2455,555,3065,1701075,2,19646,4913,1,84705400,84705400,7366,2455,4911,2455,0,1,2457,816221,0.816221
2855,555,3065,1701075,2,22846,5713,1,96289400,96289400,8566,2855,5711,2855,0,1,2857,329471,0.329471
3255,555,3065,1701075,2,26046,6513,1,107873400,107873400,9766,3255,6511,3255,0,1,3257,1078410,1.07841
3655,555,3065,1701075,2,29246,7313,1,119457400,119457400,10966,3655,7311,3655,0,1,3657,515967,0.515967
4055,555,3065,1701075,2,32446,8113,1,131041400,131041400,12166,4055,8111,4055,0,1,4057,948426,0.948426
4455,555,3065,1701075,2,35646,8913,1,142625400,142625400,13366,4455,8911,4455,0,1,4457,1473057,1.473057
4855,555,3065,1701075,2,38846,9713,1,154209400,154209400,14566,4855,9711,4855,0,1,4857,1057908,1.057908
5255,555,3065,1701075,2,42046,10513,1,165793400,165793400,15766,5255,10511,5255,0,1,5257,823840,0.82384
5655,555,3065,1701075,2,45246,11313,1,177377400,177377400,16966,5655,11311,5655,0,1,5657,1867199,1.867199
6055,555,3065,1701075,2,48446,12113,1,188961400,188961400,18166,6055,12111,6055,0,1,6057,86525,0.086525
6455,555,3065,1701075,2,51646,12913,1,200545400,200545400,19366,6455,12911,6455,0,1,6457,353364,0.353364
6855,555,3065,1701075,2,54846,13713,1,212129400,212129400,20566,6855,13711,6855,0,1,6857,799880,0.79988
40,800,2140,1712000,2,326,83,1,14636800,14636800,121,40,81,40,0,1,42,30824,0.030824
440,800,2140,1712000,2,3526,883,1,24044800,24044800,1321,440,881,440,0,1,442,157157,0.157157
840,800,2140,1712000,2,6726,1683,1,33452800,33452800,2521,840,1681,840,0,1,842,286292,0.286292
1240,800,2140,1712000,2,9926,2483,1,42860800,42860800,3721,1240,2481,1240,0,1,1242,415391,0.415391
1640,800,2140,1712000,2,13126,3283,1,52268800,52268800,4921,1640,3281,1640,0,1,1642,545000,0.545
2040,800,2140,1712000,2,16326,4083,1,61676800,61676800,6121,2040,4081,2040,0,1,2042,674596,0.674596
2440,800,2140,1712000,2,19526,4883,1,71084800,71084800,7321,2440,4881,2440,0,1,2442,541928,0.541928
2840,800,2140,1712000,2,22726,5683,1,80492800,80492800,8521,2840,5681,2840,0,1,2842,933670,0.93367
3240,800,2140,1712000,2,25926,6483,1,89900800,89900800,9721,3240,6481,3240,0,1,3242,414916,0.414916
3640,800,2140,1712000,2,29126,7283,1,99308800,99308800,10921,3640,7281,3640,0,1,3642,294866,0.294866
4040,800,2140,1712000,2,32326,8083,1,108716800,108716800,12121,4040,8081,4040,0,1,4042,626237,0.626237
4440,800,2140,1712000,2,35526,8883,1,118124800,118124800,13321,4440,8881,4440,0,1,4442,158901,0.158901
4840,800,2140,1712000,2,38726,9683,1,127532800,127532800,14521,4840,9681,4840,0,1,4842,61348,0.061348
5240,800,2140,1712000,2,41926,10483,1,136940800,136940800,15721,5240,10481,5240,0,1,5242,1304763,1.304763
5640,800,2140,1712000,2,45126,11283,1,146348800,146348800,16921,5640,11281,5640,0,1,5642,1843854,1.843854
6040,800,2140,1712000,2,48326,12083,1,155756800,155756800,18121,6040,12081,6040,0,1,6042,1108032,1.108032
6440,800,2140,1712000,2,51526,12883,1,165164800,165164800,19321,6440,12881,6440,0,1,6442,957593,0.957593
6840,800,2140,1712000,2,54726,13683,1,174572800,174572800,20521,6840,13681,6840,0,1,6842,2242844,2.242844
40,5050,340,1717000,2,326,83,1,15460800,15460800,121,40,81,40,0,1,42,5747,0.005747
440,5050,340,1717000,2,3526,883,1,32708800,32708800,1321,440,881,440,0,1,442,10420,0.01042
840,5050,340,1717000,2,6726,1683,1,49956800,49956800,2521,840,1681,840,0,1,842,49092,0.049092
1240,5050,340,1717000,2,9926,2483,1,67204800,67204800,3721,1240,2481,1240,0,1,1242,11126,0.011126
1640,5050,340,1717000,2,13126,3283,1,84452800,84452800,4921,1640,3281,1640,0,1,1642,557241,0.557241
2040,5050,340,1717000,2,16326,4083,1,101700800,101700800,6121,2040,4081,2040,0,1,2042,66996,0.066996
2440,5050,340,1717000,2,19526,4883,1,118948800,118948800,7321,2440,4881,2440,0,1,2442,831235,0.831235
2840,5050,340,1717000,2,22726,5683,1,136196800,136196800,8521,2840,5681,2840,0,1,2842,979484,0.979484
3240,5050,340,1717000,2,25926,6483,1,153444800,153444800,9721,3240,6481,3240,0,1,3242,210939,0.210939
3640,5050,340,1717000,2,29126,7283,1,170692800,170692800,10921,3640,7281,3640,0,1,3642,1249940,1.24994
4040,5050,340,1717000,2,32326,8083,1,187940800,187940800,12121,4040,8081,4040,0,1,4042,1393082,1.393082
4440,5050,340,1717000,2,35526,8883,1,205188800,205188800,13321,4440,8881,4440,0,1,4442,192298,0.192298
4840,5050,340,1717000,2,38726,9683,1,222436800,222436800,14521,4840,9681,4840,0,1,4842,1709669,1.709669
5240,5050,340,1717000,2,41926,10483,1,239684800,239684800,15721,5240,10481,5240,0,1,5242,437294,0.437294
5640,5050,340,1717000,2,45126,11283,1,256932800,256932800,16921,5640,11281,5640,0,1,5642,183044,0.183044
6040,5050,340,1717000,2,48326,12083,1,274180800,274180800,18121,6040,12081,6040,0,1,6042,1657209,1.657209
6440,5050,340,1717000,2,51526,12883,1,291428800,291428800,19321,6440,12881,6440,0,1,6442,239207,0.239207
6840,5050,340,1717000,2,54726,13683,1,308676800,308676800,20521,6840,13681,6840,0,1,6842,582129,0.582129
40,300,5740,1722000,2,326,83,1,15708800,15708800,121,40,81,40,0,1,42,32975,0.032975
440,300,5740,1722000,2,3526,883,1,35036800,35036800,1321,440,881,440,0,1,442,154667,0.154667
840,300,5740,1722000,2,6726,1683,1,54364800,54364800,2521,840,1681,840,0,1,842,9364,0.009364
1240,300,5740,1722000,2,9926,2483,1,73692800,73692800,3721,1240,2481,1240,0,1,1242,278514,0.278514
1640,300,5740,1722000,2,13126,3283,1,93020800,93020800,4921,1640,3281,1640,0,1,1642,468022,0.468022
2040,300,5740,1722000,2,16326,4083,1,112348800,112348800,6121,2040,4081,2040,0,1,2042,690853,0.690853
2440,300,5740,1722000,2,19526,4883,1,131676800,131676800,7321,2440,4881,2440,0,1,2442,56522,0.056522
2840,300,5740,1722000,2,22726,5683,1,151004800,151004800,8521,2840,5681,2840,0,1,2842,485808,0.485808
3240,300,5740,1722000,2,25926,6483,1,170332800,170332800,9721,3240,6481,3240,0,1,3242,66827,0.066827
3640,300,5740,1722000,2,29126,7283,1,189660800,189660800,10921,3640,7281,3640,0,1,3642,1228401,1.228401
4040,300,5740,1722000,2,32326,8083,1,208988800,208988800,12121,4040,8081,4040,0,1,4042,771996,0.771996
4440,300,5740,1722000,2,35526,8883,1,228316800,228316800,13321,4440,8881,4440,0,1,4442,483581,0.483581
4840,300,5740,1722000,2,38726,9683,1,247644800,247644800,14521,4840,9681,4840,0,1,4842,171346,0.171346
5240,300,5740,1722000,2,41926,10483,1,266972800,266972800,15721,5240,10481,5240,0,1,5242,912036,0.912036
5640,300,5740,1722000,2,45126,11283,1,286300800,286300800,16921,5640,11281,5640,0,1,5642,287044,0.287044
6040,300,5740,1722000,2,48326,12083,1,305628800,305628800,18121,6040,12081,6040,0,1,6042,436024,0.436024
6440,300,5740,1722000,2,51526,12883,1,324956800,324956800,19321,6440,12881,6440,0,1,6442,824305,0.824305
6840,300,5740,1722000,2,54726,13683,1,344284800,344284800,20521,6840,13681,6840,0,1,6842,1899607,1.899607
55,1805,965,1741825,2,446,113,1,15153400,15153400,166,55,111,55,0,1,57,37568,0.037568
455,1805,965,1741825,2,3646,913,1,24017400,24017400,1366,455,911,455,0,1,457,167020,0.16702
855,1805,965,1741825,2,6846,1713,1,32881400,32881400,2566,855,1711,855,0,1,857,204847,0.204847
1255,1805,965,1741825,2,10046,2513,1,41745400,41745400,3766,1255,2511,1255,0,1,1257,441655,0.441655
1655,1805,965,1741825,2,13246,3313,1,50609400,50609400,4966,1655,3311,1655,0,1,1657,578779,0.578779
2055,1805,965,1741825,2,16446,4113,1,59473400,59473400,6166,2055,4111,2055,0,1,2057,564000,0.564
2455,1805,965,1741825,2,19646,4913,1,68337400,68337400,7366,2455,4911,2455,0,1,2457,94236,0.094236
2855,1805,965,1741825,2,22846,5713,1,77201400,77201400,8566,2855,5711,2855,0,1,2857,988149,0.988149
3255,1805,965,1741825,2,26046,6513,1,86065400,86065400,9766,3255,6511,3255,0,1,3257,1123011,1.123011
3655,1805,965,1741825,2,29246,7313,1,94929400,94929400,10966,3655,7311,3655,0,1,3657,79070,0.07907
4055,1805,965,1741825,2,32446,8113,1,103793400,103793400,12166,4055,8111,4055,0,1,4057,1050758,1.050758
4455,1805,965,1741825,2,35646,8913,1,112657400,112657400,13366,4455,8911,4455,0,1,4457,1538786,1.538786
4855,1805,965,1741825,2,38846,9713,1,121521400,121521400,14566,4855,9711,4855,0,1,4857,1674743,1.674743
5255,1805,965,1741825,2,42046,10513,1,130385400,130385400,15766,5255,10511,5255,0,1,5257,1817630,1.81763
5655,1805,965,1741825,2,45246,11313,1,139249400,139249400,16966,5655,11311,5655,0,1,5657,1947159,1.947159
6055,1805,965,1741825,2,48446,12113,1,148113400,148113400,18166,6055,12111,6055,0,1,6057,2097353,2.097353
6455,1805,965,1741825,2,51646,12913,1,156977400,156977400,19366,6455,12911,6455,0,1,6457,146131,0.146131
6855,1805,965,1741825,2,54846,13713,1,165841400,165841400,20566,6855,13711,6855,0,1,6857,1637971,1.637971
55,805,2165,1742825,2,446,113,1,15249400,15249400,166,55,111,55,0,1,57,37222,0.037222
455,805,2165,1742825,2,3646,913,1,24753400,24753400,1366,455,911,455,0,1,457,167479,0.167479
855,805,2165,1742825,2,6846,1713,1,34257400,34257400,2566,855,1711,855,0,1,857,300602,0.300602
1255,805,2165,1742825,2,10046,2513,1,43761400,43761400,3766,1255,2511,1255,0,1,1257,430410,0.43041
1655,805,2165,1742825,2,13246,3313,1,53265400,53265400,4966,1655,3311,1655,0,1,1657,564516,0.564516
2055,805,2165,1742825,2,16446,4113,1,62769400,62769400,6166,2055,4111,2055,0,1,2057,697004,0.697004
2455,805,2165,1742825,2,19646,4913,1,72273400,72273400,7366,2455,4911,2455,0,1,2457,326148,0.326148
2855,805,2165,1742825,2,22846,5713,1,81777400,81777400,8566,2855,5711,2855,0,1,2857,964944,0.964944
3255,805,2165,1742825,2,26046,6513,1,91281400,91281400,9766,3255,6511,3255,0,1,3257,1098535,1.098535
3655,805,2165,1742825,2,29246,7313,1,100785400,100785400,10966,3655,7311,3655,0,1,3657,331164,0.331164
4055,805,2165,1742825,2,32446,8113,1,110289400,110289400,12166,4055,8111,4055,0,1,4057,663896,0.663896
4455,805,2165,1742825,2,35646,8913,1,119793400,119793400,13366,4455,8911,4455,0,1,4457,963882,0.963882
4855,805,2165,1742825,2,38846,9713,1,129297400,129297400,14566,4855,9711,4855,0,1,4857,1638837,1.638837
5255,805,2165,1742825,2,42046,10513,1,138801400,138801400,15766,5255,10511,5255,0,1,5257,636264,0.636264
5655,805,2165,1742825,2,45246,11313,1,148305400,148305400,16966,5655,11311,5655,0,1,5657,1058639,1.058639
6055,805,2165,1742825,2,48446,12113,1,157809400,157809400,18166,6055,12111,6055,0,1,6057,1136057,1.136057
6455,805,2165,1742825,2,51646,12913,1,167313400,167313400,19366,6455,12911,6455,0,1,6457,69079,0.069079
6855,805,2165,1742825,2,54846,13713,1,176817400,176817400,20566,6855,13711,6855,0,1,6857,1047366,1.047366
55,4805,365,1753825,2,446,113,1,16305400,16305400,166,55,111,55,0,1,57,35317,0.035317
455,4805,365,1753825,2,3646,913,1,32849400,32849400,1366,455,911,455,0,1,457,159302,0.159302
855,4805,365,1753825,2,6846,1713,1,49393400,49393400,2566,855,1711,855,0,1,857,297015,0.297015
1255,4805,365,1753825,2,10046,2513,1,65937400,65937400,3766,1255,2511,1255,0,1,1257,435275,0.435275
1655,4805,365,1753825,2,13246,3313,1,82481400,82481400,4966,1655,3311,1655,0,1,1657,565508,0.565508
2055,4805,365,1753825,2,16446,4113,1,99025400,99025400,6166,2055,4111,2055,0,1,2057,698713,0.698713
2455,4805,365,1753825,2,19646,4913,1,115569400,115569400,7366,2455,4911,2455,0,1,2457,839025,0.839025
2855,4805,365,1753825,2,22846,5713,1,132113400,132113400,8566,2855,5711,2855,0,1,2857,975336,0.975336
3255,4805,365,1753825,2,26046,6513,1,148657400,148657400,9766,3255,6511,3255,0,1,3257,210132,0.210132
3655,4805,365,1753825,2,29246,7313,1,165201400,165201400,10966,3655,7311,3655,0,1,3657,1247467,1.247467
4055,4805,365,1753825,2,32446,8113,1,181745400,181745400,12166,4055,8111,4055,0,1,4057,1385625,1.385625
4455,4805,365,1753825,2,35646,8913,1,198289400,198289400,13366,4455,8911,4455,0,1,4457,1523921,1.523921
4855,4805,365,1753825,2,38846,9713,1,214833400,214833400,14566,4855,9711,4855,0,1,4857,1666613,1.666613
5255,4805,365,1753825,2,42046,10513,1,231377400,231377400,15766,5255,10511,5255,0,1,5257,1801637,1.801637
5655,4805,365,1753825,2,45246,11313,1,247921400,247921400,16966,5655,11311,5655,0,1,5657,1961589,1.961589
6055,4805,365,1753825,2,48446,12113,1,264465400,264465400,18166,6055,12111,6055,0,1,6057,2126917,2.126917
6455,4805,365,1753825,2,51646,12913,1,281009400,281009400,19366,6455,12911,6455,0,1,6457,2198167,2.198167
6855,4805,365,1753825,2,54846,13713,1,297553400,297553400,20566,6855,13711,6855,0,1,6857,2376162,2.376162
55,305,5765,1758325,2,446,113,1,16737400,16737400,166,55,111,55,0,1,57,38533,0.038533
455,305,5765,1758325,2,3646,913,1,36161400,36161400,1366,455,911,455,0,1,457,171069,0.171069
855,305,5765,1758325,2,6846,1713,1,55585400,55585400,2566,855,1711,855,0,1,857,12756,0.012756
1255,305,5765,1758325,2,10046,2513,1,75009400,75009400,3766,1255,2511,1255,0,1,1257,242691,0.242691
1655,305,5765,1758325,2,13246,3313,1,94433400,94433400,4966,1655,3311,1655,0,1,1657,270152,0.270152
2055,305,5765,1758325,2,16446,4113,1,113857400,113857400,6166,2055,4111,2055,0,1,2057,403650,0.40365
2455,305,5765,1758325,2,19646,4913,1,133281400,133281400,7366,2455,4911,2455,0,1,2457,677659,0.677659
2855,305,5765,1758325,2,22846,5713,1,152705400,152705400,8566,2855,5711,2855,0,1,2857,896587,0.896587
3255,305,5765,1758325,2,26046,6513,1,172129400,172129400,9766,3255,6511,3255,0,1,3257,172657,0.172657
3655,305,5765,1758325,2,29246,7313,1,191553400,191553400,10966,3655,7311,3655,0,1,3657,63630,0.06363
4055,305,5765,1758325,2,32446,8113,1,210977400,210977400,12166,4055,8111,4055,0,1,4057,598883,0.598883
4455,305,5765,1758325,2,35646,8913,1,230401400,230401400,13366,4455,8911,4455,0,1,4457,481430,0.48143
4855,305,5765,1758325,2,38846,9713,1,249825400,249825400,14566,4855,9711,4855,0,1,4857,522361,0.522361
5255,305,5765,1758325,2,42046,10513,1,269249400,269249400,15766,5255,10511,5255,0,1,5257,914507,0.914507
5655,305,5765,1758325,2,45246,11313,1,288673400,288673400,16966,5655,11311,5655,0,1,5657,1143441,1.143441
6055,305,5765,1758325,2,48446,12113,1,308097400,308097400,18166,6055,12111,6055,0,1,6057,468648,0.468648
6455,305,5765,1758325,2,51646,12913,1,327521400,327521400,19366,6455,12911,6455,0,1,6457,187603,0.187603
6855,305,5765,1758325,2,54846,13713,1,346945400,346945400,20566,6855,13711,6855,0,1,6857,1042426,1.042426
35,1140,1545,1761300,2,286,73,1,14842200,14842200,106,35,71,35,0,1,37,42027,0.042027
535,1140,1545,1761300,2,4286,1073,1,25582200,25582200,1606,535,1071,535,0,1,537,194266,0.194266
1035,1140,1545,1761300,2,8286,2073,1,36322200,36322200,3106,1035,2071,1035,0,1,1037,361488,0.361488
1535,1140,1545,1761300,2,12286,3073,1,47062200,47062200,4606,1535,3071,1535,0,1,1537,524184,0.524184
2035,1140,1545,1761300,2,16286,4073,1,57802200,57802200,6106,2035,4071,2035,0,1,2037,693592,0.693592
2535,1140,1545,1761300,2,20286,5073,1,68542200,68542200,7606,2535,5071,2535,0,1,2537,858956,0.858956
3035,1140,1545,1761300,2,24286,6073,1,79282200,79282200,9106,3035,6071,3035,0,1,3037,1031072,1.031072
3535,1140,1545,1761300,2,28286,7073,1,90022200,90022200,10606,3535,7071,3535,0,1,3537,1194716,1.194716
4035,1140,1545,1761300,2,32286,8073,1,100762200,100762200,12106,4035,8071,4035,0,1,4037,1364293,1.364293
39,1143,1541,1761363,2,318,81,1,14928312,14928312,118,39,79,39,0,1,41,2879,0.002879
539,1143,1541,1761363,2,4318,1081,1,25664312,25664312,1618,539,1079,539,0,1,541,4065,0.004065
1039,1143,1541,1761363,2,8318,2081,1,36400312,36400312,3118,1039,2079,1039,0,1,1041,56465,0.056465
1539,1143,1541,1761363,2,12318,3081,1,47136312,47136312,4618,1539,3079,1539,0,1,1541,116162,0.116162
2039,1143,1541,1761363,2,16318,4081,1,57872312,57872312,6118,2039,4079,2039,0,1,2041,2838,0.002838
2539,1143,1541,1761363,2,20318,5081,1,68608312,68608312,7618,2539,5079,2539,0,1,2541,282502,0.282502
3039,1143,1541,1761363,2,24318,6081,1,79344312,79344312,9118,3039,6079,3039,0,1,3041,804294,0.804294
3539,1143,1541,1761363,2,28318,7081,1,90080312,90080312,10618,3539,7079,3539,0,1,3541,665848,0.665848
4039,1143,1541,1761363,2,32318,8081,1,100816312,100816312,12118,4039,8079,4039,0,1,4041,22900,0.0229
4539,1143,1541,1761363,2,36318,9081,1,111552312,111552312,13618,4539,9079,4539,0,1,4541,714302,0.714302
5039,1143,1541,1761363,2,40318,10081,1,122288312,122288312,15118,5039,10079,5039,0,1,5041,8426,0.008426
5539,1143,1541,1761363,2,44318,11081,1,133024312,133024312,16618,5539,11079,5539,0,1,5541,467281,0.467281
6039,1143,1541,1761363,2,48318,12081,1,143760312,143760312,18118,6039,12079,6039,0,1,6041,1007723,1.007723
6539,1143,1541,1761363,2,52318,13081,1,154496312,154496312,19618,6539,13079,6539,0,1,6541,2235479,2.235479
7039,1143,1541,1761363,2,56318,14081,1,165232312,165232312,21118,7039,14079,7039,0,1,7041,2459753,2.459753
39,1693,1041,1762413,2,318,81,1,14952312,14952312,118,39,79,39,0,1,41,32225,0.032225
539,1693,1041,1762413,2,4318,1081,1,25888312,25888312,1618,539,1079,539,0,1,541,198037,0.198037
1039,1693,1041,1762413,2,8318,2081,1,36824312,36824312,3118,1039,2079,1039,0,1,1041,371565,0.371565
1539,1693,1041,1762413,2,12318,3081,1,47760312,47760312,4618,1539,3079,1539,0,1,1541,13717,0.013717
2039,1693,1041,1762413,2,16318,4081,1,58696312,58696312,6118,2039,4079,2039,0,1,2041,720359,0.720359
2539,1693,1041,1762413,2,20318,5081,1,69632312,69632312,7618,2539,5079,2539,0,1,2541,895290,0.89529
3039,1693,1041,1762413,2,24318,6081,1,80568312,80568312,9118,3039,6079,3039,0,1,3041,1069932,1.069932
3539,1693,1041,1762413,2,28318,7081,1,91504312,91504312,10618,3539,7079,3539,0,1,3541,721345,0.721345
4039,1693,1041,1762413,2,32318,8081,1,102440312,102440312,12118,4039,8079,4039,0,1,4041,668700,0.6687
4539,1693,1041,1762413,2,36318,9081,1,113376312,113376312,13618,4539,9079,4539,0,1,4541,1590707,1.590707
5039,1693,1041,1762413,2,40318,10081,1,124312312,124312312,15118,5039,10079,5039,0,1,5041,337923,0.337923
5539,1693,1041,1762413,2,44318,11081,1,135248312,135248312,16618,5539,11079,5539,0,1,5541,1549014,1.549014
6039,1693,1041,1762413,2,48318,12081,1,146184312,146184312,18118,6039,12079,6039,0,1,6041,272456,0.272456
6539,1693,1041,1762413,2,52318,13081,1,157120312,157120312,19618,6539,13079,6539,0,1,6541,2300010,2.30001
7039,1693,1041,1762413,2,56318,14081,1,168056312,168056312,21118,7039,14079,7039,0,1,7041,105329,0.105329
40,2800,640,1792000,2,326,83,1,15436800,15436800,121,40,81,40,0,1,42,32360,0.03236
440,2800,640,1792000,2,3526,883,1,26444800,26444800,1321,440,881,440,0,1,442,159516,0.159516
840,2800,640,1792000,2,6726,1683,1,37452800,37452800,2521,840,1681,840,0,1,842,288043,0.288043
1240,2800,640,1792000,2,9926,2483,1,48460800,48460800,3721,1240,2481,1240,0,1,1242,417725,0.417725
1640,2800,640,1792000,2,13126,3283,1,59468800,59468800,4921,1640,3281,1640,0,1,1642,549410,0.54941
2040,2800,640,1792000,2,16326,4083,1,70476800,70476800,6121,2040,4081,2040,0,1,2042,686444,0.686444
2440,2800,640,1792000,2,19526,4883,1,81484800,81484800,7321,2440,4881,2440,0,1,2442,135572,0.135572
2840,2800,640,1792000,2,22726,5683,1,92492800,92492800,8521,2840,5681,2840,0,1,2842,529287,0.529287
3240,2800,640,1792000,2,25926,6483,1,103500800,103500800,9721,3240,6481,3240,0,1,3242,1083830,1.08383
3640,2800,640,1792000,2,29126,7283,1,114508800,114508800,10921,3640,7281,3640,0,1,3642,1020332,1.020332
4040,2800,640,1792000,2,32326,8083,1,125516800,125516800,12121,4040,8081,4040,0,1,4042,1357435,1.357435
4440,2800,640,1792000,2,35526,8883,1,136524800,136524800,13321,4440,8881,4440,0,1,4442,742331,0.742331
4840,2800,640,1792000,2,38726,9683,1,147532800,147532800,14521,4840,9681,4840,0,1,4842,1624930,1.62493
5240,2800,640,1792000,2,41926,10483,1,158540800,158540800,15721,5240,10481,5240,0,1,5242,11711,0.011711
5640,2800,640,1792000,2,45126,11283,1,169548800,169548800,16921,5640,11281,5640,0,1,5642,1882496,1.882496
6040,2800,640,1792000,2,48326,12083,1,180556800,180556800,18121,6040,12081,6040,0,1,6042,2022191,2.022191
6440,2800,640,1792000,2,51526,12883,1,191564800,191564800,19321,6440,12881,6440,0,1,6442,652791,0.652791
6840,2800,640,1792000,2,54726,13683,1,202572800,202572800,20521,6840,13681,6840,0,1,6842,834414,0.834414
44,1153,1555,1792915,2,358,91,1,15296536,15296536,133,44,89,44,0,1,46,2535,0.002535
544,1153,1555,1792915,2,4358,1091,1,26128536,26128536,1633,544,1089,544,0,1,546,11215,0.011215
1044,1153,1555,1792915,2,8358,2091,1,36960536,36960536,3133,1044,2089,1044,0,1,1046,103375,0.103375
1544,1153,1555,1792915,2,12358,3091,1,47792536,47792536,4633,1544,3089,1544,0,1,1546,227264,0.227264
2044,1153,1555,1792915,2,16358,4091,1,58624536,58624536,6133,2044,4089,2044,0,1,2046,23312,0.023312
2544,1153,1555,1792915,2,20358,5091,1,69456536,69456536,7633,2544,5089,2544,0,1,2546,333914,0.333914
3044,1153,1555,1792915,2,24358,6091,1,80288536,80288536,9133,3044,6089,3044,0,1,3046,478897,0.478897
3544,1153,1555,1792915,2,28358,7091,1,91120536,91120536,10633,3544,7089,3544,0,1,3546,50986,0.050986
4044,1153,1555,1792915,2,32358,8091,1,101952536,101952536,12133,4044,8089,4044,0,1,4046,188956,0.188956
4544,1153,1555,1792915,2,36358,9091,1,112784536,112784536,13633,4544,9089,4544,0,1,4546,1608451,1.608451
5044,1153,1555,1792915,2,40358,10091,1,123616536,123616536,15133,5044,10089,5044,0,1,5046,62659,0.062659
5544,1153,1555,1792915,2,44358,11091,1,134448536,134448536,16633,5544,11089,5544,0,1,5546,537863,0.537863
6044,1153,1555,1792915,2,48358,12091,1,145280536,145280536,18133,6044,12089,6044,0,1,6046,2165437,2.165437
6544,1153,1555,1792915,2,52358,13091,1,156112536,156112536,19633,6544,13089,6544,0,1,6546,464202,0.464202
7044,1153,1555,1792915,2,56358,14091,1,166944536,166944536,21133,7044,14089,7044,0,1,7046,2400031,2.400031
35,590,3045,1796550,2,286,73,1,15390200,15390200,106,35,71,35,0,1,37,8059,0.008059
535,590,3045,1796550,2,4286,1073,1,29930200,29930200,1606,535,1071,535,0,1,537,37386,0.037386
1035,590,3045,1796550,2,8286,2073,1,44470200,44470200,3106,1035,2071,1035,0,1,1037,59427,0.059427
1535,590,3045,1796550,2,12286,3073,1,59010200,59010200,4606,1535,3071,1535,0,1,1537,76206,0.076206
2035,590,3045,1796550,2,16286,4073,1,73550200,73550200,6106,2035,4071,2035,0,1,2037,115036,0.115036
2535,590,3045,1796550,2,20286,5073,1,88090200,88090200,7606,2535,5071,2535,0,1,2537,926966,0.926966
3035,590,3045,1796550,2,24286,6073,1,102630200,102630200,9106,3035,6071,3035,0,1,3037,1094520,1.09452
3535,590,3045,1796550,2,28286,7073,1,117170200,117170200,10606,3535,7071,3535,0,1,3537,1272454,1.272454
4035,590,3045,1796550,2,32286,8073,1,131710200,131710200,12106,4035,8071,4035,0,1,4037,1462504,1.462504
4535,590,3045,1796550,2,36286,9073,1,146250200,146250200,13606,4535,9071,4535,0,1,4537,1644505,1.644505
5035,590,3045,1796550,2,40286,10073,1,160790200,160790200,15106,5035,10071,5035,0,1,5037,1853663,1.853663
5535,590,3045,1796550,2,44286,11073,1,175330200,175330200,16606,5535,11071,5535,0,1,5537,2005313,2.005313
6035,590,3045,1796550,2,48286,12073,1,189870200,189870200,18106,6035,12071,6035,0,1,6037,2186682,2.186682
6535,590,3045,1796550,2,52286,13073,1,204410200,204410200,19606,6535,13071,6535,0,1,6537,2365459,2.365459
7035,590,3045,1796550,2,56286,14073,1,218950200,218950200,21106,7035,14071,7035,0,1,7037,2549321,2.549321
44,1703,1055,1796665,2,358,91,1,15344136,15344136,133,44,89,44,0,1,46,33758,0.033758
544,1703,1055,1796665,2,4358,1091,1,26376136,26376136,1633,544,1089,544,0,1,546,200672,0.200672
1044,1703,1055,1796665,2,8358,2091,1,37408136,37408136,3133,1044,2089,1044,0,1,1046,374356,0.374356
1544,1703,1055,1796665,2,12358,3091,1,48440136,48440136,4633,1544,3089,1544,0,1,1546,554756,0.554756
2044,1703,1055,1796665,2,16358,4091,1,59472136,59472136,6133,2044,4089,2044,0,1,2046,731989,0.731989
2544,1703,1055,1796665,2,20358,5091,1,70504136,70504136,7633,2544,5089,2544,0,1,2546,908412,0.908412
3044,1703,1055,1796665,2,24358,6091,1,81536136,81536136,9133,3044,6089,3044,0,1,3046,305451,0.305451
3544,1703,1055,1796665,2,28358,7091,1,92568136,92568136,10633,3544,7089,3544,0,1,3546,1259171,1.259171
4044,1703,1055,1796665,2,32358,8091,1,103600136,103600136,12133,4044,8089,4044,0,1,4046,1181810,1.18181
4544,1703,1055,1796665,2,36358,9091,1,114632136,114632136,13633,4544,9089,4544,0,1,4546,314271,0.314271
5044,1703,1055,1796665,2,40358,10091,1,125664136,125664136,15133,5044,10089,5044,0,1,5046,1753185,1.753185
5544,1703,1055,1796665,2,44358,11091,1,136696136,136696136,16633,5544,11089,5544,0,1,5546,842411,0.842411
6044,1703,1055,1796665,2,48358,12091,1,147728136,147728136,18133,6044,12089,6044,0,1,6046,2141356,2.141356
6544,1703,1055,1796665,2,52358,13091,1,158760136,158760136,19633,6544,13089,6544,0,1,6546,554808,0.554808
7044,1703,1055,1796665,2,56358,14091,1,169792136,169792136,21133,7044,14089,7044,0,1,7046,973988,0.973988
40,5300,340,1802000,2,326,83,1,16220800,16220800,121,40,81,40,0,1,42,33395,0.033395
440,5300,340,1802000,2,3526,883,1,34268800,34268800,1321,440,881,440,0,1,442,160745,0.160745
840,5300,340,1802000,2,6726,1683,1,52316800,52316800,2521,840,1681,840,0,1,842,297511,0.297511
1240,5300,340,1802000,2,9926,2483,1,70364800,70364800,3721,1240,2481,1240,0,1,1242,439657,0.439657
1640,5300,340,1802000,2,13126,3283,1,88412800,88412800,4921,1640,3281,1640,0,1,1642,31182,0.031182
2040,5300,340,1802000,2,16326,4083,1,106460800,106460800,6121,2040,4081,2040,0,1,2042,221355,0.221355
2440,5300,340,1802000,2,19526,4883,1,124508800,124508800,7321,2440,4881,2440,0,1,2442,82940,0.08294
2840,5300,340,1802000,2,22726,5683,1,142556800,142556800,8521,2840,5681,2840,0,1,2842,1018455,1.018455
3240,5300,340,1802000,2,25926,6483,1,160604800,160604800,9721,3240,6481,3240,0,1,3242,1166533,1.166533
3640,5300,340,1802000,2,29126,7283,1,178652800,178652800,10921,3640,7281,3640,0,1,3642,790096,0.790096
4040,5300,340,1802000,2,32326,8083,1,196700800,196700800,12121,4040,8081,4040,0,1,4042,1048364,1.048364
4440,5300,340,1802000,2,35526,8883,1,214748800,214748800,13321,4440,8881,4440,0,1,4442,1598635,1.598635
4840,5300,340,1802000,2,38726,9683,1,232796800,232796800,14521,4840,9681,4840,0,1,4842,457217,0.457217
5240,5300,340,1802000,2,41926,10483,1,250844800,250844800,15721,5240,10481,5240,0,1,5242,1910240,1.91024
5640,5300,340,1802000,2,45126,11283,1,268892800,268892800,16921,5640,11281,5640,0,1,5642,537115,0.537115
6040,5300,340,1802000,2,48326,12083,1,286940800,286940800,18121,6040,12081,6040,0,1,6042,2200838,2.200838
6440,5300,340,1802000,2,51526,12883,1,304988800,304988800,19321,6440,12881,6440,0,1,6442,74803,0.074803
6840,5300,340,1802000,2,54726,13683,1,323036800,323036800,20521,6840,13681,6840,0,1,6842,2515704,2.515704
39,593,3041,1803313,2,318,81,1,15560312,15560312,118,39,79,39,0,1,41,34943,0.034943
539,593,3041,1803313,2,4318,1081,1,30096312,30096312,1618,539,1079,539,0,1,541,200049,0.200049
1039,593,3041,1803313,2,8318,2081,1,44632312,44632312,3118,1039,2079,1039,0,1,1041,368257,0.368257
1539,593,3041,1803313,2,12318,3081,1,59168312,59168312,4618,1539,3079,1539,0,1,1541,135446,0.135446
2039,593,3041,1803313,2,16318,4081,1,73704312,73704312,6118,2039,4079,2039,0,1,2041,134077,0.134077
2539,593,3041,1803313,2,20318,5081,1,88240312,88240312,7618,2539,5079,2539,0,1,2541,757080,0.75708
3039,593,3041,1803313,2,24318,6081,1,102776312,102776312,9118,3039,6079,3039,0,1,3041,23343,0.023343
3539,593,3041,1803313,2,28318,7081,1,117312312,117312312,10618,3539,7079,3539,0,1,3541,790099,0.790099
4039,593,3041,1803313,2,32318,8081,1,131848312,131848312,12118,4039,8079,4039,0,1,4041,649444,0.649444
4539,593,3041,1803313,2,36318,9081,1,146384312,146384312,13618,4539,9079,4539,0,1,4541,430478,0.430478
5039,593,3041,1803313,2,40318,10081,1,160920312,160920312,15118,5039,10079,5039,0,1,5041,659375,0.659375
5539,593,3041,1803313,2,44318,11081,1,175456312,175456312,16618,5539,11079,5539,0,1,5541,417027,0.417027
6039,593,3041,1803313,2,48318,12081,1,189992312,189992312,18118,6039,12079,6039,0,1,6041,1704509,1.704509
6539,593,3041,1803313,2,52318,13081,1,204528312,204528312,19618,6539,13079,6539,0,1,6541,214400,0.2144
7039,593,3041,1803313,2,56318,14081,1,219064312,219064312,21118,7039,14079,7039,0,1,7041,509477,0.509477
39,3343,541,1808563,2,318,81,1,15680312,15680312,118,39,79,39,0,1,41,3712,0.003712
539,3343,541,1808563,2,4318,1081,1,31216312,31216312,1618,539,1079,539,0,1,541,30742,0.030742
1039,3343,541,1808563,2,8318,2081,1,46752312,46752312,3118,1039,2079,1039,0,1,1041,54316,0.054316
1539,3343,541,1808563,2,12318,3081,1,62288312,62288312,4618,1539,3079,1539,0,1,1541,395845,0.395845
2039,3343,541,1808563,2,16318,4081,1,77824312,77824312,6118,2039,4079,2039,0,1,2041,104374,0.104374
2539,3343,541,1808563,2,20318,5081,1,93360312,93360312,7618,2539,5079,2539,0,1,2541,769372,0.769372
3039,3343,541,1808563,2,24318,6081,1,108896312,108896312,9118,3039,6079,3039,0,1,3041,622502,0.622502
3539,3343,541,1808563,2,28318,7081,1,124432312,124432312,10618,3539,7079,3539,0,1,3541,1005095,1.005095
4039,3343,541,1808563,2,32318,8081,1,139968312,139968312,12118,4039,8079,4039,0,1,4041,820816,0.820816
4539,3343,541,1808563,2,36318,9081,1,155504312,155504312,13618,4539,9079,4539,0,1,4541,386298,0.386298
5039,3343,541,1808563,2,40318,10081,1,171040312,171040312,15118,5039,10079,5039,0,1,5041,1820909,1.820909
5539,3343,541,1808563,2,44318,11081,1,186576312,186576312,16618,5539,11079,5539,0,1,5541,1288356,1.288356
6039,3343,541,1808563,2,48318,12081,1,202112312,202112312,18118,6039,12079,6039,0,1,6041,2205323,2.205323
6539,3343,541,1808563,2,52318,13081,1,217648312,217648312,19618,6539,13079,6539,0,1,6541,96247,0.096247
7039,3343,541,1808563,2,56318,14081,1,233184312,233184312,21118,7039,14079,7039,0,1,7041,2545430,2.54543
40,300,6040,1812000,2,326,83,1,16524800,16524800,121,40,81,40,0,1,42,34525,0.034525
440,300,6040,1812000,2,3526,883,1,36812800,36812800,1321,440,881,440,0,1,442,178045,0.178045
840,300,6040,1812000,2,6726,1683,1,57100800,57100800,2521,840,1681,840,0,1,842,305835,0.305835
1240,300,6040,1812000,2,9926,2483,1,77388800,77388800,3721,1240,2481,1240,0,1,1242,160748,0.160748
1640,300,6040,1812000,2,13126,3283,1,97676800,97676800,4921,1640,3281,1640,0,1,1642,588153,0.588153
2040,300,6040,1812000,2,16326,4083,1,117964800,117964800,6121,2040,4081,2040,0,1,2042,90604,0.090604
2440,300,6040,1812000,2,19526,4883,1,138252800,138252800,7321,2440,4881,2440,0,1,2442,624121,0.624121
2840,300,6040,1812000,2,22726,5683,1,158540800,158540800,8521,2840,5681,2840,0,1,2842,734607,0.734607
3240,300,6040,1812000,2,25926,6483,1,178828800,178828800,9721,3240,6481,3240,0,1,3242,235482,0.235482
3640,300,6040,1812000,2,29126,7283,1,199116800,199116800,10921,3640,7281,3640,0,1,3642,285238,0.285238
4040,300,6040,1812000,2,32326,8083,1,219404800,219404800,12121,4040,8081,4040,0,1,4042,227145,0.227145
4440,300,6040,1812000,2,35526,8883,1,239692800,239692800,13321,4440,8881,4440,0,1,4442,472613,0.472613
4840,300,6040,1812000,2,38726,9683,1,259980800,259980800,14521,4840,9681,4840,0,1,4842,1097262,1.097262
5240,300,6040,1812000,2,41926,10483,1,280268800,280268800,15721,5240,10481,5240,0,1,5242,85007,0.085007
5640,300,6040,1812000,2,45126,11283,1,300556800,300556800,16921,5640,11281,5640,0,1,5642,244215,0.244215
6040,300,6040,1812000,2,48326,12083,1,320844800,320844800,18121,6040,12081,6040,0,1,6042,1337200,1.3372
6440,300,6040,1812000,2,51526,12883,1,341132800,341132800,19321,6440,12881,6440,0,1,6442,111678,0.111678
6840,300,6040,1812000,2,54726,13683,1,361420800,361420800,20521,6840,13681,6840,0,1,6842,1234234,1.234234
35,3340,545,1820300,2,286,73,1,15650200,15650200,106,35,71,35,0,1,37,46948,0.046948
535,3340,545,1820300,2,4286,1073,1,31190200,31190200,1606,535,1071,535,0,1,537,194790,0.19479
1035,3340,545,1820300,2,8286,2073,1,46730200,46730200,3106,1035,2071,1035,0,1,1037,368403,0.368403
1535,3340,545,1820300,2,12286,3073,1,62270200,62270200,4606,1535,3071,1535,0,1,1537,548993,0.548993
2035,3340,545,1820300,2,16286,4073,1,77810200,77810200,6106,2035,4071,2035,0,1,2037,714587,0.714587
40,550,3340,1837000,2,326,83,1,15940800,15940800,121,40,81,40,0,1,42,34837,0.034837
440,550,3340,1837000,2,3526,883,1,28388800,28388800,1321,440,881,440,0,1,442,169243,0.169243
840,550,3340,1837000,2,6726,1683,1,40836800,40836800,2521,840,1681,840,0,1,842,309353,0.309353
1240,550,3340,1837000,2,9926,2483,1,53284800,53284800,3721,1240,2481,1240,0,1,1242,447704,0.447704
1640,550,3340,1837000,2,13126,3283,1,65732800,65732800,4921,1640,3281,1640,0,1,1642,5412,0.005412
2040,550,3340,1837000,2,16326,4083,1,78180800,78180800,6121,2040,4081,2040,0,1,2042,727330,0.72733
2440,550,3340,1837000,2,19526,4883,1,90628800,90628800,7321,2440,4881,2440,0,1,2442,865440,0.86544
2840,550,3340,1837000,2,22726,5683,1,103076800,103076800,8521,2840,5681,2840,0,1,2842,867238,0.867238
3240,550,3340,1837000,2,25926,6483,1,115524800,115524800,9721,3240,6481,3240,0,1,3242,1032130,1.03213
3640,550,3340,1837000,2,29126,7283,1,127972800,127972800,10921,3640,7281,3640,0,1,3642,511666,0.511666
4040,550,3340,1837000,2,32326,8083,1,140420800,140420800,12121,4040,8081,4040,0,1,4042,1426068,1.426068
4440,550,3340,1837000,2,35526,8883,1,152868800,152868800,13321,4440,8881,4440,0,1,4442,1206607,1.206607
4840,550,3340,1837000,2,38726,9683,1,165316800,165316800,14521,4840,9681,4840,0,1,4842,618765,0.618765
5240,550,3340,1837000,2,41926,10483,1,177764800,177764800,15721,5240,10481,5240,0,1,5242,481303,0.481303
5640,550,3340,1837000,2,45126,11283,1,190212800,190212800,16921,5640,11281,5640,0,1,5642,1185998,1.185998
6040,550,3340,1837000,2,48326,12083,1,202660800,202660800,18121,6040,12081,6040,0,1,6042,1185955,1.185955
6440,550,3340,1837000,2,51526,12883,1,215108800,215108800,19321,6440,12881,6440,0,1,6442,375267,0.375267
6840,550,3340,1837000,2,54726,13683,1,227556800,227556800,20521,6840,13681,6840,0,1,6842,930863,0.930863
44,603,3055,1842165,2,358,91,1,16024936,16024936,133,44,89,44,0,1,46,38151,0.038151
544,603,3055,1842165,2,4358,1091,1,30656936,30656936,1633,544,1089,544,0,1,546,205539,0.205539
1044,603,3055,1842165,2,8358,2091,1,45288936,45288936,3133,1044,2089,1044,0,1,1046,44610,0.04461
1544,603,3055,1842165,2,12358,3091,1,59920936,59920936,4633,1544,3089,1544,0,1,1546,554272,0.554272
2044,603,3055,1842165,2,16358,4091,1,74552936,74552936,6133,2044,4089,2044,0,1,2046,8137,0.008137
2544,603,3055,1842165,2,20358,5091,1,89184936,89184936,7633,2544,5089,2544,0,1,2546,909795,0.909795
3044,603,3055,1842165,2,24358,6091,1,103816936,103816936,9133,3044,6089,3044,0,1,3046,521969,0.521969
3544,603,3055,1842165,2,28358,7091,1,118448936,118448936,10633,3544,7089,3544,0,1,3546,368934,0.368934
4044,603,3055,1842165,2,32358,8091,1,133080936,133080936,12133,4044,8089,4044,0,1,4046,37640,0.03764
4544,603,3055,1842165,2,36358,9091,1,147712936,147712936,13633,4544,9089,4544,0,1,4546,1008208,1.008208
5044,603,3055,1842165,2,40358,10091,1,162344936,162344936,15133,5044,10089,5044,0,1,5046,90200,0.0902
5544,603,3055,1842165,2,44358,11091,1,176976936,176976936,16633,5544,11089,5544,0,1,5546,1983058,1.983058
6044,603,3055,1842165,2,48358,12091,1,191608936,191608936,18133,6044,12089,6044,0,1,6046,2160700,2.1607
6544,603,3055,1842165,2,52358,13091,1,206240936,206240936,19633,6544,13089,6544,0,1,6546,2176764,2.176764
7044,603,3055,1842165,2,56358,14091,1,220872936,220872936,21133,7044,14089,7044,0,1,7046,104424,0.104424
55,5055,365,1845075,2,446,113,1,17145400,17145400,166,55,111,55,0,1,57,3751,0.003751
455,5055,365,1845075,2,3646,913,1,34489400,34489400,1366,455,911,455,0,1,457,22949,0.022949
855,5055,365,1845075,2,6846,1713,1,51833400,51833400,2566,855,1711,855,0,1,857,215899,0.215899
1255,5055,365,1845075,2,10046,2513,1,69177400,69177400,3766,1255,2511,1255,0,1,1257,50209,0.050209
1655,5055,365,1845075,2,13246,3313,1,86521400,86521400,4966,1655,3311,1655,0,1,1657,37221,0.037221
2055,5055,365,1845075,2,16446,4113,1,103865400,103865400,6166,2055,4111,2055,0,1,2057,758075,0.758075
2455,5055,365,1845075,2,19646,4913,1,121209400,121209400,7366,2455,4911,2455,0,1,2457,17365,0.017365
2855,5055,365,1845075,2,22846,5713,1,138553400,138553400,8566,2855,5711,2855,0,1,2857,295337,0.295337
3255,5055,365,1845075,2,26046,6513,1,155897400,155897400,9766,3255,6511,3255,0,1,3257,470068,0.470068
3655,5055,365,1845075,2,29246,7313,1,173241400,173241400,10966,3655,7311,3655,0,1,3657,1062194,1.062194
4055,5055,365,1845075,2,32446,8113,1,190585400,190585400,12166,4055,8111,4055,0,1,4057,337496,0.337496
4455,5055,365,1845075,2,35646,8913,1,207929400,207929400,13366,4455,8911,4455,0,1,4457,1643597,1.643597
4855,5055,365,1845075,2,38846,9713,1,225273400,225273400,14566,4855,9711,4855,0,1,4857,976178,0.976178
5255,5055,365,1845075,2,42046,10513,1,242617400,242617400,15766,5255,10511,5255,0,1,5257,54463,0.054463
5655,5055,365,1845075,2,45246,11313,1,259961400,259961400,16966,5655,11311,5655,0,1,5657,649110,0.64911
6055,5055,365,1845075,2,48446,12113,1,277305400,277305400,18166,6055,12111,6055,0,1,6057,2010825,2.010825
6455,5055,365,1845075,2,51646,12913,1,294649400,294649400,19366,6455,12911,6455,0,1,6457,312940,0.31294
6855,5055,365,1845075,2,54846,13713,1,311993400,311993400,20566,6855,13711,6855,0,1,6857,448241,0.448241
55,305,6065,1849825,2,446,113,1,17601400,17601400,166,55,111,55,0,1,57,40456,0.040456
455,305,6065,1849825,2,3646,913,1,37985400,37985400,1366,455,911,455,0,1,457,180028,0.180028
855,305,6065,1849825,2,6846,1713,1,58369400,58369400,2566,855,1711,855,0,1,857,138553,0.138553
1255,305,6065,1849825,2,10046,2513,1,78753400,78753400,3766,1255,2511,1255,0,1,1257,115805,0.115805
1655,305,6065,1849825,2,13246,3313,1,99137400,99137400,4966,1655,3311,1655,0,1,1657,174062,0.174062
2055,305,6065,1849825,2,16446,4113,1,119521400,119521400,6166,2055,4111,2055,0,1,2057,450103,0.450103
2455,305,6065,1849825,2,19646,4913,1,139905400,139905400,7366,2455,4911,2455,0,1,2457,38176,0.038176
2855,305,6065,1849825,2,22846,5713,1,160289400,160289400,8566,2855,5711,2855,0,1,2857,227146,0.227146
3255,305,6065,1849825,2,26046,6513,1,180673400,180673400,9766,3255,6511,3255,0,1,3257,411863,0.411863
3655,305,6065,1849825,2,29246,7313,1,201057400,201057400,10966,3655,7311,3655,0,1,3657,180003,0.180003
4055,305,6065,1849825,2,32446,8113,1,221441400,221441400,12166,4055,8111,4055,0,1,4057,246686,0.246686
4455,305,6065,1849825,2,35646,8913,1,241825400,241825400,13366,4455,8911,4455,0,1,4457,520951,0.520951
4855,305,6065,1849825,2,38846,9713,1,262209400,262209400,14566,4855,9711,4855,0,1,4857,357738,0.357738
5255,305,6065,1849825,2,42046,10513,1,282593400,282593400,15766,5255,10511,5255,0,1,5257,920442,0.920442
5655,305,6065,1849825,2,45246,11313,1,302977400,302977400,16966,5655,11311,5655,0,1,5657,568971,0.568971
6055,305,6065,1849825,2,48446,12113,1,323361400,323361400,18166,6055,12111,6055,0,1,6057,1481943,1.481943
6455,305,6065,1849825,2,51646,12913,1,343745400,343745400,19366,6455,12911,6455,0,1,6457,1700593,1.700593
6855,305,6065,1849825,2,54846,13713,1,364129400,364129400,20566,6855,13711,6855,0,1,6857,449524,0.449524
44,3353,555,1860915,2,358,91,1,16262936,16262936,133,44,89,44,0,1,46,3716,0.003716
544,3353,555,1860915,2,4358,1091,1,31894936,31894936,1633,544,1089,544,0,1,546,2088,0.002088
1044,3353,555,1860915,2,8358,2091,1,47526936,47526936,3133,1044,2089,1044,0,1,1046,11139,0.011139
1544,3353,555,1860915,2,12358,3091,1,63158936,63158936,4633,1544,3089,1544,0,1,1546,564316,0.564316
2044,3353,555,1860915,2,16358,4091,1,78790936,78790936,6133,2044,4089,2044,0,1,2046,580090,0.58009
2544,3353,555,1860915,2,20358,5091,1,94422936,94422936,7633,2544,5089,2544,0,1,2546,942605,0.942605
3044,3353,555,1860915,2,24358,6091,1,110054936,110054936,9133,3044,6089,3044,0,1,3046,1129468,1.129468
3544,3353,555,1860915,2,28358,7091,1,125686936,125686936,10633,3544,7089,3544,0,1,3546,1132151,1.132151
4044,3353,555,1860915,2,32358,8091,1,141318936,141318936,12133,4044,8089,4044,0,1,4046,441191,0.441191
4544,3353,555,1860915,2,36358,9091,1,156950936,156950936,13633,4544,9089,4544,0,1,4546,94100,0.0941
5044,3353,555,1860915,2,40358,10091,1,172582936,172582936,15133,5044,10089,5044,0,1,5046,1886002,1.886002
5544,3353,555,1860915,2,44358,11091,1,188214936,188214936,16633,5544,11089,5544,0,1,5546,332973,0.332973
6044,3353,555,1860915,2,48358,12091,1,203846936,203846936,18133,6044,12089,6044,0,1,6046,2237366,2.237366
6544,3353,555,1860915,2,52358,13091,1,219478936,219478936,19633,6544,13089,6544,0,1,6546,1152739,1.152739
7044,3353,555,1860915,2,56358,14091,1,235110936,235110936,21133,7044,14089,7044,0,1,7046,322700,0.3227
55,2805,665,1865325,2,446,113,1,16449400,16449400,166,55,111,55,0,1,57,40092,0.040092
455,2805,665,1865325,2,3646,913,1,27553400,27553400,1366,455,911,455,0,1,457,172990,0.17299
855,2805,665,1865325,2,6846,1713,1,38657400,38657400,2566,855,1711,855,0,1,857,312925,0.312925
1255,2805,665,1865325,2,10046,2513,1,49761400,49761400,3766,1255,2511,1255,0,1,1257,18356,0.018356
1655,2805,665,1865325,2,13246,3313,1,60865400,60865400,4966,1655,3311,1655,0,1,1657,607142,0.607142
2055,2805,665,1865325,2,16446,4113,1,71969400,71969400,6166,2055,4111,2055,0,1,2057,6194,0.006194
2455,2805,665,1865325,2,19646,4913,1,83073400,83073400,7366,2455,4911,2455,0,1,2457,879085,0.879085
2855,2805,665,1865325,2,22846,5713,1,94177400,94177400,8566,2855,5711,2855,0,1,2857,904252,0.904252
3255,2805,665,1865325,2,26046,6513,1,105281400,105281400,9766,3255,6511,3255,0,1,3257,1168843,1.168843
3655,2805,665,1865325,2,29246,7313,1,116385400,116385400,10966,3655,7311,3655,0,1,3657,1303910,1.30391
4055,2805,665,1865325,2,32446,8113,1,127489400,127489400,12166,4055,8111,4055,0,1,4057,1398852,1.398852
4455,2805,665,1865325,2,35646,8913,1,138593400,138593400,13366,4455,8911,4455,0,1,4457,891703,0.891703
4855,2805,665,1865325,2,38846,9713,1,149697400,149697400,14566,4855,9711,4855,0,1,4857,281486,0.281486
5255,2805,665,1865325,2,42046,10513,1,160801400,160801400,15766,5255,10511,5255,0,1,5257,92061,0.092061
5655,2805,665,1865325,2,45246,11313,1,171905400,171905400,16966,5655,11311,5655,0,1,5657,645830,0.64583
6055,2805,665,1865325,2,48446,12113,1,183009400,183009400,18166,6055,12111,6055,0,1,6057,2174119,2.174119
6455,2805,665,1865325,2,51646,12913,1,194113400,194113400,19366,6455,12911,6455,0,1,6457,2305560,2.30556
6855,2805,665,1865325,2,54846,13713,1,205217400,205217400,20566,6855,13711,6855,0,1,6857,123804,0.123804
55,555,3365,1867575,2,446,113,1,16665400,16665400,166,55,111,55,0,1,57,41581,0.041581
455,555,3365,1867575,2,3646,913,1,29209400,29209400,1366,455,911,455,0,1,457,126690,0.12669
855,555,3365,1867575,2,6846,1713,1,41753400,41753400,2566,855,1711,855,0,1,857,323412,0.323412
1255,555,3365,1867575,2,10046,2513,1,54297400,54297400,3766,1255,2511,1255,0,1,1257,465721,0.465721
1655,555,3365,1867575,2,13246,3313,1,66841400,66841400,4966,1655,3311,1655,0,1,1657,609454,0.609454
2055,555,3365,1867575,2,16446,4113,1,79385400,79385400,6166,2055,4111,2055,0,1,2057,371939,0.371939
2455,555,3365,1867575,2,19646,4913,1,91929400,91929400,7366,2455,4911,2455,0,1,2457,600479,0.600479
2855,555,3365,1867575,2,22846,5713,1,104473400,104473400,8566,2855,5711,2855,0,1,2857,310983,0.310983
3255,555,3365,1867575,2,26046,6513,1,117017400,117017400,9766,3255,6511,3255,0,1,3257,597942,0.597942
3655,555,3365,1867575,2,29246,7313,1,129561400,129561400,10966,3655,7311,3655,0,1,3657,277871,0.277871
4055,555,3365,1867575,2,32446,8113,1,142105400,142105400,12166,4055,8111,4055,0,1,4057,864896,0.864896
4455,555,3365,1867575,2,35646,8913,1,154649400,154649400,13366,4455,8911,4455,0,1,4457,216498,0.216498
4855,555,3365,1867575,2,38846,9713,1,167193400,167193400,14566,4855,9711,4855,0,1,4857,267458,0.267458
5255,555,3365,1867575,2,42046,10513,1,179737400,179737400,15766,5255,10511,5255,0,1,5257,1132190,1.13219
5655,555,3365,1867575,2,45246,11313,1,192281400,192281400,16966,5655,11311,5655,0,1,5657,142509,0.142509
6055,555,3365,1867575,2,48446,12113,1,204825400,204825400,18166,6055,12111,6055,0,1,6057,2195122,2.195122
6455,555,3365,1867575,2,51646,12913,1,217369400,217369400,19366,6455,12911,6455,0,1,6457,1835102,1.835102
6855,555,3365,1867575,2,54846,13713,1,229913400,229913400,20566,6855,13711,6855,0,1,6857,1892079,1.892079
40,5550,340,1887000,2,326,83,1,16980800,16980800,121,40,81,40,0,1,42,34714,0.034714
440,5550,340,1887000,2,3526,883,1,35828800,35828800,1321,440,881,440,0,1,442,31081,0.031081
840,5550,340,1887000,2,6726,1683,1,54676800,54676800,2521,840,1681,840,0,1,842,306678,0.306678
1240,5550,340,1887000,2,9926,2483,1,73524800,73524800,3721,1240,2481,1240,0,1,1242,459910,0.45991
1640,5550,340,1887000,2,13126,3283,1,92372800,92372800,4921,1640,3281,1640,0,1,1642,610219,0.610219
2040,5550,340,1887000,2,16326,4083,1,111220800,111220800,6121,2040,4081,2040,0,1,2042,762115,0.762115
2440,5550,340,1887000,2,19526,4883,1,130068800,130068800,7321,2440,4881,2440,0,1,2442,913608,0.913608
2840,5550,340,1887000,2,22726,5683,1,148916800,148916800,8521,2840,5681,2840,0,1,2842,377371,0.377371
3240,5550,340,1887000,2,25926,6483,1,167764800,167764800,9721,3240,6481,3240,0,1,3242,1031473,1.031473
3640,5550,340,1887000,2,29126,7283,1,186612800,186612800,10921,3640,7281,3640,0,1,3642,1375437,1.375437
4040,5550,340,1887000,2,32326,8083,1,205460800,205460800,12121,4040,8081,4040,0,1,4042,485659,0.485659
4440,5550,340,1887000,2,35526,8883,1,224308800,224308800,13321,4440,8881,4440,0,1,4442,1671470,1.67147
4840,5550,340,1887000,2,38726,9683,1,243156800,243156800,14521,4840,9681,4840,0,1,4842,73376,0.073376
5240,5550,340,1887000,2,41926,10483,1,262004800,262004800,15721,5240,10481,5240,0,1,5242,1904698,1.904698
5640,5550,340,1887000,2,45126,11283,1,280852800,280852800,16921,5640,11281,5640,0,1,5642,2133696,2.133696
6040,5550,340,1887000,2,48326,12083,1,299700800,299700800,18121,6040,12081,6040,0,1,6042,2279873,2.279873
6440,5550,340,1887000,2,51526,12883,1,318548800,318548800,19321,6440,12881,6440,0,1,6442,2472763,2.472763
6840,5550,340,1887000,2,54726,13683,1,337396800,337396800,20521,6840,13681,6840,0,1,6842,2621890,2.62189
40,300,6340,1902000,2,326,83,1,17340800,17340800,121,40,81,40,0,1,42,36278,0.036278
440,300,6340,1902000,2,3526,883,1,38588800,38588800,1321,440,881,440,0,1,442,72560,0.07256
840,300,6340,1902000,2,6726,1683,1,59836800,59836800,2521,840,1681,840,0,1,842,25801,0.025801
1240,300,6340,1902000,2,9926,2483,1,81084800,81084800,3721,1240,2481,1240,0,1,1242,146822,0.146822
1640,300,6340,1902000,2,13126,3283,1,102332800,102332800,4921,1640,3281,1640,0,1,1642,416198,0.416198
2040,300,6340,1902000,2,16326,4083,1,123580800,123580800,6121,2040,4081,2040,0,1,2042,665727,0.665727
2440,300,6340,1902000,2,19526,4883,1,144828800,144828800,7321,2440,4881,2440,0,1,2442,11434,0.011434
2840,300,6340,1902000,2,22726,5683,1,166076800,166076800,8521,2840,5681,2840,0,1,2842,200859,0.200859
3240,300,6340,1902000,2,25926,6483,1,187324800,187324800,9721,3240,6481,3240,0,1,3242,46667,0.046667
3640,300,6340,1902000,2,29126,7283,1,208572800,208572800,10921,3640,7281,3640,0,1,3642,99634,0.099634
4040,300,6340,1902000,2,32326,8083,1,229820800,229820800,12121,4040,8081,4040,0,1,4042,126051,0.126051
4440,300,6340,1902000,2,35526,8883,1,251068800,251068800,13321,4440,8881,4440,0,1,4442,122720,0.12272
4840,300,6340,1902000,2,38726,9683,1,272316800,272316800,14521,4840,9681,4840,0,1,4842,231597,0.231597
5240,300,6340,1902000,2,41926,10483,1,293564800,293564800,15721,5240,10481,5240,0,1,5242,346455,0.346455
5640,300,6340,1902000,2,45126,11283,1,314812800,314812800,16921,5640,11281,5640,0,1,5642,568039,0.568039
6040,300,6340,1902000,2,48326,12083,1,336060800,336060800,18121,6040,12081,6040,0,1,6042,1371183,1.371183
6440,300,6340,1902000,2,51526,12883,1,357308800,357308800,19321,6440,12881,6440,0,1,6442,200588,0.200588
6840,300,6340,1902000,2,54726,13683,1,378556800,378556800,20521,6840,13681,6840,0,1,6842,349389,0.349389
40,1550,1240,1922000,2,326,83,1,16268800,16268800,121,40,81,40,0,1,42,35991,0.035991
440,1550,1240,1922000,2,3526,883,1,25196800,25196800,1321,440,881,440,0,1,442,177121,0.177121
840,1550,1240,1922000,2,6726,1683,1,34124800,34124800,2521,840,1681,840,0,1,842,127405,0.127405
1240,1550,1240,1922000,2,9926,2483,1,43052800,43052800,3721,1240,2481,1240,0,1,1242,480420,0.48042
1640,1550,1240,1922000,2,13126,3283,1,51980800,51980800,4921,1640,3281,1640,0,1,1642,118650,0.11865
2040,1550,1240,1922000,2,16326,4083,1,60908800,60908800,6121,2040,4081,2040,0,1,2042,768064,0.768064
2440,1550,1240,1922000,2,19526,4883,1,69836800,69836800,7321,2440,4881,2440,0,1,2442,912818,0.912818
2840,1550,1240,1922000,2,22726,5683,1,78764800,78764800,8521,2840,5681,2840,0,1,2842,1060577,1.060577
3240,1550,1240,1922000,2,25926,6483,1,87692800,87692800,9721,3240,6481,3240,0,1,3242,1208620,1.20862
3640,1550,1240,1922000,2,29126,7283,1,96620800,96620800,10921,3640,7281,3640,0,1,3642,1363086,1.363086
4040,1550,1240,1922000,2,32326,8083,1,105548800,105548800,12121,4040,8081,4040,0,1,4042,539625,0.539625
4440,1550,1240,1922000,2,35526,8883,1,114476800,114476800,13321,4440,8881,4440,0,1,4442,1635183,1.635183
4840,1550,1240,1922000,2,38726,9683,1,123404800,123404800,14521,4840,9681,4840,0,1,4842,731176,0.731176
5240,1550,1240,1922000,2,41926,10483,1,132332800,132332800,15721,5240,10481,5240,0,1,5242,1953078,1.953078
5640,1550,1240,1922000,2,45126,11283,1,141260800,141260800,16921,5640,11281,5640,0,1,5642,641346,0.641346
6040,1550,1240,1922000,2,48326,12083,1,150188800,150188800,18121,6040,12081,6040,0,1,6042,1594327,1.594327
6440,1550,1240,1922000,2,51526,12883,1,159116800,159116800,19321,6440,12881,6440,0,1,6442,1923393,1.923393
6840,1550,1240,1922000,2,54726,13683,1,168044800,168044800,20521,6840,13681,6840,0,1,6842,2305410,2.30541
40,2050,940,1927000,2,326,83,1,16372800,16372800,121,40,81,40,0,1,42,2390,0.00239
440,2050,940,1927000,2,3526,883,1,25940800,25940800,1321,440,881,440,0,1,442,2210,0.00221
840,2050,940,1927000,2,6726,1683,1,35508800,35508800,2521,840,1681,840,0,1,842,20755,0.020755
1240,2050,940,1927000,2,9926,2483,1,45076800,45076800,3721,1240,2481,1240,0,1,1242,2485,0.002485
1640,2050,940,1927000,2,13126,3283,1,54644800,54644800,4921,1640,3281,1640,0,1,1642,27797,0.027797
2040,2050,940,1927000,2,16326,4083,1,64212800,64212800,6121,2040,4081,2040,0,1,2042,230826,0.230826
2440,2050,940,1927000,2,19526,4883,1,73780800,73780800,7321,2440,4881,2440,0,1,2442,45362,0.045362
2840,2050,940,1927000,2,22726,5683,1,83348800,83348800,8521,2840,5681,2840,0,1,2842,378733,0.378733
3240,2050,940,1927000,2,25926,6483,1,92916800,92916800,9721,3240,6481,3240,0,1,3242,411143,0.411143
3640,2050,940,1927000,2,29126,7283,1,102484800,102484800,10921,3640,7281,3640,0,1,3642,288648,0.288648
4040,2050,940,1927000,2,32326,8083,1,112052800,112052800,12121,4040,8081,4040,0,1,4042,567282,0.567282
4440,2050,940,1927000,2,35526,8883,1,121620800,121620800,13321,4440,8881,4440,0,1,4442,817490,0.81749
4840,2050,940,1927000,2,38726,9683,1,131188800,131188800,14521,4840,9681,4840,0,1,4842,227979,0.227979
5240,2050,940,1927000,2,41926,10483,1,140756800,140756800,15721,5240,10481,5240,0,1,5242,187383,0.187383
5640,2050,940,1927000,2,45126,11283,1,150324800,150324800,16921,5640,11281,5640,0,1,5642,601355,0.601355
6040,2050,940,1927000,2,48326,12083,1,159892800,159892800,18121,6040,12081,6040,0,1,6042,872259,0.872259
6440,2050,940,1927000,2,51526,12883,1,169460800,169460800,19321,6440,12881,6440,0,1,6442,885103,0.885103
6840,2050,940,1927000,2,54726,13683,1,179028800,179028800,20521,6840,13681,6840,0,1,6842,2538419,2.538419
40,1050,1840,1932000,2,326,83,1,16380800,16380800,121,40,81,40,0,1,42,10231,0.010231
440,1050,1840,1932000,2,3526,883,1,25628800,25628800,1321,440,881,440,0,1,442,25704,0.025704
840,1050,1840,1932000,2,6726,1683,1,34876800,34876800,2521,840,1681,840,0,1,842,7809,0.007809
1240,1050,1840,1932000,2,9926,2483,1,44124800,44124800,3721,1240,2481,1240,0,1,1242,37207,0.037207
1640,1050,1840,1932000,2,13126,3283,1,53372800,53372800,4921,1640,3281,1640,0,1,1642,99879,0.099879
2040,1050,1840,1932000,2,16326,4083,1,62620800,62620800,6121,2040,4081,2040,0,1,2042,95722,0.095722
2440,1050,1840,1932000,2,19526,4883,1,71868800,71868800,7321,2440,4881,2440,0,1,2442,501071,0.501071
2840,1050,1840,1932000,2,22726,5683,1,81116800,81116800,8521,2840,5681,2840,0,1,2842,510974,0.510974
3240,1050,1840,1932000,2,25926,6483,1,90364800,90364800,9721,3240,6481,3240,0,1,3242,807943,0.807943
3640,1050,1840,1932000,2,29126,7283,1,99612800,99612800,10921,3640,7281,3640,0,1,3642,69273,0.069273
4040,1050,1840,1932000,2,32326,8083,1,108860800,108860800,12121,4040,8081,4040,0,1,4042,909297,0.909297
4440,1050,1840,1932000,2,35526,8883,1,118108800,118108800,13321,4440,8881,4440,0,1,4442,684052,0.684052
4840,1050,1840,1932000,2,38726,9683,1,127356800,127356800,14521,4840,9681,4840,0,1,4842,376026,0.376026
5240,1050,1840,1932000,2,41926,10483,1,136604800,136604800,15721,5240,10481,5240,0,1,5242,434664,0.434664
5640,1050,1840,1932000,2,45126,11283,1,145852800,145852800,16921,5640,11281,5640,0,1,5642,906202,0.906202
6040,1050,1840,1932000,2,48326,12083,1,155100800,155100800,18121,6040,12081,6040,0,1,6042,770032,0.770032
6440,1050,1840,1932000,2,51526,12883,1,164348800,164348800,19321,6440,12881,6440,0,1,6442,2379422,2.379422
6840,1050,1840,1932000,2,54726,13683,1,173596800,173596800,20521,6840,13681,6840,0,1,6842,155057,0.155057
55,5305,365,1936325,2,446,113,1,17985400,17985400,166,55,111,55,0,1,57,37277,0.037277
455,5305,365,1936325,2,3646,913,1,36129400,36129400,1366,455,911,455,0,1,457,22623,0.022623
855,5305,365,1936325,2,6846,1713,1,54273400,54273400,2566,855,1711,855,0,1,857,174269,0.174269
1255,5305,365,1936325,2,10046,2513,1,72417400,72417400,3766,1255,2511,1255,0,1,1257,483422,0.483422
1655,5305,365,1936325,2,13246,3313,1,90561400,90561400,4966,1655,3311,1655,0,1,1657,640145,0.640145
2055,5305,365,1936325,2,16446,4113,1,108705400,108705400,6166,2055,4111,2055,0,1,2057,97753,0.097753
2455,5305,365,1936325,2,19646,4913,1,126849400,126849400,7366,2455,4911,2455,0,1,2457,949283,0.949283
2855,5305,365,1936325,2,22846,5713,1,144993400,144993400,8566,2855,5711,2855,0,1,2857,696281,0.696281
3255,5305,365,1936325,2,26046,6513,1,163137400,163137400,9766,3255,6511,3255,0,1,3257,1258777,1.258777
3655,5305,365,1936325,2,29246,7313,1,181281400,181281400,10966,3655,7311,3655,0,1,3657,1407434,1.407434
4055,5305,365,1936325,2,32446,8113,1,199425400,199425400,12166,4055,8111,4055,0,1,4057,710450,0.71045
4455,5305,365,1936325,2,35646,8913,1,217569400,217569400,13366,4455,8911,4455,0,1,4457,1424465,1.424465
4855,5305,365,1936325,2,38846,9713,1,235713400,235713400,14566,4855,9711,4855,0,1,4857,9422,0.009422
5255,5305,365,1936325,2,42046,10513,1,253857400,253857400,15766,5255,10511,5255,0,1,5257,1291625,1.291625
5655,5305,365,1936325,2,45246,11313,1,272001400,272001400,16966,5655,11311,5655,0,1,5657,1152059,1.152059
6055,5305,365,1936325,2,48446,12113,1,290145400,290145400,18166,6055,12111,6055,0,1,6057,230969,0.230969
6455,5305,365,1936325,2,51646,12913,1,308289400,308289400,19366,6455,12911,6455,0,1,6457,814110,0.81411
6855,5305,365,1936325,2,54846,13713,1,326433400,326433400,20566,6855,13711,6855,0,1,6857,1901841,1.901841
55,305,6365,1941325,2,446,113,1,18465400,18465400,166,55,111,55,0,1,57,42375,0.042375
455,305,6365,1941325,2,3646,913,1,39809400,39809400,1366,455,911,455,0,1,457,190785,0.190785
855,305,6365,1941325,2,6846,1713,1,61153400,61153400,2566,855,1711,855,0,1,857,31512,0.031512
1255,305,6365,1941325,2,10046,2513,1,82497400,82497400,3766,1255,2511,1255,0,1,1257,489997,0.489997
1655,305,6365,1941325,2,13246,3313,1,103841400,103841400,4966,1655,3311,1655,0,1,1657,66004,0.066004
2055,305,6365,1941325,2,16446,4113,1,125185400,125185400,6166,2055,4111,2055,0,1,2057,55763,0.055763
2455,305,6365,1941325,2,19646,4913,1,146529400,146529400,7366,2455,4911,2455,0,1,2457,140020,0.14002
2855,305,6365,1941325,2,22846,5713,1,167873400,167873400,8566,2855,5711,2855,0,1,2857,947142,0.947142
3255,305,6365,1941325,2,26046,6513,1,189217400,189217400,9766,3255,6511,3255,0,1,3257,28243,0.028243
3655,305,6365,1941325,2,29246,7313,1,210561400,210561400,10966,3655,7311,3655,0,1,3657,198032,0.198032
4055,305,6365,1941325,2,32446,8113,1,231905400,231905400,12166,4055,8111,4055,0,1,4057,424170,0.42417
4455,305,6365,1941325,2,35646,8913,1,253249400,253249400,13366,4455,8911,4455,0,1,4457,248685,0.248685
4855,305,6365,1941325,2,38846,9713,1,274593400,274593400,14566,4855,9711,4855,0,1,4857,1480843,1.480843
5255,305,6365,1941325,2,42046,10513,1,295937400,295937400,15766,5255,10511,5255,0,1,5257,349717,0.349717
5655,305,6365,1941325,2,45246,11313,1,317281400,317281400,16966,5655,11311,5655,0,1,5657,430219,0.430219
6055,305,6365,1941325,2,48446,12113,1,338625400,338625400,18166,6055,12111,6055,0,1,6057,710195,0.710195
6455,305,6365,1941325,2,51646,12913,1,359969400,359969400,19366,6455,12911,6455,0,1,6457,608103,0.608103
6855,305,6365,1941325,2,54846,13713,1,381313400,381313400,20566,6855,13711,6855,0,1,6857,2205877,2.205877
40,3050,640,1952000,2,326,83,1,16796800,16796800,121,40,81,40,0,1,42,5126,0.005126
440,3050,640,1952000,2,3526,883,1,28604800,28604800,1321,440,881,440,0,1,442,113046,0.113046
840,3050,640,1952000,2,6726,1683,1,40412800,40412800,2521,840,1681,840,0,1,842,188306,0.188306
1240,3050,640,1952000,2,9926,2483,1,52220800,52220800,3721,1240,2481,1240,0,1,1242,152461,0.152461
1640,3050,640,1952000,2,13126,3283,1,64028800,64028800,4921,1640,3281,1640,0,1,1642,397849,0.397849
2040,3050,640,1952000,2,16326,4083,1,75836800,75836800,6121,2040,4081,2040,0,1,2042,126384,0.126384
2440,3050,640,1952000,2,19526,4883,1,87644800,87644800,7321,2440,4881,2440,0,1,2442,806775,0.806775
2840,3050,640,1952000,2,22726,5683,1,99452800,99452800,8521,2840,5681,2840,0,1,2842,205287,0.205287
3240,3050,640,1952000,2,25926,6483,1,111260800,111260800,9721,3240,6481,3240,0,1,3242,1203345,1.203345
3640,3050,640,1952000,2,29126,7283,1,123068800,123068800,10921,3640,7281,3640,0,1,3642,279681,0.279681
4040,3050,640,1952000,2,32326,8083,1,134876800,134876800,12121,4040,8081,4040,0,1,4042,1494997,1.494997
40,800,2440,1952000,2,326,83,1,16652800,16652800,121,40,81,40,0,1,42,6776,0.006776
440,800,2440,1952000,2,3526,883,1,27020800,27020800,1321,440,881,440,0,1,442,176697,0.176697
840,800,2440,1952000,2,6726,1683,1,37388800,37388800,2521,840,1681,840,0,1,842,322140,0.32214
1240,800,2440,1952000,2,9926,2483,1,47756800,47756800,3721,1240,2481,1240,0,1,1242,133989,0.133989
1640,800,2440,1952000,2,13126,3283,1,58124800,58124800,4921,1640,3281,1640,0,1,1642,413637,0.413637
2040,800,2440,1952000,2,16326,4083,1,68492800,68492800,6121,2040,4081,2040,0,1,2042,381243,0.381243
2440,800,2440,1952000,2,19526,4883,1,78860800,78860800,7321,2440,4881,2440,0,1,2442,908392,0.908392
2840,800,2440,1952000,2,22726,5683,1,89228800,89228800,8521,2840,5681,2840,0,1,2842,934952,0.934952
3240,800,2440,1952000,2,25926,6483,1,99596800,99596800,9721,3240,6481,3240,0,1,3242,46470,0.04647
4440,3050,640,1952000,2,35526,8883,1,146684800,146684800,13321,4440,8881,4440,0,1,4442,299762,0.299762
3640,800,2440,1952000,2,29126,7283,1,109964800,109964800,10921,3640,7281,3640,0,1,3642,346586,0.346586
4040,800,2440,1952000,2,32326,8083,1,120332800,120332800,12121,4040,8081,4040,0,1,4042,704446,0.704446
4440,800,2440,1952000,2,35526,8883,1,130700800,130700800,13321,4440,8881,4440,0,1,4442,986491,0.986491
4840,800,2440,1952000,2,38726,9683,1,141068800,141068800,14521,4840,9681,4840,0,1,4842,945523,0.945523
4840,3050,640,1952000,2,38726,9683,1,158492800,158492800,14521,4840,9681,4840,0,1,4842,412397,0.412397
5240,800,2440,1952000,2,41926,10483,1,151436800,151436800,15721,5240,10481,5240,0,1,5242,525109,0.525109
5640,800,2440,1952000,2,45126,11283,1,161804800,161804800,16921,5640,11281,5640,0,1,5642,102466,0.102466
6040,800,2440,1952000,2,48326,12083,1,172172800,172172800,18121,6040,12081,6040,0,1,6042,1050445,1.050445
6440,800,2440,1952000,2,51526,12883,1,182540800,182540800,19321,6440,12881,6440,0,1,6442,924686,0.924686
5240,3050,640,1952000,2,41926,10483,1,170300800,170300800,15721,5240,10481,5240,0,1,5242,15275,0.015275
6840,800,2440,1952000,2,54726,13683,1,192908800,192908800,20521,6840,13681,6840,0,1,6842,2526283,2.526283
5640,3050,640,1952000,2,45126,11283,1,182108800,182108800,16921,5640,11281,5640,0,1,5642,2094669,2.094669
6040,3050,640,1952000,2,48326,12083,1,193916800,193916800,18121,6040,12081,6040,0,1,6042,295473,0.295473
6440,3050,640,1952000,2,51526,12883,1,205724800,205724800,19321,6440,12881,6440,0,1,6442,93551,0.093551
6840,3050,640,1952000,2,54726,13683,1,217532800,217532800,20521,6840,13681,6840,0,1,6842,716502,0.716502
55,1555,1265,1967075,2,446,113,1,16977400,16977400,166,55,111,55,0,1,57,40789,0.040789
455,1555,1265,1967075,2,3646,913,1,26001400,26001400,1366,455,911,455,0,1,457,188734,0.188734
855,1555,1265,1967075,2,6846,1713,1,35025400,35025400,2566,855,1711,855,0,1,857,345281,0.345281
1255,1555,1265,1967075,2,10046,2513,1,44049400,44049400,3766,1255,2511,1255,0,1,1257,497506,0.497506
1655,1555,1265,1967075,2,13246,3313,1,53073400,53073400,4966,1655,3311,1655,0,1,1657,13805,0.013805
2055,1555,1265,1967075,2,16446,4113,1,62097400,62097400,6166,2055,4111,2055,0,1,2057,803520,0.80352
2455,1555,1265,1967075,2,19646,4913,1,71121400,71121400,7366,2455,4911,2455,0,1,2457,174525,0.174525
2855,1555,1265,1967075,2,22846,5713,1,80145400,80145400,8566,2855,5711,2855,0,1,2857,173931,0.173931
3255,1555,1265,1967075,2,26046,6513,1,89169400,89169400,9766,3255,6511,3255,0,1,3257,144150,0.14415
3655,1555,1265,1967075,2,29246,7313,1,98193400,98193400,10966,3655,7311,3655,0,1,3657,841224,0.841224
4055,1555,1265,1967075,2,32446,8113,1,107217400,107217400,12166,4055,8111,4055,0,1,4057,1574474,1.574474
4455,1555,1265,1967075,2,35646,8913,1,116241400,116241400,13366,4455,8911,4455,0,1,4457,1728325,1.728325
4855,1555,1265,1967075,2,38846,9713,1,125265400,125265400,14566,4855,9711,4855,0,1,4857,426952,0.426952
5255,1555,1265,1967075,2,42046,10513,1,134289400,134289400,15766,5255,10511,5255,0,1,5257,968451,0.968451
5655,1555,1265,1967075,2,45246,11313,1,143313400,143313400,16966,5655,11311,5655,0,1,5657,54922,0.054922
6055,1555,1265,1967075,2,48446,12113,1,152337400,152337400,18166,6055,12111,6055,0,1,6057,628290,0.62829
6455,1555,1265,1967075,2,51646,12913,1,161361400,161361400,19366,6455,12911,6455,0,1,6457,2501853,2.501853
6855,1555,1265,1967075,2,54846,13713,1,170385400,170385400,20566,6855,13711,6855,0,1,6857,2661743,2.661743
55,1055,1865,1967575,2,446,113,1,17025400,17025400,166,55,111,55,0,1,57,8749,0.008749
455,1055,1865,1967575,2,3646,913,1,26369400,26369400,1366,455,911,455,0,1,457,33728,0.033728
855,1055,1865,1967575,2,6846,1713,1,35713400,35713400,2566,855,1711,855,0,1,857,131171,0.131171
1255,1055,1865,1967575,2,10046,2513,1,45057400,45057400,3766,1255,2511,1255,0,1,1257,23572,0.023572
1655,1055,1865,1967575,2,13246,3313,1,54401400,54401400,4966,1655,3311,1655,0,1,1657,4472,0.004472
2055,1055,1865,1967575,2,16446,4113,1,63745400,63745400,6166,2055,4111,2055,0,1,2057,72371,0.072371
2455,1055,1865,1967575,2,19646,4913,1,73089400,73089400,7366,2455,4911,2455,0,1,2457,9005,0.009005
2855,1055,1865,1967575,2,22846,5713,1,82433400,82433400,8566,2855,5711,2855,0,1,2857,954300,0.9543
3255,1055,1865,1967575,2,26046,6513,1,91777400,91777400,9766,3255,6511,3255,0,1,3257,159710,0.15971
3655,1055,1865,1967575,2,29246,7313,1,101121400,101121400,10966,3655,7311,3655,0,1,3657,16089,0.016089
4055,1055,1865,1967575,2,32446,8113,1,110465400,110465400,12166,4055,8111,4055,0,1,4057,285802,0.285802
4455,1055,1865,1967575,2,35646,8913,1,119809400,119809400,13366,4455,8911,4455,0,1,4457,22690,0.02269
4855,1055,1865,1967575,2,38846,9713,1,129153400,129153400,14566,4855,9711,4855,0,1,4857,370365,0.370365
5255,1055,1865,1967575,2,42046,10513,1,138497400,138497400,15766,5255,10511,5255,0,1,5257,605688,0.605688
5655,1055,1865,1967575,2,45246,11313,1,147841400,147841400,16966,5655,11311,5655,0,1,5657,1101549,1.101549
6055,1055,1865,1967575,2,48446,12113,1,157185400,157185400,18166,6055,12111,6055,0,1,6057,133332,0.133332
6455,1055,1865,1967575,2,51646,12913,1,166529400,166529400,19366,6455,12911,6455,0,1,6457,95981,0.095981
6855,1055,1865,1967575,2,54846,13713,1,175873400,175873400,20566,6855,13711,6855,0,1,6857,506779,0.506779
40,5800,340,1972000,2,326,83,1,17740800,17740800,121,40,81,40,0,1,42,4206,0.004206
440,5800,340,1972000,2,3526,883,1,37388800,37388800,1321,440,881,440,0,1,442,46137,0.046137
840,5800,340,1972000,2,6726,1683,1,57036800,57036800,2521,840,1681,840,0,1,842,104392,0.104392
1240,5800,340,1972000,2,9926,2483,1,76684800,76684800,3721,1240,2481,1240,0,1,1242,82022,0.082022
1640,5800,340,1972000,2,13126,3283,1,96332800,96332800,4921,1640,3281,1640,0,1,1642,241584,0.241584
2040,5800,340,1972000,2,16326,4083,1,115980800,115980800,6121,2040,4081,2040,0,1,2042,7131,0.007131
2440,5800,340,1972000,2,19526,4883,1,135628800,135628800,7321,2440,4881,2440,0,1,2442,428342,0.428342
2840,5800,340,1972000,2,22726,5683,1,155276800,155276800,8521,2840,5681,2840,0,1,2842,976750,0.97675
3240,5800,340,1972000,2,25926,6483,1,174924800,174924800,9721,3240,6481,3240,0,1,3242,1233013,1.233013
3640,5800,340,1972000,2,29126,7283,1,194572800,194572800,10921,3640,7281,3640,0,1,3642,930410,0.93041
4040,5800,340,1972000,2,32326,8083,1,214220800,214220800,12121,4040,8081,4040,0,1,4042,1164371,1.164371
4440,5800,340,1972000,2,35526,8883,1,233868800,233868800,13321,4440,8881,4440,0,1,4442,1145509,1.145509
4840,5800,340,1972000,2,38726,9683,1,253516800,253516800,14521,4840,9681,4840,0,1,4842,214882,0.214882
5240,5800,340,1972000,2,41926,10483,1,273164800,273164800,15721,5240,10481,5240,0,1,5242,722448,0.722448
5640,5800,340,1972000,2,45126,11283,1,292812800,292812800,16921,5640,11281,5640,0,1,5642,1175573,1.175573
6040,5800,340,1972000,2,48326,12083,1,312460800,312460800,18121,6040,12081,6040,0,1,6042,492517,0.492517
6440,5800,340,1972000,2,51526,12883,1,332108800,332108800,19321,6440,12881,6440,0,1,6442,983169,0.983169
6840,5800,340,1972000,2,54726,13683,1,351756800,351756800,20521,6840,13681,6840,0,1,6842,353623,0.353623
55,2055,965,1983075,2,446,113,1,17193400,17193400,166,55,111,55,0,1,57,13313,0.013313
455,2055,965,1983075,2,3646,913,1,26857400,26857400,1366,455,911,455,0,1,457,10770,0.01077
855,2055,965,1983075,2,6846,1713,1,36521400,36521400,2566,855,1711,855,0,1,857,34902,0.034902
1255,2055,965,1983075,2,10046,2513,1,46185400,46185400,3766,1255,2511,1255,0,1,1257,48943,0.048943
1655,2055,965,1983075,2,13246,3313,1,55849400,55849400,4966,1655,3311,1655,0,1,1657,57843,0.057843
2055,2055,965,1983075,2,16446,4113,1,65513400,65513400,6166,2055,4111,2055,0,1,2057,781130,0.78113
2455,2055,965,1983075,2,19646,4913,1,75177400,75177400,7366,2455,4911,2455,0,1,2457,279227,0.279227
2855,2055,965,1983075,2,22846,5713,1,84841400,84841400,8566,2855,5711,2855,0,1,2857,4625,0.004625
3255,2055,965,1983075,2,26046,6513,1,94505400,94505400,9766,3255,6511,3255,0,1,3257,127388,0.127388
3655,2055,965,1983075,2,29246,7313,1,104169400,104169400,10966,3655,7311,3655,0,1,3657,629791,0.629791
4055,2055,965,1983075,2,32446,8113,1,113833400,113833400,12166,4055,8111,4055,0,1,4057,692732,0.692732
4455,2055,965,1983075,2,35646,8913,1,123497400,123497400,13366,4455,8911,4455,0,1,4457,1129353,1.129353
4855,2055,965,1983075,2,38846,9713,1,133161400,133161400,14566,4855,9711,4855,0,1,4857,171836,0.171836
5255,2055,965,1983075,2,42046,10513,1,142825400,142825400,15766,5255,10511,5255,0,1,5257,1028058,1.028058
5655,2055,965,1983075,2,45246,11313,1,152489400,152489400,16966,5655,11311,5655,0,1,5657,16508,0.016508
6055,2055,965,1983075,2,48446,12113,1,162153400,162153400,18166,6055,12111,6055,0,1,6057,275601,0.275601
6455,2055,965,1983075,2,51646,12913,1,171817400,171817400,19366,6455,12911,6455,0,1,6457,421086,0.421086
6855,2055,965,1983075,2,54846,13713,1,181481400,181481400,20566,6855,13711,6855,0,1,6857,346693,0.346693
55,805,2465,1984325,2,446,113,1,17313400,17313400,166,55,111,55,0,1,57,42133,0.042133
455,805,2465,1984325,2,3646,913,1,27777400,27777400,1366,455,911,455,0,1,457,188006,0.188006
855,805,2465,1984325,2,6846,1713,1,38241400,38241400,2566,855,1711,855,0,1,857,340740,0.34074
1255,805,2465,1984325,2,10046,2513,1,48705400,48705400,3766,1255,2511,1255,0,1,1257,490900,0.4909
1655,805,2465,1984325,2,13246,3313,1,59169400,59169400,4966,1655,3311,1655,0,1,1657,477915,0.477915
2055,805,2465,1984325,2,16446,4113,1,69633400,69633400,6166,2055,4111,2055,0,1,2057,793023,0.793023
2455,805,2465,1984325,2,19646,4913,1,80097400,80097400,7366,2455,4911,2455,0,1,2457,359485,0.359485
2855,805,2465,1984325,2,22846,5713,1,90561400,90561400,8566,2855,5711,2855,0,1,2857,105247,0.105247
3255,805,2465,1984325,2,26046,6513,1,101025400,101025400,9766,3255,6511,3255,0,1,3257,996008,0.996008
3655,805,2465,1984325,2,29246,7313,1,111489400,111489400,10966,3655,7311,3655,0,1,3657,37916,0.037916
4055,805,2465,1984325,2,32446,8113,1,121953400,121953400,12166,4055,8111,4055,0,1,4057,534802,0.534802
4455,805,2465,1984325,2,35646,8913,1,132417400,132417400,13366,4455,8911,4455,0,1,4457,648921,0.648921
4855,805,2465,1984325,2,38846,9713,1,142881400,142881400,14566,4855,9711,4855,0,1,4857,377234,0.377234
5255,805,2465,1984325,2,42046,10513,1,153345400,153345400,15766,5255,10511,5255,0,1,5257,1303368,1.303368
5655,805,2465,1984325,2,45246,11313,1,163809400,163809400,16966,5655,11311,5655,0,1,5657,215329,0.215329
6055,805,2465,1984325,2,48446,12113,1,174273400,174273400,18166,6055,12111,6055,0,1,6057,2320403,2.320403
6455,805,2465,1984325,2,51646,12913,1,184737400,184737400,19366,6455,12911,6455,0,1,6457,2068569,2.068569
6855,805,2465,1984325,2,54846,13713,1,195201400,195201400,20566,6855,13711,6855,0,1,6857,1380120,1.38012
40,300,6640,1992000,2,326,83,1,18156800,18156800,121,40,81,40,0,1,42,37015,0.037015
440,300,6640,1992000,2,3526,883,1,40364800,40364800,1321,440,881,440,0,1,442,185785,0.185785
840,300,6640,1992000,2,6726,1683,1,62572800,62572800,2521,840,1681,840,0,1,842,329570,0.32957
1240,300,6640,1992000,2,9926,2483,1,84780800,84780800,3721,1240,2481,1240,0,1,1242,177344,0.177344
1640,300,6640,1992000,2,13126,3283,1,106988800,106988800,4921,1640,3281,1640,0,1,1642,224835,0.224835
2040,300,6640,1992000,2,16326,4083,1,129196800,129196800,6121,2040,4081,2040,0,1,2042,416060,0.41606
2440,300,6640,1992000,2,19526,4883,1,151404800,151404800,7321,2440,4881,2440,0,1,2442,143741,0.143741
2840,300,6640,1992000,2,22726,5683,1,173612800,173612800,8521,2840,5681,2840,0,1,2842,171963,0.171963
3240,300,6640,1992000,2,25926,6483,1,195820800,195820800,9721,3240,6481,3240,0,1,3242,547317,0.547317
3640,300,6640,1992000,2,29126,7283,1,218028800,218028800,10921,3640,7281,3640,0,1,3642,464680,0.46468
4040,300,6640,1992000,2,32326,8083,1,240236800,240236800,12121,4040,8081,4040,0,1,4042,258736,0.258736
4440,300,6640,1992000,2,35526,8883,1,262444800,262444800,13321,4440,8881,4440,0,1,4442,39977,0.039977
4840,300,6640,1992000,2,38726,9683,1,284652800,284652800,14521,4840,9681,4840,0,1,4842,193210,0.19321
5240,300,6640,1992000,2,41926,10483,1,306860800,306860800,15721,5240,10481,5240,0,1,5242,385229,0.385229
5640,300,6640,1992000,2,45126,11283,1,329068800,329068800,16921,5640,11281,5640,0,1,5642,607608,0.607608
6040,300,6640,1992000,2,48326,12083,1,351276800,351276800,18121,6040,12081,6040,0,1,6042,336010,0.33601
6440,300,6640,1992000,2,51526,12883,1,373484800,373484800,19321,6440,12881,6440,0,1,6442,1851470,1.85147
6840,300,6640,1992000,2,54726,13683,1,395692800,395692800,20521,6840,13681,6840,0,1,6842,1659899,1.659899
40,550,3640,2002000,2,326,83,1,17356800,17356800,121,40,81,40,0,1,42,37568,0.037568
440,550,3640,2002000,2,3526,883,1,30764800,30764800,1321,440,881,440,0,1,442,183149,0.183149
840,550,3640,2002000,2,6726,1683,1,44172800,44172800,2521,840,1681,840,0,1,842,17570,0.01757
1240,550,3640,2002000,2,9926,2483,1,57580800,57580800,3721,1240,2481,1240,0,1,1242,410175,0.410175
1640,550,3640,2002000,2,13126,3283,1,70988800,70988800,4921,1640,3281,1640,0,1,1642,274111,0.274111
2040,550,3640,2002000,2,16326,4083,1,84396800,84396800,6121,2040,4081,2040,0,1,2042,681876,0.681876
2440,550,3640,2002000,2,19526,4883,1,97804800,97804800,7321,2440,4881,2440,0,1,2442,936055,0.936055
2840,550,3640,2002000,2,22726,5683,1,111212800,111212800,8521,2840,5681,2840,0,1,2842,1086553,1.086553
3240,550,3640,2002000,2,25926,6483,1,124620800,124620800,9721,3240,6481,3240,0,1,3242,245177,0.245177
3640,550,3640,2002000,2,29126,7283,1,138028800,138028800,10921,3640,7281,3640,0,1,3642,577673,0.577673
4040,550,3640,2002000,2,32326,8083,1,151436800,151436800,12121,4040,8081,4040,0,1,4042,248549,0.248549
4440,550,3640,2002000,2,35526,8883,1,164844800,164844800,13321,4440,8881,4440,0,1,4442,547471,0.547471
4840,550,3640,2002000,2,38726,9683,1,178252800,178252800,14521,4840,9681,4840,0,1,4842,39332,0.039332
5240,550,3640,2002000,2,41926,10483,1,191660800,191660800,15721,5240,10481,5240,0,1,5242,840924,0.840924
5640,550,3640,2002000,2,45126,11283,1,205068800,205068800,16921,5640,11281,5640,0,1,5642,300611,0.300611
6040,550,3640,2002000,2,48326,12083,1,218476800,218476800,18121,6040,12081,6040,0,1,6042,673404,0.673404
6440,550,3640,2002000,2,51526,12883,1,231884800,231884800,19321,6440,12881,6440,0,1,6442,1216912,1.216912
6840,550,3640,2002000,2,54726,13683,1,245292800,245292800,20521,6840,13681,6840,0,1,6842,822672,0.822672
40,1300,1540,2002000,2,326,83,1,16924800,16924800,121,40,81,40,0,1,42,39256,0.039256
440,1300,1540,2002000,2,3526,883,1,26012800,26012800,1321,440,881,440,0,1,442,187942,0.187942
840,1300,1540,2002000,2,6726,1683,1,35100800,35100800,2521,840,1681,840,0,1,842,339386,0.339386
1240,1300,1540,2002000,2,9926,2483,1,44188800,44188800,3721,1240,2481,1240,0,1,1242,167936,0.167936
1640,1300,1540,2002000,2,13126,3283,1,53276800,53276800,4921,1640,3281,1640,0,1,1642,513521,0.513521
2040,1300,1540,2002000,2,16326,4083,1,62364800,62364800,6121,2040,4081,2040,0,1,2042,215358,0.215358
2440,1300,1540,2002000,2,19526,4883,1,71452800,71452800,7321,2440,4881,2440,0,1,2442,965170,0.96517
2840,1300,1540,2002000,2,22726,5683,1,80540800,80540800,8521,2840,5681,2840,0,1,2842,924432,0.924432
3240,1300,1540,2002000,2,25926,6483,1,89628800,89628800,9721,3240,6481,3240,0,1,3242,1082591,1.082591
3640,1300,1540,2002000,2,29126,7283,1,98716800,98716800,10921,3640,7281,3640,0,1,3642,1161603,1.161603
4040,1300,1540,2002000,2,32326,8083,1,107804800,107804800,12121,4040,8081,4040,0,1,4042,152967,0.152967
4440,1300,1540,2002000,2,35526,8883,1,116892800,116892800,13321,4440,8881,4440,0,1,4442,901181,0.901181
4840,1300,1540,2002000,2,38726,9683,1,125980800,125980800,14521,4840,9681,4840,0,1,4842,319110,0.31911
5240,1300,1540,2002000,2,41926,10483,1,135068800,135068800,15721,5240,10481,5240,0,1,5242,1297168,1.297168
5640,1300,1540,2002000,2,45126,11283,1,144156800,144156800,16921,5640,11281,5640,0,1,5642,1552705,1.552705
6040,1300,1540,2002000,2,48326,12083,1,153244800,153244800,18121,6040,12081,6040,0,1,6042,2362355,2.362355
6440,1300,1540,2002000,2,51526,12883,1,162332800,162332800,19321,6440,12881,6440,0,1,6442,2228876,2.228876
6840,1300,1540,2002000,2,54726,13683,1,171420800,171420800,20521,6840,13681,6840,0,1,6842,590665,0.590665
55,5555,365,2027575,2,446,113,1,18825400,18825400,166,55,111,55,0,1,57,43020,0.04302
455,5555,365,2027575,2,3646,913,1,37769400,37769400,1366,455,911,455,0,1,457,185599,0.185599
855,5555,365,2027575,2,6846,1713,1,56713400,56713400,2566,855,1711,855,0,1,857,344365,0.344365
1255,5555,365,2027575,2,10046,2513,1,75657400,75657400,3766,1255,2511,1255,0,1,1257,119154,0.119154
1655,5555,365,2027575,2,13246,3313,1,94601400,94601400,4966,1655,3311,1655,0,1,1657,670943,0.670943
2055,5555,365,2027575,2,16446,4113,1,113545400,113545400,6166,2055,4111,2055,0,1,2057,830764,0.830764
2455,5555,365,2027575,2,19646,4913,1,132489400,132489400,7366,2455,4911,2455,0,1,2457,1004152,1.004152
2855,5555,365,2027575,2,22846,5713,1,151433400,151433400,8566,2855,5711,2855,0,1,2857,1166645,1.166645
3255,5555,365,2027575,2,26046,6513,1,170377400,170377400,9766,3255,6511,3255,0,1,3257,254143,0.254143
3655,5555,365,2027575,2,29246,7313,1,189321400,189321400,10966,3655,7311,3655,0,1,3657,688789,0.688789
4055,5555,365,2027575,2,32446,8113,1,208265400,208265400,12166,4055,8111,4055,0,1,4057,638509,0.638509
4455,5555,365,2027575,2,35646,8913,1,227209400,227209400,13366,4455,8911,4455,0,1,4457,274590,0.27459
4855,5555,365,2027575,2,38846,9713,1,246153400,246153400,14566,4855,9711,4855,0,1,4857,1973836,1.973836
5255,5555,365,2027575,2,42046,10513,1,265097400,265097400,15766,5255,10511,5255,0,1,5257,2152254,2.152254
5655,5555,365,2027575,2,45246,11313,1,284041400,284041400,16966,5655,11311,5655,0,1,5657,2297216,2.297216
6055,5555,365,2027575,2,48446,12113,1,302985400,302985400,18166,6055,12111,6055,0,1,6057,2465794,2.465794
6455,5555,365,2027575,2,51646,12913,1,321929400,321929400,19366,6455,12911,6455,0,1,6457,2613385,2.613385
6855,5555,365,2027575,2,54846,13713,1,340873400,340873400,20566,6855,13711,6855,0,1,6857,2555917,2.555917
55,3055,665,2031575,2,446,113,1,17889400,17889400,166,55,111,55,0,1,57,7789,0.007789
455,3055,665,2031575,2,3646,913,1,29793400,29793400,1366,455,911,455,0,1,457,16777,0.016777
855,3055,665,2031575,2,6846,1713,1,41697400,41697400,2566,855,1711,855,0,1,857,214859,0.214859
1255,3055,665,2031575,2,10046,2513,1,53601400,53601400,3766,1255,2511,1255,0,1,1257,47543,0.047543
1655,3055,665,2031575,2,13246,3313,1,65505400,65505400,4966,1655,3311,1655,0,1,1657,370761,0.370761
2055,3055,665,2031575,2,16446,4113,1,77409400,77409400,6166,2055,4111,2055,0,1,2057,810605,0.810605
2455,3055,665,2031575,2,19646,4913,1,89313400,89313400,7366,2455,4911,2455,0,1,2457,299584,0.299584
2855,3055,665,2031575,2,22846,5713,1,101217400,101217400,8566,2855,5711,2855,0,1,2857,169753,0.169753
3255,3055,665,2031575,2,26046,6513,1,113121400,113121400,9766,3255,6511,3255,0,1,3257,1311517,1.311517
3655,3055,665,2031575,2,29246,7313,1,125025400,125025400,10966,3655,7311,3655,0,1,3657,11952,0.011952
4055,3055,665,2031575,2,32446,8113,1,136929400,136929400,12166,4055,8111,4055,0,1,4057,499284,0.499284
4455,3055,665,2031575,2,35646,8913,1,148833400,148833400,13366,4455,8911,4455,0,1,4457,1019693,1.019693
4855,3055,665,2031575,2,38846,9713,1,160737400,160737400,14566,4855,9711,4855,0,1,4857,1344150,1.34415
5255,3055,665,2031575,2,42046,10513,1,172641400,172641400,15766,5255,10511,5255,0,1,5257,1486584,1.486584
5655,3055,665,2031575,2,45246,11313,1,184545400,184545400,16966,5655,11311,5655,0,1,5657,2079592,2.079592
6055,3055,665,2031575,2,48446,12113,1,196449400,196449400,18166,6055,12111,6055,0,1,6057,979913,0.979913
6455,3055,665,2031575,2,51646,12913,1,208353400,208353400,19366,6455,12911,6455,0,1,6457,190807,0.190807
6855,3055,665,2031575,2,54846,13713,1,220257400,220257400,20566,6855,13711,6855,0,1,6857,1736382,1.736382
55,305,6665,2032825,2,446,113,1,19329400,19329400,166,55,111,55,0,1,57,4113,0.004113
455,305,6665,2032825,2,3646,913,1,41633400,41633400,1366,455,911,455,0,1,457,196769,0.196769
855,305,6665,2032825,2,6846,1713,1,63937400,63937400,2566,855,1711,855,0,1,857,310316,0.310316
1255,305,6665,2032825,2,10046,2513,1,86241400,86241400,3766,1255,2511,1255,0,1,1257,511130,0.51113
1655,305,6665,2032825,2,13246,3313,1,108545400,108545400,4966,1655,3311,1655,0,1,1657,274483,0.274483
2055,305,6665,2032825,2,16446,4113,1,130849400,130849400,6166,2055,4111,2055,0,1,2057,830890,0.83089
2455,305,6665,2032825,2,19646,4913,1,153153400,153153400,7366,2455,4911,2455,0,1,2457,232911,0.232911
2855,305,6665,2032825,2,22846,5713,1,175457400,175457400,8566,2855,5711,2855,0,1,2857,492400,0.4924
3255,305,6665,2032825,2,26046,6513,1,197761400,197761400,9766,3255,6511,3255,0,1,3257,155603,0.155603
3655,305,6665,2032825,2,29246,7313,1,220065400,220065400,10966,3655,7311,3655,0,1,3657,23714,0.023714
4055,305,6665,2032825,2,32446,8113,1,242369400,242369400,12166,4055,8111,4055,0,1,4057,225281,0.225281
4455,305,6665,2032825,2,35646,8913,1,264673400,264673400,13366,4455,8911,4455,0,1,4457,162283,0.162283
4855,305,6665,2032825,2,38846,9713,1,286977400,286977400,14566,4855,9711,4855,0,1,4857,1096022,1.096022
5255,305,6665,2032825,2,42046,10513,1,309281400,309281400,15766,5255,10511,5255,0,1,5257,520532,0.520532
5655,305,6665,2032825,2,45246,11313,1,331585400,331585400,16966,5655,11311,5655,0,1,5657,941070,0.94107
6055,305,6665,2032825,2,48446,12113,1,353889400,353889400,18166,6055,12111,6055,0,1,6057,36009,0.036009
6455,305,6665,2032825,2,51646,12913,1,376193400,376193400,19366,6455,12911,6455,0,1,6457,79109,0.079109
6855,305,6665,2032825,2,54846,13713,1,398497400,398497400,20566,6855,13711,6855,0,1,6857,296423,0.296423
55,555,3665,2034075,2,446,113,1,18129400,18129400,166,55,111,55,0,1,57,43242,0.043242
455,555,3665,2034075,2,3646,913,1,31633400,31633400,1366,455,911,455,0,1,457,7317,0.007317
855,555,3665,2034075,2,6846,1713,1,45137400,45137400,2566,855,1711,855,0,1,857,7310,0.00731
1255,555,3665,2034075,2,10046,2513,1,58641400,58641400,3766,1255,2511,1255,0,1,1257,506802,0.506802
1655,555,3665,2034075,2,13246,3313,1,72145400,72145400,4966,1655,3311,1655,0,1,1657,260767,0.260767
2055,555,3665,2034075,2,16446,4113,1,85649400,85649400,6166,2055,4111,2055,0,1,2057,818285,0.818285
2455,555,3665,2034075,2,19646,4913,1,99153400,99153400,7366,2455,4911,2455,0,1,2457,973293,0.973293
2855,555,3665,2034075,2,22846,5713,1,112657400,112657400,8566,2855,5711,2855,0,1,2857,458044,0.458044
3255,555,3665,2034075,2,26046,6513,1,126161400,126161400,9766,3255,6511,3255,0,1,3257,284032,0.284032
3655,555,3665,2034075,2,29246,7313,1,139665400,139665400,10966,3655,7311,3655,0,1,3657,1135299,1.135299
4055,555,3665,2034075,2,32446,8113,1,153169400,153169400,12166,4055,8111,4055,0,1,4057,99227,0.099227
4455,555,3665,2034075,2,35646,8913,1,166673400,166673400,13366,4455,8911,4455,0,1,4457,152717,0.152717
4855,555,3665,2034075,2,38846,9713,1,180177400,180177400,14566,4855,9711,4855,0,1,4857,1722654,1.722654
5255,555,3665,2034075,2,42046,10513,1,193681400,193681400,15766,5255,10511,5255,0,1,5257,965277,0.965277
5655,555,3665,2034075,2,45246,11313,1,207185400,207185400,16966,5655,11311,5655,0,1,5657,72371,0.072371
6055,555,3665,2034075,2,48446,12113,1,220689400,220689400,18166,6055,12111,6055,0,1,6057,1931301,1.931301
6455,555,3665,2034075,2,51646,12913,1,234193400,234193400,19366,6455,12911,6455,0,1,6457,609711,0.609711
6855,555,3665,2034075,2,54846,13713,1,247697400,247697400,20566,6855,13711,6855,0,1,6857,54625,0.054625
55,1305,1565,2042325,2,446,113,1,17601400,17601400,166,55,111,55,0,1,57,42044,0.042044
455,1305,1565,2042325,2,3646,913,1,26785400,26785400,1366,455,911,455,0,1,457,195756,0.195756
855,1305,1565,2042325,2,6846,1713,1,35969400,35969400,2566,855,1711,855,0,1,857,95495,0.095495
1255,1305,1565,2042325,2,10046,2513,1,45153400,45153400,3766,1255,2511,1255,0,1,1257,490415,0.490415
1655,1305,1565,2042325,2,13246,3313,1,54337400,54337400,4966,1655,3311,1655,0,1,1657,86947,0.086947
2055,1305,1565,2042325,2,16446,4113,1,63521400,63521400,6166,2055,4111,2055,0,1,2057,836170,0.83617
2455,1305,1565,2042325,2,19646,4913,1,72705400,72705400,7366,2455,4911,2455,0,1,2457,666736,0.666736
2855,1305,1565,2042325,2,22846,5713,1,81889400,81889400,8566,2855,5711,2855,0,1,2857,176285,0.176285
3255,1305,1565,2042325,2,26046,6513,1,91073400,91073400,9766,3255,6511,3255,0,1,3257,1312959,1.312959
3655,1305,1565,2042325,2,29246,7313,1,100257400,100257400,10966,3655,7311,3655,0,1,3657,1456052,1.456052
4055,1305,1565,2042325,2,32446,8113,1,109441400,109441400,12166,4055,8111,4055,0,1,4057,1458393,1.458393
4455,1305,1565,2042325,2,35646,8913,1,118625400,118625400,13366,4455,8911,4455,0,1,4457,172066,0.172066
4855,1305,1565,2042325,2,38846,9713,1,127809400,127809400,14566,4855,9711,4855,0,1,4857,1354931,1.354931
5255,1305,1565,2042325,2,42046,10513,1,136993400,136993400,15766,5255,10511,5255,0,1,5257,469478,0.469478
5655,1305,1565,2042325,2,45246,11313,1,146177400,146177400,16966,5655,11311,5655,0,1,5657,2271514,2.271514
6055,1305,1565,2042325,2,48446,12113,1,155361400,155361400,18166,6055,12111,6055,0,1,6057,2437367,2.437367
6455,1305,1565,2042325,2,51646,12913,1,164545400,164545400,19366,6455,12911,6455,0,1,6457,1775678,1.775678
6855,1305,1565,2042325,2,54846,13713,1,173729400,173729400,20566,6855,13711,6855,0,1,6857,2428767,2.428767
40,6050,340,2057000,2,326,83,1,18500800,18500800,121,40,81,40,0,1,42,36579,0.036579
440,6050,340,2057000,2,3526,883,1,38948800,38948800,1321,440,881,440,0,1,442,181088,0.181088
840,6050,340,2057000,2,6726,1683,1,59396800,59396800,2521,840,1681,840,0,1,842,190896,0.190896
1240,6050,340,2057000,2,9926,2483,1,79844800,79844800,3721,1240,2481,1240,0,1,1242,494579,0.494579
1640,6050,340,2057000,2,13126,3283,1,100292800,100292800,4921,1640,3281,1640,0,1,1642,651857,0.651857
2040,6050,340,2057000,2,16326,4083,1,120740800,120740800,6121,2040,4081,2040,0,1,2042,810863,0.810863
2440,6050,340,2057000,2,19526,4883,1,141188800,141188800,7321,2440,4881,2440,0,1,2442,973426,0.973426
2840,6050,340,2057000,2,22726,5683,1,161636800,161636800,8521,2840,5681,2840,0,1,2842,1148609,1.148609
3240,6050,340,2057000,2,25926,6483,1,182084800,182084800,9721,3240,6481,3240,0,1,3242,283649,0.283649
3640,6050,340,2057000,2,29126,7283,1,202532800,202532800,10921,3640,7281,3640,0,1,3642,888775,0.888775
4040,6050,340,2057000,2,32326,8083,1,222980800,222980800,12121,4040,8081,4040,0,1,4042,1603989,1.603989
4440,6050,340,2057000,2,35526,8883,1,243428800,243428800,13321,4440,8881,4440,0,1,4442,1788878,1.788878
4840,6050,340,2057000,2,38726,9683,1,263876800,263876800,14521,4840,9681,4840,0,1,4842,1458418,1.458418
5240,6050,340,2057000,2,41926,10483,1,284324800,284324800,15721,5240,10481,5240,0,1,5242,1346104,1.346104
5640,6050,340,2057000,2,45126,11283,1,304772800,304772800,16921,5640,11281,5640,0,1,5642,2272173,2.272173
6040,6050,340,2057000,2,48326,12083,1,325220800,325220800,18121,6040,12081,6040,0,1,6042,2424769,2.424769
6440,6050,340,2057000,2,51526,12883,1,345668800,345668800,19321,6440,12881,6440,0,1,6442,2581587,2.581587
6840,6050,340,2057000,2,54726,13683,1,366116800,366116800,20521,6840,13681,6840,0,1,6842,1435355,1.435355
40,300,6940,2082000,2,326,83,1,18972800,18972800,121,40,81,40,0,1,42,39666,0.039666
440,300,6940,2082000,2,3526,883,1,42140800,42140800,1321,440,881,440,0,1,442,197330,0.19733
840,300,6940,2082000,2,6726,1683,1,65308800,65308800,2521,840,1681,840,0,1,842,142512,0.142512
1240,300,6940,2082000,2,9926,2483,1,88476800,88476800,3721,1240,2481,1240,0,1,1242,514455,0.514455
1640,300,6940,2082000,2,13126,3283,1,111644800,111644800,4921,1640,3281,1640,0,1,1642,59227,0.059227
2040,300,6940,2082000,2,16326,4083,1,134812800,134812800,6121,2040,4081,2040,0,1,2042,38059,0.038059
2440,300,6940,2082000,2,19526,4883,1,157980800,157980800,7321,2440,4881,2440,0,1,2442,998267,0.998267
2840,300,6940,2082000,2,22726,5683,1,181148800,181148800,8521,2840,5681,2840,0,1,2842,81631,0.081631
3240,300,6940,2082000,2,25926,6483,1,204316800,204316800,9721,3240,6481,3240,0,1,3242,120410,0.12041
3640,300,6940,2082000,2,29126,7283,1,227484800,227484800,10921,3640,7281,3640,0,1,3642,582322,0.582322
4040,300,6940,2082000,2,32326,8083,1,250652800,250652800,12121,4040,8081,4040,0,1,4042,429161,0.429161
4440,300,6940,2082000,2,35526,8883,1,273820800,273820800,13321,4440,8881,4440,0,1,4442,1808245,1.808245
4840,300,6940,2082000,2,38726,9683,1,296988800,296988800,14521,4840,9681,4840,0,1,4842,185712,0.185712
5240,300,6940,2082000,2,41926,10483,1,320156800,320156800,15721,5240,10481,5240,0,1,5242,629246,0.629246
5640,300,6940,2082000,2,45126,11283,1,343324800,343324800,16921,5640,11281,5640,0,1,5642,210063,0.210063
6040,300,6940,2082000,2,48326,12083,1,366492800,366492800,18121,6040,12081,6040,0,1,6042,395264,0.395264
6440,300,6940,2082000,2,51526,12883,1,389660800,389660800,19321,6440,12881,6440,0,1,6442,1616205,1.616205
6840,300,6940,2082000,2,54726,13683,1,412828800,412828800,20521,6840,13681,6840,0,1,6842,324750,0.32475
35,590,3545,2091550,2,286,73,1,17890200,17890200,106,35,71,35,0,1,37,5885,0.005885
535,590,3545,2091550,2,4286,1073,1,34430200,34430200,1606,535,1071,535,0,1,537,74571,0.074571
1035,590,3545,2091550,2,8286,2073,1,50970200,50970200,3106,1035,2071,1035,0,1,1037,139627,0.139627
1535,590,3545,2091550,2,12286,3073,1,67510200,67510200,4606,1535,3071,1535,0,1,1537,95038,0.095038
2035,590,3545,2091550,2,16286,4073,1,84050200,84050200,6106,2035,4071,2035,0,1,2037,79815,0.079815
2535,590,3545,2091550,2,20286,5073,1,100590200,100590200,7606,2535,5071,2535,0,1,2537,1065244,1.065244
3035,590,3545,2091550,2,24286,6073,1,117130200,117130200,9106,3035,6071,3035,0,1,3037,1269975,1.269975
3535,590,3545,2091550,2,28286,7073,1,133670200,133670200,10606,3535,7071,3535,0,1,3537,1484817,1.484817
4035,590,3545,2091550,2,32286,8073,1,150210200,150210200,12106,4035,8071,4035,0,1,4037,1696527,1.696527
4535,590,3545,2091550,2,36286,9073,1,166750200,166750200,13606,4535,9071,4535,0,1,4537,1908486,1.908486
5035,590,3545,2091550,2,40286,10073,1,183290200,183290200,15106,5035,10071,5035,0,1,5037,2138837,2.138837
5535,590,3545,2091550,2,44286,11073,1,199830200,199830200,16606,5535,11071,5535,0,1,5537,2332874,2.332874
6035,590,3545,2091550,2,48286,12073,1,216370200,216370200,18106,6035,12071,6035,0,1,6037,2547607,2.547607
6535,590,3545,2091550,2,52286,13073,1,232910200,232910200,19606,6535,13071,6535,0,1,6537,2757991,2.757991
7035,590,3545,2091550,2,56286,14073,1,249450200,249450200,21106,7035,14071,7035,0,1,7037,2991141,2.991141
39,593,3541,2099813,2,318,81,1,18088312,18088312,118,39,79,39,0,1,41,42069,0.042069
539,593,3541,2099813,2,4318,1081,1,34624312,34624312,1618,539,1079,539,0,1,541,51542,0.051542
1039,593,3541,2099813,2,8318,2081,1,51160312,51160312,3118,1039,2079,1039,0,1,1041,429890,0.42989
1539,593,3541,2099813,2,12318,3081,1,67696312,67696312,4618,1539,3079,1539,0,1,1541,633296,0.633296
2039,593,3541,2099813,2,16318,4081,1,84232312,84232312,6118,2039,4079,2039,0,1,2041,650921,0.650921
2539,593,3541,2099813,2,20318,5081,1,100768312,100768312,7618,2539,5079,2539,0,1,2541,171156,0.171156
3039,593,3541,2099813,2,24318,6081,1,117304312,117304312,9118,3039,6079,3039,0,1,3041,7490,0.00749
3539,593,3541,2099813,2,28318,7081,1,133840312,133840312,10618,3539,7079,3539,0,1,3541,733634,0.733634
4039,593,3541,2099813,2,32318,8081,1,150376312,150376312,12118,4039,8079,4039,0,1,4041,168610,0.16861
4539,593,3541,2099813,2,36318,9081,1,166912312,166912312,13618,4539,9079,4539,0,1,4541,469664,0.469664
5039,593,3541,2099813,2,40318,10081,1,183448312,183448312,15118,5039,10079,5039,0,1,5041,1064173,1.064173
5539,593,3541,2099813,2,44318,11081,1,199984312,199984312,16618,5539,11079,5539,0,1,5541,1632259,1.632259
6039,593,3541,2099813,2,48318,12081,1,216520312,216520312,18118,6039,12079,6039,0,1,6041,32879,0.032879
6539,593,3541,2099813,2,52318,13081,1,233056312,233056312,19618,6539,13079,6539,0,1,6541,522854,0.522854
7039,593,3541,2099813,2,56318,14081,1,249592312,249592312,21118,7039,14079,7039,0,1,7041,1875076,1.875076
39,3893,541,2106113,2,318,81,1,18232312,18232312,118,39,79,39,0,1,41,38399,0.038399
539,3893,541,2106113,2,4318,1081,1,35968312,35968312,1618,539,1079,539,0,1,541,231453,0.231453
1039,3893,541,2106113,2,8318,2081,1,53704312,53704312,3118,1039,2079,1039,0,1,1041,440159,0.440159
1539,3893,541,2106113,2,12318,3081,1,71440312,71440312,4618,1539,3079,1539,0,1,1541,651500,0.6515
2039,3893,541,2106113,2,16318,4081,1,89176312,89176312,6118,2039,4079,2039,0,1,2041,859482,0.859482
2539,3893,541,2106113,2,20318,5081,1,106912312,106912312,7618,2539,5079,2539,0,1,2541,1066819,1.066819
3039,3893,541,2106113,2,24318,6081,1,124648312,124648312,9118,3039,6079,3039,0,1,3041,1280288,1.280288
3539,3893,541,2106113,2,28318,7081,1,142384312,142384312,10618,3539,7079,3539,0,1,3541,467139,0.467139
4039,3893,541,2106113,2,32318,8081,1,160120312,160120312,12118,4039,8079,4039,0,1,4041,1708735,1.708735
4539,3893,541,2106113,2,36318,9081,1,177856312,177856312,13618,4539,9079,4539,0,1,4541,686137,0.686137
5039,3893,541,2106113,2,40318,10081,1,195592312,195592312,15118,5039,10079,5039,0,1,5041,548527,0.548527
5539,3893,541,2106113,2,44318,11081,1,213328312,213328312,16618,5539,11079,5539,0,1,5541,2362117,2.362117
6039,3893,541,2106113,2,48318,12081,1,231064312,231064312,18118,6039,12079,6039,0,1,6041,2090002,2.090002
6539,3893,541,2106113,2,52318,13081,1,248800312,248800312,19618,6539,13079,6539,0,1,6541,1263406,1.263406
7039,3893,541,2106113,2,56318,14081,1,266536312,266536312,21118,7039,14079,7039,0,1,7041,2984604,2.984604
40,3300,640,2112000,2,326,83,1,18156800,18156800,121,40,81,40,0,1,42,36594,0.036594
440,3300,640,2112000,2,3526,883,1,30764800,30764800,1321,440,881,440,0,1,442,188668,0.188668
840,3300,640,2112000,2,6726,1683,1,43372800,43372800,2521,840,1681,840,0,1,842,342504,0.342504
1240,3300,640,2112000,2,9926,2483,1,55980800,55980800,3721,1240,2481,1240,0,1,1242,501807,0.501807
1640,3300,640,2112000,2,13126,3283,1,68588800,68588800,4921,1640,3281,1640,0,1,1642,296972,0.296972
2040,3300,640,2112000,2,16326,4083,1,81196800,81196800,6121,2040,4081,2040,0,1,2042,830067,0.830067
2440,3300,640,2112000,2,19526,4883,1,93804800,93804800,7321,2440,4881,2440,0,1,2442,984578,0.984578
2840,3300,640,2112000,2,22726,5683,1,106412800,106412800,8521,2840,5681,2840,0,1,2842,1144085,1.144085
3240,3300,640,2112000,2,25926,6483,1,119020800,119020800,9721,3240,6481,3240,0,1,3242,1211239,1.211239
3640,3300,640,2112000,2,29126,7283,1,131628800,131628800,10921,3640,7281,3640,0,1,3642,1327063,1.327063
4040,3300,640,2112000,2,32326,8083,1,144236800,144236800,12121,4040,8081,4040,0,1,4042,95826,0.095826
4440,3300,640,2112000,2,35526,8883,1,156844800,156844800,13321,4440,8881,4440,0,1,4442,1031545,1.031545
4840,3300,640,2112000,2,38726,9683,1,169452800,169452800,14521,4840,9681,4840,0,1,4842,1950096,1.950096
5240,3300,640,2112000,2,41926,10483,1,182060800,182060800,15721,5240,10481,5240,0,1,5242,311096,0.311096
5640,3300,640,2112000,2,45126,11283,1,194668800,194668800,16921,5640,11281,5640,0,1,5642,61129,0.061129
6040,3300,640,2112000,2,48326,12083,1,207276800,207276800,18121,6040,12081,6040,0,1,6042,1715007,1.715007
6440,3300,640,2112000,2,51526,12883,1,219884800,219884800,19321,6440,12881,6440,0,1,6442,1526147,1.526147
6840,3300,640,2112000,2,54726,13683,1,232492800,232492800,20521,6840,13681,6840,0,1,6842,13040,0.01304
55,5805,365,2118825,2,446,113,1,19665400,19665400,166,55,111,55,0,1,57,7542,0.007542
455,5805,365,2118825,2,3646,913,1,39409400,39409400,1366,455,911,455,0,1,457,11283,0.011283
855,5805,365,2118825,2,6846,1713,1,59153400,59153400,2566,855,1711,855,0,1,857,206368,0.206368
1255,5805,365,2118825,2,10046,2513,1,78897400,78897400,3766,1255,2511,1255,0,1,1257,450010,0.45001
1655,5805,365,2118825,2,13246,3313,1,98641400,98641400,4966,1655,3311,1655,0,1,1657,315269,0.315269
2055,5805,365,2118825,2,16446,4113,1,118385400,118385400,6166,2055,4111,2055,0,1,2057,133395,0.133395
2455,5805,365,2118825,2,19646,4913,1,138129400,138129400,7366,2455,4911,2455,0,1,2457,69757,0.069757
2855,5805,365,2118825,2,22846,5713,1,157873400,157873400,8566,2855,5711,2855,0,1,2857,205443,0.205443
3255,5805,365,2118825,2,26046,6513,1,177617400,177617400,9766,3255,6511,3255,0,1,3257,474584,0.474584
3655,5805,365,2118825,2,29246,7313,1,197361400,197361400,10966,3655,7311,3655,0,1,3657,816450,0.81645
4055,5805,365,2118825,2,32446,8113,1,217105400,217105400,12166,4055,8111,4055,0,1,4057,88973,0.088973
4455,5805,365,2118825,2,35646,8913,1,236849400,236849400,13366,4455,8911,4455,0,1,4457,1870460,1.87046
4855,5805,365,2118825,2,38846,9713,1,256593400,256593400,14566,4855,9711,4855,0,1,4857,808646,0.808646
5255,5805,365,2118825,2,42046,10513,1,276337400,276337400,15766,5255,10511,5255,0,1,5257,2221471,2.221471
5655,5805,365,2118825,2,45246,11313,1,296081400,296081400,16966,5655,11311,5655,0,1,5657,666451,0.666451
6055,5805,365,2118825,2,48446,12113,1,315825400,315825400,18166,6055,12111,6055,0,1,6057,2563051,2.563051
6455,5805,365,2118825,2,51646,12913,1,335569400,335569400,19366,6455,12911,6455,0,1,6457,1535817,1.535817
6855,5805,365,2118825,2,54846,13713,1,355313400,355313400,20566,6855,13711,6855,0,1,6857,1968844,1.968844
55,305,6965,2124325,2,446,113,1,20193400,20193400,166,55,111,55,0,1,57,45742,0.045742
455,305,6965,2124325,2,3646,913,1,43457400,43457400,1366,455,911,455,0,1,457,155581,0.155581
855,305,6965,2124325,2,6846,1713,1,66721400,66721400,2566,855,1711,855,0,1,857,341836,0.341836
1255,305,6965,2124325,2,10046,2513,1,89985400,89985400,3766,1255,2511,1255,0,1,1257,139194,0.139194
1655,305,6965,2124325,2,13246,3313,1,113249400,113249400,4966,1655,3311,1655,0,1,1657,367260,0.36726
2055,305,6965,2124325,2,16446,4113,1,136513400,136513400,6166,2055,4111,2055,0,1,2057,117583,0.117583
2455,305,6965,2124325,2,19646,4913,1,159777400,159777400,7366,2455,4911,2455,0,1,2457,704687,0.704687
2855,305,6965,2124325,2,22846,5713,1,183041400,183041400,8566,2855,5711,2855,0,1,2857,526038,0.526038
3255,305,6965,2124325,2,26046,6513,1,206305400,206305400,9766,3255,6511,3255,0,1,3257,541712,0.541712
3655,305,6965,2124325,2,29246,7313,1,229569400,229569400,10966,3655,7311,3655,0,1,3657,1536177,1.536177
4055,305,6965,2124325,2,32446,8113,1,252833400,252833400,12166,4055,8111,4055,0,1,4057,152211,0.152211
4455,305,6965,2124325,2,35646,8913,1,276097400,276097400,13366,4455,8911,4455,0,1,4457,92987,0.092987
4855,305,6965,2124325,2,38846,9713,1,299361400,299361400,14566,4855,9711,4855,0,1,4857,843130,0.84313
5255,305,6965,2124325,2,42046,10513,1,322625400,322625400,15766,5255,10511,5255,0,1,5257,919968,0.919968
5655,305,6965,2124325,2,45246,11313,1,345889400,345889400,16966,5655,11311,5655,0,1,5657,1710436,1.710436
6055,305,6965,2124325,2,48446,12113,1,369153400,369153400,18166,6055,12111,6055,0,1,6057,414725,0.414725
6455,305,6965,2124325,2,51646,12913,1,392417400,392417400,19366,6455,12911,6455,0,1,6457,335714,0.335714
6855,305,6965,2124325,2,54846,13713,1,415681400,415681400,20566,6855,13711,6855,0,1,6857,1585913,1.585913
40,6300,340,2142000,2,326,83,1,19260800,19260800,121,40,81,40,0,1,42,39444,0.039444
440,6300,340,2142000,2,3526,883,1,40508800,40508800,1321,440,881,440,0,1,442,191052,0.191052
840,6300,340,2142000,2,6726,1683,1,61756800,61756800,2521,840,1681,840,0,1,842,353887,0.353887
1240,6300,340,2142000,2,9926,2483,1,83004800,83004800,3721,1240,2481,1240,0,1,1242,516635,0.516635
1640,6300,340,2142000,2,13126,3283,1,104252800,104252800,4921,1640,3281,1640,0,1,1642,696364,0.696364
2040,6300,340,2142000,2,16326,4083,1,125500800,125500800,6121,2040,4081,2040,0,1,2042,842453,0.842453
2440,6300,340,2142000,2,19526,4883,1,146748800,146748800,7321,2440,4881,2440,0,1,2442,488711,0.488711
2840,6300,340,2142000,2,22726,5683,1,167996800,167996800,8521,2840,5681,2840,0,1,2842,1172466,1.172466
3240,6300,340,2142000,2,25926,6483,1,189244800,189244800,9721,3240,6481,3240,0,1,3242,1354416,1.354416
3640,6300,340,2142000,2,29126,7283,1,210492800,210492800,10921,3640,7281,3640,0,1,3642,575156,0.575156
4040,6300,340,2142000,2,32326,8083,1,231740800,231740800,12121,4040,8081,4040,0,1,4042,826984,0.826984
4440,6300,340,2142000,2,35526,8883,1,252988800,252988800,13321,4440,8881,4440,0,1,4442,287438,0.287438
4840,6300,340,2142000,2,38726,9683,1,274236800,274236800,14521,4840,9681,4840,0,1,4842,1854536,1.854536
5240,6300,340,2142000,2,41926,10483,1,295484800,295484800,15721,5240,10481,5240,0,1,5242,425666,0.425666
5640,6300,340,2142000,2,45126,11283,1,316732800,316732800,16921,5640,11281,5640,0,1,5642,1290602,1.290602
6040,6300,340,2142000,2,48326,12083,1,337980800,337980800,18121,6040,12081,6040,0,1,6042,2516570,2.51657
6440,6300,340,2142000,2,51526,12883,1,359228800,359228800,19321,6440,12881,6440,0,1,6442,2689914,2.689914
6840,6300,340,2142000,2,54726,13683,1,380476800,380476800,20521,6840,13681,6840,0,1,6842,2920919,2.920919
44,603,3555,2143665,2,358,91,1,18612936,18612936,133,44,89,44,0,1,46,42420,0.04242
544,603,3555,2143665,2,4358,1091,1,35244936,35244936,1633,544,1089,544,0,1,546,62101,0.062101
1044,603,3555,2143665,2,8358,2091,1,51876936,51876936,3133,1044,2089,1044,0,1,1046,104607,0.104607
1544,603,3555,2143665,2,12358,3091,1,68508936,68508936,4633,1544,3089,1544,0,1,1546,4116,0.004116
2044,603,3555,2143665,2,16358,4091,1,85140936,85140936,6133,2044,4089,2044,0,1,2046,234609,0.234609
2544,603,3555,2143665,2,20358,5091,1,101772936,101772936,7633,2544,5089,2544,0,1,2546,302021,0.302021
3044,603,3555,2143665,2,24358,6091,1,118404936,118404936,9133,3044,6089,3044,0,1,3046,595427,0.595427
3544,603,3555,2143665,2,28358,7091,1,135036936,135036936,10633,3544,7089,3544,0,1,3546,445906,0.445906
4044,603,3555,2143665,2,32358,8091,1,151668936,151668936,12133,4044,8089,4044,0,1,4046,142505,0.142505
4544,603,3555,2143665,2,36358,9091,1,168300936,168300936,13633,4544,9089,4544,0,1,4546,436965,0.436965
5044,603,3555,2143665,2,40358,10091,1,184932936,184932936,15133,5044,10089,5044,0,1,5046,403493,0.403493
5544,603,3555,2143665,2,44358,11091,1,201564936,201564936,16633,5544,11089,5544,0,1,5546,23610,0.02361
6044,603,3555,2143665,2,48358,12091,1,218196936,218196936,18133,6044,12089,6044,0,1,6046,202331,0.202331
6544,603,3555,2143665,2,52358,13091,1,234828936,234828936,19633,6544,13089,6544,0,1,6546,1216078,1.216078
7044,603,3555,2143665,2,56358,14091,1,251460936,251460936,21133,7044,14089,7044,0,1,7046,1296456,1.296456
40,2300,940,2162000,2,326,83,1,18332800,18332800,121,40,81,40,0,1,42,40182,0.040182
440,2300,940,2162000,2,3526,883,1,28700800,28700800,1321,440,881,440,0,1,442,196983,0.196983
840,2300,940,2162000,2,6726,1683,1,39068800,39068800,2521,840,1681,840,0,1,842,359311,0.359311
1240,2300,940,2162000,2,9926,2483,1,49436800,49436800,3721,1240,2481,1240,0,1,1242,331509,0.331509
1640,2300,940,2162000,2,13126,3283,1,59804800,59804800,4921,1640,3281,1640,0,1,1642,691391,0.691391
2040,2300,940,2162000,2,16326,4083,1,70172800,70172800,6121,2040,4081,2040,0,1,2042,849635,0.849635
2440,2300,940,2162000,2,19526,4883,1,80540800,80540800,7321,2440,4881,2440,0,1,2442,423416,0.423416
2840,2300,940,2162000,2,22726,5683,1,90908800,90908800,8521,2840,5681,2840,0,1,2842,1178045,1.178045
3240,2300,940,2162000,2,25926,6483,1,101276800,101276800,9721,3240,6481,3240,0,1,3242,630335,0.630335
3640,2300,940,2162000,2,29126,7283,1,111644800,111644800,10921,3640,7281,3640,0,1,3642,492017,0.492017
4040,2300,940,2162000,2,32326,8083,1,122012800,122012800,12121,4040,8081,4040,0,1,4042,968018,0.968018
4440,2300,940,2162000,2,35526,8883,1,132380800,132380800,13321,4440,8881,4440,0,1,4442,447314,0.447314
4840,2300,940,2162000,2,38726,9683,1,142748800,142748800,14521,4840,9681,4840,0,1,4842,2003388,2.003388
5240,2300,940,2162000,2,41926,10483,1,153116800,153116800,15721,5240,10481,5240,0,1,5242,1235823,1.235823
5640,2300,940,2162000,2,45126,11283,1,163484800,163484800,16921,5640,11281,5640,0,1,5642,1154699,1.154699
6040,2300,940,2162000,2,48326,12083,1,173852800,173852800,18121,6040,12081,6040,0,1,6042,2509448,2.509448
6440,2300,940,2162000,2,51526,12883,1,184220800,184220800,19321,6440,12881,6440,0,1,6442,161666,0.161666
6840,2300,940,2162000,2,54726,13683,1,194588800,194588800,20521,6840,13681,6840,0,1,6842,559692,0.559692
44,3903,555,2166165,2,358,91,1,18898536,18898536,133,44,89,44,0,1,46,41853,0.041853
544,3903,555,2166165,2,4358,1091,1,36730536,36730536,1633,544,1089,544,0,1,546,241693,0.241693
1044,3903,555,2166165,2,8358,2091,1,54562536,54562536,3133,1044,2089,1044,0,1,1046,452149,0.452149
1544,3903,555,2166165,2,12358,3091,1,72394536,72394536,4633,1544,3089,1544,0,1,1546,668322,0.668322
2044,3903,555,2166165,2,16358,4091,1,90226536,90226536,6133,2044,4089,2044,0,1,2046,153432,0.153432
2544,3903,555,2166165,2,20358,5091,1,108058536,108058536,7633,2544,5089,2544,0,1,2546,941970,0.94197
3044,3903,555,2166165,2,24358,6091,1,125890536,125890536,9133,3044,6089,3044,0,1,3046,1315271,1.315271
3544,3903,555,2166165,2,28358,7091,1,143722536,143722536,10633,3544,7089,3544,0,1,3546,1534905,1.534905
4044,3903,555,2166165,2,32358,8091,1,161554536,161554536,12133,4044,8089,4044,0,1,4046,762080,0.76208
4544,3903,555,2166165,2,36358,9091,1,179386536,179386536,13633,4544,9089,4544,0,1,4546,1953978,1.953978
5044,3903,555,2166165,2,40358,10091,1,197218536,197218536,15133,5044,10089,5044,0,1,5046,26496,0.026496
5544,3903,555,2166165,2,44358,11091,1,215050536,215050536,16633,5544,11089,5544,0,1,5546,183079,0.183079
6044,3903,555,2166165,2,48358,12091,1,232882536,232882536,18133,6044,12089,6044,0,1,6046,1593891,1.593891
6544,3903,555,2166165,2,52358,13091,1,250714536,250714536,19633,6544,13089,6544,0,1,6546,2841787,2.841787
7044,3903,555,2166165,2,56358,14091,1,268546536,268546536,21133,7044,14089,7044,0,1,7046,3043760,3.04376
40,550,3940,2167000,2,326,83,1,18772800,18772800,121,40,81,40,0,1,42,40913,0.040913
440,550,3940,2167000,2,3526,883,1,33140800,33140800,1321,440,881,440,0,1,442,199092,0.199092
840,550,3940,2167000,2,6726,1683,1,47508800,47508800,2521,840,1681,840,0,1,842,304467,0.304467
1240,550,3940,2167000,2,9926,2483,1,61876800,61876800,3721,1240,2481,1240,0,1,1242,528939,0.528939
1640,550,3940,2167000,2,13126,3283,1,76244800,76244800,4921,1640,3281,1640,0,1,1642,420912,0.420912
2040,550,3940,2167000,2,16326,4083,1,90612800,90612800,6121,2040,4081,2040,0,1,2042,856860,0.85686
2440,550,3940,2167000,2,19526,4883,1,104980800,104980800,7321,2440,4881,2440,0,1,2442,23260,0.02326
2840,550,3940,2167000,2,22726,5683,1,119348800,119348800,8521,2840,5681,2840,0,1,2842,442867,0.442867
3240,550,3940,2167000,2,25926,6483,1,133716800,133716800,9721,3240,6481,3240,0,1,3242,313981,0.313981
3640,550,3940,2167000,2,29126,7283,1,148084800,148084800,10921,3640,7281,3640,0,1,3642,170329,0.170329
4040,550,3940,2167000,2,32326,8083,1,162452800,162452800,12121,4040,8081,4040,0,1,4042,453120,0.45312
4440,550,3940,2167000,2,35526,8883,1,176820800,176820800,13321,4440,8881,4440,0,1,4442,68488,0.068488
4840,550,3940,2167000,2,38726,9683,1,191188800,191188800,14521,4840,9681,4840,0,1,4842,896702,0.896702
5240,550,3940,2167000,2,41926,10483,1,205556800,205556800,15721,5240,10481,5240,0,1,5242,111292,0.111292
5640,550,3940,2167000,2,45126,11283,1,219924800,219924800,16921,5640,11281,5640,0,1,5642,2343505,2.343505
6040,550,3940,2167000,2,48326,12083,1,234292800,234292800,18121,6040,12081,6040,0,1,6042,364816,0.364816
6440,550,3940,2167000,2,51526,12883,1,248660800,248660800,19321,6440,12881,6440,0,1,6442,743459,0.743459
6840,550,3940,2167000,2,54726,13683,1,263028800,263028800,20521,6840,13681,6840,0,1,6842,701682,0.701682
40,800,2740,2192000,2,326,83,1,18668800,18668800,121,40,81,40,0,1,42,40728,0.040728
440,800,2740,2192000,2,3526,883,1,29996800,29996800,1321,440,881,440,0,1,442,199767,0.199767
840,800,2740,2192000,2,6726,1683,1,41324800,41324800,2521,840,1681,840,0,1,842,292449,0.292449
1240,800,2740,2192000,2,9926,2483,1,52652800,52652800,3721,1240,2481,1240,0,1,1242,530723,0.530723
1640,800,2740,2192000,2,13126,3283,1,63980800,63980800,4921,1640,3281,1640,0,1,1642,46066,0.046066
2040,800,2740,2192000,2,16326,4083,1,75308800,75308800,6121,2040,4081,2040,0,1,2042,8776,0.008776
2440,800,2740,2192000,2,19526,4883,1,86636800,86636800,7321,2440,4881,2440,0,1,2442,902621,0.902621
2840,800,2740,2192000,2,22726,5683,1,97964800,97964800,8521,2840,5681,2840,0,1,2842,1126481,1.126481
3240,800,2740,2192000,2,25926,6483,1,109292800,109292800,9721,3240,6481,3240,0,1,3242,137621,0.137621
3640,800,2740,2192000,2,29126,7283,1,120620800,120620800,10921,3640,7281,3640,0,1,3642,192170,0.19217
4040,800,2740,2192000,2,32326,8083,1,131948800,131948800,12121,4040,8081,4040,0,1,4042,719803,0.719803
4440,800,2740,2192000,2,35526,8883,1,143276800,143276800,13321,4440,8881,4440,0,1,4442,1208989,1.208989
4840,800,2740,2192000,2,38726,9683,1,154604800,154604800,14521,4840,9681,4840,0,1,4842,883500,0.8835
5240,800,2740,2192000,2,41926,10483,1,165932800,165932800,15721,5240,10481,5240,0,1,5242,1128541,1.128541
5640,800,2740,2192000,2,45126,11283,1,177260800,177260800,16921,5640,11281,5640,0,1,5642,1356831,1.356831
6040,800,2740,2192000,2,48326,12083,1,188588800,188588800,18121,6040,12081,6040,0,1,6042,163214,0.163214
6440,800,2740,2192000,2,51526,12883,1,199916800,199916800,19321,6440,12881,6440,0,1,6442,907448,0.907448
6840,800,2740,2192000,2,54726,13683,1,211244800,211244800,20521,6840,13681,6840,0,1,6842,29665,0.029665
55,3305,665,2197825,2,446,113,1,19329400,19329400,166,55,111,55,0,1,57,45593,0.045593
455,3305,665,2197825,2,3646,913,1,32033400,32033400,1366,455,911,455,0,1,457,205559,0.205559
855,3305,665,2197825,2,6846,1713,1,44737400,44737400,2566,855,1711,855,0,1,857,380046,0.380046
1255,3305,665,2197825,2,10046,2513,1,57441400,57441400,3766,1255,2511,1255,0,1,1257,556034,0.556034
1655,3305,665,2197825,2,13246,3313,1,70145400,70145400,4966,1655,3311,1655,0,1,1657,733768,0.733768
2055,3305,665,2197825,2,16446,4113,1,82849400,82849400,6166,2055,4111,2055,0,1,2057,904502,0.904502
2455,3305,665,2197825,2,19646,4913,1,95553400,95553400,7366,2455,4911,2455,0,1,2457,167930,0.16793
2855,3305,665,2197825,2,22846,5713,1,108257400,108257400,8566,2855,5711,2855,0,1,2857,1253772,1.253772
3255,3305,665,2197825,2,26046,6513,1,120961400,120961400,9766,3255,6511,3255,0,1,3257,740167,0.740167
3655,3305,665,2197825,2,29246,7313,1,133665400,133665400,10966,3655,7311,3655,0,1,3657,802145,0.802145
4055,3305,665,2197825,2,32446,8113,1,146369400,146369400,12166,4055,8111,4055,0,1,4057,756862,0.756862
4455,3305,665,2197825,2,35646,8913,1,159073400,159073400,13366,4455,8911,4455,0,1,4457,736117,0.736117
4855,3305,665,2197825,2,38846,9713,1,171777400,171777400,14566,4855,9711,4855,0,1,4857,779252,0.779252
5255,3305,665,2197825,2,42046,10513,1,184481400,184481400,15766,5255,10511,5255,0,1,5257,581168,0.581168
5655,3305,665,2197825,2,45246,11313,1,197185400,197185400,16966,5655,11311,5655,0,1,5657,2304110,2.30411
6055,3305,665,2197825,2,48446,12113,1,209889400,209889400,18166,6055,12111,6055,0,1,6057,2642143,2.642143
6455,3305,665,2197825,2,51646,12913,1,222593400,222593400,19366,6455,12911,6455,0,1,6457,2814634,2.814634
6855,3305,665,2197825,2,54846,13713,1,235297400,235297400,20566,6855,13711,6855,0,1,6857,2290355,2.290355
55,555,3965,2200575,2,446,113,1,19593400,19593400,166,55,111,55,0,1,57,47201,0.047201
455,555,3965,2200575,2,3646,913,1,34057400,34057400,1366,455,911,455,0,1,457,208061,0.208061
855,555,3965,2200575,2,6846,1713,1,48521400,48521400,2566,855,1711,855,0,1,857,379435,0.379435
1255,555,3965,2200575,2,10046,2513,1,62985400,62985400,3766,1255,2511,1255,0,1,1257,4636,0.004636
1655,555,3965,2200575,2,13246,3313,1,77449400,77449400,4966,1655,3311,1655,0,1,1657,266864,0.266864
2055,555,3965,2200575,2,16446,4113,1,91913400,91913400,6166,2055,4111,2055,0,1,2057,569061,0.569061
2455,555,3965,2200575,2,19646,4913,1,106377400,106377400,7366,2455,4911,2455,0,1,2457,445663,0.445663
2855,555,3965,2200575,2,22846,5713,1,120841400,120841400,8566,2855,5711,2855,0,1,2857,65941,0.065941
3255,555,3965,2200575,2,26046,6513,1,135305400,135305400,9766,3255,6511,3255,0,1,3257,9598,0.009598
3655,555,3965,2200575,2,29246,7313,1,149769400,149769400,10966,3655,7311,3655,0,1,3657,354775,0.354775
4055,555,3965,2200575,2,32446,8113,1,164233400,164233400,12166,4055,8111,4055,0,1,4057,1729581,1.729581
4455,555,3965,2200575,2,35646,8913,1,178697400,178697400,13366,4455,8911,4455,0,1,4457,437361,0.437361
4855,555,3965,2200575,2,38846,9713,1,193161400,193161400,14566,4855,9711,4855,0,1,4857,2071298,2.071298
5255,555,3965,2200575,2,42046,10513,1,207625400,207625400,15766,5255,10511,5255,0,1,5257,1711642,1.711642
5655,555,3965,2200575,2,45246,11313,1,222089400,222089400,16966,5655,11311,5655,0,1,5657,194276,0.194276
6055,555,3965,2200575,2,48446,12113,1,236553400,236553400,18166,6055,12111,6055,0,1,6057,907227,0.907227
6455,555,3965,2200575,2,51646,12913,1,251017400,251017400,19366,6455,12911,6455,0,1,6457,1763430,1.76343
6855,555,3965,2200575,2,54846,13713,1,265481400,265481400,20566,6855,13711,6855,0,1,6857,1814923,1.814923
55,6055,365,2210075,2,446,113,1,20505400,20505400,166,55,111,55,0,1,57,43605,0.043605
455,6055,365,2210075,2,3646,913,1,41049400,41049400,1366,455,911,455,0,1,457,202734,0.202734
855,6055,365,2210075,2,6846,1713,1,61593400,61593400,2566,855,1711,855,0,1,857,371357,0.371357
1255,6055,365,2210075,2,10046,2513,1,82137400,82137400,3766,1255,2511,1255,0,1,1257,545592,0.545592
1655,6055,365,2210075,2,13246,3313,1,102681400,102681400,4966,1655,3311,1655,0,1,1657,386510,0.38651
2055,6055,365,2210075,2,16446,4113,1,123225400,123225400,6166,2055,4111,2055,0,1,2057,385339,0.385339
2455,6055,365,2210075,2,19646,4913,1,143769400,143769400,7366,2455,4911,2455,0,1,2457,1070070,1.07007
2855,6055,365,2210075,2,22846,5713,1,164313400,164313400,8566,2855,5711,2855,0,1,2857,1242538,1.242538
3255,6055,365,2210075,2,26046,6513,1,184857400,184857400,9766,3255,6511,3255,0,1,3257,815138,0.815138
3655,6055,365,2210075,2,29246,7313,1,205401400,205401400,10966,3655,7311,3655,0,1,3657,37435,0.037435
4055,6055,365,2210075,2,32446,8113,1,225945400,225945400,12166,4055,8111,4055,0,1,4057,665936,0.665936
4455,6055,365,2210075,2,35646,8913,1,246489400,246489400,13366,4455,8911,4455,0,1,4457,1503614,1.503614
4855,6055,365,2210075,2,38846,9713,1,267033400,267033400,14566,4855,9711,4855,0,1,4857,2146809,2.146809
5255,6055,365,2210075,2,42046,10513,1,287577400,287577400,15766,5255,10511,5255,0,1,5257,1471554,1.471554
5655,6055,365,2210075,2,45246,11313,1,308121400,308121400,16966,5655,11311,5655,0,1,5657,160726,0.160726
6055,6055,365,2210075,2,48446,12113,1,328665400,328665400,18166,6055,12111,6055,0,1,6057,2646888,2.646888
6455,6055,365,2210075,2,51646,12913,1,349209400,349209400,19366,6455,12911,6455,0,1,6457,2070953,2.070953
6855,6055,365,2210075,2,54846,13713,1,369753400,369753400,20566,6855,13711,6855,0,1,6857,2995704,2.995704
55,2305,965,2224325,2,446,113,1,19233400,19233400,166,55,111,55,0,1,57,45542,0.045542
455,2305,965,2224325,2,3646,913,1,29697400,29697400,1366,455,911,455,0,1,457,207078,0.207078
855,2305,965,2224325,2,6846,1713,1,40161400,40161400,2566,855,1711,855,0,1,857,372959,0.372959
1255,2305,965,2224325,2,10046,2513,1,50625400,50625400,3766,1255,2511,1255,0,1,1257,540657,0.540657
1655,2305,965,2224325,2,13246,3313,1,61089400,61089400,4966,1655,3311,1655,0,1,1657,142467,0.142467
2055,2305,965,2224325,2,16446,4113,1,71553400,71553400,6166,2055,4111,2055,0,1,2057,877924,0.877924
2455,2305,965,2224325,2,19646,4913,1,82017400,82017400,7366,2455,4911,2455,0,1,2457,1044930,1.04493
2855,2305,965,2224325,2,22846,5713,1,92481400,92481400,8566,2855,5711,2855,0,1,2857,1015411,1.015411
3255,2305,965,2224325,2,26046,6513,1,102945400,102945400,9766,3255,6511,3255,0,1,3257,401516,0.401516
3655,2305,965,2224325,2,29246,7313,1,113409400,113409400,10966,3655,7311,3655,0,1,3657,1551699,1.551699
4055,2305,965,2224325,2,32446,8113,1,123873400,123873400,12166,4055,8111,4055,0,1,4057,615162,0.615162
4455,2305,965,2224325,2,35646,8913,1,134337400,134337400,13366,4455,8911,4455,0,1,4457,1889481,1.889481
4855,2305,965,2224325,2,38846,9713,1,144801400,144801400,14566,4855,9711,4855,0,1,4857,251537,0.251537
5255,2305,965,2224325,2,42046,10513,1,155265400,155265400,15766,5255,10511,5255,0,1,5257,1325526,1.325526
5655,2305,965,2224325,2,45246,11313,1,165729400,165729400,16966,5655,11311,5655,0,1,5657,2141832,2.141832
6055,2305,965,2224325,2,48446,12113,1,176193400,176193400,18166,6055,12111,6055,0,1,6057,2565054,2.565054
6455,2305,965,2224325,2,51646,12913,1,186657400,186657400,19366,6455,12911,6455,0,1,6457,2002118,2.002118
6855,2305,965,2224325,2,54846,13713,1,197121400,197121400,20566,6855,13711,6855,0,1,6857,283063,0.283063
55,805,2765,2225825,2,446,113,1,19377400,19377400,166,55,111,55,0,1,57,46425,0.046425
455,805,2765,2225825,2,3646,913,1,30801400,30801400,1366,455,911,455,0,1,457,211592,0.211592
855,805,2765,2225825,2,6846,1713,1,42225400,42225400,2566,855,1711,855,0,1,857,338259,0.338259
1255,805,2765,2225825,2,10046,2513,1,53649400,53649400,3766,1255,2511,1255,0,1,1257,44865,0.044865
1655,805,2765,2225825,2,13246,3313,1,65073400,65073400,4966,1655,3311,1655,0,1,1657,387204,0.387204
2055,805,2765,2225825,2,16446,4113,1,76497400,76497400,6166,2055,4111,2055,0,1,2057,262118,0.262118
2455,805,2765,2225825,2,19646,4913,1,87921400,87921400,7366,2455,4911,2455,0,1,2457,954161,0.954161
2855,805,2765,2225825,2,22846,5713,1,99345400,99345400,8566,2855,5711,2855,0,1,2857,246964,0.246964
3255,805,2765,2225825,2,26046,6513,1,110769400,110769400,9766,3255,6511,3255,0,1,3257,601169,0.601169
3655,805,2765,2225825,2,29246,7313,1,122193400,122193400,10966,3655,7311,3655,0,1,3657,62338,0.062338
4055,805,2765,2225825,2,32446,8113,1,133617400,133617400,12166,4055,8111,4055,0,1,4057,680913,0.680913
4455,805,2765,2225825,2,35646,8913,1,145041400,145041400,13366,4455,8911,4455,0,1,4457,1914842,1.914842
4855,805,2765,2225825,2,38846,9713,1,156465400,156465400,14566,4855,9711,4855,0,1,4857,1737280,1.73728
5255,805,2765,2225825,2,42046,10513,1,167889400,167889400,15766,5255,10511,5255,0,1,5257,585468,0.585468
5655,805,2765,2225825,2,45246,11313,1,179313400,179313400,16966,5655,11311,5655,0,1,5657,2428056,2.428056
6055,805,2765,2225825,2,48446,12113,1,190737400,190737400,18166,6055,12111,6055,0,1,6057,1331723,1.331723
6455,805,2765,2225825,2,51646,12913,1,202161400,202161400,19366,6455,12911,6455,0,1,6457,330142,0.330142
6855,805,2765,2225825,2,54846,13713,1,213585400,213585400,20566,6855,13711,6855,0,1,6857,518742,0.518742
40,6550,340,2227000,2,326,83,1,20020800,20020800,121,40,81,40,0,1,42,5597,0.005597
440,6550,340,2227000,2,3526,883,1,42068800,42068800,1321,440,881,440,0,1,442,18815,0.018815
840,6550,340,2227000,2,6726,1683,1,64116800,64116800,2521,840,1681,840,0,1,842,297913,0.297913
1240,6550,340,2227000,2,9926,2483,1,86164800,86164800,3721,1240,2481,1240,0,1,1242,151729,0.151729
1640,6550,340,2227000,2,13126,3283,1,108212800,108212800,4921,1640,3281,1640,0,1,1642,457883,0.457883
2040,6550,340,2227000,2,16326,4083,1,130260800,130260800,6121,2040,4081,2040,0,1,2042,161897,0.161897
2440,6550,340,2227000,2,19526,4883,1,152308800,152308800,7321,2440,4881,2440,0,1,2442,1094437,1.094437
2840,6550,340,2227000,2,22726,5683,1,174356800,174356800,8521,2840,5681,2840,0,1,2842,118598,0.118598
3240,6550,340,2227000,2,25926,6483,1,196404800,196404800,9721,3240,6481,3240,0,1,3242,185902,0.185902
3640,6550,340,2227000,2,29126,7283,1,218452800,218452800,10921,3640,7281,3640,0,1,3642,68787,0.068787
4040,6550,340,2227000,2,32326,8083,1,240500800,240500800,12121,4040,8081,4040,0,1,4042,120339,0.120339
4440,6550,340,2227000,2,35526,8883,1,262548800,262548800,13321,4440,8881,4440,0,1,4442,66216,0.066216
4840,6550,340,2227000,2,38726,9683,1,284596800,284596800,14521,4840,9681,4840,0,1,4842,15445,0.015445
5240,6550,340,2227000,2,41926,10483,1,306644800,306644800,15721,5240,10481,5240,0,1,5242,1211831,1.211831
5640,6550,340,2227000,2,45126,11283,1,328692800,328692800,16921,5640,11281,5640,0,1,5642,610157,0.610157
6040,6550,340,2227000,2,48326,12083,1,350740800,350740800,18121,6040,12081,6040,0,1,6042,1519281,1.519281
6440,6550,340,2227000,2,51526,12883,1,372788800,372788800,19321,6440,12881,6440,0,1,6442,1020656,1.020656
6840,6550,340,2227000,2,54726,13683,1,394836800,394836800,20521,6840,13681,6840,0,1,6842,1939278,1.939278
40,1800,1240,2232000,2,326,83,1,18828800,18828800,121,40,81,40,0,1,42,41755,0.041755
440,1800,1240,2232000,2,3526,883,1,28556800,28556800,1321,440,881,440,0,1,442,207716,0.207716
840,1800,1240,2232000,2,6726,1683,1,38284800,38284800,2521,840,1681,840,0,1,842,378786,0.378786
1240,1800,1240,2232000,2,9926,2483,1,48012800,48012800,3721,1240,2481,1240,0,1,1242,50629,0.050629
1640,1800,1240,2232000,2,13126,3283,1,57740800,57740800,4921,1640,3281,1640,0,1,1642,292978,0.292978
2040,1800,1240,2232000,2,16326,4083,1,67468800,67468800,6121,2040,4081,2040,0,1,2042,719898,0.719898
2440,1800,1240,2232000,2,19526,4883,1,77196800,77196800,7321,2440,4881,2440,0,1,2442,733278,0.733278
2840,1800,1240,2232000,2,22726,5683,1,86924800,86924800,8521,2840,5681,2840,0,1,2842,1243767,1.243767
3240,1800,1240,2232000,2,25926,6483,1,96652800,96652800,9721,3240,6481,3240,0,1,3242,315776,0.315776
3640,1800,1240,2232000,2,29126,7283,1,106380800,106380800,10921,3640,7281,3640,0,1,3642,1571718,1.571718
4040,1800,1240,2232000,2,32326,8083,1,116108800,116108800,12121,4040,8081,4040,0,1,4042,1762225,1.762225
4440,1800,1240,2232000,2,35526,8883,1,125836800,125836800,13321,4440,8881,4440,0,1,4442,1323946,1.323946
4840,1800,1240,2232000,2,38726,9683,1,135564800,135564800,14521,4840,9681,4840,0,1,4842,367556,0.367556
5240,1800,1240,2232000,2,41926,10483,1,145292800,145292800,15721,5240,10481,5240,0,1,5242,266098,0.266098
5640,1800,1240,2232000,2,45126,11283,1,155020800,155020800,16921,5640,11281,5640,0,1,5642,669864,0.669864
6040,1800,1240,2232000,2,48326,12083,1,164748800,164748800,18121,6040,12081,6040,0,1,6042,2614141,2.614141
6440,1800,1240,2232000,2,51526,12883,1,174476800,174476800,19321,6440,12881,6440,0,1,6442,2218026,2.218026
6840,1800,1240,2232000,2,54726,13683,1,184204800,184204800,20521,6840,13681,6840,0,1,6842,328643,0.328643
40,1050,2140,2247000,2,326,83,1,18996800,18996800,121,40,81,40,0,1,42,6005,0.006005
440,1050,2140,2247000,2,3526,883,1,29204800,29204800,1321,440,881,440,0,1,442,45619,0.045619
840,1050,2140,2247000,2,6726,1683,1,39412800,39412800,2521,840,1681,840,0,1,842,2060,0.00206
1240,1050,2140,2247000,2,9926,2483,1,49620800,49620800,3721,1240,2481,1240,0,1,1242,87188,0.087188
1640,1050,2140,2247000,2,13126,3283,1,59828800,59828800,4921,1640,3281,1640,0,1,1642,16614,0.016614
2040,1050,2140,2247000,2,16326,4083,1,70036800,70036800,6121,2040,4081,2040,0,1,2042,29986,0.029986
2440,1050,2140,2247000,2,19526,4883,1,80244800,80244800,7321,2440,4881,2440,0,1,2442,225713,0.225713
2840,1050,2140,2247000,2,22726,5683,1,90452800,90452800,8521,2840,5681,2840,0,1,2842,97611,0.097611
3240,1050,2140,2247000,2,25926,6483,1,100660800,100660800,9721,3240,6481,3240,0,1,3242,94134,0.094134
3640,1050,2140,2247000,2,29126,7283,1,110868800,110868800,10921,3640,7281,3640,0,1,3642,1065225,1.065225
4040,1050,2140,2247000,2,32326,8083,1,121076800,121076800,12121,4040,8081,4040,0,1,4042,672751,0.672751
4440,1050,2140,2247000,2,35526,8883,1,131284800,131284800,13321,4440,8881,4440,0,1,4442,41486,0.041486
4840,1050,2140,2247000,2,38726,9683,1,141492800,141492800,14521,4840,9681,4840,0,1,4842,16499,0.016499
5240,1050,2140,2247000,2,41926,10483,1,151700800,151700800,15721,5240,10481,5240,0,1,5242,552055,0.552055
5640,1050,2140,2247000,2,45126,11283,1,161908800,161908800,16921,5640,11281,5640,0,1,5642,151477,0.151477
6040,1050,2140,2247000,2,48326,12083,1,172116800,172116800,18121,6040,12081,6040,0,1,6042,377196,0.377196
6440,1050,2140,2247000,2,51526,12883,1,182324800,182324800,19321,6440,12881,6440,0,1,6442,472931,0.472931
6840,1050,2140,2247000,2,54726,13683,1,192532800,192532800,20521,6840,13681,6840,0,1,6842,99540,0.09954
40,3550,640,2272000,2,326,83,1,19516800,19516800,121,40,81,40,0,1,42,39386,0.039386
440,3550,640,2272000,2,3526,883,1,32924800,32924800,1321,440,881,440,0,1,442,198216,0.198216
840,3550,640,2272000,2,6726,1683,1,46332800,46332800,2521,840,1681,840,0,1,842,369360,0.36936
1240,3550,640,2272000,2,9926,2483,1,59740800,59740800,3721,1240,2481,1240,0,1,1242,544257,0.544257
1640,3550,640,2272000,2,13126,3283,1,73148800,73148800,4921,1640,3281,1640,0,1,1642,721450,0.72145
2040,3550,640,2272000,2,16326,4083,1,86556800,86556800,6121,2040,4081,2040,0,1,2042,885237,0.885237
2440,3550,640,2272000,2,19526,4883,1,99964800,99964800,7321,2440,4881,2440,0,1,2442,1031682,1.031682
2840,3550,640,2272000,2,22726,5683,1,113372800,113372800,8521,2840,5681,2840,0,1,2842,788247,0.788247
3240,3550,640,2272000,2,25926,6483,1,126780800,126780800,9721,3240,6481,3240,0,1,3242,1401774,1.401774
3640,3550,640,2272000,2,29126,7283,1,140188800,140188800,10921,3640,7281,3640,0,1,3642,1135966,1.135966
4040,3550,640,2272000,2,32326,8083,1,153596800,153596800,12121,4040,8081,4040,0,1,4042,1757813,1.757813
4440,3550,640,2272000,2,35526,8883,1,167004800,167004800,13321,4440,8881,4440,0,1,4442,1911687,1.911687
4840,3550,640,2272000,2,38726,9683,1,180412800,180412800,14521,4840,9681,4840,0,1,4842,2092575,2.092575
5240,3550,640,2272000,2,41926,10483,1,193820800,193820800,15721,5240,10481,5240,0,1,5242,808825,0.808825
5640,3550,640,2272000,2,45126,11283,1,207228800,207228800,16921,5640,11281,5640,0,1,5642,2128825,2.128825
6040,3550,640,2272000,2,48326,12083,1,220636800,220636800,18121,6040,12081,6040,0,1,6042,1435445,1.435445
6440,3550,640,2272000,2,51526,12883,1,234044800,234044800,19321,6440,12881,6440,0,1,6442,2776549,2.776549
6840,3550,640,2272000,2,54726,13683,1,247452800,247452800,20521,6840,13681,6840,0,1,6842,2950522,2.950522
55,1805,1265,2283325,2,446,113,1,19617400,19617400,166,55,111,55,0,1,57,48391,0.048391
455,1805,1265,2283325,2,3646,913,1,29441400,29441400,1366,455,911,455,0,1,457,221597,0.221597
855,1805,1265,2283325,2,6846,1713,1,39265400,39265400,2566,855,1711,855,0,1,857,396412,0.396412
1255,1805,1265,2283325,2,10046,2513,1,49089400,49089400,3766,1255,2511,1255,0,1,1257,574169,0.574169
1655,1805,1265,2283325,2,13246,3313,1,58913400,58913400,4966,1655,3311,1655,0,1,1657,12904,0.012904
2055,1805,1265,2283325,2,16446,4113,1,68737400,68737400,6166,2055,4111,2055,0,1,2057,932931,0.932931
2455,1805,1265,2283325,2,19646,4913,1,78561400,78561400,7366,2455,4911,2455,0,1,2457,1108169,1.108169
2855,1805,1265,2283325,2,22846,5713,1,88385400,88385400,8566,2855,5711,2855,0,1,2857,1290784,1.290784
3255,1805,1265,2283325,2,26046,6513,1,98209400,98209400,9766,3255,6511,3255,0,1,3257,1174363,1.174363
3655,1805,1265,2283325,2,29246,7313,1,108033400,108033400,10966,3655,7311,3655,0,1,3657,460140,0.46014
4055,1805,1265,2283325,2,32446,8113,1,117857400,117857400,12166,4055,8111,4055,0,1,4057,1342210,1.34221
4455,1805,1265,2283325,2,35646,8913,1,127681400,127681400,13366,4455,8911,4455,0,1,4457,859320,0.85932
4855,1805,1265,2283325,2,38846,9713,1,137505400,137505400,14566,4855,9711,4855,0,1,4857,257289,0.257289
5255,1805,1265,2283325,2,42046,10513,1,147329400,147329400,15766,5255,10511,5255,0,1,5257,275067,0.275067
5655,1805,1265,2283325,2,45246,11313,1,157153400,157153400,16966,5655,11311,5655,0,1,5657,2085792,2.085792
6055,1805,1265,2283325,2,48446,12113,1,166977400,166977400,18166,6055,12111,6055,0,1,6057,2649022,2.649022
6455,1805,1265,2283325,2,51646,12913,1,176801400,176801400,19366,6455,12911,6455,0,1,6457,335728,0.335728
6855,1805,1265,2283325,2,54846,13713,1,186625400,186625400,20566,6855,13711,6855,0,1,6857,20043,0.020043
55,1055,2165,2284075,2,446,113,1,19689400,19689400,166,55,111,55,0,1,57,4720,0.00472
455,1055,2165,2284075,2,3646,913,1,29993400,29993400,1366,455,911,455,0,1,457,2192,0.002192
855,1055,2165,2284075,2,6846,1713,1,40297400,40297400,2566,855,1711,855,0,1,857,77595,0.077595
1255,1055,2165,2284075,2,10046,2513,1,50601400,50601400,3766,1255,2511,1255,0,1,1257,153826,0.153826
1655,1055,2165,2284075,2,13246,3313,1,60905400,60905400,4966,1655,3311,1655,0,1,1657,252948,0.252948
2055,1055,2165,2284075,2,16446,4113,1,71209400,71209400,6166,2055,4111,2055,0,1,2057,90986,0.090986
2455,1055,2165,2284075,2,19646,4913,1,81513400,81513400,7366,2455,4911,2455,0,1,2457,4089,0.004089
2855,1055,2165,2284075,2,22846,5713,1,91817400,91817400,8566,2855,5711,2855,0,1,2857,292639,0.292639
3255,1055,2165,2284075,2,26046,6513,1,102121400,102121400,9766,3255,6511,3255,0,1,3257,538724,0.538724
3655,1055,2165,2284075,2,29246,7313,1,112425400,112425400,10966,3655,7311,3655,0,1,3657,413561,0.413561
4055,1055,2165,2284075,2,32446,8113,1,122729400,122729400,12166,4055,8111,4055,0,1,4057,648953,0.648953
4455,1055,2165,2284075,2,35646,8913,1,133033400,133033400,13366,4455,8911,4455,0,1,4457,249253,0.249253
4855,1055,2165,2284075,2,38846,9713,1,143337400,143337400,14566,4855,9711,4855,0,1,4857,1059995,1.059995
5255,1055,2165,2284075,2,42046,10513,1,153641400,153641400,15766,5255,10511,5255,0,1,5257,277372,0.277372
5655,1055,2165,2284075,2,45246,11313,1,163945400,163945400,16966,5655,11311,5655,0,1,5657,946026,0.946026
6055,1055,2165,2284075,2,48446,12113,1,174249400,174249400,18166,6055,12111,6055,0,1,6057,671115,0.671115
6455,1055,2165,2284075,2,51646,12913,1,184553400,184553400,19366,6455,12911,6455,0,1,6457,198134,0.198134
6855,1055,2165,2284075,2,54846,13713,1,194857400,194857400,20566,6855,13711,6855,0,1,6857,245884,0.245884
55,6305,365,2301325,2,446,113,1,21345400,21345400,166,55,111,55,0,1,57,46665,0.046665
455,6305,365,2301325,2,3646,913,1,42689400,42689400,1366,455,911,455,0,1,457,211365,0.211365
855,6305,365,2301325,2,6846,1713,1,64033400,64033400,2566,855,1711,855,0,1,857,392795,0.392795
1255,6305,365,2301325,2,10046,2513,1,85377400,85377400,3766,1255,2511,1255,0,1,1257,572709,0.572709
1655,6305,365,2301325,2,13246,3313,1,106721400,106721400,4966,1655,3311,1655,0,1,1657,754136,0.754136
2055,6305,365,2301325,2,16446,4113,1,128065400,128065400,6166,2055,4111,2055,0,1,2057,935780,0.93578
2455,6305,365,2301325,2,19646,4913,1,149409400,149409400,7366,2455,4911,2455,0,1,2457,1128214,1.128214
2855,6305,365,2301325,2,22846,5713,1,170753400,170753400,8566,2855,5711,2855,0,1,2857,78815,0.078815
3255,6305,365,2301325,2,26046,6513,1,192097400,192097400,9766,3255,6511,3255,0,1,3257,1476044,1.476044
3655,6305,365,2301325,2,29246,7313,1,213441400,213441400,10966,3655,7311,3655,0,1,3657,1549901,1.549901
4055,6305,365,2301325,2,32446,8113,1,234785400,234785400,12166,4055,8111,4055,0,1,4057,270837,0.270837
4455,6305,365,2301325,2,35646,8913,1,256129400,256129400,13366,4455,8911,4455,0,1,4457,1934912,1.934912
4855,6305,365,2301325,2,38846,9713,1,277473400,277473400,14566,4855,9711,4855,0,1,4857,2228528,2.228528
5255,6305,365,2301325,2,42046,10513,1,298817400,298817400,15766,5255,10511,5255,0,1,5257,2394260,2.39426
5655,6305,365,2301325,2,45246,11313,1,320161400,320161400,16966,5655,11311,5655,0,1,5657,2583168,2.583168
6055,6305,365,2301325,2,48446,12113,1,341505400,341505400,18166,6055,12111,6055,0,1,6057,2788257,2.788257
6455,6305,365,2301325,2,51646,12913,1,362849400,362849400,19366,6455,12911,6455,0,1,6457,2946677,2.946677
6855,6305,365,2301325,2,54846,13713,1,384193400,384193400,20566,6855,13711,6855,0,1,6857,3127796,3.127796
40,6800,340,2312000,2,326,83,1,20780800,20780800,121,40,81,40,0,1,42,40456,0.040456
440,6800,340,2312000,2,3526,883,1,43628800,43628800,1321,440,881,440,0,1,442,204234,0.204234
840,6800,340,2312000,2,6726,1683,1,66476800,66476800,2521,840,1681,840,0,1,842,382427,0.382427
1240,6800,340,2312000,2,9926,2483,1,89324800,89324800,3721,1240,2481,1240,0,1,1242,65649,0.065649
1640,6800,340,2312000,2,13126,3283,1,112172800,112172800,4921,1640,3281,1640,0,1,1642,758791,0.758791
2040,6800,340,2312000,2,16326,4083,1,135020800,135020800,6121,2040,4081,2040,0,1,2042,945126,0.945126
2440,6800,340,2312000,2,19526,4883,1,157868800,157868800,7321,2440,4881,2440,0,1,2442,1131077,1.131077
2840,6800,340,2312000,2,22726,5683,1,180716800,180716800,8521,2840,5681,2840,0,1,2842,1321128,1.321128
3240,6800,340,2312000,2,25926,6483,1,203564800,203564800,9721,3240,6481,3240,0,1,3242,1531573,1.531573
3640,6800,340,2312000,2,29126,7283,1,226412800,226412800,10921,3640,7281,3640,0,1,3642,1700432,1.700432
4040,6800,340,2312000,2,32326,8083,1,249260800,249260800,12121,4040,8081,4040,0,1,4042,1478820,1.47882
4440,6800,340,2312000,2,35526,8883,1,272108800,272108800,13321,4440,8881,4440,0,1,4442,616968,0.616968
4840,6800,340,2312000,2,38726,9683,1,294956800,294956800,14521,4840,9681,4840,0,1,4842,337102,0.337102
5240,6800,340,2312000,2,41926,10483,1,317804800,317804800,15721,5240,10481,5240,0,1,5242,295942,0.295942
5640,6800,340,2312000,2,45126,11283,1,340652800,340652800,16921,5640,11281,5640,0,1,5642,2661716,2.661716
6040,6800,340,2312000,2,48326,12083,1,363500800,363500800,18121,6040,12081,6040,0,1,6042,2555805,2.555805
6440,6800,340,2312000,2,51526,12883,1,386348800,386348800,19321,6440,12881,6440,0,1,6442,3040361,3.040361
6840,6800,340,2312000,2,54726,13683,1,409196800,409196800,20521,6840,13681,6840,0,1,6842,3232107,3.232107
35,1140,2045,2331300,2,286,73,1,19542200,19542200,106,35,71,35,0,1,37,54181,0.054181
535,1140,2045,2331300,2,4286,1073,1,32282200,32282200,1606,535,1071,535,0,1,537,254258,0.254258
1035,1140,2045,2331300,2,8286,2073,1,45022200,45022200,3106,1035,2071,1035,0,1,1037,477422,0.477422
1535,1140,2045,2331300,2,12286,3073,1,57762200,57762200,4606,1535,3071,1535,0,1,1537,691109,0.691109
2035,1140,2045,2331300,2,16286,4073,1,70502200,70502200,6106,2035,4071,2035,0,1,2037,914157,0.914157
2535,1140,2045,2331300,2,20286,5073,1,83242200,83242200,7606,2535,5071,2535,0,1,2537,1134439,1.134439
3035,1140,2045,2331300,2,24286,6073,1,95982200,95982200,9106,3035,6071,3035,0,1,3037,1359613,1.359613
3535,1140,2045,2331300,2,28286,7073,1,108722200,108722200,10606,3535,7071,3535,0,1,3537,1576485,1.576485
4035,1140,2045,2331300,2,32286,8073,1,121462200,121462200,12106,4035,8071,4035,0,1,4037,1797898,1.797898
40,550,4240,2332000,2,326,83,1,20188800,20188800,121,40,81,40,0,1,42,43198,0.043198
440,550,4240,2332000,2,3526,883,1,35516800,35516800,1321,440,881,440,0,1,442,209166,0.209166
840,550,4240,2332000,2,6726,1683,1,50844800,50844800,2521,840,1681,840,0,1,842,11620,0.01162
1240,550,4240,2332000,2,9926,2483,1,66172800,66172800,3721,1240,2481,1240,0,1,1242,161539,0.161539
1640,550,4240,2332000,2,13126,3283,1,81500800,81500800,4921,1640,3281,1640,0,1,1642,129674,0.129674
2040,550,4240,2332000,2,16326,4083,1,96828800,96828800,6121,2040,4081,2040,0,1,2042,149285,0.149285
2440,550,4240,2332000,2,19526,4883,1,112156800,112156800,7321,2440,4881,2440,0,1,2442,110419,0.110419
2840,550,4240,2332000,2,22726,5683,1,127484800,127484800,8521,2840,5681,2840,0,1,2842,76084,0.076084
3240,550,4240,2332000,2,25926,6483,1,142812800,142812800,9721,3240,6481,3240,0,1,3242,1058343,1.058343
3640,550,4240,2332000,2,29126,7283,1,158140800,158140800,10921,3640,7281,3640,0,1,3642,457426,0.457426
4040,550,4240,2332000,2,32326,8083,1,173468800,173468800,12121,4040,8081,4040,0,1,4042,462045,0.462045
4440,550,4240,2332000,2,35526,8883,1,188796800,188796800,13321,4440,8881,4440,0,1,4442,338179,0.338179
4840,550,4240,2332000,2,38726,9683,1,204124800,204124800,14521,4840,9681,4840,0,1,4842,2109621,2.109621
5240,550,4240,2332000,2,41926,10483,1,219452800,219452800,15721,5240,10481,5240,0,1,5242,2286104,2.286104
5640,550,4240,2332000,2,45126,11283,1,234780800,234780800,16921,5640,11281,5640,0,1,5642,1325189,1.325189
6040,550,4240,2332000,2,48326,12083,1,250108800,250108800,18121,6040,12081,6040,0,1,6042,871244,0.871244
6440,550,4240,2332000,2,51526,12883,1,265436800,265436800,19321,6440,12881,6440,0,1,6442,606871,0.606871
6840,550,4240,2332000,2,54726,13683,1,280764800,280764800,20521,6840,13681,6840,0,1,6842,1362140,1.36214
39,1143,2041,2332863,2,318,81,1,19656312,19656312,118,39,79,39,0,1,41,5007,0.005007
539,1143,2041,2332863,2,4318,1081,1,32392312,32392312,1618,539,1079,539,0,1,541,7575,0.007575
1039,1143,2041,2332863,2,8318,2081,1,45128312,45128312,3118,1039,2079,1039,0,1,1041,185943,0.185943
1539,1143,2041,2332863,2,12318,3081,1,57864312,57864312,4618,1539,3079,1539,0,1,1541,36654,0.036654
2039,1143,2041,2332863,2,16318,4081,1,70600312,70600312,6118,2039,4079,2039,0,1,2041,26883,0.026883
2539,1143,2041,2332863,2,20318,5081,1,83336312,83336312,7618,2539,5079,2539,0,1,2541,127897,0.127897
3039,1143,2041,2332863,2,24318,6081,1,96072312,96072312,9118,3039,6079,3039,0,1,3041,1338242,1.338242
3539,1143,2041,2332863,2,28318,7081,1,108808312,108808312,10618,3539,7079,3539,0,1,3541,34990,0.03499
4039,1143,2041,2332863,2,32318,8081,1,121544312,121544312,12118,4039,8079,4039,0,1,4041,125765,0.125765
4539,1143,2041,2332863,2,36318,9081,1,134280312,134280312,13618,4539,9079,4539,0,1,4541,267504,0.267504
5039,1143,2041,2332863,2,40318,10081,1,147016312,147016312,15118,5039,10079,5039,0,1,5041,959827,0.959827
5539,1143,2041,2332863,2,44318,11081,1,159752312,159752312,16618,5539,11079,5539,0,1,5541,1601502,1.601502
6039,1143,2041,2332863,2,48318,12081,1,172488312,172488312,18118,6039,12079,6039,0,1,6041,1278643,1.278643
6539,1143,2041,2332863,2,52318,13081,1,185224312,185224312,19618,6539,13079,6539,0,1,6541,1654538,1.654538
7039,1143,2041,2332863,2,56318,14081,1,197960312,197960312,21118,7039,14079,7039,0,1,7041,120769,0.120769
39,2243,1041,2334963,2,318,81,1,19704312,19704312,118,39,79,39,0,1,41,5555,0.005555
539,2243,1041,2334963,2,4318,1081,1,32840312,32840312,1618,539,1079,539,0,1,541,7376,0.007376
1039,2243,1041,2334963,2,8318,2081,1,45976312,45976312,3118,1039,2079,1039,0,1,1041,104300,0.1043
1539,2243,1041,2334963,2,12318,3081,1,59112312,59112312,4618,1539,3079,1539,0,1,1541,104150,0.10415
2039,2243,1041,2334963,2,16318,4081,1,72248312,72248312,6118,2039,4079,2039,0,1,2041,923245,0.923245
2539,2243,1041,2334963,2,20318,5081,1,85384312,85384312,7618,2539,5079,2539,0,1,2541,126540,0.12654
3039,2243,1041,2334963,2,24318,6081,1,98520312,98520312,9118,3039,6079,3039,0,1,3041,308581,0.308581
3539,2243,1041,2334963,2,28318,7081,1,111656312,111656312,10618,3539,7079,3539,0,1,3541,1000265,1.000265
4039,2243,1041,2334963,2,32318,8081,1,124792312,124792312,12118,4039,8079,4039,0,1,4041,944747,0.944747
4539,2243,1041,2334963,2,36318,9081,1,137928312,137928312,13618,4539,9079,4539,0,1,4541,820986,0.820986
5039,2243,1041,2334963,2,40318,10081,1,151064312,151064312,15118,5039,10079,5039,0,1,5041,847384,0.847384
5539,2243,1041,2334963,2,44318,11081,1,164200312,164200312,16618,5539,11079,5539,0,1,5541,93457,0.093457
6039,2243,1041,2334963,2,48318,12081,1,177336312,177336312,18118,6039,12079,6039,0,1,6041,169364,0.169364
6539,2243,1041,2334963,2,52318,13081,1,190472312,190472312,19618,6539,13079,6539,0,1,6541,346948,0.346948
7039,2243,1041,2334963,2,56318,14081,1,203608312,203608312,21118,7039,14079,7039,0,1,7041,241958,0.241958
35,2240,1045,2340800,2,286,73,1,19646200,19646200,106,35,71,35,0,1,37,54823,0.054823
535,2240,1045,2340800,2,4286,1073,1,32786200,32786200,1606,535,1071,535,0,1,537,253035,0.253035
1035,2240,1045,2340800,2,8286,2073,1,45926200,45926200,3106,1035,2071,1035,0,1,1037,476493,0.476493
1535,2240,1045,2340800,2,12286,3073,1,59066200,59066200,4606,1535,3071,1535,0,1,1537,701437,0.701437
2035,2240,1045,2340800,2,16286,4073,1,72206200,72206200,6106,2035,4071,2035,0,1,2037,924864,0.924864
2535,2240,1045,2340800,2,20286,5073,1,85346200,85346200,7606,2535,5071,2535,0,1,2537,1140203,1.140203
55,3555,665,2364075,2,446,113,1,20769400,20769400,166,55,111,55,0,1,57,13393,0.013393
455,3555,665,2364075,2,3646,913,1,34273400,34273400,1366,455,911,455,0,1,457,221760,0.22176
855,3555,665,2364075,2,6846,1713,1,47777400,47777400,2566,855,1711,855,0,1,857,408796,0.408796
1255,3555,665,2364075,2,10046,2513,1,61281400,61281400,3766,1255,2511,1255,0,1,1257,600040,0.60004
1655,3555,665,2364075,2,13246,3313,1,74785400,74785400,4966,1655,3311,1655,0,1,1657,787205,0.787205
2055,3555,665,2364075,2,16446,4113,1,88289400,88289400,6166,2055,4111,2055,0,1,2057,970824,0.970824
2455,3555,665,2364075,2,19646,4913,1,101793400,101793400,7366,2455,4911,2455,0,1,2457,67479,0.067479
2855,3555,665,2364075,2,22846,5713,1,115297400,115297400,8566,2855,5711,2855,0,1,2857,310112,0.310112
3255,3555,665,2364075,2,26046,6513,1,128801400,128801400,9766,3255,6511,3255,0,1,3257,1528795,1.528795
3655,3555,665,2364075,2,29246,7313,1,142305400,142305400,10966,3655,7311,3655,0,1,3657,1728174,1.728174
4055,3555,665,2364075,2,32446,8113,1,155809400,155809400,12166,4055,8111,4055,0,1,4057,1898312,1.898312
4455,3555,665,2364075,2,35646,8913,1,169313400,169313400,13366,4455,8911,4455,0,1,4457,2105053,2.105053
4855,3555,665,2364075,2,38846,9713,1,182817400,182817400,14566,4855,9711,4855,0,1,4857,648975,0.648975
5255,3555,665,2364075,2,42046,10513,1,196321400,196321400,15766,5255,10511,5255,0,1,5257,2468589,2.468589
5655,3555,665,2364075,2,45246,11313,1,209825400,209825400,16966,5655,11311,5655,0,1,5657,2652633,2.652633
6055,3555,665,2364075,2,48446,12113,1,223329400,223329400,18166,6055,12111,6055,0,1,6057,2049706,2.049706
6455,3555,665,2364075,2,51646,12913,1,236833400,236833400,19366,6455,12911,6455,0,1,6457,2760925,2.760925
6855,3555,665,2364075,2,54846,13713,1,250337400,250337400,20566,6855,13711,6855,0,1,6857,3242657,3.242657
55,555,4265,2367075,2,446,113,1,21057400,21057400,166,55,111,55,0,1,57,50330,0.05033
455,555,4265,2367075,2,3646,913,1,36481400,36481400,1366,455,911,455,0,1,457,227634,0.227634
855,555,4265,2367075,2,6846,1713,1,51905400,51905400,2566,855,1711,855,0,1,857,173094,0.173094
1255,555,4265,2367075,2,10046,2513,1,67329400,67329400,3766,1255,2511,1255,0,1,1257,588368,0.588368
1655,555,4265,2367075,2,13246,3313,1,82753400,82753400,4966,1655,3311,1655,0,1,1657,14766,0.014766
2055,555,4265,2367075,2,16446,4113,1,98177400,98177400,6166,2055,4111,2055,0,1,2057,134252,0.134252
2455,555,4265,2367075,2,19646,4913,1,113601400,113601400,7366,2455,4911,2455,0,1,2457,1131690,1.13169
2855,555,4265,2367075,2,22846,5713,1,129025400,129025400,8566,2855,5711,2855,0,1,2857,105848,0.105848
3255,555,4265,2367075,2,26046,6513,1,144449400,144449400,9766,3255,6511,3255,0,1,3257,1207279,1.207279
3655,555,4265,2367075,2,29246,7313,1,159873400,159873400,10966,3655,7311,3655,0,1,3657,181066,0.181066
4055,555,4265,2367075,2,32446,8113,1,175297400,175297400,12166,4055,8111,4055,0,1,4057,258300,0.2583
4455,555,4265,2367075,2,35646,8913,1,190721400,190721400,13366,4455,8911,4455,0,1,4457,531894,0.531894
4855,555,4265,2367075,2,38846,9713,1,206145400,206145400,14566,4855,9711,4855,0,1,4857,298101,0.298101
5255,555,4265,2367075,2,42046,10513,1,221569400,221569400,15766,5255,10511,5255,0,1,5257,372651,0.372651
5655,555,4265,2367075,2,45246,11313,1,236993400,236993400,16966,5655,11311,5655,0,1,5657,263172,0.263172
6055,555,4265,2367075,2,48446,12113,1,252417400,252417400,18166,6055,12111,6055,0,1,6057,375591,0.375591
6455,555,4265,2367075,2,51646,12913,1,267841400,267841400,19366,6455,12911,6455,0,1,6457,206325,0.206325
6855,555,4265,2367075,2,54846,13713,1,283265400,283265400,20566,6855,13711,6855,0,1,6857,3151514,3.151514
44,1153,2055,2369415,2,358,91,1,20084536,20084536,133,44,89,44,0,1,46,2851,0.002851
544,1153,2055,2369415,2,4358,1091,1,32916536,32916536,1633,544,1089,544,0,1,546,29509,0.029509
1044,1153,2055,2369415,2,8358,2091,1,45748536,45748536,3133,1044,2089,1044,0,1,1046,34505,0.034505
1544,1153,2055,2369415,2,12358,3091,1,58580536,58580536,4633,1544,3089,1544,0,1,1546,317730,0.31773
2044,1153,2055,2369415,2,16358,4091,1,71412536,71412536,6133,2044,4089,2044,0,1,2046,99367,0.099367
2544,1153,2055,2369415,2,20358,5091,1,84244536,84244536,7633,2544,5089,2544,0,1,2546,75048,0.075048
3044,1153,2055,2369415,2,24358,6091,1,97076536,97076536,9133,3044,6089,3044,0,1,3046,310141,0.310141
3544,1153,2055,2369415,2,28358,7091,1,109908536,109908536,10633,3544,7089,3544,0,1,3546,76116,0.076116
4044,1153,2055,2369415,2,32358,8091,1,122740536,122740536,12133,4044,8089,4044,0,1,4046,153139,0.153139
4544,1153,2055,2369415,2,36358,9091,1,135572536,135572536,13633,4544,9089,4544,0,1,4546,48652,0.048652
5044,1153,2055,2369415,2,40358,10091,1,148404536,148404536,15133,5044,10089,5044,0,1,5046,1446661,1.446661
5544,1153,2055,2369415,2,44358,11091,1,161236536,161236536,16633,5544,11089,5544,0,1,5546,464208,0.464208
6044,1153,2055,2369415,2,48358,12091,1,174068536,174068536,18133,6044,12089,6044,0,1,6046,584011,0.584011
6544,1153,2055,2369415,2,52358,13091,1,186900536,186900536,19633,6544,13089,6544,0,1,6546,658681,0.658681
7044,1153,2055,2369415,2,56358,14091,1,199732536,199732536,21133,7044,14089,7044,0,1,7046,3287998,3.287998
44,2253,1055,2376915,2,358,91,1,20179736,20179736,133,44,89,44,0,1,46,654,0.000654
544,2253,1055,2376915,2,4358,1091,1,33411736,33411736,1633,544,1089,544,0,1,546,16881,0.016881
1044,2253,1055,2376915,2,8358,2091,1,46643736,46643736,3133,1044,2089,1044,0,1,1046,178419,0.178419
1544,2253,1055,2376915,2,12358,3091,1,59875736,59875736,4633,1544,3089,1544,0,1,1546,81195,0.081195
2044,2253,1055,2376915,2,16358,4091,1,73107736,73107736,6133,2044,4089,2044,0,1,2046,481054,0.481054
2544,2253,1055,2376915,2,20358,5091,1,86339736,86339736,7633,2544,5089,2544,0,1,2546,285372,0.285372
3044,2253,1055,2376915,2,24358,6091,1,99571736,99571736,9133,3044,6089,3044,0,1,3046,923192,0.923192
3544,2253,1055,2376915,2,28358,7091,1,112803736,112803736,10633,3544,7089,3544,0,1,3546,131988,0.131988
4044,2253,1055,2376915,2,32358,8091,1,126035736,126035736,12133,4044,8089,4044,0,1,4046,43762,0.043762
4544,2253,1055,2376915,2,36358,9091,1,139267736,139267736,13633,4544,9089,4544,0,1,4546,733982,0.733982
5044,2253,1055,2376915,2,40358,10091,1,152499736,152499736,15133,5044,10089,5044,0,1,5046,608902,0.608902
5544,2253,1055,2376915,2,44358,11091,1,165731736,165731736,16633,5544,11089,5544,0,1,5546,222566,0.222566
6044,2253,1055,2376915,2,48358,12091,1,178963736,178963736,18133,6044,12089,6044,0,1,6046,18605,0.018605
6544,2253,1055,2376915,2,52358,13091,1,192195736,192195736,19633,6544,13089,6544,0,1,6546,749096,0.749096
7044,2253,1055,2376915,2,56358,14091,1,205427736,205427736,21133,7044,14089,7044,0,1,7046,1273239,1.273239
35,590,4045,2386550,2,286,73,1,20390200,20390200,106,35,71,35,0,1,37,22721,0.022721
535,590,4045,2386550,2,4286,1073,1,38930200,38930200,1606,535,1071,535,0,1,537,75103,0.075103
1035,590,4045,2386550,2,8286,2073,1,57470200,57470200,3106,1035,2071,1035,0,1,1037,90594,0.090594
1535,590,4045,2386550,2,12286,3073,1,76010200,76010200,4606,1535,3071,1535,0,1,1537,157716,0.157716
2035,590,4045,2386550,2,16286,4073,1,94550200,94550200,6106,2035,4071,2035,0,1,2037,242113,0.242113
2535,590,4045,2386550,2,20286,5073,1,113090200,113090200,7606,2535,5071,2535,0,1,2537,1211544,1.211544
3035,590,4045,2386550,2,24286,6073,1,131630200,131630200,9106,3035,6071,3035,0,1,3037,1448682,1.448682
3535,590,4045,2386550,2,28286,7073,1,150170200,150170200,10606,3535,7071,3535,0,1,3537,1699494,1.699494
4035,590,4045,2386550,2,32286,8073,1,168710200,168710200,12106,4035,8071,4035,0,1,4037,1936795,1.936795
4535,590,4045,2386550,2,36286,9073,1,187250200,187250200,13606,4535,9071,4535,0,1,4537,2176726,2.176726
5035,590,4045,2386550,2,40286,10073,1,205790200,205790200,15106,5035,10071,5035,0,1,5037,2426543,2.426543
5535,590,4045,2386550,2,44286,11073,1,224330200,224330200,16606,5535,11071,5535,0,1,5537,2664154,2.664154
6035,590,4045,2386550,2,48286,12073,1,242870200,242870200,18106,6035,12071,6035,0,1,6037,2907783,2.907783
6535,590,4045,2386550,2,52286,13073,1,261410200,261410200,19606,6535,13071,6535,0,1,6537,3142685,3.142685
7035,590,4045,2386550,2,56286,14073,1,279950200,279950200,21106,7035,14071,7035,0,1,7037,3384494,3.384494
40,1550,1540,2387000,2,326,83,1,20084800,20084800,121,40,81,40,0,1,42,16729,0.016729
440,1550,1540,2387000,2,3526,883,1,29972800,29972800,1321,440,881,440,0,1,442,223033,0.223033
840,1550,1540,2387000,2,6726,1683,1,39860800,39860800,2521,840,1681,840,0,1,842,405798,0.405798
1240,1550,1540,2387000,2,9926,2483,1,49748800,49748800,3721,1240,2481,1240,0,1,1242,508988,0.508988
1640,1550,1540,2387000,2,13126,3283,1,59636800,59636800,4921,1640,3281,1640,0,1,1642,411146,0.411146
2040,1550,1540,2387000,2,16326,4083,1,69524800,69524800,6121,2040,4081,2040,0,1,2042,225456,0.225456
2440,1550,1540,2387000,2,19526,4883,1,79412800,79412800,7321,2440,4881,2440,0,1,2442,1144433,1.144433
2840,1550,1540,2387000,2,22726,5683,1,89300800,89300800,8521,2840,5681,2840,0,1,2842,1330191,1.330191
3240,1550,1540,2387000,2,25926,6483,1,99188800,99188800,9721,3240,6481,3240,0,1,3242,1515184,1.515184
3640,1550,1540,2387000,2,29126,7283,1,109076800,109076800,10921,3640,7281,3640,0,1,3642,385852,0.385852
4040,1550,1540,2387000,2,32326,8083,1,118964800,118964800,12121,4040,8081,4040,0,1,4042,1889660,1.88966
4440,1550,1540,2387000,2,35526,8883,1,128852800,128852800,13321,4440,8881,4440,0,1,4442,2088876,2.088876
4840,1550,1540,2387000,2,38726,9683,1,138740800,138740800,14521,4840,9681,4840,0,1,4842,242911,0.242911
5240,1550,1540,2387000,2,41926,10483,1,148628800,148628800,15721,5240,10481,5240,0,1,5242,364731,0.364731
5640,1550,1540,2387000,2,45126,11283,1,158516800,158516800,16921,5640,11281,5640,0,1,5642,2631374,2.631374
6040,1550,1540,2387000,2,48326,12083,1,168404800,168404800,18121,6040,12081,6040,0,1,6042,2816550,2.81655
6440,1550,1540,2387000,2,51526,12883,1,178292800,178292800,19321,6440,12881,6440,0,1,6442,3000872,3.000872
6840,1550,1540,2387000,2,54726,13683,1,188180800,188180800,20521,6840,13681,6840,0,1,6842,555511,0.555511
40,1300,1840,2392000,2,326,83,1,20140800,20140800,121,40,81,40,0,1,42,45029,0.045029
440,1300,1840,2392000,2,3526,883,1,30188800,30188800,1321,440,881,440,0,1,442,38838,0.038838
840,1300,1840,2392000,2,6726,1683,1,40236800,40236800,2521,840,1681,840,0,1,842,404665,0.404665
1240,1300,1840,2392000,2,9926,2483,1,50284800,50284800,3721,1240,2481,1240,0,1,1242,19010,0.01901
1640,1300,1840,2392000,2,13126,3283,1,60332800,60332800,4921,1640,3281,1640,0,1,1642,759589,0.759589
2040,1300,1840,2392000,2,16326,4083,1,70380800,70380800,6121,2040,4081,2040,0,1,2042,392141,0.392141
2440,1300,1840,2392000,2,19526,4883,1,80428800,80428800,7321,2440,4881,2440,0,1,2442,449818,0.449818
2840,1300,1840,2392000,2,22726,5683,1,90476800,90476800,8521,2840,5681,2840,0,1,2842,197463,0.197463
3240,1300,1840,2392000,2,25926,6483,1,100524800,100524800,9721,3240,6481,3240,0,1,3242,273448,0.273448
3640,1300,1840,2392000,2,29126,7283,1,110572800,110572800,10921,3640,7281,3640,0,1,3642,464152,0.464152
4040,1300,1840,2392000,2,32326,8083,1,120620800,120620800,12121,4040,8081,4040,0,1,4042,570000,0.57
4440,1300,1840,2392000,2,35526,8883,1,130668800,130668800,13321,4440,8881,4440,0,1,4442,994938,0.994938
4840,1300,1840,2392000,2,38726,9683,1,140716800,140716800,14521,4840,9681,4840,0,1,4842,2216173,2.216173
5240,1300,1840,2392000,2,41926,10483,1,150764800,150764800,15721,5240,10481,5240,0,1,5242,572513,0.572513
5640,1300,1840,2392000,2,45126,11283,1,160812800,160812800,16921,5640,11281,5640,0,1,5642,94317,0.094317
6040,1300,1840,2392000,2,48326,12083,1,170860800,170860800,18121,6040,12081,6040,0,1,6042,2354275,2.354275
6440,1300,1840,2392000,2,51526,12883,1,180908800,180908800,19321,6440,12881,6440,0,1,6442,166335,0.166335
6840,1300,1840,2392000,2,54726,13683,1,190956800,190956800,20521,6840,13681,6840,0,1,6842,1363654,1.363654
55,6555,365,2392575,2,446,113,1,22185400,22185400,166,55,111,55,0,1,57,5400,0.0054
455,6555,365,2392575,2,3646,913,1,44329400,44329400,1366,455,911,455,0,1,457,32769,0.032769
855,6555,365,2392575,2,6846,1713,1,66473400,66473400,2566,855,1711,855,0,1,857,174905,0.174905
1255,6555,365,2392575,2,10046,2513,1,88617400,88617400,3766,1255,2511,1255,0,1,1257,98544,0.098544
1655,6555,365,2392575,2,13246,3313,1,110761400,110761400,4966,1655,3311,1655,0,1,1657,61910,0.06191
2055,6555,365,2392575,2,16446,4113,1,132905400,132905400,6166,2055,4111,2055,0,1,2057,464257,0.464257
2455,6555,365,2392575,2,19646,4913,1,155049400,155049400,7366,2455,4911,2455,0,1,2457,809659,0.809659
2855,6555,365,2392575,2,22846,5713,1,177193400,177193400,8566,2855,5711,2855,0,1,2857,42273,0.042273
3255,6555,365,2392575,2,26046,6513,1,199337400,199337400,9766,3255,6511,3255,0,1,3257,150361,0.150361
3655,6555,365,2392575,2,29246,7313,1,221481400,221481400,10966,3655,7311,3655,0,1,3657,228557,0.228557
4055,6555,365,2392575,2,32446,8113,1,243625400,243625400,12166,4055,8111,4055,0,1,4057,1715908,1.715908
4455,6555,365,2392575,2,35646,8913,1,265769400,265769400,13366,4455,8911,4455,0,1,4457,130400,0.1304
4855,6555,365,2392575,2,38846,9713,1,287913400,287913400,14566,4855,9711,4855,0,1,4857,444563,0.444563
5255,6555,365,2392575,2,42046,10513,1,310057400,310057400,15766,5255,10511,5255,0,1,5257,2559002,2.559002
5655,6555,365,2392575,2,45246,11313,1,332201400,332201400,16966,5655,11311,5655,0,1,5657,332228,0.332228
6055,6555,365,2392575,2,48446,12113,1,354345400,354345400,18166,6055,12111,6055,0,1,6057,795984,0.795984
6455,6555,365,2392575,2,51646,12913,1,376489400,376489400,19366,6455,12911,6455,0,1,6457,29933,0.029933
6855,6555,365,2392575,2,54846,13713,1,398633400,398633400,20566,6855,13711,6855,0,1,6857,1971557,1.971557
39,593,4041,2396313,2,318,81,1,20616312,20616312,118,39,79,39,0,1,41,47029,0.047029
539,593,4041,2396313,2,4318,1081,1,39152312,39152312,1618,539,1079,539,0,1,541,267978,0.267978
1039,593,4041,2396313,2,8318,2081,1,57688312,57688312,3118,1039,2079,1039,0,1,1041,423998,0.423998
1539,593,4041,2396313,2,12318,3081,1,76224312,76224312,4618,1539,3079,1539,0,1,1541,33625,0.033625
2039,593,4041,2396313,2,16318,4081,1,94760312,94760312,6118,2039,4079,2039,0,1,2041,944902,0.944902
2539,593,4041,2396313,2,20318,5081,1,113296312,113296312,7618,2539,5079,2539,0,1,2541,319519,0.319519
3039,593,4041,2396313,2,24318,6081,1,131832312,131832312,9118,3039,6079,3039,0,1,3041,1408743,1.408743
3539,593,4041,2396313,2,28318,7081,1,150368312,150368312,10618,3539,7079,3539,0,1,3541,308177,0.308177
4039,593,4041,2396313,2,32318,8081,1,168904312,168904312,12118,4039,8079,4039,0,1,4041,52679,0.052679
4539,593,4041,2396313,2,36318,9081,1,187440312,187440312,13618,4539,9079,4539,0,1,4541,301895,0.301895
5039,593,4041,2396313,2,40318,10081,1,205976312,205976312,15118,5039,10079,5039,0,1,5041,1655936,1.655936
5539,593,4041,2396313,2,44318,11081,1,224512312,224512312,16618,5539,11079,5539,0,1,5541,394053,0.394053
6039,593,4041,2396313,2,48318,12081,1,243048312,243048312,18118,6039,12079,6039,0,1,6041,100543,0.100543
6539,593,4041,2396313,2,52318,13081,1,261584312,261584312,19618,6539,13079,6539,0,1,6541,550083,0.550083
7039,593,4041,2396313,2,56318,14081,1,280120312,280120312,21118,7039,14079,7039,0,1,7041,31388,0.031388
40,2550,940,2397000,2,326,83,1,20292800,20292800,121,40,81,40,0,1,42,45548,0.045548
440,2550,940,2397000,2,3526,883,1,31460800,31460800,1321,440,881,440,0,1,442,215992,0.215992
840,2550,940,2397000,2,6726,1683,1,42628800,42628800,2521,840,1681,840,0,1,842,92515,0.092515
1240,2550,940,2397000,2,9926,2483,1,53796800,53796800,3721,1240,2481,1240,0,1,1242,576189,0.576189
1640,2550,940,2397000,2,13126,3283,1,64964800,64964800,4921,1640,3281,1640,0,1,1642,761422,0.761422
2040,2550,940,2397000,2,16326,4083,1,76132800,76132800,6121,2040,4081,2040,0,1,2042,941157,0.941157
2440,2550,940,2397000,2,19526,4883,1,87300800,87300800,7321,2440,4881,2440,0,1,2442,318265,0.318265
2840,2550,940,2397000,2,22726,5683,1,98468800,98468800,8521,2840,5681,2840,0,1,2842,1064875,1.064875
3240,2550,940,2397000,2,25926,6483,1,109636800,109636800,9721,3240,6481,3240,0,1,3242,25456,0.025456
3640,2550,940,2397000,2,29126,7283,1,120804800,120804800,10921,3640,7281,3640,0,1,3642,1306825,1.306825
4040,2550,940,2397000,2,32326,8083,1,131972800,131972800,12121,4040,8081,4040,0,1,4042,1202810,1.20281
4440,2550,940,2397000,2,35526,8883,1,143140800,143140800,13321,4440,8881,4440,0,1,4442,2037403,2.037403
4840,2550,940,2397000,2,38726,9683,1,154308800,154308800,14521,4840,9681,4840,0,1,4842,402717,0.402717
5240,2550,940,2397000,2,41926,10483,1,165476800,165476800,15721,5240,10481,5240,0,1,5242,2407306,2.407306
5640,2550,940,2397000,2,45126,11283,1,176644800,176644800,16921,5640,11281,5640,0,1,5642,598447,0.598447
6040,2550,940,2397000,2,48326,12083,1,187812800,187812800,18121,6040,12081,6040,0,1,6042,789415,0.789415
6440,2550,940,2397000,2,51526,12883,1,198980800,198980800,19321,6440,12881,6440,0,1,6442,63456,0.063456
6840,2550,940,2397000,2,54726,13683,1,210148800,210148800,20521,6840,13681,6840,0,1,6842,1232694,1.232694
40,7050,340,2397000,2,326,83,1,21540800,21540800,121,40,81,40,0,1,42,41356,0.041356
440,7050,340,2397000,2,3526,883,1,45188800,45188800,1321,440,881,440,0,1,442,210170,0.21017
840,7050,340,2397000,2,6726,1683,1,68836800,68836800,2521,840,1681,840,0,1,842,396253,0.396253
1240,7050,340,2397000,2,9926,2483,1,92484800,92484800,3721,1240,2481,1240,0,1,1242,595686,0.595686
1640,7050,340,2397000,2,13126,3283,1,116132800,116132800,4921,1640,3281,1640,0,1,1642,359034,0.359034
2040,7050,340,2397000,2,16326,4083,1,139780800,139780800,6121,2040,4081,2040,0,1,2042,981632,0.981632
2440,7050,340,2397000,2,19526,4883,1,163428800,163428800,7321,2440,4881,2440,0,1,2442,1190477,1.190477
2840,7050,340,2397000,2,22726,5683,1,187076800,187076800,8521,2840,5681,2840,0,1,2842,1393370,1.39337
3240,7050,340,2397000,2,25926,6483,1,210724800,210724800,9721,3240,6481,3240,0,1,3242,1568210,1.56821
3640,7050,340,2397000,2,29126,7283,1,234372800,234372800,10921,3640,7281,3640,0,1,3642,1755747,1.755747
4040,7050,340,2397000,2,32326,8083,1,258020800,258020800,12121,4040,8081,4040,0,1,4042,1967115,1.967115
4440,7050,340,2397000,2,35526,8883,1,281668800,281668800,13321,4440,8881,4440,0,1,4442,2167805,2.167805
4840,7050,340,2397000,2,38726,9683,1,305316800,305316800,14521,4840,9681,4840,0,1,4842,2366636,2.366636
5240,7050,340,2397000,2,41926,10483,1,328964800,328964800,15721,5240,10481,5240,0,1,5242,2581781,2.581781
5640,7050,340,2397000,2,45126,11283,1,352612800,352612800,16921,5640,11281,5640,0,1,5642,2739244,2.739244
6040,7050,340,2397000,2,48326,12083,1,376260800,376260800,18121,6040,12081,6040,0,1,6042,2935355,2.935355
6440,7050,340,2397000,2,51526,12883,1,399908800,399908800,19321,6440,12881,6440,0,1,6442,3147760,3.14776
6840,7050,340,2397000,2,54726,13683,1,423556800,423556800,20521,6840,13681,6840,0,1,6842,3347110,3.34711
35,4400,545,2398000,2,286,73,1,20568600,20568600,106,35,71,35,0,1,37,53997,0.053997
535,4400,545,2398000,2,4286,1073,1,40348600,40348600,1606,535,1071,535,0,1,537,62110,0.06211
1035,4400,545,2398000,2,8286,2073,1,60128600,60128600,3106,1035,2071,1035,0,1,1037,89897,0.089897
1535,4400,545,2398000,2,12286,3073,1,79908600,79908600,4606,1535,3071,1535,0,1,1537,721767,0.721767
2035,4400,545,2398000,2,16286,4073,1,99688600,99688600,6106,2035,4071,2035,0,1,2037,952562,0.952562
2535,4400,545,2398000,2,20286,5073,1,119468600,119468600,7606,2535,5071,2535,0,1,2537,1192405,1.192405
3035,4400,545,2398000,2,24286,6073,1,139248600,139248600,9106,3035,6071,3035,0,1,3037,905496,0.905496
3535,4400,545,2398000,2,28286,7073,1,159028600,159028600,10606,3535,7071,3535,0,1,3537,1646414,1.646414
4035,4400,545,2398000,2,32286,8073,1,178808600,178808600,12106,4035,8071,4035,0,1,4037,365539,0.365539
4535,4400,545,2398000,2,36286,9073,1,198588600,198588600,13606,4535,9071,4535,0,1,4537,2113117,2.113117
5035,4400,545,2398000,2,40286,10073,1,218368600,218368600,15106,5035,10071,5035,0,1,5037,1437234,1.437234
5535,4400,545,2398000,2,44286,11073,1,238148600,238148600,16606,5535,11071,5535,0,1,5537,2608517,2.608517
6035,4400,545,2398000,2,48286,12073,1,257928600,257928600,18106,6035,12071,6035,0,1,6037,1124555,1.124555
6535,4400,545,2398000,2,52286,13073,1,277708600,277708600,19606,6535,13071,6535,0,1,6537,3061650,3.06165
7035,4400,545,2398000,2,56286,14073,1,297488600,297488600,21106,7035,14071,7035,0,1,7037,782110,0.78211
39,4443,541,2403663,2,318,81,1,20784312,20784312,118,39,79,39,0,1,41,4402,0.004402
539,4443,541,2403663,2,4318,1081,1,40720312,40720312,1618,539,1079,539,0,1,541,349,0.000349
1039,4443,541,2403663,2,8318,2081,1,60656312,60656312,3118,1039,2079,1039,0,1,1041,4585,0.004585
1539,4443,541,2403663,2,12318,3081,1,80592312,80592312,4618,1539,3079,1539,0,1,1541,350453,0.350453
2039,4443,541,2403663,2,16318,4081,1,100528312,100528312,6118,2039,4079,2039,0,1,2041,140565,0.140565
2539,4443,541,2403663,2,20318,5081,1,120464312,120464312,7618,2539,5079,2539,0,1,2541,42453,0.042453
3039,4443,541,2403663,2,24318,6081,1,140400312,140400312,9118,3039,6079,3039,0,1,3041,412776,0.412776
3539,4443,541,2403663,2,28318,7081,1,160336312,160336312,10618,3539,7079,3539,0,1,3541,16879,0.016879
4039,4443,541,2403663,2,32318,8081,1,180272312,180272312,12118,4039,8079,4039,0,1,4041,22640,0.02264
4539,4443,541,2403663,2,36318,9081,1,200208312,200208312,13618,4539,9079,4539,0,1,4541,1233802,1.233802
5039,4443,541,2403663,2,40318,10081,1,220144312,220144312,15118,5039,10079,5039,0,1,5041,2357340,2.35734
5539,4443,541,2403663,2,44318,11081,1,240080312,240080312,16618,5539,11079,5539,0,1,5541,1342162,1.342162
6039,4443,541,2403663,2,48318,12081,1,260016312,260016312,18118,6039,12079,6039,0,1,6041,544189,0.544189
6539,4443,541,2403663,2,52318,13081,1,279952312,279952312,19618,6539,13079,6539,0,1,6541,673021,0.673021
7039,4443,541,2403663,2,56318,14081,1,299888312,299888312,21118,7039,14079,7039,0,1,7041,1944680,1.94468
35,4440,545,2419800,2,286,73,1,20754200,20754200,106,35,71,35,0,1,37,58969,0.058969
535,4440,545,2419800,2,4286,1073,1,40694200,40694200,1606,535,1071,535,0,1,537,260110,0.26011
1035,4440,545,2419800,2,8286,2073,1,60634200,60634200,3106,1035,2071,1035,0,1,1037,611751,0.611751
1535,4440,545,2419800,2,12286,3073,1,80574200,80574200,4606,1535,3071,1535,0,1,1537,717880,0.71788
2035,4440,545,2419800,2,16286,4073,1,100514200,100514200,6106,2035,4071,2035,0,1,2037,950740,0.95074
40,800,3040,2432000,2,326,83,1,20684800,20684800,121,40,81,40,0,1,42,43902,0.043902
440,800,3040,2432000,2,3526,883,1,32972800,32972800,1321,440,881,440,0,1,442,215730,0.21573
840,800,3040,2432000,2,6726,1683,1,45260800,45260800,2521,840,1681,840,0,1,842,393557,0.393557
1240,800,3040,2432000,2,9926,2483,1,57548800,57548800,3721,1240,2481,1240,0,1,1242,573946,0.573946
1640,800,3040,2432000,2,13126,3283,1,69836800,69836800,4921,1640,3281,1640,0,1,1642,750623,0.750623
2040,800,3040,2432000,2,16326,4083,1,82124800,82124800,6121,2040,4081,2040,0,1,2042,845650,0.84565
2440,800,3040,2432000,2,19526,4883,1,94412800,94412800,7321,2440,4881,2440,0,1,2442,1109334,1.109334
2840,800,3040,2432000,2,22726,5683,1,106700800,106700800,8521,2840,5681,2840,0,1,2842,578949,0.578949
3240,800,3040,2432000,2,25926,6483,1,118988800,118988800,9721,3240,6481,3240,0,1,3242,111515,0.111515
3640,800,3040,2432000,2,29126,7283,1,131276800,131276800,10921,3640,7281,3640,0,1,3642,1440074,1.440074
4040,800,3040,2432000,2,32326,8083,1,143564800,143564800,12121,4040,8081,4040,0,1,4042,945207,0.945207
4440,800,3040,2432000,2,35526,8883,1,155852800,155852800,13321,4440,8881,4440,0,1,4442,76951,0.076951
4840,800,3040,2432000,2,38726,9683,1,168140800,168140800,14521,4840,9681,4840,0,1,4842,2187266,2.187266
5240,800,3040,2432000,2,41926,10483,1,180428800,180428800,15721,5240,10481,5240,0,1,5242,1021362,1.021362
5640,800,3040,2432000,2,45126,11283,1,192716800,192716800,16921,5640,11281,5640,0,1,5642,408634,0.408634
6040,800,3040,2432000,2,48326,12083,1,205004800,205004800,18121,6040,12081,6040,0,1,6042,1232554,1.232554
6440,800,3040,2432000,2,51526,12883,1,217292800,217292800,19321,6440,12881,6440,0,1,6442,727414,0.727414
6840,800,3040,2432000,2,54726,13683,1,229580800,229580800,20521,6840,13681,6840,0,1,6842,1584556,1.584556
40,3800,640,2432000,2,326,83,1,20876800,20876800,121,40,81,40,0,1,42,42850,0.04285
440,3800,640,2432000,2,3526,883,1,35084800,35084800,1321,440,881,440,0,1,442,217107,0.217107
840,3800,640,2432000,2,6726,1683,1,49292800,49292800,2521,840,1681,840,0,1,842,397865,0.397865
1240,3800,640,2432000,2,9926,2483,1,63500800,63500800,3721,1240,2481,1240,0,1,1242,582538,0.582538
1640,3800,640,2432000,2,13126,3283,1,77708800,77708800,4921,1640,3281,1640,0,1,1642,773147,0.773147
2040,3800,640,2432000,2,16326,4083,1,91916800,91916800,6121,2040,4081,2040,0,1,2042,953444,0.953444
2440,3800,640,2432000,2,19526,4883,1,106124800,106124800,7321,2440,4881,2440,0,1,2442,1143384,1.143384
2840,3800,640,2432000,2,22726,5683,1,120332800,120332800,8521,2840,5681,2840,0,1,2842,869454,0.869454
3240,3800,640,2432000,2,25926,6483,1,134540800,134540800,9721,3240,6481,3240,0,1,3242,1505060,1.50506
3640,3800,640,2432000,2,29126,7283,1,148748800,148748800,10921,3640,7281,3640,0,1,3642,1688008,1.688008
4040,3800,640,2432000,2,32326,8083,1,162956800,162956800,12121,4040,8081,4040,0,1,4042,1498591,1.498591
4440,3800,640,2432000,2,35526,8883,1,177164800,177164800,13321,4440,8881,4440,0,1,4442,902162,0.902162
4840,3800,640,2432000,2,38726,9683,1,191372800,191372800,14521,4840,9681,4840,0,1,4842,2238583,2.238583
5240,3800,640,2432000,2,41926,10483,1,205580800,205580800,15721,5240,10481,5240,0,1,5242,2430152,2.430152
5640,3800,640,2432000,2,45126,11283,1,219788800,219788800,16921,5640,11281,5640,0,1,5642,1311469,1.311469
6040,3800,640,2432000,2,48326,12083,1,233996800,233996800,18121,6040,12081,6040,0,1,6042,497711,0.497711
6440,3800,640,2432000,2,51526,12883,1,248204800,248204800,19321,6440,12881,6440,0,1,6442,2994644,2.994644
6840,3800,640,2432000,2,54726,13683,1,262412800,262412800,20521,6840,13681,6840,0,1,6842,2349325,2.349325
55,1555,1565,2433575,2,446,113,1,20841400,20841400,166,55,111,55,0,1,57,50317,0.050317
455,1555,1565,2433575,2,3646,913,1,30825400,30825400,1366,455,911,455,0,1,457,23630,0.02363
855,1555,1565,2433575,2,6846,1713,1,40809400,40809400,2566,855,1711,855,0,1,857,420922,0.420922
1255,1555,1565,2433575,2,10046,2513,1,50793400,50793400,3766,1255,2511,1255,0,1,1257,346519,0.346519
1655,1555,1565,2433575,2,13246,3313,1,60777400,60777400,4966,1655,3311,1655,0,1,1657,154980,0.15498
2055,1555,1565,2433575,2,16446,4113,1,70761400,70761400,6166,2055,4111,2055,0,1,2057,990245,0.990245
2455,1555,1565,2433575,2,19646,4913,1,80745400,80745400,7366,2455,4911,2455,0,1,2457,1183679,1.183679
2855,1555,1565,2433575,2,22846,5713,1,90729400,90729400,8566,2855,5711,2855,0,1,2857,1370057,1.370057
3255,1555,1565,2433575,2,26046,6513,1,100713400,100713400,9766,3255,6511,3255,0,1,3257,1457747,1.457747
3655,1555,1565,2433575,2,29246,7313,1,110697400,110697400,10966,3655,7311,3655,0,1,3657,303757,0.303757
4055,1555,1565,2433575,2,32446,8113,1,120681400,120681400,12166,4055,8111,4055,0,1,4057,1575799,1.575799
4455,1555,1565,2433575,2,35646,8913,1,130665400,130665400,13366,4455,8911,4455,0,1,4457,22499,0.022499
4855,1555,1565,2433575,2,38846,9713,1,140649400,140649400,14566,4855,9711,4855,0,1,4857,187801,0.187801
5255,1555,1565,2433575,2,42046,10513,1,150633400,150633400,15766,5255,10511,5255,0,1,5257,14065,0.014065
5655,1555,1565,2433575,2,45246,11313,1,160617400,160617400,16966,5655,11311,5655,0,1,5657,1536372,1.536372
6055,1555,1565,2433575,2,48446,12113,1,170601400,170601400,18166,6055,12111,6055,0,1,6057,1882914,1.882914
6455,1555,1565,2433575,2,51646,12913,1,180585400,180585400,19366,6455,12911,6455,0,1,6457,3087429,3.087429
6855,1555,1565,2433575,2,54846,13713,1,190569400,190569400,20566,6855,13711,6855,0,1,6857,649684,0.649684
55,1305,1865,2433825,2,446,113,1,20865400,20865400,166,55,111,55,0,1,57,49744,0.049744
455,1305,1865,2433825,2,3646,913,1,31009400,31009400,1366,455,911,455,0,1,457,234344,0.234344
855,1305,1865,2433825,2,6846,1713,1,41153400,41153400,2566,855,1711,855,0,1,857,421289,0.421289
1255,1305,1865,2433825,2,10046,2513,1,51297400,51297400,3766,1255,2511,1255,0,1,1257,612590,0.61259
1655,1305,1865,2433825,2,13246,3313,1,61441400,61441400,4966,1655,3311,1655,0,1,1657,344509,0.344509
2055,1305,1865,2433825,2,16446,4113,1,71585400,71585400,6166,2055,4111,2055,0,1,2057,882459,0.882459
2455,1305,1865,2433825,2,19646,4913,1,81729400,81729400,7366,2455,4911,2455,0,1,2457,1181504,1.181504
2855,1305,1865,2433825,2,22846,5713,1,91873400,91873400,8566,2855,5711,2855,0,1,2857,378731,0.378731
3255,1305,1865,2433825,2,26046,6513,1,102017400,102017400,9766,3255,6511,3255,0,1,3257,613509,0.613509
3655,1305,1865,2433825,2,29246,7313,1,112161400,112161400,10966,3655,7311,3655,0,1,3657,939313,0.939313
4055,1305,1865,2433825,2,32446,8113,1,122305400,122305400,12166,4055,8111,4055,0,1,4057,1799984,1.799984
4455,1305,1865,2433825,2,35646,8913,1,132449400,132449400,13366,4455,8911,4455,0,1,4457,2136459,2.136459
4855,1305,1865,2433825,2,38846,9713,1,142593400,142593400,14566,4855,9711,4855,0,1,4857,416529,0.416529
5255,1305,1865,2433825,2,42046,10513,1,152737400,152737400,15766,5255,10511,5255,0,1,5257,1590715,1.590715
5655,1305,1865,2433825,2,45246,11313,1,162881400,162881400,16966,5655,11311,5655,0,1,5657,410265,0.410265
6055,1305,1865,2433825,2,48446,12113,1,173025400,173025400,18166,6055,12111,6055,0,1,6057,2081221,2.081221
6455,1305,1865,2433825,2,51646,12913,1,183169400,183169400,19366,6455,12911,6455,0,1,6457,1560881,1.560881
6855,1305,1865,2433825,2,54846,13713,1,193313400,193313400,20566,6855,13711,6855,0,1,6857,1486970,1.48697
44,603,4055,2445165,2,358,91,1,21200936,21200936,133,44,89,44,0,1,46,50662,0.050662
544,603,4055,2445165,2,4358,1091,1,39832936,39832936,1633,544,1089,544,0,1,546,271438,0.271438
1044,603,4055,2445165,2,8358,2091,1,58464936,58464936,3133,1044,2089,1044,0,1,1046,505567,0.505567
1544,603,4055,2445165,2,12358,3091,1,77096936,77096936,4633,1544,3089,1544,0,1,1546,618834,0.618834
2044,603,4055,2445165,2,16358,4091,1,95728936,95728936,6133,2044,4089,2044,0,1,2046,166001,0.166001
2544,603,4055,2445165,2,20358,5091,1,114360936,114360936,7633,2544,5089,2544,0,1,2546,89991,0.089991
3044,603,4055,2445165,2,24358,6091,1,132992936,132992936,9133,3044,6089,3044,0,1,3046,186781,0.186781
3544,603,4055,2445165,2,28358,7091,1,151624936,151624936,10633,3544,7089,3544,0,1,3546,703319,0.703319
4044,603,4055,2445165,2,32358,8091,1,170256936,170256936,12133,4044,8089,4044,0,1,4046,210764,0.210764
4544,603,4055,2445165,2,36358,9091,1,188888936,188888936,13633,4544,9089,4544,0,1,4546,1293765,1.293765
5044,603,4055,2445165,2,40358,10091,1,207520936,207520936,15133,5044,10089,5044,0,1,5046,174237,0.174237
5544,603,4055,2445165,2,44358,11091,1,226152936,226152936,16633,5544,11089,5544,0,1,5546,550764,0.550764
6044,603,4055,2445165,2,48358,12091,1,244784936,244784936,18133,6044,12089,6044,0,1,6046,1173620,1.17362
6544,603,4055,2445165,2,52358,13091,1,263416936,263416936,19633,6544,13089,6544,0,1,6546,1317246,1.317246
7044,603,4055,2445165,2,56358,14091,1,282048936,282048936,21133,7044,14089,7044,0,1,7046,254666,0.254666
55,2555,965,2465575,2,446,113,1,21273400,21273400,166,55,111,55,0,1,57,50158,0.050158
455,2555,965,2465575,2,3646,913,1,32537400,32537400,1366,455,911,455,0,1,457,230459,0.230459
855,2555,965,2465575,2,6846,1713,1,43801400,43801400,2566,855,1711,855,0,1,857,414713,0.414713
1255,2555,965,2465575,2,10046,2513,1,55065400,55065400,3766,1255,2511,1255,0,1,1257,600365,0.600365
1655,2555,965,2465575,2,13246,3313,1,66329400,66329400,4966,1655,3311,1655,0,1,1657,786601,0.786601
2055,2555,965,2465575,2,16446,4113,1,77593400,77593400,6166,2055,4111,2055,0,1,2057,295507,0.295507
2455,2555,965,2465575,2,19646,4913,1,88857400,88857400,7366,2455,4911,2455,0,1,2457,1157219,1.157219
2855,2555,965,2465575,2,22846,5713,1,100121400,100121400,8566,2855,5711,2855,0,1,2857,642697,0.642697
3255,2555,965,2465575,2,26046,6513,1,111385400,111385400,9766,3255,6511,3255,0,1,3257,1532726,1.532726
3655,2555,965,2465575,2,29246,7313,1,122649400,122649400,10966,3655,7311,3655,0,1,3657,516533,0.516533
4055,2555,965,2465575,2,32446,8113,1,133913400,133913400,12166,4055,8111,4055,0,1,4057,1893547,1.893547
4455,2555,965,2465575,2,35646,8913,1,145177400,145177400,13366,4455,8911,4455,0,1,4457,17992,0.017992
4855,2555,965,2465575,2,38846,9713,1,156441400,156441400,14566,4855,9711,4855,0,1,4857,471354,0.471354
5255,2555,965,2465575,2,42046,10513,1,167705400,167705400,15766,5255,10511,5255,0,1,5257,816148,0.816148
5655,2555,965,2465575,2,45246,11313,1,178969400,178969400,16966,5655,11311,5655,0,1,5657,15156,0.015156
6055,2555,965,2465575,2,48446,12113,1,190233400,190233400,18166,6055,12111,6055,0,1,6057,797105,0.797105
6455,2555,965,2465575,2,51646,12913,1,201497400,201497400,19366,6455,12911,6455,0,1,6457,3024714,3.024714
6855,2555,965,2465575,2,54846,13713,1,212761400,212761400,20566,6855,13711,6855,0,1,6857,1177742,1.177742
55,805,3065,2467325,2,446,113,1,21441400,21441400,166,55,111,55,0,1,57,31149,0.031149
455,805,3065,2467325,2,3646,913,1,33825400,33825400,1366,455,911,455,0,1,457,236267,0.236267
855,805,3065,2467325,2,6846,1713,1,46209400,46209400,2566,855,1711,855,0,1,857,421282,0.421282
1255,805,3065,2467325,2,10046,2513,1,58593400,58593400,3766,1255,2511,1255,0,1,1257,607493,0.607493
1655,805,3065,2467325,2,13246,3313,1,70977400,70977400,4966,1655,3311,1655,0,1,1657,798181,0.798181
2055,805,3065,2467325,2,16446,4113,1,83361400,83361400,6166,2055,4111,2055,0,1,2057,446463,0.446463
2455,805,3065,2467325,2,19646,4913,1,95745400,95745400,7366,2455,4911,2455,0,1,2457,146471,0.146471
2855,805,3065,2467325,2,22846,5713,1,108129400,108129400,8566,2855,5711,2855,0,1,2857,431252,0.431252
3255,805,3065,2467325,2,26046,6513,1,120513400,120513400,9766,3255,6511,3255,0,1,3257,273085,0.273085
3655,805,3065,2467325,2,29246,7313,1,132897400,132897400,10966,3655,7311,3655,0,1,3657,1527128,1.527128
4055,805,3065,2467325,2,32446,8113,1,145281400,145281400,12166,4055,8111,4055,0,1,4057,472260,0.47226
4455,805,3065,2467325,2,35646,8913,1,157665400,157665400,13366,4455,8911,4455,0,1,4457,1056346,1.056346
4855,805,3065,2467325,2,38846,9713,1,170049400,170049400,14566,4855,9711,4855,0,1,4857,1362786,1.362786
5255,805,3065,2467325,2,42046,10513,1,182433400,182433400,15766,5255,10511,5255,0,1,5257,2498010,2.49801
5655,805,3065,2467325,2,45246,11313,1,194817400,194817400,16966,5655,11311,5655,0,1,5657,2456598,2.456598
6055,805,3065,2467325,2,48446,12113,1,207201400,207201400,18166,6055,12111,6055,0,1,6057,333529,0.333529
6455,805,3065,2467325,2,51646,12913,1,219585400,219585400,19366,6455,12911,6455,0,1,6457,1580396,1.580396
6855,805,3065,2467325,2,54846,13713,1,231969400,231969400,20566,6855,13711,6855,0,1,6857,1354369,1.354369
44,4453,555,2471415,2,358,91,1,21534136,21534136,133,44,89,44,0,1,46,4486,0.004486
544,4453,555,2471415,2,4358,1091,1,41566136,41566136,1633,544,1089,544,0,1,546,2539,0.002539
1044,4453,555,2471415,2,8358,2091,1,61598136,61598136,3133,1044,2089,1044,0,1,1046,262985,0.262985
1544,4453,555,2471415,2,12358,3091,1,81630136,81630136,4633,1544,3089,1544,0,1,1546,499033,0.499033
2044,4453,555,2471415,2,16358,4091,1,101662136,101662136,6133,2044,4089,2044,0,1,2046,629638,0.629638
2544,4453,555,2471415,2,20358,5091,1,121694136,121694136,7633,2544,5089,2544,0,1,2546,1212304,1.212304
3044,4453,555,2471415,2,24358,6091,1,141726136,141726136,9133,3044,6089,3044,0,1,3046,215130,0.21513
3544,4453,555,2471415,2,28358,7091,1,161758136,161758136,10633,3544,7089,3544,0,1,3546,1699908,1.699908
4044,4453,555,2471415,2,32358,8091,1,181790136,181790136,12133,4044,8089,4044,0,1,4046,497930,0.49793
4544,4453,555,2471415,2,36358,9091,1,201822136,201822136,13633,4544,9089,4544,0,1,4546,1323493,1.323493
5044,4453,555,2471415,2,40358,10091,1,221854136,221854136,15133,5044,10089,5044,0,1,5046,2412374,2.412374
5544,4453,555,2471415,2,44358,11091,1,241886136,241886136,16633,5544,11089,5544,0,1,5546,413282,0.413282
6044,4453,555,2471415,2,48358,12091,1,261918136,261918136,18133,6044,12089,6044,0,1,6046,361338,0.361338
6544,4453,555,2471415,2,52358,13091,1,281950136,281950136,19633,6544,13089,6544,0,1,6546,504789,0.504789
7044,4453,555,2471415,2,56358,14091,1,301982136,301982136,21133,7044,14089,7044,0,1,7046,161486,0.161486
55,6805,365,2483825,2,446,113,1,23025400,23025400,166,55,111,55,0,1,57,48603,0.048603
455,6805,365,2483825,2,3646,913,1,45969400,45969400,1366,455,911,455,0,1,457,228488,0.228488
855,6805,365,2483825,2,6846,1713,1,68913400,68913400,2566,855,1711,855,0,1,857,424308,0.424308
1255,6805,365,2483825,2,10046,2513,1,91857400,91857400,3766,1255,2511,1255,0,1,1257,625611,0.625611
1655,6805,365,2483825,2,13246,3313,1,114801400,114801400,4966,1655,3311,1655,0,1,1657,521542,0.521542
2055,6805,365,2483825,2,16446,4113,1,137745400,137745400,6166,2055,4111,2055,0,1,2057,575393,0.575393
2455,6805,365,2483825,2,19646,4913,1,160689400,160689400,7366,2455,4911,2455,0,1,2457,337187,0.337187
2855,6805,365,2483825,2,22846,5713,1,183633400,183633400,8566,2855,5711,2855,0,1,2857,1427240,1.42724
3255,6805,365,2483825,2,26046,6513,1,206577400,206577400,9766,3255,6511,3255,0,1,3257,126610,0.12661
3655,6805,365,2483825,2,29246,7313,1,229521400,229521400,10966,3655,7311,3655,0,1,3657,419626,0.419626
4055,6805,365,2483825,2,32446,8113,1,252465400,252465400,12166,4055,8111,4055,0,1,4057,1555743,1.555743
4455,6805,365,2483825,2,35646,8913,1,275409400,275409400,13366,4455,8911,4455,0,1,4457,1173010,1.17301
4855,6805,365,2483825,2,38846,9713,1,298353400,298353400,14566,4855,9711,4855,0,1,4857,693871,0.693871
5255,6805,365,2483825,2,42046,10513,1,321297400,321297400,15766,5255,10511,5255,0,1,5257,215303,0.215303
5655,6805,365,2483825,2,45246,11313,1,344241400,344241400,16966,5655,11311,5655,0,1,5657,2845877,2.845877
6055,6805,365,2483825,2,48446,12113,1,367185400,367185400,18166,6055,12111,6055,0,1,6057,1583721,1.583721
6455,6805,365,2483825,2,51646,12913,1,390129400,390129400,19366,6455,12911,6455,0,1,6457,1293452,1.293452
6855,6805,365,2483825,2,54846,13713,1,413073400,413073400,20566,6855,13711,6855,0,1,6857,457006,0.457006
40,550,4540,2497000,2,326,83,1,21604800,21604800,121,40,81,40,0,1,42,47069,0.047069
440,550,4540,2497000,2,3526,883,1,37892800,37892800,1321,440,881,440,0,1,442,229192,0.229192
840,550,4540,2497000,2,6726,1683,1,54180800,54180800,2521,840,1681,840,0,1,842,417269,0.417269
1240,550,4540,2497000,2,9926,2483,1,70468800,70468800,3721,1240,2481,1240,0,1,1242,459161,0.459161
1640,550,4540,2497000,2,13126,3283,1,86756800,86756800,4921,1640,3281,1640,0,1,1642,579118,0.579118
2040,550,4540,2497000,2,16326,4083,1,103044800,103044800,6121,2040,4081,2040,0,1,2042,73738,0.073738
2440,550,4540,2497000,2,19526,4883,1,119332800,119332800,7321,2440,4881,2440,0,1,2442,583676,0.583676
2840,550,4540,2497000,2,22726,5683,1,135620800,135620800,8521,2840,5681,2840,0,1,2842,1147214,1.147214
3240,550,4540,2497000,2,25926,6483,1,151908800,151908800,9721,3240,6481,3240,0,1,3242,1268868,1.268868
3640,550,4540,2497000,2,29126,7283,1,168196800,168196800,10921,3640,7281,3640,0,1,3642,589392,0.589392
4040,550,4540,2497000,2,32326,8083,1,184484800,184484800,12121,4040,8081,4040,0,1,4042,753811,0.753811
4440,550,4540,2497000,2,35526,8883,1,200772800,200772800,13321,4440,8881,4440,0,1,4442,77794,0.077794
4840,550,4540,2497000,2,38726,9683,1,217060800,217060800,14521,4840,9681,4840,0,1,4842,243917,0.243917
5240,550,4540,2497000,2,41926,10483,1,233348800,233348800,15721,5240,10481,5240,0,1,5242,146958,0.146958
5640,550,4540,2497000,2,45126,11283,1,249636800,249636800,16921,5640,11281,5640,0,1,5642,203492,0.203492
6040,550,4540,2497000,2,48326,12083,1,265924800,265924800,18121,6040,12081,6040,0,1,6042,92535,0.092535
6440,550,4540,2497000,2,51526,12883,1,282212800,282212800,19321,6440,12881,6440,0,1,6442,437072,0.437072
6840,550,4540,2497000,2,54726,13683,1,298500800,298500800,20521,6840,13681,6840,0,1,6842,120357,0.120357
55,3805,665,2530325,2,446,113,1,22209400,22209400,166,55,111,55,0,1,57,52786,0.052786
455,3805,665,2530325,2,3646,913,1,36513400,36513400,1366,455,911,455,0,1,457,238987,0.238987
855,3805,665,2530325,2,6846,1713,1,50817400,50817400,2566,855,1711,855,0,1,857,438127,0.438127
1255,3805,665,2530325,2,10046,2513,1,65121400,65121400,3766,1255,2511,1255,0,1,1257,647121,0.647121
1655,3805,665,2530325,2,13246,3313,1,79425400,79425400,4966,1655,3311,1655,0,1,1657,842363,0.842363
2055,3805,665,2530325,2,16446,4113,1,93729400,93729400,6166,2055,4111,2055,0,1,2057,1040809,1.040809
2455,3805,665,2530325,2,19646,4913,1,108033400,108033400,7366,2455,4911,2455,0,1,2457,1241401,1.241401
2855,3805,665,2530325,2,22846,5713,1,122337400,122337400,8566,2855,5711,2855,0,1,2857,1436769,1.436769
3255,3805,665,2530325,2,26046,6513,1,136641400,136641400,9766,3255,6511,3255,0,1,3257,395769,0.395769
3655,3805,665,2530325,2,29246,7313,1,150945400,150945400,10966,3655,7311,3655,0,1,3657,1846229,1.846229
4055,3805,665,2530325,2,32446,8113,1,165249400,165249400,12166,4055,8111,4055,0,1,4057,2043641,2.043641
4455,3805,665,2530325,2,35646,8913,1,179553400,179553400,13366,4455,8911,4455,0,1,4457,2232840,2.23284
4855,3805,665,2530325,2,38846,9713,1,193857400,193857400,14566,4855,9711,4855,0,1,4857,2438460,2.43846
5255,3805,665,2530325,2,42046,10513,1,208161400,208161400,15766,5255,10511,5255,0,1,5257,542618,0.542618
5655,3805,665,2530325,2,45246,11313,1,222465400,222465400,16966,5655,11311,5655,0,1,5657,2840611,2.840611
6055,3805,665,2530325,2,48446,12113,1,236769400,236769400,18166,6055,12111,6055,0,1,6057,1172533,1.172533
6455,3805,665,2530325,2,51646,12913,1,251073400,251073400,19366,6455,12911,6455,0,1,6457,3243513,3.243513
6855,3805,665,2530325,2,54846,13713,1,265377400,265377400,20566,6855,13711,6855,0,1,6857,1791404,1.791404
55,555,4565,2533575,2,446,113,1,22521400,22521400,166,55,111,55,0,1,57,53651,0.053651
455,555,4565,2533575,2,3646,913,1,38905400,38905400,1366,455,911,455,0,1,457,243537,0.243537
855,555,4565,2533575,2,6846,1713,1,55289400,55289400,2566,855,1711,855,0,1,857,101964,0.101964
1255,555,4565,2533575,2,10046,2513,1,71673400,71673400,3766,1255,2511,1255,0,1,1257,451996,0.451996
1655,555,4565,2533575,2,13246,3313,1,88057400,88057400,4966,1655,3311,1655,0,1,1657,171794,0.171794
2055,555,4565,2533575,2,16446,4113,1,104441400,104441400,6166,2055,4111,2055,0,1,2057,255157,0.255157
2455,555,4565,2533575,2,19646,4913,1,120825400,120825400,7366,2455,4911,2455,0,1,2457,97913,0.097913
2855,555,4565,2533575,2,22846,5713,1,137209400,137209400,8566,2855,5711,2855,0,1,2857,186237,0.186237
3255,555,4565,2533575,2,26046,6513,1,153593400,153593400,9766,3255,6511,3255,0,1,3257,1360987,1.360987
3655,555,4565,2533575,2,29246,7313,1,169977400,169977400,10966,3655,7311,3655,0,1,3657,393931,0.393931
4055,555,4565,2533575,2,32446,8113,1,186361400,186361400,12166,4055,8111,4055,0,1,4057,1519315,1.519315
4455,555,4565,2533575,2,35646,8913,1,202745400,202745400,13366,4455,8911,4455,0,1,4457,1496854,1.496854
4855,555,4565,2533575,2,38846,9713,1,219129400,219129400,14566,4855,9711,4855,0,1,4857,327211,0.327211
5255,555,4565,2533575,2,42046,10513,1,235513400,235513400,15766,5255,10511,5255,0,1,5257,628430,0.62843
5655,555,4565,2533575,2,45246,11313,1,251897400,251897400,16966,5655,11311,5655,0,1,5657,289799,0.289799
6055,555,4565,2533575,2,48446,12113,1,268281400,268281400,18166,6055,12111,6055,0,1,6057,487321,0.487321
6455,555,4565,2533575,2,51646,12913,1,284665400,284665400,19366,6455,12911,6455,0,1,6457,348179,0.348179
6855,555,4565,2533575,2,54846,13713,1,301049400,301049400,20566,6855,13711,6855,0,1,6857,391037,0.391037
40,2050,1240,2542000,2,326,83,1,21388800,21388800,121,40,81,40,0,1,42,8976,0.008976
440,2050,1240,2542000,2,3526,883,1,31916800,31916800,1321,440,881,440,0,1,442,18819,0.018819
840,2050,1240,2542000,2,6726,1683,1,42444800,42444800,2521,840,1681,840,0,1,842,120779,0.120779
1240,2050,1240,2542000,2,9926,2483,1,52972800,52972800,3721,1240,2481,1240,0,1,1242,109853,0.109853
1640,2050,1240,2542000,2,13126,3283,1,63500800,63500800,4921,1640,3281,1640,0,1,1642,21552,0.021552
2040,2050,1240,2542000,2,16326,4083,1,74028800,74028800,6121,2040,4081,2040,0,1,2042,19017,0.019017
2440,2050,1240,2542000,2,19526,4883,1,84556800,84556800,7321,2440,4881,2440,0,1,2442,143244,0.143244
2840,2050,1240,2542000,2,22726,5683,1,95084800,95084800,8521,2840,5681,2840,0,1,2842,284838,0.284838
3240,2050,1240,2542000,2,25926,6483,1,105612800,105612800,9721,3240,6481,3240,0,1,3242,248761,0.248761
3640,2050,1240,2542000,2,29126,7283,1,116140800,116140800,10921,3640,7281,3640,0,1,3642,204841,0.204841
4040,2050,1240,2542000,2,32326,8083,1,126668800,126668800,12121,4040,8081,4040,0,1,4042,1777702,1.777702
4440,2050,1240,2542000,2,35526,8883,1,137196800,137196800,13321,4440,8881,4440,0,1,4442,234985,0.234985
4840,2050,1240,2542000,2,38726,9683,1,147724800,147724800,14521,4840,9681,4840,0,1,4842,791872,0.791872
5240,2050,1240,2542000,2,41926,10483,1,158252800,158252800,15721,5240,10481,5240,0,1,5242,64835,0.064835
5640,2050,1240,2542000,2,45126,11283,1,168780800,168780800,16921,5640,11281,5640,0,1,5642,179434,0.179434
6040,2050,1240,2542000,2,48326,12083,1,179308800,179308800,18121,6040,12081,6040,0,1,6042,1504281,1.504281
6440,2050,1240,2542000,2,51526,12883,1,189836800,189836800,19321,6440,12881,6440,0,1,6442,1652589,1.652589
6840,2050,1240,2542000,2,54726,13683,1,200364800,200364800,20521,6840,13681,6840,0,1,6842,45096,0.045096
40,1050,2440,2562000,2,326,83,1,21612800,21612800,121,40,81,40,0,1,42,6551,0.006551
440,1050,2440,2562000,2,3526,883,1,32780800,32780800,1321,440,881,440,0,1,442,77895,0.077895
840,1050,2440,2562000,2,6726,1683,1,43948800,43948800,2521,840,1681,840,0,1,842,49396,0.049396
1240,1050,2440,2562000,2,9926,2483,1,55116800,55116800,3721,1240,2481,1240,0,1,1242,82932,0.082932
1640,1050,2440,2562000,2,13126,3283,1,66284800,66284800,4921,1640,3281,1640,0,1,1642,225419,0.225419
2040,1050,2440,2562000,2,16326,4083,1,77452800,77452800,6121,2040,4081,2040,0,1,2042,196553,0.196553
2440,1050,2440,2562000,2,19526,4883,1,88620800,88620800,7321,2440,4881,2440,0,1,2442,670721,0.670721
2840,1050,2440,2562000,2,22726,5683,1,99788800,99788800,8521,2840,5681,2840,0,1,2842,177797,0.177797
3240,1050,2440,2562000,2,25926,6483,1,110956800,110956800,9721,3240,6481,3240,0,1,3242,113375,0.113375
3640,1050,2440,2562000,2,29126,7283,1,122124800,122124800,10921,3640,7281,3640,0,1,3642,181614,0.181614
4040,1050,2440,2562000,2,32326,8083,1,133292800,133292800,12121,4040,8081,4040,0,1,4042,515205,0.515205
4440,1050,2440,2562000,2,35526,8883,1,144460800,144460800,13321,4440,8881,4440,0,1,4442,29777,0.029777
4840,1050,2440,2562000,2,38726,9683,1,155628800,155628800,14521,4840,9681,4840,0,1,4842,109604,0.109604
5240,1050,2440,2562000,2,41926,10483,1,166796800,166796800,15721,5240,10481,5240,0,1,5242,637603,0.637603
5640,1050,2440,2562000,2,45126,11283,1,177964800,177964800,16921,5640,11281,5640,0,1,5642,319818,0.319818
6040,1050,2440,2562000,2,48326,12083,1,189132800,189132800,18121,6040,12081,6040,0,1,6042,79242,0.079242
6440,1050,2440,2562000,2,51526,12883,1,200300800,200300800,19321,6440,12881,6440,0,1,6442,917162,0.917162
6840,1050,2440,2562000,2,54726,13683,1,211468800,211468800,20521,6840,13681,6840,0,1,6842,280157,0.280157
55,7055,365,2575075,2,446,113,1,23865400,23865400,166,55,111,55,0,1,57,50737,0.050737
455,7055,365,2575075,2,3646,913,1,47609400,47609400,1366,455,911,455,0,1,457,240013,0.240013
855,7055,365,2575075,2,6846,1713,1,71353400,71353400,2566,855,1711,855,0,1,857,441385,0.441385
1255,7055,365,2575075,2,10046,2513,1,95097400,95097400,3766,1255,2511,1255,0,1,1257,655730,0.65573
1655,7055,365,2575075,2,13246,3313,1,118841400,118841400,4966,1655,3311,1655,0,1,1657,855975,0.855975
2055,7055,365,2575075,2,16446,4113,1,142585400,142585400,6166,2055,4111,2055,0,1,2057,1062830,1.06283
2455,7055,365,2575075,2,19646,4913,1,166329400,166329400,7366,2455,4911,2455,0,1,2457,90059,0.090059
2855,7055,365,2575075,2,22846,5713,1,190073400,190073400,8566,2855,5711,2855,0,1,2857,642314,0.642314
3255,7055,365,2575075,2,26046,6513,1,213817400,213817400,9766,3255,6511,3255,0,1,3257,1699909,1.699909
3655,7055,365,2575075,2,29246,7313,1,237561400,237561400,10966,3655,7311,3655,0,1,3657,1922641,1.922641
4055,7055,365,2575075,2,32446,8113,1,261305400,261305400,12166,4055,8111,4055,0,1,4057,388114,0.388114
4455,7055,365,2575075,2,35646,8913,1,285049400,285049400,13366,4455,8911,4455,0,1,4457,2353910,2.35391
4855,7055,365,2575075,2,38846,9713,1,308793400,308793400,14566,4855,9711,4855,0,1,4857,2561816,2.561816
5255,7055,365,2575075,2,42046,10513,1,332537400,332537400,15766,5255,10511,5255,0,1,5257,2733476,2.733476
5655,7055,365,2575075,2,45246,11313,1,356281400,356281400,16966,5655,11311,5655,0,1,5657,2963432,2.963432
6055,7055,365,2575075,2,48446,12113,1,380025400,380025400,18166,6055,12111,6055,0,1,6057,3156715,3.156715
6455,7055,365,2575075,2,51646,12913,1,403769400,403769400,19366,6455,12911,6455,0,1,6457,3373190,3.37319
6855,7055,365,2575075,2,54846,13713,1,427513400,427513400,20566,6855,13711,6855,0,1,6857,3598793,3.598793
40,4050,640,2592000,2,326,83,1,22236800,22236800,121,40,81,40,0,1,42,3080,0.00308
440,4050,640,2592000,2,3526,883,1,37244800,37244800,1321,440,881,440,0,1,442,16528,0.016528
840,4050,640,2592000,2,6726,1683,1,52252800,52252800,2521,840,1681,840,0,1,842,3129,0.003129
1240,4050,640,2592000,2,9926,2483,1,67260800,67260800,3721,1240,2481,1240,0,1,1242,39043,0.039043
1640,4050,640,2592000,2,13126,3283,1,82268800,82268800,4921,1640,3281,1640,0,1,1642,33482,0.033482
2040,4050,640,2592000,2,16326,4083,1,97276800,97276800,6121,2040,4081,2040,0,1,2042,130914,0.130914
2440,4050,640,2592000,2,19526,4883,1,112284800,112284800,7321,2440,4881,2440,0,1,2442,18776,0.018776
2840,4050,640,2592000,2,22726,5683,1,127292800,127292800,8521,2840,5681,2840,0,1,2842,402770,0.40277
3240,4050,640,2592000,2,25926,6483,1,142300800,142300800,9721,3240,6481,3240,0,1,3242,580298,0.580298
3640,4050,640,2592000,2,29126,7283,1,157308800,157308800,10921,3640,7281,3640,0,1,3642,6756,0.006756
4040,4050,640,2592000,2,32326,8083,1,172316800,172316800,12121,4040,8081,4040,0,1,4042,741700,0.7417
4440,4050,640,2592000,2,35526,8883,1,187324800,187324800,13321,4440,8881,4440,0,1,4442,425693,0.425693
4840,4050,640,2592000,2,38726,9683,1,202332800,202332800,14521,4840,9681,4840,0,1,4842,47377,0.047377
5240,4050,640,2592000,2,41926,10483,1,217340800,217340800,15721,5240,10481,5240,0,1,5242,554758,0.554758
5640,4050,640,2592000,2,45126,11283,1,232348800,232348800,16921,5640,11281,5640,0,1,5642,1632015,1.632015
6040,4050,640,2592000,2,48326,12083,1,247356800,247356800,18121,6040,12081,6040,0,1,6042,372171,0.372171
6440,4050,640,2592000,2,51526,12883,1,262364800,262364800,19321,6440,12881,6440,0,1,6442,782380,0.78238
6840,4050,640,2592000,2,54726,13683,1,277372800,277372800,20521,6840,13681,6840,0,1,6842,318390,0.31839
55,2055,1265,2599575,2,446,113,1,22257400,22257400,166,55,111,55,0,1,57,7770,0.00777
455,2055,1265,2599575,2,3646,913,1,32881400,32881400,1366,455,911,455,0,1,457,82324,0.082324
855,2055,1265,2599575,2,6846,1713,1,43505400,43505400,2566,855,1711,855,0,1,857,45806,0.045806
1255,2055,1265,2599575,2,10046,2513,1,54129400,54129400,3766,1255,2511,1255,0,1,1257,14205,0.014205
1655,2055,1265,2599575,2,13246,3313,1,64753400,64753400,4966,1655,3311,1655,0,1,1657,575116,0.575116
2055,2055,1265,2599575,2,16446,4113,1,75377400,75377400,6166,2055,4111,2055,0,1,2057,274411,0.274411
2455,2055,1265,2599575,2,19646,4913,1,86001400,86001400,7366,2455,4911,2455,0,1,2457,582264,0.582264
2855,2055,1265,2599575,2,22846,5713,1,96625400,96625400,8566,2855,5711,2855,0,1,2857,304929,0.304929
3255,2055,1265,2599575,2,26046,6513,1,107249400,107249400,9766,3255,6511,3255,0,1,3257,5351,0.005351
3655,2055,1265,2599575,2,29246,7313,1,117873400,117873400,10966,3655,7311,3655,0,1,3657,912516,0.912516
4055,2055,1265,2599575,2,32446,8113,1,128497400,128497400,12166,4055,8111,4055,0,1,4057,100146,0.100146
4455,2055,1265,2599575,2,35646,8913,1,139121400,139121400,13366,4455,8911,4455,0,1,4457,910737,0.910737
4855,2055,1265,2599575,2,38846,9713,1,149745400,149745400,14566,4855,9711,4855,0,1,4857,536291,0.536291
5255,2055,1265,2599575,2,42046,10513,1,160369400,160369400,15766,5255,10511,5255,0,1,5257,750095,0.750095
5655,2055,1265,2599575,2,45246,11313,1,170993400,170993400,16966,5655,11311,5655,0,1,5657,146652,0.146652
6055,2055,1265,2599575,2,48446,12113,1,181617400,181617400,18166,6055,12111,6055,0,1,6057,249429,0.249429
6455,2055,1265,2599575,2,51646,12913,1,192241400,192241400,19366,6455,12911,6455,0,1,6457,59002,0.059002
6855,2055,1265,2599575,2,54846,13713,1,202865400,202865400,20566,6855,13711,6855,0,1,6857,790267,0.790267
55,1055,2465,2600575,2,446,113,1,22353400,22353400,166,55,111,55,0,1,57,5169,0.005169
455,1055,2465,2600575,2,3646,913,1,33617400,33617400,1366,455,911,455,0,1,457,52315,0.052315
855,1055,2465,2600575,2,6846,1713,1,44881400,44881400,2566,855,1711,855,0,1,857,31537,0.031537
1255,1055,2465,2600575,2,10046,2513,1,56145400,56145400,3766,1255,2511,1255,0,1,1257,12935,0.012935
1655,1055,2465,2600575,2,13246,3313,1,67409400,67409400,4966,1655,3311,1655,0,1,1657,125766,0.125766
2055,1055,2465,2600575,2,16446,4113,1,78673400,78673400,6166,2055,4111,2055,0,1,2057,21669,0.021669
2455,1055,2465,2600575,2,19646,4913,1,89937400,89937400,7366,2455,4911,2455,0,1,2457,157849,0.157849
2855,1055,2465,2600575,2,22846,5713,1,101201400,101201400,8566,2855,5711,2855,0,1,2857,667983,0.667983
3255,1055,2465,2600575,2,26046,6513,1,112465400,112465400,9766,3255,6511,3255,0,1,3257,98938,0.098938
3655,1055,2465,2600575,2,29246,7313,1,123729400,123729400,10966,3655,7311,3655,0,1,3657,318735,0.318735
4055,1055,2465,2600575,2,32446,8113,1,134993400,134993400,12166,4055,8111,4055,0,1,4057,399460,0.39946
4455,1055,2465,2600575,2,35646,8913,1,146257400,146257400,13366,4455,8911,4455,0,1,4457,9486,0.009486
4855,1055,2465,2600575,2,38846,9713,1,157521400,157521400,14566,4855,9711,4855,0,1,4857,270004,0.270004
5255,1055,2465,2600575,2,42046,10513,1,168785400,168785400,15766,5255,10511,5255,0,1,5257,859230,0.85923
5655,1055,2465,2600575,2,45246,11313,1,180049400,180049400,16966,5655,11311,5655,0,1,5657,545997,0.545997
6055,1055,2465,2600575,2,48446,12113,1,191313400,191313400,18166,6055,12111,6055,0,1,6057,605867,0.605867
6455,1055,2465,2600575,2,51646,12913,1,202577400,202577400,19366,6455,12911,6455,0,1,6457,417018,0.417018
6855,1055,2465,2600575,2,54846,13713,1,213841400,213841400,20566,6855,13711,6855,0,1,6857,14273,0.014273
39,1693,1541,2608913,2,318,81,1,21880312,21880312,118,39,79,39,0,1,41,47175,0.047175
539,1693,1541,2608913,2,4318,1081,1,34816312,34816312,1618,539,1079,539,0,1,541,101379,0.101379
1039,1693,1541,2608913,2,8318,2081,1,47752312,47752312,3118,1039,2079,1039,0,1,1041,554529,0.554529
1539,1693,1541,2608913,2,12318,3081,1,60688312,60688312,4618,1539,3079,1539,0,1,1541,800571,0.800571
2039,1693,1541,2608913,2,16318,4081,1,73624312,73624312,6118,2039,4079,2039,0,1,2041,990563,0.990563
2539,1693,1541,2608913,2,20318,5081,1,86560312,86560312,7618,2539,5079,2539,0,1,2541,1312548,1.312548
3039,1693,1541,2608913,2,24318,6081,1,99496312,99496312,9118,3039,6079,3039,0,1,3041,681270,0.68127
3539,1693,1541,2608913,2,28318,7081,1,112432312,112432312,10618,3539,7079,3539,0,1,3541,102490,0.10249
4039,1693,1541,2608913,2,32318,8081,1,125368312,125368312,12118,4039,8079,4039,0,1,4041,603659,0.603659
4539,1693,1541,2608913,2,36318,9081,1,138304312,138304312,13618,4539,9079,4539,0,1,4541,2346012,2.346012
5039,1693,1541,2608913,2,40318,10081,1,151240312,151240312,15118,5039,10079,5039,0,1,5041,1166608,1.166608
5539,1693,1541,2608913,2,44318,11081,1,164176312,164176312,16618,5539,11079,5539,0,1,5541,1182132,1.182132
6039,1693,1541,2608913,2,48318,12081,1,177112312,177112312,18118,6039,12079,6039,0,1,6041,1371456,1.371456
6539,1693,1541,2608913,2,52318,13081,1,190048312,190048312,19618,6539,13079,6539,0,1,6541,1399233,1.399233
7039,1693,1541,2608913,2,56318,14081,1,202984312,202984312,21118,7039,14079,7039,0,1,7041,3639453,3.639453
40,2800,940,2632000,2,326,83,1,22252800,22252800,121,40,81,40,0,1,42,47213,0.047213
440,2800,940,2632000,2,3526,883,1,34220800,34220800,1321,440,881,440,0,1,442,237969,0.237969
840,2800,940,2632000,2,6726,1683,1,46188800,46188800,2521,840,1681,840,0,1,842,436982,0.436982
1240,2800,940,2632000,2,9926,2483,1,58156800,58156800,3721,1240,2481,1240,0,1,1242,633077,0.633077
1640,2800,940,2632000,2,13126,3283,1,70124800,70124800,4921,1640,3281,1640,0,1,1642,73633,0.073633
2040,2800,940,2632000,2,16326,4083,1,82092800,82092800,6121,2040,4081,2040,0,1,2042,120436,0.120436
2440,2800,940,2632000,2,19526,4883,1,94060800,94060800,7321,2440,4881,2440,0,1,2442,1253792,1.253792
2840,2800,940,2632000,2,22726,5683,1,106028800,106028800,8521,2840,5681,2840,0,1,2842,1430521,1.430521
3240,2800,940,2632000,2,25926,6483,1,117996800,117996800,9721,3240,6481,3240,0,1,3242,1631077,1.631077
3640,2800,940,2632000,2,29126,7283,1,129964800,129964800,10921,3640,7281,3640,0,1,3642,868918,0.868918
4040,2800,940,2632000,2,32326,8083,1,141932800,141932800,12121,4040,8081,4040,0,1,4042,1008766,1.008766
4440,2800,940,2632000,2,35526,8883,1,153900800,153900800,13321,4440,8881,4440,0,1,4442,2236379,2.236379
4840,2800,940,2632000,2,38726,9683,1,165868800,165868800,14521,4840,9681,4840,0,1,4842,412287,0.412287
5240,2800,940,2632000,2,41926,10483,1,177836800,177836800,15721,5240,10481,5240,0,1,5242,338179,0.338179
5640,2800,940,2632000,2,45126,11283,1,189804800,189804800,16921,5640,11281,5640,0,1,5642,21120,0.02112
6040,2800,940,2632000,2,48326,12083,1,201772800,201772800,18121,6040,12081,6040,0,1,6042,1015860,1.01586
6440,2800,940,2632000,2,51526,12883,1,213740800,213740800,19321,6440,12881,6440,0,1,6442,3236408,3.236408
6840,2800,940,2632000,2,54726,13683,1,225708800,225708800,20521,6840,13681,6840,0,1,6842,3445049,3.445049
44,1703,1555,2648165,2,358,91,1,22332136,22332136,133,44,89,44,0,1,46,50347,0.050347
544,1703,1555,2648165,2,4358,1091,1,35364136,35364136,1633,544,1089,544,0,1,546,301308,0.301308
1044,1703,1555,2648165,2,8358,2091,1,48396136,48396136,3133,1044,2089,1044,0,1,1046,482951,0.482951
1544,1703,1555,2648165,2,12358,3091,1,61428136,61428136,4633,1544,3089,1544,0,1,1546,208703,0.208703
2044,1703,1555,2648165,2,16358,4091,1,74460136,74460136,6133,2044,4089,2044,0,1,2046,1070763,1.070763
2544,1703,1555,2648165,2,20358,5091,1,87492136,87492136,7633,2544,5089,2544,0,1,2546,1327977,1.327977
3044,1703,1555,2648165,2,24358,6091,1,100524136,100524136,9133,3044,6089,3044,0,1,3046,1593751,1.593751
3544,1703,1555,2648165,2,28358,7091,1,113556136,113556136,10633,3544,7089,3544,0,1,3546,538654,0.538654
4044,1703,1555,2648165,2,32358,8091,1,126588136,126588136,12133,4044,8089,4044,0,1,4046,2119181,2.119181
4544,1703,1555,2648165,2,36358,9091,1,139620136,139620136,13633,4544,9089,4544,0,1,4546,2367456,2.367456
5044,1703,1555,2648165,2,40358,10091,1,152652136,152652136,15133,5044,10089,5044,0,1,5046,1097510,1.09751
5544,1703,1555,2648165,2,44358,11091,1,165684136,165684136,16633,5544,11089,5544,0,1,5546,624848,0.624848
6044,1703,1555,2648165,2,48358,12091,1,178716136,178716136,18133,6044,12089,6044,0,1,6046,832520,0.83252
6544,1703,1555,2648165,2,52358,13091,1,191748136,191748136,19633,6544,13089,6544,0,1,6546,20549,0.020549
7044,1703,1555,2648165,2,56358,14091,1,204780136,204780136,21133,7044,14089,7044,0,1,7046,892239,0.892239
40,550,4840,2662000,2,326,83,1,23020800,23020800,121,40,81,40,0,1,42,49560,0.04956
440,550,4840,2662000,2,3526,883,1,40268800,40268800,1321,440,881,440,0,1,442,243907,0.243907
840,550,4840,2662000,2,6726,1683,1,57516800,57516800,2521,840,1681,840,0,1,842,312144,0.312144
1240,550,4840,2662000,2,9926,2483,1,74764800,74764800,3721,1240,2481,1240,0,1,1242,45592,0.045592
1640,550,4840,2662000,2,13126,3283,1,92012800,92012800,4921,1640,3281,1640,0,1,1642,841210,0.84121
2040,550,4840,2662000,2,16326,4083,1,109260800,109260800,6121,2040,4081,2040,0,1,2042,231096,0.231096
2440,550,4840,2662000,2,19526,4883,1,126508800,126508800,7321,2440,4881,2440,0,1,2442,889520,0.88952
2840,550,4840,2662000,2,22726,5683,1,143756800,143756800,8521,2840,5681,2840,0,1,2842,1076093,1.076093
3240,550,4840,2662000,2,25926,6483,1,161004800,161004800,9721,3240,6481,3240,0,1,3242,1167468,1.167468
3640,550,4840,2662000,2,29126,7283,1,178252800,178252800,10921,3640,7281,3640,0,1,3642,1842923,1.842923
4040,550,4840,2662000,2,32326,8083,1,195500800,195500800,12121,4040,8081,4040,0,1,4042,13658,0.013658
4440,550,4840,2662000,2,35526,8883,1,212748800,212748800,13321,4440,8881,4440,0,1,4442,906374,0.906374
4840,550,4840,2662000,2,38726,9683,1,229996800,229996800,14521,4840,9681,4840,0,1,4842,2447408,2.447408
5240,550,4840,2662000,2,41926,10483,1,247244800,247244800,15721,5240,10481,5240,0,1,5242,1349196,1.349196
5640,550,4840,2662000,2,45126,11283,1,264492800,264492800,16921,5640,11281,5640,0,1,5642,2344150,2.34415
6040,550,4840,2662000,2,48326,12083,1,281740800,281740800,18121,6040,12081,6040,0,1,6042,2206262,2.206262
6440,550,4840,2662000,2,51526,12883,1,298988800,298988800,19321,6440,12881,6440,0,1,6442,63072,0.063072
6840,550,4840,2662000,2,54726,13683,1,316236800,316236800,20521,6840,13681,6840,0,1,6842,1851082,1.851082
40,800,3340,2672000,2,326,83,1,22700800,22700800,121,40,81,40,0,1,42,49188,0.049188
440,800,3340,2672000,2,3526,883,1,35948800,35948800,1321,440,881,440,0,1,442,244515,0.244515
840,800,3340,2672000,2,6726,1683,1,49196800,49196800,2521,840,1681,840,0,1,842,422274,0.422274
1240,800,3340,2672000,2,9926,2483,1,62444800,62444800,3721,1240,2481,1240,0,1,1242,645438,0.645438
1640,800,3340,2672000,2,13126,3283,1,75692800,75692800,4921,1640,3281,1640,0,1,1642,533501,0.533501
2040,800,3340,2672000,2,16326,4083,1,88940800,88940800,6121,2040,4081,2040,0,1,2042,134003,0.134003
2440,800,3340,2672000,2,19526,4883,1,102188800,102188800,7321,2440,4881,2440,0,1,2442,105784,0.105784
2840,800,3340,2672000,2,22726,5683,1,115436800,115436800,8521,2840,5681,2840,0,1,2842,705704,0.705704
3240,800,3340,2672000,2,25926,6483,1,128684800,128684800,9721,3240,6481,3240,0,1,3242,631219,0.631219
3640,800,3340,2672000,2,29126,7283,1,141932800,141932800,10921,3640,7281,3640,0,1,3642,250619,0.250619
4040,800,3340,2672000,2,32326,8083,1,155180800,155180800,12121,4040,8081,4040,0,1,4042,1124984,1.124984
4440,800,3340,2672000,2,35526,8883,1,168428800,168428800,13321,4440,8881,4440,0,1,4442,74524,0.074524
4840,800,3340,2672000,2,38726,9683,1,181676800,181676800,14521,4840,9681,4840,0,1,4842,405383,0.405383
5240,800,3340,2672000,2,41926,10483,1,194924800,194924800,15721,5240,10481,5240,0,1,5242,1284194,1.284194
5640,800,3340,2672000,2,45126,11283,1,208172800,208172800,16921,5640,11281,5640,0,1,5642,1126291,1.126291
6040,800,3340,2672000,2,48326,12083,1,221420800,221420800,18121,6040,12081,6040,0,1,6042,536926,0.536926
6440,800,3340,2672000,2,51526,12883,1,234668800,234668800,19321,6440,12881,6440,0,1,6442,671720,0.67172
6840,800,3340,2672000,2,54726,13683,1,247916800,247916800,20521,6840,13681,6840,0,1,6842,946738,0.946738
35,590,4545,2681550,2,286,73,1,22890200,22890200,106,35,71,35,0,1,37,11506,0.011506
535,590,4545,2681550,2,4286,1073,1,43430200,43430200,1606,535,1071,535,0,1,537,30276,0.030276
1035,590,4545,2681550,2,8286,2073,1,63970200,63970200,3106,1035,2071,1035,0,1,1037,41983,0.041983
1535,590,4545,2681550,2,12286,3073,1,84510200,84510200,4606,1535,3071,1535,0,1,1537,230183,0.230183
2035,590,4545,2681550,2,16286,4073,1,105050200,105050200,6106,2035,4071,2035,0,1,2037,32152,0.032152
2535,590,4545,2681550,2,20286,5073,1,125590200,125590200,7606,2535,5071,2535,0,1,2537,1357762,1.357762
3035,590,4545,2681550,2,24286,6073,1,146130200,146130200,9106,3035,6071,3035,0,1,3037,1624065,1.624065
3535,590,4545,2681550,2,28286,7073,1,166670200,166670200,10606,3535,7071,3535,0,1,3537,1898051,1.898051
4035,590,4545,2681550,2,32286,8073,1,187210200,187210200,12106,4035,8071,4035,0,1,4037,2192836,2.192836
4535,590,4545,2681550,2,36286,9073,1,207750200,207750200,13606,4535,9071,4535,0,1,4537,2449565,2.449565
5035,590,4545,2681550,2,40286,10073,1,228290200,228290200,15106,5035,10071,5035,0,1,5037,2739781,2.739781
5535,590,4545,2681550,2,44286,11073,1,248830200,248830200,16606,5535,11071,5535,0,1,5537,2993062,2.993062
6035,590,4545,2681550,2,48286,12073,1,269370200,269370200,18106,6035,12071,6035,0,1,6037,3266814,3.266814
6535,590,4545,2681550,2,52286,13073,1,289910200,289910200,19606,6535,13071,6535,0,1,6537,3556658,3.556658
7035,590,4545,2681550,2,56286,14073,1,310450200,310450200,21106,7035,14071,7035,0,1,7037,3799694,3.799694
39,593,4541,2692813,2,318,81,1,23144312,23144312,118,39,79,39,0,1,41,5115,0.005115
539,593,4541,2692813,2,4318,1081,1,43680312,43680312,1618,539,1079,539,0,1,541,295798,0.295798
1039,593,4541,2692813,2,8318,2081,1,64216312,64216312,3118,1039,2079,1039,0,1,1041,20816,0.020816
1539,593,4541,2692813,2,12318,3081,1,84752312,84752312,4618,1539,3079,1539,0,1,1541,582698,0.582698
2039,593,4541,2692813,2,16318,4081,1,105288312,105288312,6118,2039,4079,2039,0,1,2041,643096,0.643096
2539,593,4541,2692813,2,20318,5081,1,125824312,125824312,7618,2539,5079,2539,0,1,2541,430227,0.430227
3039,593,4541,2692813,2,24318,6081,1,146360312,146360312,9118,3039,6079,3039,0,1,3041,1079897,1.079897
3539,593,4541,2692813,2,28318,7081,1,166896312,166896312,10618,3539,7079,3539,0,1,3541,445405,0.445405
4039,593,4541,2692813,2,32318,8081,1,187432312,187432312,12118,4039,8079,4039,0,1,4041,408959,0.408959
4539,593,4541,2692813,2,36318,9081,1,207968312,207968312,13618,4539,9079,4539,0,1,4541,439601,0.439601
5039,593,4541,2692813,2,40318,10081,1,228504312,228504312,15118,5039,10079,5039,0,1,5041,89953,0.089953
5539,593,4541,2692813,2,44318,11081,1,249040312,249040312,16618,5539,11079,5539,0,1,5541,1069742,1.069742
6039,593,4541,2692813,2,48318,12081,1,269576312,269576312,18118,6039,12079,6039,0,1,6041,765733,0.765733
6539,593,4541,2692813,2,52318,13081,1,290112312,290112312,19618,6539,13079,6539,0,1,6541,266416,0.266416
7039,593,4541,2692813,2,56318,14081,1,310648312,310648312,21118,7039,14079,7039,0,1,7041,389119,0.389119
55,4055,665,2696575,2,446,113,1,23649400,23649400,166,55,111,55,0,1,57,12482,0.012482
455,4055,665,2696575,2,3646,913,1,38753400,38753400,1366,455,911,455,0,1,457,32917,0.032917
855,4055,665,2696575,2,6846,1713,1,53857400,53857400,2566,855,1711,855,0,1,857,13494,0.013494
1255,4055,665,2696575,2,10046,2513,1,68961400,68961400,3766,1255,2511,1255,0,1,1257,136142,0.136142
1655,4055,665,2696575,2,13246,3313,1,84065400,84065400,4966,1655,3311,1655,0,1,1657,485860,0.48586
2055,4055,665,2696575,2,16446,4113,1,99169400,99169400,6166,2055,4111,2055,0,1,2057,809267,0.809267
2455,4055,665,2696575,2,19646,4913,1,114273400,114273400,7366,2455,4911,2455,0,1,2457,18522,0.018522
2855,4055,665,2696575,2,22846,5713,1,129377400,129377400,8566,2855,5711,2855,0,1,2857,183351,0.183351
3255,4055,665,2696575,2,26046,6513,1,144481400,144481400,9766,3255,6511,3255,0,1,3257,35224,0.035224
3655,4055,665,2696575,2,29246,7313,1,159585400,159585400,10966,3655,7311,3655,0,1,3657,109080,0.10908
4055,4055,665,2696575,2,32446,8113,1,174689400,174689400,12166,4055,8111,4055,0,1,4057,746158,0.746158
4455,4055,665,2696575,2,35646,8913,1,189793400,189793400,13366,4455,8911,4455,0,1,4457,1228085,1.228085
4855,4055,665,2696575,2,38846,9713,1,204897400,204897400,14566,4855,9711,4855,0,1,4857,266159,0.266159
5255,4055,665,2696575,2,42046,10513,1,220001400,220001400,15766,5255,10511,5255,0,1,5257,729968,0.729968
5655,4055,665,2696575,2,45246,11313,1,235105400,235105400,16966,5655,11311,5655,0,1,5657,1023927,1.023927
6055,4055,665,2696575,2,48446,12113,1,250209400,250209400,18166,6055,12111,6055,0,1,6057,1223590,1.22359
6455,4055,665,2696575,2,51646,12913,1,265313400,265313400,19366,6455,12911,6455,0,1,6457,117699,0.117699
6855,4055,665,2696575,2,54846,13713,1,280417400,280417400,20566,6855,13711,6855,0,1,6857,3553052,3.553052
35,4950,545,2697750,2,286,73,1,23120600,23120600,106,35,71,35,0,1,37,5051,0.005051
535,4950,545,2697750,2,4286,1073,1,45100600,45100600,1606,535,1071,535,0,1,537,2178,0.002178
1035,4950,545,2697750,2,8286,2073,1,67080600,67080600,3106,1035,2071,1035,0,1,1037,426943,0.426943
1535,4950,545,2697750,2,12286,3073,1,89060600,89060600,4606,1535,3071,1535,0,1,1537,835964,0.835964
2035,4950,545,2697750,2,16286,4073,1,111040600,111040600,6106,2035,4071,2035,0,1,2037,547569,0.547569
2535,4950,545,2697750,2,20286,5073,1,133020600,133020600,7606,2535,5071,2535,0,1,2537,1377501,1.377501
3035,4950,545,2697750,2,24286,6073,1,155000600,155000600,9106,3035,6071,3035,0,1,3037,1633367,1.633367
3535,4950,545,2697750,2,28286,7073,1,176980600,176980600,10606,3535,7071,3535,0,1,3537,486965,0.486965
4035,4950,545,2697750,2,32286,8073,1,198960600,198960600,12106,4035,8071,4035,0,1,4037,178372,0.178372
4535,4950,545,2697750,2,36286,9073,1,220940600,220940600,13606,4535,9071,4535,0,1,4537,2456967,2.456967
5035,4950,545,2697750,2,40286,10073,1,242920600,242920600,15106,5035,10071,5035,0,1,5037,2695849,2.695849
5535,4950,545,2697750,2,44286,11073,1,264900600,264900600,16606,5535,11071,5535,0,1,5537,2989182,2.989182
6035,4950,545,2697750,2,48286,12073,1,286880600,286880600,18106,6035,12071,6035,0,1,6037,3240149,3.240149
6535,4950,545,2697750,2,52286,13073,1,308860600,308860600,19606,6535,13071,6535,0,1,6537,3496822,3.496822
7035,4950,545,2697750,2,56286,14073,1,330840600,330840600,21106,7035,14071,7035,0,1,7037,3783384,3.783384
55,555,4865,2700075,2,446,113,1,23985400,23985400,166,55,111,55,0,1,57,56941,0.056941
455,555,4865,2700075,2,3646,913,1,41329400,41329400,1366,455,911,455,0,1,457,186970,0.18697
855,555,4865,2700075,2,6846,1713,1,58673400,58673400,2566,855,1711,855,0,1,857,226427,0.226427
1255,555,4865,2700075,2,10046,2513,1,76017400,76017400,3766,1255,2511,1255,0,1,1257,668707,0.668707
1655,555,4865,2700075,2,13246,3313,1,93361400,93361400,4966,1655,3311,1655,0,1,1657,875266,0.875266
2055,555,4865,2700075,2,16446,4113,1,110705400,110705400,6166,2055,4111,2055,0,1,2057,218742,0.218742
2455,555,4865,2700075,2,19646,4913,1,128049400,128049400,7366,2455,4911,2455,0,1,2457,1289905,1.289905
2855,555,4865,2700075,2,22846,5713,1,145393400,145393400,8566,2855,5711,2855,0,1,2857,1126582,1.126582
3255,555,4865,2700075,2,26046,6513,1,162737400,162737400,9766,3255,6511,3255,0,1,3257,695768,0.695768
3655,555,4865,2700075,2,29246,7313,1,180081400,180081400,10966,3655,7311,3655,0,1,3657,1912862,1.912862
4055,555,4865,2700075,2,32446,8113,1,197425400,197425400,12166,4055,8111,4055,0,1,4057,49326,0.049326
4455,555,4865,2700075,2,35646,8913,1,214769400,214769400,13366,4455,8911,4455,0,1,4457,1443336,1.443336
4855,555,4865,2700075,2,38846,9713,1,232113400,232113400,14566,4855,9711,4855,0,1,4857,892297,0.892297
5255,555,4865,2700075,2,42046,10513,1,249457400,249457400,15766,5255,10511,5255,0,1,5257,618647,0.618647
5655,555,4865,2700075,2,45246,11313,1,266801400,266801400,16966,5655,11311,5655,0,1,5657,1147026,1.147026
6055,555,4865,2700075,2,48446,12113,1,284145400,284145400,18166,6055,12111,6055,0,1,6057,2812782,2.812782
6455,555,4865,2700075,2,51646,12913,1,301489400,301489400,19366,6455,12911,6455,0,1,6457,298180,0.29818
6855,555,4865,2700075,2,54846,13713,1,318833400,318833400,20566,6855,13711,6855,0,1,6857,43473,0.043473
39,4993,541,2701213,2,318,81,1,23336312,23336312,118,39,79,39,0,1,41,47416,0.047416
539,4993,541,2701213,2,4318,1081,1,45472312,45472312,1618,539,1079,539,0,1,541,291520,0.29152
1039,4993,541,2701213,2,8318,2081,1,67608312,67608312,3118,1039,2079,1039,0,1,1041,547545,0.547545
1539,4993,541,2701213,2,12318,3081,1,89744312,89744312,4618,1539,3079,1539,0,1,1541,811400,0.8114
2039,4993,541,2701213,2,16318,4081,1,111880312,111880312,6118,2039,4079,2039,0,1,2041,1065809,1.065809
2539,4993,541,2701213,2,20318,5081,1,134016312,134016312,7618,2539,5079,2539,0,1,2541,1324075,1.324075
3039,4993,541,2701213,2,24318,6081,1,156152312,156152312,9118,3039,6079,3039,0,1,3041,1201301,1.201301
3539,4993,541,2701213,2,28318,7081,1,178288312,178288312,10618,3539,7079,3539,0,1,3541,881958,0.881958
4039,4993,541,2701213,2,32318,8081,1,200424312,200424312,12118,4039,8079,4039,0,1,4041,2105336,2.105336
4539,4993,541,2701213,2,36318,9081,1,222560312,222560312,13618,4539,9079,4539,0,1,4541,2367418,2.367418
5039,4993,541,2701213,2,40318,10081,1,244696312,244696312,15118,5039,10079,5039,0,1,5041,2611041,2.611041
5539,4993,541,2701213,2,44318,11081,1,266832312,266832312,16618,5539,11079,5539,0,1,5541,2868948,2.868948
6039,4993,541,2701213,2,48318,12081,1,288968312,288968312,18118,6039,12079,6039,0,1,6041,3164066,3.164066
6539,4993,541,2701213,2,52318,13081,1,311104312,311104312,19618,6539,13079,6539,0,1,6541,3392149,3.392149
7039,4993,541,2701213,2,56318,14081,1,333240312,333240312,21118,7039,14079,7039,0,1,7041,3668118,3.668118
55,2805,965,2706825,2,446,113,1,23313400,23313400,166,55,111,55,0,1,57,54679,0.054679
455,2805,965,2706825,2,3646,913,1,35377400,35377400,1366,455,911,455,0,1,457,252350,0.25235
855,2805,965,2706825,2,6846,1713,1,47441400,47441400,2566,855,1711,855,0,1,857,454073,0.454073
1255,2805,965,2706825,2,10046,2513,1,59505400,59505400,3766,1255,2511,1255,0,1,1257,232215,0.232215
1655,2805,965,2706825,2,13246,3313,1,71569400,71569400,4966,1655,3311,1655,0,1,1657,859056,0.859056
2055,2805,965,2706825,2,16446,4113,1,83633400,83633400,6166,2055,4111,2055,0,1,2057,75195,0.075195
2455,2805,965,2706825,2,19646,4913,1,95697400,95697400,7366,2455,4911,2455,0,1,2457,185189,0.185189
2855,2805,965,2706825,2,22846,5713,1,107761400,107761400,8566,2855,5711,2855,0,1,2857,1470386,1.470386
3255,2805,965,2706825,2,26046,6513,1,119825400,119825400,9766,3255,6511,3255,0,1,3257,1676380,1.67638
3655,2805,965,2706825,2,29246,7313,1,131889400,131889400,10966,3655,7311,3655,0,1,3657,345615,0.345615
4055,2805,965,2706825,2,32446,8113,1,143953400,143953400,12166,4055,8111,4055,0,1,4057,1146508,1.146508
4455,2805,965,2706825,2,35646,8913,1,156017400,156017400,13366,4455,8911,4455,0,1,4457,789762,0.789762
4855,2805,965,2706825,2,38846,9713,1,168081400,168081400,14566,4855,9711,4855,0,1,4857,301000,0.301
5255,2805,965,2706825,2,42046,10513,1,180145400,180145400,15766,5255,10511,5255,0,1,5257,2703344,2.703344
5655,2805,965,2706825,2,45246,11313,1,192209400,192209400,16966,5655,11311,5655,0,1,5657,695350,0.69535
6055,2805,965,2706825,2,48446,12113,1,204273400,204273400,18166,6055,12111,6055,0,1,6057,2469189,2.469189
6455,2805,965,2706825,2,51646,12913,1,216337400,216337400,19366,6455,12911,6455,0,1,6457,427438,0.427438
6855,2805,965,2706825,2,54846,13713,1,228401400,228401400,20566,6855,13711,6855,0,1,6857,3505447,3.505447
55,805,3365,2708825,2,446,113,1,23505400,23505400,166,55,111,55,0,1,57,56313,0.056313
455,805,3365,2708825,2,3646,913,1,36849400,36849400,1366,455,911,455,0,1,457,258360,0.25836
855,805,3365,2708825,2,6846,1713,1,50193400,50193400,2566,855,1711,855,0,1,857,461952,0.461952
1255,805,3365,2708825,2,10046,2513,1,63537400,63537400,3766,1255,2511,1255,0,1,1257,652520,0.65252
1655,805,3365,2708825,2,13246,3313,1,76881400,76881400,4966,1655,3311,1655,0,1,1657,824674,0.824674
2055,805,3365,2708825,2,16446,4113,1,90225400,90225400,6166,2055,4111,2055,0,1,2057,1082655,1.082655
2455,805,3365,2708825,2,19646,4913,1,103569400,103569400,7366,2455,4911,2455,0,1,2457,1290158,1.290158
2855,805,3365,2708825,2,22846,5713,1,116913400,116913400,8566,2855,5711,2855,0,1,2857,1495224,1.495224
3255,805,3365,2708825,2,26046,6513,1,130257400,130257400,9766,3255,6511,3255,0,1,3257,25710,0.02571
3655,805,3365,2708825,2,29246,7313,1,143601400,143601400,10966,3655,7311,3655,0,1,3657,1354936,1.354936
4055,805,3365,2708825,2,32446,8113,1,156945400,156945400,12166,4055,8111,4055,0,1,4057,154230,0.15423
4455,805,3365,2708825,2,35646,8913,1,170289400,170289400,13366,4455,8911,4455,0,1,4457,286214,0.286214
4855,805,3365,2708825,2,38846,9713,1,183633400,183633400,14566,4855,9711,4855,0,1,4857,2534896,2.534896
5255,805,3365,2708825,2,42046,10513,1,196977400,196977400,15766,5255,10511,5255,0,1,5257,170773,0.170773
5655,805,3365,2708825,2,45246,11313,1,210321400,210321400,16966,5655,11311,5655,0,1,5657,130037,0.130037
6055,805,3365,2708825,2,48446,12113,1,223665400,223665400,18166,6055,12111,6055,0,1,6057,996226,0.996226
6455,805,3365,2708825,2,51646,12913,1,237009400,237009400,19366,6455,12911,6455,0,1,6457,1025368,1.025368
6855,805,3365,2708825,2,54846,13713,1,250353400,250353400,20566,6855,13711,6855,0,1,6857,3182643,3.182643
44,603,4555,2746665,2,358,91,1,23788936,23788936,133,44,89,44,0,1,46,55075,0.055075
544,603,4555,2746665,2,4358,1091,1,44420936,44420936,1633,544,1089,544,0,1,546,147903,0.147903
1044,603,4555,2746665,2,8358,2091,1,65052936,65052936,3133,1044,2089,1044,0,1,1046,195643,0.195643
1544,603,4555,2746665,2,12358,3091,1,85684936,85684936,4633,1544,3089,1544,0,1,1546,755097,0.755097
2044,603,4555,2746665,2,16358,4091,1,106316936,106316936,6133,2044,4089,2044,0,1,2046,1089998,1.089998
2544,603,4555,2746665,2,20358,5091,1,126948936,126948936,7633,2544,5089,2544,0,1,2546,82535,0.082535
3044,603,4555,2746665,2,24358,6091,1,147580936,147580936,9133,3044,6089,3044,0,1,3046,70298,0.070298
3544,603,4555,2746665,2,28358,7091,1,168212936,168212936,10633,3544,7089,3544,0,1,3546,176409,0.176409
4044,603,4555,2746665,2,32358,8091,1,188844936,188844936,12133,4044,8089,4044,0,1,4046,308252,0.308252
4544,603,4555,2746665,2,36358,9091,1,209476936,209476936,13633,4544,9089,4544,0,1,4546,1235752,1.235752
5044,603,4555,2746665,2,40358,10091,1,230108936,230108936,15133,5044,10089,5044,0,1,5046,2135960,2.13596
5544,603,4555,2746665,2,44358,11091,1,250740936,250740936,16633,5544,11089,5544,0,1,5546,781841,0.781841
6044,603,4555,2746665,2,48358,12091,1,271372936,271372936,18133,6044,12089,6044,0,1,6046,282108,0.282108
6544,603,4555,2746665,2,52358,13091,1,292004936,292004936,19633,6544,13089,6544,0,1,6546,2474522,2.474522
7044,603,4555,2746665,2,56358,14091,1,312636936,312636936,21133,7044,14089,7044,0,1,7046,209780,0.20978
40,4300,640,2752000,2,326,83,1,23596800,23596800,121,40,81,40,0,1,42,48740,0.04874
440,4300,640,2752000,2,3526,883,1,39404800,39404800,1321,440,881,440,0,1,442,242037,0.242037
840,4300,640,2752000,2,6726,1683,1,55212800,55212800,2521,840,1681,840,0,1,842,380808,0.380808
1240,4300,640,2752000,2,9926,2483,1,71020800,71020800,3721,1240,2481,1240,0,1,1242,639449,0.639449
1640,4300,640,2752000,2,13126,3283,1,86828800,86828800,4921,1640,3281,1640,0,1,1642,17690,0.01769
2040,4300,640,2752000,2,16326,4083,1,102636800,102636800,6121,2040,4081,2040,0,1,2042,1042604,1.042604
2440,4300,640,2752000,2,19526,4883,1,118444800,118444800,7321,2440,4881,2440,0,1,2442,24145,0.024145
2840,4300,640,2752000,2,22726,5683,1,134252800,134252800,8521,2840,5681,2840,0,1,2842,135374,0.135374
3240,4300,640,2752000,2,25926,6483,1,150060800,150060800,9721,3240,6481,3240,0,1,3242,1635613,1.635613
3640,4300,640,2752000,2,29126,7283,1,165868800,165868800,10921,3640,7281,3640,0,1,3642,590932,0.590932
4040,4300,640,2752000,2,32326,8083,1,181676800,181676800,12121,4040,8081,4040,0,1,4042,2042605,2.042605
4440,4300,640,2752000,2,35526,8883,1,197484800,197484800,13321,4440,8881,4440,0,1,4442,981513,0.981513
4840,4300,640,2752000,2,38726,9683,1,213292800,213292800,14521,4840,9681,4840,0,1,4842,2436275,2.436275
5240,4300,640,2752000,2,41926,10483,1,229100800,229100800,15721,5240,10481,5240,0,1,5242,2639208,2.639208
5640,4300,640,2752000,2,45126,11283,1,244908800,244908800,16921,5640,11281,5640,0,1,5642,2206976,2.206976
6040,4300,640,2752000,2,48326,12083,1,260716800,260716800,18121,6040,12081,6040,0,1,6042,265527,0.265527
6440,4300,640,2752000,2,51526,12883,1,276524800,276524800,19321,6440,12881,6440,0,1,6442,565882,0.565882
6840,4300,640,2752000,2,54726,13683,1,292332800,292332800,20521,6840,13681,6840,0,1,6842,1668966,1.668966
40,1800,1540,2772000,2,326,83,1,23244800,23244800,121,40,81,40,0,1,42,52401,0.052401
440,1800,1540,2772000,2,3526,883,1,33932800,33932800,1321,440,881,440,0,1,442,257775,0.257775
840,1800,1540,2772000,2,6726,1683,1,44620800,44620800,2521,840,1681,840,0,1,842,471751,0.471751
1240,1800,1540,2772000,2,9926,2483,1,55308800,55308800,3721,1240,2481,1240,0,1,1242,473957,0.473957
1640,1800,1540,2772000,2,13126,3283,1,65996800,65996800,4921,1640,3281,1640,0,1,1642,898135,0.898135
2040,1800,1540,2772000,2,16326,4083,1,76684800,76684800,6121,2040,4081,2040,0,1,2042,913724,0.913724
2440,1800,1540,2772000,2,19526,4883,1,87372800,87372800,7321,2440,4881,2440,0,1,2442,390489,0.390489
2840,1800,1540,2772000,2,22726,5683,1,98060800,98060800,8521,2840,5681,2840,0,1,2842,173701,0.173701
3240,1800,1540,2772000,2,25926,6483,1,108748800,108748800,9721,3240,6481,3240,0,1,3242,828491,0.828491
3640,1800,1540,2772000,2,29126,7283,1,119436800,119436800,10921,3640,7281,3640,0,1,3642,1283767,1.283767
4040,1800,1540,2772000,2,32326,8083,1,130124800,130124800,12121,4040,8081,4040,0,1,4042,870408,0.870408
4440,1800,1540,2772000,2,35526,8883,1,140812800,140812800,13321,4440,8881,4440,0,1,4442,2195119,2.195119
4840,1800,1540,2772000,2,38726,9683,1,151500800,151500800,14521,4840,9681,4840,0,1,4842,933946,0.933946
5240,1800,1540,2772000,2,41926,10483,1,162188800,162188800,15721,5240,10481,5240,0,1,5242,2419929,2.419929
5640,1800,1540,2772000,2,45126,11283,1,172876800,172876800,16921,5640,11281,5640,0,1,5642,16854,0.016854
6040,1800,1540,2772000,2,48326,12083,1,183564800,183564800,18121,6040,12081,6040,0,1,6042,70934,0.070934
6440,1800,1540,2772000,2,51526,12883,1,194252800,194252800,19321,6440,12881,6440,0,1,6442,470567,0.470567
6840,1800,1540,2772000,2,54726,13683,1,204940800,204940800,20521,6840,13681,6840,0,1,6842,3717745,3.717745
44,5003,555,2776665,2,358,91,1,24169736,24169736,133,44,89,44,0,1,46,51326,0.051326
544,5003,555,2776665,2,4358,1091,1,46401736,46401736,1633,544,1089,544,0,1,546,306026,0.306026
1044,5003,555,2776665,2,8358,2091,1,68633736,68633736,3133,1044,2089,1044,0,1,1046,572252,0.572252
1544,5003,555,2776665,2,12358,3091,1,90865736,90865736,4633,1544,3089,1544,0,1,1546,837549,0.837549
2044,5003,555,2776665,2,16358,4091,1,113097736,113097736,6133,2044,4089,2044,0,1,2046,818753,0.818753
2544,5003,555,2776665,2,20358,5091,1,135329736,135329736,7633,2544,5089,2544,0,1,2546,117388,0.117388
3044,5003,555,2776665,2,24358,6091,1,157561736,157561736,9133,3044,6089,3044,0,1,3046,1647601,1.647601
3544,5003,555,2776665,2,28358,7091,1,179793736,179793736,10633,3544,7089,3544,0,1,3546,1933774,1.933774
4044,5003,555,2776665,2,32358,8091,1,202025736,202025736,12133,4044,8089,4044,0,1,4046,1674252,1.674252
4544,5003,555,2776665,2,36358,9091,1,224257736,224257736,13633,4544,9089,4544,0,1,4546,2434587,2.434587
5044,5003,555,2776665,2,40358,10091,1,246489736,246489736,15133,5044,10089,5044,0,1,5046,2723717,2.723717
5544,5003,555,2776665,2,44358,11091,1,268721736,268721736,16633,5544,11089,5544,0,1,5546,2973170,2.97317
6044,5003,555,2776665,2,48358,12091,1,290953736,290953736,18133,6044,12089,6044,0,1,6046,3234090,3.23409
6544,5003,555,2776665,2,52358,13091,1,313185736,313185736,19633,6544,13089,6544,0,1,6546,3543598,3.543598
7044,5003,555,2776665,2,56358,14091,1,335417736,335417736,21133,7044,14089,7044,0,1,7046,3763953,3.763953
40,1300,2140,2782000,2,326,83,1,23356800,23356800,121,40,81,40,0,1,42,53631,0.053631
440,1300,2140,2782000,2,3526,883,1,34364800,34364800,1321,440,881,440,0,1,442,259657,0.259657
840,1300,2140,2782000,2,6726,1683,1,45372800,45372800,2521,840,1681,840,0,1,842,474699,0.474699
1240,1300,2140,2782000,2,9926,2483,1,56380800,56380800,3721,1240,2481,1240,0,1,1242,688047,0.688047
1640,1300,2140,2782000,2,13126,3283,1,67388800,67388800,4921,1640,3281,1640,0,1,1642,590860,0.59086
2040,1300,2140,2782000,2,16326,4083,1,78396800,78396800,6121,2040,4081,2040,0,1,2042,235998,0.235998
2440,1300,2140,2782000,2,19526,4883,1,89404800,89404800,7321,2440,4881,2440,0,1,2442,70729,0.070729
2840,1300,2140,2782000,2,22726,5683,1,100412800,100412800,8521,2840,5681,2840,0,1,2842,152927,0.152927
3240,1300,2140,2782000,2,25926,6483,1,111420800,111420800,9721,3240,6481,3240,0,1,3242,1767307,1.767307
3640,1300,2140,2782000,2,29126,7283,1,122428800,122428800,10921,3640,7281,3640,0,1,3642,62406,0.062406
4040,1300,2140,2782000,2,32326,8083,1,133436800,133436800,12121,4040,8081,4040,0,1,4042,567231,0.567231
4440,1300,2140,2782000,2,35526,8883,1,144444800,144444800,13321,4440,8881,4440,0,1,4442,1456935,1.456935
4840,1300,2140,2782000,2,38726,9683,1,155452800,155452800,14521,4840,9681,4840,0,1,4842,309604,0.309604
5240,1300,2140,2782000,2,41926,10483,1,166460800,166460800,15721,5240,10481,5240,0,1,5242,2353992,2.353992
5640,1300,2140,2782000,2,45126,11283,1,177468800,177468800,16921,5640,11281,5640,0,1,5642,2177012,2.177012
6040,1300,2140,2782000,2,48326,12083,1,188476800,188476800,18121,6040,12081,6040,0,1,6042,3270129,3.270129
6440,1300,2140,2782000,2,51526,12883,1,199484800,199484800,19321,6440,12881,6440,0,1,6442,937758,0.937758
6840,1300,2140,2782000,2,54726,13683,1,210492800,210492800,20521,6840,13681,6840,0,1,6842,1504596,1.504596
55,1805,1565,2824825,2,446,113,1,24081400,24081400,166,55,111,55,0,1,57,59962,0.059962
455,1805,1565,2824825,2,3646,913,1,34865400,34865400,1366,455,911,455,0,1,457,276056,0.276056
855,1805,1565,2824825,2,6846,1713,1,45649400,45649400,2566,855,1711,855,0,1,857,493940,0.49394
1255,1805,1565,2824825,2,10046,2513,1,56433400,56433400,3766,1255,2511,1255,0,1,1257,711438,0.711438
1655,1805,1565,2824825,2,13246,3313,1,67217400,67217400,4966,1655,3311,1655,0,1,1657,548295,0.548295
2055,1805,1565,2824825,2,16446,4113,1,78001400,78001400,6166,2055,4111,2055,0,1,2057,1146088,1.146088
2455,1805,1565,2824825,2,19646,4913,1,88785400,88785400,7366,2455,4911,2455,0,1,2457,1064719,1.064719
2855,1805,1565,2824825,2,22846,5713,1,99569400,99569400,8566,2855,5711,2855,0,1,2857,43946,0.043946
3255,1805,1565,2824825,2,26046,6513,1,110353400,110353400,9766,3255,6511,3255,0,1,3257,3989,0.003989
3655,1805,1565,2824825,2,29246,7313,1,121137400,121137400,10966,3655,7311,3655,0,1,3657,465934,0.465934
4055,1805,1565,2824825,2,32446,8113,1,131921400,131921400,12166,4055,8111,4055,0,1,4057,809858,0.809858
4455,1805,1565,2824825,2,35646,8913,1,142705400,142705400,13366,4455,8911,4455,0,1,4457,227814,0.227814
4855,1805,1565,2824825,2,38846,9713,1,153489400,153489400,14566,4855,9711,4855,0,1,4857,1687146,1.687146
5255,1805,1565,2824825,2,42046,10513,1,164273400,164273400,15766,5255,10511,5255,0,1,5257,412833,0.412833
5655,1805,1565,2824825,2,45246,11313,1,175057400,175057400,16966,5655,11311,5655,0,1,5657,2187145,2.187145
6055,1805,1565,2824825,2,48446,12113,1,185841400,185841400,18166,6055,12111,6055,0,1,6057,810493,0.810493
6455,1805,1565,2824825,2,51646,12913,1,196625400,196625400,19366,6455,12911,6455,0,1,6457,588914,0.588914
6855,1805,1565,2824825,2,54846,13713,1,207409400,207409400,20566,6855,13711,6855,0,1,6857,3104348,3.104348
55,1305,2165,2825325,2,446,113,1,24129400,24129400,166,55,111,55,0,1,57,57768,0.057768
455,1305,2165,2825325,2,3646,913,1,35233400,35233400,1366,455,911,455,0,1,457,272696,0.272696
855,1305,2165,2825325,2,6846,1713,1,46337400,46337400,2566,855,1711,855,0,1,857,17922,0.017922
1255,1305,2165,2825325,2,10046,2513,1,57441400,57441400,3766,1255,2511,1255,0,1,1257,709613,0.709613
1655,1305,2165,2825325,2,13246,3313,1,68545400,68545400,4966,1655,3311,1655,0,1,1657,940181,0.940181
2055,1305,2165,2825325,2,16446,4113,1,79649400,79649400,6166,2055,4111,2055,0,1,2057,1150092,1.150092
2455,1305,2165,2825325,2,19646,4913,1,90753400,90753400,7366,2455,4911,2455,0,1,2457,227740,0.22774
2855,1305,2165,2825325,2,22846,5713,1,101857400,101857400,8566,2855,5711,2855,0,1,2857,1319234,1.319234
3255,1305,2165,2825325,2,26046,6513,1,112961400,112961400,9766,3255,6511,3255,0,1,3257,65132,0.065132
3655,1305,2165,2825325,2,29246,7313,1,124065400,124065400,10966,3655,7311,3655,0,1,3657,174157,0.174157
4055,1305,2165,2825325,2,32446,8113,1,135169400,135169400,12166,4055,8111,4055,0,1,4057,339955,0.339955
4455,1305,2165,2825325,2,35646,8913,1,146273400,146273400,13366,4455,8911,4455,0,1,4457,2472990,2.47299
4855,1305,2165,2825325,2,38846,9713,1,157377400,157377400,14566,4855,9711,4855,0,1,4857,569811,0.569811
5255,1305,2165,2825325,2,42046,10513,1,168481400,168481400,15766,5255,10511,5255,0,1,5257,2922158,2.922158
5655,1305,2165,2825325,2,45246,11313,1,179585400,179585400,16966,5655,11311,5655,0,1,5657,940419,0.940419
6055,1305,2165,2825325,2,48446,12113,1,190689400,190689400,18166,6055,12111,6055,0,1,6057,122358,0.122358
6455,1305,2165,2825325,2,51646,12913,1,201793400,201793400,19366,6455,12911,6455,0,1,6457,1475275,1.475275
6855,1305,2165,2825325,2,54846,13713,1,212897400,212897400,20566,6855,13711,6855,0,1,6857,138762,0.138762
40,550,5140,2827000,2,326,83,1,24436800,24436800,121,40,81,40,0,1,42,53136,0.053136
440,550,5140,2827000,2,3526,883,1,42644800,42644800,1321,440,881,440,0,1,442,54311,0.054311
840,550,5140,2827000,2,6726,1683,1,60852800,60852800,2521,840,1681,840,0,1,842,472786,0.472786
1240,550,5140,2827000,2,9926,2483,1,79060800,79060800,3721,1240,2481,1240,0,1,1242,335284,0.335284
1640,550,5140,2827000,2,13126,3283,1,97268800,97268800,4921,1640,3281,1640,0,1,1642,898574,0.898574
2040,550,5140,2827000,2,16326,4083,1,115476800,115476800,6121,2040,4081,2040,0,1,2042,1114799,1.114799
2440,550,5140,2827000,2,19526,4883,1,133684800,133684800,7321,2440,4881,2440,0,1,2442,127864,0.127864
2840,550,5140,2827000,2,22726,5683,1,151892800,151892800,8521,2840,5681,2840,0,1,2842,1544411,1.544411
3240,550,5140,2827000,2,25926,6483,1,170100800,170100800,9721,3240,6481,3240,0,1,3242,747270,0.74727
3640,550,5140,2827000,2,29126,7283,1,188308800,188308800,10921,3640,7281,3640,0,1,3642,343737,0.343737
4040,550,5140,2827000,2,32326,8083,1,206516800,206516800,12121,4040,8081,4040,0,1,4042,1754107,1.754107
4440,550,5140,2827000,2,35526,8883,1,224724800,224724800,13321,4440,8881,4440,0,1,4442,630562,0.630562
4840,550,5140,2827000,2,38726,9683,1,242932800,242932800,14521,4840,9681,4840,0,1,4842,588528,0.588528
5240,550,5140,2827000,2,41926,10483,1,261140800,261140800,15721,5240,10481,5240,0,1,5242,406164,0.406164
5640,550,5140,2827000,2,45126,11283,1,279348800,279348800,16921,5640,11281,5640,0,1,5642,1256383,1.256383
6040,550,5140,2827000,2,48326,12083,1,297556800,297556800,18121,6040,12081,6040,0,1,6042,384226,0.384226
6440,550,5140,2827000,2,51526,12883,1,315764800,315764800,19321,6440,12881,6440,0,1,6442,2041309,2.041309
6840,550,5140,2827000,2,54726,13683,1,333972800,333972800,20521,6840,13681,6840,0,1,6842,1545566,1.545566
40,2300,1240,2852000,2,326,83,1,23948800,23948800,121,40,81,40,0,1,42,53229,0.053229
440,2300,1240,2852000,2,3526,883,1,35276800,35276800,1321,440,881,440,0,1,442,15586,0.015586
840,2300,1240,2852000,2,6726,1683,1,46604800,46604800,2521,840,1681,840,0,1,842,471850,0.47185
1240,2300,1240,2852000,2,9926,2483,1,57932800,57932800,3721,1240,2481,1240,0,1,1242,679995,0.679995
1640,2300,1240,2852000,2,13126,3283,1,69260800,69260800,4921,1640,3281,1640,0,1,1642,895138,0.895138
2040,2300,1240,2852000,2,16326,4083,1,80588800,80588800,6121,2040,4081,2040,0,1,2042,1105549,1.105549
2440,2300,1240,2852000,2,19526,4883,1,91916800,91916800,7321,2440,4881,2440,0,1,2442,1325342,1.325342
2840,2300,1240,2852000,2,22726,5683,1,103244800,103244800,8521,2840,5681,2840,0,1,2842,1536152,1.536152
40,1550,1840,2852000,2,326,83,1,23900800,23900800,121,40,81,40,0,1,42,53404,0.053404
440,1550,1840,2852000,2,3526,883,1,34748800,34748800,1321,440,881,440,0,1,442,261674,0.261674
840,1550,1840,2852000,2,6726,1683,1,45596800,45596800,2521,840,1681,840,0,1,842,474458,0.474458
1240,1550,1840,2852000,2,9926,2483,1,56444800,56444800,3721,1240,2481,1240,0,1,1242,688571,0.688571
3240,2300,1240,2852000,2,25926,6483,1,114572800,114572800,9721,3240,6481,3240,0,1,3242,615577,0.615577
1640,1550,1840,2852000,2,13126,3283,1,67292800,67292800,4921,1640,3281,1640,0,1,1642,683981,0.683981
2040,1550,1840,2852000,2,16326,4083,1,78140800,78140800,6121,2040,4081,2040,0,1,2042,1112094,1.112094
2440,1550,1840,2852000,2,19526,4883,1,88988800,88988800,7321,2440,4881,2440,0,1,2442,1329896,1.329896
3640,2300,1240,2852000,2,29126,7283,1,125900800,125900800,10921,3640,7281,3640,0,1,3642,433678,0.433678
2840,1550,1840,2852000,2,22726,5683,1,99836800,99836800,8521,2840,5681,2840,0,1,2842,1548371,1.548371
3240,1550,1840,2852000,2,25926,6483,1,110684800,110684800,9721,3240,6481,3240,0,1,3242,1764512,1.764512
4040,2300,1240,2852000,2,32326,8083,1,137228800,137228800,12121,4040,8081,4040,0,1,4042,914774,0.914774
3640,1550,1840,2852000,2,29126,7283,1,121532800,121532800,10921,3640,7281,3640,0,1,3642,1982603,1.982603
4440,2300,1240,2852000,2,35526,8883,1,148556800,148556800,13321,4440,8881,4440,0,1,4442,2384924,2.384924
4040,1550,1840,2852000,2,32326,8083,1,132380800,132380800,12121,4040,8081,4040,0,1,4042,2193757,2.193757
4440,1550,1840,2852000,2,35526,8883,1,143228800,143228800,13321,4440,8881,4440,0,1,4442,2431837,2.431837
4840,2300,1240,2852000,2,38726,9683,1,159884800,159884800,14521,4840,9681,4840,0,1,4842,2603834,2.603834
4840,1550,1840,2852000,2,38726,9683,1,154076800,154076800,14521,4840,9681,4840,0,1,4842,617447,0.617447
5240,2300,1240,2852000,2,41926,10483,1,171212800,171212800,15721,5240,10481,5240,0,1,5242,230246,0.230246
5240,1550,1840,2852000,2,41926,10483,1,164924800,164924800,15721,5240,10481,5240,0,1,5242,82780,0.08278
5640,1550,1840,2852000,2,45126,11283,1,175772800,175772800,16921,5640,11281,5640,0,1,5642,420741,0.420741
5640,2300,1240,2852000,2,45126,11283,1,182540800,182540800,16921,5640,11281,5640,0,1,5642,352302,0.352302
6040,1550,1840,2852000,2,48326,12083,1,186620800,186620800,18121,6040,12081,6040,0,1,6042,1314317,1.314317
6040,2300,1240,2852000,2,48326,12083,1,193868800,193868800,18121,6040,12081,6040,0,1,6042,1307019,1.307019
6440,1550,1840,2852000,2,51526,12883,1,197468800,197468800,19321,6440,12881,6440,0,1,6442,538908,0.538908
6840,1550,1840,2852000,2,54726,13683,1,208316800,208316800,20521,6840,13681,6840,0,1,6842,1672512,1.672512
6440,2300,1240,2852000,2,51526,12883,1,205196800,205196800,19321,6440,12881,6440,0,1,6442,1713711,1.713711
6840,2300,1240,2852000,2,54726,13683,1,216524800,216524800,20521,6840,13681,6840,0,1,6842,1373791,1.373791
55,4305,665,2862825,2,446,113,1,25089400,25089400,166,55,111,55,0,1,57,58682,0.058682
455,4305,665,2862825,2,3646,913,1,40993400,40993400,1366,455,911,455,0,1,457,39480,0.03948
855,4305,665,2862825,2,6846,1713,1,56897400,56897400,2566,855,1711,855,0,1,857,200918,0.200918
1255,4305,665,2862825,2,10046,2513,1,72801400,72801400,3766,1255,2511,1255,0,1,1257,160691,0.160691
1655,4305,665,2862825,2,13246,3313,1,88705400,88705400,4966,1655,3311,1655,0,1,1657,924030,0.92403
2055,4305,665,2862825,2,16446,4113,1,104609400,104609400,6166,2055,4111,2055,0,1,2057,560585,0.560585
2455,4305,665,2862825,2,19646,4913,1,120513400,120513400,7366,2455,4911,2455,0,1,2457,246751,0.246751
2855,4305,665,2862825,2,22846,5713,1,136417400,136417400,8566,2855,5711,2855,0,1,2857,494668,0.494668
3255,4305,665,2862825,2,26046,6513,1,152321400,152321400,9766,3255,6511,3255,0,1,3257,249289,0.249289
3655,4305,665,2862825,2,29246,7313,1,168225400,168225400,10966,3655,7311,3655,0,1,3657,1906426,1.906426
4055,4305,665,2862825,2,32446,8113,1,184129400,184129400,12166,4055,8111,4055,0,1,4057,33496,0.033496
4455,4305,665,2862825,2,35646,8913,1,200033400,200033400,13366,4455,8911,4455,0,1,4457,261167,0.261167
4855,4305,665,2862825,2,38846,9713,1,215937400,215937400,14566,4855,9711,4855,0,1,4857,92193,0.092193
5255,4305,665,2862825,2,42046,10513,1,231841400,231841400,15766,5255,10511,5255,0,1,5257,2692651,2.692651
5655,4305,665,2862825,2,45246,11313,1,247745400,247745400,16966,5655,11311,5655,0,1,5657,1790246,1.790246
6055,4305,665,2862825,2,48446,12113,1,263649400,263649400,18166,6055,12111,6055,0,1,6057,14338,0.014338
6455,4305,665,2862825,2,51646,12913,1,279553400,279553400,19366,6455,12911,6455,0,1,6457,2352335,2.352335
6855,4305,665,2862825,2,54846,13713,1,295457400,295457400,20566,6855,13711,6855,0,1,6857,3505867,3.505867
55,555,5165,2866575,2,446,113,1,25449400,25449400,166,55,111,55,0,1,57,60292,0.060292
455,555,5165,2866575,2,3646,913,1,43753400,43753400,1366,455,911,455,0,1,457,274924,0.274924
855,555,5165,2866575,2,6846,1713,1,62057400,62057400,2566,855,1711,855,0,1,857,96622,0.096622
1255,555,5165,2866575,2,10046,2513,1,80361400,80361400,3766,1255,2511,1255,0,1,1257,600938,0.600938
1655,555,5165,2866575,2,13246,3313,1,98665400,98665400,4966,1655,3311,1655,0,1,1657,536033,0.536033
2055,555,5165,2866575,2,16446,4113,1,116969400,116969400,6166,2055,4111,2055,0,1,2057,121836,0.121836
2455,555,5165,2866575,2,19646,4913,1,135273400,135273400,7366,2455,4911,2455,0,1,2457,1131812,1.131812
2855,555,5165,2866575,2,22846,5713,1,153577400,153577400,8566,2855,5711,2855,0,1,2857,436343,0.436343
3255,555,5165,2866575,2,26046,6513,1,171881400,171881400,9766,3255,6511,3255,0,1,3257,339557,0.339557
3655,555,5165,2866575,2,29246,7313,1,190185400,190185400,10966,3655,7311,3655,0,1,3657,934317,0.934317
4055,555,5165,2866575,2,32446,8113,1,208489400,208489400,12166,4055,8111,4055,0,1,4057,835324,0.835324
4455,555,5165,2866575,2,35646,8913,1,226793400,226793400,13366,4455,8911,4455,0,1,4457,359342,0.359342
4855,555,5165,2866575,2,38846,9713,1,245097400,245097400,14566,4855,9711,4855,0,1,4857,63178,0.063178
5255,555,5165,2866575,2,42046,10513,1,263401400,263401400,15766,5255,10511,5255,0,1,5257,678401,0.678401
5655,555,5165,2866575,2,45246,11313,1,281705400,281705400,16966,5655,11311,5655,0,1,5657,708326,0.708326
6055,555,5165,2866575,2,48446,12113,1,300009400,300009400,18166,6055,12111,6055,0,1,6057,1438006,1.438006
6455,555,5165,2866575,2,51646,12913,1,318313400,318313400,19366,6455,12911,6455,0,1,6457,2702249,2.702249
6855,555,5165,2866575,2,54846,13713,1,336617400,336617400,20566,6855,13711,6855,0,1,6857,2365938,2.365938
40,3050,940,2867000,2,326,83,1,24212800,24212800,121,40,81,40,0,1,42,1114,0.001114
440,3050,940,2867000,2,3526,883,1,36980800,36980800,1321,440,881,440,0,1,442,8650,0.00865
840,3050,940,2867000,2,6726,1683,1,49748800,49748800,2521,840,1681,840,0,1,842,67293,0.067293
1240,3050,940,2867000,2,9926,2483,1,62516800,62516800,3721,1240,2481,1240,0,1,1242,209223,0.209223
1640,3050,940,2867000,2,13126,3283,1,75284800,75284800,4921,1640,3281,1640,0,1,1642,866986,0.866986
2040,3050,940,2867000,2,16326,4083,1,88052800,88052800,6121,2040,4081,2040,0,1,2042,37022,0.037022
2440,3050,940,2867000,2,19526,4883,1,100820800,100820800,7321,2440,4881,2440,0,1,2442,611890,0.61189
2840,3050,940,2867000,2,22726,5683,1,113588800,113588800,8521,2840,5681,2840,0,1,2842,705458,0.705458
3240,3050,940,2867000,2,25926,6483,1,126356800,126356800,9721,3240,6481,3240,0,1,3242,358366,0.358366
3640,3050,940,2867000,2,29126,7283,1,139124800,139124800,10921,3640,7281,3640,0,1,3642,46421,0.046421
4040,3050,940,2867000,2,32326,8083,1,151892800,151892800,12121,4040,8081,4040,0,1,4042,1393742,1.393742
4440,3050,940,2867000,2,35526,8883,1,164660800,164660800,13321,4440,8881,4440,0,1,4442,416002,0.416002
4840,3050,940,2867000,2,38726,9683,1,177428800,177428800,14521,4840,9681,4840,0,1,4842,660504,0.660504
5240,3050,940,2867000,2,41926,10483,1,190196800,190196800,15721,5240,10481,5240,0,1,5242,2941481,2.941481
5640,3050,940,2867000,2,45126,11283,1,202964800,202964800,16921,5640,11281,5640,0,1,5642,3136034,3.136034
6040,3050,940,2867000,2,48326,12083,1,215732800,215732800,18121,6040,12081,6040,0,1,6042,398100,0.3981
6440,3050,940,2867000,2,51526,12883,1,228500800,228500800,19321,6440,12881,6440,0,1,6442,373920,0.37392
6840,3050,940,2867000,2,54726,13683,1,241268800,241268800,20521,6840,13681,6840,0,1,6842,247566,0.247566
40,1050,2740,2877000,2,326,83,1,24228800,24228800,121,40,81,40,0,1,42,8361,0.008361
440,1050,2740,2877000,2,3526,883,1,36356800,36356800,1321,440,881,440,0,1,442,23367,0.023367
840,1050,2740,2877000,2,6726,1683,1,48484800,48484800,2521,840,1681,840,0,1,842,77530,0.07753
1240,1050,2740,2877000,2,9926,2483,1,60612800,60612800,3721,1240,2481,1240,0,1,1242,59701,0.059701
1640,1050,2740,2877000,2,13126,3283,1,72740800,72740800,4921,1640,3281,1640,0,1,1642,212433,0.212433
2040,1050,2740,2877000,2,16326,4083,1,84868800,84868800,6121,2040,4081,2040,0,1,2042,231174,0.231174
2440,1050,2740,2877000,2,19526,4883,1,96996800,96996800,7321,2440,4881,2440,0,1,2442,42580,0.04258
2840,1050,2740,2877000,2,22726,5683,1,109124800,109124800,8521,2840,5681,2840,0,1,2842,12916,0.012916
3240,1050,2740,2877000,2,25926,6483,1,121252800,121252800,9721,3240,6481,3240,0,1,3242,308009,0.308009
3640,1050,2740,2877000,2,29126,7283,1,133380800,133380800,10921,3640,7281,3640,0,1,3642,640740,0.64074
4040,1050,2740,2877000,2,32326,8083,1,145508800,145508800,12121,4040,8081,4040,0,1,4042,528946,0.528946
4440,1050,2740,2877000,2,35526,8883,1,157636800,157636800,13321,4440,8881,4440,0,1,4442,596222,0.596222
4840,1050,2740,2877000,2,38726,9683,1,169764800,169764800,14521,4840,9681,4840,0,1,4842,702954,0.702954
5240,1050,2740,2877000,2,41926,10483,1,181892800,181892800,15721,5240,10481,5240,0,1,5242,949236,0.949236
5640,1050,2740,2877000,2,45126,11283,1,194020800,194020800,16921,5640,11281,5640,0,1,5642,1470578,1.470578
6040,1050,2740,2877000,2,48326,12083,1,206148800,206148800,18121,6040,12081,6040,0,1,6042,227015,0.227015
6440,1050,2740,2877000,2,51526,12883,1,218276800,218276800,19321,6440,12881,6440,0,1,6442,145808,0.145808
6840,1050,2740,2877000,2,54726,13683,1,230404800,230404800,20521,6840,13681,6840,0,1,6842,529709,0.529709
55,1555,1865,2900075,2,446,113,1,24705400,24705400,166,55,111,55,0,1,57,59691,0.059691
455,1555,1865,2900075,2,3646,913,1,35649400,35649400,1366,455,911,455,0,1,457,280652,0.280652
855,1555,1865,2900075,2,6846,1713,1,46593400,46593400,2566,855,1711,855,0,1,857,504927,0.504927
1255,1555,1865,2900075,2,10046,2513,1,57537400,57537400,3766,1255,2511,1255,0,1,1257,299281,0.299281
1655,1555,1865,2900075,2,13246,3313,1,68481400,68481400,4966,1655,3311,1655,0,1,1657,956292,0.956292
2055,1555,1865,2900075,2,16446,4113,1,79425400,79425400,6166,2055,4111,2055,0,1,2057,341763,0.341763
2455,1555,1865,2900075,2,19646,4913,1,90369400,90369400,7366,2455,4911,2455,0,1,2457,948326,0.948326
2855,1555,1865,2900075,2,22846,5713,1,101313400,101313400,8566,2855,5711,2855,0,1,2857,1628839,1.628839
3255,1555,1865,2900075,2,26046,6513,1,112257400,112257400,9766,3255,6511,3255,0,1,3257,519050,0.51905
3655,1555,1865,2900075,2,29246,7313,1,123201400,123201400,10966,3655,7311,3655,0,1,3657,2086650,2.08665
4055,1555,1865,2900075,2,32446,8113,1,134145400,134145400,12166,4055,8111,4055,0,1,4057,1795279,1.795279
4455,1555,1865,2900075,2,35646,8913,1,145089400,145089400,13366,4455,8911,4455,0,1,4457,1809642,1.809642
4855,1555,1865,2900075,2,38846,9713,1,156033400,156033400,14566,4855,9711,4855,0,1,4857,29992,0.029992
5255,1555,1865,2900075,2,42046,10513,1,166977400,166977400,15766,5255,10511,5255,0,1,5257,2994620,2.99462
5655,1555,1865,2900075,2,45246,11313,1,177921400,177921400,16966,5655,11311,5655,0,1,5657,2848114,2.848114
6055,1555,1865,2900075,2,48446,12113,1,188865400,188865400,18166,6055,12111,6055,0,1,6057,3447061,3.447061
6455,1555,1865,2900075,2,51646,12913,1,199809400,199809400,19366,6455,12911,6455,0,1,6457,1323328,1.323328
6855,1555,1865,2900075,2,54846,13713,1,210753400,210753400,20566,6855,13711,6855,0,1,6857,477235,0.477235
35,1140,2545,2901300,2,286,73,1,24242200,24242200,106,35,71,35,0,1,37,67752,0.067752
535,1140,2545,2901300,2,4286,1073,1,38982200,38982200,1606,535,1071,535,0,1,537,318671,0.318671
1035,1140,2545,2901300,2,8286,2073,1,53722200,53722200,3106,1035,2071,1035,0,1,1037,586293,0.586293
1535,1140,2545,2901300,2,12286,3073,1,68462200,68462200,4606,1535,3071,1535,0,1,1537,859568,0.859568
2035,1140,2545,2901300,2,16286,4073,1,83202200,83202200,6106,2035,4071,2035,0,1,2037,1132970,1.13297
2535,1140,2545,2901300,2,20286,5073,1,97942200,97942200,7606,2535,5071,2535,0,1,2537,1408662,1.408662
3035,1140,2545,2901300,2,24286,6073,1,112682200,112682200,9106,3035,6071,3035,0,1,3037,1688182,1.688182
3535,1140,2545,2901300,2,28286,7073,1,127422200,127422200,10606,3535,7071,3535,0,1,3537,1959049,1.959049
4035,1140,2545,2901300,2,32286,8073,1,142162200,142162200,12106,4035,8071,4035,0,1,4037,2234484,2.234484
39,1143,2541,2904363,2,318,81,1,24384312,24384312,118,39,79,39,0,1,41,10081,0.010081
539,1143,2541,2904363,2,4318,1081,1,39120312,39120312,1618,539,1079,539,0,1,541,3800,0.0038
1039,1143,2541,2904363,2,8318,2081,1,53856312,53856312,3118,1039,2079,1039,0,1,1041,107189,0.107189
1539,1143,2541,2904363,2,12318,3081,1,68592312,68592312,4618,1539,3079,1539,0,1,1541,12909,0.012909
2039,1143,2541,2904363,2,16318,4081,1,83328312,83328312,6118,2039,4079,2039,0,1,2041,72081,0.072081
2539,1143,2541,2904363,2,20318,5081,1,98064312,98064312,7618,2539,5079,2539,0,1,2541,713251,0.713251
3039,1143,2541,2904363,2,24318,6081,1,112800312,112800312,9118,3039,6079,3039,0,1,3041,209118,0.209118
3539,1143,2541,2904363,2,28318,7081,1,127536312,127536312,10618,3539,7079,3539,0,1,3541,679798,0.679798
4039,1143,2541,2904363,2,32318,8081,1,142272312,142272312,12118,4039,8079,4039,0,1,4041,371272,0.371272
4539,1143,2541,2904363,2,36318,9081,1,157008312,157008312,13618,4539,9079,4539,0,1,4541,723828,0.723828
5039,1143,2541,2904363,2,40318,10081,1,171744312,171744312,15118,5039,10079,5039,0,1,5041,2057765,2.057765
5539,1143,2541,2904363,2,44318,11081,1,186480312,186480312,16618,5539,11079,5539,0,1,5541,985995,0.985995
6039,1143,2541,2904363,2,48318,12081,1,201216312,201216312,18118,6039,12079,6039,0,1,6041,2020796,2.020796
6539,1143,2541,2904363,2,52318,13081,1,215952312,215952312,19618,6539,13079,6539,0,1,6541,1455753,1.455753
7039,1143,2541,2904363,2,56318,14081,1,230688312,230688312,21118,7039,14079,7039,0,1,7041,1510880,1.51088
39,2793,1041,2907513,2,318,81,1,24456312,24456312,118,39,79,39,0,1,41,53185,0.053185
539,2793,1041,2907513,2,4318,1081,1,39792312,39792312,1618,539,1079,539,0,1,541,317832,0.317832
1039,2793,1041,2907513,2,8318,2081,1,55128312,55128312,3118,1039,2079,1039,0,1,1041,595637,0.595637
1539,2793,1041,2907513,2,12318,3081,1,70464312,70464312,4618,1539,3079,1539,0,1,1541,508578,0.508578
2039,2793,1041,2907513,2,16318,4081,1,85800312,85800312,6118,2039,4079,2039,0,1,2041,1149790,1.14979
2539,2793,1041,2907513,2,20318,5081,1,101136312,101136312,7618,2539,5079,2539,0,1,2541,1223749,1.223749
3039,2793,1041,2907513,2,24318,6081,1,116472312,116472312,9118,3039,6079,3039,0,1,3041,1704778,1.704778
3539,2793,1041,2907513,2,28318,7081,1,131808312,131808312,10618,3539,7079,3539,0,1,3541,25207,0.025207
4039,2793,1041,2907513,2,32318,8081,1,147144312,147144312,12118,4039,8079,4039,0,1,4041,1317912,1.317912
4539,2793,1041,2907513,2,36318,9081,1,162480312,162480312,13618,4539,9079,4539,0,1,4541,1651936,1.651936
5039,2793,1041,2907513,2,40318,10081,1,177816312,177816312,15118,5039,10079,5039,0,1,5041,473376,0.473376
5539,2793,1041,2907513,2,44318,11081,1,193152312,193152312,16618,5539,11079,5539,0,1,5541,1381491,1.381491
6039,2793,1041,2907513,2,48318,12081,1,208488312,208488312,18118,6039,12079,6039,0,1,6041,817339,0.817339
6539,2793,1041,2907513,2,52318,13081,1,223824312,223824312,19618,6539,13079,6539,0,1,6541,3691763,3.691763
7039,2793,1041,2907513,2,56318,14081,1,239160312,239160312,21118,7039,14079,7039,0,1,7041,1251985,1.251985
40,800,3640,2912000,2,326,83,1,24716800,24716800,121,40,81,40,0,1,42,52927,0.052927
440,800,3640,2912000,2,3526,883,1,38924800,38924800,1321,440,881,440,0,1,442,263329,0.263329
840,800,3640,2912000,2,6726,1683,1,53132800,53132800,2521,840,1681,840,0,1,842,479980,0.47998
1240,800,3640,2912000,2,9926,2483,1,67340800,67340800,3721,1240,2481,1240,0,1,1242,697329,0.697329
1640,800,3640,2912000,2,13126,3283,1,81548800,81548800,4921,1640,3281,1640,0,1,1642,579892,0.579892
2040,800,3640,2912000,2,16326,4083,1,95756800,95756800,6121,2040,4081,2040,0,1,2042,104102,0.104102
2440,800,3640,2912000,2,19526,4883,1,109964800,109964800,7321,2440,4881,2440,0,1,2442,931235,0.931235
2840,800,3640,2912000,2,22726,5683,1,124172800,124172800,8521,2840,5681,2840,0,1,2842,1567400,1.5674
3240,800,3640,2912000,2,25926,6483,1,138380800,138380800,9721,3240,6481,3240,0,1,3242,223830,0.22383
3640,800,3640,2912000,2,29126,7283,1,152588800,152588800,10921,3640,7281,3640,0,1,3642,311824,0.311824
4040,800,3640,2912000,2,32326,8083,1,166796800,166796800,12121,4040,8081,4040,0,1,4042,1294306,1.294306
4440,800,3640,2912000,2,35526,8883,1,181004800,181004800,13321,4440,8881,4440,0,1,4442,388368,0.388368
4840,800,3640,2912000,2,38726,9683,1,195212800,195212800,14521,4840,9681,4840,0,1,4842,1469119,1.469119
5240,800,3640,2912000,2,41926,10483,1,209420800,209420800,15721,5240,10481,5240,0,1,5242,224890,0.22489
5640,800,3640,2912000,2,45126,11283,1,223628800,223628800,16921,5640,11281,5640,0,1,5642,58645,0.058645
6040,800,3640,2912000,2,48326,12083,1,237836800,237836800,18121,6040,12081,6040,0,1,6042,1586279,1.586279
6440,800,3640,2912000,2,51526,12883,1,252044800,252044800,19321,6440,12881,6440,0,1,6442,453231,0.453231
6840,800,3640,2912000,2,54726,13683,1,266252800,266252800,20521,6840,13681,6840,0,1,6842,2074486,2.074486
40,4550,640,2912000,2,326,83,1,24956800,24956800,121,40,81,40,0,1,42,52009,0.052009
440,4550,640,2912000,2,3526,883,1,41564800,41564800,1321,440,881,440,0,1,442,254064,0.254064
840,4550,640,2912000,2,6726,1683,1,58172800,58172800,2521,840,1681,840,0,1,842,468776,0.468776
1240,4550,640,2912000,2,9926,2483,1,74780800,74780800,3721,1240,2481,1240,0,1,1242,678203,0.678203
1640,4550,640,2912000,2,13126,3283,1,91388800,91388800,4921,1640,3281,1640,0,1,1642,882840,0.88284
2040,4550,640,2912000,2,16326,4083,1,107996800,107996800,6121,2040,4081,2040,0,1,2042,572020,0.57202
2440,4550,640,2912000,2,19526,4883,1,124604800,124604800,7321,2440,4881,2440,0,1,2442,1305161,1.305161
2840,4550,640,2912000,2,22726,5683,1,141212800,141212800,8521,2840,5681,2840,0,1,2842,1516448,1.516448
3240,4550,640,2912000,2,25926,6483,1,157820800,157820800,9721,3240,6481,3240,0,1,3242,1751745,1.751745
3640,4550,640,2912000,2,29126,7283,1,174428800,174428800,10921,3640,7281,3640,0,1,3642,1941295,1.941295
4040,4550,640,2912000,2,32326,8083,1,191036800,191036800,12121,4040,8081,4040,0,1,4042,2173181,2.173181
4440,4550,640,2912000,2,35526,8883,1,207644800,207644800,13321,4440,8881,4440,0,1,4442,18100,0.0181
4840,4550,640,2912000,2,38726,9683,1,224252800,224252800,14521,4840,9681,4840,0,1,4842,1262265,1.262265
5240,4550,640,2912000,2,41926,10483,1,240860800,240860800,15721,5240,10481,5240,0,1,5242,2813209,2.813209
5640,4550,640,2912000,2,45126,11283,1,257468800,257468800,16921,5640,11281,5640,0,1,5642,789949,0.789949
6040,4550,640,2912000,2,48326,12083,1,274076800,274076800,18121,6040,12081,6040,0,1,6042,700100,0.7001
6440,4550,640,2912000,2,51526,12883,1,290684800,290684800,19321,6440,12881,6440,0,1,6442,1779023,1.779023
6840,4550,640,2912000,2,54726,13683,1,307292800,307292800,20521,6840,13681,6840,0,1,6842,3666909,3.666909
55,2305,1265,2915825,2,446,113,1,24897400,24897400,166,55,111,55,0,1,57,59275,0.059275
455,2305,1265,2915825,2,3646,913,1,36321400,36321400,1366,455,911,455,0,1,457,85456,0.085456
855,2305,1265,2915825,2,6846,1713,1,47745400,47745400,2566,855,1711,855,0,1,857,270055,0.270055
1255,2305,1265,2915825,2,10046,2513,1,59169400,59169400,3766,1255,2511,1255,0,1,1257,706432,0.706432
1655,2305,1265,2915825,2,13246,3313,1,70593400,70593400,4966,1655,3311,1655,0,1,1657,923852,0.923852
2055,2305,1265,2915825,2,16446,4113,1,82017400,82017400,6166,2055,4111,2055,0,1,2057,303793,0.303793
2455,2305,1265,2915825,2,19646,4913,1,93441400,93441400,7366,2455,4911,2455,0,1,2457,1363494,1.363494
2855,2305,1265,2915825,2,22846,5713,1,104865400,104865400,8566,2855,5711,2855,0,1,2857,855969,0.855969
3255,2305,1265,2915825,2,26046,6513,1,116289400,116289400,9766,3255,6511,3255,0,1,3257,654353,0.654353
3655,2305,1265,2915825,2,29246,7313,1,127713400,127713400,10966,3655,7311,3655,0,1,3657,734780,0.73478
4055,2305,1265,2915825,2,32446,8113,1,139137400,139137400,12166,4055,8111,4055,0,1,4057,706066,0.706066
4455,2305,1265,2915825,2,35646,8913,1,150561400,150561400,13366,4455,8911,4455,0,1,4457,109246,0.109246
4855,2305,1265,2915825,2,38846,9713,1,161985400,161985400,14566,4855,9711,4855,0,1,4857,9093,0.009093
5255,2305,1265,2915825,2,42046,10513,1,173409400,173409400,15766,5255,10511,5255,0,1,5257,1365264,1.365264
5655,2305,1265,2915825,2,45246,11313,1,184833400,184833400,16966,5655,11311,5655,0,1,5657,368214,0.368214
6055,2305,1265,2915825,2,48446,12113,1,196257400,196257400,18166,6055,12111,6055,0,1,6057,1365817,1.365817
6455,2305,1265,2915825,2,51646,12913,1,207681400,207681400,19366,6455,12911,6455,0,1,6457,3587886,3.587886
6855,2305,1265,2915825,2,54846,13713,1,219105400,219105400,20566,6855,13711,6855,0,1,6857,303588,0.303588
55,1055,2765,2917075,2,446,113,1,25017400,25017400,166,55,111,55,0,1,57,2758,0.002758
455,1055,2765,2917075,2,3646,913,1,37241400,37241400,1366,455,911,455,0,1,457,9493,0.009493
855,1055,2765,2917075,2,6846,1713,1,49465400,49465400,2566,855,1711,855,0,1,857,98861,0.098861
1255,1055,2765,2917075,2,10046,2513,1,61689400,61689400,3766,1255,2511,1255,0,1,1257,125698,0.125698
1655,1055,2765,2917075,2,13246,3313,1,73913400,73913400,4966,1655,3311,1655,0,1,1657,39357,0.039357
2055,1055,2765,2917075,2,16446,4113,1,86137400,86137400,6166,2055,4111,2055,0,1,2057,150417,0.150417
2455,1055,2765,2917075,2,19646,4913,1,98361400,98361400,7366,2455,4911,2455,0,1,2457,358601,0.358601
2855,1055,2765,2917075,2,22846,5713,1,110585400,110585400,8566,2855,5711,2855,0,1,2857,582770,0.58277
3255,1055,2765,2917075,2,26046,6513,1,122809400,122809400,9766,3255,6511,3255,0,1,3257,69153,0.069153
3655,1055,2765,2917075,2,29246,7313,1,135033400,135033400,10966,3655,7311,3655,0,1,3657,9813,0.009813
4055,1055,2765,2917075,2,32446,8113,1,147257400,147257400,12166,4055,8111,4055,0,1,4057,64356,0.064356
4455,1055,2765,2917075,2,35646,8913,1,159481400,159481400,13366,4455,8911,4455,0,1,4457,312280,0.31228
4855,1055,2765,2917075,2,38846,9713,1,171705400,171705400,14566,4855,9711,4855,0,1,4857,494256,0.494256
5255,1055,2765,2917075,2,42046,10513,1,183929400,183929400,15766,5255,10511,5255,0,1,5257,40063,0.040063
5655,1055,2765,2917075,2,45246,11313,1,196153400,196153400,16966,5655,11311,5655,0,1,5657,160722,0.160722
6055,1055,2765,2917075,2,48446,12113,1,208377400,208377400,18166,6055,12111,6055,0,1,6057,383697,0.383697
6455,1055,2765,2917075,2,51646,12913,1,220601400,220601400,19366,6455,12911,6455,0,1,6457,1337146,1.337146
6855,1055,2765,2917075,2,54846,13713,1,232825400,232825400,20566,6855,13711,6855,0,1,6857,515477,0.515477
44,1153,2555,2945915,2,358,91,1,24872536,24872536,133,44,89,44,0,1,46,3360,0.00336
544,1153,2555,2945915,2,4358,1091,1,39704536,39704536,1633,544,1089,544,0,1,546,2985,0.002985
1044,1153,2555,2945915,2,8358,2091,1,54536536,54536536,3133,1044,2089,1044,0,1,1046,241734,0.241734
1544,1153,2555,2945915,2,12358,3091,1,69368536,69368536,4633,1544,3089,1544,0,1,1546,17404,0.017404
2044,1153,2555,2945915,2,16358,4091,1,84200536,84200536,6133,2044,4089,2044,0,1,2046,137966,0.137966
2544,1153,2555,2945915,2,20358,5091,1,99032536,99032536,7633,2544,5089,2544,0,1,2546,467481,0.467481
3044,1153,2555,2945915,2,24358,6091,1,113864536,113864536,9133,3044,6089,3044,0,1,3046,535522,0.535522
3544,1153,2555,2945915,2,28358,7091,1,128696536,128696536,10633,3544,7089,3544,0,1,3546,698310,0.69831
4044,1153,2555,2945915,2,32358,8091,1,143528536,143528536,12133,4044,8089,4044,0,1,4046,298009,0.298009
4544,1153,2555,2945915,2,36358,9091,1,158360536,158360536,13633,4544,9089,4544,0,1,4546,688996,0.688996
5044,1153,2555,2945915,2,40358,10091,1,173192536,173192536,15133,5044,10089,5044,0,1,5046,1033134,1.033134
5544,1153,2555,2945915,2,44358,11091,1,188024536,188024536,16633,5544,11089,5544,0,1,5546,101705,0.101705
6044,1153,2555,2945915,2,48358,12091,1,202856536,202856536,18133,6044,12089,6044,0,1,6046,1262222,1.262222
6544,1153,2555,2945915,2,52358,13091,1,217688536,217688536,19633,6544,13089,6544,0,1,6546,1366389,1.366389
7044,1153,2555,2945915,2,56358,14091,1,232520536,232520536,21133,7044,14089,7044,0,1,7046,77999,0.077999
55,3055,965,2948075,2,446,113,1,25353400,25353400,166,55,111,55,0,1,57,14456,0.014456
455,3055,965,2948075,2,3646,913,1,38217400,38217400,1366,455,911,455,0,1,457,55565,0.055565
855,3055,965,2948075,2,6846,1713,1,51081400,51081400,2566,855,1711,855,0,1,857,274726,0.274726
1255,3055,965,2948075,2,10046,2513,1,63945400,63945400,3766,1255,2511,1255,0,1,1257,134282,0.134282
1655,3055,965,2948075,2,13246,3313,1,76809400,76809400,4966,1655,3311,1655,0,1,1657,140146,0.140146
2055,3055,965,2948075,2,16446,4113,1,89673400,89673400,6166,2055,4111,2055,0,1,2057,10556,0.010556
2455,3055,965,2948075,2,19646,4913,1,102537400,102537400,7366,2455,4911,2455,0,1,2457,31005,0.031005
2855,3055,965,2948075,2,22846,5713,1,115401400,115401400,8566,2855,5711,2855,0,1,2857,294595,0.294595
3255,3055,965,2948075,2,26046,6513,1,128265400,128265400,9766,3255,6511,3255,0,1,3257,26709,0.026709
3655,3055,965,2948075,2,29246,7313,1,141129400,141129400,10966,3655,7311,3655,0,1,3657,138038,0.138038
4055,3055,965,2948075,2,32446,8113,1,153993400,153993400,12166,4055,8111,4055,0,1,4057,2364310,2.36431
4455,3055,965,2948075,2,35646,8913,1,166857400,166857400,13366,4455,8911,4455,0,1,4457,454968,0.454968
4855,3055,965,2948075,2,38846,9713,1,179721400,179721400,14566,4855,9711,4855,0,1,4857,2034733,2.034733
5255,3055,965,2948075,2,42046,10513,1,192585400,192585400,15766,5255,10511,5255,0,1,5257,45004,0.045004
5655,3055,965,2948075,2,45246,11313,1,205449400,205449400,16966,5655,11311,5655,0,1,5657,1410276,1.410276
6055,3055,965,2948075,2,48446,12113,1,218313400,218313400,18166,6055,12111,6055,0,1,6057,470956,0.470956
6455,3055,965,2948075,2,51646,12913,1,231177400,231177400,19366,6455,12911,6455,0,1,6457,72427,0.072427
6855,3055,965,2948075,2,54846,13713,1,244041400,244041400,20566,6855,13711,6855,0,1,6857,18749,0.018749
55,805,3665,2950325,2,446,113,1,25569400,25569400,166,55,111,55,0,1,57,61881,0.061881
455,805,3665,2950325,2,3646,913,1,39873400,39873400,1366,455,911,455,0,1,457,30676,0.030676
855,805,3665,2950325,2,6846,1713,1,54177400,54177400,2566,855,1711,855,0,1,857,504723,0.504723
1255,805,3665,2950325,2,10046,2513,1,68481400,68481400,3766,1255,2511,1255,0,1,1257,508209,0.508209
1655,805,3665,2950325,2,13246,3313,1,82785400,82785400,4966,1655,3311,1655,0,1,1657,665343,0.665343
2055,805,3665,2950325,2,16446,4113,1,97089400,97089400,6166,2055,4111,2055,0,1,2057,714828,0.714828
2455,805,3665,2950325,2,19646,4913,1,111393400,111393400,7366,2455,4911,2455,0,1,2457,250391,0.250391
2855,805,3665,2950325,2,22846,5713,1,125697400,125697400,8566,2855,5711,2855,0,1,2857,1332916,1.332916
3255,805,3665,2950325,2,26046,6513,1,140001400,140001400,9766,3255,6511,3255,0,1,3257,41198,0.041198
3655,805,3665,2950325,2,29246,7313,1,154305400,154305400,10966,3655,7311,3655,0,1,3657,1461742,1.461742
4055,805,3665,2950325,2,32446,8113,1,168609400,168609400,12166,4055,8111,4055,0,1,4057,59863,0.059863
4455,805,3665,2950325,2,35646,8913,1,182913400,182913400,13366,4455,8911,4455,0,1,4457,1154398,1.154398
4855,805,3665,2950325,2,38846,9713,1,197217400,197217400,14566,4855,9711,4855,0,1,4857,117364,0.117364
5255,805,3665,2950325,2,42046,10513,1,211521400,211521400,15766,5255,10511,5255,0,1,5257,2985538,2.985538
5655,805,3665,2950325,2,45246,11313,1,225825400,225825400,16966,5655,11311,5655,0,1,5657,2254455,2.254455
6055,805,3665,2950325,2,48446,12113,1,240129400,240129400,18166,6055,12111,6055,0,1,6057,455909,0.455909
6455,805,3665,2950325,2,51646,12913,1,254433400,254433400,19366,6455,12911,6455,0,1,6457,407342,0.407342
6855,805,3665,2950325,2,54846,13713,1,268737400,268737400,20566,6855,13711,6855,0,1,6857,942414,0.942414
44,2803,1055,2957165,2,358,91,1,25015336,25015336,133,44,89,44,0,1,46,54921,0.054921
544,2803,1055,2957165,2,4358,1091,1,40447336,40447336,1633,544,1089,544,0,1,546,324678,0.324678
1044,2803,1055,2957165,2,8358,2091,1,55879336,55879336,3133,1044,2089,1044,0,1,1046,601857,0.601857
1544,2803,1055,2957165,2,12358,3091,1,71311336,71311336,4633,1544,3089,1544,0,1,1546,876750,0.87675
2044,2803,1055,2957165,2,16358,4091,1,86743336,86743336,6133,2044,4089,2044,0,1,2046,886697,0.886697
2544,2803,1055,2957165,2,20358,5091,1,102175336,102175336,7633,2544,5089,2544,0,1,2546,472567,0.472567
3044,2803,1055,2957165,2,24358,6091,1,117607336,117607336,9133,3044,6089,3044,0,1,3046,1710607,1.710607
3544,2803,1055,2957165,2,28358,7091,1,133039336,133039336,10633,3544,7089,3544,0,1,3546,1988641,1.988641
4044,2803,1055,2957165,2,32358,8091,1,148471336,148471336,12133,4044,8089,4044,0,1,4046,1282391,1.282391
4544,2803,1055,2957165,2,36358,9091,1,163903336,163903336,13633,4544,9089,4544,0,1,4546,2547742,2.547742
5044,2803,1055,2957165,2,40358,10091,1,179335336,179335336,15133,5044,10089,5044,0,1,5046,2829715,2.829715
5544,2803,1055,2957165,2,44358,11091,1,194767336,194767336,16633,5544,11089,5544,0,1,5546,562451,0.562451
6044,2803,1055,2957165,2,48358,12091,1,210199336,210199336,18133,6044,12089,6044,0,1,6046,1055668,1.055668
6544,2803,1055,2957165,2,52358,13091,1,225631336,225631336,19633,6544,13089,6544,0,1,6546,3672904,3.672904
7044,2803,1055,2957165,2,56358,14091,1,241063336,241063336,21133,7044,14089,7044,0,1,7046,1007854,1.007854
35,590,5045,2976550,2,286,73,1,25390200,25390200,106,35,71,35,0,1,37,35867,0.035867
535,590,5045,2976550,2,4286,1073,1,47930200,47930200,1606,535,1071,535,0,1,537,82943,0.082943
1035,590,5045,2976550,2,8286,2073,1,70470200,70470200,3106,1035,2071,1035,0,1,1037,123886,0.123886
1535,590,5045,2976550,2,12286,3073,1,93010200,93010200,4606,1535,3071,1535,0,1,1537,45794,0.045794
2035,590,5045,2976550,2,16286,4073,1,115550200,115550200,6106,2035,4071,2035,0,1,2037,309502,0.309502
2535,590,5045,2976550,2,20286,5073,1,138090200,138090200,7606,2535,5071,2535,0,1,2537,1508707,1.508707
3035,590,5045,2976550,2,24286,6073,1,160630200,160630200,9106,3035,6071,3035,0,1,3037,1803962,1.803962
3535,590,5045,2976550,2,28286,7073,1,183170200,183170200,10606,3535,7071,3535,0,1,3537,2113434,2.113434
4035,590,5045,2976550,2,32286,8073,1,205710200,205710200,12106,4035,8071,4035,0,1,4037,2452332,2.452332
4535,590,5045,2976550,2,36286,9073,1,228250200,228250200,13606,4535,9071,4535,0,1,4537,2718369,2.718369
5035,590,5045,2976550,2,40286,10073,1,250790200,250790200,15106,5035,10071,5035,0,1,5037,3032956,3.032956
5535,590,5045,2976550,2,44286,11073,1,273330200,273330200,16606,5535,11071,5535,0,1,5537,3318611,3.318611
6035,590,5045,2976550,2,48286,12073,1,295870200,295870200,18106,6035,12071,6035,0,1,6037,3633094,3.633094
6535,590,5045,2976550,2,52286,13073,1,318410200,318410200,19606,6535,13071,6535,0,1,6537,3971890,3.97189
7035,590,5045,2976550,2,56286,14073,1,340950200,340950200,21106,7035,14071,7035,0,1,7037,4224675,4.224675
39,593,5041,2989313,2,318,81,1,25672312,25672312,118,39,79,39,0,1,41,57736,0.057736
539,593,5041,2989313,2,4318,1081,1,48208312,48208312,1618,539,1079,539,0,1,541,92366,0.092366
1039,593,5041,2989313,2,8318,2081,1,70744312,70744312,3118,1039,2079,1039,0,1,1041,121406,0.121406
1539,593,5041,2989313,2,12318,3081,1,93280312,93280312,4618,1539,3079,1539,0,1,1541,701919,0.701919
2039,593,5041,2989313,2,16318,4081,1,115816312,115816312,6118,2039,4079,2039,0,1,2041,542380,0.54238
2539,593,5041,2989313,2,20318,5081,1,138352312,138352312,7618,2539,5079,2539,0,1,2541,458219,0.458219
3039,593,5041,2989313,2,24318,6081,1,160888312,160888312,9118,3039,6079,3039,0,1,3041,866010,0.86601
3539,593,5041,2989313,2,28318,7081,1,183424312,183424312,10618,3539,7079,3539,0,1,3541,965525,0.965525
4039,593,5041,2989313,2,32318,8081,1,205960312,205960312,12118,4039,8079,4039,0,1,4041,300824,0.300824
4539,593,5041,2989313,2,36318,9081,1,228496312,228496312,13618,4539,9079,4539,0,1,4541,130444,0.130444
5039,593,5041,2989313,2,40318,10081,1,251032312,251032312,15118,5039,10079,5039,0,1,5041,24521,0.024521
5539,593,5041,2989313,2,44318,11081,1,273568312,273568312,16618,5539,11079,5539,0,1,5541,616303,0.616303
6039,593,5041,2989313,2,48318,12081,1,296104312,296104312,18118,6039,12079,6039,0,1,6041,149968,0.149968
6539,593,5041,2989313,2,52318,13081,1,318640312,318640312,19618,6539,13079,6539,0,1,6541,244246,0.244246
7039,593,5041,2989313,2,56318,14081,1,341176312,341176312,21118,7039,14079,7039,0,1,7041,1214088,1.214088
40,550,5440,2992000,2,326,83,1,25852800,25852800,121,40,81,40,0,1,42,22566,0.022566
440,550,5440,2992000,2,3526,883,1,45020800,45020800,1321,440,881,440,0,1,442,268494,0.268494
840,550,5440,2992000,2,6726,1683,1,64188800,64188800,2521,840,1681,840,0,1,842,76980,0.07698
1240,550,5440,2992000,2,9926,2483,1,83356800,83356800,3721,1240,2481,1240,0,1,1242,168206,0.168206
1640,550,5440,2992000,2,13126,3283,1,102524800,102524800,4921,1640,3281,1640,0,1,1642,421582,0.421582
2040,550,5440,2992000,2,16326,4083,1,121692800,121692800,6121,2040,4081,2040,0,1,2042,31381,0.031381
2440,550,5440,2992000,2,19526,4883,1,140860800,140860800,7321,2440,4881,2440,0,1,2442,1006097,1.006097
2840,550,5440,2992000,2,22726,5683,1,160028800,160028800,8521,2840,5681,2840,0,1,2842,326519,0.326519
3240,550,5440,2992000,2,25926,6483,1,179196800,179196800,9721,3240,6481,3240,0,1,3242,22353,0.022353
3640,550,5440,2992000,2,29126,7283,1,198364800,198364800,10921,3640,7281,3640,0,1,3642,227706,0.227706
4040,550,5440,2992000,2,32326,8083,1,217532800,217532800,12121,4040,8081,4040,0,1,4042,1475740,1.47574
4440,550,5440,2992000,2,35526,8883,1,236700800,236700800,13321,4440,8881,4440,0,1,4442,2477902,2.477902
4840,550,5440,2992000,2,38726,9683,1,255868800,255868800,14521,4840,9681,4840,0,1,4842,165523,0.165523
5240,550,5440,2992000,2,41926,10483,1,275036800,275036800,15721,5240,10481,5240,0,1,5242,1694096,1.694096
5640,550,5440,2992000,2,45126,11283,1,294204800,294204800,16921,5640,11281,5640,0,1,5642,656862,0.656862
6040,550,5440,2992000,2,48326,12083,1,313372800,313372800,18121,6040,12081,6040,0,1,6042,826349,0.826349
6440,550,5440,2992000,2,51526,12883,1,332540800,332540800,19321,6440,12881,6440,0,1,6442,207337,0.207337
6840,550,5440,2992000,2,54726,13683,1,351708800,351708800,20521,6840,13681,6840,0,1,6842,833919,0.833919
35,5500,545,2997500,2,286,73,1,25672600,25672600,106,35,71,35,0,1,37,8357,0.008357
535,5500,545,2997500,2,4286,1073,1,49852600,49852600,1606,535,1071,535,0,1,537,40373,0.040373
1035,5500,545,2997500,2,8286,2073,1,74032600,74032600,3106,1035,2071,1035,0,1,1037,408400,0.4084
1535,5500,545,2997500,2,12286,3073,1,98212600,98212600,4606,1535,3071,1535,0,1,1537,171380,0.17138
2035,5500,545,2997500,2,16286,4073,1,122392600,122392600,6106,2035,4071,2035,0,1,2037,860291,0.860291
2535,5500,545,2997500,2,20286,5073,1,146572600,146572600,7606,2535,5071,2535,0,1,2537,1463031,1.463031
3035,5500,545,2997500,2,24286,6073,1,170752600,170752600,9106,3035,6071,3035,0,1,3037,1742311,1.742311
3535,5500,545,2997500,2,28286,7073,1,194932600,194932600,10606,3535,7071,3535,0,1,3537,2034970,2.03497
4035,5500,545,2997500,2,32286,8073,1,219112600,219112600,12106,4035,8071,4035,0,1,4037,2337868,2.337868
4535,5500,545,2997500,2,36286,9073,1,243292600,243292600,13606,4535,9071,4535,0,1,4537,2178169,2.178169
5035,5500,545,2997500,2,40286,10073,1,267472600,267472600,15106,5035,10071,5035,0,1,5037,2923910,2.92391
5535,5500,545,2997500,2,44286,11073,1,291652600,291652600,16606,5535,11071,5535,0,1,5537,112021,0.112021
6035,5500,545,2997500,2,48286,12073,1,315832600,315832600,18106,6035,12071,6035,0,1,6037,3461390,3.46139
6535,5500,545,2997500,2,52286,13073,1,340012600,340012600,19606,6535,13071,6535,0,1,6537,1320995,1.320995
7035,5500,545,2997500,2,56286,14073,1,364192600,364192600,21106,7035,14071,7035,0,1,7037,4037898,4.037898
39,5543,541,2998763,2,318,81,1,25888312,25888312,118,39,79,39,0,1,41,5319,0.005319
539,5543,541,2998763,2,4318,1081,1,50224312,50224312,1618,539,1079,539,0,1,541,76996,0.076996
1039,5543,541,2998763,2,8318,2081,1,74560312,74560312,3118,1039,2079,1039,0,1,1041,197166,0.197166
1539,5543,541,2998763,2,12318,3081,1,98896312,98896312,4618,1539,3079,1539,0,1,1541,120112,0.120112
2039,5543,541,2998763,2,16318,4081,1,123232312,123232312,6118,2039,4079,2039,0,1,2041,1223202,1.223202
2539,5543,541,2998763,2,20318,5081,1,147568312,147568312,7618,2539,5079,2539,0,1,2541,688811,0.688811
3039,5543,541,2998763,2,24318,6081,1,171904312,171904312,9118,3039,6079,3039,0,1,3041,1819402,1.819402
3539,5543,541,2998763,2,28318,7081,1,196240312,196240312,10618,3539,7079,3539,0,1,3541,2164123,2.164123
4039,5543,541,2998763,2,32318,8081,1,220576312,220576312,12118,4039,8079,4039,0,1,4041,941375,0.941375
4539,5543,541,2998763,2,36318,9081,1,244912312,244912312,13618,4539,9079,4539,0,1,4541,2724535,2.724535
5039,5543,541,2998763,2,40318,10081,1,269248312,269248312,15118,5039,10079,5039,0,1,5041,1741130,1.74113
5539,5543,541,2998763,2,44318,11081,1,293584312,293584312,16618,5539,11079,5539,0,1,5541,1059662,1.059662
6039,5543,541,2998763,2,48318,12081,1,317920312,317920312,18118,6039,12079,6039,0,1,6041,661365,0.661365
6539,5543,541,2998763,2,52318,13081,1,342256312,342256312,19618,6539,13079,6539,0,1,6541,318347,0.318347
7039,5543,541,2998763,2,56318,14081,1,366592312,366592312,21118,7039,14079,7039,0,1,7041,432910,0.43291
35,5540,545,3019300,2,286,73,1,25858200,25858200,106,35,71,35,0,1,37,70044,0.070044
535,5540,545,3019300,2,4286,1073,1,50198200,50198200,1606,535,1071,535,0,1,537,319054,0.319054
1035,5540,545,3019300,2,8286,2073,1,74538200,74538200,3106,1035,2071,1035,0,1,1037,497371,0.497371
1535,5540,545,3019300,2,12286,3073,1,98878200,98878200,4606,1535,3071,1535,0,1,1537,903327,0.903327
55,4555,665,3029075,2,446,113,1,26529400,26529400,166,55,111,55,0,1,57,62065,0.062065
455,4555,665,3029075,2,3646,913,1,43233400,43233400,1366,455,911,455,0,1,457,283816,0.283816
855,4555,665,3029075,2,6846,1713,1,59937400,59937400,2566,855,1711,855,0,1,857,514971,0.514971
1255,4555,665,3029075,2,10046,2513,1,76641400,76641400,3766,1255,2511,1255,0,1,1257,747030,0.74703
1655,4555,665,3029075,2,13246,3313,1,93345400,93345400,4966,1655,3311,1655,0,1,1657,199258,0.199258
2055,4555,665,3029075,2,16446,4113,1,110049400,110049400,6166,2055,4111,2055,0,1,2057,1200704,1.200704
2455,4555,665,3029075,2,19646,4913,1,126753400,126753400,7366,2455,4911,2455,0,1,2457,1174977,1.174977
2855,4555,665,3029075,2,22846,5713,1,143457400,143457400,8566,2855,5711,2855,0,1,2857,1660575,1.660575
3255,4555,665,3029075,2,26046,6513,1,160161400,160161400,9766,3255,6511,3255,0,1,3257,997164,0.997164
3655,4555,665,3029075,2,29246,7313,1,176865400,176865400,10966,3655,7311,3655,0,1,3657,270104,0.270104
4055,4555,665,3029075,2,32446,8113,1,193569400,193569400,12166,4055,8111,4055,0,1,4057,365960,0.36596
4455,4555,665,3029075,2,35646,8913,1,210273400,210273400,13366,4455,8911,4455,0,1,4457,2584964,2.584964
4855,4555,665,3029075,2,38846,9713,1,226977400,226977400,14566,4855,9711,4855,0,1,4857,1763735,1.763735
5255,4555,665,3029075,2,42046,10513,1,243681400,243681400,15766,5255,10511,5255,0,1,5257,694304,0.694304
5655,4555,665,3029075,2,45246,11313,1,260385400,260385400,16966,5655,11311,5655,0,1,5657,1577396,1.577396
6055,4555,665,3029075,2,48446,12113,1,277089400,277089400,18166,6055,12111,6055,0,1,6057,3532688,3.532688
6455,4555,665,3029075,2,51646,12913,1,293793400,293793400,19366,6455,12911,6455,0,1,6457,79568,0.079568
6855,4555,665,3029075,2,54846,13713,1,310497400,310497400,20566,6855,13711,6855,0,1,6857,1329433,1.329433
55,555,5465,3033075,2,446,113,1,26913400,26913400,166,55,111,55,0,1,57,63712,0.063712
455,555,5465,3033075,2,3646,913,1,46177400,46177400,1366,455,911,455,0,1,457,290848,0.290848
855,555,5465,3033075,2,6846,1713,1,65441400,65441400,2566,855,1711,855,0,1,857,18533,0.018533
1255,555,5465,3033075,2,10046,2513,1,84705400,84705400,3766,1255,2511,1255,0,1,1257,751926,0.751926
1655,555,5465,3033075,2,13246,3313,1,103969400,103969400,4966,1655,3311,1655,0,1,1657,22224,0.022224
2055,555,5465,3033075,2,16446,4113,1,123233400,123233400,6166,2055,4111,2055,0,1,2057,1219581,1.219581
2455,555,5465,3033075,2,19646,4913,1,142497400,142497400,7366,2455,4911,2455,0,1,2457,720383,0.720383
2855,555,5465,3033075,2,22846,5713,1,161761400,161761400,8566,2855,5711,2855,0,1,2857,60611,0.060611
3255,555,5465,3033075,2,26046,6513,1,181025400,181025400,9766,3255,6511,3255,0,1,3257,103252,0.103252
3655,555,5465,3033075,2,29246,7313,1,200289400,200289400,10966,3655,7311,3655,0,1,3657,362762,0.362762
4055,555,5465,3033075,2,32446,8113,1,219553400,219553400,12166,4055,8111,4055,0,1,4057,957194,0.957194
4455,555,5465,3033075,2,35646,8913,1,238817400,238817400,13366,4455,8911,4455,0,1,4457,724692,0.724692
4855,555,5465,3033075,2,38846,9713,1,258081400,258081400,14566,4855,9711,4855,0,1,4857,1414735,1.414735
5255,555,5465,3033075,2,42046,10513,1,277345400,277345400,15766,5255,10511,5255,0,1,5257,824711,0.824711
5655,555,5465,3033075,2,45246,11313,1,296609400,296609400,16966,5655,11311,5655,0,1,5657,1693389,1.693389
6055,555,5465,3033075,2,48446,12113,1,315873400,315873400,18166,6055,12111,6055,0,1,6057,1403118,1.403118
6455,555,5465,3033075,2,51646,12913,1,335137400,335137400,19366,6455,12911,6455,0,1,6457,299835,0.299835
6855,555,5465,3033075,2,54846,13713,1,354401400,354401400,20566,6855,13711,6855,0,1,6857,1411697,1.411697
44,603,5055,3048165,2,358,91,1,26376936,26376936,133,44,89,44,0,1,46,59517,0.059517
544,603,5055,3048165,2,4358,1091,1,49008936,49008936,1633,544,1089,544,0,1,546,109847,0.109847
1044,603,5055,3048165,2,8358,2091,1,71640936,71640936,3133,1044,2089,1044,0,1,1046,116291,0.116291
1544,603,5055,3048165,2,12358,3091,1,94272936,94272936,4633,1544,3089,1544,0,1,1546,622619,0.622619
2044,603,5055,3048165,2,16358,4091,1,116904936,116904936,6133,2044,4089,2044,0,1,2046,88453,0.088453
2544,603,5055,3048165,2,20358,5091,1,139536936,139536936,7633,2544,5089,2544,0,1,2546,261203,0.261203
3044,603,5055,3048165,2,24358,6091,1,162168936,162168936,9133,3044,6089,3044,0,1,3046,227248,0.227248
3544,603,5055,3048165,2,28358,7091,1,184800936,184800936,10633,3544,7089,3544,0,1,3546,80736,0.080736
4044,603,5055,3048165,2,32358,8091,1,207432936,207432936,12133,4044,8089,4044,0,1,4046,291340,0.29134
4544,603,5055,3048165,2,36358,9091,1,230064936,230064936,13633,4544,9089,4544,0,1,4546,412193,0.412193
5044,603,5055,3048165,2,40358,10091,1,252696936,252696936,15133,5044,10089,5044,0,1,5046,524065,0.524065
5544,603,5055,3048165,2,44358,11091,1,275328936,275328936,16633,5544,11089,5544,0,1,5546,1062087,1.062087
6044,603,5055,3048165,2,48358,12091,1,297960936,297960936,18133,6044,12089,6044,0,1,6046,370407,0.370407
6544,603,5055,3048165,2,52358,13091,1,320592936,320592936,19633,6544,13089,6544,0,1,6546,1288527,1.288527
7044,603,5055,3048165,2,56358,14091,1,343224936,343224936,21133,7044,14089,7044,0,1,7046,2926617,2.926617
40,4800,640,3072000,2,326,83,1,26316800,26316800,121,40,81,40,0,1,42,56238,0.056238
440,4800,640,3072000,2,3526,883,1,43724800,43724800,1321,440,881,440,0,1,442,267815,0.267815
840,4800,640,3072000,2,6726,1683,1,61132800,61132800,2521,840,1681,840,0,1,842,492246,0.492246
1240,4800,640,3072000,2,9926,2483,1,78540800,78540800,3721,1240,2481,1240,0,1,1242,714796,0.714796
1640,4800,640,3072000,2,13126,3283,1,95948800,95948800,4921,1640,3281,1640,0,1,1642,943683,0.943683
2040,4800,640,3072000,2,16326,4083,1,113356800,113356800,6121,2040,4081,2040,0,1,2042,656819,0.656819
2440,4800,640,3072000,2,19526,4883,1,130764800,130764800,7321,2440,4881,2440,0,1,2442,1403971,1.403971
2840,4800,640,3072000,2,22726,5683,1,148172800,148172800,8521,2840,5681,2840,0,1,2842,1607998,1.607998
3240,4800,640,3072000,2,25926,6483,1,165580800,165580800,9721,3240,6481,3240,0,1,3242,1189481,1.189481
3640,4800,640,3072000,2,29126,7283,1,182988800,182988800,10921,3640,7281,3640,0,1,3642,1927217,1.927217
4040,4800,640,3072000,2,32326,8083,1,200396800,200396800,12121,4040,8081,4040,0,1,4042,1420429,1.420429
4440,4800,640,3072000,2,35526,8883,1,217804800,217804800,13321,4440,8881,4440,0,1,4442,2514982,2.514982
4840,4800,640,3072000,2,38726,9683,1,235212800,235212800,14521,4840,9681,4840,0,1,4842,2731148,2.731148
5240,4800,640,3072000,2,41926,10483,1,252620800,252620800,15721,5240,10481,5240,0,1,5242,2944041,2.944041
5640,4800,640,3072000,2,45126,11283,1,270028800,270028800,16921,5640,11281,5640,0,1,5642,2828352,2.828352
6040,4800,640,3072000,2,48326,12083,1,287436800,287436800,18121,6040,12081,6040,0,1,6042,1681172,1.681172
6440,4800,640,3072000,2,51526,12883,1,304844800,304844800,19321,6440,12881,6440,0,1,6442,303943,0.303943
6840,4800,640,3072000,2,54726,13683,1,322252800,322252800,20521,6840,13681,6840,0,1,6842,3855009,3.855009
44,5553,555,3081915,2,358,91,1,26805336,26805336,133,44,89,44,0,1,46,11538,0.011538
544,5553,555,3081915,2,4358,1091,1,51237336,51237336,1633,544,1089,544,0,1,546,16382,0.016382
1044,5553,555,3081915,2,8358,2091,1,75669336,75669336,3133,1044,2089,1044,0,1,1046,175395,0.175395
1544,5553,555,3081915,2,12358,3091,1,100101336,100101336,4633,1544,3089,1544,0,1,1546,939431,0.939431
2044,5553,555,3081915,2,16358,4091,1,124533336,124533336,6133,2044,4089,2044,0,1,2046,575247,0.575247
2544,5553,555,3081915,2,20358,5091,1,148965336,148965336,7633,2544,5089,2544,0,1,2546,257341,0.257341
3044,5553,555,3081915,2,24358,6091,1,173397336,173397336,9133,3044,6089,3044,0,1,3046,480742,0.480742
3544,5553,555,3081915,2,28358,7091,1,197829336,197829336,10633,3544,7089,3544,0,1,3546,2182110,2.18211
4044,5553,555,3081915,2,32358,8091,1,222261336,222261336,12133,4044,8089,4044,0,1,4046,2468639,2.468639
4544,5553,555,3081915,2,36358,9091,1,246693336,246693336,13633,4544,9089,4544,0,1,4546,1694355,1.694355
5044,5553,555,3081915,2,40358,10091,1,271125336,271125336,15133,5044,10089,5044,0,1,5046,2544190,2.54419
5544,5553,555,3081915,2,44358,11091,1,295557336,295557336,16633,5544,11089,5544,0,1,5546,3408365,3.408365
6044,5553,555,3081915,2,48358,12091,1,319989336,319989336,18133,6044,12089,6044,0,1,6046,461064,0.461064
6544,5553,555,3081915,2,52358,13091,1,344421336,344421336,19633,6544,13089,6544,0,1,6546,4011160,4.01116
7044,5553,555,3081915,2,56358,14091,1,368853336,368853336,21133,7044,14089,7044,0,1,7046,3565496,3.565496
40,3300,940,3102000,2,326,83,1,26172800,26172800,121,40,81,40,0,1,42,54278,0.054278
440,3300,940,3102000,2,3526,883,1,39740800,39740800,1321,440,881,440,0,1,442,286306,0.286306
840,3300,940,3102000,2,6726,1683,1,53308800,53308800,2521,840,1681,840,0,1,842,52599,0.052599
1240,3300,940,3102000,2,9926,2483,1,66876800,66876800,3721,1240,2481,1240,0,1,1242,121719,0.121719
1640,3300,940,3102000,2,13126,3283,1,80444800,80444800,4921,1640,3281,1640,0,1,1642,721996,0.721996
2040,3300,940,3102000,2,16326,4083,1,94012800,94012800,6121,2040,4081,2040,0,1,2042,71682,0.071682
2440,3300,940,3102000,2,19526,4883,1,107580800,107580800,7321,2440,4881,2440,0,1,2442,38113,0.038113
2840,3300,940,3102000,2,22726,5683,1,121148800,121148800,8521,2840,5681,2840,0,1,2842,1549570,1.54957
3240,3300,940,3102000,2,25926,6483,1,134716800,134716800,9721,3240,6481,3240,0,1,3242,361193,0.361193
3640,3300,940,3102000,2,29126,7283,1,148284800,148284800,10921,3640,7281,3640,0,1,3642,77040,0.07704
4040,3300,940,3102000,2,32326,8083,1,161852800,161852800,12121,4040,8081,4040,0,1,4042,1678662,1.678662
4440,3300,940,3102000,2,35526,8883,1,175420800,175420800,13321,4440,8881,4440,0,1,4442,2689195,2.689195
4840,3300,940,3102000,2,38726,9683,1,188988800,188988800,14521,4840,9681,4840,0,1,4842,490570,0.49057
5240,3300,940,3102000,2,41926,10483,1,202556800,202556800,15721,5240,10481,5240,0,1,5242,434725,0.434725
5640,3300,940,3102000,2,45126,11283,1,216124800,216124800,16921,5640,11281,5640,0,1,5642,333038,0.333038
6040,3300,940,3102000,2,48326,12083,1,229692800,229692800,18121,6040,12081,6040,0,1,6042,2713983,2.713983
6440,3300,940,3102000,2,51526,12883,1,243260800,243260800,19321,6440,12881,6440,0,1,6442,2632604,2.632604
6840,3300,940,3102000,2,54726,13683,1,256828800,256828800,20521,6840,13681,6840,0,1,6842,1118947,1.118947
40,800,3940,3152000,2,326,83,1,26732800,26732800,121,40,81,40,0,1,42,57532,0.057532
440,800,3940,3152000,2,3526,883,1,41900800,41900800,1321,440,881,440,0,1,442,286922,0.286922
840,800,3940,3152000,2,6726,1683,1,57068800,57068800,2521,840,1681,840,0,1,842,523052,0.523052
1240,800,3940,3152000,2,9926,2483,1,72236800,72236800,3721,1240,2481,1240,0,1,1242,60147,0.060147
1640,800,3940,3152000,2,13126,3283,1,87404800,87404800,4921,1640,3281,1640,0,1,1642,439181,0.439181
2040,800,3940,3152000,2,16326,4083,1,102572800,102572800,6121,2040,4081,2040,0,1,2042,1234508,1.234508
2440,800,3940,3152000,2,19526,4883,1,117740800,117740800,7321,2440,4881,2440,0,1,2442,134813,0.134813
2840,800,3940,3152000,2,22726,5683,1,132908800,132908800,8521,2840,5681,2840,0,1,2842,336633,0.336633
3240,800,3940,3152000,2,25926,6483,1,148076800,148076800,9721,3240,6481,3240,0,1,3242,382892,0.382892
3640,800,3940,3152000,2,29126,7283,1,163244800,163244800,10921,3640,7281,3640,0,1,3642,419102,0.419102
4040,800,3940,3152000,2,32326,8083,1,178412800,178412800,12121,4040,8081,4040,0,1,4042,377231,0.377231
4440,800,3940,3152000,2,35526,8883,1,193580800,193580800,13321,4440,8881,4440,0,1,4442,565550,0.56555
4840,800,3940,3152000,2,38726,9683,1,208748800,208748800,14521,4840,9681,4840,0,1,4842,692656,0.692656
5240,800,3940,3152000,2,41926,10483,1,223916800,223916800,15721,5240,10481,5240,0,1,5242,720567,0.720567
5640,800,3940,3152000,2,45126,11283,1,239084800,239084800,16921,5640,11281,5640,0,1,5642,2317744,2.317744
6040,800,3940,3152000,2,48326,12083,1,254252800,254252800,18121,6040,12081,6040,0,1,6042,1009135,1.009135
6440,800,3940,3152000,2,51526,12883,1,269420800,269420800,19321,6440,12881,6440,0,1,6442,16488,0.016488
6840,800,3940,3152000,2,54726,13683,1,284588800,284588800,20521,6840,13681,6840,0,1,6842,1144358,1.144358
40,2050,1540,3157000,2,326,83,1,26404800,26404800,121,40,81,40,0,1,42,5922,0.005922
440,2050,1540,3157000,2,3526,883,1,37892800,37892800,1321,440,881,440,0,1,442,42463,0.042463
840,2050,1540,3157000,2,6726,1683,1,49380800,49380800,2521,840,1681,840,0,1,842,79766,0.079766
1240,2050,1540,3157000,2,9926,2483,1,60868800,60868800,3721,1240,2481,1240,0,1,1242,72458,0.072458
1640,2050,1540,3157000,2,13126,3283,1,72356800,72356800,4921,1640,3281,1640,0,1,1642,106734,0.106734
2040,2050,1540,3157000,2,16326,4083,1,83844800,83844800,6121,2040,4081,2040,0,1,2042,478296,0.478296
2440,2050,1540,3157000,2,19526,4883,1,95332800,95332800,7321,2440,4881,2440,0,1,2442,715849,0.715849
2840,2050,1540,3157000,2,22726,5683,1,106820800,106820800,8521,2840,5681,2840,0,1,2842,152226,0.152226
40,550,5740,3157000,2,326,83,1,27268800,27268800,121,40,81,40,0,1,42,59514,0.059514
440,550,5740,3157000,2,3526,883,1,47396800,47396800,1321,440,881,440,0,1,442,229315,0.229315
840,550,5740,3157000,2,6726,1683,1,67524800,67524800,2521,840,1681,840,0,1,842,527560,0.52756
3240,2050,1540,3157000,2,25926,6483,1,118308800,118308800,9721,3240,6481,3240,0,1,3242,94052,0.094052
1240,550,5740,3157000,2,9926,2483,1,87652800,87652800,3721,1240,2481,1240,0,1,1242,695765,0.695765
1640,550,5740,3157000,2,13126,3283,1,107780800,107780800,4921,1640,3281,1640,0,1,1642,535252,0.535252
2040,550,5740,3157000,2,16326,4083,1,127908800,127908800,6121,2040,4081,2040,0,1,2042,613758,0.613758
2440,550,5740,3157000,2,19526,4883,1,148036800,148036800,7321,2440,4881,2440,0,1,2442,778743,0.778743
2840,550,5740,3157000,2,22726,5683,1,168164800,168164800,8521,2840,5681,2840,0,1,2842,625743,0.625743
3640,2050,1540,3157000,2,29126,7283,1,129796800,129796800,10921,3640,7281,3640,0,1,3642,350750,0.35075
3240,550,5740,3157000,2,25926,6483,1,188292800,188292800,9721,3240,6481,3240,0,1,3242,1966570,1.96657
3640,550,5740,3157000,2,29126,7283,1,208420800,208420800,10921,3640,7281,3640,0,1,3642,100588,0.100588
4040,550,5740,3157000,2,32326,8083,1,228548800,228548800,12121,4040,8081,4040,0,1,4042,326683,0.326683
4440,550,5740,3157000,2,35526,8883,1,248676800,248676800,13321,4440,8881,4440,0,1,4442,1191196,1.191196
4040,2050,1540,3157000,2,32326,8083,1,141284800,141284800,12121,4040,8081,4040,0,1,4042,293425,0.293425
4840,550,5740,3157000,2,38726,9683,1,268804800,268804800,14521,4840,9681,4840,0,1,4842,1349130,1.34913
5240,550,5740,3157000,2,41926,10483,1,288932800,288932800,15721,5240,10481,5240,0,1,5242,970215,0.970215
5640,550,5740,3157000,2,45126,11283,1,309060800,309060800,16921,5640,11281,5640,0,1,5642,499618,0.499618
4440,2050,1540,3157000,2,35526,8883,1,152772800,152772800,13321,4440,8881,4440,0,1,4442,346602,0.346602
6040,550,5740,3157000,2,48326,12083,1,329188800,329188800,18121,6040,12081,6040,0,1,6042,37217,0.037217
6440,550,5740,3157000,2,51526,12883,1,349316800,349316800,19321,6440,12881,6440,0,1,6442,770720,0.77072
4840,2050,1540,3157000,2,38726,9683,1,164260800,164260800,14521,4840,9681,4840,0,1,4842,1536849,1.536849
6840,550,5740,3157000,2,54726,13683,1,369444800,369444800,20521,6840,13681,6840,0,1,6842,2213569,2.213569
5240,2050,1540,3157000,2,41926,10483,1,175748800,175748800,15721,5240,10481,5240,0,1,5242,746183,0.746183
5640,2050,1540,3157000,2,45126,11283,1,187236800,187236800,16921,5640,11281,5640,0,1,5642,192132,0.192132
6040,2050,1540,3157000,2,48326,12083,1,198724800,198724800,18121,6040,12081,6040,0,1,6042,234653,0.234653
6440,2050,1540,3157000,2,51526,12883,1,210212800,210212800,19321,6440,12881,6440,0,1,6442,134521,0.134521
6840,2050,1540,3157000,2,54726,13683,1,221700800,221700800,20521,6840,13681,6840,0,1,6842,861055,0.861055
40,2550,1240,3162000,2,326,83,1,26508800,26508800,121,40,81,40,0,1,42,58946,0.058946
440,2550,1240,3162000,2,3526,883,1,38636800,38636800,1321,440,881,440,0,1,442,282179,0.282179
840,2550,1240,3162000,2,6726,1683,1,50764800,50764800,2521,840,1681,840,0,1,842,520514,0.520514
1240,2550,1240,3162000,2,9926,2483,1,62892800,62892800,3721,1240,2481,1240,0,1,1242,756245,0.756245
1640,2550,1240,3162000,2,13126,3283,1,75020800,75020800,4921,1640,3281,1640,0,1,1642,989055,0.989055
2040,2550,1240,3162000,2,16326,4083,1,87148800,87148800,6121,2040,4081,2040,0,1,2042,1226554,1.226554
2440,2550,1240,3162000,2,19526,4883,1,99276800,99276800,7321,2440,4881,2440,0,1,2442,1420496,1.420496
2840,2550,1240,3162000,2,22726,5683,1,111404800,111404800,8521,2840,5681,2840,0,1,2842,1698833,1.698833
3240,2550,1240,3162000,2,25926,6483,1,123532800,123532800,9721,3240,6481,3240,0,1,3242,117765,0.117765
3640,2550,1240,3162000,2,29126,7283,1,135660800,135660800,10921,3640,7281,3640,0,1,3642,1889404,1.889404
4040,2550,1240,3162000,2,32326,8083,1,147788800,147788800,12121,4040,8081,4040,0,1,4042,763508,0.763508
4440,2550,1240,3162000,2,35526,8883,1,159916800,159916800,13321,4440,8881,4440,0,1,4442,930190,0.93019
4840,2550,1240,3162000,2,38726,9683,1,172044800,172044800,14521,4840,9681,4840,0,1,4842,1254570,1.25457
5240,2550,1240,3162000,2,41926,10483,1,184172800,184172800,15721,5240,10481,5240,0,1,5242,3128063,3.128063
5640,2550,1240,3162000,2,45126,11283,1,196300800,196300800,16921,5640,11281,5640,0,1,5642,15943,0.015943
6040,2550,1240,3162000,2,48326,12083,1,208428800,208428800,18121,6040,12081,6040,0,1,6042,3589219,3.589219
6440,2550,1240,3162000,2,51526,12883,1,220556800,220556800,19321,6440,12881,6440,0,1,6442,2300928,2.300928
6840,2550,1240,3162000,2,54726,13683,1,232684800,232684800,20521,6840,13681,6840,0,1,6842,3863209,3.863209
40,1300,2440,3172000,2,326,83,1,26572800,26572800,121,40,81,40,0,1,42,60982,0.060982
440,1300,2440,3172000,2,3526,883,1,38540800,38540800,1321,440,881,440,0,1,442,292557,0.292557
840,1300,2440,3172000,2,6726,1683,1,50508800,50508800,2521,840,1681,840,0,1,842,140269,0.140269
1240,1300,2440,3172000,2,9926,2483,1,62476800,62476800,3721,1240,2481,1240,0,1,1242,777810,0.77781
1640,1300,2440,3172000,2,13126,3283,1,74444800,74444800,4921,1640,3281,1640,0,1,1642,959230,0.95923
2040,1300,2440,3172000,2,16326,4083,1,86412800,86412800,6121,2040,4081,2040,0,1,2042,697161,0.697161
2440,1300,2440,3172000,2,19526,4883,1,98380800,98380800,7321,2440,4881,2440,0,1,2442,234302,0.234302
2840,1300,2440,3172000,2,22726,5683,1,110348800,110348800,8521,2840,5681,2840,0,1,2842,1753084,1.753084
3240,1300,2440,3172000,2,25926,6483,1,122316800,122316800,9721,3240,6481,3240,0,1,3242,1991835,1.991835
3640,1300,2440,3172000,2,29126,7283,1,134284800,134284800,10921,3640,7281,3640,0,1,3642,456780,0.45678
4040,1300,2440,3172000,2,32326,8083,1,146252800,146252800,12121,4040,8081,4040,0,1,4042,443649,0.443649
4440,1300,2440,3172000,2,35526,8883,1,158220800,158220800,13321,4440,8881,4440,0,1,4442,352226,0.352226
4840,1300,2440,3172000,2,38726,9683,1,170188800,170188800,14521,4840,9681,4840,0,1,4842,898622,0.898622
5240,1300,2440,3172000,2,41926,10483,1,182156800,182156800,15721,5240,10481,5240,0,1,5242,2017744,2.017744
5640,1300,2440,3172000,2,45126,11283,1,194124800,194124800,16921,5640,11281,5640,0,1,5642,1171196,1.171196
6040,1300,2440,3172000,2,48326,12083,1,206092800,206092800,18121,6040,12081,6040,0,1,6042,1171713,1.171713
6440,1300,2440,3172000,2,51526,12883,1,218060800,218060800,19321,6440,12881,6440,0,1,6442,1810642,1.810642
6840,1300,2440,3172000,2,54726,13683,1,230028800,230028800,20521,6840,13681,6840,0,1,6842,828540,0.82854
55,3305,965,3189325,2,446,113,1,27393400,27393400,166,55,111,55,0,1,57,64579,0.064579
455,3305,965,3189325,2,3646,913,1,41057400,41057400,1366,455,911,455,0,1,457,304514,0.304514
855,3305,965,3189325,2,6846,1713,1,54721400,54721400,2566,855,1711,855,0,1,857,557676,0.557676
1255,3305,965,3189325,2,10046,2513,1,68385400,68385400,3766,1255,2511,1255,0,1,1257,731198,0.731198
1655,3305,965,3189325,2,13246,3313,1,82049400,82049400,4966,1655,3311,1655,0,1,1657,1052235,1.052235
2055,3305,965,3189325,2,16446,4113,1,95713400,95713400,6166,2055,4111,2055,0,1,2057,352129,0.352129
2455,3305,965,3189325,2,19646,4913,1,109377400,109377400,7366,2455,4911,2455,0,1,2457,1005008,1.005008
2855,3305,965,3189325,2,22846,5713,1,123041400,123041400,8566,2855,5711,2855,0,1,2857,1806947,1.806947
3255,3305,965,3189325,2,26046,6513,1,136705400,136705400,9766,3255,6511,3255,0,1,3257,2048782,2.048782
3655,3305,965,3189325,2,29246,7313,1,150369400,150369400,10966,3655,7311,3655,0,1,3657,2302188,2.302188
4055,3305,965,3189325,2,32446,8113,1,164033400,164033400,12166,4055,8111,4055,0,1,4057,1092342,1.092342
4455,3305,965,3189325,2,35646,8913,1,177697400,177697400,13366,4455,8911,4455,0,1,4457,689496,0.689496
4855,3305,965,3189325,2,38846,9713,1,191361400,191361400,14566,4855,9711,4855,0,1,4857,2237409,2.237409
5255,3305,965,3189325,2,42046,10513,1,205025400,205025400,15766,5255,10511,5255,0,1,5257,1578099,1.578099
5655,3305,965,3189325,2,45246,11313,1,218689400,218689400,16966,5655,11311,5655,0,1,5657,503675,0.503675
6055,3305,965,3189325,2,48446,12113,1,232353400,232353400,18166,6055,12111,6055,0,1,6057,1118966,1.118966
6455,3305,965,3189325,2,51646,12913,1,246017400,246017400,19366,6455,12911,6455,0,1,6457,2419627,2.419627
6855,3305,965,3189325,2,54846,13713,1,259681400,259681400,20566,6855,13711,6855,0,1,6857,361472,0.361472
55,805,3965,3191825,2,446,113,1,27633400,27633400,166,55,111,55,0,1,57,68726,0.068726
455,805,3965,3191825,2,3646,913,1,42897400,42897400,1366,455,911,455,0,1,457,304951,0.304951
855,805,3965,3191825,2,6846,1713,1,58161400,58161400,2566,855,1711,855,0,1,857,288368,0.288368
1255,805,3965,3191825,2,10046,2513,1,73425400,73425400,3766,1255,2511,1255,0,1,1257,786236,0.786236
1655,805,3965,3191825,2,13246,3313,1,88689400,88689400,4966,1655,3311,1655,0,1,1657,995949,0.995949
2055,805,3965,3191825,2,16446,4113,1,103953400,103953400,6166,2055,4111,2055,0,1,2057,211028,0.211028
2455,805,3965,3191825,2,19646,4913,1,119217400,119217400,7366,2455,4911,2455,0,1,2457,680556,0.680556
2855,805,3965,3191825,2,22846,5713,1,134481400,134481400,8566,2855,5711,2855,0,1,2857,262933,0.262933
3255,805,3965,3191825,2,26046,6513,1,149745400,149745400,9766,3255,6511,3255,0,1,3257,325984,0.325984
3655,805,3965,3191825,2,29246,7313,1,165009400,165009400,10966,3655,7311,3655,0,1,3657,1405512,1.405512
4055,805,3965,3191825,2,32446,8113,1,180273400,180273400,12166,4055,8111,4055,0,1,4057,327785,0.327785
4455,805,3965,3191825,2,35646,8913,1,195537400,195537400,13366,4455,8911,4455,0,1,4457,828621,0.828621
4855,805,3965,3191825,2,38846,9713,1,210801400,210801400,14566,4855,9711,4855,0,1,4857,504310,0.50431
5255,805,3965,3191825,2,42046,10513,1,226065400,226065400,15766,5255,10511,5255,0,1,5257,123362,0.123362
5655,805,3965,3191825,2,45246,11313,1,241329400,241329400,16966,5655,11311,5655,0,1,5657,741282,0.741282
6055,805,3965,3191825,2,48446,12113,1,256593400,256593400,18166,6055,12111,6055,0,1,6057,2650496,2.650496
6455,805,3965,3191825,2,51646,12913,1,271857400,271857400,19366,6455,12911,6455,0,1,6457,388573,0.388573
6855,805,3965,3191825,2,54846,13713,1,287121400,287121400,20566,6855,13711,6855,0,1,6857,622219,0.622219
40,1050,3040,3192000,2,326,83,1,26844800,26844800,121,40,81,40,0,1,42,6033,0.006033
440,1050,3040,3192000,2,3526,883,1,39932800,39932800,1321,440,881,440,0,1,442,8011,0.008011
840,1050,3040,3192000,2,6726,1683,1,53020800,53020800,2521,840,1681,840,0,1,842,40119,0.040119
1240,1050,3040,3192000,2,9926,2483,1,66108800,66108800,3721,1240,2481,1240,0,1,1242,6972,0.006972
1640,1050,3040,3192000,2,13126,3283,1,79196800,79196800,4921,1640,3281,1640,0,1,1642,101103,0.101103
2040,1050,3040,3192000,2,16326,4083,1,92284800,92284800,6121,2040,4081,2040,0,1,2042,19883,0.019883
2440,1050,3040,3192000,2,19526,4883,1,105372800,105372800,7321,2440,4881,2440,0,1,2442,5723,0.005723
2840,1050,3040,3192000,2,22726,5683,1,118460800,118460800,8521,2840,5681,2840,0,1,2842,224163,0.224163
3240,1050,3040,3192000,2,25926,6483,1,131548800,131548800,9721,3240,6481,3240,0,1,3242,223280,0.22328
3640,1050,3040,3192000,2,29126,7283,1,144636800,144636800,10921,3640,7281,3640,0,1,3642,1482857,1.482857
4040,1050,3040,3192000,2,32326,8083,1,157724800,157724800,12121,4040,8081,4040,0,1,4042,345941,0.345941
4440,1050,3040,3192000,2,35526,8883,1,170812800,170812800,13321,4440,8881,4440,0,1,4442,32822,0.032822
4840,1050,3040,3192000,2,38726,9683,1,183900800,183900800,14521,4840,9681,4840,0,1,4842,114383,0.114383
5240,1050,3040,3192000,2,41926,10483,1,196988800,196988800,15721,5240,10481,5240,0,1,5242,385765,0.385765
5640,1050,3040,3192000,2,45126,11283,1,210076800,210076800,16921,5640,11281,5640,0,1,5642,34200,0.0342
6040,1050,3040,3192000,2,48326,12083,1,223164800,223164800,18121,6040,12081,6040,0,1,6042,352283,0.352283
6440,1050,3040,3192000,2,51526,12883,1,236252800,236252800,19321,6440,12881,6440,0,1,6442,144412,0.144412
6840,1050,3040,3192000,2,54726,13683,1,249340800,249340800,20521,6840,13681,6840,0,1,6842,1257570,1.25757
55,4805,665,3195325,2,446,113,1,27969400,27969400,166,55,111,55,0,1,57,63709,0.063709
455,4805,665,3195325,2,3646,913,1,45473400,45473400,1366,455,911,455,0,1,457,293745,0.293745
855,4805,665,3195325,2,6846,1713,1,62977400,62977400,2566,855,1711,855,0,1,857,542092,0.542092
1255,4805,665,3195325,2,10046,2513,1,80481400,80481400,3766,1255,2511,1255,0,1,1257,786965,0.786965
1655,4805,665,3195325,2,13246,3313,1,97985400,97985400,4966,1655,3311,1655,0,1,1657,1022153,1.022153
2055,4805,665,3195325,2,16446,4113,1,115489400,115489400,6166,2055,4111,2055,0,1,2057,505115,0.505115
2455,4805,665,3195325,2,19646,4913,1,132993400,132993400,7366,2455,4911,2455,0,1,2457,1281420,1.28142
2855,4805,665,3195325,2,22846,5713,1,150497400,150497400,8566,2855,5711,2855,0,1,2857,1755374,1.755374
3255,4805,665,3195325,2,26046,6513,1,168001400,168001400,9766,3255,6511,3255,0,1,3257,774933,0.774933
3655,4805,665,3195325,2,29246,7313,1,185505400,185505400,10966,3655,7311,3655,0,1,3657,1862270,1.86227
4055,4805,665,3195325,2,32446,8113,1,203009400,203009400,12166,4055,8111,4055,0,1,4057,2484694,2.484694
4455,4805,665,3195325,2,35646,8913,1,220513400,220513400,13366,4455,8911,4455,0,1,4457,2729098,2.729098
4855,4805,665,3195325,2,38846,9713,1,238017400,238017400,14566,4855,9711,4855,0,1,4857,2978376,2.978376
5255,4805,665,3195325,2,42046,10513,1,255521400,255521400,15766,5255,10511,5255,0,1,5257,3217204,3.217204
5655,4805,665,3195325,2,45246,11313,1,273025400,273025400,16966,5655,11311,5655,0,1,5657,3484728,3.484728
6055,4805,665,3195325,2,48446,12113,1,290529400,290529400,18166,6055,12111,6055,0,1,6057,3740661,3.740661
6455,4805,665,3195325,2,51646,12913,1,308033400,308033400,19366,6455,12911,6455,0,1,6457,3939912,3.939912
6855,4805,665,3195325,2,54846,13713,1,325537400,325537400,20566,6855,13711,6855,0,1,6857,2847393,2.847393
55,555,5765,3199575,2,446,113,1,28377400,28377400,166,55,111,55,0,1,57,67256,0.067256
455,555,5765,3199575,2,3646,913,1,48601400,48601400,1366,455,911,455,0,1,457,304084,0.304084
855,555,5765,3199575,2,6846,1713,1,68825400,68825400,2566,855,1711,855,0,1,857,264597,0.264597
1255,555,5765,3199575,2,10046,2513,1,89049400,89049400,3766,1255,2511,1255,0,1,1257,792941,0.792941
1655,555,5765,3199575,2,13246,3313,1,109273400,109273400,4966,1655,3311,1655,0,1,1657,151240,0.15124
2055,555,5765,3199575,2,16446,4113,1,129497400,129497400,6166,2055,4111,2055,0,1,2057,1147058,1.147058
2455,555,5765,3199575,2,19646,4913,1,149721400,149721400,7366,2455,4911,2455,0,1,2457,702590,0.70259
2855,555,5765,3199575,2,22846,5713,1,169945400,169945400,8566,2855,5711,2855,0,1,2857,563524,0.563524
3255,555,5765,3199575,2,26046,6513,1,190169400,190169400,9766,3255,6511,3255,0,1,3257,13219,0.013219
3655,555,5765,3199575,2,29246,7313,1,210393400,210393400,10966,3655,7311,3655,0,1,3657,556839,0.556839
4055,555,5765,3199575,2,32446,8113,1,230617400,230617400,12166,4055,8111,4055,0,1,4057,807926,0.807926
4455,555,5765,3199575,2,35646,8913,1,250841400,250841400,13366,4455,8911,4455,0,1,4457,629966,0.629966
4855,555,5765,3199575,2,38846,9713,1,271065400,271065400,14566,4855,9711,4855,0,1,4857,24855,0.024855
5255,555,5765,3199575,2,42046,10513,1,291289400,291289400,15766,5255,10511,5255,0,1,5257,643759,0.643759
5655,555,5765,3199575,2,45246,11313,1,311513400,311513400,16966,5655,11311,5655,0,1,5657,311262,0.311262
6055,555,5765,3199575,2,48446,12113,1,331737400,331737400,18166,6055,12111,6055,0,1,6057,202617,0.202617
6455,555,5765,3199575,2,51646,12913,1,351961400,351961400,19366,6455,12911,6455,0,1,6457,616133,0.616133
6855,555,5765,3199575,2,54846,13713,1,372185400,372185400,20566,6855,13711,6855,0,1,6857,325436,0.325436
55,2055,1565,3216075,2,446,113,1,27321400,27321400,166,55,111,55,0,1,57,6774,0.006774
455,2055,1565,3216075,2,3646,913,1,38905400,38905400,1366,455,911,455,0,1,457,64122,0.064122
855,2055,1565,3216075,2,6846,1713,1,50489400,50489400,2566,855,1711,855,0,1,857,3690,0.00369
1255,2055,1565,3216075,2,10046,2513,1,62073400,62073400,3766,1255,2511,1255,0,1,1257,125675,0.125675
1655,2055,1565,3216075,2,13246,3313,1,73657400,73657400,4966,1655,3311,1655,0,1,1657,280518,0.280518
2055,2055,1565,3216075,2,16446,4113,1,85241400,85241400,6166,2055,4111,2055,0,1,2057,149723,0.149723
2455,2055,1565,3216075,2,19646,4913,1,96825400,96825400,7366,2455,4911,2455,0,1,2457,213828,0.213828
2855,2055,1565,3216075,2,22846,5713,1,108409400,108409400,8566,2855,5711,2855,0,1,2857,550051,0.550051
3255,2055,1565,3216075,2,26046,6513,1,119993400,119993400,9766,3255,6511,3255,0,1,3257,52576,0.052576
3655,2055,1565,3216075,2,29246,7313,1,131577400,131577400,10966,3655,7311,3655,0,1,3657,239022,0.239022
4055,2055,1565,3216075,2,32446,8113,1,143161400,143161400,12166,4055,8111,4055,0,1,4057,632852,0.632852
4455,2055,1565,3216075,2,35646,8913,1,154745400,154745400,13366,4455,8911,4455,0,1,4457,1022376,1.022376
4855,2055,1565,3216075,2,38846,9713,1,166329400,166329400,14566,4855,9711,4855,0,1,4857,333011,0.333011
5255,2055,1565,3216075,2,42046,10513,1,177913400,177913400,15766,5255,10511,5255,0,1,5257,618543,0.618543
5655,2055,1565,3216075,2,45246,11313,1,189497400,189497400,16966,5655,11311,5655,0,1,5657,172789,0.172789
6055,2055,1565,3216075,2,48446,12113,1,201081400,201081400,18166,6055,12111,6055,0,1,6057,1548003,1.548003
6455,2055,1565,3216075,2,51646,12913,1,212665400,212665400,19366,6455,12911,6455,0,1,6457,2105785,2.105785
6855,2055,1565,3216075,2,54846,13713,1,224249400,224249400,20566,6855,13711,6855,0,1,6857,4162306,4.162306
55,1305,2465,3216825,2,446,113,1,27393400,27393400,166,55,111,55,0,1,57,65590,0.06559
455,1305,2465,3216825,2,3646,913,1,39457400,39457400,1366,455,911,455,0,1,457,309613,0.309613
855,1305,2465,3216825,2,6846,1713,1,51521400,51521400,2566,855,1711,855,0,1,857,557584,0.557584
1255,1305,2465,3216825,2,10046,2513,1,63585400,63585400,3766,1255,2511,1255,0,1,1257,765888,0.765888
1655,1305,2465,3216825,2,13246,3313,1,75649400,75649400,4966,1655,3311,1655,0,1,1657,188662,0.188662
2055,1305,2465,3216825,2,16446,4113,1,87713400,87713400,6166,2055,4111,2055,0,1,2057,6373,0.006373
2455,1305,2465,3216825,2,19646,4913,1,99777400,99777400,7366,2455,4911,2455,0,1,2457,289753,0.289753
2855,1305,2465,3216825,2,22846,5713,1,111841400,111841400,8566,2855,5711,2855,0,1,2857,1806341,1.806341
3255,1305,2465,3216825,2,26046,6513,1,123905400,123905400,9766,3255,6511,3255,0,1,3257,703074,0.703074
3655,1305,2465,3216825,2,29246,7313,1,135969400,135969400,10966,3655,7311,3655,0,1,3657,632284,0.632284
4055,1305,2465,3216825,2,32446,8113,1,148033400,148033400,12166,4055,8111,4055,0,1,4057,645364,0.645364
4455,1305,2465,3216825,2,35646,8913,1,160097400,160097400,13366,4455,8911,4455,0,1,4457,1335303,1.335303
4855,1305,2465,3216825,2,38846,9713,1,172161400,172161400,14566,4855,9711,4855,0,1,4857,122159,0.122159
5255,1305,2465,3216825,2,42046,10513,1,184225400,184225400,15766,5255,10511,5255,0,1,5257,3109721,3.109721
5655,1305,2465,3216825,2,45246,11313,1,196289400,196289400,16966,5655,11311,5655,0,1,5657,469437,0.469437
6055,1305,2465,3216825,2,48446,12113,1,208353400,208353400,18166,6055,12111,6055,0,1,6057,89533,0.089533
6455,1305,2465,3216825,2,51646,12913,1,220417400,220417400,19366,6455,12911,6455,0,1,6457,440496,0.440496
6855,1305,2465,3216825,2,54846,13713,1,232481400,232481400,20566,6855,13711,6855,0,1,6857,208132,0.208132
40,5050,640,3232000,2,326,83,1,27676800,27676800,121,40,81,40,0,1,42,354,0.000354
440,5050,640,3232000,2,3526,883,1,45884800,45884800,1321,440,881,440,0,1,442,2584,0.002584
840,5050,640,3232000,2,6726,1683,1,64092800,64092800,2521,840,1681,840,0,1,842,3372,0.003372
1240,5050,640,3232000,2,9926,2483,1,82300800,82300800,3721,1240,2481,1240,0,1,1242,254218,0.254218
1640,5050,640,3232000,2,13126,3283,1,100508800,100508800,4921,1640,3281,1640,0,1,1642,107123,0.107123
2040,5050,640,3232000,2,16326,4083,1,118716800,118716800,6121,2040,4081,2040,0,1,2042,405669,0.405669
2440,5050,640,3232000,2,19526,4883,1,136924800,136924800,7321,2440,4881,2440,0,1,2442,65614,0.065614
2840,5050,640,3232000,2,22726,5683,1,155132800,155132800,8521,2840,5681,2840,0,1,2842,507065,0.507065
3240,5050,640,3232000,2,25926,6483,1,173340800,173340800,9721,3240,6481,3240,0,1,3242,556091,0.556091
3640,5050,640,3232000,2,29126,7283,1,191548800,191548800,10921,3640,7281,3640,0,1,3642,1150550,1.15055
4040,5050,640,3232000,2,32326,8083,1,209756800,209756800,12121,4040,8081,4040,0,1,4042,394418,0.394418
4440,5050,640,3232000,2,35526,8883,1,227964800,227964800,13321,4440,8881,4440,0,1,4442,656446,0.656446
4840,5050,640,3232000,2,38726,9683,1,246172800,246172800,14521,4840,9681,4840,0,1,4842,1812232,1.812232
5240,5050,640,3232000,2,41926,10483,1,264380800,264380800,15721,5240,10481,5240,0,1,5242,794042,0.794042
5640,5050,640,3232000,2,45126,11283,1,282588800,282588800,16921,5640,11281,5640,0,1,5642,794465,0.794465
6040,5050,640,3232000,2,48326,12083,1,300796800,300796800,18121,6040,12081,6040,0,1,6042,3574133,3.574133
6440,5050,640,3232000,2,51526,12883,1,319004800,319004800,19321,6440,12881,6440,0,1,6442,650744,0.650744
6840,5050,640,3232000,2,54726,13683,1,337212800,337212800,20521,6840,13681,6840,0,1,6842,243367,0.243367
55,2555,1265,3232075,2,446,113,1,27537400,27537400,166,55,111,55,0,1,57,65730,0.06573
455,2555,1265,3232075,2,3646,913,1,39761400,39761400,1366,455,911,455,0,1,457,301962,0.301962
855,2555,1265,3232075,2,6846,1713,1,51985400,51985400,2566,855,1711,855,0,1,857,542377,0.542377
1255,2555,1265,3232075,2,10046,2513,1,64209400,64209400,3766,1255,2511,1255,0,1,1257,182352,0.182352
1655,2555,1265,3232075,2,13246,3313,1,76433400,76433400,4966,1655,3311,1655,0,1,1657,1027098,1.027098
2055,2555,1265,3232075,2,16446,4113,1,88657400,88657400,6166,2055,4111,2055,0,1,2057,268993,0.268993
2455,2555,1265,3232075,2,19646,4913,1,100881400,100881400,7366,2455,4911,2455,0,1,2457,1084065,1.084065
2855,2555,1265,3232075,2,22846,5713,1,113105400,113105400,8566,2855,5711,2855,0,1,2857,1757398,1.757398
3255,2555,1265,3232075,2,26046,6513,1,125329400,125329400,9766,3255,6511,3255,0,1,3257,1998551,1.998551
3655,2555,1265,3232075,2,29246,7313,1,137553400,137553400,10966,3655,7311,3655,0,1,3657,1808922,1.808922
4055,2555,1265,3232075,2,32446,8113,1,149777400,149777400,12166,4055,8111,4055,0,1,4057,1592457,1.592457
4455,2555,1265,3232075,2,35646,8913,1,162001400,162001400,13366,4455,8911,4455,0,1,4457,2726912,2.726912
4855,2555,1265,3232075,2,38846,9713,1,174225400,174225400,14566,4855,9711,4855,0,1,4857,1221940,1.22194
5255,2555,1265,3232075,2,42046,10513,1,186449400,186449400,15766,5255,10511,5255,0,1,5257,159771,0.159771
5655,2555,1265,3232075,2,45246,11313,1,198673400,198673400,16966,5655,11311,5655,0,1,5657,99547,0.099547
6055,2555,1265,3232075,2,48446,12113,1,210897400,210897400,18166,6055,12111,6055,0,1,6057,1847435,1.847435
6455,2555,1265,3232075,2,51646,12913,1,223121400,223121400,19366,6455,12911,6455,0,1,6457,23034,0.023034
6855,2555,1265,3232075,2,54846,13713,1,235345400,235345400,20566,6855,13711,6855,0,1,6857,1796873,1.796873
55,1055,3065,3233575,2,446,113,1,27681400,27681400,166,55,111,55,0,1,57,319,0.000319
455,1055,3065,3233575,2,3646,913,1,40865400,40865400,1366,455,911,455,0,1,457,15242,0.015242
855,1055,3065,3233575,2,6846,1713,1,54049400,54049400,2566,855,1711,855,0,1,857,77707,0.077707
1255,1055,3065,3233575,2,10046,2513,1,67233400,67233400,3766,1255,2511,1255,0,1,1257,32071,0.032071
1655,1055,3065,3233575,2,13246,3313,1,80417400,80417400,4966,1655,3311,1655,0,1,1657,51871,0.051871
2055,1055,3065,3233575,2,16446,4113,1,93601400,93601400,6166,2055,4111,2055,0,1,2057,4874,0.004874
2455,1055,3065,3233575,2,19646,4913,1,106785400,106785400,7366,2455,4911,2455,0,1,2457,655924,0.655924
2855,1055,3065,3233575,2,22846,5713,1,119969400,119969400,8566,2855,5711,2855,0,1,2857,98708,0.098708
3255,1055,3065,3233575,2,26046,6513,1,133153400,133153400,9766,3255,6511,3255,0,1,3257,78560,0.07856
3655,1055,3065,3233575,2,29246,7313,1,146337400,146337400,10966,3655,7311,3655,0,1,3657,255738,0.255738
4055,1055,3065,3233575,2,32446,8113,1,159521400,159521400,12166,4055,8111,4055,0,1,4057,76437,0.076437
4455,1055,3065,3233575,2,35646,8913,1,172705400,172705400,13366,4455,8911,4455,0,1,4457,457635,0.457635
4855,1055,3065,3233575,2,38846,9713,1,185889400,185889400,14566,4855,9711,4855,0,1,4857,531259,0.531259
5255,1055,3065,3233575,2,42046,10513,1,199073400,199073400,15766,5255,10511,5255,0,1,5257,1248478,1.248478
5655,1055,3065,3233575,2,45246,11313,1,212257400,212257400,16966,5655,11311,5655,0,1,5657,446640,0.44664
6055,1055,3065,3233575,2,48446,12113,1,225441400,225441400,18166,6055,12111,6055,0,1,6057,352162,0.352162
6455,1055,3065,3233575,2,51646,12913,1,238625400,238625400,19366,6455,12911,6455,0,1,6457,1255942,1.255942
6855,1055,3065,3233575,2,54846,13713,1,251809400,251809400,20566,6855,13711,6855,0,1,6857,30902,0.030902
35,590,5545,3271550,2,286,73,1,27890200,27890200,106,35,71,35,0,1,37,10733,0.010733
535,590,5545,3271550,2,4286,1073,1,52430200,52430200,1606,535,1071,535,0,1,537,5744,0.005744
1035,590,5545,3271550,2,8286,2073,1,76970200,76970200,3106,1035,2071,1035,0,1,1037,44065,0.044065
1535,590,5545,3271550,2,12286,3073,1,101510200,101510200,4606,1535,3071,1535,0,1,1537,99852,0.099852
2035,590,5545,3271550,2,16286,4073,1,126050200,126050200,6106,2035,4071,2035,0,1,2037,159475,0.159475
2535,590,5545,3271550,2,20286,5073,1,150590200,150590200,7606,2535,5071,2535,0,1,2537,1656188,1.656188
3035,590,5545,3271550,2,24286,6073,1,175130200,175130200,9106,3035,6071,3035,0,1,3037,1984200,1.9842
3535,590,5545,3271550,2,28286,7073,1,199670200,199670200,10606,3535,7071,3535,0,1,3537,2320759,2.320759
4035,590,5545,3271550,2,32286,8073,1,224210200,224210200,12106,4035,8071,4035,0,1,4037,2668942,2.668942
4535,590,5545,3271550,2,36286,9073,1,248750200,248750200,13606,4535,9071,4535,0,1,4537,2987977,2.987977
5035,590,5545,3271550,2,40286,10073,1,273290200,273290200,15106,5035,10071,5035,0,1,5037,3318305,3.318305
5535,590,5545,3271550,2,44286,11073,1,297830200,297830200,16606,5535,11071,5535,0,1,5537,3649318,3.649318
6035,590,5545,3271550,2,48286,12073,1,322370200,322370200,18106,6035,12071,6035,0,1,6037,3976958,3.976958
6535,590,5545,3271550,2,52286,13073,1,346910200,346910200,19606,6535,13071,6535,0,1,6537,4370103,4.370103
7035,590,5545,3271550,2,56286,14073,1,371450200,371450200,21106,7035,14071,7035,0,1,7037,4639158,4.639158
39,593,5541,3285813,2,318,81,1,28200312,28200312,118,39,79,39,0,1,41,63666,0.063666
539,593,5541,3285813,2,4318,1081,1,52736312,52736312,1618,539,1079,539,0,1,541,365693,0.365693
1039,593,5541,3285813,2,8318,2081,1,77272312,77272312,3118,1039,2079,1039,0,1,1041,203419,0.203419
1539,593,5541,3285813,2,12318,3081,1,101808312,101808312,4618,1539,3079,1539,0,1,1541,104068,0.104068
2039,593,5541,3285813,2,16318,4081,1,126344312,126344312,6118,2039,4079,2039,0,1,2041,159497,0.159497
2539,593,5541,3285813,2,20318,5081,1,150880312,150880312,7618,2539,5079,2539,0,1,2541,44792,0.044792
3039,593,5541,3285813,2,24318,6081,1,175416312,175416312,9118,3039,6079,3039,0,1,3041,653284,0.653284
3539,593,5541,3285813,2,28318,7081,1,199952312,199952312,10618,3539,7079,3539,0,1,3541,761575,0.761575
4039,593,5541,3285813,2,32318,8081,1,224488312,224488312,12118,4039,8079,4039,0,1,4041,1613020,1.61302
4539,593,5541,3285813,2,36318,9081,1,249024312,249024312,13618,4539,9079,4539,0,1,4541,2502707,2.502707
5039,593,5541,3285813,2,40318,10081,1,273560312,273560312,15118,5039,10079,5039,0,1,5041,621895,0.621895
5539,593,5541,3285813,2,44318,11081,1,298096312,298096312,16618,5539,11079,5539,0,1,5541,476858,0.476858
6039,593,5541,3285813,2,48318,12081,1,322632312,322632312,18118,6039,12079,6039,0,1,6041,124668,0.124668
6539,593,5541,3285813,2,52318,13081,1,347168312,347168312,19618,6539,13079,6539,0,1,6541,1111158,1.111158
7039,593,5541,3285813,2,56318,14081,1,371704312,371704312,21118,7039,14079,7039,0,1,7041,1083302,1.083302
39,6093,541,3296313,2,318,81,1,28440312,28440312,118,39,79,39,0,1,41,845,0.000845
539,6093,541,3296313,2,4318,1081,1,54976312,54976312,1618,539,1079,539,0,1,541,14655,0.014655
1039,6093,541,3296313,2,8318,2081,1,81512312,81512312,3118,1039,2079,1039,0,1,1041,182550,0.18255
1539,6093,541,3296313,2,12318,3081,1,108048312,108048312,4618,1539,3079,1539,0,1,1541,680762,0.680762
2039,6093,541,3296313,2,16318,4081,1,134584312,134584312,6118,2039,4079,2039,0,1,2041,3658,0.003658
2539,6093,541,3296313,2,20318,5081,1,161120312,161120312,7618,2539,5079,2539,0,1,2541,152813,0.152813
3039,6093,541,3296313,2,24318,6081,1,187656312,187656312,9118,3039,6079,3039,0,1,3041,72364,0.072364
3539,6093,541,3296313,2,28318,7081,1,214192312,214192312,10618,3539,7079,3539,0,1,3541,1013372,1.013372
4039,6093,541,3296313,2,32318,8081,1,240728312,240728312,12118,4039,8079,4039,0,1,4041,2592464,2.592464
4539,6093,541,3296313,2,36318,9081,1,267264312,267264312,13618,4539,9079,4539,0,1,4541,1758023,1.758023
5039,6093,541,3296313,2,40318,10081,1,293800312,293800312,15118,5039,10079,5039,0,1,5041,3238620,3.23862
5539,6093,541,3296313,2,44318,11081,1,320336312,320336312,16618,5539,11079,5539,0,1,5541,2990752,2.990752
6039,6093,541,3296313,2,48318,12081,1,346872312,346872312,18118,6039,12079,6039,0,1,6041,2598589,2.598589
6539,6093,541,3296313,2,52318,13081,1,373408312,373408312,19618,6539,13079,6539,0,1,6541,101122,0.101122
7039,6093,541,3296313,2,56318,14081,1,399944312,399944312,21118,7039,14079,7039,0,1,7041,4573305,4.573305
35,6050,545,3297250,2,286,73,1,28224600,28224600,106,35,71,35,0,1,37,6671,0.006671
535,6050,545,3297250,2,4286,1073,1,54604600,54604600,1606,535,1071,535,0,1,537,12039,0.012039
1535,6050,545,3297250,2,12286,3073,1,107364600,107364600,4606,1535,3071,1535,0,1,1537,1017010,1.01701
2035,6050,545,3297250,2,16286,4073,1,133744600,133744600,6106,2035,4071,2035,0,1,2037,1342651,1.342651
2535,6050,545,3297250,2,20286,5073,1,160124600,160124600,7606,2535,5071,2535,0,1,2537,1569160,1.56916
3035,6050,545,3297250,2,24286,6073,1,186504600,186504600,9106,3035,6071,3035,0,1,3037,1995774,1.995774
3535,6050,545,3297250,2,28286,7073,1,212884600,212884600,10606,3535,7071,3535,0,1,3537,2324684,2.324684
4035,6050,545,3297250,2,32286,8073,1,239264600,239264600,12106,4035,8071,4035,0,1,4037,2671173,2.671173
4535,6050,545,3297250,2,36286,9073,1,265644600,265644600,13606,4535,9071,4535,0,1,4537,3008724,3.008724
5035,6050,545,3297250,2,40286,10073,1,292024600,292024600,15106,5035,10071,5035,0,1,5037,530176,0.530176
5535,6050,545,3297250,2,44286,11073,1,318404600,318404600,16606,5535,11071,5535,0,1,5537,3634611,3.634611
6035,6050,545,3297250,2,48286,12073,1,344784600,344784600,18106,6035,12071,6035,0,1,6037,874137,0.874137
6535,6050,545,3297250,2,52286,13073,1,371164600,371164600,19606,6535,13071,6535,0,1,6537,2903448,2.903448
7035,6050,545,3297250,2,56286,14073,1,397544600,397544600,21106,7035,14071,7035,0,1,7037,3874024,3.874024
40,1800,1840,3312000,2,326,83,1,27660800,27660800,121,40,81,40,0,1,42,61454,0.061454
440,1800,1840,3312000,2,3526,883,1,39308800,39308800,1321,440,881,440,0,1,442,303385,0.303385
840,1800,1840,3312000,2,6726,1683,1,50956800,50956800,2521,840,1681,840,0,1,842,550060,0.55006
1240,1800,1840,3312000,2,9926,2483,1,62604800,62604800,3721,1240,2481,1240,0,1,1242,801442,0.801442
1640,1800,1840,3312000,2,13126,3283,1,74252800,74252800,4921,1640,3281,1640,0,1,1642,1013309,1.013309
2040,1800,1840,3312000,2,16326,4083,1,85900800,85900800,6121,2040,4081,2040,0,1,2042,1298311,1.298311
2440,1800,1840,3312000,2,19526,4883,1,97548800,97548800,7321,2440,4881,2440,0,1,2442,1467713,1.467713
2840,1800,1840,3312000,2,22726,5683,1,109196800,109196800,8521,2840,5681,2840,0,1,2842,343889,0.343889
3240,1800,1840,3312000,2,25926,6483,1,120844800,120844800,9721,3240,6481,3240,0,1,3242,501617,0.501617
3640,1800,1840,3312000,2,29126,7283,1,132492800,132492800,10921,3640,7281,3640,0,1,3642,289439,0.289439
4040,1800,1840,3312000,2,32326,8083,1,144140800,144140800,12121,4040,8081,4040,0,1,4042,781123,0.781123
4440,1800,1840,3312000,2,35526,8883,1,155788800,155788800,13321,4440,8881,4440,0,1,4442,1760649,1.760649
4840,1800,1840,3312000,2,38726,9683,1,167436800,167436800,14521,4840,9681,4840,0,1,4842,637905,0.637905
5240,1800,1840,3312000,2,41926,10483,1,179084800,179084800,15721,5240,10481,5240,0,1,5242,1599208,1.599208
5640,1800,1840,3312000,2,45126,11283,1,190732800,190732800,16921,5640,11281,5640,0,1,5642,718929,0.718929
6040,1800,1840,3312000,2,48326,12083,1,202380800,202380800,18121,6040,12081,6040,0,1,6042,652740,0.65274
6440,1800,1840,3312000,2,51526,12883,1,214028800,214028800,19321,6440,12881,6440,0,1,6442,1812418,1.812418
6840,1800,1840,3312000,2,54726,13683,1,225676800,225676800,20521,6840,13681,6840,0,1,6842,2247132,2.247132
40,1550,2140,3317000,2,326,83,1,27716800,27716800,121,40,81,40,0,1,42,62764,0.062764
440,1550,2140,3317000,2,3526,883,1,39524800,39524800,1321,440,881,440,0,1,442,308191,0.308191
840,1550,2140,3317000,2,6726,1683,1,51332800,51332800,2521,840,1681,840,0,1,842,559180,0.55918
1240,1550,2140,3317000,2,9926,2483,1,63140800,63140800,3721,1240,2481,1240,0,1,1242,818577,0.818577
1640,1550,2140,3317000,2,13126,3283,1,74948800,74948800,4921,1640,3281,1640,0,1,1642,1073367,1.073367
2040,1550,2140,3317000,2,16326,4083,1,86756800,86756800,6121,2040,4081,2040,0,1,2042,923397,0.923397
2440,1550,2140,3317000,2,19526,4883,1,98564800,98564800,7321,2440,4881,2440,0,1,2442,642679,0.642679
2840,1550,2140,3317000,2,22726,5683,1,110372800,110372800,8521,2840,5681,2840,0,1,2842,1056054,1.056054
3240,1550,2140,3317000,2,25926,6483,1,122180800,122180800,9721,3240,6481,3240,0,1,3242,581837,0.581837
3640,1550,2140,3317000,2,29126,7283,1,133988800,133988800,10921,3640,7281,3640,0,1,3642,778938,0.778938
4040,1550,2140,3317000,2,32326,8083,1,145796800,145796800,12121,4040,8081,4040,0,1,4042,350368,0.350368
4440,1550,2140,3317000,2,35526,8883,1,157604800,157604800,13321,4440,8881,4440,0,1,4442,1614997,1.614997
4840,1550,2140,3317000,2,38726,9683,1,169412800,169412800,14521,4840,9681,4840,0,1,4842,1806034,1.806034
5240,1550,2140,3317000,2,41926,10483,1,181220800,181220800,15721,5240,10481,5240,0,1,5242,81586,0.081586
5640,1550,2140,3317000,2,45126,11283,1,193028800,193028800,16921,5640,11281,5640,0,1,5642,628692,0.628692
6040,1550,2140,3317000,2,48326,12083,1,204836800,204836800,18121,6040,12081,6040,0,1,6042,1469029,1.469029
6440,1550,2140,3317000,2,51526,12883,1,216644800,216644800,19321,6440,12881,6440,0,1,6442,3112303,3.112303
6840,1550,2140,3317000,2,54726,13683,1,228452800,228452800,20521,6840,13681,6840,0,1,6842,786029,0.786029
35,6090,545,3319050,2,286,73,1,28410200,28410200,106,35,71,35,0,1,37,3370,0.00337
535,6090,545,3319050,2,4286,1073,1,54950200,54950200,1606,535,1071,535,0,1,537,358587,0.358587
1035,6090,545,3319050,2,8286,2073,1,81490200,81490200,3106,1035,2071,1035,0,1,1037,700295,0.700295
1535,6090,545,3319050,2,12286,3073,1,108030200,108030200,4606,1535,3071,1535,0,1,1537,1025350,1.02535
40,550,6040,3322000,2,326,83,1,28684800,28684800,121,40,81,40,0,1,42,61317,0.061317
440,550,6040,3322000,2,3526,883,1,49772800,49772800,1321,440,881,440,0,1,442,302441,0.302441
840,550,6040,3322000,2,6726,1683,1,70860800,70860800,2521,840,1681,840,0,1,842,550590,0.55059
1240,550,6040,3322000,2,9926,2483,1,91948800,91948800,3721,1240,2481,1240,0,1,1242,95721,0.095721
1640,550,6040,3322000,2,13126,3283,1,113036800,113036800,4921,1640,3281,1640,0,1,1642,167635,0.167635
2040,550,6040,3322000,2,16326,4083,1,134124800,134124800,6121,2040,4081,2040,0,1,2042,1298623,1.298623
2440,550,6040,3322000,2,19526,4883,1,155212800,155212800,7321,2440,4881,2440,0,1,2442,344922,0.344922
2840,550,6040,3322000,2,22726,5683,1,176300800,176300800,8521,2840,5681,2840,0,1,2842,132838,0.132838
3240,550,6040,3322000,2,25926,6483,1,197388800,197388800,9721,3240,6481,3240,0,1,3242,961475,0.961475
3640,550,6040,3322000,2,29126,7283,1,218476800,218476800,10921,3640,7281,3640,0,1,3642,893982,0.893982
4040,550,6040,3322000,2,32326,8083,1,239564800,239564800,12121,4040,8081,4040,0,1,4042,345150,0.34515
4440,550,6040,3322000,2,35526,8883,1,260652800,260652800,13321,4440,8881,4440,0,1,4442,220390,0.22039
4840,550,6040,3322000,2,38726,9683,1,281740800,281740800,14521,4840,9681,4840,0,1,4842,1179139,1.179139
5240,550,6040,3322000,2,41926,10483,1,302828800,302828800,15721,5240,10481,5240,0,1,5242,1284057,1.284057
5640,550,6040,3322000,2,45126,11283,1,323916800,323916800,16921,5640,11281,5640,0,1,5642,55584,0.055584
6040,550,6040,3322000,2,48326,12083,1,345004800,345004800,18121,6040,12081,6040,0,1,6042,903951,0.903951
6440,550,6040,3322000,2,51526,12883,1,366092800,366092800,19321,6440,12881,6440,0,1,6442,799033,0.799033
6840,550,6040,3322000,2,54726,13683,1,387180800,387180800,20521,6840,13681,6840,0,1,6842,621814,0.621814
40,3550,940,3337000,2,326,83,1,28132800,28132800,121,40,81,40,0,1,42,59126,0.059126
440,3550,940,3337000,2,3526,883,1,42500800,42500800,1321,440,881,440,0,1,442,304845,0.304845
840,3550,940,3337000,2,6726,1683,1,56868800,56868800,2521,840,1681,840,0,1,842,79644,0.079644
1240,3550,940,3337000,2,9926,2483,1,71236800,71236800,3721,1240,2481,1240,0,1,1242,825052,0.825052
1640,3550,940,3337000,2,13126,3283,1,85604800,85604800,4921,1640,3281,1640,0,1,1642,136025,0.136025
2040,3550,940,3337000,2,16326,4083,1,99972800,99972800,6121,2040,4081,2040,0,1,2042,51174,0.051174
2440,3550,940,3337000,2,19526,4883,1,114340800,114340800,7321,2440,4881,2440,0,1,2442,1191998,1.191998
2840,3550,940,3337000,2,22726,5683,1,128708800,128708800,8521,2840,5681,2840,0,1,2842,753018,0.753018
3240,3550,940,3337000,2,25926,6483,1,143076800,143076800,9721,3240,6481,3240,0,1,3242,2104700,2.1047
3640,3550,940,3337000,2,29126,7283,1,157444800,157444800,10921,3640,7281,3640,0,1,3642,521632,0.521632
4040,3550,940,3337000,2,32326,8083,1,171812800,171812800,12121,4040,8081,4040,0,1,4042,149118,0.149118
4440,3550,940,3337000,2,35526,8883,1,186180800,186180800,13321,4440,8881,4440,0,1,4442,1299099,1.299099
4840,3550,940,3337000,2,38726,9683,1,200548800,200548800,14521,4840,9681,4840,0,1,4842,3143019,3.143019
5240,3550,940,3337000,2,41926,10483,1,214916800,214916800,15721,5240,10481,5240,0,1,5242,225016,0.225016
5640,3550,940,3337000,2,45126,11283,1,229284800,229284800,16921,5640,11281,5640,0,1,5642,3659594,3.659594
6040,3550,940,3337000,2,48326,12083,1,243652800,243652800,18121,6040,12081,6040,0,1,6042,2153544,2.153544
6440,3550,940,3337000,2,51526,12883,1,258020800,258020800,19321,6440,12881,6440,0,1,6442,721489,0.721489
6840,3550,940,3337000,2,54726,13683,1,272388800,272388800,20521,6840,13681,6840,0,1,6842,4447512,4.447512
44,603,5555,3349665,2,358,91,1,28964936,28964936,133,44,89,44,0,1,46,65150,0.06515
544,603,5555,3349665,2,4358,1091,1,53596936,53596936,1633,544,1089,544,0,1,546,138143,0.138143
1044,603,5555,3349665,2,8358,2091,1,78228936,78228936,3133,1044,2089,1044,0,1,1046,688339,0.688339
1544,603,5555,3349665,2,12358,3091,1,102860936,102860936,4633,1544,3089,1544,0,1,1546,661581,0.661581
2044,603,5555,3349665,2,16358,4091,1,127492936,127492936,6133,2044,4089,2044,0,1,2046,75739,0.075739
2544,603,5555,3349665,2,20358,5091,1,152124936,152124936,7633,2544,5089,2544,0,1,2546,37858,0.037858
3044,603,5555,3349665,2,24358,6091,1,176756936,176756936,9133,3044,6089,3044,0,1,3046,554008,0.554008
3544,603,5555,3349665,2,28358,7091,1,201388936,201388936,10633,3544,7089,3544,0,1,3546,273393,0.273393
4044,603,5555,3349665,2,32358,8091,1,226020936,226020936,12133,4044,8089,4044,0,1,4046,78268,0.078268
4544,603,5555,3349665,2,36358,9091,1,250652936,250652936,13633,4544,9089,4544,0,1,4546,1770162,1.770162
5044,603,5555,3349665,2,40358,10091,1,275284936,275284936,15133,5044,10089,5044,0,1,5046,466940,0.46694
5544,603,5555,3349665,2,44358,11091,1,299916936,299916936,16633,5544,11089,5544,0,1,5546,1051828,1.051828
6044,603,5555,3349665,2,48358,12091,1,324548936,324548936,18133,6044,12089,6044,0,1,6046,22656,0.022656
6544,603,5555,3349665,2,52358,13091,1,349180936,349180936,19633,6544,13089,6544,0,1,6546,341818,0.341818
7044,603,5555,3349665,2,56358,14091,1,373812936,373812936,21133,7044,14089,7044,0,1,7046,574664,0.574664
55,5055,665,3361575,2,446,113,1,29409400,29409400,166,55,111,55,0,1,57,7540,0.00754
455,5055,665,3361575,2,3646,913,1,47713400,47713400,1366,455,911,455,0,1,457,62982,0.062982
855,5055,665,3361575,2,6846,1713,1,66017400,66017400,2566,855,1711,855,0,1,857,25927,0.025927
1255,5055,665,3361575,2,10046,2513,1,84321400,84321400,3766,1255,2511,1255,0,1,1257,153727,0.153727
1655,5055,665,3361575,2,13246,3313,1,102625400,102625400,4966,1655,3311,1655,0,1,1657,362082,0.362082
2055,5055,665,3361575,2,16446,4113,1,120929400,120929400,6166,2055,4111,2055,0,1,2057,630933,0.630933
2455,5055,665,3361575,2,19646,4913,1,139233400,139233400,7366,2455,4911,2455,0,1,2457,311283,0.311283
2855,5055,665,3361575,2,22846,5713,1,157537400,157537400,8566,2855,5711,2855,0,1,2857,1240177,1.240177
3255,5055,665,3361575,2,26046,6513,1,175841400,175841400,9766,3255,6511,3255,0,1,3257,221587,0.221587
3655,5055,665,3361575,2,29246,7313,1,194145400,194145400,10966,3655,7311,3655,0,1,3657,12219,0.012219
4055,5055,665,3361575,2,32446,8113,1,212449400,212449400,12166,4055,8111,4055,0,1,4057,656443,0.656443
4455,5055,665,3361575,2,35646,8913,1,230753400,230753400,13366,4455,8911,4455,0,1,4457,2110695,2.110695
4855,5055,665,3361575,2,38846,9713,1,249057400,249057400,14566,4855,9711,4855,0,1,4857,1707924,1.707924
5255,5055,665,3361575,2,42046,10513,1,267361400,267361400,15766,5255,10511,5255,0,1,5257,1292888,1.292888
5655,5055,665,3361575,2,45246,11313,1,285665400,285665400,16966,5655,11311,5655,0,1,5657,3489949,3.489949
6055,5055,665,3361575,2,48446,12113,1,303969400,303969400,18166,6055,12111,6055,0,1,6057,2386767,2.386767
6455,5055,665,3361575,2,51646,12913,1,322273400,322273400,19366,6455,12911,6455,0,1,6457,272226,0.272226
6855,5055,665,3361575,2,54846,13713,1,340577400,340577400,20566,6855,13711,6855,0,1,6857,815874,0.815874
55,555,6065,3366075,2,446,113,1,29841400,29841400,166,55,111,55,0,1,57,70615,0.070615
455,555,6065,3366075,2,3646,913,1,51025400,51025400,1366,455,911,455,0,1,457,97786,0.097786
855,555,6065,3366075,2,6846,1713,1,72209400,72209400,2566,855,1711,855,0,1,857,579898,0.579898
1255,555,6065,3366075,2,10046,2513,1,93393400,93393400,3766,1255,2511,1255,0,1,1257,45771,0.045771
1655,555,6065,3366075,2,13246,3313,1,114577400,114577400,4966,1655,3311,1655,0,1,1657,192923,0.192923
2055,555,6065,3366075,2,16446,4113,1,135761400,135761400,6166,2055,4111,2055,0,1,2057,1353070,1.35307
2455,555,6065,3366075,2,19646,4913,1,156945400,156945400,7366,2455,4911,2455,0,1,2457,447633,0.447633
2855,555,6065,3366075,2,22846,5713,1,178129400,178129400,8566,2855,5711,2855,0,1,2857,589640,0.58964
3255,555,6065,3366075,2,26046,6513,1,199313400,199313400,9766,3255,6511,3255,0,1,3257,1198710,1.19871
3655,555,6065,3366075,2,29246,7313,1,220497400,220497400,10966,3655,7311,3655,0,1,3657,351775,0.351775
4055,555,6065,3366075,2,32446,8113,1,241681400,241681400,12166,4055,8111,4055,0,1,4057,17196,0.017196
4455,555,6065,3366075,2,35646,8913,1,262865400,262865400,13366,4455,8911,4455,0,1,4457,912248,0.912248
4855,555,6065,3366075,2,38846,9713,1,284049400,284049400,14566,4855,9711,4855,0,1,4857,1973338,1.973338
5255,555,6065,3366075,2,42046,10513,1,305233400,305233400,15766,5255,10511,5255,0,1,5257,63372,0.063372
5655,555,6065,3366075,2,45246,11313,1,326417400,326417400,16966,5655,11311,5655,0,1,5657,678904,0.678904
6055,555,6065,3366075,2,48446,12113,1,347601400,347601400,18166,6055,12111,6055,0,1,6057,261739,0.261739
6455,555,6065,3366075,2,51646,12913,1,368785400,368785400,19366,6455,12911,6455,0,1,6457,145462,0.145462
6855,555,6065,3366075,2,54846,13713,1,389969400,389969400,20566,6855,13711,6855,0,1,6857,393215,0.393215
55,1805,1865,3366325,2,446,113,1,28545400,28545400,166,55,111,55,0,1,57,71072,0.071072
455,1805,1865,3366325,2,3646,913,1,40289400,40289400,1366,455,911,455,0,1,457,325506,0.325506
855,1805,1865,3366325,2,6846,1713,1,52033400,52033400,2566,855,1711,855,0,1,857,588780,0.58878
1255,1805,1865,3366325,2,10046,2513,1,63777400,63777400,3766,1255,2511,1255,0,1,1257,289372,0.289372
1655,1805,1865,3366325,2,13246,3313,1,75521400,75521400,4966,1655,3311,1655,0,1,1657,948396,0.948396
2055,1805,1865,3366325,2,16446,4113,1,87265400,87265400,6166,2055,4111,2055,0,1,2057,47420,0.04742
2455,1805,1865,3366325,2,19646,4913,1,99009400,99009400,7366,2455,4911,2455,0,1,2457,1053834,1.053834
2855,1805,1865,3366325,2,22846,5713,1,110753400,110753400,8566,2855,5711,2855,0,1,2857,83330,0.08333
3255,1805,1865,3366325,2,26046,6513,1,122497400,122497400,9766,3255,6511,3255,0,1,3257,465827,0.465827
3655,1805,1865,3366325,2,29246,7313,1,134241400,134241400,10966,3655,7311,3655,0,1,3657,1146427,1.146427
4055,1805,1865,3366325,2,32446,8113,1,145985400,145985400,12166,4055,8111,4055,0,1,4057,2680777,2.680777
4455,1805,1865,3366325,2,35646,8913,1,157729400,157729400,13366,4455,8911,4455,0,1,4457,1559061,1.559061
4855,1805,1865,3366325,2,38846,9713,1,169473400,169473400,14566,4855,9711,4855,0,1,4857,3209153,3.209153
5255,1805,1865,3366325,2,42046,10513,1,181217400,181217400,15766,5255,10511,5255,0,1,5257,2531064,2.531064
5655,1805,1865,3366325,2,45246,11313,1,192961400,192961400,16966,5655,11311,5655,0,1,5657,73931,0.073931
6055,1805,1865,3366325,2,48446,12113,1,204705400,204705400,18166,6055,12111,6055,0,1,6057,1977822,1.977822
6455,1805,1865,3366325,2,51646,12913,1,216449400,216449400,19366,6455,12911,6455,0,1,6457,883073,0.883073
6855,1805,1865,3366325,2,54846,13713,1,228193400,228193400,20566,6855,13711,6855,0,1,6857,1414070,1.41407
55,1555,2165,3366575,2,446,113,1,28569400,28569400,166,55,111,55,0,1,57,69399,0.069399
455,1555,2165,3366575,2,3646,913,1,40473400,40473400,1366,455,911,455,0,1,457,325406,0.325406
855,1555,2165,3366575,2,6846,1713,1,52377400,52377400,2566,855,1711,855,0,1,857,585430,0.58543
1255,1555,2165,3366575,2,10046,2513,1,64281400,64281400,3766,1255,2511,1255,0,1,1257,18378,0.018378
1655,1555,2165,3366575,2,13246,3313,1,76185400,76185400,4966,1655,3311,1655,0,1,1657,1106270,1.10627
2055,1555,2165,3366575,2,16446,4113,1,88089400,88089400,6166,2055,4111,2055,0,1,2057,517956,0.517956
2455,1555,2165,3366575,2,19646,4913,1,99993400,99993400,7366,2455,4911,2455,0,1,2457,299650,0.29965
2855,1555,2165,3366575,2,22846,5713,1,111897400,111897400,8566,2855,5711,2855,0,1,2857,1889888,1.889888
3255,1555,2165,3366575,2,26046,6513,1,123801400,123801400,9766,3255,6511,3255,0,1,3257,2163149,2.163149
3655,1555,2165,3366575,2,29246,7313,1,135705400,135705400,10966,3655,7311,3655,0,1,3657,2414940,2.41494
4055,1555,2165,3366575,2,32446,8113,1,147609400,147609400,12166,4055,8111,4055,0,1,4057,1838403,1.838403
4455,1555,2165,3366575,2,35646,8913,1,159513400,159513400,13366,4455,8911,4455,0,1,4457,2690072,2.690072
4855,1555,2165,3366575,2,38846,9713,1,171417400,171417400,14566,4855,9711,4855,0,1,4857,814830,0.81483
5255,1555,2165,3366575,2,42046,10513,1,183321400,183321400,15766,5255,10511,5255,0,1,5257,2257157,2.257157
5655,1555,2165,3366575,2,45246,11313,1,195225400,195225400,16966,5655,11311,5655,0,1,5657,1692270,1.69227
6055,1555,2165,3366575,2,48446,12113,1,207129400,207129400,18166,6055,12111,6055,0,1,6057,43405,0.043405
6455,1555,2165,3366575,2,51646,12913,1,219033400,219033400,19366,6455,12911,6455,0,1,6457,1027871,1.027871
6855,1555,2165,3366575,2,54846,13713,1,230937400,230937400,20566,6855,13711,6855,0,1,6857,4539528,4.539528
44,6103,555,3387165,2,358,91,1,29440936,29440936,133,44,89,44,0,1,46,3591,0.003591
544,6103,555,3387165,2,4358,1091,1,56072936,56072936,1633,544,1089,544,0,1,546,16479,0.016479
1044,6103,555,3387165,2,8358,2091,1,82704936,82704936,3133,1044,2089,1044,0,1,1046,74924,0.074924
1544,6103,555,3387165,2,12358,3091,1,109336936,109336936,4633,1544,3089,1544,0,1,1546,39109,0.039109
2044,6103,555,3387165,2,16358,4091,1,135968936,135968936,6133,2044,4089,2044,0,1,2046,1350367,1.350367
2544,6103,555,3387165,2,20358,5091,1,162600936,162600936,7633,2544,5089,2544,0,1,2546,436611,0.436611
3044,6103,555,3387165,2,24358,6091,1,189232936,189232936,9133,3044,6089,3044,0,1,3046,38745,0.038745
3544,6103,555,3387165,2,28358,7091,1,215864936,215864936,10633,3544,7089,3544,0,1,3546,1044075,1.044075
4044,6103,555,3387165,2,32358,8091,1,242496936,242496936,12133,4044,8089,4044,0,1,4046,27434,0.027434
4544,6103,555,3387165,2,36358,9091,1,269128936,269128936,13633,4544,9089,4544,0,1,4546,433763,0.433763
5044,6103,555,3387165,2,40358,10091,1,295760936,295760936,15133,5044,10089,5044,0,1,5046,49468,0.049468
5544,6103,555,3387165,2,44358,11091,1,322392936,322392936,16633,5544,11089,5544,0,1,5546,379028,0.379028
6044,6103,555,3387165,2,48358,12091,1,349024936,349024936,18133,6044,12089,6044,0,1,6046,111553,0.111553
6544,6103,555,3387165,2,52358,13091,1,375656936,375656936,19633,6544,13089,6544,0,1,6546,256632,0.256632
7044,6103,555,3387165,2,56358,14091,1,402288936,402288936,21133,7044,14089,7044,0,1,7046,2247497,2.247497
40,800,4240,3392000,2,326,83,1,28748800,28748800,121,40,81,40,0,1,42,70358,0.070358
440,800,4240,3392000,2,3526,883,1,44876800,44876800,1321,440,881,440,0,1,442,300867,0.300867
840,800,4240,3392000,2,6726,1683,1,61004800,61004800,2521,840,1681,840,0,1,842,550511,0.550511
1240,800,4240,3392000,2,9926,2483,1,77132800,77132800,3721,1240,2481,1240,0,1,1242,701856,0.701856
1640,800,4240,3392000,2,13126,3283,1,93260800,93260800,4921,1640,3281,1640,0,1,1642,275485,0.275485
2040,800,4240,3392000,2,16326,4083,1,109388800,109388800,6121,2040,4081,2040,0,1,2042,44154,0.044154
2440,800,4240,3392000,2,19526,4883,1,125516800,125516800,7321,2440,4881,2440,0,1,2442,1547976,1.547976
2840,800,4240,3392000,2,22726,5683,1,141644800,141644800,8521,2840,5681,2840,0,1,2842,801752,0.801752
3240,800,4240,3392000,2,25926,6483,1,157772800,157772800,9721,3240,6481,3240,0,1,3242,371289,0.371289
3640,800,4240,3392000,2,29126,7283,1,173900800,173900800,10921,3640,7281,3640,0,1,3642,461965,0.461965
4040,800,4240,3392000,2,32326,8083,1,190028800,190028800,12121,4040,8081,4040,0,1,4042,1005872,1.005872
4440,800,4240,3392000,2,35526,8883,1,206156800,206156800,13321,4440,8881,4440,0,1,4442,460978,0.460978
4840,800,4240,3392000,2,38726,9683,1,222284800,222284800,14521,4840,9681,4840,0,1,4842,133464,0.133464
5240,800,4240,3392000,2,41926,10483,1,238412800,238412800,15721,5240,10481,5240,0,1,5242,802881,0.802881
5640,800,4240,3392000,2,45126,11283,1,254540800,254540800,16921,5640,11281,5640,0,1,5642,353262,0.353262
6040,800,4240,3392000,2,48326,12083,1,270668800,270668800,18121,6040,12081,6040,0,1,6042,160032,0.160032
6440,800,4240,3392000,2,51526,12883,1,286796800,286796800,19321,6440,12881,6440,0,1,6442,1110989,1.110989
6840,800,4240,3392000,2,54726,13683,1,302924800,302924800,20521,6840,13681,6840,0,1,6842,525581,0.525581
40,5300,640,3392000,2,326,83,1,29036800,29036800,121,40,81,40,0,1,42,60080,0.06008
440,5300,640,3392000,2,3526,883,1,48044800,48044800,1321,440,881,440,0,1,442,301193,0.301193
840,5300,640,3392000,2,6726,1683,1,67052800,67052800,2521,840,1681,840,0,1,842,561638,0.561638
1240,5300,640,3392000,2,9926,2483,1,86060800,86060800,3721,1240,2481,1240,0,1,1242,822725,0.822725
1640,5300,640,3392000,2,13126,3283,1,105068800,105068800,4921,1640,3281,1640,0,1,1642,1078147,1.078147
2040,5300,640,3392000,2,16326,4083,1,124076800,124076800,6121,2040,4081,2040,0,1,2042,1342013,1.342013
2440,5300,640,3392000,2,19526,4883,1,143084800,143084800,7321,2440,4881,2440,0,1,2442,1597435,1.597435
2840,5300,640,3392000,2,22726,5683,1,162092800,162092800,8521,2840,5681,2840,0,1,2842,1835033,1.835033
3240,5300,640,3392000,2,25926,6483,1,181100800,181100800,9721,3240,6481,3240,0,1,3242,1599659,1.599659
3640,5300,640,3392000,2,29126,7283,1,200108800,200108800,10921,3640,7281,3640,0,1,3642,1868984,1.868984
4040,5300,640,3392000,2,32326,8083,1,219116800,219116800,12121,4040,8081,4040,0,1,4042,319385,0.319385
4440,5300,640,3392000,2,35526,8883,1,238124800,238124800,13321,4440,8881,4440,0,1,4442,184886,0.184886
4840,5300,640,3392000,2,38726,9683,1,257132800,257132800,14521,4840,9681,4840,0,1,4842,1123893,1.123893
5240,5300,640,3392000,2,41926,10483,1,276140800,276140800,15721,5240,10481,5240,0,1,5242,2520800,2.5208
5640,5300,640,3392000,2,45126,11283,1,295148800,295148800,16921,5640,11281,5640,0,1,5642,1693810,1.69381
6040,5300,640,3392000,2,48326,12083,1,314156800,314156800,18121,6040,12081,6040,0,1,6042,2360740,2.36074
6440,5300,640,3392000,2,51526,12883,1,333164800,333164800,19321,6440,12881,6440,0,1,6442,525333,0.525333
6840,5300,640,3392000,2,54726,13683,1,352172800,352172800,20521,6840,13681,6840,0,1,6842,2519650,2.51965
55,3555,965,3430575,2,446,113,1,29433400,29433400,166,55,111,55,0,1,57,70128,0.070128
455,3555,965,3430575,2,3646,913,1,43897400,43897400,1366,455,911,455,0,1,457,326251,0.326251
855,3555,965,3430575,2,6846,1713,1,58361400,58361400,2566,855,1711,855,0,1,857,45699,0.045699
1255,3555,965,3430575,2,10046,2513,1,72825400,72825400,3766,1255,2511,1255,0,1,1257,498225,0.498225
1655,3555,965,3430575,2,13246,3313,1,87289400,87289400,4966,1655,3311,1655,0,1,1657,1134213,1.134213
2055,3555,965,3430575,2,16446,4113,1,101753400,101753400,6166,2055,4111,2055,0,1,2057,1100836,1.100836
2455,3555,965,3430575,2,19646,4913,1,116217400,116217400,7366,2455,4911,2455,0,1,2457,677490,0.67749
2855,3555,965,3430575,2,22846,5713,1,130681400,130681400,8566,2855,5711,2855,0,1,2857,1360210,1.36021
3255,3555,965,3430575,2,26046,6513,1,145145400,145145400,9766,3255,6511,3255,0,1,3257,1929343,1.929343
3655,3555,965,3430575,2,29246,7313,1,159609400,159609400,10966,3655,7311,3655,0,1,3657,1461969,1.461969
4055,3555,965,3430575,2,32446,8113,1,174073400,174073400,12166,4055,8111,4055,0,1,4057,2745710,2.74571
4455,3555,965,3430575,2,35646,8913,1,188537400,188537400,13366,4455,8911,4455,0,1,4457,1620818,1.620818
4855,3555,965,3430575,2,38846,9713,1,203001400,203001400,14566,4855,9711,4855,0,1,4857,325049,0.325049
5255,3555,965,3430575,2,42046,10513,1,217465400,217465400,15766,5255,10511,5255,0,1,5257,1151176,1.151176
5655,3555,965,3430575,2,45246,11313,1,231929400,231929400,16966,5655,11311,5655,0,1,5657,3384432,3.384432
6055,3555,965,3430575,2,48446,12113,1,246393400,246393400,18166,6055,12111,6055,0,1,6057,1482523,1.482523
6455,3555,965,3430575,2,51646,12913,1,260857400,260857400,19366,6455,12911,6455,0,1,6457,63393,0.063393
6855,3555,965,3430575,2,54846,13713,1,275321400,275321400,20566,6855,13711,6855,0,1,6857,1647384,1.647384
55,805,4265,3433325,2,446,113,1,29697400,29697400,166,55,111,55,0,1,57,81910,0.08191
455,805,4265,3433325,2,3646,913,1,45921400,45921400,1366,455,911,455,0,1,457,326325,0.326325
855,805,4265,3433325,2,6846,1713,1,62145400,62145400,2566,855,1711,855,0,1,857,155558,0.155558
1255,805,4265,3433325,2,10046,2513,1,78369400,78369400,3766,1255,2511,1255,0,1,1257,315026,0.315026
1655,805,4265,3433325,2,13246,3313,1,94593400,94593400,4966,1655,3311,1655,0,1,1657,1104622,1.104622
2055,805,4265,3433325,2,16446,4113,1,110817400,110817400,6166,2055,4111,2055,0,1,2057,1368940,1.36894
2455,805,4265,3433325,2,19646,4913,1,127041400,127041400,7366,2455,4911,2455,0,1,2457,15544,0.015544
2855,805,4265,3433325,2,22846,5713,1,143265400,143265400,8566,2855,5711,2855,0,1,2857,175097,0.175097
3255,805,4265,3433325,2,26046,6513,1,159489400,159489400,9766,3255,6511,3255,0,1,3257,370614,0.370614
3655,805,4265,3433325,2,29246,7313,1,175713400,175713400,10966,3655,7311,3655,0,1,3657,1580870,1.58087
4055,805,4265,3433325,2,32446,8113,1,191937400,191937400,12166,4055,8111,4055,0,1,4057,222681,0.222681
4455,805,4265,3433325,2,35646,8913,1,208161400,208161400,13366,4455,8911,4455,0,1,4457,881862,0.881862
4855,805,4265,3433325,2,38846,9713,1,224385400,224385400,14566,4855,9711,4855,0,1,4857,1189531,1.189531
5255,805,4265,3433325,2,42046,10513,1,240609400,240609400,15766,5255,10511,5255,0,1,5257,188806,0.188806
5655,805,4265,3433325,2,45246,11313,1,256833400,256833400,16966,5655,11311,5655,0,1,5657,2508832,2.508832
6055,805,4265,3433325,2,48446,12113,1,273057400,273057400,18166,6055,12111,6055,0,1,6057,1294514,1.294514
6455,805,4265,3433325,2,51646,12913,1,289281400,289281400,19366,6455,12911,6455,0,1,6457,419593,0.419593
6855,805,4265,3433325,2,54846,13713,1,305505400,305505400,20566,6855,13711,6855,0,1,6857,1113504,1.113504
39,1693,2041,3455413,2,318,81,1,28808312,28808312,118,39,79,39,0,1,41,62065,0.062065
539,1693,2041,3455413,2,4318,1081,1,43744312,43744312,1618,539,1079,539,0,1,541,392831,0.392831
1039,1693,2041,3455413,2,8318,2081,1,58680312,58680312,3118,1039,2079,1039,0,1,1041,729831,0.729831
1539,1693,2041,3455413,2,12318,3081,1,73616312,73616312,4618,1539,3079,1539,0,1,1541,148146,0.148146
2039,1693,2041,3455413,2,16318,4081,1,88552312,88552312,6118,2039,4079,2039,0,1,2041,1122525,1.122525
2539,1693,2041,3455413,2,20318,5081,1,103488312,103488312,7618,2539,5079,2539,0,1,2541,1431491,1.431491
3039,1693,2041,3455413,2,24318,6081,1,118424312,118424312,9118,3039,6079,3039,0,1,3041,2070467,2.070467
3539,1693,2041,3455413,2,28318,7081,1,133360312,133360312,10618,3539,7079,3539,0,1,3541,958873,0.958873
4039,1693,2041,3455413,2,32318,8081,1,148296312,148296312,12118,4039,8079,4039,0,1,4041,247288,0.247288
4539,1693,2041,3455413,2,36318,9081,1,163232312,163232312,13618,4539,9079,4539,0,1,4541,3094589,3.094589
5039,1693,2041,3455413,2,40318,10081,1,178168312,178168312,15118,5039,10079,5039,0,1,5041,2940844,2.940844
5539,1693,2041,3455413,2,44318,11081,1,193104312,193104312,16618,5539,11079,5539,0,1,5541,211597,0.211597
6039,1693,2041,3455413,2,48318,12081,1,208040312,208040312,18118,6039,12079,6039,0,1,6041,596606,0.596606
6539,1693,2041,3455413,2,52318,13081,1,222976312,222976312,19618,6539,13079,6539,0,1,6541,2760644,2.760644
7039,1693,2041,3455413,2,56318,14081,1,237912312,237912312,21118,7039,14079,7039,0,1,7041,2330345,2.330345
39,2243,1541,3456463,2,318,81,1,28832312,28832312,118,39,79,39,0,1,41,6212,0.006212
539,2243,1541,3456463,2,4318,1081,1,43968312,43968312,1618,539,1079,539,0,1,541,66472,0.066472
1039,2243,1541,3456463,2,8318,2081,1,59104312,59104312,3118,1039,2079,1039,0,1,1041,211652,0.211652
1539,2243,1541,3456463,2,12318,3081,1,74240312,74240312,4618,1539,3079,1539,0,1,1541,92878,0.092878
2039,2243,1541,3456463,2,16318,4081,1,89376312,89376312,6118,2039,4079,2039,0,1,2041,225969,0.225969
2539,2243,1541,3456463,2,20318,5081,1,104512312,104512312,7618,2539,5079,2539,0,1,2541,643417,0.643417
3039,2243,1541,3456463,2,24318,6081,1,119648312,119648312,9118,3039,6079,3039,0,1,3041,6281,0.006281
3539,2243,1541,3456463,2,28318,7081,1,134784312,134784312,10618,3539,7079,3539,0,1,3541,224254,0.224254
4039,2243,1541,3456463,2,32318,8081,1,149920312,149920312,12118,4039,8079,4039,0,1,4041,1242550,1.24255
4539,2243,1541,3456463,2,36318,9081,1,165056312,165056312,13618,4539,9079,4539,0,1,4541,2239376,2.239376
5039,2243,1541,3456463,2,40318,10081,1,180192312,180192312,15118,5039,10079,5039,0,1,5041,995388,0.995388
5539,2243,1541,3456463,2,44318,11081,1,195328312,195328312,16618,5539,11079,5539,0,1,5541,10639,0.010639
6039,2243,1541,3456463,2,48318,12081,1,210464312,210464312,18118,6039,12079,6039,0,1,6041,4002770,4.00277
6539,2243,1541,3456463,2,52318,13081,1,225600312,225600312,19618,6539,13079,6539,0,1,6541,1090916,1.090916
7039,2243,1541,3456463,2,56318,14081,1,240736312,240736312,21118,7039,14079,7039,0,1,7041,550469,0.550469
35,2240,1545,3460800,2,286,73,1,28746200,28746200,106,35,71,35,0,1,37,74483,0.074483
535,2240,1545,3460800,2,4286,1073,1,43886200,43886200,1606,535,1071,535,0,1,537,372920,0.37292
1035,2240,1545,3460800,2,8286,2073,1,59026200,59026200,3106,1035,2071,1035,0,1,1037,697802,0.697802
1535,2240,1545,3460800,2,12286,3073,1,74166200,74166200,4606,1535,3071,1535,0,1,1537,1022372,1.022372
2035,2240,1545,3460800,2,16286,4073,1,89306200,89306200,6106,2035,4071,2035,0,1,2037,1357912,1.357912
2535,2240,1545,3460800,2,20286,5073,1,104446200,104446200,7606,2535,5071,2535,0,1,2537,1678212,1.678212
35,1140,3045,3471300,2,286,73,1,28942200,28942200,106,35,71,35,0,1,37,74283,0.074283
535,1140,3045,3471300,2,4286,1073,1,45682200,45682200,1606,535,1071,535,0,1,537,378730,0.37873
1035,1140,3045,3471300,2,8286,2073,1,62422200,62422200,3106,1035,2071,1035,0,1,1037,697415,0.697415
1535,1140,3045,3471300,2,12286,3073,1,79162200,79162200,4606,1535,3071,1535,0,1,1537,1026386,1.026386
2035,1140,3045,3471300,2,16286,4073,1,95902200,95902200,6106,2035,4071,2035,0,1,2037,1355941,1.355941
2535,1140,3045,3471300,2,20286,5073,1,112642200,112642200,7606,2535,5071,2535,0,1,2537,1685450,1.68545
3035,1140,3045,3471300,2,24286,6073,1,129382200,129382200,9106,3035,6071,3035,0,1,3037,2011031,2.011031
3535,1140,3045,3471300,2,28286,7073,1,146122200,146122200,10606,3535,7071,3535,0,1,3537,2340248,2.340248
4035,1140,3045,3471300,2,32286,8073,1,162862200,162862200,12106,4035,8071,4035,0,1,4037,2669252,2.669252
40,2800,1240,3472000,2,326,83,1,29068800,29068800,121,40,81,40,0,1,42,61563,0.061563
440,2800,1240,3472000,2,3526,883,1,41996800,41996800,1321,440,881,440,0,1,442,314084,0.314084
840,2800,1240,3472000,2,6726,1683,1,54924800,54924800,2521,840,1681,840,0,1,842,217847,0.217847
1240,2800,1240,3472000,2,9926,2483,1,67852800,67852800,3721,1240,2481,1240,0,1,1242,117809,0.117809
1640,2800,1240,3472000,2,13126,3283,1,80780800,80780800,4921,1640,3281,1640,0,1,1642,292240,0.29224
2040,2800,1240,3472000,2,16326,4083,1,93708800,93708800,6121,2040,4081,2040,0,1,2042,1347146,1.347146
2440,2800,1240,3472000,2,19526,4883,1,106636800,106636800,7321,2440,4881,2440,0,1,2442,585514,0.585514
2840,2800,1240,3472000,2,22726,5683,1,119564800,119564800,8521,2840,5681,2840,0,1,2842,1088128,1.088128
3240,2800,1240,3472000,2,25926,6483,1,132492800,132492800,9721,3240,6481,3240,0,1,3242,287903,0.287903
3640,2800,1240,3472000,2,29126,7283,1,145420800,145420800,10921,3640,7281,3640,0,1,3642,2388333,2.388333
4040,2800,1240,3472000,2,32326,8083,1,158348800,158348800,12121,4040,8081,4040,0,1,4042,2495189,2.495189
4440,2800,1240,3472000,2,35526,8883,1,171276800,171276800,13321,4440,8881,4440,0,1,4442,2908553,2.908553
4840,2800,1240,3472000,2,38726,9683,1,184204800,184204800,14521,4840,9681,4840,0,1,4842,3170042,3.170042
5240,2800,1240,3472000,2,41926,10483,1,197132800,197132800,15721,5240,10481,5240,0,1,5242,1283231,1.283231
5640,2800,1240,3472000,2,45126,11283,1,210060800,210060800,16921,5640,11281,5640,0,1,5642,1181373,1.181373
6040,2800,1240,3472000,2,48326,12083,1,222988800,222988800,18121,6040,12081,6040,0,1,6042,620084,0.620084
6440,2800,1240,3472000,2,51526,12883,1,235916800,235916800,19321,6440,12881,6440,0,1,6442,56667,0.056667
6840,2800,1240,3472000,2,54726,13683,1,248844800,248844800,20521,6840,13681,6840,0,1,6842,4476705,4.476705
39,1143,3041,3475863,2,318,81,1,29112312,29112312,118,39,79,39,0,1,41,23228,0.023228
539,1143,3041,3475863,2,4318,1081,1,45848312,45848312,1618,539,1079,539,0,1,541,33878,0.033878
1039,1143,3041,3475863,2,8318,2081,1,62584312,62584312,3118,1039,2079,1039,0,1,1041,137926,0.137926
1539,1143,3041,3475863,2,12318,3081,1,79320312,79320312,4618,1539,3079,1539,0,1,1541,99347,0.099347
2039,1143,3041,3475863,2,16318,4081,1,96056312,96056312,6118,2039,4079,2039,0,1,2041,81214,0.081214
2539,1143,3041,3475863,2,20318,5081,1,112792312,112792312,7618,2539,5079,2539,0,1,2541,262300,0.2623
3039,1143,3041,3475863,2,24318,6081,1,129528312,129528312,9118,3039,6079,3039,0,1,3041,187277,0.187277
3539,1143,3041,3475863,2,28318,7081,1,146264312,146264312,10618,3539,7079,3539,0,1,3541,1264787,1.264787
4039,1143,3041,3475863,2,32318,8081,1,163000312,163000312,12118,4039,8079,4039,0,1,4041,1126255,1.126255
4539,1143,3041,3475863,2,36318,9081,1,179736312,179736312,13618,4539,9079,4539,0,1,4541,1298675,1.298675
5039,1143,3041,3475863,2,40318,10081,1,196472312,196472312,15118,5039,10079,5039,0,1,5041,58583,0.058583
5539,1143,3041,3475863,2,44318,11081,1,213208312,213208312,16618,5539,11079,5539,0,1,5541,935177,0.935177
6039,1143,3041,3475863,2,48318,12081,1,229944312,229944312,18118,6039,12079,6039,0,1,6041,372783,0.372783
6539,1143,3041,3475863,2,52318,13081,1,246680312,246680312,19618,6539,13079,6539,0,1,6541,1323401,1.323401
7039,1143,3041,3475863,2,56318,14081,1,263416312,263416312,21118,7039,14079,7039,0,1,7041,2497690,2.49769
39,3343,1041,3480063,2,318,81,1,29208312,29208312,118,39,79,39,0,1,41,262,0.000262
539,3343,1041,3480063,2,4318,1081,1,46744312,46744312,1618,539,1079,539,0,1,541,4892,0.004892
1039,3343,1041,3480063,2,8318,2081,1,64280312,64280312,3118,1039,2079,1039,0,1,1041,350741,0.350741
1539,3343,1041,3480063,2,12318,3081,1,81816312,81816312,4618,1539,3079,1539,0,1,1541,62842,0.062842
2039,3343,1041,3480063,2,16318,4081,1,99352312,99352312,6118,2039,4079,2039,0,1,2041,1113668,1.113668
2539,3343,1041,3480063,2,20318,5081,1,116888312,116888312,7618,2539,5079,2539,0,1,2541,925331,0.925331
3039,3343,1041,3480063,2,24318,6081,1,134424312,134424312,9118,3039,6079,3039,0,1,3041,9245,0.009245
3539,3343,1041,3480063,2,28318,7081,1,151960312,151960312,10618,3539,7079,3539,0,1,3541,1484808,1.484808
4039,3343,1041,3480063,2,32318,8081,1,169496312,169496312,12118,4039,8079,4039,0,1,4041,2780415,2.780415
4539,3343,1041,3480063,2,36318,9081,1,187032312,187032312,13618,4539,9079,4539,0,1,4541,352112,0.352112
5039,3343,1041,3480063,2,40318,10081,1,204568312,204568312,15118,5039,10079,5039,0,1,5041,338288,0.338288
5539,3343,1041,3480063,2,44318,11081,1,222104312,222104312,16618,5539,11079,5539,0,1,5541,512458,0.512458
6039,3343,1041,3480063,2,48318,12081,1,239640312,239640312,18118,6039,12079,6039,0,1,6041,4184697,4.184697
6539,3343,1041,3480063,2,52318,13081,1,257176312,257176312,19618,6539,13079,6539,0,1,6541,123805,0.123805
7039,3343,1041,3480063,2,56318,14081,1,274712312,274712312,21118,7039,14079,7039,0,1,7041,472903,0.472903
40,550,6340,3487000,2,326,83,1,30100800,30100800,121,40,81,40,0,1,42,64600,0.0646
440,550,6340,3487000,2,3526,883,1,52148800,52148800,1321,440,881,440,0,1,442,168781,0.168781
840,550,6340,3487000,2,6726,1683,1,74196800,74196800,2521,840,1681,840,0,1,842,182919,0.182919
1240,550,6340,3487000,2,9926,2483,1,96244800,96244800,3721,1240,2481,1240,0,1,1242,848399,0.848399
1640,550,6340,3487000,2,13126,3283,1,118292800,118292800,4921,1640,3281,1640,0,1,1642,42067,0.042067
2040,550,6340,3487000,2,16326,4083,1,140340800,140340800,6121,2040,4081,2040,0,1,2042,718895,0.718895
2440,550,6340,3487000,2,19526,4883,1,162388800,162388800,7321,2440,4881,2440,0,1,2442,240247,0.240247
2840,550,6340,3487000,2,22726,5683,1,184436800,184436800,8521,2840,5681,2840,0,1,2842,252260,0.25226
3240,550,6340,3487000,2,25926,6483,1,206484800,206484800,9721,3240,6481,3240,0,1,3242,1316278,1.316278
3640,550,6340,3487000,2,29126,7283,1,228532800,228532800,10921,3640,7281,3640,0,1,3642,1052525,1.052525
4040,550,6340,3487000,2,32326,8083,1,250580800,250580800,12121,4040,8081,4040,0,1,4042,359558,0.359558
4440,550,6340,3487000,2,35526,8883,1,272628800,272628800,13321,4440,8881,4440,0,1,4442,160264,0.160264
4840,550,6340,3487000,2,38726,9683,1,294676800,294676800,14521,4840,9681,4840,0,1,4842,699484,0.699484
5240,550,6340,3487000,2,41926,10483,1,316724800,316724800,15721,5240,10481,5240,0,1,5242,955281,0.955281
5640,550,6340,3487000,2,45126,11283,1,338772800,338772800,16921,5640,11281,5640,0,1,5642,191189,0.191189
6040,550,6340,3487000,2,48326,12083,1,360820800,360820800,18121,6040,12081,6040,0,1,6042,2288402,2.288402
6440,550,6340,3487000,2,51526,12883,1,382868800,382868800,19321,6440,12881,6440,0,1,6442,1263897,1.263897
6840,550,6340,3487000,2,54726,13683,1,404916800,404916800,20521,6840,13681,6840,0,1,6842,3150875,3.150875
35,3340,1045,3490300,2,286,73,1,29150200,29150200,106,35,71,35,0,1,37,80425,0.080425
535,3340,1045,3490300,2,4286,1073,1,46690200,46690200,1606,535,1071,535,0,1,537,376270,0.37627
1035,3340,1045,3490300,2,8286,2073,1,64230200,64230200,3106,1035,2071,1035,0,1,1037,704871,0.704871
1535,3340,1045,3490300,2,12286,3073,1,81770200,81770200,4606,1535,3071,1535,0,1,1537,1039246,1.039246
2035,3340,1045,3490300,2,16286,4073,1,99310200,99310200,6106,2035,4071,2035,0,1,2037,1367818,1.367818
44,1703,2055,3499665,2,358,91,1,29320136,29320136,133,44,89,44,0,1,46,65873,0.065873
544,1703,2055,3499665,2,4358,1091,1,44352136,44352136,1633,544,1089,544,0,1,546,396636,0.396636
1044,1703,2055,3499665,2,8358,2091,1,59384136,59384136,3133,1044,2089,1044,0,1,1046,691291,0.691291
1544,1703,2055,3499665,2,12358,3091,1,74416136,74416136,4633,1544,3089,1544,0,1,1546,51546,0.051546
2044,1703,2055,3499665,2,16358,4091,1,89448136,89448136,6133,2044,4089,2044,0,1,2046,598377,0.598377
2544,1703,2055,3499665,2,20358,5091,1,104480136,104480136,7633,2544,5089,2544,0,1,2546,1758162,1.758162
3044,1703,2055,3499665,2,24358,6091,1,119512136,119512136,9133,3044,6089,3044,0,1,3046,802640,0.80264
3544,1703,2055,3499665,2,28358,7091,1,134544136,134544136,10633,3544,7089,3544,0,1,3546,71128,0.071128
4044,1703,2055,3499665,2,32358,8091,1,149576136,149576136,12133,4044,8089,4044,0,1,4046,933942,0.933942
4544,1703,2055,3499665,2,36358,9091,1,164608136,164608136,13633,4544,9089,4544,0,1,4546,96116,0.096116
5044,1703,2055,3499665,2,40358,10091,1,179640136,179640136,15133,5044,10089,5044,0,1,5046,920254,0.920254
5544,1703,2055,3499665,2,44358,11091,1,194672136,194672136,16633,5544,11089,5544,0,1,5546,614512,0.614512
6044,1703,2055,3499665,2,48358,12091,1,209704136,209704136,18133,6044,12089,6044,0,1,6046,1690544,1.690544
6544,1703,2055,3499665,2,52358,13091,1,224736136,224736136,19633,6544,13089,6544,0,1,6546,969651,0.969651
7044,1703,2055,3499665,2,56358,14091,1,239768136,239768136,21133,7044,14089,7044,0,1,7046,1041959,1.041959
44,2253,1555,3503415,2,358,91,1,29367736,29367736,133,44,89,44,0,1,46,10272,0.010272
544,2253,1555,3503415,2,4358,1091,1,44599736,44599736,1633,544,1089,544,0,1,546,84503,0.084503
1044,2253,1555,3503415,2,8358,2091,1,59831736,59831736,3133,1044,2089,1044,0,1,1046,52781,0.052781
1544,2253,1555,3503415,2,12358,3091,1,75063736,75063736,4633,1544,3089,1544,0,1,1546,399491,0.399491
2044,2253,1555,3503415,2,16358,4091,1,90295736,90295736,6133,2044,4089,2044,0,1,2046,827357,0.827357
2544,2253,1555,3503415,2,20358,5091,1,105527736,105527736,7633,2544,5089,2544,0,1,2546,939612,0.939612
3044,2253,1555,3503415,2,24358,6091,1,120759736,120759736,9133,3044,6089,3044,0,1,3046,569617,0.569617
3544,2253,1555,3503415,2,28358,7091,1,135991736,135991736,10633,3544,7089,3544,0,1,3546,1002408,1.002408
4044,2253,1555,3503415,2,32358,8091,1,151223736,151223736,12133,4044,8089,4044,0,1,4046,612201,0.612201
4544,2253,1555,3503415,2,36358,9091,1,166455736,166455736,13633,4544,9089,4544,0,1,4546,3001579,3.001579
5044,2253,1555,3503415,2,40358,10091,1,181687736,181687736,15133,5044,10089,5044,0,1,5046,1690395,1.690395
5544,2253,1555,3503415,2,44358,11091,1,196919736,196919736,16633,5544,11089,5544,0,1,5546,3663915,3.663915
6044,2253,1555,3503415,2,48358,12091,1,212151736,212151736,18133,6044,12089,6044,0,1,6046,1636310,1.63631
6544,2253,1555,3503415,2,52358,13091,1,227383736,227383736,19633,6544,13089,6544,0,1,6546,756383,0.756383
7044,2253,1555,3503415,2,56358,14091,1,242615736,242615736,21133,7044,14089,7044,0,1,7046,44364,0.044364
40,1050,3340,3507000,2,326,83,1,29460800,29460800,121,40,81,40,0,1,42,19429,0.019429
440,1050,3340,3507000,2,3526,883,1,43508800,43508800,1321,440,881,440,0,1,442,9663,0.009663
840,1050,3340,3507000,2,6726,1683,1,57556800,57556800,2521,840,1681,840,0,1,842,70079,0.070079
1240,1050,3340,3507000,2,9926,2483,1,71604800,71604800,3721,1240,2481,1240,0,1,1242,141872,0.141872
1640,1050,3340,3507000,2,13126,3283,1,85652800,85652800,4921,1640,3281,1640,0,1,1642,182358,0.182358
2040,1050,3340,3507000,2,16326,4083,1,99700800,99700800,6121,2040,4081,2040,0,1,2042,44193,0.044193
2440,1050,3340,3507000,2,19526,4883,1,113748800,113748800,7321,2440,4881,2440,0,1,2442,255265,0.255265
2840,1050,3340,3507000,2,22726,5683,1,127796800,127796800,8521,2840,5681,2840,0,1,2842,358474,0.358474
3240,1050,3340,3507000,2,25926,6483,1,141844800,141844800,9721,3240,6481,3240,0,1,3242,876885,0.876885
3640,1050,3340,3507000,2,29126,7283,1,155892800,155892800,10921,3640,7281,3640,0,1,3642,155376,0.155376
4040,1050,3340,3507000,2,32326,8083,1,169940800,169940800,12121,4040,8081,4040,0,1,4042,886288,0.886288
4440,1050,3340,3507000,2,35526,8883,1,183988800,183988800,13321,4440,8881,4440,0,1,4442,87848,0.087848
4840,1050,3340,3507000,2,38726,9683,1,198036800,198036800,14521,4840,9681,4840,0,1,4842,209131,0.209131
5240,1050,3340,3507000,2,41926,10483,1,212084800,212084800,15721,5240,10481,5240,0,1,5242,125376,0.125376
5640,1050,3340,3507000,2,45126,11283,1,226132800,226132800,16921,5640,11281,5640,0,1,5642,366624,0.366624
6040,1050,3340,3507000,2,48326,12083,1,240180800,240180800,18121,6040,12081,6040,0,1,6042,1562090,1.56209
6440,1050,3340,3507000,2,51526,12883,1,254228800,254228800,19321,6440,12881,6440,0,1,6442,24129,0.024129
6840,1050,3340,3507000,2,54726,13683,1,268276800,268276800,20521,6840,13681,6840,0,1,6842,567529,0.567529
44,1153,3055,3522415,2,358,91,1,29660536,29660536,133,44,89,44,0,1,46,19865,0.019865
544,1153,3055,3522415,2,4358,1091,1,46492536,46492536,1633,544,1089,544,0,1,546,21018,0.021018
1044,1153,3055,3522415,2,8358,2091,1,63324536,63324536,3133,1044,2089,1044,0,1,1046,34642,0.034642
1544,1153,3055,3522415,2,12358,3091,1,80156536,80156536,4633,1544,3089,1544,0,1,1546,10953,0.010953
2044,1153,3055,3522415,2,16358,4091,1,96988536,96988536,6133,2044,4089,2044,0,1,2046,104482,0.104482
2544,1153,3055,3522415,2,20358,5091,1,113820536,113820536,7633,2544,5089,2544,0,1,2546,49298,0.049298
3044,1153,3055,3522415,2,24358,6091,1,130652536,130652536,9133,3044,6089,3044,0,1,3046,471077,0.471077
3544,1153,3055,3522415,2,28358,7091,1,147484536,147484536,10633,3544,7089,3544,0,1,3546,616689,0.616689
4044,1153,3055,3522415,2,32358,8091,1,164316536,164316536,12133,4044,8089,4044,0,1,4046,327482,0.327482
4544,1153,3055,3522415,2,36358,9091,1,181148536,181148536,13633,4544,9089,4544,0,1,4546,243191,0.243191
5044,1153,3055,3522415,2,40358,10091,1,197980536,197980536,15133,5044,10089,5044,0,1,5046,1076795,1.076795
5544,1153,3055,3522415,2,44358,11091,1,214812536,214812536,16633,5544,11089,5544,0,1,5546,788561,0.788561
6044,1153,3055,3522415,2,48358,12091,1,231644536,231644536,18133,6044,12089,6044,0,1,6046,1314410,1.31441
6544,1153,3055,3522415,2,52358,13091,1,248476536,248476536,19633,6544,13089,6544,0,1,6546,208541,0.208541
7044,1153,3055,3522415,2,56358,14091,1,265308536,265308536,21133,7044,14089,7044,0,1,7046,594626,0.594626
55,5305,665,3527825,2,446,113,1,30849400,30849400,166,55,111,55,0,1,57,69066,0.069066
455,5305,665,3527825,2,3646,913,1,49953400,49953400,1366,455,911,455,0,1,457,330349,0.330349
855,5305,665,3527825,2,6846,1713,1,69057400,69057400,2566,855,1711,855,0,1,857,610518,0.610518
1255,5305,665,3527825,2,10046,2513,1,88161400,88161400,3766,1255,2511,1255,0,1,1257,772890,0.77289
1655,5305,665,3527825,2,13246,3313,1,107265400,107265400,4966,1655,3311,1655,0,1,1657,776424,0.776424
2055,5305,665,3527825,2,16446,4113,1,126369400,126369400,6166,2055,4111,2055,0,1,2057,12016,0.012016
2455,5305,665,3527825,2,19646,4913,1,145473400,145473400,7366,2455,4911,2455,0,1,2457,1376359,1.376359
2855,5305,665,3527825,2,22846,5713,1,164577400,164577400,8566,2855,5711,2855,0,1,2857,764570,0.76457
3255,5305,665,3527825,2,26046,6513,1,183681400,183681400,9766,3255,6511,3255,0,1,3257,2135089,2.135089
3655,5305,665,3527825,2,29246,7313,1,202785400,202785400,10966,3655,7311,3655,0,1,3657,395907,0.395907
4055,5305,665,3527825,2,32446,8113,1,221889400,221889400,12166,4055,8111,4055,0,1,4057,105621,0.105621
4455,5305,665,3527825,2,35646,8913,1,240993400,240993400,13366,4455,8911,4455,0,1,4457,1169200,1.1692
4855,5305,665,3527825,2,38846,9713,1,260097400,260097400,14566,4855,9711,4855,0,1,4857,130581,0.130581
5255,5305,665,3527825,2,42046,10513,1,279201400,279201400,15766,5255,10511,5255,0,1,5257,3628263,3.628263
5655,5305,665,3527825,2,45246,11313,1,298305400,298305400,16966,5655,11311,5655,0,1,5657,508536,0.508536
6055,5305,665,3527825,2,48446,12113,1,317409400,317409400,18166,6055,12111,6055,0,1,6057,1174303,1.174303
6455,5305,665,3527825,2,51646,12913,1,336513400,336513400,19366,6455,12911,6455,0,1,6457,1817259,1.817259
6855,5305,665,3527825,2,54846,13713,1,355617400,355617400,20566,6855,13711,6855,0,1,6857,4189254,4.189254
55,555,6365,3532575,2,446,113,1,31305400,31305400,166,55,111,55,0,1,57,74178,0.074178
455,555,6365,3532575,2,3646,913,1,53449400,53449400,1366,455,911,455,0,1,457,336241,0.336241
855,555,6365,3532575,2,6846,1713,1,75593400,75593400,2566,855,1711,855,0,1,857,269648,0.269648
1255,555,6365,3532575,2,10046,2513,1,97737400,97737400,3766,1255,2511,1255,0,1,1257,759834,0.759834
1655,555,6365,3532575,2,13246,3313,1,119881400,119881400,4966,1655,3311,1655,0,1,1657,1143600,1.1436
2055,555,6365,3532575,2,16446,4113,1,142025400,142025400,6166,2055,4111,2055,0,1,2057,192620,0.19262
2455,555,6365,3532575,2,19646,4913,1,164169400,164169400,7366,2455,4911,2455,0,1,2457,1442600,1.4426
2855,555,6365,3532575,2,22846,5713,1,186313400,186313400,8566,2855,5711,2855,0,1,2857,219924,0.219924
3255,555,6365,3532575,2,26046,6513,1,208457400,208457400,9766,3255,6511,3255,0,1,3257,587440,0.58744
3655,555,6365,3532575,2,29246,7313,1,230601400,230601400,10966,3655,7311,3655,0,1,3657,538833,0.538833
4055,555,6365,3532575,2,32446,8113,1,252745400,252745400,12166,4055,8111,4055,0,1,4057,124174,0.124174
4455,555,6365,3532575,2,35646,8913,1,274889400,274889400,13366,4455,8911,4455,0,1,4457,69230,0.06923
4855,555,6365,3532575,2,38846,9713,1,297033400,297033400,14566,4855,9711,4855,0,1,4857,1710088,1.710088
5255,555,6365,3532575,2,42046,10513,1,319177400,319177400,15766,5255,10511,5255,0,1,5257,817935,0.817935
5655,555,6365,3532575,2,45246,11313,1,341321400,341321400,16966,5655,11311,5655,0,1,5657,469837,0.469837
6055,555,6365,3532575,2,48446,12113,1,363465400,363465400,18166,6055,12111,6055,0,1,6057,1861322,1.861322
6455,555,6365,3532575,2,51646,12913,1,385609400,385609400,19366,6455,12911,6455,0,1,6457,669565,0.669565
6855,555,6365,3532575,2,54846,13713,1,407753400,407753400,20566,6855,13711,6855,0,1,6857,1083960,1.08396
44,3353,1055,3537415,2,358,91,1,29850936,29850936,133,44,89,44,0,1,46,16471,0.016471
544,3353,1055,3537415,2,4358,1091,1,47482936,47482936,1633,544,1089,544,0,1,546,7805,0.007805
1044,3353,1055,3537415,2,8358,2091,1,65114936,65114936,3133,1044,2089,1044,0,1,1046,51486,0.051486
1544,3353,1055,3537415,2,12358,3091,1,82746936,82746936,4633,1544,3089,1544,0,1,1546,494105,0.494105
2044,3353,1055,3537415,2,16358,4091,1,100378936,100378936,6133,2044,4089,2044,0,1,2046,882553,0.882553
2544,3353,1055,3537415,2,20358,5091,1,118010936,118010936,7633,2544,5089,2544,0,1,2546,30846,0.030846
3044,3353,1055,3537415,2,24358,6091,1,135642936,135642936,9133,3044,6089,3044,0,1,3046,434334,0.434334
3544,3353,1055,3537415,2,28358,7091,1,153274936,153274936,10633,3544,7089,3544,0,1,3546,969200,0.9692
4044,3353,1055,3537415,2,32358,8091,1,170906936,170906936,12133,4044,8089,4044,0,1,4046,2496593,2.496593
4544,3353,1055,3537415,2,36358,9091,1,188538936,188538936,13633,4544,9089,4544,0,1,4546,333758,0.333758
5044,3353,1055,3537415,2,40358,10091,1,206170936,206170936,15133,5044,10089,5044,0,1,5046,1639949,1.639949
5544,3353,1055,3537415,2,44358,11091,1,223802936,223802936,16633,5544,11089,5544,0,1,5546,2356071,2.356071
6044,3353,1055,3537415,2,48358,12091,1,241434936,241434936,18133,6044,12089,6044,0,1,6046,3003036,3.003036
6544,3353,1055,3537415,2,52358,13091,1,259066936,259066936,19633,6544,13089,6544,0,1,6546,2720780,2.72078
7044,3353,1055,3537415,2,56358,14091,1,276698936,276698936,21133,7044,14089,7044,0,1,7046,686002,0.686002
40,2300,1540,3542000,2,326,83,1,29564800,29564800,121,40,81,40,0,1,42,66163,0.066163
440,2300,1540,3542000,2,3526,883,1,41852800,41852800,1321,440,881,440,0,1,442,109230,0.10923
840,2300,1540,3542000,2,6726,1683,1,54140800,54140800,2521,840,1681,840,0,1,842,590641,0.590641
1240,2300,1540,3542000,2,9926,2483,1,66428800,66428800,3721,1240,2481,1240,0,1,1242,849676,0.849676
1640,2300,1540,3542000,2,13126,3283,1,78716800,78716800,4921,1640,3281,1640,0,1,1642,948791,0.948791
2040,2300,1540,3542000,2,16326,4083,1,91004800,91004800,6121,2040,4081,2040,0,1,2042,1382954,1.382954
2440,2300,1540,3542000,2,19526,4883,1,103292800,103292800,7321,2440,4881,2440,0,1,2442,131883,0.131883
2840,2300,1540,3542000,2,22726,5683,1,115580800,115580800,8521,2840,5681,2840,0,1,2842,1686162,1.686162
3240,2300,1540,3542000,2,25926,6483,1,127868800,127868800,9721,3240,6481,3240,0,1,3242,524900,0.5249
3640,2300,1540,3542000,2,29126,7283,1,140156800,140156800,10921,3640,7281,3640,0,1,3642,237428,0.237428
4040,2300,1540,3542000,2,32326,8083,1,152444800,152444800,12121,4040,8081,4040,0,1,4042,436606,0.436606
4440,2300,1540,3542000,2,35526,8883,1,164732800,164732800,13321,4440,8881,4440,0,1,4442,2994962,2.994962
4840,2300,1540,3542000,2,38726,9683,1,177020800,177020800,14521,4840,9681,4840,0,1,4842,149034,0.149034
5240,2300,1540,3542000,2,41926,10483,1,189308800,189308800,15721,5240,10481,5240,0,1,5242,853302,0.853302
5640,2300,1540,3542000,2,45126,11283,1,201596800,201596800,16921,5640,11281,5640,0,1,5642,3796247,3.796247
6040,2300,1540,3542000,2,48326,12083,1,213884800,213884800,18121,6040,12081,6040,0,1,6042,2631405,2.631405
6440,2300,1540,3542000,2,51526,12883,1,226172800,226172800,19321,6440,12881,6440,0,1,6442,3535230,3.53523
6840,2300,1540,3542000,2,54726,13683,1,238460800,238460800,20521,6840,13681,6840,0,1,6842,366967,0.366967
55,2805,1265,3548325,2,446,113,1,30177400,30177400,166,55,111,55,0,1,57,71344,0.071344
455,2805,1265,3548325,2,3646,913,1,43201400,43201400,1366,455,911,455,0,1,457,154640,0.15464
855,2805,1265,3548325,2,6846,1713,1,56225400,56225400,2566,855,1711,855,0,1,857,594342,0.594342
1255,2805,1265,3548325,2,10046,2513,1,69249400,69249400,3766,1255,2511,1255,0,1,1257,863564,0.863564
1655,2805,1265,3548325,2,13246,3313,1,82273400,82273400,4966,1655,3311,1655,0,1,1657,1122105,1.122105
2055,2805,1265,3548325,2,16446,4113,1,95297400,95297400,6166,2055,4111,2055,0,1,2057,1388854,1.388854
2455,2805,1265,3548325,2,19646,4913,1,108321400,108321400,7366,2455,4911,2455,0,1,2457,1654171,1.654171
2855,2805,1265,3548325,2,22846,5713,1,121345400,121345400,8566,2855,5711,2855,0,1,2857,1919448,1.919448
3255,2805,1265,3548325,2,26046,6513,1,134369400,134369400,9766,3255,6511,3255,0,1,3257,1287261,1.287261
3655,2805,1265,3548325,2,29246,7313,1,147393400,147393400,10966,3655,7311,3655,0,1,3657,1832999,1.832999
4055,2805,1265,3548325,2,32446,8113,1,160417400,160417400,12166,4055,8111,4055,0,1,4057,2734404,2.734404
4455,2805,1265,3548325,2,35646,8913,1,173441400,173441400,13366,4455,8911,4455,0,1,4457,1012385,1.012385
4855,2805,1265,3548325,2,38846,9713,1,186465400,186465400,14566,4855,9711,4855,0,1,4857,197807,0.197807
5255,2805,1265,3548325,2,42046,10513,1,199489400,199489400,15766,5255,10511,5255,0,1,5257,3526860,3.52686
5655,2805,1265,3548325,2,45246,11313,1,212513400,212513400,16966,5655,11311,5655,0,1,5657,2221213,2.221213
6055,2805,1265,3548325,2,48446,12113,1,225537400,225537400,18166,6055,12111,6055,0,1,6057,89514,0.089514
6455,2805,1265,3548325,2,51646,12913,1,238561400,238561400,19366,6455,12911,6455,0,1,6457,469707,0.469707
6855,2805,1265,3548325,2,54846,13713,1,251585400,251585400,20566,6855,13711,6855,0,1,6857,3008618,3.008618
55,1055,3365,3550075,2,446,113,1,30345400,30345400,166,55,111,55,0,1,57,10144,0.010144
455,1055,3365,3550075,2,3646,913,1,44489400,44489400,1366,455,911,455,0,1,457,231,0.000231
855,1055,3365,3550075,2,6846,1713,1,58633400,58633400,2566,855,1711,855,0,1,857,5284,0.005284
1255,1055,3365,3550075,2,10046,2513,1,72777400,72777400,3766,1255,2511,1255,0,1,1257,205928,0.205928
1655,1055,3365,3550075,2,13246,3313,1,86921400,86921400,4966,1655,3311,1655,0,1,1657,4789,0.004789
2055,1055,3365,3550075,2,16446,4113,1,101065400,101065400,6166,2055,4111,2055,0,1,2057,138903,0.138903
2455,1055,3365,3550075,2,19646,4913,1,115209400,115209400,7366,2455,4911,2455,0,1,2457,58376,0.058376
2855,1055,3365,3550075,2,22846,5713,1,129353400,129353400,8566,2855,5711,2855,0,1,2857,32699,0.032699
3255,1055,3365,3550075,2,26046,6513,1,143497400,143497400,9766,3255,6511,3255,0,1,3257,286554,0.286554
3655,1055,3365,3550075,2,29246,7313,1,157641400,157641400,10966,3655,7311,3655,0,1,3657,247297,0.247297
4055,1055,3365,3550075,2,32446,8113,1,171785400,171785400,12166,4055,8111,4055,0,1,4057,661441,0.661441
4455,1055,3365,3550075,2,35646,8913,1,185929400,185929400,13366,4455,8911,4455,0,1,4457,150747,0.150747
4855,1055,3365,3550075,2,38846,9713,1,200073400,200073400,14566,4855,9711,4855,0,1,4857,948017,0.948017
5255,1055,3365,3550075,2,42046,10513,1,214217400,214217400,15766,5255,10511,5255,0,1,5257,258450,0.25845
5655,1055,3365,3550075,2,45246,11313,1,228361400,228361400,16966,5655,11311,5655,0,1,5657,1146242,1.146242
6055,1055,3365,3550075,2,48446,12113,1,242505400,242505400,18166,6055,12111,6055,0,1,6057,305074,0.305074
6455,1055,3365,3550075,2,51646,12913,1,256649400,256649400,19366,6455,12911,6455,0,1,6457,374643,0.374643
6855,1055,3365,3550075,2,54846,13713,1,270793400,270793400,20566,6855,13711,6855,0,1,6857,294671,0.294671
40,5550,640,3552000,2,326,83,1,30396800,30396800,121,40,81,40,0,1,42,63432,0.063432
440,5550,640,3552000,2,3526,883,1,50204800,50204800,1321,440,881,440,0,1,442,318186,0.318186
840,5550,640,3552000,2,6726,1683,1,70012800,70012800,2521,840,1681,840,0,1,842,581995,0.581995
1240,5550,640,3552000,2,9926,2483,1,89820800,89820800,3721,1240,2481,1240,0,1,1242,850269,0.850269
1640,5550,640,3552000,2,13126,3283,1,109628800,109628800,4921,1640,3281,1640,0,1,1642,1123975,1.123975
2040,5550,640,3552000,2,16326,4083,1,129436800,129436800,6121,2040,4081,2040,0,1,2042,904650,0.90465
2440,5550,640,3552000,2,19526,4883,1,149244800,149244800,7321,2440,4881,2440,0,1,2442,1647421,1.647421
2840,5550,640,3552000,2,22726,5683,1,169052800,169052800,8521,2840,5681,2840,0,1,2842,1932561,1.932561
3240,5550,640,3552000,2,25926,6483,1,188860800,188860800,9721,3240,6481,3240,0,1,3242,275046,0.275046
3640,5550,640,3552000,2,29126,7283,1,208668800,208668800,10921,3640,7281,3640,0,1,3642,1106765,1.106765
4040,5550,640,3552000,2,32326,8083,1,228476800,228476800,12121,4040,8081,4040,0,1,4042,1410625,1.410625
4440,5550,640,3552000,2,35526,8883,1,248284800,248284800,13321,4440,8881,4440,0,1,4442,360466,0.360466
4840,5550,640,3552000,2,38726,9683,1,268092800,268092800,14521,4840,9681,4840,0,1,4842,609048,0.609048
5240,5550,640,3552000,2,41926,10483,1,287900800,287900800,15721,5240,10481,5240,0,1,5242,949319,0.949319
5640,5550,640,3552000,2,45126,11283,1,307708800,307708800,16921,5640,11281,5640,0,1,5642,1270798,1.270798
6040,5550,640,3552000,2,48326,12083,1,327516800,327516800,18121,6040,12081,6040,0,1,6042,430235,0.430235
6440,5550,640,3552000,2,51526,12883,1,347324800,347324800,19321,6440,12881,6440,0,1,6442,4414389,4.414389
6840,5550,640,3552000,2,54726,13683,1,367132800,367132800,20521,6840,13681,6840,0,1,6842,615117,0.615117
40,1300,2740,3562000,2,326,83,1,29788800,29788800,121,40,81,40,0,1,42,68368,0.068368
440,1300,2740,3562000,2,3526,883,1,42716800,42716800,1321,440,881,440,0,1,442,331917,0.331917
840,1300,2740,3562000,2,6726,1683,1,55644800,55644800,2521,840,1681,840,0,1,842,608631,0.608631
1240,1300,2740,3562000,2,9926,2483,1,68572800,68572800,3721,1240,2481,1240,0,1,1242,723930,0.72393
1640,1300,2740,3562000,2,13126,3283,1,81500800,81500800,4921,1640,3281,1640,0,1,1642,581791,0.581791
2040,1300,2740,3562000,2,16326,4083,1,94428800,94428800,6121,2040,4081,2040,0,1,2042,799305,0.799305
2440,1300,2740,3562000,2,19526,4883,1,107356800,107356800,7321,2440,4881,2440,0,1,2442,579889,0.579889
2840,1300,2740,3562000,2,22726,5683,1,120284800,120284800,8521,2840,5681,2840,0,1,2842,173548,0.173548
3240,1300,2740,3562000,2,25926,6483,1,133212800,133212800,9721,3240,6481,3240,0,1,3242,512989,0.512989
3640,1300,2740,3562000,2,29126,7283,1,146140800,146140800,10921,3640,7281,3640,0,1,3642,2531305,2.531305
4040,1300,2740,3562000,2,32326,8083,1,159068800,159068800,12121,4040,8081,4040,0,1,4042,147541,0.147541
4440,1300,2740,3562000,2,35526,8883,1,171996800,171996800,13321,4440,8881,4440,0,1,4442,705686,0.705686
4840,1300,2740,3562000,2,38726,9683,1,184924800,184924800,14521,4840,9681,4840,0,1,4842,152674,0.152674
5240,1300,2740,3562000,2,41926,10483,1,197852800,197852800,15721,5240,10481,5240,0,1,5242,264543,0.264543
5640,1300,2740,3562000,2,45126,11283,1,210780800,210780800,16921,5640,11281,5640,0,1,5642,524345,0.524345
6040,1300,2740,3562000,2,48326,12083,1,223708800,223708800,18121,6040,12081,6040,0,1,6042,670509,0.670509
6440,1300,2740,3562000,2,51526,12883,1,236636800,236636800,19321,6440,12881,6440,0,1,6442,2297110,2.29711
6840,1300,2740,3562000,2,54726,13683,1,249564800,249564800,20521,6840,13681,6840,0,1,6842,1135115,1.135115
35,590,6045,3566550,2,286,73,1,30390200,30390200,106,35,71,35,0,1,37,36777,0.036777
535,590,6045,3566550,2,4286,1073,1,56930200,56930200,1606,535,1071,535,0,1,537,18870,0.01887
1035,590,6045,3566550,2,8286,2073,1,83470200,83470200,3106,1035,2071,1035,0,1,1037,138277,0.138277
1535,590,6045,3566550,2,12286,3073,1,110010200,110010200,4606,1535,3071,1535,0,1,1537,34978,0.034978
2035,590,6045,3566550,2,16286,4073,1,136550200,136550200,6106,2035,4071,2035,0,1,2037,1169592,1.169592
2535,590,6045,3566550,2,20286,5073,1,163090200,163090200,7606,2535,5071,2535,0,1,2537,1805760,1.80576
3035,590,6045,3566550,2,24286,6073,1,189630200,189630200,9106,3035,6071,3035,0,1,3037,2155186,2.155186
3535,590,6045,3566550,2,28286,7073,1,216170200,216170200,10606,3535,7071,3535,0,1,3537,2579622,2.579622
4035,590,6045,3566550,2,32286,8073,1,242710200,242710200,12106,4035,8071,4035,0,1,4037,2892649,2.892649
4535,590,6045,3566550,2,36286,9073,1,269250200,269250200,13606,4535,9071,4535,0,1,4537,3256308,3.256308
5035,590,6045,3566550,2,40286,10073,1,295790200,295790200,15106,5035,10071,5035,0,1,5037,3612308,3.612308
5535,590,6045,3566550,2,44286,11073,1,322330200,322330200,16606,5535,11071,5535,0,1,5537,3979632,3.979632
6035,590,6045,3566550,2,48286,12073,1,348870200,348870200,18106,6035,12071,6035,0,1,6037,4413625,4.413625
6535,590,6045,3566550,2,52286,13073,1,375410200,375410200,19606,6535,13071,6535,0,1,6537,4723434,4.723434
7035,590,6045,3566550,2,56286,14073,1,401950200,401950200,21106,7035,14071,7035,0,1,7037,5053911,5.053911
40,3800,940,3572000,2,326,83,1,30092800,30092800,121,40,81,40,0,1,42,64033,0.064033
440,3800,940,3572000,2,3526,883,1,45260800,45260800,1321,440,881,440,0,1,442,329741,0.329741
840,3800,940,3572000,2,6726,1683,1,60428800,60428800,2521,840,1681,840,0,1,842,608863,0.608863
1240,3800,940,3572000,2,9926,2483,1,75596800,75596800,3721,1240,2481,1240,0,1,1242,888047,0.888047
1640,3800,940,3572000,2,13126,3283,1,90764800,90764800,4921,1640,3281,1640,0,1,1642,59065,0.059065
2040,3800,940,3572000,2,16326,4083,1,105932800,105932800,6121,2040,4081,2040,0,1,2042,1438464,1.438464
2440,3800,940,3572000,2,19526,4883,1,121100800,121100800,7321,2440,4881,2440,0,1,2442,304719,0.304719
2840,3800,940,3572000,2,22726,5683,1,136268800,136268800,8521,2840,5681,2840,0,1,2842,504225,0.504225
3240,3800,940,3572000,2,25926,6483,1,151436800,151436800,9721,3240,6481,3240,0,1,3242,2276815,2.276815
3640,3800,940,3572000,2,29126,7283,1,166604800,166604800,10921,3640,7281,3640,0,1,3642,2554751,2.554751
4040,3800,940,3572000,2,32326,8083,1,181772800,181772800,12121,4040,8081,4040,0,1,4042,954021,0.954021
4440,3800,940,3572000,2,35526,8883,1,196940800,196940800,13321,4440,8881,4440,0,1,4442,3109684,3.109684
4840,3800,940,3572000,2,38726,9683,1,212108800,212108800,14521,4840,9681,4840,0,1,4842,18670,0.01867
5240,3800,940,3572000,2,41926,10483,1,227276800,227276800,15721,5240,10481,5240,0,1,5242,2174580,2.17458
5640,3800,940,3572000,2,45126,11283,1,242444800,242444800,16921,5640,11281,5640,0,1,5642,2642493,2.642493
6040,3800,940,3572000,2,48326,12083,1,257612800,257612800,18121,6040,12081,6040,0,1,6042,429222,0.429222
6440,3800,940,3572000,2,51526,12883,1,272780800,272780800,19321,6440,12881,6440,0,1,6442,1414807,1.414807
6840,3800,940,3572000,2,54726,13683,1,287948800,287948800,20521,6840,13681,6840,0,1,6842,2244626,2.244626
39,593,6041,3582313,2,318,81,1,30728312,30728312,118,39,79,39,0,1,41,57877,0.057877
539,593,6041,3582313,2,4318,1081,1,57264312,57264312,1618,539,1079,539,0,1,541,393409,0.393409
1039,593,6041,3582313,2,8318,2081,1,83800312,83800312,3118,1039,2079,1039,0,1,1041,299023,0.299023
1539,593,6041,3582313,2,12318,3081,1,110336312,110336312,4618,1539,3079,1539,0,1,1541,1070632,1.070632
2039,593,6041,3582313,2,16318,4081,1,136872312,136872312,6118,2039,4079,2039,0,1,2041,112343,0.112343
2539,593,6041,3582313,2,20318,5081,1,163408312,163408312,7618,2539,5079,2539,0,1,2541,347040,0.34704
3039,593,6041,3582313,2,24318,6081,1,189944312,189944312,9118,3039,6079,3039,0,1,3041,1065578,1.065578
3539,593,6041,3582313,2,28318,7081,1,216480312,216480312,10618,3539,7079,3539,0,1,3541,540270,0.54027
4039,593,6041,3582313,2,32318,8081,1,243016312,243016312,12118,4039,8079,4039,0,1,4041,411175,0.411175
4539,593,6041,3582313,2,36318,9081,1,269552312,269552312,13618,4539,9079,4539,0,1,4541,394409,0.394409
5039,593,6041,3582313,2,40318,10081,1,296088312,296088312,15118,5039,10079,5039,0,1,5041,752157,0.752157
5539,593,6041,3582313,2,44318,11081,1,322624312,322624312,16618,5539,11079,5539,0,1,5541,721244,0.721244
6039,593,6041,3582313,2,48318,12081,1,349160312,349160312,18118,6039,12079,6039,0,1,6041,316180,0.31618
6539,593,6041,3582313,2,52318,13081,1,375696312,375696312,19618,6539,13079,6539,0,1,6541,289744,0.289744
7039,593,6041,3582313,2,56318,14081,1,402232312,402232312,21118,7039,14079,7039,0,1,7041,128047,0.128047
39,6643,541,3593863,2,318,81,1,30992312,30992312,118,39,79,39,0,1,41,6112,0.006112
539,6643,541,3593863,2,4318,1081,1,59728312,59728312,1618,539,1079,539,0,1,541,95440,0.09544
1039,6643,541,3593863,2,8318,2081,1,88464312,88464312,3118,1039,2079,1039,0,1,1041,57853,0.057853
1539,6643,541,3593863,2,12318,3081,1,117200312,117200312,4618,1539,3079,1539,0,1,1541,203198,0.203198
2039,6643,541,3593863,2,16318,4081,1,145936312,145936312,6118,2039,4079,2039,0,1,2041,113409,0.113409
2539,6643,541,3593863,2,20318,5081,1,174672312,174672312,7618,2539,5079,2539,0,1,2541,1857751,1.857751
3039,6643,541,3593863,2,24318,6081,1,203408312,203408312,9118,3039,6079,3039,0,1,3041,969089,0.969089
3539,6643,541,3593863,2,28318,7081,1,232144312,232144312,10618,3539,7079,3539,0,1,3541,1277450,1.27745
4039,6643,541,3593863,2,32318,8081,1,260880312,260880312,12118,4039,8079,4039,0,1,4041,1637746,1.637746
4539,6643,541,3593863,2,36318,9081,1,289616312,289616312,13618,4539,9079,4539,0,1,4541,2564438,2.564438
5039,6643,541,3593863,2,40318,10081,1,318352312,318352312,15118,5039,10079,5039,0,1,5041,206698,0.206698
5539,6643,541,3593863,2,44318,11081,1,347088312,347088312,16618,5539,11079,5539,0,1,5541,1154890,1.15489
6039,6643,541,3593863,2,48318,12081,1,375824312,375824312,18118,6039,12079,6039,0,1,6041,925554,0.925554
6539,6643,541,3593863,2,52318,13081,1,404560312,404560312,19618,6539,13079,6539,0,1,6541,379957,0.379957
7039,6643,541,3593863,2,56318,14081,1,433296312,433296312,21118,7039,14079,7039,0,1,7041,713381,0.713381
35,6600,545,3597000,2,286,73,1,30776600,30776600,106,35,71,35,0,1,37,6827,0.006827
535,6600,545,3597000,2,4286,1073,1,59356600,59356600,1606,535,1071,535,0,1,537,88370,0.08837
1035,6600,545,3597000,2,8286,2073,1,87936600,87936600,3106,1035,2071,1035,0,1,1037,718658,0.718658
1535,6600,545,3597000,2,12286,3073,1,116516600,116516600,4606,1535,3071,1535,0,1,1537,1064202,1.064202
2035,6600,545,3597000,2,16286,4073,1,145096600,145096600,6106,2035,4071,2035,0,1,2037,1405862,1.405862
2535,6600,545,3597000,2,20286,5073,1,173676600,173676600,7606,2535,5071,2535,0,1,2537,782583,0.782583
3035,6600,545,3597000,2,24286,6073,1,202256600,202256600,9106,3035,6071,3035,0,1,3037,976308,0.976308
3535,6600,545,3597000,2,28286,7073,1,230836600,230836600,10606,3535,7071,3535,0,1,3537,650628,0.650628
4035,6600,545,3597000,2,32286,8073,1,259416600,259416600,12106,4035,8071,4035,0,1,4037,691381,0.691381
4535,6600,545,3597000,2,36286,9073,1,287996600,287996600,13606,4535,9071,4535,0,1,4537,2380650,2.38065
5035,6600,545,3597000,2,40286,10073,1,316576600,316576600,15106,5035,10071,5035,0,1,5037,3476093,3.476093
5535,6600,545,3597000,2,44286,11073,1,345156600,345156600,16606,5535,11071,5535,0,1,5537,3102469,3.102469
6035,6600,545,3597000,2,48286,12073,1,373736600,373736600,18106,6035,12071,6035,0,1,6037,4210010,4.21001
6535,6600,545,3597000,2,52286,13073,1,402316600,402316600,19606,6535,13071,6535,0,1,6537,716327,0.716327
7035,6600,545,3597000,2,56286,14073,1,430896600,430896600,21106,7035,14071,7035,0,1,7037,4872721,4.872721
55,2305,1565,3607325,2,446,113,1,30561400,30561400,166,55,111,55,0,1,57,73080,0.07308
455,2305,1565,3607325,2,3646,913,1,42945400,42945400,1366,455,911,455,0,1,457,335244,0.335244
855,2305,1565,3607325,2,6846,1713,1,55329400,55329400,2566,855,1711,855,0,1,857,602478,0.602478
1255,2305,1565,3607325,2,10046,2513,1,67713400,67713400,3766,1255,2511,1255,0,1,1257,871639,0.871639
1655,2305,1565,3607325,2,13246,3313,1,80097400,80097400,4966,1655,3311,1655,0,1,1657,1139304,1.139304
2055,2305,1565,3607325,2,16446,4113,1,92481400,92481400,6166,2055,4111,2055,0,1,2057,1413986,1.413986
2455,2305,1565,3607325,2,19646,4913,1,104865400,104865400,7366,2455,4911,2455,0,1,2457,1681452,1.681452
2855,2305,1565,3607325,2,22846,5713,1,117249400,117249400,8566,2855,5711,2855,0,1,2857,1957803,1.957803
3255,2305,1565,3607325,2,26046,6513,1,129633400,129633400,9766,3255,6511,3255,0,1,3257,45732,0.045732
3655,2305,1565,3607325,2,29246,7313,1,142017400,142017400,10966,3655,7311,3655,0,1,3657,118932,0.118932
4055,2305,1565,3607325,2,32446,8113,1,154401400,154401400,12166,4055,8111,4055,0,1,4057,1932923,1.932923
4455,2305,1565,3607325,2,35646,8913,1,166785400,166785400,13366,4455,8911,4455,0,1,4457,14763,0.014763
4855,2305,1565,3607325,2,38846,9713,1,179169400,179169400,14566,4855,9711,4855,0,1,4857,3318134,3.318134
5255,2305,1565,3607325,2,42046,10513,1,191553400,191553400,15766,5255,10511,5255,0,1,5257,75719,0.075719
5655,2305,1565,3607325,2,45246,11313,1,203937400,203937400,16966,5655,11311,5655,0,1,5657,881608,0.881608
6055,2305,1565,3607325,2,48446,12113,1,216321400,216321400,18166,6055,12111,6055,0,1,6057,520568,0.520568
6455,2305,1565,3607325,2,51646,12913,1,228705400,228705400,19366,6455,12911,6455,0,1,6457,167268,0.167268
6855,2305,1565,3607325,2,54846,13713,1,241089400,241089400,20566,6855,13711,6855,0,1,6857,1650217,1.650217
55,1305,2765,3608325,2,446,113,1,30657400,30657400,166,55,111,55,0,1,57,73739,0.073739
455,1305,2765,3608325,2,3646,913,1,43681400,43681400,1366,455,911,455,0,1,457,200284,0.200284
855,1305,2765,3608325,2,6846,1713,1,56705400,56705400,2566,855,1711,855,0,1,857,624811,0.624811
1255,1305,2765,3608325,2,10046,2513,1,69729400,69729400,3766,1255,2511,1255,0,1,1257,913102,0.913102
1655,1305,2765,3608325,2,13246,3313,1,82753400,82753400,4966,1655,3311,1655,0,1,1657,197108,0.197108
2055,1305,2765,3608325,2,16446,4113,1,95777400,95777400,6166,2055,4111,2055,0,1,2057,1470523,1.470523
2455,1305,2765,3608325,2,19646,4913,1,108801400,108801400,7366,2455,4911,2455,0,1,2457,693136,0.693136
2855,1305,2765,3608325,2,22846,5713,1,121825400,121825400,8566,2855,5711,2855,0,1,2857,1190085,1.190085
3255,1305,2765,3608325,2,26046,6513,1,134849400,134849400,9766,3255,6511,3255,0,1,3257,722230,0.72223
3655,1305,2765,3608325,2,29246,7313,1,147873400,147873400,10966,3655,7311,3655,0,1,3657,393834,0.393834
4055,1305,2765,3608325,2,32446,8113,1,160897400,160897400,12166,4055,8111,4055,0,1,4057,235650,0.23565
4455,1305,2765,3608325,2,35646,8913,1,173921400,173921400,13366,4455,8911,4455,0,1,4457,214928,0.214928
4855,1305,2765,3608325,2,38846,9713,1,186945400,186945400,14566,4855,9711,4855,0,1,4857,1245103,1.245103
5255,1305,2765,3608325,2,42046,10513,1,199969400,199969400,15766,5255,10511,5255,0,1,5257,1848078,1.848078
5655,1305,2765,3608325,2,45246,11313,1,212993400,212993400,16966,5655,11311,5655,0,1,5657,1349858,1.349858
6055,1305,2765,3608325,2,48446,12113,1,226017400,226017400,18166,6055,12111,6055,0,1,6057,230023,0.230023
6455,1305,2765,3608325,2,51646,12913,1,239041400,239041400,19366,6455,12911,6455,0,1,6457,377873,0.377873
6855,1305,2765,3608325,2,54846,13713,1,252065400,252065400,20566,6855,13711,6855,0,1,6857,1358791,1.358791
40,800,4540,3632000,2,326,83,1,30764800,30764800,121,40,81,40,0,1,42,5228,0.005228
440,800,4540,3632000,2,3526,883,1,47852800,47852800,1321,440,881,440,0,1,442,329997,0.329997
840,800,4540,3632000,2,6726,1683,1,64940800,64940800,2521,840,1681,840,0,1,842,169623,0.169623
1240,800,4540,3632000,2,9926,2483,1,82028800,82028800,3721,1240,2481,1240,0,1,1242,608367,0.608367
1640,800,4540,3632000,2,13126,3283,1,99116800,99116800,4921,1640,3281,1640,0,1,1642,1148433,1.148433
2040,800,4540,3632000,2,16326,4083,1,116204800,116204800,6121,2040,4081,2040,0,1,2042,1427453,1.427453
2440,800,4540,3632000,2,19526,4883,1,133292800,133292800,7321,2440,4881,2440,0,1,2442,1700105,1.700105
2840,800,4540,3632000,2,22726,5683,1,150380800,150380800,8521,2840,5681,2840,0,1,2842,1972404,1.972404
3240,800,4540,3632000,2,25926,6483,1,167468800,167468800,9721,3240,6481,3240,0,1,3242,312048,0.312048
3640,800,4540,3632000,2,29126,7283,1,184556800,184556800,10921,3640,7281,3640,0,1,3642,47034,0.047034
4040,800,4540,3632000,2,32326,8083,1,201644800,201644800,12121,4040,8081,4040,0,1,4042,893764,0.893764
4440,800,4540,3632000,2,35526,8883,1,218732800,218732800,13321,4440,8881,4440,0,1,4442,1585380,1.58538
4840,800,4540,3632000,2,38726,9683,1,235820800,235820800,14521,4840,9681,4840,0,1,4842,1340409,1.340409
5240,800,4540,3632000,2,41926,10483,1,252908800,252908800,15721,5240,10481,5240,0,1,5242,575172,0.575172
5640,800,4540,3632000,2,45126,11283,1,269996800,269996800,16921,5640,11281,5640,0,1,5642,820909,0.820909
6040,800,4540,3632000,2,48326,12083,1,287084800,287084800,18121,6040,12081,6040,0,1,6042,1395146,1.395146
6440,800,4540,3632000,2,51526,12883,1,304172800,304172800,19321,6440,12881,6440,0,1,6442,50061,0.050061
6840,800,4540,3632000,2,54726,13683,1,321260800,321260800,20521,6840,13681,6840,0,1,6842,1164657,1.164657
44,603,6055,3651165,2,358,91,1,31552936,31552936,133,44,89,44,0,1,46,69845,0.069845
544,603,6055,3651165,2,4358,1091,1,58184936,58184936,1633,544,1089,544,0,1,546,184679,0.184679
1044,603,6055,3651165,2,8358,2091,1,84816936,84816936,3133,1044,2089,1044,0,1,1046,122548,0.122548
1544,603,6055,3651165,2,12358,3091,1,111448936,111448936,4633,1544,3089,1544,0,1,1546,32192,0.032192
2044,603,6055,3651165,2,16358,4091,1,138080936,138080936,6133,2044,4089,2044,0,1,2046,1042772,1.042772
2544,603,6055,3651165,2,20358,5091,1,164712936,164712936,7633,2544,5089,2544,0,1,2546,33616,0.033616
3044,603,6055,3651165,2,24358,6091,1,191344936,191344936,9133,3044,6089,3044,0,1,3046,71311,0.071311
3544,603,6055,3651165,2,28358,7091,1,217976936,217976936,10633,3544,7089,3544,0,1,3546,11849,0.011849
4044,603,6055,3651165,2,32358,8091,1,244608936,244608936,12133,4044,8089,4044,0,1,4046,498553,0.498553
4544,603,6055,3651165,2,36358,9091,1,271240936,271240936,13633,4544,9089,4544,0,1,4546,1141870,1.14187
5044,603,6055,3651165,2,40358,10091,1,297872936,297872936,15133,5044,10089,5044,0,1,5046,233769,0.233769
5544,603,6055,3651165,2,44358,11091,1,324504936,324504936,16633,5544,11089,5544,0,1,5546,29432,0.029432
6044,603,6055,3651165,2,48358,12091,1,351136936,351136936,18133,6044,12089,6044,0,1,6046,95128,0.095128
6544,603,6055,3651165,2,52358,13091,1,377768936,377768936,19633,6544,13089,6544,0,1,6546,1429944,1.429944
7044,603,6055,3651165,2,56358,14091,1,404400936,404400936,21133,7044,14089,7044,0,1,7046,1143112,1.143112
40,550,6640,3652000,2,326,83,1,31516800,31516800,121,40,81,40,0,1,42,66757,0.066757
440,550,6640,3652000,2,3526,883,1,54524800,54524800,1321,440,881,440,0,1,442,327451,0.327451
840,550,6640,3652000,2,6726,1683,1,77532800,77532800,2521,840,1681,840,0,1,842,502363,0.502363
1240,550,6640,3652000,2,9926,2483,1,100540800,100540800,3721,1240,2481,1240,0,1,1242,193855,0.193855
1640,550,6640,3652000,2,13126,3283,1,123548800,123548800,4921,1640,3281,1640,0,1,1642,192727,0.192727
2040,550,6640,3652000,2,16326,4083,1,146556800,146556800,6121,2040,4081,2040,0,1,2042,208680,0.20868
2440,550,6640,3652000,2,19526,4883,1,169564800,169564800,7321,2440,4881,2440,0,1,2442,650834,0.650834
2840,550,6640,3652000,2,22726,5683,1,192572800,192572800,8521,2840,5681,2840,0,1,2842,61120,0.06112
3240,550,6640,3652000,2,25926,6483,1,215580800,215580800,9721,3240,6481,3240,0,1,3242,34704,0.034704
3640,550,6640,3652000,2,29126,7283,1,238588800,238588800,10921,3640,7281,3640,0,1,3642,346377,0.346377
4040,550,6640,3652000,2,32326,8083,1,261596800,261596800,12121,4040,8081,4040,0,1,4042,601531,0.601531
4440,550,6640,3652000,2,35526,8883,1,284604800,284604800,13321,4440,8881,4440,0,1,4442,723203,0.723203
4840,550,6640,3652000,2,38726,9683,1,307612800,307612800,14521,4840,9681,4840,0,1,4842,358625,0.358625
5240,550,6640,3652000,2,41926,10483,1,330620800,330620800,15721,5240,10481,5240,0,1,5242,2558825,2.558825
5640,550,6640,3652000,2,45126,11283,1,353628800,353628800,16921,5640,11281,5640,0,1,5642,935235,0.935235
6040,550,6640,3652000,2,48326,12083,1,376636800,376636800,18121,6040,12081,6040,0,1,6042,280539,0.280539
6440,550,6640,3652000,2,51526,12883,1,399644800,399644800,19321,6440,12881,6440,0,1,6442,1354394,1.354394
6840,550,6640,3652000,2,54726,13683,1,422652800,422652800,20521,6840,13681,6840,0,1,6842,796904,0.796904
55,3805,965,3671825,2,446,113,1,31473400,31473400,166,55,111,55,0,1,57,75953,0.075953
455,3805,965,3671825,2,3646,913,1,46737400,46737400,1366,455,911,455,0,1,457,359943,0.359943
855,3805,965,3671825,2,6846,1713,1,62001400,62001400,2566,855,1711,855,0,1,857,643329,0.643329
1255,3805,965,3671825,2,10046,2513,1,77265400,77265400,3766,1255,2511,1255,0,1,1257,933633,0.933633
1655,3805,965,3671825,2,13246,3313,1,92529400,92529400,4966,1655,3311,1655,0,1,1657,1219382,1.219382
2055,3805,965,3671825,2,16446,4113,1,107793400,107793400,6166,2055,4111,2055,0,1,2057,1522582,1.522582
2455,3805,965,3671825,2,19646,4913,1,123057400,123057400,7366,2455,4911,2455,0,1,2457,229092,0.229092
2855,3805,965,3671825,2,22846,5713,1,138321400,138321400,8566,2855,5711,2855,0,1,2857,2071640,2.07164
3255,3805,965,3671825,2,26046,6513,1,153585400,153585400,9766,3255,6511,3255,0,1,3257,2357794,2.357794
3655,3805,965,3671825,2,29246,7313,1,168849400,168849400,10966,3655,7311,3655,0,1,3657,444854,0.444854
4055,3805,965,3671825,2,32446,8113,1,184113400,184113400,12166,4055,8111,4055,0,1,4057,33201,0.033201
4455,3805,965,3671825,2,35646,8913,1,199377400,199377400,13366,4455,8911,4455,0,1,4457,2329371,2.329371
4855,3805,965,3671825,2,38846,9713,1,214641400,214641400,14566,4855,9711,4855,0,1,4857,3508718,3.508718
5255,3805,965,3671825,2,42046,10513,1,229905400,229905400,15766,5255,10511,5255,0,1,5257,117199,0.117199
5655,3805,965,3671825,2,45246,11313,1,245169400,245169400,16966,5655,11311,5655,0,1,5657,1099423,1.099423
6055,3805,965,3671825,2,48446,12113,1,260433400,260433400,18166,6055,12111,6055,0,1,6057,865601,0.865601
6455,3805,965,3671825,2,51646,12913,1,275697400,275697400,19366,6455,12911,6455,0,1,6457,2147239,2.147239
6855,3805,965,3671825,2,54846,13713,1,290961400,290961400,20566,6855,13711,6855,0,1,6857,4959757,4.959757
55,805,4565,3674825,2,446,113,1,31761400,31761400,166,55,111,55,0,1,57,76864,0.076864
455,805,4565,3674825,2,3646,913,1,48945400,48945400,1366,455,911,455,0,1,457,347155,0.347155
855,805,4565,3674825,2,6846,1713,1,66129400,66129400,2566,855,1711,855,0,1,857,346036,0.346036
1255,805,4565,3674825,2,10046,2513,1,83313400,83313400,3766,1255,2511,1255,0,1,1257,842960,0.84296
1655,805,4565,3674825,2,13246,3313,1,100497400,100497400,4966,1655,3311,1655,0,1,1657,837549,0.837549
2055,805,4565,3674825,2,16446,4113,1,117681400,117681400,6166,2055,4111,2055,0,1,2057,1463057,1.463057
2455,805,4565,3674825,2,19646,4913,1,134865400,134865400,7366,2455,4911,2455,0,1,2457,1745770,1.74577
2855,805,4565,3674825,2,22846,5713,1,152049400,152049400,8566,2855,5711,2855,0,1,2857,109799,0.109799
3255,805,4565,3674825,2,26046,6513,1,169233400,169233400,9766,3255,6511,3255,0,1,3257,168809,0.168809
3655,805,4565,3674825,2,29246,7313,1,186417400,186417400,10966,3655,7311,3655,0,1,3657,572373,0.572373
4055,805,4565,3674825,2,32446,8113,1,203601400,203601400,12166,4055,8111,4055,0,1,4057,2089322,2.089322
4455,805,4565,3674825,2,35646,8913,1,220785400,220785400,13366,4455,8911,4455,0,1,4457,2731595,2.731595
4855,805,4565,3674825,2,38846,9713,1,237969400,237969400,14566,4855,9711,4855,0,1,4857,2300268,2.300268
5255,805,4565,3674825,2,42046,10513,1,255153400,255153400,15766,5255,10511,5255,0,1,5257,462708,0.462708
5655,805,4565,3674825,2,45246,11313,1,272337400,272337400,16966,5655,11311,5655,0,1,5657,2158260,2.15826
6055,805,4565,3674825,2,48446,12113,1,289521400,289521400,18166,6055,12111,6055,0,1,6057,856569,0.856569
6455,805,4565,3674825,2,51646,12913,1,306705400,306705400,19366,6455,12911,6455,0,1,6457,1504208,1.504208
6855,805,4565,3674825,2,54846,13713,1,323889400,323889400,20566,6855,13711,6855,0,1,6857,310819,0.310819
44,6653,555,3692415,2,358,91,1,32076536,32076536,133,44,89,44,0,1,46,6775,0.006775
544,6653,555,3692415,2,4358,1091,1,60908536,60908536,1633,544,1089,544,0,1,546,107281,0.107281
1044,6653,555,3692415,2,8358,2091,1,89740536,89740536,3133,1044,2089,1044,0,1,1046,4821,0.004821
1544,6653,555,3692415,2,12358,3091,1,118572536,118572536,4633,1544,3089,1544,0,1,1546,358674,0.358674
2044,6653,555,3692415,2,16358,4091,1,147404536,147404536,6133,2044,4089,2044,0,1,2046,823047,0.823047
2544,6653,555,3692415,2,20358,5091,1,176236536,176236536,7633,2544,5089,2544,0,1,2546,294467,0.294467
3044,6653,555,3692415,2,24358,6091,1,205068536,205068536,9133,3044,6089,3044,0,1,3046,2236518,2.236518
3544,6653,555,3692415,2,28358,7091,1,233900536,233900536,10633,3544,7089,3544,0,1,3546,1112881,1.112881
4044,6653,555,3692415,2,32358,8091,1,262732536,262732536,12133,4044,8089,4044,0,1,4046,343652,0.343652
4544,6653,555,3692415,2,36358,9091,1,291564536,291564536,13633,4544,9089,4544,0,1,4546,1603661,1.603661
5044,6653,555,3692415,2,40358,10091,1,320396536,320396536,15133,5044,10089,5044,0,1,5046,3725861,3.725861
5544,6653,555,3692415,2,44358,11091,1,349228536,349228536,16633,5544,11089,5544,0,1,5546,606394,0.606394
6044,6653,555,3692415,2,48358,12091,1,378060536,378060536,18133,6044,12089,6044,0,1,6046,2725783,2.725783
6544,6653,555,3692415,2,52358,13091,1,406892536,406892536,19633,6544,13089,6544,0,1,6546,4820375,4.820375
7044,6653,555,3692415,2,56358,14091,1,435724536,435724536,21133,7044,14089,7044,0,1,7046,172721,0.172721
55,5555,665,3694075,2,446,113,1,32289400,32289400,166,55,111,55,0,1,57,74753,0.074753
455,5555,665,3694075,2,3646,913,1,52193400,52193400,1366,455,911,455,0,1,457,346200,0.3462
855,5555,665,3694075,2,6846,1713,1,72097400,72097400,2566,855,1711,855,0,1,857,406284,0.406284
1255,5555,665,3694075,2,10046,2513,1,92001400,92001400,3766,1255,2511,1255,0,1,1257,776927,0.776927
1655,5555,665,3694075,2,13246,3313,1,111905400,111905400,4966,1655,3311,1655,0,1,1657,1218035,1.218035
2055,5555,665,3694075,2,16446,4113,1,131809400,131809400,6166,2055,4111,2055,0,1,2057,1495810,1.49581
2455,5555,665,3694075,2,19646,4913,1,151713400,151713400,7366,2455,4911,2455,0,1,2457,1800394,1.800394
2855,5555,665,3694075,2,22846,5713,1,171617400,171617400,8566,2855,5711,2855,0,1,2857,2084153,2.084153
3255,5555,665,3694075,2,26046,6513,1,191521400,191521400,9766,3255,6511,3255,0,1,3257,2371463,2.371463
3655,5555,665,3694075,2,29246,7313,1,211425400,211425400,10966,3655,7311,3655,0,1,3657,754359,0.754359
4055,5555,665,3694075,2,32446,8113,1,231329400,231329400,12166,4055,8111,4055,0,1,4057,2107151,2.107151
4455,5555,665,3694075,2,35646,8913,1,251233400,251233400,13366,4455,8911,4455,0,1,4457,1121912,1.121912
4855,5555,665,3694075,2,38846,9713,1,271137400,271137400,14566,4855,9711,4855,0,1,4857,3200573,3.200573
5255,5555,665,3694075,2,42046,10513,1,291041400,291041400,15766,5255,10511,5255,0,1,5257,3835996,3.835996
5655,5555,665,3694075,2,45246,11313,1,310945400,310945400,16966,5655,11311,5655,0,1,5657,177344,0.177344
6055,5555,665,3694075,2,48446,12113,1,330849400,330849400,18166,6055,12111,6055,0,1,6057,2741436,2.741436
6455,5555,665,3694075,2,51646,12913,1,350753400,350753400,19366,6455,12911,6455,0,1,6457,3613099,3.613099
6855,5555,665,3694075,2,54846,13713,1,370657400,370657400,20566,6855,13711,6855,0,1,6857,4991369,4.991369
55,555,6665,3699075,2,446,113,1,32769400,32769400,166,55,111,55,0,1,57,77425,0.077425
455,555,6665,3699075,2,3646,913,1,55873400,55873400,1366,455,911,455,0,1,457,352761,0.352761
855,555,6665,3699075,2,6846,1713,1,78977400,78977400,2566,855,1711,855,0,1,857,636483,0.636483
1255,555,6665,3699075,2,10046,2513,1,102081400,102081400,3766,1255,2511,1255,0,1,1257,724087,0.724087
1655,555,6665,3699075,2,13246,3313,1,125185400,125185400,4966,1655,3311,1655,0,1,1657,98939,0.098939
2055,555,6665,3699075,2,16446,4113,1,148289400,148289400,6166,2055,4111,2055,0,1,2057,370290,0.37029
2455,555,6665,3699075,2,19646,4913,1,171393400,171393400,7366,2455,4911,2455,0,1,2457,498539,0.498539
2855,555,6665,3699075,2,22846,5713,1,194497400,194497400,8566,2855,5711,2855,0,1,2857,145895,0.145895
3255,555,6665,3699075,2,26046,6513,1,217601400,217601400,9766,3255,6511,3255,0,1,3257,925852,0.925852
3655,555,6665,3699075,2,29246,7313,1,240705400,240705400,10966,3655,7311,3655,0,1,3657,2619574,2.619574
4055,555,6665,3699075,2,32446,8113,1,263809400,263809400,12166,4055,8111,4055,0,1,4057,308873,0.308873
4455,555,6665,3699075,2,35646,8913,1,286913400,286913400,13366,4455,8911,4455,0,1,4457,629295,0.629295
4855,555,6665,3699075,2,38846,9713,1,310017400,310017400,14566,4855,9711,4855,0,1,4857,1249376,1.249376
5255,555,6665,3699075,2,42046,10513,1,333121400,333121400,15766,5255,10511,5255,0,1,5257,3768927,3.768927
5655,555,6665,3699075,2,45246,11313,1,356225400,356225400,16966,5655,11311,5655,0,1,5657,641372,0.641372
6055,555,6665,3699075,2,48446,12113,1,379329400,379329400,18166,6055,12111,6055,0,1,6057,49720,0.04972
6455,555,6665,3699075,2,51646,12913,1,402433400,402433400,19366,6455,12911,6455,0,1,6457,390484,0.390484
6855,555,6665,3699075,2,54846,13713,1,425537400,425537400,20566,6855,13711,6855,0,1,6857,477761,0.477761
40,5800,640,3712000,2,326,83,1,31756800,31756800,121,40,81,40,0,1,42,549,0.000549
440,5800,640,3712000,2,3526,883,1,52364800,52364800,1321,440,881,440,0,1,442,3596,0.003596
840,5800,640,3712000,2,6726,1683,1,72972800,72972800,2521,840,1681,840,0,1,842,173535,0.173535
1240,5800,640,3712000,2,9926,2483,1,93580800,93580800,3721,1240,2481,1240,0,1,1242,18816,0.018816
1640,5800,640,3712000,2,13126,3283,1,114188800,114188800,4921,1640,3281,1640,0,1,1642,277305,0.277305
2040,5800,640,3712000,2,16326,4083,1,134796800,134796800,6121,2040,4081,2040,0,1,2042,131473,0.131473
2440,5800,640,3712000,2,19526,4883,1,155404800,155404800,7321,2440,4881,2440,0,1,2442,74670,0.07467
2840,5800,640,3712000,2,22726,5683,1,176012800,176012800,8521,2840,5681,2840,0,1,2842,176021,0.176021
3240,5800,640,3712000,2,25926,6483,1,196620800,196620800,9721,3240,6481,3240,0,1,3242,65466,0.065466
3640,5800,640,3712000,2,29126,7283,1,217228800,217228800,10921,3640,7281,3640,0,1,3642,1903378,1.903378
4040,5800,640,3712000,2,32326,8083,1,237836800,237836800,12121,4040,8081,4040,0,1,4042,1902916,1.902916
4440,5800,640,3712000,2,35526,8883,1,258444800,258444800,13321,4440,8881,4440,0,1,4442,1981083,1.981083
4840,5800,640,3712000,2,38726,9683,1,279052800,279052800,14521,4840,9681,4840,0,1,4842,55181,0.055181
5240,5800,640,3712000,2,41926,10483,1,299660800,299660800,15721,5240,10481,5240,0,1,5242,3255263,3.255263
5640,5800,640,3712000,2,45126,11283,1,320268800,320268800,16921,5640,11281,5640,0,1,5642,841194,0.841194
6040,5800,640,3712000,2,48326,12083,1,340876800,340876800,18121,6040,12081,6040,0,1,6042,2900585,2.900585
6440,5800,640,3712000,2,51526,12883,1,361484800,361484800,19321,6440,12881,6440,0,1,6442,335283,0.335283
6840,5800,640,3712000,2,54726,13683,1,382092800,382092800,20521,6840,13681,6840,0,1,6842,1456894,1.456894
40,2050,1840,3772000,2,326,83,1,31420800,31420800,121,40,81,40,0,1,42,6865,0.006865
440,2050,1840,3772000,2,3526,883,1,43868800,43868800,1321,440,881,440,0,1,442,4900,0.0049
840,2050,1840,3772000,2,6726,1683,1,56316800,56316800,2521,840,1681,840,0,1,842,9468,0.009468
1240,2050,1840,3772000,2,9926,2483,1,68764800,68764800,3721,1240,2481,1240,0,1,1242,38256,0.038256
1640,2050,1840,3772000,2,13126,3283,1,81212800,81212800,4921,1640,3281,1640,0,1,1642,132709,0.132709
2040,2050,1840,3772000,2,16326,4083,1,93660800,93660800,6121,2040,4081,2040,0,1,2042,168278,0.168278
2440,2050,1840,3772000,2,19526,4883,1,106108800,106108800,7321,2440,4881,2440,0,1,2442,66432,0.066432
2840,2050,1840,3772000,2,22726,5683,1,118556800,118556800,8521,2840,5681,2840,0,1,2842,628156,0.628156
3240,2050,1840,3772000,2,25926,6483,1,131004800,131004800,9721,3240,6481,3240,0,1,3242,72214,0.072214
3640,2050,1840,3772000,2,29126,7283,1,143452800,143452800,10921,3640,7281,3640,0,1,3642,891537,0.891537
4040,2050,1840,3772000,2,32326,8083,1,155900800,155900800,12121,4040,8081,4040,0,1,4042,7930,0.00793
4440,2050,1840,3772000,2,35526,8883,1,168348800,168348800,13321,4440,8881,4440,0,1,4442,804132,0.804132
4840,2050,1840,3772000,2,38726,9683,1,180796800,180796800,14521,4840,9681,4840,0,1,4842,1603411,1.603411
5240,2050,1840,3772000,2,41926,10483,1,193244800,193244800,15721,5240,10481,5240,0,1,5242,206571,0.206571
5640,2050,1840,3772000,2,45126,11283,1,205692800,205692800,16921,5640,11281,5640,0,1,5642,392180,0.39218
6040,2050,1840,3772000,2,48326,12083,1,218140800,218140800,18121,6040,12081,6040,0,1,6042,164251,0.164251
6440,2050,1840,3772000,2,51526,12883,1,230588800,230588800,19321,6440,12881,6440,0,1,6442,159168,0.159168
6840,2050,1840,3772000,2,54726,13683,1,243036800,243036800,20521,6840,13681,6840,0,1,6842,1004711,1.004711
40,3050,1240,3782000,2,326,83,1,31628800,31628800,121,40,81,40,0,1,42,5413,0.005413
440,3050,1240,3782000,2,3526,883,1,45356800,45356800,1321,440,881,440,0,1,442,43333,0.043333
840,3050,1240,3782000,2,6726,1683,1,59084800,59084800,2521,840,1681,840,0,1,842,8793,0.008793
1240,3050,1240,3782000,2,9926,2483,1,72812800,72812800,3721,1240,2481,1240,0,1,1242,120485,0.120485
1640,3050,1240,3782000,2,13126,3283,1,86540800,86540800,4921,1640,3281,1640,0,1,1642,532949,0.532949
2040,3050,1240,3782000,2,16326,4083,1,100268800,100268800,6121,2040,4081,2040,0,1,2042,203198,0.203198
2440,3050,1240,3782000,2,19526,4883,1,113996800,113996800,7321,2440,4881,2440,0,1,2442,616510,0.61651
2840,3050,1240,3782000,2,22726,5683,1,127724800,127724800,8521,2840,5681,2840,0,1,2842,73051,0.073051
3240,3050,1240,3782000,2,25926,6483,1,141452800,141452800,9721,3240,6481,3240,0,1,3242,79545,0.079545
3640,3050,1240,3782000,2,29126,7283,1,155180800,155180800,10921,3640,7281,3640,0,1,3642,295431,0.295431
4040,3050,1240,3782000,2,32326,8083,1,168908800,168908800,12121,4040,8081,4040,0,1,4042,41700,0.0417
4440,3050,1240,3782000,2,35526,8883,1,182636800,182636800,13321,4440,8881,4440,0,1,4442,67083,0.067083
4840,3050,1240,3782000,2,38726,9683,1,196364800,196364800,14521,4840,9681,4840,0,1,4842,772258,0.772258
5240,3050,1240,3782000,2,41926,10483,1,210092800,210092800,15721,5240,10481,5240,0,1,5242,1200155,1.200155
5640,3050,1240,3782000,2,45126,11283,1,223820800,223820800,16921,5640,11281,5640,0,1,5642,2062001,2.062001
6040,3050,1240,3782000,2,48326,12083,1,237548800,237548800,18121,6040,12081,6040,0,1,6042,317438,0.317438
40,1550,2440,3782000,2,326,83,1,31532800,31532800,121,40,81,40,0,1,42,71312,0.071312
440,1550,2440,3782000,2,3526,883,1,44300800,44300800,1321,440,881,440,0,1,442,348465,0.348465
840,1550,2440,3782000,2,6726,1683,1,57068800,57068800,2521,840,1681,840,0,1,842,325365,0.325365
6440,3050,1240,3782000,2,51526,12883,1,251276800,251276800,19321,6440,12881,6440,0,1,6442,1054171,1.054171
1240,1550,2440,3782000,2,9926,2483,1,69836800,69836800,3721,1240,2481,1240,0,1,1242,921690,0.92169
1640,1550,2440,3782000,2,13126,3283,1,82604800,82604800,4921,1640,3281,1640,0,1,1642,1213201,1.213201
2040,1550,2440,3782000,2,16326,4083,1,95372800,95372800,6121,2040,4081,2040,0,1,2042,1502032,1.502032
2440,1550,2440,3782000,2,19526,4883,1,108140800,108140800,7321,2440,4881,2440,0,1,2442,1790996,1.790996
2840,1550,2440,3782000,2,22726,5683,1,120908800,120908800,8521,2840,5681,2840,0,1,2842,1361803,1.361803
3240,1550,2440,3782000,2,25926,6483,1,133676800,133676800,9721,3240,6481,3240,0,1,3242,175832,0.175832
6840,3050,1240,3782000,2,54726,13683,1,265004800,265004800,20521,6840,13681,6840,0,1,6842,4468896,4.468896
3640,1550,2440,3782000,2,29126,7283,1,146444800,146444800,10921,3640,7281,3640,0,1,3642,888010,0.88801
4040,1550,2440,3782000,2,32326,8083,1,159212800,159212800,12121,4040,8081,4040,0,1,4042,2943482,2.943482
4440,1550,2440,3782000,2,35526,8883,1,171980800,171980800,13321,4440,8881,4440,0,1,4442,72774,0.072774
4840,1550,2440,3782000,2,38726,9683,1,184748800,184748800,14521,4840,9681,4840,0,1,4842,162750,0.16275
5240,1550,2440,3782000,2,41926,10483,1,197516800,197516800,15721,5240,10481,5240,0,1,5242,1634733,1.634733
5640,1550,2440,3782000,2,45126,11283,1,210284800,210284800,16921,5640,11281,5640,0,1,5642,1933335,1.933335
6040,1550,2440,3782000,2,48326,12083,1,223052800,223052800,18121,6040,12081,6040,0,1,6042,712033,0.712033
6440,1550,2440,3782000,2,51526,12883,1,235820800,235820800,19321,6440,12881,6440,0,1,6442,3112250,3.11225
6840,1550,2440,3782000,2,54726,13683,1,248588800,248588800,20521,6840,13681,6840,0,1,6842,1438249,1.438249
40,4050,940,3807000,2,326,83,1,32052800,32052800,121,40,81,40,0,1,42,12424,0.012424
440,4050,940,3807000,2,3526,883,1,48020800,48020800,1321,440,881,440,0,1,442,2302,0.002302
840,4050,940,3807000,2,6726,1683,1,63988800,63988800,2521,840,1681,840,0,1,842,94942,0.094942
1240,4050,940,3807000,2,9926,2483,1,79956800,79956800,3721,1240,2481,1240,0,1,1242,2512,0.002512
1640,4050,940,3807000,2,13126,3283,1,95924800,95924800,4921,1640,3281,1640,0,1,1642,30330,0.03033
2040,4050,940,3807000,2,16326,4083,1,111892800,111892800,6121,2040,4081,2040,0,1,2042,413780,0.41378
2440,4050,940,3807000,2,19526,4883,1,127860800,127860800,7321,2440,4881,2440,0,1,2442,518292,0.518292
2840,4050,940,3807000,2,22726,5683,1,143828800,143828800,8521,2840,5681,2840,0,1,2842,1277783,1.277783
3240,4050,940,3807000,2,25926,6483,1,159796800,159796800,9721,3240,6481,3240,0,1,3242,445761,0.445761
3640,4050,940,3807000,2,29126,7283,1,175764800,175764800,10921,3640,7281,3640,0,1,3642,808970,0.80897
4040,4050,940,3807000,2,32326,8083,1,191732800,191732800,12121,4040,8081,4040,0,1,4042,1146239,1.146239
4440,4050,940,3807000,2,35526,8883,1,207700800,207700800,13321,4440,8881,4440,0,1,4442,465,0.000465
4840,4050,940,3807000,2,38726,9683,1,223668800,223668800,14521,4840,9681,4840,0,1,4842,2512108,2.512108
5240,4050,940,3807000,2,41926,10483,1,239636800,239636800,15721,5240,10481,5240,0,1,5242,469395,0.469395
5640,4050,940,3807000,2,45126,11283,1,255604800,255604800,16921,5640,11281,5640,0,1,5642,2102607,2.102607
6040,4050,940,3807000,2,48326,12083,1,271572800,271572800,18121,6040,12081,6040,0,1,6042,672801,0.672801
6440,4050,940,3807000,2,51526,12883,1,287540800,287540800,19321,6440,12881,6440,0,1,6442,94276,0.094276
6840,4050,940,3807000,2,54726,13683,1,303508800,303508800,20521,6840,13681,6840,0,1,6842,4931773,4.931773
40,550,6940,3817000,2,326,83,1,32932800,32932800,121,40,81,40,0,1,42,70709,0.070709
440,550,6940,3817000,2,3526,883,1,56900800,56900800,1321,440,881,440,0,1,442,349919,0.349919
840,550,6940,3817000,2,6726,1683,1,80868800,80868800,2521,840,1681,840,0,1,842,636818,0.636818
1240,550,6940,3817000,2,9926,2483,1,104836800,104836800,3721,1240,2481,1240,0,1,1242,502757,0.502757
1640,550,6940,3817000,2,13126,3283,1,128804800,128804800,4921,1640,3281,1640,0,1,1642,98807,0.098807
2040,550,6940,3817000,2,16326,4083,1,152772800,152772800,6121,2040,4081,2040,0,1,2042,33465,0.033465
2440,550,6940,3817000,2,19526,4883,1,176740800,176740800,7321,2440,4881,2440,0,1,2442,1795682,1.795682
2840,550,6940,3817000,2,22726,5683,1,200708800,200708800,8521,2840,5681,2840,0,1,2842,34038,0.034038
3240,550,6940,3817000,2,25926,6483,1,224676800,224676800,9721,3240,6481,3240,0,1,3242,495642,0.495642
3640,550,6940,3817000,2,29126,7283,1,248644800,248644800,10921,3640,7281,3640,0,1,3642,615792,0.615792
4040,550,6940,3817000,2,32326,8083,1,272612800,272612800,12121,4040,8081,4040,0,1,4042,1121406,1.121406
4440,550,6940,3817000,2,35526,8883,1,296580800,296580800,13321,4440,8881,4440,0,1,4442,1916301,1.916301
4840,550,6940,3817000,2,38726,9683,1,320548800,320548800,14521,4840,9681,4840,0,1,4842,730614,0.730614
5240,550,6940,3817000,2,41926,10483,1,344516800,344516800,15721,5240,10481,5240,0,1,5242,2159271,2.159271
5640,550,6940,3817000,2,45126,11283,1,368484800,368484800,16921,5640,11281,5640,0,1,5642,2028995,2.028995
6040,550,6940,3817000,2,48326,12083,1,392452800,392452800,18121,6040,12081,6040,0,1,6042,1678537,1.678537
6440,550,6940,3817000,2,51526,12883,1,416420800,416420800,19321,6440,12881,6440,0,1,6442,660852,0.660852
6840,550,6940,3817000,2,54726,13683,1,440388800,440388800,20521,6840,13681,6840,0,1,6842,1223397,1.223397
40,1050,3640,3822000,2,326,83,1,32076800,32076800,121,40,81,40,0,1,42,3478,0.003478
440,1050,3640,3822000,2,3526,883,1,47084800,47084800,1321,440,881,440,0,1,442,13187,0.013187
840,1050,3640,3822000,2,6726,1683,1,62092800,62092800,2521,840,1681,840,0,1,842,17744,0.017744
1240,1050,3640,3822000,2,9926,2483,1,77100800,77100800,3721,1240,2481,1240,0,1,1242,94850,0.09485
1640,1050,3640,3822000,2,13126,3283,1,92108800,92108800,4921,1640,3281,1640,0,1,1642,63193,0.063193
2040,1050,3640,3822000,2,16326,4083,1,107116800,107116800,6121,2040,4081,2040,0,1,2042,199387,0.199387
2440,1050,3640,3822000,2,19526,4883,1,122124800,122124800,7321,2440,4881,2440,0,1,2442,366095,0.366095
2840,1050,3640,3822000,2,22726,5683,1,137132800,137132800,8521,2840,5681,2840,0,1,2842,404822,0.404822
3240,1050,3640,3822000,2,25926,6483,1,152140800,152140800,9721,3240,6481,3240,0,1,3242,9204,0.009204
3640,1050,3640,3822000,2,29126,7283,1,167148800,167148800,10921,3640,7281,3640,0,1,3642,666785,0.666785
4040,1050,3640,3822000,2,32326,8083,1,182156800,182156800,12121,4040,8081,4040,0,1,4042,434034,0.434034
4440,1050,3640,3822000,2,35526,8883,1,197164800,197164800,13321,4440,8881,4440,0,1,4442,602931,0.602931
4840,1050,3640,3822000,2,38726,9683,1,212172800,212172800,14521,4840,9681,4840,0,1,4842,272543,0.272543
5240,1050,3640,3822000,2,41926,10483,1,227180800,227180800,15721,5240,10481,5240,0,1,5242,99745,0.099745
5640,1050,3640,3822000,2,45126,11283,1,242188800,242188800,16921,5640,11281,5640,0,1,5642,1189089,1.189089
6040,1050,3640,3822000,2,48326,12083,1,257196800,257196800,18121,6040,12081,6040,0,1,6042,252979,0.252979
6440,1050,3640,3822000,2,51526,12883,1,272204800,272204800,19321,6440,12881,6440,0,1,6442,415192,0.415192
6840,1050,3640,3822000,2,54726,13683,1,287212800,287212800,20521,6840,13681,6840,0,1,6842,18028,0.018028
55,2055,1865,3832575,2,446,113,1,32385400,32385400,166,55,111,55,0,1,57,15955,0.015955
455,2055,1865,3832575,2,3646,913,1,44929400,44929400,1366,455,911,455,0,1,457,57549,0.057549
855,2055,1865,3832575,2,6846,1713,1,57473400,57473400,2566,855,1711,855,0,1,857,4302,0.004302
1255,2055,1865,3832575,2,10046,2513,1,70017400,70017400,3766,1255,2511,1255,0,1,1257,101282,0.101282
1655,2055,1865,3832575,2,13246,3313,1,82561400,82561400,4966,1655,3311,1655,0,1,1657,159166,0.159166
2055,2055,1865,3832575,2,16446,4113,1,95105400,95105400,6166,2055,4111,2055,0,1,2057,220592,0.220592
2455,2055,1865,3832575,2,19646,4913,1,107649400,107649400,7366,2455,4911,2455,0,1,2457,914804,0.914804
2855,2055,1865,3832575,2,22846,5713,1,120193400,120193400,8566,2855,5711,2855,0,1,2857,49589,0.049589
3255,2055,1865,3832575,2,26046,6513,1,132737400,132737400,9766,3255,6511,3255,0,1,3257,221973,0.221973
3655,2055,1865,3832575,2,29246,7313,1,145281400,145281400,10966,3655,7311,3655,0,1,3657,190062,0.190062
4055,2055,1865,3832575,2,32446,8113,1,157825400,157825400,12166,4055,8111,4055,0,1,4057,1086837,1.086837
4455,2055,1865,3832575,2,35646,8913,1,170369400,170369400,13366,4455,8911,4455,0,1,4457,895967,0.895967
4855,2055,1865,3832575,2,38846,9713,1,182913400,182913400,14566,4855,9711,4855,0,1,4857,1012500,1.0125
5255,2055,1865,3832575,2,42046,10513,1,195457400,195457400,15766,5255,10511,5255,0,1,5257,1833160,1.83316
5655,2055,1865,3832575,2,45246,11313,1,208001400,208001400,16966,5655,11311,5655,0,1,5657,298744,0.298744
6055,2055,1865,3832575,2,48446,12113,1,220545400,220545400,18166,6055,12111,6055,0,1,6057,74762,0.074762
6455,2055,1865,3832575,2,51646,12913,1,233089400,233089400,19366,6455,12911,6455,0,1,6457,22112,0.022112
6855,2055,1865,3832575,2,54846,13713,1,245633400,245633400,20566,6855,13711,6855,0,1,6857,3021738,3.021738
55,1555,2465,3833075,2,446,113,1,32433400,32433400,166,55,111,55,0,1,57,78947,0.078947
455,1555,2465,3833075,2,3646,913,1,45297400,45297400,1366,455,911,455,0,1,457,368951,0.368951
855,1555,2465,3833075,2,6846,1713,1,58161400,58161400,2566,855,1711,855,0,1,857,182620,0.18262
1255,1555,2465,3833075,2,10046,2513,1,71025400,71025400,3766,1255,2511,1255,0,1,1257,957534,0.957534
1655,1555,2465,3833075,2,13246,3313,1,83889400,83889400,4966,1655,3311,1655,0,1,1657,1257367,1.257367
2055,1555,2465,3833075,2,16446,4113,1,96753400,96753400,6166,2055,4111,2055,0,1,2057,822730,0.82273
2455,1555,2465,3833075,2,19646,4913,1,109617400,109617400,7366,2455,4911,2455,0,1,2457,1854753,1.854753
2855,1555,2465,3833075,2,22846,5713,1,122481400,122481400,8566,2855,5711,2855,0,1,2857,1789762,1.789762
3255,1555,2465,3833075,2,26046,6513,1,135345400,135345400,9766,3255,6511,3255,0,1,3257,2452372,2.452372
3655,1555,2465,3833075,2,29246,7313,1,148209400,148209400,10966,3655,7311,3655,0,1,3657,382838,0.382838
4055,1555,2465,3833075,2,32446,8113,1,161073400,161073400,12166,4055,8111,4055,0,1,4057,802573,0.802573
4455,1555,2465,3833075,2,35646,8913,1,173937400,173937400,13366,4455,8911,4455,0,1,4457,39719,0.039719
4855,1555,2465,3833075,2,38846,9713,1,186801400,186801400,14566,4855,9711,4855,0,1,4857,134734,0.134734
5255,1555,2465,3833075,2,42046,10513,1,199665400,199665400,15766,5255,10511,5255,0,1,5257,710856,0.710856
5655,1555,2465,3833075,2,45246,11313,1,212529400,212529400,16966,5655,11311,5655,0,1,5657,2382926,2.382926
6055,1555,2465,3833075,2,48446,12113,1,225393400,225393400,18166,6055,12111,6055,0,1,6057,1512566,1.512566
6455,1555,2465,3833075,2,51646,12913,1,238257400,238257400,19366,6455,12911,6455,0,1,6457,359567,0.359567
6855,1555,2465,3833075,2,54846,13713,1,251121400,251121400,20566,6855,13711,6855,0,1,6857,1073514,1.073514
40,1800,2140,3852000,2,326,83,1,32076800,32076800,121,40,81,40,0,1,42,72378,0.072378
440,1800,2140,3852000,2,3526,883,1,44684800,44684800,1321,440,881,440,0,1,442,48292,0.048292
840,1800,2140,3852000,2,6726,1683,1,57292800,57292800,2521,840,1681,840,0,1,842,330897,0.330897
1240,1800,2140,3852000,2,9926,2483,1,69900800,69900800,3721,1240,2481,1240,0,1,1242,406967,0.406967
1640,1800,2140,3852000,2,13126,3283,1,82508800,82508800,4921,1640,3281,1640,0,1,1642,876200,0.8762
2040,1800,2140,3852000,2,16326,4083,1,95116800,95116800,6121,2040,4081,2040,0,1,2042,978764,0.978764
2440,1800,2140,3852000,2,19526,4883,1,107724800,107724800,7321,2440,4881,2440,0,1,2442,1837939,1.837939
2840,1800,2140,3852000,2,22726,5683,1,120332800,120332800,8521,2840,5681,2840,0,1,2842,900035,0.900035
3240,1800,2140,3852000,2,25926,6483,1,132940800,132940800,9721,3240,6481,3240,0,1,3242,746295,0.746295
3640,1800,2140,3852000,2,29126,7283,1,145548800,145548800,10921,3640,7281,3640,0,1,3642,288131,0.288131
4040,1800,2140,3852000,2,32326,8083,1,158156800,158156800,12121,4040,8081,4040,0,1,4042,562765,0.562765
4440,1800,2140,3852000,2,35526,8883,1,170764800,170764800,13321,4440,8881,4440,0,1,4442,242913,0.242913
4840,1800,2140,3852000,2,38726,9683,1,183372800,183372800,14521,4840,9681,4840,0,1,4842,490308,0.490308
5240,1800,2140,3852000,2,41926,10483,1,195980800,195980800,15721,5240,10481,5240,0,1,5242,337699,0.337699
5640,1800,2140,3852000,2,45126,11283,1,208588800,208588800,16921,5640,11281,5640,0,1,5642,4222695,4.222695
6040,1800,2140,3852000,2,48326,12083,1,221196800,221196800,18121,6040,12081,6040,0,1,6042,2218989,2.218989
6440,1800,2140,3852000,2,51526,12883,1,233804800,233804800,19321,6440,12881,6440,0,1,6442,1311411,1.311411
6840,1800,2140,3852000,2,54726,13683,1,246412800,246412800,20521,6840,13681,6840,0,1,6842,310734,0.310734
55,5805,665,3860325,2,446,113,1,33729400,33729400,166,55,111,55,0,1,57,6667,0.006667
455,5805,665,3860325,2,3646,913,1,54433400,54433400,1366,455,911,455,0,1,457,53884,0.053884
855,5805,665,3860325,2,6846,1713,1,75137400,75137400,2566,855,1711,855,0,1,857,58743,0.058743
1255,5805,665,3860325,2,10046,2513,1,95841400,95841400,3766,1255,2511,1255,0,1,1257,312582,0.312582
1655,5805,665,3860325,2,13246,3313,1,116545400,116545400,4966,1655,3311,1655,0,1,1657,31598,0.031598
2055,5805,665,3860325,2,16446,4113,1,137249400,137249400,6166,2055,4111,2055,0,1,2057,104086,0.104086
2455,5805,665,3860325,2,19646,4913,1,157953400,157953400,7366,2455,4911,2455,0,1,2457,160849,0.160849
2855,5805,665,3860325,2,22846,5713,1,178657400,178657400,8566,2855,5711,2855,0,1,2857,777277,0.777277
3255,5805,665,3860325,2,26046,6513,1,199361400,199361400,9766,3255,6511,3255,0,1,3257,548231,0.548231
3655,5805,665,3860325,2,29246,7313,1,220065400,220065400,10966,3655,7311,3655,0,1,3657,346088,0.346088
4055,5805,665,3860325,2,32446,8113,1,240769400,240769400,12166,4055,8111,4055,0,1,4057,64816,0.064816
4455,5805,665,3860325,2,35646,8913,1,261473400,261473400,13366,4455,8911,4455,0,1,4457,563810,0.56381
4855,5805,665,3860325,2,38846,9713,1,282177400,282177400,14566,4855,9711,4855,0,1,4857,719149,0.719149
5255,5805,665,3860325,2,42046,10513,1,302881400,302881400,15766,5255,10511,5255,0,1,5257,84786,0.084786
5655,5805,665,3860325,2,45246,11313,1,323585400,323585400,16966,5655,11311,5655,0,1,5657,377562,0.377562
6055,5805,665,3860325,2,48446,12113,1,344289400,344289400,18166,6055,12111,6055,0,1,6057,282950,0.28295
6455,5805,665,3860325,2,51646,12913,1,364993400,364993400,19366,6455,12911,6455,0,1,6457,205406,0.205406
6855,5805,665,3860325,2,54846,13713,1,385697400,385697400,20566,6855,13711,6855,0,1,6857,13280,0.01328
35,590,6545,3861550,2,286,73,1,32890200,32890200,106,35,71,35,0,1,37,7592,0.007592
535,590,6545,3861550,2,4286,1073,1,61430200,61430200,1606,535,1071,535,0,1,537,41035,0.041035
1035,590,6545,3861550,2,8286,2073,1,89970200,89970200,3106,1035,2071,1035,0,1,1037,163523,0.163523
1535,590,6545,3861550,2,12286,3073,1,118510200,118510200,4606,1535,3071,1535,0,1,1537,111314,0.111314
2035,590,6545,3861550,2,16286,4073,1,147050200,147050200,6106,2035,4071,2035,0,1,2037,1591935,1.591935
2535,590,6545,3861550,2,20286,5073,1,175590200,175590200,7606,2535,5071,2535,0,1,2537,1963823,1.963823
3035,590,6545,3861550,2,24286,6073,1,204130200,204130200,9106,3035,6071,3035,0,1,3037,2339762,2.339762
3535,590,6545,3861550,2,28286,7073,1,232670200,232670200,10606,3535,7071,3535,0,1,3537,2756643,2.756643
4035,590,6545,3861550,2,32286,8073,1,261210200,261210200,12106,4035,8071,4035,0,1,4037,3135164,3.135164
4535,590,6545,3861550,2,36286,9073,1,289750200,289750200,13606,4535,9071,4535,0,1,4537,3522763,3.522763
5035,590,6545,3861550,2,40286,10073,1,318290200,318290200,15106,5035,10071,5035,0,1,5037,3915575,3.915575
5535,590,6545,3861550,2,44286,11073,1,346830200,346830200,16606,5535,11071,5535,0,1,5537,4312805,4.312805
6035,590,6545,3861550,2,48286,12073,1,375370200,375370200,18106,6035,12071,6035,0,1,6037,4769776,4.769776
6535,590,6545,3861550,2,52286,13073,1,403910200,403910200,19606,6535,13071,6535,0,1,6537,5081020,5.08102
7035,590,6545,3861550,2,56286,14073,1,432450200,432450200,21106,7035,14071,7035,0,1,7037,5474287,5.474287
55,3055,1265,3864575,2,446,113,1,32817400,32817400,166,55,111,55,0,1,57,711,0.000711
455,3055,1265,3864575,2,3646,913,1,46641400,46641400,1366,455,911,455,0,1,457,15850,0.01585
855,3055,1265,3864575,2,6846,1713,1,60465400,60465400,2566,855,1711,855,0,1,857,87036,0.087036
1255,3055,1265,3864575,2,10046,2513,1,74289400,74289400,3766,1255,2511,1255,0,1,1257,13756,0.013756
1655,3055,1265,3864575,2,13246,3313,1,88113400,88113400,4966,1655,3311,1655,0,1,1657,88027,0.088027
2055,3055,1265,3864575,2,16446,4113,1,101937400,101937400,6166,2055,4111,2055,0,1,2057,570277,0.570277
2455,3055,1265,3864575,2,19646,4913,1,115761400,115761400,7366,2455,4911,2455,0,1,2457,222438,0.222438
2855,3055,1265,3864575,2,22846,5713,1,129585400,129585400,8566,2855,5711,2855,0,1,2857,606722,0.606722
3255,3055,1265,3864575,2,26046,6513,1,143409400,143409400,9766,3255,6511,3255,0,1,3257,654555,0.654555
3655,3055,1265,3864575,2,29246,7313,1,157233400,157233400,10966,3655,7311,3655,0,1,3657,111602,0.111602
4055,3055,1265,3864575,2,32446,8113,1,171057400,171057400,12166,4055,8111,4055,0,1,4057,1435162,1.435162
4455,3055,1265,3864575,2,35646,8913,1,184881400,184881400,13366,4455,8911,4455,0,1,4457,881576,0.881576
4855,3055,1265,3864575,2,38846,9713,1,198705400,198705400,14566,4855,9711,4855,0,1,4857,103653,0.103653
5255,3055,1265,3864575,2,42046,10513,1,212529400,212529400,15766,5255,10511,5255,0,1,5257,2110224,2.110224
5655,3055,1265,3864575,2,45246,11313,1,226353400,226353400,16966,5655,11311,5655,0,1,5657,1192923,1.192923
6055,3055,1265,3864575,2,48446,12113,1,240177400,240177400,18166,6055,12111,6055,0,1,6057,511230,0.51123
6455,3055,1265,3864575,2,51646,12913,1,254001400,254001400,19366,6455,12911,6455,0,1,6457,573740,0.57374
6855,3055,1265,3864575,2,54846,13713,1,267825400,267825400,20566,6855,13711,6855,0,1,6857,4090746,4.090746
55,555,6965,3865575,2,446,113,1,34233400,34233400,166,55,111,55,0,1,57,80818,0.080818
455,555,6965,3865575,2,3646,913,1,58297400,58297400,1366,455,911,455,0,1,457,369765,0.369765
855,555,6965,3865575,2,6846,1713,1,82361400,82361400,2566,855,1711,855,0,1,857,110557,0.110557
1255,555,6965,3865575,2,10046,2513,1,106425400,106425400,3766,1255,2511,1255,0,1,1257,368200,0.3682
1655,555,6965,3865575,2,13246,3313,1,130489400,130489400,4966,1655,3311,1655,0,1,1657,1255955,1.255955
2055,555,6965,3865575,2,16446,4113,1,154553400,154553400,6166,2055,4111,2055,0,1,2057,953736,0.953736
2455,555,6965,3865575,2,19646,4913,1,178617400,178617400,7366,2455,4911,2455,0,1,2457,1471708,1.471708
2855,555,6965,3865575,2,22846,5713,1,202681400,202681400,8566,2855,5711,2855,0,1,2857,281965,0.281965
3255,555,6965,3865575,2,26046,6513,1,226745400,226745400,9766,3255,6511,3255,0,1,3257,1360881,1.360881
3655,555,6965,3865575,2,29246,7313,1,250809400,250809400,10966,3655,7311,3655,0,1,3657,493841,0.493841
4055,555,6965,3865575,2,32446,8113,1,274873400,274873400,12166,4055,8111,4055,0,1,4057,706127,0.706127
4455,555,6965,3865575,2,35646,8913,1,298937400,298937400,13366,4455,8911,4455,0,1,4457,407200,0.4072
4855,555,6965,3865575,2,38846,9713,1,323001400,323001400,14566,4855,9711,4855,0,1,4857,486903,0.486903
5255,555,6965,3865575,2,42046,10513,1,347065400,347065400,15766,5255,10511,5255,0,1,5257,1601484,1.601484
5655,555,6965,3865575,2,45246,11313,1,371129400,371129400,16966,5655,11311,5655,0,1,5657,2232578,2.232578
6055,555,6965,3865575,2,48446,12113,1,395193400,395193400,18166,6055,12111,6055,0,1,6057,178986,0.178986
6455,555,6965,3865575,2,51646,12913,1,419257400,419257400,19366,6455,12911,6455,0,1,6457,1759135,1.759135
6855,555,6965,3865575,2,54846,13713,1,443321400,443321400,20566,6855,13711,6855,0,1,6857,938518,0.938518
55,1055,3665,3866575,2,446,113,1,33009400,33009400,166,55,111,55,0,1,57,7846,0.007846
455,1055,3665,3866575,2,3646,913,1,48113400,48113400,1366,455,911,455,0,1,457,3824,0.003824
855,1055,3665,3866575,2,6846,1713,1,63217400,63217400,2566,855,1711,855,0,1,857,99702,0.099702
1255,1055,3665,3866575,2,10046,2513,1,78321400,78321400,3766,1255,2511,1255,0,1,1257,107932,0.107932
1655,1055,3665,3866575,2,13246,3313,1,93425400,93425400,4966,1655,3311,1655,0,1,1657,27306,0.027306
2055,1055,3665,3866575,2,16446,4113,1,108529400,108529400,6166,2055,4111,2055,0,1,2057,210592,0.210592
2455,1055,3665,3866575,2,19646,4913,1,123633400,123633400,7366,2455,4911,2455,0,1,2457,97753,0.097753
2855,1055,3665,3866575,2,22846,5713,1,138737400,138737400,8566,2855,5711,2855,0,1,2857,138736,0.138736
3255,1055,3665,3866575,2,26046,6513,1,153841400,153841400,9766,3255,6511,3255,0,1,3257,27113,0.027113
3655,1055,3665,3866575,2,29246,7313,1,168945400,168945400,10966,3655,7311,3655,0,1,3657,399027,0.399027
4055,1055,3665,3866575,2,32446,8113,1,184049400,184049400,12166,4055,8111,4055,0,1,4057,848493,0.848493
4455,1055,3665,3866575,2,35646,8913,1,199153400,199153400,13366,4455,8911,4455,0,1,4457,30580,0.03058
4855,1055,3665,3866575,2,38846,9713,1,214257400,214257400,14566,4855,9711,4855,0,1,4857,208102,0.208102
5255,1055,3665,3866575,2,42046,10513,1,229361400,229361400,15766,5255,10511,5255,0,1,5257,1725905,1.725905
5655,1055,3665,3866575,2,45246,11313,1,244465400,244465400,16966,5655,11311,5655,0,1,5657,712582,0.712582
6055,1055,3665,3866575,2,48446,12113,1,259569400,259569400,18166,6055,12111,6055,0,1,6057,43096,0.043096
6455,1055,3665,3866575,2,51646,12913,1,274673400,274673400,19366,6455,12911,6455,0,1,6457,749160,0.74916
6855,1055,3665,3866575,2,54846,13713,1,289777400,289777400,20566,6855,13711,6855,0,1,6857,655760,0.65576
40,800,4840,3872000,2,326,83,1,32780800,32780800,121,40,81,40,0,1,42,70705,0.070705
440,800,4840,3872000,2,3526,883,1,50828800,50828800,1321,440,881,440,0,1,442,353835,0.353835
840,800,4840,3872000,2,6726,1683,1,68876800,68876800,2521,840,1681,840,0,1,842,636435,0.636435
1240,800,4840,3872000,2,9926,2483,1,86924800,86924800,3721,1240,2481,1240,0,1,1242,925300,0.9253
1640,800,4840,3872000,2,13126,3283,1,104972800,104972800,4921,1640,3281,1640,0,1,1642,824504,0.824504
2040,800,4840,3872000,2,16326,4083,1,123020800,123020800,6121,2040,4081,2040,0,1,2042,1501287,1.501287
2440,800,4840,3872000,2,19526,4883,1,141068800,141068800,7321,2440,4881,2440,0,1,2442,1791073,1.791073
2840,800,4840,3872000,2,22726,5683,1,159116800,159116800,8521,2840,5681,2840,0,1,2842,330089,0.330089
3240,800,4840,3872000,2,25926,6483,1,177164800,177164800,9721,3240,6481,3240,0,1,3242,98510,0.09851
3640,800,4840,3872000,2,29126,7283,1,195212800,195212800,10921,3640,7281,3640,0,1,3642,1047572,1.047572
4040,800,4840,3872000,2,32326,8083,1,213260800,213260800,12121,4040,8081,4040,0,1,4042,76043,0.076043
4440,800,4840,3872000,2,35526,8883,1,231308800,231308800,13321,4440,8881,4440,0,1,4442,1274880,1.27488
4840,800,4840,3872000,2,38726,9683,1,249356800,249356800,14521,4840,9681,4840,0,1,4842,672316,0.672316
5240,800,4840,3872000,2,41926,10483,1,267404800,267404800,15721,5240,10481,5240,0,1,5242,848942,0.848942
5640,800,4840,3872000,2,45126,11283,1,285452800,285452800,16921,5640,11281,5640,0,1,5642,878963,0.878963
6040,800,4840,3872000,2,48326,12083,1,303500800,303500800,18121,6040,12081,6040,0,1,6042,3893753,3.893753
6440,800,4840,3872000,2,51526,12883,1,321548800,321548800,19321,6440,12881,6440,0,1,6442,562453,0.562453
6840,800,4840,3872000,2,54726,13683,1,339596800,339596800,20521,6840,13681,6840,0,1,6842,1777202,1.777202
40,6050,640,3872000,2,326,83,1,33116800,33116800,121,40,81,40,0,1,42,66058,0.066058
440,6050,640,3872000,2,3526,883,1,54524800,54524800,1321,440,881,440,0,1,442,118578,0.118578
840,6050,640,3872000,2,6726,1683,1,75932800,75932800,2521,840,1681,840,0,1,842,615135,0.615135
1240,6050,640,3872000,2,9926,2483,1,97340800,97340800,3721,1240,2481,1240,0,1,1242,896426,0.896426
1640,6050,640,3872000,2,13126,3283,1,118748800,118748800,4921,1640,3281,1640,0,1,1642,1177548,1.177548
2040,6050,640,3872000,2,16326,4083,1,140156800,140156800,6121,2040,4081,2040,0,1,2042,149219,0.149219
2440,6050,640,3872000,2,19526,4883,1,161564800,161564800,7321,2440,4881,2440,0,1,2442,1745717,1.745717
2840,6050,640,3872000,2,22726,5683,1,182972800,182972800,8521,2840,5681,2840,0,1,2842,2016070,2.01607
3240,6050,640,3872000,2,25926,6483,1,204380800,204380800,9721,3240,6481,3240,0,1,3242,2086775,2.086775
3640,6050,640,3872000,2,29126,7283,1,225788800,225788800,10921,3640,7281,3640,0,1,3642,249006,0.249006
4040,6050,640,3872000,2,32326,8083,1,247196800,247196800,12121,4040,8081,4040,0,1,4042,1092989,1.092989
4440,6050,640,3872000,2,35526,8883,1,268604800,268604800,13321,4440,8881,4440,0,1,4442,3176392,3.176392
4840,6050,640,3872000,2,38726,9683,1,290012800,290012800,14521,4840,9681,4840,0,1,4842,9431,0.009431
5240,6050,640,3872000,2,41926,10483,1,311420800,311420800,15721,5240,10481,5240,0,1,5242,3745076,3.745076
5640,6050,640,3872000,2,45126,11283,1,332828800,332828800,16921,5640,11281,5640,0,1,5642,291691,0.291691
6040,6050,640,3872000,2,48326,12083,1,354236800,354236800,18121,6040,12081,6040,0,1,6042,4298741,4.298741
6440,6050,640,3872000,2,51526,12883,1,375644800,375644800,19321,6440,12881,6440,0,1,6442,956539,0.956539
6840,6050,640,3872000,2,54726,13683,1,397052800,397052800,20521,6840,13681,6840,0,1,6842,1224592,1.224592
39,593,6541,3878813,2,318,81,1,33256312,33256312,118,39,79,39,0,1,41,74207,0.074207
539,593,6541,3878813,2,4318,1081,1,61792312,61792312,1618,539,1079,539,0,1,541,122734,0.122734
1039,593,6541,3878813,2,8318,2081,1,90328312,90328312,3118,1039,2079,1039,0,1,1041,141482,0.141482
1539,593,6541,3878813,2,12318,3081,1,118864312,118864312,4618,1539,3079,1539,0,1,1541,422890,0.42289
2039,593,6541,3878813,2,16318,4081,1,147400312,147400312,6118,2039,4079,2039,0,1,2041,1465277,1.465277
2539,593,6541,3878813,2,20318,5081,1,175936312,175936312,7618,2539,5079,2539,0,1,2541,395222,0.395222
3039,593,6541,3878813,2,24318,6081,1,204472312,204472312,9118,3039,6079,3039,0,1,3041,267221,0.267221
3539,593,6541,3878813,2,28318,7081,1,233008312,233008312,10618,3539,7079,3539,0,1,3541,1025329,1.025329
4039,593,6541,3878813,2,32318,8081,1,261544312,261544312,12118,4039,8079,4039,0,1,4041,469300,0.4693
4539,593,6541,3878813,2,36318,9081,1,290080312,290080312,13618,4539,9079,4539,0,1,4541,132274,0.132274
5039,593,6541,3878813,2,40318,10081,1,318616312,318616312,15118,5039,10079,5039,0,1,5041,450592,0.450592
5539,593,6541,3878813,2,44318,11081,1,347152312,347152312,16618,5539,11079,5539,0,1,5541,47796,0.047796
6039,593,6541,3878813,2,48318,12081,1,375688312,375688312,18118,6039,12079,6039,0,1,6041,123377,0.123377
6539,593,6541,3878813,2,52318,13081,1,404224312,404224312,19618,6539,13079,6539,0,1,6541,809682,0.809682
7039,593,6541,3878813,2,56318,14081,1,432760312,432760312,21118,7039,14079,7039,0,1,7041,2186982,2.186982
55,1805,2165,3907825,2,446,113,1,33009400,33009400,166,55,111,55,0,1,57,82650,0.08265
455,1805,2165,3907825,2,3646,913,1,45713400,45713400,1366,455,911,455,0,1,457,375997,0.375997
855,1805,2165,3907825,2,6846,1713,1,58417400,58417400,2566,855,1711,855,0,1,857,676736,0.676736
1255,1805,2165,3907825,2,10046,2513,1,71121400,71121400,3766,1255,2511,1255,0,1,1257,326717,0.326717
1655,1805,2165,3907825,2,13246,3313,1,83825400,83825400,4966,1655,3311,1655,0,1,1657,1212732,1.212732
2055,1805,2165,3907825,2,16446,4113,1,96529400,96529400,6166,2055,4111,2055,0,1,2057,1581442,1.581442
2455,1805,2165,3907825,2,19646,4913,1,109233400,109233400,7366,2455,4911,2455,0,1,2457,1518304,1.518304
2855,1805,2165,3907825,2,22846,5713,1,121937400,121937400,8566,2855,5711,2855,0,1,2857,26834,0.026834
3255,1805,2165,3907825,2,26046,6513,1,134641400,134641400,9766,3255,6511,3255,0,1,3257,1479054,1.479054
3655,1805,2165,3907825,2,29246,7313,1,147345400,147345400,10966,3655,7311,3655,0,1,3657,92830,0.09283
4055,1805,2165,3907825,2,32446,8113,1,160049400,160049400,12166,4055,8111,4055,0,1,4057,1125773,1.125773
4455,1805,2165,3907825,2,35646,8913,1,172753400,172753400,13366,4455,8911,4455,0,1,4457,579408,0.579408
4855,1805,2165,3907825,2,38846,9713,1,185457400,185457400,14566,4855,9711,4855,0,1,4857,1824233,1.824233
5255,1805,2165,3907825,2,42046,10513,1,198161400,198161400,15766,5255,10511,5255,0,1,5257,4025840,4.02584
5655,1805,2165,3907825,2,45246,11313,1,210865400,210865400,16966,5655,11311,5655,0,1,5657,152674,0.152674
6055,1805,2165,3907825,2,48446,12113,1,223569400,223569400,18166,6055,12111,6055,0,1,6057,1159066,1.159066
6455,1805,2165,3907825,2,51646,12913,1,236273400,236273400,19366,6455,12911,6455,0,1,6457,1222492,1.222492
6855,1805,2165,3907825,2,54846,13713,1,248977400,248977400,20566,6855,13711,6855,0,1,6857,5233182,5.233182
55,4055,965,3913075,2,446,113,1,33513400,33513400,166,55,111,55,0,1,57,6218,0.006218
455,4055,965,3913075,2,3646,913,1,49577400,49577400,1366,455,911,455,0,1,457,3931,0.003931
855,4055,965,3913075,2,6846,1713,1,65641400,65641400,2566,855,1711,855,0,1,857,90575,0.090575
1255,4055,965,3913075,2,10046,2513,1,81705400,81705400,3766,1255,2511,1255,0,1,1257,139111,0.139111
1655,4055,965,3913075,2,13246,3313,1,97769400,97769400,4966,1655,3311,1655,0,1,1657,73361,0.073361
2055,4055,965,3913075,2,16446,4113,1,113833400,113833400,6166,2055,4111,2055,0,1,2057,382570,0.38257
2455,4055,965,3913075,2,19646,4913,1,129897400,129897400,7366,2455,4911,2455,0,1,2457,393372,0.393372
2855,4055,965,3913075,2,22846,5713,1,145961400,145961400,8566,2855,5711,2855,0,1,2857,122919,0.122919
3255,4055,965,3913075,2,26046,6513,1,162025400,162025400,9766,3255,6511,3255,0,1,3257,372044,0.372044
3655,4055,965,3913075,2,29246,7313,1,178089400,178089400,10966,3655,7311,3655,0,1,3657,75757,0.075757
4055,4055,965,3913075,2,32446,8113,1,194153400,194153400,12166,4055,8111,4055,0,1,4057,415720,0.41572
4455,4055,965,3913075,2,35646,8913,1,210217400,210217400,13366,4455,8911,4455,0,1,4457,306777,0.306777
4855,4055,965,3913075,2,38846,9713,1,226281400,226281400,14566,4855,9711,4855,0,1,4857,486743,0.486743
5255,4055,965,3913075,2,42046,10513,1,242345400,242345400,15766,5255,10511,5255,0,1,5257,763653,0.763653
5655,4055,965,3913075,2,45246,11313,1,258409400,258409400,16966,5655,11311,5655,0,1,5657,645298,0.645298
6055,4055,965,3913075,2,48446,12113,1,274473400,274473400,18166,6055,12111,6055,0,1,6057,1350260,1.35026
6455,4055,965,3913075,2,51646,12913,1,290537400,290537400,19366,6455,12911,6455,0,1,6457,743239,0.743239
6855,4055,965,3913075,2,54846,13713,1,306601400,306601400,20566,6855,13711,6855,0,1,6857,907611,0.907611
55,805,4865,3916325,2,446,113,1,33825400,33825400,166,55,111,55,0,1,57,81158,0.081158
455,805,4865,3916325,2,3646,913,1,51969400,51969400,1366,455,911,455,0,1,457,373023,0.373023
855,805,4865,3916325,2,6846,1713,1,70113400,70113400,2566,855,1711,855,0,1,857,17216,0.017216
1255,805,4865,3916325,2,10046,2513,1,88257400,88257400,3766,1255,2511,1255,0,1,1257,15425,0.015425
1655,805,4865,3916325,2,13246,3313,1,106401400,106401400,4966,1655,3311,1655,0,1,1657,40643,0.040643
2055,805,4865,3916325,2,16446,4113,1,124545400,124545400,6166,2055,4111,2055,0,1,2057,419502,0.419502
2455,805,4865,3916325,2,19646,4913,1,142689400,142689400,7366,2455,4911,2455,0,1,2457,25489,0.025489
2855,805,4865,3916325,2,22846,5713,1,160833400,160833400,8566,2855,5711,2855,0,1,2857,146998,0.146998
3255,805,4865,3916325,2,26046,6513,1,178977400,178977400,9766,3255,6511,3255,0,1,3257,1229071,1.229071
3655,805,4865,3916325,2,29246,7313,1,197121400,197121400,10966,3655,7311,3655,0,1,3657,13214,0.013214
4055,805,4865,3916325,2,32446,8113,1,215265400,215265400,12166,4055,8111,4055,0,1,4057,497092,0.497092
4455,805,4865,3916325,2,35646,8913,1,233409400,233409400,13366,4455,8911,4455,0,1,4457,164564,0.164564
4855,805,4865,3916325,2,38846,9713,1,251553400,251553400,14566,4855,9711,4855,0,1,4857,493455,0.493455
5255,805,4865,3916325,2,42046,10513,1,269697400,269697400,15766,5255,10511,5255,0,1,5257,401860,0.40186
5655,805,4865,3916325,2,45246,11313,1,287841400,287841400,16966,5655,11311,5655,0,1,5657,2022688,2.022688
6055,805,4865,3916325,2,48446,12113,1,305985400,305985400,18166,6055,12111,6055,0,1,6057,3035571,3.035571
6455,805,4865,3916325,2,51646,12913,1,324129400,324129400,19366,6455,12911,6455,0,1,6457,422707,0.422707
6855,805,4865,3916325,2,54846,13713,1,342273400,342273400,20566,6855,13711,6855,0,1,6857,959715,0.959715
40,2550,1540,3927000,2,326,83,1,32724800,32724800,121,40,81,40,0,1,42,73560,0.07356
440,2550,1540,3927000,2,3526,883,1,45812800,45812800,1321,440,881,440,0,1,442,356995,0.356995
840,2550,1540,3927000,2,6726,1683,1,58900800,58900800,2521,840,1681,840,0,1,842,647995,0.647995
1240,2550,1540,3927000,2,9926,2483,1,71988800,71988800,3721,1240,2481,1240,0,1,1242,589276,0.589276
1640,2550,1540,3927000,2,13126,3283,1,85076800,85076800,4921,1640,3281,1640,0,1,1642,322716,0.322716
2040,2550,1540,3927000,2,16326,4083,1,98164800,98164800,6121,2040,4081,2040,0,1,2042,687574,0.687574
2440,2550,1540,3927000,2,19526,4883,1,111252800,111252800,7321,2440,4881,2440,0,1,2442,1242052,1.242052
2840,2550,1540,3927000,2,22726,5683,1,124340800,124340800,8521,2840,5681,2840,0,1,2842,1127877,1.127877
3240,2550,1540,3927000,2,25926,6483,1,137428800,137428800,9721,3240,6481,3240,0,1,3242,943372,0.943372
3640,2550,1540,3927000,2,29126,7283,1,150516800,150516800,10921,3640,7281,3640,0,1,3642,2606994,2.606994
4040,2550,1540,3927000,2,32326,8083,1,163604800,163604800,12121,4040,8081,4040,0,1,4042,160417,0.160417
4440,2550,1540,3927000,2,35526,8883,1,176692800,176692800,13321,4440,8881,4440,0,1,4442,549977,0.549977
4840,2550,1540,3927000,2,38726,9683,1,189780800,189780800,14521,4840,9681,4840,0,1,4842,36389,0.036389
5240,2550,1540,3927000,2,41926,10483,1,202868800,202868800,15721,5240,10481,5240,0,1,5242,719639,0.719639
5640,2550,1540,3927000,2,45126,11283,1,215956800,215956800,16921,5640,11281,5640,0,1,5642,4121,0.004121
6040,2550,1540,3927000,2,48326,12083,1,229044800,229044800,18121,6040,12081,6040,0,1,6042,962209,0.962209
6440,2550,1540,3927000,2,51526,12883,1,242132800,242132800,19321,6440,12881,6440,0,1,6442,1167675,1.167675
6840,2550,1540,3927000,2,54726,13683,1,255220800,255220800,20521,6840,13681,6840,0,1,6842,664923,0.664923
40,1300,3040,3952000,2,326,83,1,33004800,33004800,121,40,81,40,0,1,42,74250,0.07425
440,1300,3040,3952000,2,3526,883,1,46892800,46892800,1321,440,881,440,0,1,442,359050,0.35905
840,1300,3040,3952000,2,6726,1683,1,60780800,60780800,2521,840,1681,840,0,1,842,23831,0.023831
1240,1300,3040,3952000,2,9926,2483,1,74668800,74668800,3721,1240,2481,1240,0,1,1242,619621,0.619621
1640,1300,3040,3952000,2,13126,3283,1,88556800,88556800,4921,1640,3281,1640,0,1,1642,1251373,1.251373
2040,1300,3040,3952000,2,16326,4083,1,102444800,102444800,6121,2040,4081,2040,0,1,2042,837541,0.837541
2440,1300,3040,3952000,2,19526,4883,1,116332800,116332800,7321,2440,4881,2440,0,1,2442,82734,0.082734
2840,1300,3040,3952000,2,22726,5683,1,130220800,130220800,8521,2840,5681,2840,0,1,2842,349245,0.349245
3240,1300,3040,3952000,2,25926,6483,1,144108800,144108800,9721,3240,6481,3240,0,1,3242,2442295,2.442295
3640,1300,3040,3952000,2,29126,7283,1,157996800,157996800,10921,3640,7281,3640,0,1,3642,683116,0.683116
4040,1300,3040,3952000,2,32326,8083,1,171884800,171884800,12121,4040,8081,4040,0,1,4042,980128,0.980128
4440,1300,3040,3952000,2,35526,8883,1,185772800,185772800,13321,4440,8881,4440,0,1,4442,732519,0.732519
4840,1300,3040,3952000,2,38726,9683,1,199660800,199660800,14521,4840,9681,4840,0,1,4842,318708,0.318708
5240,1300,3040,3952000,2,41926,10483,1,213548800,213548800,15721,5240,10481,5240,0,1,5242,3933023,3.933023
5640,1300,3040,3952000,2,45126,11283,1,227436800,227436800,16921,5640,11281,5640,0,1,5642,2597352,2.597352
6040,1300,3040,3952000,2,48326,12083,1,241324800,241324800,18121,6040,12081,6040,0,1,6042,607214,0.607214
6440,1300,3040,3952000,2,51526,12883,1,255212800,255212800,19321,6440,12881,6440,0,1,6442,2136114,2.136114
6840,1300,3040,3952000,2,54726,13683,1,269100800,269100800,20521,6840,13681,6840,0,1,6842,275392,0.275392
44,603,6555,3952665,2,358,91,1,34140936,34140936,133,44,89,44,0,1,46,75518,0.075518
544,603,6555,3952665,2,4358,1091,1,62772936,62772936,1633,544,1089,544,0,1,546,58420,0.05842
1044,603,6555,3952665,2,8358,2091,1,91404936,91404936,3133,1044,2089,1044,0,1,1046,157500,0.1575
1544,603,6555,3952665,2,12358,3091,1,120036936,120036936,4633,1544,3089,1544,0,1,1546,1081927,1.081927
2044,603,6555,3952665,2,16358,4091,1,148668936,148668936,6133,2044,4089,2044,0,1,2046,12143,0.012143
2544,603,6555,3952665,2,20358,5091,1,177300936,177300936,7633,2544,5089,2544,0,1,2546,313536,0.313536
3044,603,6555,3952665,2,24358,6091,1,205932936,205932936,9133,3044,6089,3044,0,1,3046,301835,0.301835
3544,603,6555,3952665,2,28358,7091,1,234564936,234564936,10633,3544,7089,3544,0,1,3546,177099,0.177099
4044,603,6555,3952665,2,32358,8091,1,263196936,263196936,12133,4044,8089,4044,0,1,4046,58606,0.058606
4544,603,6555,3952665,2,36358,9091,1,291828936,291828936,13633,4544,9089,4544,0,1,4546,328112,0.328112
5044,603,6555,3952665,2,40358,10091,1,320460936,320460936,15133,5044,10089,5044,0,1,5046,107058,0.107058
5544,603,6555,3952665,2,44358,11091,1,349092936,349092936,16633,5544,11089,5544,0,1,5546,83681,0.083681
6044,603,6555,3952665,2,48358,12091,1,377724936,377724936,18133,6044,12089,6044,0,1,6046,391668,0.391668
6544,603,6555,3952665,2,52358,13091,1,406356936,406356936,19633,6544,13089,6544,0,1,6546,810442,0.810442
7044,603,6555,3952665,2,56358,14091,1,434988936,434988936,21133,7044,14089,7044,0,1,7046,1277757,1.277757
55,2555,1565,3998575,2,446,113,1,33801400,33801400,166,55,111,55,0,1,57,80977,0.080977
455,2555,1565,3998575,2,3646,913,1,46985400,46985400,1366,455,911,455,0,1,457,175643,0.175643
855,2555,1565,3998575,2,6846,1713,1,60169400,60169400,2566,855,1711,855,0,1,857,24865,0.024865
1255,2555,1565,3998575,2,10046,2513,1,73353400,73353400,3766,1255,2511,1255,0,1,1257,61604,0.061604
1655,2555,1565,3998575,2,13246,3313,1,86537400,86537400,4966,1655,3311,1655,0,1,1657,1266618,1.266618
2055,2555,1565,3998575,2,16446,4113,1,99721400,99721400,6166,2055,4111,2055,0,1,2057,1097455,1.097455
2455,2555,1565,3998575,2,19646,4913,1,112905400,112905400,7366,2455,4911,2455,0,1,2457,968783,0.968783
2855,2555,1565,3998575,2,22846,5713,1,126089400,126089400,8566,2855,5711,2855,0,1,2857,635446,0.635446
3255,2555,1565,3998575,2,26046,6513,1,139273400,139273400,9766,3255,6511,3255,0,1,3257,1100556,1.100556
3655,2555,1565,3998575,2,29246,7313,1,152457400,152457400,10966,3655,7311,3655,0,1,3657,1171318,1.171318
4055,2555,1565,3998575,2,32446,8113,1,165641400,165641400,12166,4055,8111,4055,0,1,4057,3073042,3.073042
4455,2555,1565,3998575,2,35646,8913,1,178825400,178825400,13366,4455,8911,4455,0,1,4457,47198,0.047198
4855,2555,1565,3998575,2,38846,9713,1,192009400,192009400,14566,4855,9711,4855,0,1,4857,3668754,3.668754
5255,2555,1565,3998575,2,42046,10513,1,205193400,205193400,15766,5255,10511,5255,0,1,5257,361717,0.361717
5655,2555,1565,3998575,2,45246,11313,1,218377400,218377400,16966,5655,11311,5655,0,1,5657,71489,0.071489
6055,2555,1565,3998575,2,48446,12113,1,231561400,231561400,18166,6055,12111,6055,0,1,6057,112576,0.112576
6455,2555,1565,3998575,2,51646,12913,1,244745400,244745400,19366,6455,12911,6455,0,1,6457,1340377,1.340377
6855,2555,1565,3998575,2,54846,13713,1,257929400,257929400,20566,6855,13711,6855,0,1,6857,235395,0.235395
55,1305,3065,3999825,2,446,113,1,33921400,33921400,166,55,111,55,0,1,57,82092,0.082092
455,1305,3065,3999825,2,3646,913,1,47905400,47905400,1366,455,911,455,0,1,457,11335,0.011335
855,1305,3065,3999825,2,6846,1713,1,61889400,61889400,2566,855,1711,855,0,1,857,195671,0.195671
1255,1305,3065,3999825,2,10046,2513,1,75873400,75873400,3766,1255,2511,1255,0,1,1257,680988,0.680988
1655,1305,3065,3999825,2,13246,3313,1,89857400,89857400,4966,1655,3311,1655,0,1,1657,571416,0.571416
2055,1305,3065,3999825,2,16446,4113,1,103841400,103841400,6166,2055,4111,2055,0,1,2057,941859,0.941859
2455,1305,3065,3999825,2,19646,4913,1,117825400,117825400,7366,2455,4911,2455,0,1,2457,201407,0.201407
2855,1305,3065,3999825,2,22846,5713,1,131809400,131809400,8566,2855,5711,2855,0,1,2857,720215,0.720215
3255,1305,3065,3999825,2,26046,6513,1,145793400,145793400,9766,3255,6511,3255,0,1,3257,1231998,1.231998
3655,1305,3065,3999825,2,29246,7313,1,159777400,159777400,10966,3655,7311,3655,0,1,3657,1153361,1.153361
4055,1305,3065,3999825,2,32446,8113,1,173761400,173761400,12166,4055,8111,4055,0,1,4057,542130,0.54213
4455,1305,3065,3999825,2,35646,8913,1,187745400,187745400,13366,4455,8911,4455,0,1,4457,301511,0.301511
4855,1305,3065,3999825,2,38846,9713,1,201729400,201729400,14566,4855,9711,4855,0,1,4857,2424139,2.424139
5255,1305,3065,3999825,2,42046,10513,1,215713400,215713400,15766,5255,10511,5255,0,1,5257,4110198,4.110198
5655,1305,3065,3999825,2,45246,11313,1,229697400,229697400,16966,5655,11311,5655,0,1,5657,2222762,2.222762
6055,1305,3065,3999825,2,48446,12113,1,243681400,243681400,18166,6055,12111,6055,0,1,6057,136326,0.136326
6455,1305,3065,3999825,2,51646,12913,1,257665400,257665400,19366,6455,12911,6455,0,1,6457,1787896,1.787896
6855,1305,3065,3999825,2,54846,13713,1,271649400,271649400,20566,6855,13711,6855,0,1,6857,2457834,2.457834
55,6055,665,4026575,2,446,113,1,35169400,35169400,166,55,111,55,0,1,57,78329,0.078329
455,6055,665,4026575,2,3646,913,1,56673400,56673400,1366,455,911,455,0,1,457,375926,0.375926
855,6055,665,4026575,2,6846,1713,1,78177400,78177400,2566,855,1711,855,0,1,857,683538,0.683538
1255,6055,665,4026575,2,10046,2513,1,99681400,99681400,3766,1255,2511,1255,0,1,1257,631759,0.631759
1655,6055,665,4026575,2,13246,3313,1,121185400,121185400,4966,1655,3311,1655,0,1,1657,1304621,1.304621
2055,6055,665,4026575,2,16446,4113,1,142689400,142689400,6166,2055,4111,2055,0,1,2057,1612656,1.612656
2455,6055,665,4026575,2,19646,4913,1,164193400,164193400,7366,2455,4911,2455,0,1,2457,1580067,1.580067
2855,6055,665,4026575,2,22846,5713,1,185697400,185697400,8566,2855,5711,2855,0,1,2857,817226,0.817226
3255,6055,665,4026575,2,26046,6513,1,207201400,207201400,9766,3255,6511,3255,0,1,3257,137360,0.13736
3655,6055,665,4026575,2,29246,7313,1,228705400,228705400,10966,3655,7311,3655,0,1,3657,2861455,2.861455
4055,6055,665,4026575,2,32446,8113,1,250209400,250209400,12166,4055,8111,4055,0,1,4057,754882,0.754882
4455,6055,665,4026575,2,35646,8913,1,271713400,271713400,13366,4455,8911,4455,0,1,4457,435077,0.435077
4855,6055,665,4026575,2,38846,9713,1,293217400,293217400,14566,4855,9711,4855,0,1,4857,1281067,1.281067
5255,6055,665,4026575,2,42046,10513,1,314721400,314721400,15766,5255,10511,5255,0,1,5257,1274234,1.274234
5655,6055,665,4026575,2,45246,11313,1,336225400,336225400,16966,5655,11311,5655,0,1,5657,4451216,4.451216
6055,6055,665,4026575,2,48446,12113,1,357729400,357729400,18166,6055,12111,6055,0,1,6057,1544846,1.544846
6455,6055,665,4026575,2,51646,12913,1,379233400,379233400,19366,6455,12911,6455,0,1,6457,975860,0.97586
6855,6055,665,4026575,2,54846,13713,1,400737400,400737400,20566,6855,13711,6855,0,1,6857,1797280,1.79728
40,6300,640,4032000,2,326,83,1,34476800,34476800,121,40,81,40,0,1,42,72196,0.072196
440,6300,640,4032000,2,3526,883,1,56684800,56684800,1321,440,881,440,0,1,442,352791,0.352791
840,6300,640,4032000,2,6726,1683,1,78892800,78892800,2521,840,1681,840,0,1,842,578929,0.578929
1240,6300,640,4032000,2,9926,2483,1,101100800,101100800,3721,1240,2481,1240,0,1,1242,935664,0.935664
1640,6300,640,4032000,2,13126,3283,1,123308800,123308800,4921,1640,3281,1640,0,1,1642,1243937,1.243937
2040,6300,640,4032000,2,16326,4083,1,145516800,145516800,6121,2040,4081,2040,0,1,2042,1516903,1.516903
2440,6300,640,4032000,2,19526,4883,1,167724800,167724800,7321,2440,4881,2440,0,1,2442,1328947,1.328947
2840,6300,640,4032000,2,22726,5683,1,189932800,189932800,8521,2840,5681,2840,0,1,2842,2102499,2.102499
3240,6300,640,4032000,2,25926,6483,1,212140800,212140800,9721,3240,6481,3240,0,1,3242,1588818,1.588818
3640,6300,640,4032000,2,29126,7283,1,234348800,234348800,10921,3640,7281,3640,0,1,3642,2729443,2.729443
4040,6300,640,4032000,2,32326,8083,1,256556800,256556800,12121,4040,8081,4040,0,1,4042,103215,0.103215
4440,6300,640,4032000,2,35526,8883,1,278764800,278764800,13321,4440,8881,4440,0,1,4442,925084,0.925084
4840,6300,640,4032000,2,38726,9683,1,300972800,300972800,14521,4840,9681,4840,0,1,4842,3575110,3.57511
5240,6300,640,4032000,2,41926,10483,1,323180800,323180800,15721,5240,10481,5240,0,1,5242,3902367,3.902367
5640,6300,640,4032000,2,45126,11283,1,345388800,345388800,16921,5640,11281,5640,0,1,5642,4168458,4.168458
6040,6300,640,4032000,2,48326,12083,1,367596800,367596800,18121,6040,12081,6040,0,1,6042,1708019,1.708019
6440,6300,640,4032000,2,51526,12883,1,389804800,389804800,19321,6440,12881,6440,0,1,6442,4755076,4.755076
6840,6300,640,4032000,2,54726,13683,1,412012800,412012800,20521,6840,13681,6840,0,1,6842,5099646,5.099646
35,1140,3545,4041300,2,286,73,1,33642200,33642200,106,35,71,35,0,1,37,85182,0.085182
535,1140,3545,4041300,2,4286,1073,1,52382200,52382200,1606,535,1071,535,0,1,537,439144,0.439144
1035,1140,3545,4041300,2,8286,2073,1,71122200,71122200,3106,1035,2071,1035,0,1,1037,814453,0.814453
1535,1140,3545,4041300,2,12286,3073,1,89862200,89862200,4606,1535,3071,1535,0,1,1537,1196547,1.196547
2035,1140,3545,4041300,2,16286,4073,1,108602200,108602200,6106,2035,4071,2035,0,1,2037,1576219,1.576219
2535,1140,3545,4041300,2,20286,5073,1,127342200,127342200,7606,2535,5071,2535,0,1,2537,1959568,1.959568
3035,1140,3545,4041300,2,24286,6073,1,146082200,146082200,9106,3035,6071,3035,0,1,3037,2340226,2.340226
3535,1140,3545,4041300,2,28286,7073,1,164822200,164822200,10606,3535,7071,3535,0,1,3537,2738254,2.738254
4035,1140,3545,4041300,2,32286,8073,1,183562200,183562200,12106,4035,8071,4035,0,1,4037,3102715,3.102715
40,4300,940,4042000,2,326,83,1,34012800,34012800,121,40,81,40,0,1,42,71853,0.071853
440,4300,940,4042000,2,3526,883,1,50780800,50780800,1321,440,881,440,0,1,442,367804,0.367804
840,4300,940,4042000,2,6726,1683,1,67548800,67548800,2521,840,1681,840,0,1,842,183522,0.183522
1240,4300,940,4042000,2,9926,2483,1,84316800,84316800,3721,1240,2481,1240,0,1,1242,562796,0.562796
1640,4300,940,4042000,2,13126,3283,1,101084800,101084800,4921,1640,3281,1640,0,1,1642,1268202,1.268202
2040,4300,940,4042000,2,16326,4083,1,117852800,117852800,6121,2040,4081,2040,0,1,2042,1238528,1.238528
2440,4300,940,4042000,2,19526,4883,1,134620800,134620800,7321,2440,4881,2440,0,1,2442,1881166,1.881166
2840,4300,940,4042000,2,22726,5683,1,151388800,151388800,8521,2840,5681,2840,0,1,2842,2185602,2.185602
3240,4300,940,4042000,2,25926,6483,1,168156800,168156800,9721,3240,6481,3240,0,1,3242,1055547,1.055547
3640,4300,940,4042000,2,29126,7283,1,184924800,184924800,10921,3640,7281,3640,0,1,3642,2790824,2.790824
4040,4300,940,4042000,2,32326,8083,1,201692800,201692800,12121,4040,8081,4040,0,1,4042,461945,0.461945
4440,4300,940,4042000,2,35526,8883,1,218460800,218460800,13321,4440,8881,4440,0,1,4442,438269,0.438269
4840,4300,940,4042000,2,38726,9683,1,235228800,235228800,14521,4840,9681,4840,0,1,4842,63050,0.06305
5240,4300,940,4042000,2,41926,10483,1,251996800,251996800,15721,5240,10481,5240,0,1,5242,2903498,2.903498
5640,4300,940,4042000,2,45126,11283,1,268764800,268764800,16921,5640,11281,5640,0,1,5642,65431,0.065431
6040,4300,940,4042000,2,48326,12083,1,285532800,285532800,18121,6040,12081,6040,0,1,6042,1163726,1.163726
6440,4300,940,4042000,2,51526,12883,1,302300800,302300800,19321,6440,12881,6440,0,1,6442,1665337,1.665337
6840,4300,940,4042000,2,54726,13683,1,319068800,319068800,20521,6840,13681,6840,0,1,6842,512927,0.512927
39,1143,3541,4047363,2,318,81,1,33840312,33840312,118,39,79,39,0,1,41,313,0.000313
539,1143,3541,4047363,2,4318,1081,1,52576312,52576312,1618,539,1079,539,0,1,541,21105,0.021105
1039,1143,3541,4047363,2,8318,2081,1,71312312,71312312,3118,1039,2079,1039,0,1,1041,35412,0.035412
1539,1143,3541,4047363,2,12318,3081,1,90048312,90048312,4618,1539,3079,1539,0,1,1541,128532,0.128532
2039,1143,3541,4047363,2,16318,4081,1,108784312,108784312,6118,2039,4079,2039,0,1,2041,682866,0.682866
2539,1143,3541,4047363,2,20318,5081,1,127520312,127520312,7618,2539,5079,2539,0,1,2541,574280,0.57428
3039,1143,3541,4047363,2,24318,6081,1,146256312,146256312,9118,3039,6079,3039,0,1,3041,22776,0.022776
3539,1143,3541,4047363,2,28318,7081,1,164992312,164992312,10618,3539,7079,3539,0,1,3541,839472,0.839472
4039,1143,3541,4047363,2,32318,8081,1,183728312,183728312,12118,4039,8079,4039,0,1,4041,837897,0.837897
4539,1143,3541,4047363,2,36318,9081,1,202464312,202464312,13618,4539,9079,4539,0,1,4541,33377,0.033377
5039,1143,3541,4047363,2,40318,10081,1,221200312,221200312,15118,5039,10079,5039,0,1,5041,2786553,2.786553
5539,1143,3541,4047363,2,44318,11081,1,239936312,239936312,16618,5539,11079,5539,0,1,5541,1317680,1.31768
6039,1143,3541,4047363,2,48318,12081,1,258672312,258672312,18118,6039,12079,6039,0,1,6041,785650,0.78565
6539,1143,3541,4047363,2,52318,13081,1,277408312,277408312,19618,6539,13079,6539,0,1,6541,923061,0.923061
7039,1143,3541,4047363,2,56318,14081,1,296144312,296144312,21118,7039,14079,7039,0,1,7041,605365,0.605365
39,3893,1041,4052613,2,318,81,1,33960312,33960312,118,39,79,39,0,1,41,73812,0.073812
539,3893,1041,4052613,2,4318,1081,1,53696312,53696312,1618,539,1079,539,0,1,541,455773,0.455773
1039,3893,1041,4052613,2,8318,2081,1,73432312,73432312,3118,1039,2079,1039,0,1,1041,867062,0.867062
1539,3893,1041,4052613,2,12318,3081,1,93168312,93168312,4618,1539,3079,1539,0,1,1541,763683,0.763683
2039,3893,1041,4052613,2,16318,4081,1,112904312,112904312,6118,2039,4079,2039,0,1,2041,922346,0.922346
2539,3893,1041,4052613,2,20318,5081,1,132640312,132640312,7618,2539,5079,2539,0,1,2541,976062,0.976062
3039,3893,1041,4052613,2,24318,6081,1,152376312,152376312,9118,3039,6079,3039,0,1,3041,2445002,2.445002
3539,3893,1041,4052613,2,28318,7081,1,172112312,172112312,10618,3539,7079,3539,0,1,3541,2869014,2.869014
4039,3893,1041,4052613,2,32318,8081,1,191848312,191848312,12118,4039,8079,4039,0,1,4041,125826,0.125826
4539,3893,1041,4052613,2,36318,9081,1,211584312,211584312,13618,4539,9079,4539,0,1,4541,2989003,2.989003
5039,3893,1041,4052613,2,40318,10081,1,231320312,231320312,15118,5039,10079,5039,0,1,5041,4047112,4.047112
5539,3893,1041,4052613,2,44318,11081,1,251056312,251056312,16618,5539,11079,5539,0,1,5541,983807,0.983807
6039,3893,1041,4052613,2,48318,12081,1,270792312,270792312,18118,6039,12079,6039,0,1,6041,567668,0.567668
6539,3893,1041,4052613,2,52318,13081,1,290528312,290528312,19618,6539,13079,6539,0,1,6541,5263814,5.263814
7039,3893,1041,4052613,2,56318,14081,1,310264312,310264312,21118,7039,14079,7039,0,1,7041,5668233,5.668233
40,3300,1240,4092000,2,326,83,1,34188800,34188800,121,40,81,40,0,1,42,71354,0.071354
440,3300,1240,4092000,2,3526,883,1,48716800,48716800,1321,440,881,440,0,1,442,379058,0.379058
840,3300,1240,4092000,2,6726,1683,1,63244800,63244800,2521,840,1681,840,0,1,842,514622,0.514622
1240,3300,1240,4092000,2,9926,2483,1,77772800,77772800,3721,1240,2481,1240,0,1,1242,994590,0.99459
1640,3300,1240,4092000,2,13126,3283,1,92300800,92300800,4921,1640,3281,1640,0,1,1642,818776,0.818776
2040,3300,1240,4092000,2,16326,4083,1,106828800,106828800,6121,2040,4081,2040,0,1,2042,1618089,1.618089
2440,3300,1240,4092000,2,19526,4883,1,121356800,121356800,7321,2440,4881,2440,0,1,2442,1925171,1.925171
2840,3300,1240,4092000,2,22726,5683,1,135884800,135884800,8521,2840,5681,2840,0,1,2842,2239020,2.23902
3240,3300,1240,4092000,2,25926,6483,1,150412800,150412800,9721,3240,6481,3240,0,1,3242,1922695,1.922695
3640,3300,1240,4092000,2,29126,7283,1,164940800,164940800,10921,3640,7281,3640,0,1,3642,952709,0.952709
4040,3300,1240,4092000,2,32326,8083,1,179468800,179468800,12121,4040,8081,4040,0,1,4042,176385,0.176385
4440,3300,1240,4092000,2,35526,8883,1,193996800,193996800,13321,4440,8881,4440,0,1,4442,1627296,1.627296
4840,3300,1240,4092000,2,38726,9683,1,208524800,208524800,14521,4840,9681,4840,0,1,4842,1188895,1.188895
5240,3300,1240,4092000,2,41926,10483,1,223052800,223052800,15721,5240,10481,5240,0,1,5242,932176,0.932176
5640,3300,1240,4092000,2,45126,11283,1,237580800,237580800,16921,5640,11281,5640,0,1,5642,64002,0.064002
6040,3300,1240,4092000,2,48326,12083,1,252108800,252108800,18121,6040,12081,6040,0,1,6042,714218,0.714218
6440,3300,1240,4092000,2,51526,12883,1,266636800,266636800,19321,6440,12881,6440,0,1,6442,434109,0.434109
6840,3300,1240,4092000,2,54726,13683,1,281164800,281164800,20521,6840,13681,6840,0,1,6842,137161,0.137161
44,1153,3555,4098915,2,358,91,1,34448536,34448536,133,44,89,44,0,1,46,4576,0.004576
544,1153,3555,4098915,2,4358,1091,1,53280536,53280536,1633,544,1089,544,0,1,546,45087,0.045087
1044,1153,3555,4098915,2,8358,2091,1,72112536,72112536,3133,1044,2089,1044,0,1,1046,142224,0.142224
1544,1153,3555,4098915,2,12358,3091,1,90944536,90944536,4633,1544,3089,1544,0,1,1546,291769,0.291769
2044,1153,3555,4098915,2,16358,4091,1,109776536,109776536,6133,2044,4089,2044,0,1,2046,44760,0.04476
2544,1153,3555,4098915,2,20358,5091,1,128608536,128608536,7633,2544,5089,2544,0,1,2546,522982,0.522982
3044,1153,3555,4098915,2,24358,6091,1,147440536,147440536,9133,3044,6089,3044,0,1,3046,713956,0.713956
3544,1153,3555,4098915,2,28358,7091,1,166272536,166272536,10633,3544,7089,3544,0,1,3546,1235119,1.235119
4044,1153,3555,4098915,2,32358,8091,1,185104536,185104536,12133,4044,8089,4044,0,1,4046,10575,0.010575
4544,1153,3555,4098915,2,36358,9091,1,203936536,203936536,13633,4544,9089,4544,0,1,4546,118229,0.118229
5044,1153,3555,4098915,2,40358,10091,1,222768536,222768536,15133,5044,10089,5044,0,1,5046,1500014,1.500014
5544,1153,3555,4098915,2,44358,11091,1,241600536,241600536,16633,5544,11089,5544,0,1,5546,1494170,1.49417
6044,1153,3555,4098915,2,48358,12091,1,260432536,260432536,18133,6044,12089,6044,0,1,6046,892424,0.892424
6544,1153,3555,4098915,2,52358,13091,1,279264536,279264536,19633,6544,13089,6544,0,1,6546,1896908,1.896908
7044,1153,3555,4098915,2,56358,14091,1,298096536,298096536,21133,7044,14089,7044,0,1,7046,876291,0.876291
40,800,5140,4112000,2,326,83,1,34796800,34796800,121,40,81,40,0,1,42,74533,0.074533
440,800,5140,4112000,2,3526,883,1,53804800,53804800,1321,440,881,440,0,1,442,374475,0.374475
840,800,5140,4112000,2,6726,1683,1,72812800,72812800,2521,840,1681,840,0,1,842,681751,0.681751
1240,800,5140,4112000,2,9926,2483,1,91820800,91820800,3721,1240,2481,1240,0,1,1242,209087,0.209087
1640,800,5140,4112000,2,13126,3283,1,110828800,110828800,4921,1640,3281,1640,0,1,1642,110264,0.110264
2040,800,5140,4112000,2,16326,4083,1,129836800,129836800,6121,2040,4081,2040,0,1,2042,89016,0.089016
2440,800,5140,4112000,2,19526,4883,1,148844800,148844800,7321,2440,4881,2440,0,1,2442,14117,0.014117
2840,800,5140,4112000,2,22726,5683,1,167852800,167852800,8521,2840,5681,2840,0,1,2842,2230056,2.230056
3240,800,5140,4112000,2,25926,6483,1,186860800,186860800,9721,3240,6481,3240,0,1,3242,477542,0.477542
3640,800,5140,4112000,2,29126,7283,1,205868800,205868800,10921,3640,7281,3640,0,1,3642,28044,0.028044
4040,800,5140,4112000,2,32326,8083,1,224876800,224876800,12121,4040,8081,4040,0,1,4042,1106994,1.106994
4440,800,5140,4112000,2,35526,8883,1,243884800,243884800,13321,4440,8881,4440,0,1,4442,303161,0.303161
4840,800,5140,4112000,2,38726,9683,1,262892800,262892800,14521,4840,9681,4840,0,1,4842,719263,0.719263
5240,800,5140,4112000,2,41926,10483,1,281900800,281900800,15721,5240,10481,5240,0,1,5242,63277,0.063277
5640,800,5140,4112000,2,45126,11283,1,300908800,300908800,16921,5640,11281,5640,0,1,5642,121102,0.121102
6040,800,5140,4112000,2,48326,12083,1,319916800,319916800,18121,6040,12081,6040,0,1,6042,1505971,1.505971
6440,800,5140,4112000,2,51526,12883,1,338924800,338924800,19321,6440,12881,6440,0,1,6442,975974,0.975974
6840,800,5140,4112000,2,54726,13683,1,357932800,357932800,20521,6840,13681,6840,0,1,6842,2308695,2.308695
44,3903,1055,4117665,2,358,91,1,34686536,34686536,133,44,89,44,0,1,46,77669,0.077669
544,3903,1055,4117665,2,4358,1091,1,54518536,54518536,1633,544,1089,544,0,1,546,465397,0.465397
1044,3903,1055,4117665,2,8358,2091,1,74350536,74350536,3133,1044,2089,1044,0,1,1046,874587,0.874587
1544,3903,1055,4117665,2,12358,3091,1,94182536,94182536,4633,1544,3089,1544,0,1,1546,415891,0.415891
2044,3903,1055,4117665,2,16358,4091,1,114014536,114014536,6133,2044,4089,2044,0,1,2046,1629046,1.629046
2544,3903,1055,4117665,2,20358,5091,1,133846536,133846536,7633,2544,5089,2544,0,1,2546,2078821,2.078821
3044,3903,1055,4117665,2,24358,6091,1,153678536,153678536,9133,3044,6089,3044,0,1,3046,1355142,1.355142
3544,3903,1055,4117665,2,28358,7091,1,173510536,173510536,10633,3544,7089,3544,0,1,3546,247392,0.247392
4044,3903,1055,4117665,2,32358,8091,1,193342536,193342536,12133,4044,8089,4044,0,1,4046,1330833,1.330833
4544,3903,1055,4117665,2,36358,9091,1,213174536,213174536,13633,4544,9089,4544,0,1,4546,3673592,3.673592
5044,3903,1055,4117665,2,40358,10091,1,233006536,233006536,15133,5044,10089,5044,0,1,5046,4118069,4.118069
5544,3903,1055,4117665,2,44358,11091,1,252838536,252838536,16633,5544,11089,5544,0,1,5546,4517606,4.517606
6044,3903,1055,4117665,2,48358,12091,1,272670536,272670536,18133,6044,12089,6044,0,1,6046,3179796,3.179796
6544,3903,1055,4117665,2,52358,13091,1,292502536,292502536,19633,6544,13089,6544,0,1,6546,5339870,5.33987
7044,3903,1055,4117665,2,56358,14091,1,312334536,312334536,21133,7044,14089,7044,0,1,7046,5734941,5.734941
40,1050,3940,4137000,2,326,83,1,34692800,34692800,121,40,81,40,0,1,42,23114,0.023114
440,1050,3940,4137000,2,3526,883,1,50660800,50660800,1321,440,881,440,0,1,442,62121,0.062121
840,1050,3940,4137000,2,6726,1683,1,66628800,66628800,2521,840,1681,840,0,1,842,27223,0.027223
1240,1050,3940,4137000,2,9926,2483,1,82596800,82596800,3721,1240,2481,1240,0,1,1242,30756,0.030756
1640,1050,3940,4137000,2,13126,3283,1,98564800,98564800,4921,1640,3281,1640,0,1,1642,284128,0.284128
2040,1050,3940,4137000,2,16326,4083,1,114532800,114532800,6121,2040,4081,2040,0,1,2042,364452,0.364452
2440,1050,3940,4137000,2,19526,4883,1,130500800,130500800,7321,2440,4881,2440,0,1,2442,261035,0.261035
2840,1050,3940,4137000,2,22726,5683,1,146468800,146468800,8521,2840,5681,2840,0,1,2842,345430,0.34543
3240,1050,3940,4137000,2,25926,6483,1,162436800,162436800,9721,3240,6481,3240,0,1,3242,868511,0.868511
3640,1050,3940,4137000,2,29126,7283,1,178404800,178404800,10921,3640,7281,3640,0,1,3642,21187,0.021187
4040,1050,3940,4137000,2,32326,8083,1,194372800,194372800,12121,4040,8081,4040,0,1,4042,969861,0.969861
4440,1050,3940,4137000,2,35526,8883,1,210340800,210340800,13321,4440,8881,4440,0,1,4442,460806,0.460806
4840,1050,3940,4137000,2,38726,9683,1,226308800,226308800,14521,4840,9681,4840,0,1,4842,766487,0.766487
5240,1050,3940,4137000,2,41926,10483,1,242276800,242276800,15721,5240,10481,5240,0,1,5242,17954,0.017954
5640,1050,3940,4137000,2,45126,11283,1,258244800,258244800,16921,5640,11281,5640,0,1,5642,411154,0.411154
6040,1050,3940,4137000,2,48326,12083,1,274212800,274212800,18121,6040,12081,6040,0,1,6042,318958,0.318958
6440,1050,3940,4137000,2,51526,12883,1,290180800,290180800,19321,6440,12881,6440,0,1,6442,1484155,1.484155
6840,1050,3940,4137000,2,54726,13683,1,306148800,306148800,20521,6840,13681,6840,0,1,6842,47726,0.047726
55,4305,965,4154325,2,446,113,1,35553400,35553400,166,55,111,55,0,1,57,83824,0.083824
455,4305,965,4154325,2,3646,913,1,52417400,52417400,1366,455,911,455,0,1,457,385798,0.385798
855,4305,965,4154325,2,6846,1713,1,69281400,69281400,2566,855,1711,855,0,1,857,577613,0.577613
1255,4305,965,4154325,2,10046,2513,1,86145400,86145400,3766,1255,2511,1255,0,1,1257,70684,0.070684
1655,4305,965,4154325,2,13246,3313,1,103009400,103009400,4966,1655,3311,1655,0,1,1657,1332564,1.332564
2055,4305,965,4154325,2,16446,4113,1,119873400,119873400,6166,2055,4111,2055,0,1,2057,126544,0.126544
2455,4305,965,4154325,2,19646,4913,1,136737400,136737400,7366,2455,4911,2455,0,1,2457,1646865,1.646865
2855,4305,965,4154325,2,22846,5713,1,153601400,153601400,8566,2855,5711,2855,0,1,2857,2160367,2.160367
3255,4305,965,4154325,2,26046,6513,1,170465400,170465400,9766,3255,6511,3255,0,1,3257,1683780,1.68378
3655,4305,965,4154325,2,29246,7313,1,187329400,187329400,10966,3655,7311,3655,0,1,3657,2676517,2.676517
4055,4305,965,4154325,2,32446,8113,1,204193400,204193400,12166,4055,8111,4055,0,1,4057,3228975,3.228975
4455,4305,965,4154325,2,35646,8913,1,221057400,221057400,13366,4455,8911,4455,0,1,4457,1329046,1.329046
4855,4305,965,4154325,2,38846,9713,1,237921400,237921400,14566,4855,9711,4855,0,1,4857,535667,0.535667
5255,4305,965,4154325,2,42046,10513,1,254785400,254785400,15766,5255,10511,5255,0,1,5257,2236721,2.236721
5655,4305,965,4154325,2,45246,11313,1,271649400,271649400,16966,5655,11311,5655,0,1,5657,1177223,1.177223
6055,4305,965,4154325,2,48446,12113,1,288513400,288513400,18166,6055,12111,6055,0,1,6057,681786,0.681786
6455,4305,965,4154325,2,51646,12913,1,305377400,305377400,19366,6455,12911,6455,0,1,6457,2226140,2.22614
6855,4305,965,4154325,2,54846,13713,1,322241400,322241400,20566,6855,13711,6855,0,1,6857,20560,0.02056
35,590,7045,4156550,2,286,73,1,35390200,35390200,106,35,71,35,0,1,37,24614,0.024614
535,590,7045,4156550,2,4286,1073,1,65930200,65930200,1606,535,1071,535,0,1,537,117532,0.117532
1035,590,7045,4156550,2,8286,2073,1,96470200,96470200,3106,1035,2071,1035,0,1,1037,69168,0.069168
1535,590,7045,4156550,2,12286,3073,1,127010200,127010200,4606,1535,3071,1535,0,1,1537,11016,0.011016
2035,590,7045,4156550,2,16286,4073,1,157550200,157550200,6106,2035,4071,2035,0,1,2037,1712267,1.712267
2535,590,7045,4156550,2,20286,5073,1,188090200,188090200,7606,2535,5071,2535,0,1,2537,2097470,2.09747
3035,590,7045,4156550,2,24286,6073,1,218630200,218630200,9106,3035,6071,3035,0,1,3037,2527358,2.527358
3535,590,7045,4156550,2,28286,7073,1,249170200,249170200,10606,3535,7071,3535,0,1,3537,2951522,2.951522
4035,590,7045,4156550,2,32286,8073,1,279710200,279710200,12106,4035,8071,4035,0,1,4037,3373807,3.373807
4535,590,7045,4156550,2,36286,9073,1,310250200,310250200,13606,4535,9071,4535,0,1,4537,3799230,3.79923
5035,590,7045,4156550,2,40286,10073,1,340790200,340790200,15106,5035,10071,5035,0,1,5037,4215815,4.215815
5535,590,7045,4156550,2,44286,11073,1,371330200,371330200,16606,5535,11071,5535,0,1,5537,4646527,4.646527
6035,590,7045,4156550,2,48286,12073,1,401870200,401870200,18106,6035,12071,6035,0,1,6037,5127006,5.127006
6535,590,7045,4156550,2,52286,13073,1,432410200,432410200,19606,6535,13071,6535,0,1,6537,5473741,5.473741
7035,590,7045,4156550,2,56286,14073,1,462950200,462950200,21106,7035,14071,7035,0,1,7037,5897501,5.897501
55,805,5165,4157825,2,446,113,1,35889400,35889400,166,55,111,55,0,1,57,86059,0.086059
455,805,5165,4157825,2,3646,913,1,54993400,54993400,1366,455,911,455,0,1,457,393769,0.393769
855,805,5165,4157825,2,6846,1713,1,74097400,74097400,2566,855,1711,855,0,1,857,107969,0.107969
1255,805,5165,4157825,2,10046,2513,1,93201400,93201400,3766,1255,2511,1255,0,1,1257,625499,0.625499
1655,805,5165,4157825,2,13246,3313,1,112305400,112305400,4966,1655,3311,1655,0,1,1657,1342371,1.342371
2055,805,5165,4157825,2,16446,4113,1,131409400,131409400,6166,2055,4111,2055,0,1,2057,1075928,1.075928
2455,805,5165,4157825,2,19646,4913,1,150513400,150513400,7366,2455,4911,2455,0,1,2457,755903,0.755903
2855,805,5165,4157825,2,22846,5713,1,169617400,169617400,8566,2855,5711,2855,0,1,2857,314486,0.314486
3255,805,5165,4157825,2,26046,6513,1,188721400,188721400,9766,3255,6511,3255,0,1,3257,743311,0.743311
3655,805,5165,4157825,2,29246,7313,1,207825400,207825400,10966,3655,7311,3655,0,1,3657,2103367,2.103367
4055,805,5165,4157825,2,32446,8113,1,226929400,226929400,12166,4055,8111,4055,0,1,4057,325296,0.325296
4455,805,5165,4157825,2,35646,8913,1,246033400,246033400,13366,4455,8911,4455,0,1,4457,269917,0.269917
4855,805,5165,4157825,2,38846,9713,1,265137400,265137400,14566,4855,9711,4855,0,1,4857,620078,0.620078
5255,805,5165,4157825,2,42046,10513,1,284241400,284241400,15766,5255,10511,5255,0,1,5257,531778,0.531778
5655,805,5165,4157825,2,45246,11313,1,303345400,303345400,16966,5655,11311,5655,0,1,5657,333796,0.333796
6055,805,5165,4157825,2,48446,12113,1,322449400,322449400,18166,6055,12111,6055,0,1,6057,186010,0.18601
6455,805,5165,4157825,2,51646,12913,1,341553400,341553400,19366,6455,12911,6455,0,1,6457,4265666,4.265666
6855,805,5165,4157825,2,54846,13713,1,360657400,360657400,20566,6855,13711,6855,0,1,6857,2532474,2.532474
39,593,7041,4175313,2,318,81,1,35784312,35784312,118,39,79,39,0,1,41,79809,0.079809
539,593,7041,4175313,2,4318,1081,1,66320312,66320312,1618,539,1079,539,0,1,541,218256,0.218256
1039,593,7041,4175313,2,8318,2081,1,96856312,96856312,3118,1039,2079,1039,0,1,1041,94576,0.094576
1539,593,7041,4175313,2,12318,3081,1,127392312,127392312,4618,1539,3079,1539,0,1,1541,894852,0.894852
2039,593,7041,4175313,2,16318,4081,1,157928312,157928312,6118,2039,4079,2039,0,1,2041,134536,0.134536
2539,593,7041,4175313,2,20318,5081,1,188464312,188464312,7618,2539,5079,2539,0,1,2541,1066428,1.066428
3039,593,7041,4175313,2,24318,6081,1,219000312,219000312,9118,3039,6079,3039,0,1,3041,242446,0.242446
3539,593,7041,4175313,2,28318,7081,1,249536312,249536312,10618,3539,7079,3539,0,1,3541,53925,0.053925
4039,593,7041,4175313,2,32318,8081,1,280072312,280072312,12118,4039,8079,4039,0,1,4041,1673939,1.673939
4539,593,7041,4175313,2,36318,9081,1,310608312,310608312,13618,4539,9079,4539,0,1,4541,1176642,1.176642
5039,593,7041,4175313,2,40318,10081,1,341144312,341144312,15118,5039,10079,5039,0,1,5041,229500,0.2295
5539,593,7041,4175313,2,44318,11081,1,371680312,371680312,16618,5539,11079,5539,0,1,5541,866829,0.866829
6039,593,7041,4175313,2,48318,12081,1,402216312,402216312,18118,6039,12079,6039,0,1,6041,2958403,2.958403
6539,593,7041,4175313,2,52318,13081,1,432752312,432752312,19618,6539,13079,6539,0,1,6541,1658223,1.658223
7039,593,7041,4175313,2,56318,14081,1,463288312,463288312,21118,7039,14079,7039,0,1,7041,879653,0.879653
55,3305,1265,4180825,2,446,113,1,35457400,35457400,166,55,111,55,0,1,57,84628,0.084628
455,3305,1265,4180825,2,3646,913,1,50081400,50081400,1366,455,911,455,0,1,457,174589,0.174589
855,3305,1265,4180825,2,6846,1713,1,64705400,64705400,2566,855,1711,855,0,1,857,730659,0.730659
1255,3305,1265,4180825,2,10046,2513,1,79329400,79329400,3766,1255,2511,1255,0,1,1257,1055261,1.055261
1655,3305,1265,4180825,2,13246,3313,1,93953400,93953400,4966,1655,3311,1655,0,1,1657,1374826,1.374826
2055,3305,1265,4180825,2,16446,4113,1,108577400,108577400,6166,2055,4111,2055,0,1,2057,1700749,1.700749
2455,3305,1265,4180825,2,19646,4913,1,123201400,123201400,7366,2455,4911,2455,0,1,2457,1354952,1.354952
2855,3305,1265,4180825,2,22846,5713,1,137825400,137825400,8566,2855,5711,2855,0,1,2857,67003,0.067003
3255,3305,1265,4180825,2,26046,6513,1,152449400,152449400,9766,3255,6511,3255,0,1,3257,307230,0.30723
3655,3305,1265,4180825,2,29246,7313,1,167073400,167073400,10966,3655,7311,3655,0,1,3657,1386058,1.386058
4055,3305,1265,4180825,2,32446,8113,1,181697400,181697400,12166,4055,8111,4055,0,1,4057,2045645,2.045645
4455,3305,1265,4180825,2,35646,8913,1,196321400,196321400,13366,4455,8911,4455,0,1,4457,766924,0.766924
4855,3305,1265,4180825,2,38846,9713,1,210945400,210945400,14566,4855,9711,4855,0,1,4857,1060225,1.060225
5255,3305,1265,4180825,2,42046,10513,1,225569400,225569400,15766,5255,10511,5255,0,1,5257,3293180,3.29318
5655,3305,1265,4180825,2,45246,11313,1,240193400,240193400,16966,5655,11311,5655,0,1,5657,901830,0.90183
6055,3305,1265,4180825,2,48446,12113,1,254817400,254817400,18166,6055,12111,6055,0,1,6057,3421307,3.421307
6455,3305,1265,4180825,2,51646,12913,1,269441400,269441400,19366,6455,12911,6455,0,1,6457,3557684,3.557684
6855,3305,1265,4180825,2,54846,13713,1,284065400,284065400,20566,6855,13711,6855,0,1,6857,4903074,4.903074
55,1055,3965,4183075,2,446,113,1,35673400,35673400,166,55,111,55,0,1,57,22674,0.022674
455,1055,3965,4183075,2,3646,913,1,51737400,51737400,1366,455,911,455,0,1,457,13048,0.013048
855,1055,3965,4183075,2,6846,1713,1,67801400,67801400,2566,855,1711,855,0,1,857,30249,0.030249
1255,1055,3965,4183075,2,10046,2513,1,83865400,83865400,3766,1255,2511,1255,0,1,1257,8185,0.008185
1655,1055,3965,4183075,2,13246,3313,1,99929400,99929400,4966,1655,3311,1655,0,1,1657,58899,0.058899
2055,1055,3965,4183075,2,16446,4113,1,115993400,115993400,6166,2055,4111,2055,0,1,2057,130262,0.130262
2455,1055,3965,4183075,2,19646,4913,1,132057400,132057400,7366,2455,4911,2455,0,1,2457,85085,0.085085
2855,1055,3965,4183075,2,22846,5713,1,148121400,148121400,8566,2855,5711,2855,0,1,2857,54969,0.054969
3255,1055,3965,4183075,2,26046,6513,1,164185400,164185400,9766,3255,6511,3255,0,1,3257,211118,0.211118
3655,1055,3965,4183075,2,29246,7313,1,180249400,180249400,10966,3655,7311,3655,0,1,3657,1332851,1.332851
4055,1055,3965,4183075,2,32446,8113,1,196313400,196313400,12166,4055,8111,4055,0,1,4057,1226096,1.226096
4455,1055,3965,4183075,2,35646,8913,1,212377400,212377400,13366,4455,8911,4455,0,1,4457,267463,0.267463
4855,1055,3965,4183075,2,38846,9713,1,228441400,228441400,14566,4855,9711,4855,0,1,4857,97224,0.097224
5255,1055,3965,4183075,2,42046,10513,1,244505400,244505400,15766,5255,10511,5255,0,1,5257,607288,0.607288
5655,1055,3965,4183075,2,45246,11313,1,260569400,260569400,16966,5655,11311,5655,0,1,5657,119232,0.119232
6055,1055,3965,4183075,2,48446,12113,1,276633400,276633400,18166,6055,12111,6055,0,1,6057,1276150,1.27615
6455,1055,3965,4183075,2,51646,12913,1,292697400,292697400,19366,6455,12911,6455,0,1,6457,55666,0.055666
6855,1055,3965,4183075,2,54846,13713,1,308761400,308761400,20566,6855,13711,6855,0,1,6857,540522,0.540522
40,6550,640,4192000,2,326,83,1,35836800,35836800,121,40,81,40,0,1,42,6913,0.006913
440,6550,640,4192000,2,3526,883,1,58844800,58844800,1321,440,881,440,0,1,442,9834,0.009834
840,6550,640,4192000,2,6726,1683,1,81852800,81852800,2521,840,1681,840,0,1,842,250022,0.250022
1240,6550,640,4192000,2,9926,2483,1,104860800,104860800,3721,1240,2481,1240,0,1,1242,75270,0.07527
1640,6550,640,4192000,2,13126,3283,1,127868800,127868800,4921,1640,3281,1640,0,1,1642,307130,0.30713
2040,6550,640,4192000,2,16326,4083,1,150876800,150876800,6121,2040,4081,2040,0,1,2042,150129,0.150129
2440,6550,640,4192000,2,19526,4883,1,173884800,173884800,7321,2440,4881,2440,0,1,2442,692805,0.692805
2840,6550,640,4192000,2,22726,5683,1,196892800,196892800,8521,2840,5681,2840,0,1,2842,46443,0.046443
3240,6550,640,4192000,2,25926,6483,1,219900800,219900800,9721,3240,6481,3240,0,1,3242,385268,0.385268
3640,6550,640,4192000,2,29126,7283,1,242908800,242908800,10921,3640,7281,3640,0,1,3642,2385495,2.385495
4040,6550,640,4192000,2,32326,8083,1,265916800,265916800,12121,4040,8081,4040,0,1,4042,2599061,2.599061
4440,6550,640,4192000,2,35526,8883,1,288924800,288924800,13321,4440,8881,4440,0,1,4442,772266,0.772266
4840,6550,640,4192000,2,38726,9683,1,311932800,311932800,14521,4840,9681,4840,0,1,4842,1862549,1.862549
5240,6550,640,4192000,2,41926,10483,1,334940800,334940800,15721,5240,10481,5240,0,1,5242,1066701,1.066701
5640,6550,640,4192000,2,45126,11283,1,357948800,357948800,16921,5640,11281,5640,0,1,5642,785761,0.785761
6040,6550,640,4192000,2,48326,12083,1,380956800,380956800,18121,6040,12081,6040,0,1,6042,809310,0.80931
6440,6550,640,4192000,2,51526,12883,1,403964800,403964800,19321,6440,12881,6440,0,1,6442,163507,0.163507
6840,6550,640,4192000,2,54726,13683,1,426972800,426972800,20521,6840,13681,6840,0,1,6842,3366967,3.366967
55,6305,665,4192825,2,446,113,1,36609400,36609400,166,55,111,55,0,1,57,86491,0.086491
455,6305,665,4192825,2,3646,913,1,58913400,58913400,1366,455,911,455,0,1,457,391601,0.391601
855,6305,665,4192825,2,6846,1713,1,81217400,81217400,2566,855,1711,855,0,1,857,717385,0.717385
1255,6305,665,4192825,2,10046,2513,1,103521400,103521400,3766,1255,2511,1255,0,1,1257,1038266,1.038266
1655,6305,665,4192825,2,13246,3313,1,125825400,125825400,4966,1655,3311,1655,0,1,1657,50801,0.050801
2055,6305,665,4192825,2,16446,4113,1,148129400,148129400,6166,2055,4111,2055,0,1,2057,1684953,1.684953
2455,6305,665,4192825,2,19646,4913,1,170433400,170433400,7366,2455,4911,2455,0,1,2457,1110669,1.110669
2855,6305,665,4192825,2,22846,5713,1,192737400,192737400,8566,2855,5711,2855,0,1,2857,181751,0.181751
3255,6305,665,4192825,2,26046,6513,1,215041400,215041400,9766,3255,6511,3255,0,1,3257,424903,0.424903
3655,6305,665,4192825,2,29246,7313,1,237345400,237345400,10966,3655,7311,3655,0,1,3657,724648,0.724648
4055,6305,665,4192825,2,32446,8113,1,259649400,259649400,12166,4055,8111,4055,0,1,4057,3327474,3.327474
4455,6305,665,4192825,2,35646,8913,1,281953400,281953400,13366,4455,8911,4455,0,1,4457,1962797,1.962797
4855,6305,665,4192825,2,38846,9713,1,304257400,304257400,14566,4855,9711,4855,0,1,4857,4000556,4.000556
5255,6305,665,4192825,2,42046,10513,1,326561400,326561400,15766,5255,10511,5255,0,1,5257,2453044,2.453044
5655,6305,665,4192825,2,45246,11313,1,348865400,348865400,16966,5655,11311,5655,0,1,5657,1846183,1.846183
6055,6305,665,4192825,2,48446,12113,1,371169400,371169400,18166,6055,12111,6055,0,1,6057,4972086,4.972086
6455,6305,665,4192825,2,51646,12913,1,393473400,393473400,19366,6455,12911,6455,0,1,6457,308033,0.308033
6855,6305,665,4192825,2,54846,13713,1,415777400,415777400,20566,6855,13711,6855,0,1,6857,925697,0.925697
40,2300,1840,4232000,2,326,83,1,35180800,35180800,121,40,81,40,0,1,42,77806,0.077806
440,2300,1840,4232000,2,3526,883,1,48428800,48428800,1321,440,881,440,0,1,442,378010,0.37801
840,2300,1840,4232000,2,6726,1683,1,61676800,61676800,2521,840,1681,840,0,1,842,348036,0.348036
1240,2300,1840,4232000,2,9926,2483,1,74924800,74924800,3721,1240,2481,1240,0,1,1242,860350,0.86035
1640,2300,1840,4232000,2,13126,3283,1,88172800,88172800,4921,1640,3281,1640,0,1,1642,1301244,1.301244
2040,2300,1840,4232000,2,16326,4083,1,101420800,101420800,6121,2040,4081,2040,0,1,2042,342253,0.342253
2440,2300,1840,4232000,2,19526,4883,1,114668800,114668800,7321,2440,4881,2440,0,1,2442,1172633,1.172633
2840,2300,1840,4232000,2,22726,5683,1,127916800,127916800,8521,2840,5681,2840,0,1,2842,2231120,2.23112
3240,2300,1840,4232000,2,25926,6483,1,141164800,141164800,9721,3240,6481,3240,0,1,3242,665953,0.665953
3640,2300,1840,4232000,2,29126,7283,1,154412800,154412800,10921,3640,7281,3640,0,1,3642,184083,0.184083
4040,2300,1840,4232000,2,32326,8083,1,167660800,167660800,12121,4040,8081,4040,0,1,4042,611503,0.611503
4440,2300,1840,4232000,2,35526,8883,1,180908800,180908800,13321,4440,8881,4440,0,1,4442,2189779,2.189779
4840,2300,1840,4232000,2,38726,9683,1,194156800,194156800,14521,4840,9681,4840,0,1,4842,1360072,1.360072
5240,2300,1840,4232000,2,41926,10483,1,207404800,207404800,15721,5240,10481,5240,0,1,5242,1759271,1.759271
5640,2300,1840,4232000,2,45126,11283,1,220652800,220652800,16921,5640,11281,5640,0,1,5642,2243693,2.243693
6040,2300,1840,4232000,2,48326,12083,1,233900800,233900800,18121,6040,12081,6040,0,1,6042,2619264,2.619264
6440,2300,1840,4232000,2,51526,12883,1,247148800,247148800,19321,6440,12881,6440,0,1,6442,3578340,3.57834
6840,2300,1840,4232000,2,54726,13683,1,260396800,260396800,20521,6840,13681,6840,0,1,6842,313335,0.313335
40,1550,2740,4247000,2,326,83,1,35348800,35348800,121,40,81,40,0,1,42,80442,0.080442
440,1550,2740,4247000,2,3526,883,1,49076800,49076800,1321,440,881,440,0,1,442,336493,0.336493
840,1550,2740,4247000,2,6726,1683,1,62804800,62804800,2521,840,1681,840,0,1,842,720833,0.720833
1240,1550,2740,4247000,2,9926,2483,1,76532800,76532800,3721,1240,2481,1240,0,1,1242,1045745,1.045745
1640,1550,2740,4247000,2,13126,3283,1,90260800,90260800,4921,1640,3281,1640,0,1,1642,1050335,1.050335
2040,1550,2740,4247000,2,16326,4083,1,103988800,103988800,6121,2040,4081,2040,0,1,2042,120153,0.120153
2440,1550,2740,4247000,2,19526,4883,1,117716800,117716800,7321,2440,4881,2440,0,1,2442,32784,0.032784
2840,1550,2740,4247000,2,22726,5683,1,131444800,131444800,8521,2840,5681,2840,0,1,2842,664572,0.664572
3240,1550,2740,4247000,2,25926,6483,1,145172800,145172800,9721,3240,6481,3240,0,1,3242,1253997,1.253997
3640,1550,2740,4247000,2,29126,7283,1,158900800,158900800,10921,3640,7281,3640,0,1,3642,3017456,3.017456
4040,1550,2740,4247000,2,32326,8083,1,172628800,172628800,12121,4040,8081,4040,0,1,4042,1045766,1.045766
4440,1550,2740,4247000,2,35526,8883,1,186356800,186356800,13321,4440,8881,4440,0,1,4442,1712313,1.712313
4840,1550,2740,4247000,2,38726,9683,1,200084800,200084800,14521,4840,9681,4840,0,1,4842,434191,0.434191
5240,1550,2740,4247000,2,41926,10483,1,213812800,213812800,15721,5240,10481,5240,0,1,5242,503210,0.50321
5640,1550,2740,4247000,2,45126,11283,1,227540800,227540800,16921,5640,11281,5640,0,1,5642,4666347,4.666347
6040,1550,2740,4247000,2,48326,12083,1,241268800,241268800,18121,6040,12081,6040,0,1,6042,2090889,2.090889
6440,1550,2740,4247000,2,51526,12883,1,254996800,254996800,19321,6440,12881,6440,0,1,6442,2790512,2.790512
6840,1550,2740,4247000,2,54726,13683,1,268724800,268724800,20521,6840,13681,6840,0,1,6842,268789,0.268789
44,603,7055,4254165,2,358,91,1,36728936,36728936,133,44,89,44,0,1,46,80809,0.080809
544,603,7055,4254165,2,4358,1091,1,67360936,67360936,1633,544,1089,544,0,1,546,50788,0.050788
1044,603,7055,4254165,2,8358,2091,1,97992936,97992936,3133,1044,2089,1044,0,1,1046,701724,0.701724
1544,603,7055,4254165,2,12358,3091,1,128624936,128624936,4633,1544,3089,1544,0,1,1546,680188,0.680188
2044,603,7055,4254165,2,16358,4091,1,159256936,159256936,6133,2044,4089,2044,0,1,2046,349947,0.349947
2544,603,7055,4254165,2,20358,5091,1,189888936,189888936,7633,2544,5089,2544,0,1,2546,1256561,1.256561
3044,603,7055,4254165,2,24358,6091,1,220520936,220520936,9133,3044,6089,3044,0,1,3046,359007,0.359007
3544,603,7055,4254165,2,28358,7091,1,251152936,251152936,10633,3544,7089,3544,0,1,3546,561078,0.561078
4044,603,7055,4254165,2,32358,8091,1,281784936,281784936,12133,4044,8089,4044,0,1,4046,164869,0.164869
4544,603,7055,4254165,2,36358,9091,1,312416936,312416936,13633,4544,9089,4544,0,1,4546,434487,0.434487
5044,603,7055,4254165,2,40358,10091,1,343048936,343048936,15133,5044,10089,5044,0,1,5046,645460,0.64546
5544,603,7055,4254165,2,44358,11091,1,373680936,373680936,16633,5544,11089,5544,0,1,5546,222853,0.222853
6044,603,7055,4254165,2,48358,12091,1,404312936,404312936,18133,6044,12089,6044,0,1,6046,574497,0.574497
6544,603,7055,4254165,2,52358,13091,1,434944936,434944936,19633,6544,13089,6544,0,1,6546,694851,0.694851
7044,603,7055,4254165,2,56358,14091,1,465576936,465576936,21133,7044,14089,7044,0,1,7046,1547178,1.547178
40,4550,940,4277000,2,326,83,1,35972800,35972800,121,40,81,40,0,1,42,76923,0.076923
440,4550,940,4277000,2,3526,883,1,53540800,53540800,1321,440,881,440,0,1,442,386868,0.386868
840,4550,940,4277000,2,6726,1683,1,71108800,71108800,2521,840,1681,840,0,1,842,705146,0.705146
1240,4550,940,4277000,2,9926,2483,1,88676800,88676800,3721,1240,2481,1240,0,1,1242,1021974,1.021974
1640,4550,940,4277000,2,13126,3283,1,106244800,106244800,4921,1640,3281,1640,0,1,1642,156598,0.156598
2040,4550,940,4277000,2,16326,4083,1,123812800,123812800,6121,2040,4081,2040,0,1,2042,1656066,1.656066
2440,4550,940,4277000,2,19526,4883,1,141380800,141380800,7321,2440,4881,2440,0,1,2442,1974578,1.974578
2840,4550,940,4277000,2,22726,5683,1,158948800,158948800,8521,2840,5681,2840,0,1,2842,2296444,2.296444
3240,4550,940,4277000,2,25926,6483,1,176516800,176516800,9721,3240,6481,3240,0,1,3242,605323,0.605323
3640,4550,940,4277000,2,29126,7283,1,194084800,194084800,10921,3640,7281,3640,0,1,3642,1545721,1.545721
4040,4550,940,4277000,2,32326,8083,1,211652800,211652800,12121,4040,8081,4040,0,1,4042,3283687,3.283687
4440,4550,940,4277000,2,35526,8883,1,229220800,229220800,13321,4440,8881,4440,0,1,4442,1143804,1.143804
4840,4550,940,4277000,2,38726,9683,1,246788800,246788800,14521,4840,9681,4840,0,1,4842,1349147,1.349147
5240,4550,940,4277000,2,41926,10483,1,264356800,264356800,15721,5240,10481,5240,0,1,5242,1418888,1.418888
5640,4550,940,4277000,2,45126,11283,1,281924800,281924800,16921,5640,11281,5640,0,1,5642,60379,0.060379
6040,4550,940,4277000,2,48326,12083,1,299492800,299492800,18121,6040,12081,6040,0,1,6042,4862161,4.862161
6440,4550,940,4277000,2,51526,12883,1,317060800,317060800,19321,6440,12881,6440,0,1,6442,3292682,3.292682
6840,4550,940,4277000,2,54726,13683,1,334628800,334628800,20521,6840,13681,6840,0,1,6842,5531661,5.531661
55,2305,1865,4298825,2,446,113,1,36225400,36225400,166,55,111,55,0,1,57,87007,0.087007
455,2305,1865,4298825,2,3646,913,1,49569400,49569400,1366,455,911,455,0,1,457,308929,0.308929
855,2305,1865,4298825,2,6846,1713,1,62913400,62913400,2566,855,1711,855,0,1,857,717128,0.717128
1255,2305,1865,4298825,2,10046,2513,1,76257400,76257400,3766,1255,2511,1255,0,1,1257,1037859,1.037859
1655,2305,1865,4298825,2,13246,3313,1,89601400,89601400,4966,1655,3311,1655,0,1,1657,1357033,1.357033
2055,2305,1865,4298825,2,16446,4113,1,102945400,102945400,6166,2055,4111,2055,0,1,2057,1143852,1.143852
2455,2305,1865,4298825,2,19646,4913,1,116289400,116289400,7366,2455,4911,2455,0,1,2457,2001002,2.001002
2855,2305,1865,4298825,2,22846,5713,1,129633400,129633400,8566,2855,5711,2855,0,1,2857,2331607,2.331607
3255,2305,1865,4298825,2,26046,6513,1,142977400,142977400,9766,3255,6511,3255,0,1,3257,380602,0.380602
3655,2305,1865,4298825,2,29246,7313,1,156321400,156321400,10966,3655,7311,3655,0,1,3657,744442,0.744442
4055,2305,1865,4298825,2,32446,8113,1,169665400,169665400,12166,4055,8111,4055,0,1,4057,1523531,1.523531
4455,2305,1865,4298825,2,35646,8913,1,183009400,183009400,13366,4455,8911,4455,0,1,4457,1054936,1.054936
4855,2305,1865,4298825,2,38846,9713,1,196353400,196353400,14566,4855,9711,4855,0,1,4857,149039,0.149039
5255,2305,1865,4298825,2,42046,10513,1,209697400,209697400,15766,5255,10511,5255,0,1,5257,259173,0.259173
5655,2305,1865,4298825,2,45246,11313,1,223041400,223041400,16966,5655,11311,5655,0,1,5657,187529,0.187529
6055,2305,1865,4298825,2,48446,12113,1,236385400,236385400,18166,6055,12111,6055,0,1,6057,2654820,2.65482
6455,2305,1865,4298825,2,51646,12913,1,249729400,249729400,19366,6455,12911,6455,0,1,6457,5236769,5.236769
6855,2305,1865,4298825,2,54846,13713,1,263073400,263073400,20566,6855,13711,6855,0,1,6857,402671,0.402671
55,1555,2765,4299575,2,446,113,1,36297400,36297400,166,55,111,55,0,1,57,88537,0.088537
455,1555,2765,4299575,2,3646,913,1,50121400,50121400,1366,455,911,455,0,1,457,416870,0.41687
855,1555,2765,4299575,2,6846,1713,1,63945400,63945400,2566,855,1711,855,0,1,857,746441,0.746441
1255,1555,2765,4299575,2,10046,2513,1,77769400,77769400,3766,1255,2511,1255,0,1,1257,483196,0.483196
1655,1555,2765,4299575,2,13246,3313,1,91593400,91593400,4966,1655,3311,1655,0,1,1657,645492,0.645492
2055,1555,2765,4299575,2,16446,4113,1,105417400,105417400,6166,2055,4111,2055,0,1,2057,832580,0.83258
2455,1555,2765,4299575,2,19646,4913,1,119241400,119241400,7366,2455,4911,2455,0,1,2457,1603577,1.603577
2855,1555,2765,4299575,2,22846,5713,1,133065400,133065400,8566,2855,5711,2855,0,1,2857,307177,0.307177
3255,1555,2765,4299575,2,26046,6513,1,146889400,146889400,9766,3255,6511,3255,0,1,3257,1982641,1.982641
3655,1555,2765,4299575,2,29246,7313,1,160713400,160713400,10966,3655,7311,3655,0,1,3657,522376,0.522376
4055,1555,2765,4299575,2,32446,8113,1,174537400,174537400,12166,4055,8111,4055,0,1,4057,3424950,3.42495
4455,1555,2765,4299575,2,35646,8913,1,188361400,188361400,13366,4455,8911,4455,0,1,4457,3747332,3.747332
4855,1555,2765,4299575,2,38846,9713,1,202185400,202185400,14566,4855,9711,4855,0,1,4857,854431,0.854431
5255,1555,2765,4299575,2,42046,10513,1,216009400,216009400,15766,5255,10511,5255,0,1,5257,263086,0.263086
5655,1555,2765,4299575,2,45246,11313,1,229833400,229833400,16966,5655,11311,5655,0,1,5657,1336157,1.336157
6055,1555,2765,4299575,2,48446,12113,1,243657400,243657400,18166,6055,12111,6055,0,1,6057,4711726,4.711726
6455,1555,2765,4299575,2,51646,12913,1,257481400,257481400,19366,6455,12911,6455,0,1,6457,3087664,3.087664
6855,1555,2765,4299575,2,54846,13713,1,271305400,271305400,20566,6855,13711,6855,0,1,6857,4467294,4.467294
39,1693,2541,4301913,2,318,81,1,35736312,35736312,118,39,79,39,0,1,41,35883,0.035883
539,1693,2541,4301913,2,4318,1081,1,52672312,52672312,1618,539,1079,539,0,1,541,400780,0.40078
1039,1693,2541,4301913,2,8318,2081,1,69608312,69608312,3118,1039,2079,1039,0,1,1041,413124,0.413124
1539,1693,2541,4301913,2,12318,3081,1,86544312,86544312,4618,1539,3079,1539,0,1,1541,1256655,1.256655
2039,1693,2541,4301913,2,16318,4081,1,103480312,103480312,6118,2039,4079,2039,0,1,2041,1734537,1.734537
2539,1693,2541,4301913,2,20318,5081,1,120416312,120416312,7618,2539,5079,2539,0,1,2541,1321396,1.321396
3039,1693,2541,4301913,2,24318,6081,1,137352312,137352312,9118,3039,6079,3039,0,1,3041,1603336,1.603336
3539,1693,2541,4301913,2,28318,7081,1,154288312,154288312,10618,3539,7079,3539,0,1,3541,865433,0.865433
4039,1693,2541,4301913,2,32318,8081,1,171224312,171224312,12118,4039,8079,4039,0,1,4041,2096464,2.096464
4539,1693,2541,4301913,2,36318,9081,1,188160312,188160312,13618,4539,9079,4539,0,1,4541,713951,0.713951
5039,1693,2541,4301913,2,40318,10081,1,205096312,205096312,15118,5039,10079,5039,0,1,5041,4034337,4.034337
5539,1693,2541,4301913,2,44318,11081,1,222032312,222032312,16618,5539,11079,5539,0,1,5541,1105751,1.105751
6039,1693,2541,4301913,2,48318,12081,1,238968312,238968312,18118,6039,12079,6039,0,1,6041,2831456,2.831456
6539,1693,2541,4301913,2,52318,13081,1,255904312,255904312,19618,6539,13079,6539,0,1,6541,178063,0.178063
7039,1693,2541,4301913,2,56318,14081,1,272840312,272840312,21118,7039,14079,7039,0,1,7041,2136017,2.136017
39,2793,1541,4304013,2,318,81,1,35784312,35784312,118,39,79,39,0,1,41,81156,0.081156
539,2793,1541,4304013,2,4318,1081,1,53120312,53120312,1618,539,1079,539,0,1,541,477266,0.477266
1039,2793,1541,4304013,2,8318,2081,1,70456312,70456312,3118,1039,2079,1039,0,1,1041,539312,0.539312
1539,2793,1541,4304013,2,12318,3081,1,87792312,87792312,4618,1539,3079,1539,0,1,1541,893306,0.893306
2039,2793,1541,4304013,2,16318,4081,1,105128312,105128312,6118,2039,4079,2039,0,1,2041,455923,0.455923
2539,2793,1541,4304013,2,20318,5081,1,122464312,122464312,7618,2539,5079,2539,0,1,2541,2105221,2.105221
3039,2793,1541,4304013,2,24318,6081,1,139800312,139800312,9118,3039,6079,3039,0,1,3041,1013884,1.013884
3539,2793,1541,4304013,2,28318,7081,1,157136312,157136312,10618,3539,7079,3539,0,1,3541,2203798,2.203798
4039,2793,1541,4304013,2,32318,8081,1,174472312,174472312,12118,4039,8079,4039,0,1,4041,2021297,2.021297
4539,2793,1541,4304013,2,36318,9081,1,191808312,191808312,13618,4539,9079,4539,0,1,4541,1536323,1.536323
5039,2793,1541,4304013,2,40318,10081,1,209144312,209144312,15118,5039,10079,5039,0,1,5041,14841,0.014841
5539,2793,1541,4304013,2,44318,11081,1,226480312,226480312,16618,5539,11079,5539,0,1,5541,3392322,3.392322
6039,2793,1541,4304013,2,48318,12081,1,243816312,243816312,18118,6039,12079,6039,0,1,6041,170092,0.170092
6539,2793,1541,4304013,2,52318,13081,1,261152312,261152312,19618,6539,13079,6539,0,1,6541,3462878,3.462878
7039,2793,1541,4304013,2,56318,14081,1,278488312,278488312,21118,7039,14079,7039,0,1,7041,4228809,4.228809
40,2800,1540,4312000,2,326,83,1,35884800,35884800,121,40,81,40,0,1,42,76404,0.076404
440,2800,1540,4312000,2,3526,883,1,49772800,49772800,1321,440,881,440,0,1,442,391173,0.391173
840,2800,1540,4312000,2,6726,1683,1,63660800,63660800,2521,840,1681,840,0,1,842,712895,0.712895
1240,2800,1540,4312000,2,9926,2483,1,77548800,77548800,3721,1240,2481,1240,0,1,1242,1030779,1.030779
1640,2800,1540,4312000,2,13126,3283,1,91436800,91436800,4921,1640,3281,1640,0,1,1642,726747,0.726747
2040,2800,1540,4312000,2,16326,4083,1,105324800,105324800,6121,2040,4081,2040,0,1,2042,1681440,1.68144
2440,2800,1540,4312000,2,19526,4883,1,119212800,119212800,7321,2440,4881,2440,0,1,2442,1415901,1.415901
2840,2800,1540,4312000,2,22726,5683,1,133100800,133100800,8521,2840,5681,2840,0,1,2842,1723088,1.723088
3240,2800,1540,4312000,2,25926,6483,1,146988800,146988800,9721,3240,6481,3240,0,1,3242,2653790,2.65379
3640,2800,1540,4312000,2,29126,7283,1,160876800,160876800,10921,3640,7281,3640,0,1,3642,2135782,2.135782
4040,2800,1540,4312000,2,32326,8083,1,174764800,174764800,12121,4040,8081,4040,0,1,4042,3308186,3.308186
4440,2800,1540,4312000,2,35526,8883,1,188652800,188652800,13321,4440,8881,4440,0,1,4442,1748792,1.748792
4840,2800,1540,4312000,2,38726,9683,1,202540800,202540800,14521,4840,9681,4840,0,1,4842,841782,0.841782
5240,2800,1540,4312000,2,41926,10483,1,216428800,216428800,15721,5240,10481,5240,0,1,5242,12624,0.012624
5640,2800,1540,4312000,2,45126,11283,1,230316800,230316800,16921,5640,11281,5640,0,1,5642,1025344,1.025344
6040,2800,1540,4312000,2,48326,12083,1,244204800,244204800,18121,6040,12081,6040,0,1,6042,3383709,3.383709
6440,2800,1540,4312000,2,51526,12883,1,258092800,258092800,19321,6440,12881,6440,0,1,6442,4126266,4.126266
6840,2800,1540,4312000,2,54726,13683,1,271980800,271980800,20521,6840,13681,6840,0,1,6842,1533934,1.533934
40,1300,3340,4342000,2,326,83,1,36220800,36220800,121,40,81,40,0,1,42,82897,0.082897
440,1300,3340,4342000,2,3526,883,1,51068800,51068800,1321,440,881,440,0,1,442,406125,0.406125
840,1300,3340,4342000,2,6726,1683,1,65916800,65916800,2521,840,1681,840,0,1,842,40692,0.040692
1240,1300,3340,4342000,2,9926,2483,1,80764800,80764800,3721,1240,2481,1240,0,1,1242,201401,0.201401
1640,1300,3340,4342000,2,13126,3283,1,95612800,95612800,4921,1640,3281,1640,0,1,1642,89552,0.089552
2040,1300,3340,4342000,2,16326,4083,1,110460800,110460800,6121,2040,4081,2040,0,1,2042,879814,0.879814
2440,1300,3340,4342000,2,19526,4883,1,125308800,125308800,7321,2440,4881,2440,0,1,2442,275607,0.275607
2840,1300,3340,4342000,2,22726,5683,1,140156800,140156800,8521,2840,5681,2840,0,1,2842,184604,0.184604
3240,1300,3340,4342000,2,25926,6483,1,155004800,155004800,9721,3240,6481,3240,0,1,3242,744332,0.744332
3640,1300,3340,4342000,2,29126,7283,1,169852800,169852800,10921,3640,7281,3640,0,1,3642,994184,0.994184
4040,1300,3340,4342000,2,32326,8083,1,184700800,184700800,12121,4040,8081,4040,0,1,4042,960987,0.960987
4440,1300,3340,4342000,2,35526,8883,1,199548800,199548800,13321,4440,8881,4440,0,1,4442,239149,0.239149
4840,1300,3340,4342000,2,38726,9683,1,214396800,214396800,14521,4840,9681,4840,0,1,4842,486365,0.486365
5240,1300,3340,4342000,2,41926,10483,1,229244800,229244800,15721,5240,10481,5240,0,1,5242,3484055,3.484055
5640,1300,3340,4342000,2,45126,11283,1,244092800,244092800,16921,5640,11281,5640,0,1,5642,2777937,2.777937
6040,1300,3340,4342000,2,48326,12083,1,258940800,258940800,18121,6040,12081,6040,0,1,6042,2126381,2.126381
6440,1300,3340,4342000,2,51526,12883,1,273788800,273788800,19321,6440,12881,6440,0,1,6442,101145,0.101145
6840,1300,3340,4342000,2,54726,13683,1,288636800,288636800,20521,6840,13681,6840,0,1,6842,1486661,1.486661
44,1703,2555,4351165,2,358,91,1,36308136,36308136,133,44,89,44,0,1,46,81138,0.081138
544,1703,2555,4351165,2,4358,1091,1,53340136,53340136,1633,544,1089,544,0,1,546,491639,0.491639
1044,1703,2555,4351165,2,8358,2091,1,70372136,70372136,3133,1044,2089,1044,0,1,1046,909633,0.909633
1544,1703,2555,4351165,2,12358,3091,1,87404136,87404136,4633,1544,3089,1544,0,1,1546,285489,0.285489
2044,1703,2555,4351165,2,16358,4091,1,104436136,104436136,6133,2044,4089,2044,0,1,2046,1755598,1.755598
2544,1703,2555,4351165,2,20358,5091,1,121468136,121468136,7633,2544,5089,2544,0,1,2546,1346507,1.346507
3044,1703,2555,4351165,2,24358,6091,1,138500136,138500136,9133,3044,6089,3044,0,1,3046,973661,0.973661
3544,1703,2555,4351165,2,28358,7091,1,155532136,155532136,10633,3544,7089,3544,0,1,3546,652733,0.652733
4044,1703,2555,4351165,2,32358,8091,1,172564136,172564136,12133,4044,8089,4044,0,1,4046,2191930,2.19193
4544,1703,2555,4351165,2,36358,9091,1,189596136,189596136,13633,4544,9089,4544,0,1,4546,1506267,1.506267
5044,1703,2555,4351165,2,40358,10091,1,206628136,206628136,15133,5044,10089,5044,0,1,5046,879882,0.879882
5544,1703,2555,4351165,2,44358,11091,1,223660136,223660136,16633,5544,11089,5544,0,1,5546,3395076,3.395076
6044,1703,2555,4351165,2,48358,12091,1,240692136,240692136,18133,6044,12089,6044,0,1,6046,1457222,1.457222
6544,1703,2555,4351165,2,52358,13091,1,257724136,257724136,19633,6544,13089,6544,0,1,6546,322722,0.322722
7044,1703,2555,4351165,2,56358,14091,1,274756136,274756136,21133,7044,14089,7044,0,1,7046,195793,0.195793
40,800,5440,4352000,2,326,83,1,36812800,36812800,121,40,81,40,0,1,42,77858,0.077858
440,800,5440,4352000,2,3526,883,1,56780800,56780800,1321,440,881,440,0,1,442,386484,0.386484
840,800,5440,4352000,2,6726,1683,1,76748800,76748800,2521,840,1681,840,0,1,842,704186,0.704186
1240,800,5440,4352000,2,9926,2483,1,96716800,96716800,3721,1240,2481,1240,0,1,1242,47092,0.047092
1640,800,5440,4352000,2,13126,3283,1,116684800,116684800,4921,1640,3281,1640,0,1,1642,1340972,1.340972
2040,800,5440,4352000,2,16326,4083,1,136652800,136652800,6121,2040,4081,2040,0,1,2042,450807,0.450807
2440,800,5440,4352000,2,19526,4883,1,156620800,156620800,7321,2440,4881,2440,0,1,2442,1035003,1.035003
2840,800,5440,4352000,2,22726,5683,1,176588800,176588800,8521,2840,5681,2840,0,1,2842,1485052,1.485052
3240,800,5440,4352000,2,25926,6483,1,196556800,196556800,9721,3240,6481,3240,0,1,3242,262835,0.262835
3640,800,5440,4352000,2,29126,7283,1,216524800,216524800,10921,3640,7281,3640,0,1,3642,1175189,1.175189
4040,800,5440,4352000,2,32326,8083,1,236492800,236492800,12121,4040,8081,4040,0,1,4042,1792414,1.792414
4440,800,5440,4352000,2,35526,8883,1,256460800,256460800,13321,4440,8881,4440,0,1,4442,667975,0.667975
4840,800,5440,4352000,2,38726,9683,1,276428800,276428800,14521,4840,9681,4840,0,1,4842,1366704,1.366704
5240,800,5440,4352000,2,41926,10483,1,296396800,296396800,15721,5240,10481,5240,0,1,5242,294011,0.294011
5640,800,5440,4352000,2,45126,11283,1,316364800,316364800,16921,5640,11281,5640,0,1,5642,377921,0.377921
6040,800,5440,4352000,2,48326,12083,1,336332800,336332800,18121,6040,12081,6040,0,1,6042,2763375,2.763375
6440,800,5440,4352000,2,51526,12883,1,356300800,356300800,19321,6440,12881,6440,0,1,6442,4080290,4.08029
6840,800,5440,4352000,2,54726,13683,1,376268800,376268800,20521,6840,13681,6840,0,1,6842,1072576,1.072576
40,6800,640,4352000,2,326,83,1,37196800,37196800,121,40,81,40,0,1,42,74327,0.074327
440,6800,640,4352000,2,3526,883,1,61004800,61004800,1321,440,881,440,0,1,442,387398,0.387398
840,6800,640,4352000,2,6726,1683,1,84812800,84812800,2521,840,1681,840,0,1,842,727770,0.72777
1240,6800,640,4352000,2,9926,2483,1,108620800,108620800,3721,1240,2481,1240,0,1,1242,380399,0.380399
1640,6800,640,4352000,2,13126,3283,1,132428800,132428800,4921,1640,3281,1640,0,1,1642,1389212,1.389212
2040,6800,640,4352000,2,16326,4083,1,156236800,156236800,6121,2040,4081,2040,0,1,2042,1722026,1.722026
2440,6800,640,4352000,2,19526,4883,1,180044800,180044800,7321,2440,4881,2440,0,1,2442,2062721,2.062721
2840,6800,640,4352000,2,22726,5683,1,203852800,203852800,8521,2840,5681,2840,0,1,2842,1106799,1.106799
3240,6800,640,4352000,2,25926,6483,1,227660800,227660800,9721,3240,6481,3240,0,1,3242,2747571,2.747571
3640,6800,640,4352000,2,29126,7283,1,251468800,251468800,10921,3640,7281,3640,0,1,3642,1577331,1.577331
4040,6800,640,4352000,2,32326,8083,1,275276800,275276800,12121,4040,8081,4040,0,1,4042,2958099,2.958099
4440,6800,640,4352000,2,35526,8883,1,299084800,299084800,13321,4440,8881,4440,0,1,4442,2480846,2.480846
4840,6800,640,4352000,2,38726,9683,1,322892800,322892800,14521,4840,9681,4840,0,1,4842,1310795,1.310795
5240,6800,640,4352000,2,41926,10483,1,346700800,346700800,15721,5240,10481,5240,0,1,5242,404551,0.404551
5640,6800,640,4352000,2,45126,11283,1,370508800,370508800,16921,5640,11281,5640,0,1,5642,4759397,4.759397
6040,6800,640,4352000,2,48326,12083,1,394316800,394316800,18121,6040,12081,6040,0,1,6042,307482,0.307482
6440,6800,640,4352000,2,51526,12883,1,418124800,418124800,19321,6440,12881,6440,0,1,6442,5425308,5.425308
6840,6800,640,4352000,2,54726,13683,1,441932800,441932800,20521,6840,13681,6840,0,1,6842,502873,0.502873
44,2803,1555,4358665,2,358,91,1,36403336,36403336,133,44,89,44,0,1,46,80560,0.08056
544,2803,1555,4358665,2,4358,1091,1,53835336,53835336,1633,544,1089,544,0,1,546,478405,0.478405
1044,2803,1555,4358665,2,8358,2091,1,71267336,71267336,3133,1044,2089,1044,0,1,1046,883102,0.883102
1544,2803,1555,4358665,2,12358,3091,1,88699336,88699336,4633,1544,3089,1544,0,1,1546,1287891,1.287891
2044,2803,1555,4358665,2,16358,4091,1,106131336,106131336,6133,2044,4089,2044,0,1,2046,1700750,1.70075
2544,2803,1555,4358665,2,20358,5091,1,123563336,123563336,7633,2544,5089,2544,0,1,2546,426065,0.426065
3044,2803,1555,4358665,2,24358,6091,1,140995336,140995336,9133,3044,6089,3044,0,1,3046,458141,0.458141
3544,2803,1555,4358665,2,28358,7091,1,158427336,158427336,10633,3544,7089,3544,0,1,3546,93111,0.093111
4044,2803,1555,4358665,2,32358,8091,1,175859336,175859336,12133,4044,8089,4044,0,1,4046,3017223,3.017223
4544,2803,1555,4358665,2,36358,9091,1,193291336,193291336,13633,4544,9089,4544,0,1,4546,3734892,3.734892
5044,2803,1555,4358665,2,40358,10091,1,210723336,210723336,15133,5044,10089,5044,0,1,5046,205009,0.205009
5544,2803,1555,4358665,2,44358,11091,1,228155336,228155336,16633,5544,11089,5544,0,1,5546,2025141,2.025141
6044,2803,1555,4358665,2,48358,12091,1,245587336,245587336,18133,6044,12089,6044,0,1,6046,950290,0.95029
6544,2803,1555,4358665,2,52358,13091,1,263019336,263019336,19633,6544,13089,6544,0,1,6546,5019162,5.019162
7044,2803,1555,4358665,2,56358,14091,1,280451336,280451336,21133,7044,14089,7044,0,1,7046,2500910,2.50091
55,6555,665,4359075,2,446,113,1,38049400,38049400,166,55,111,55,0,1,57,4853,0.004853
455,6555,665,4359075,2,3646,913,1,61153400,61153400,1366,455,911,455,0,1,457,22221,0.022221
855,6555,665,4359075,2,6846,1713,1,84257400,84257400,2566,855,1711,855,0,1,857,181197,0.181197
1255,6555,665,4359075,2,10046,2513,1,107361400,107361400,3766,1255,2511,1255,0,1,1257,150921,0.150921
1655,6555,665,4359075,2,13246,3313,1,130465400,130465400,4966,1655,3311,1655,0,1,1657,830474,0.830474
2055,6555,665,4359075,2,16446,4113,1,153569400,153569400,6166,2055,4111,2055,0,1,2057,295279,0.295279
2455,6555,665,4359075,2,19646,4913,1,176673400,176673400,7366,2455,4911,2455,0,1,2457,345388,0.345388
2855,6555,665,4359075,2,22846,5713,1,199777400,199777400,8566,2855,5711,2855,0,1,2857,203435,0.203435
3255,6555,665,4359075,2,26046,6513,1,222881400,222881400,9766,3255,6511,3255,0,1,3257,29589,0.029589
3655,6555,665,4359075,2,29246,7313,1,245985400,245985400,10966,3655,7311,3655,0,1,3657,1631485,1.631485
4055,6555,665,4359075,2,32446,8113,1,269089400,269089400,12166,4055,8111,4055,0,1,4057,812221,0.812221
4455,6555,665,4359075,2,35646,8913,1,292193400,292193400,13366,4455,8911,4455,0,1,4457,88008,0.088008
4855,6555,665,4359075,2,38846,9713,1,315297400,315297400,14566,4855,9711,4855,0,1,4857,412006,0.412006
5255,6555,665,4359075,2,42046,10513,1,338401400,338401400,15766,5255,10511,5255,0,1,5257,222953,0.222953
5655,6555,665,4359075,2,45246,11313,1,361505400,361505400,16966,5655,11311,5655,0,1,5657,1150658,1.150658
6055,6555,665,4359075,2,48446,12113,1,384609400,384609400,18166,6055,12111,6055,0,1,6057,3075409,3.075409
6455,6555,665,4359075,2,51646,12913,1,407713400,407713400,19366,6455,12911,6455,0,1,6457,671471,0.671471
6855,6555,665,4359075,2,54846,13713,1,430817400,430817400,20566,6855,13711,6855,0,1,6857,1143411,1.143411
40,2050,2140,4387000,2,326,83,1,36436800,36436800,121,40,81,40,0,1,42,6107,0.006107
440,2050,2140,4387000,2,3526,883,1,49844800,49844800,1321,440,881,440,0,1,442,25489,0.025489
840,2050,2140,4387000,2,6726,1683,1,63252800,63252800,2521,840,1681,840,0,1,842,146636,0.146636
1240,2050,2140,4387000,2,9926,2483,1,76660800,76660800,3721,1240,2481,1240,0,1,1242,29167,0.029167
1640,2050,2140,4387000,2,13126,3283,1,90068800,90068800,4921,1640,3281,1640,0,1,1642,395997,0.395997
2040,2050,2140,4387000,2,16326,4083,1,103476800,103476800,6121,2040,4081,2040,0,1,2042,524408,0.524408
2440,2050,2140,4387000,2,19526,4883,1,116884800,116884800,7321,2440,4881,2440,0,1,2442,473648,0.473648
2840,2050,2140,4387000,2,22726,5683,1,130292800,130292800,8521,2840,5681,2840,0,1,2842,200479,0.200479
3240,2050,2140,4387000,2,25926,6483,1,143700800,143700800,9721,3240,6481,3240,0,1,3242,472951,0.472951
3640,2050,2140,4387000,2,29126,7283,1,157108800,157108800,10921,3640,7281,3640,0,1,3642,1043525,1.043525
4040,2050,2140,4387000,2,32326,8083,1,170516800,170516800,12121,4040,8081,4040,0,1,4042,76312,0.076312
4440,2050,2140,4387000,2,35526,8883,1,183924800,183924800,13321,4440,8881,4440,0,1,4442,1187463,1.187463
4840,2050,2140,4387000,2,38726,9683,1,197332800,197332800,14521,4840,9681,4840,0,1,4842,551186,0.551186
5240,2050,2140,4387000,2,41926,10483,1,210740800,210740800,15721,5240,10481,5240,0,1,5242,231721,0.231721
5640,2050,2140,4387000,2,45126,11283,1,224148800,224148800,16921,5640,11281,5640,0,1,5642,213239,0.213239
6040,2050,2140,4387000,2,48326,12083,1,237556800,237556800,18121,6040,12081,6040,0,1,6042,684632,0.684632
6440,2050,2140,4387000,2,51526,12883,1,250964800,250964800,19321,6440,12881,6440,0,1,6442,122373,0.122373
6840,2050,2140,4387000,2,54726,13683,1,264372800,264372800,20521,6840,13681,6840,0,1,6842,602035,0.602035
55,2805,1565,4389825,2,446,113,1,37041400,37041400,166,55,111,55,0,1,57,88156,0.088156
455,2805,1565,4389825,2,3646,913,1,51025400,51025400,1366,455,911,455,0,1,457,408137,0.408137
855,2805,1565,4389825,2,6846,1713,1,65009400,65009400,2566,855,1711,855,0,1,857,734275,0.734275
1255,2805,1565,4389825,2,10046,2513,1,78993400,78993400,3766,1255,2511,1255,0,1,1257,97699,0.097699
1655,2805,1565,4389825,2,13246,3313,1,92977400,92977400,4966,1655,3311,1655,0,1,1657,675034,0.675034
2055,2805,1565,4389825,2,16446,4113,1,106961400,106961400,6166,2055,4111,2055,0,1,2057,1200724,1.200724
2455,2805,1565,4389825,2,19646,4913,1,120945400,120945400,7366,2455,4911,2455,0,1,2457,1405945,1.405945
2855,2805,1565,4389825,2,22846,5713,1,134929400,134929400,8566,2855,5711,2855,0,1,2857,1525602,1.525602
3255,2805,1565,4389825,2,26046,6513,1,148913400,148913400,9766,3255,6511,3255,0,1,3257,2697035,2.697035
3655,2805,1565,4389825,2,29246,7313,1,162897400,162897400,10966,3655,7311,3655,0,1,3657,3025910,3.02591
4055,2805,1565,4389825,2,32446,8113,1,176881400,176881400,12166,4055,8111,4055,0,1,4057,2210026,2.210026
4455,2805,1565,4389825,2,35646,8913,1,190865400,190865400,13366,4455,8911,4455,0,1,4457,1407532,1.407532
4855,2805,1565,4389825,2,38846,9713,1,204849400,204849400,14566,4855,9711,4855,0,1,4857,239805,0.239805
5255,2805,1565,4389825,2,42046,10513,1,218833400,218833400,15766,5255,10511,5255,0,1,5257,1635744,1.635744
5655,2805,1565,4389825,2,45246,11313,1,232817400,232817400,16966,5655,11311,5655,0,1,5657,1072975,1.072975
6055,2805,1565,4389825,2,48446,12113,1,246801400,246801400,18166,6055,12111,6055,0,1,6057,752862,0.752862
6455,2805,1565,4389825,2,51646,12913,1,260785400,260785400,19366,6455,12911,6455,0,1,6457,5342811,5.342811
6855,2805,1565,4389825,2,54846,13713,1,274769400,274769400,20566,6855,13711,6855,0,1,6857,2742468,2.742468
55,1305,3365,4391325,2,446,113,1,37185400,37185400,166,55,111,55,0,1,57,89805,0.089805
455,1305,3365,4391325,2,3646,913,1,52129400,52129400,1366,455,911,455,0,1,457,419311,0.419311
855,1305,3365,4391325,2,6846,1713,1,67073400,67073400,2566,855,1711,855,0,1,857,211110,0.21111
1255,1305,3365,4391325,2,10046,2513,1,82017400,82017400,3766,1255,2511,1255,0,1,1257,195558,0.195558
1655,1305,3365,4391325,2,13246,3313,1,96961400,96961400,4966,1655,3311,1655,0,1,1657,395921,0.395921
2055,1305,3365,4391325,2,16446,4113,1,111905400,111905400,6166,2055,4111,2055,0,1,2057,1265868,1.265868
2455,1305,3365,4391325,2,19646,4913,1,126849400,126849400,7366,2455,4911,2455,0,1,2457,2122725,2.122725
2855,1305,3365,4391325,2,22846,5713,1,141793400,141793400,8566,2855,5711,2855,0,1,2857,84968,0.084968
3255,1305,3365,4391325,2,26046,6513,1,156737400,156737400,9766,3255,6511,3255,0,1,3257,2166386,2.166386
3655,1305,3365,4391325,2,29246,7313,1,171681400,171681400,10966,3655,7311,3655,0,1,3657,1676348,1.676348
4055,1305,3365,4391325,2,32446,8113,1,186625400,186625400,12166,4055,8111,4055,0,1,4057,1111946,1.111946
4455,1305,3365,4391325,2,35646,8913,1,201569400,201569400,13366,4455,8911,4455,0,1,4457,229830,0.22983
4855,1305,3365,4391325,2,38846,9713,1,216513400,216513400,14566,4855,9711,4855,0,1,4857,395383,0.395383
5255,1305,3365,4391325,2,42046,10513,1,231457400,231457400,15766,5255,10511,5255,0,1,5257,277296,0.277296
5655,1305,3365,4391325,2,45246,11313,1,246401400,246401400,16966,5655,11311,5655,0,1,5657,1474285,1.474285
6055,1305,3365,4391325,2,48446,12113,1,261345400,261345400,18166,6055,12111,6055,0,1,6057,338157,0.338157
6455,1305,3365,4391325,2,51646,12913,1,276289400,276289400,19366,6455,12911,6455,0,1,6457,15741,0.015741
6855,1305,3365,4391325,2,54846,13713,1,291233400,291233400,20566,6855,13711,6855,0,1,6857,1443644,1.443644
40,1800,2440,4392000,2,326,83,1,36492800,36492800,121,40,81,40,0,1,42,82404,0.082404
440,1800,2440,4392000,2,3526,883,1,50060800,50060800,1321,440,881,440,0,1,442,410249,0.410249
840,1800,2440,4392000,2,6726,1683,1,63628800,63628800,2521,840,1681,840,0,1,842,740404,0.740404
1240,1800,2440,4392000,2,9926,2483,1,77196800,77196800,3721,1240,2481,1240,0,1,1242,1073645,1.073645
1640,1800,2440,4392000,2,13126,3283,1,90764800,90764800,4921,1640,3281,1640,0,1,1642,662941,0.662941
2040,1800,2440,4392000,2,16326,4083,1,104332800,104332800,6121,2040,4081,2040,0,1,2042,1747289,1.747289
2440,1800,2440,4392000,2,19526,4883,1,117900800,117900800,7321,2440,4881,2440,0,1,2442,1538749,1.538749
2840,1800,2440,4392000,2,22726,5683,1,131468800,131468800,8521,2840,5681,2840,0,1,2842,1178799,1.178799
3240,1800,2440,4392000,2,25926,6483,1,145036800,145036800,9721,3240,6481,3240,0,1,3242,1754611,1.754611
3640,1800,2440,4392000,2,29126,7283,1,158604800,158604800,10921,3640,7281,3640,0,1,3642,72448,0.072448
4040,1800,2440,4392000,2,32326,8083,1,172172800,172172800,12121,4040,8081,4040,0,1,4042,3420757,3.420757
4440,1800,2440,4392000,2,35526,8883,1,185740800,185740800,13321,4440,8881,4440,0,1,4442,993921,0.993921
4840,1800,2440,4392000,2,38726,9683,1,199308800,199308800,14521,4840,9681,4840,0,1,4842,319302,0.319302
5240,1800,2440,4392000,2,41926,10483,1,212876800,212876800,15721,5240,10481,5240,0,1,5242,196242,0.196242
5640,1800,2440,4392000,2,45126,11283,1,226444800,226444800,16921,5640,11281,5640,0,1,5642,2195701,2.195701
6040,1800,2440,4392000,2,48326,12083,1,240012800,240012800,18121,6040,12081,6040,0,1,6042,1203886,1.203886
6440,1800,2440,4392000,2,51526,12883,1,253580800,253580800,19321,6440,12881,6440,0,1,6442,2057717,2.057717
6840,1800,2440,4392000,2,54726,13683,1,267148800,267148800,20521,6840,13681,6840,0,1,6842,1374423,1.374423
55,4555,965,4395575,2,446,113,1,37593400,37593400,166,55,111,55,0,1,57,90019,0.090019
455,4555,965,4395575,2,3646,913,1,55257400,55257400,1366,455,911,455,0,1,457,414726,0.414726
855,4555,965,4395575,2,6846,1713,1,72921400,72921400,2566,855,1711,855,0,1,857,256117,0.256117
1255,4555,965,4395575,2,10046,2513,1,90585400,90585400,3766,1255,2511,1255,0,1,1257,1084321,1.084321
1655,4555,965,4395575,2,13246,3313,1,108249400,108249400,4966,1655,3311,1655,0,1,1657,373734,0.373734
2055,4555,965,4395575,2,16446,4113,1,125913400,125913400,6166,2055,4111,2055,0,1,2057,1106325,1.106325
2455,4555,965,4395575,2,19646,4913,1,143577400,143577400,7366,2455,4911,2455,0,1,2457,2062663,2.062663
2855,4555,965,4395575,2,22846,5713,1,161241400,161241400,8566,2855,5711,2855,0,1,2857,1786354,1.786354
3255,4555,965,4395575,2,26046,6513,1,178905400,178905400,9766,3255,6511,3255,0,1,3257,397458,0.397458
3655,4555,965,4395575,2,29246,7313,1,196569400,196569400,10966,3655,7311,3655,0,1,3657,312050,0.31205
4055,4555,965,4395575,2,32446,8113,1,214233400,214233400,12166,4055,8111,4055,0,1,4057,3412666,3.412666
4455,4555,965,4395575,2,35646,8913,1,231897400,231897400,13366,4455,8911,4455,0,1,4457,3746237,3.746237
4855,4555,965,4395575,2,38846,9713,1,249561400,249561400,14566,4855,9711,4855,0,1,4857,803719,0.803719
5255,4555,965,4395575,2,42046,10513,1,267225400,267225400,15766,5255,10511,5255,0,1,5257,7045,0.007045
5655,4555,965,4395575,2,45246,11313,1,284889400,284889400,16966,5655,11311,5655,0,1,5657,631030,0.63103
6055,4555,965,4395575,2,48446,12113,1,302553400,302553400,18166,6055,12111,6055,0,1,6057,3528886,3.528886
6455,4555,965,4395575,2,51646,12913,1,320217400,320217400,19366,6455,12911,6455,0,1,6457,1660598,1.660598
6855,4555,965,4395575,2,54846,13713,1,337881400,337881400,20566,6855,13711,6855,0,1,6857,2311816,2.311816
55,805,5465,4399325,2,446,113,1,37953400,37953400,166,55,111,55,0,1,57,90755,0.090755
455,805,5465,4399325,2,3646,913,1,58017400,58017400,1366,455,911,455,0,1,457,414741,0.414741
855,805,5465,4399325,2,6846,1713,1,78081400,78081400,2566,855,1711,855,0,1,857,632661,0.632661
1255,805,5465,4399325,2,10046,2513,1,98145400,98145400,3766,1255,2511,1255,0,1,1257,1070538,1.070538
1655,805,5465,4399325,2,13246,3313,1,118209400,118209400,4966,1655,3311,1655,0,1,1657,97084,0.097084
2055,805,5465,4399325,2,16446,4113,1,138273400,138273400,6166,2055,4111,2055,0,1,2057,614261,0.614261
2455,805,5465,4399325,2,19646,4913,1,158337400,158337400,7366,2455,4911,2455,0,1,2457,1389156,1.389156
2855,805,5465,4399325,2,22846,5713,1,178401400,178401400,8566,2855,5711,2855,0,1,2857,368002,0.368002
3255,805,5465,4399325,2,26046,6513,1,198465400,198465400,9766,3255,6511,3255,0,1,3257,15733,0.015733
3655,805,5465,4399325,2,29246,7313,1,218529400,218529400,10966,3655,7311,3655,0,1,3657,2052186,2.052186
4055,805,5465,4399325,2,32446,8113,1,238593400,238593400,12166,4055,8111,4055,0,1,4057,212378,0.212378
4455,805,5465,4399325,2,35646,8913,1,258657400,258657400,13366,4455,8911,4455,0,1,4457,646373,0.646373
4855,805,5465,4399325,2,38846,9713,1,278721400,278721400,14566,4855,9711,4855,0,1,4857,308381,0.308381
5255,805,5465,4399325,2,42046,10513,1,298785400,298785400,15766,5255,10511,5255,0,1,5257,757889,0.757889
5655,805,5465,4399325,2,45246,11313,1,318849400,318849400,16966,5655,11311,5655,0,1,5657,728611,0.728611
6055,805,5465,4399325,2,48446,12113,1,338913400,338913400,18166,6055,12111,6055,0,1,6057,1039325,1.039325
6455,805,5465,4399325,2,51646,12913,1,358977400,358977400,19366,6455,12911,6455,0,1,6457,3738363,3.738363
6855,805,5465,4399325,2,54846,13713,1,379041400,379041400,20566,6855,13711,6855,0,1,6857,1037157,1.037157
40,3550,1240,4402000,2,326,83,1,36748800,36748800,121,40,81,40,0,1,42,82869,0.082869
440,3550,1240,4402000,2,3526,883,1,52076800,52076800,1321,440,881,440,0,1,442,403386,0.403386
840,3550,1240,4402000,2,6726,1683,1,67404800,67404800,2521,840,1681,840,0,1,842,738730,0.73873
1240,3550,1240,4402000,2,9926,2483,1,82732800,82732800,3721,1240,2481,1240,0,1,1242,1073491,1.073491
1640,3550,1240,4402000,2,13126,3283,1,98060800,98060800,4921,1640,3281,1640,0,1,1642,1414802,1.414802
2040,3550,1240,4402000,2,16326,4083,1,113388800,113388800,6121,2040,4081,2040,0,1,2042,1731308,1.731308
2440,3550,1240,4402000,2,19526,4883,1,128716800,128716800,7321,2440,4881,2440,0,1,2442,1472813,1.472813
2840,3550,1240,4402000,2,22726,5683,1,144044800,144044800,8521,2840,5681,2840,0,1,2842,2218720,2.21872
3240,3550,1240,4402000,2,25926,6483,1,159372800,159372800,9721,3240,6481,3240,0,1,3242,2276100,2.2761
3640,3550,1240,4402000,2,29126,7283,1,174700800,174700800,10921,3640,7281,3640,0,1,3642,3087092,3.087092
4040,3550,1240,4402000,2,32326,8083,1,190028800,190028800,12121,4040,8081,4040,0,1,4042,925115,0.925115
4440,3550,1240,4402000,2,35526,8883,1,205356800,205356800,13321,4440,8881,4440,0,1,4442,648329,0.648329
4840,3550,1240,4402000,2,38726,9683,1,220684800,220684800,14521,4840,9681,4840,0,1,4842,2321894,2.321894
5240,3550,1240,4402000,2,41926,10483,1,236012800,236012800,15721,5240,10481,5240,0,1,5242,2246306,2.246306
5640,3550,1240,4402000,2,45126,11283,1,251340800,251340800,16921,5640,11281,5640,0,1,5642,2349374,2.349374
6040,3550,1240,4402000,2,48326,12083,1,266668800,266668800,18121,6040,12081,6040,0,1,6042,4144419,4.144419
6440,3550,1240,4402000,2,51526,12883,1,281996800,281996800,19321,6440,12881,6440,0,1,6442,729477,0.729477
6840,3550,1240,4402000,2,54726,13683,1,297324800,297324800,20521,6840,13681,6840,0,1,6842,1338940,1.33894
55,2055,2165,4449075,2,446,113,1,37449400,37449400,166,55,111,55,0,1,57,9673,0.009673
455,2055,2165,4449075,2,3646,913,1,50953400,50953400,1366,455,911,455,0,1,457,4435,0.004435
855,2055,2165,4449075,2,6846,1713,1,64457400,64457400,2566,855,1711,855,0,1,857,20735,0.020735
1255,2055,2165,4449075,2,10046,2513,1,77961400,77961400,3766,1255,2511,1255,0,1,1257,136488,0.136488
1655,2055,2165,4449075,2,13246,3313,1,91465400,91465400,4966,1655,3311,1655,0,1,1657,18790,0.01879
2055,2055,2165,4449075,2,16446,4113,1,104969400,104969400,6166,2055,4111,2055,0,1,2057,200195,0.200195
2455,2055,2165,4449075,2,19646,4913,1,118473400,118473400,7366,2455,4911,2455,0,1,2457,267024,0.267024
2855,2055,2165,4449075,2,22846,5713,1,131977400,131977400,8566,2855,5711,2855,0,1,2857,92147,0.092147
3255,2055,2165,4449075,2,26046,6513,1,145481400,145481400,9766,3255,6511,3255,0,1,3257,196320,0.19632
3655,2055,2165,4449075,2,29246,7313,1,158985400,158985400,10966,3655,7311,3655,0,1,3657,582773,0.582773
4055,2055,2165,4449075,2,32446,8113,1,172489400,172489400,12166,4055,8111,4055,0,1,4057,1539461,1.539461
4455,2055,2165,4449075,2,35646,8913,1,185993400,185993400,13366,4455,8911,4455,0,1,4457,74015,0.074015
4855,2055,2165,4449075,2,38846,9713,1,199497400,199497400,14566,4855,9711,4855,0,1,4857,270379,0.270379
5255,2055,2165,4449075,2,42046,10513,1,213001400,213001400,15766,5255,10511,5255,0,1,5257,221156,0.221156
5655,2055,2165,4449075,2,45246,11313,1,226505400,226505400,16966,5655,11311,5655,0,1,5657,1021269,1.021269
6055,2055,2165,4449075,2,48446,12113,1,240009400,240009400,18166,6055,12111,6055,0,1,6057,33470,0.03347
6455,2055,2165,4449075,2,51646,12913,1,253513400,253513400,19366,6455,12911,6455,0,1,6457,217178,0.217178
6855,2055,2165,4449075,2,54846,13713,1,267017400,267017400,20566,6855,13711,6855,0,1,6857,4608932,4.608932
55,1805,2465,4449325,2,446,113,1,37473400,37473400,166,55,111,55,0,1,57,94670,0.09467
455,1805,2465,4449325,2,3646,913,1,51137400,51137400,1366,455,911,455,0,1,457,235966,0.235966
855,1805,2465,4449325,2,6846,1713,1,64801400,64801400,2566,855,1711,855,0,1,857,160669,0.160669
1255,1805,2465,4449325,2,10046,2513,1,78465400,78465400,3766,1255,2511,1255,0,1,1257,1118719,1.118719
1655,1805,2465,4449325,2,13246,3313,1,92129400,92129400,4966,1655,3311,1655,0,1,1657,1350842,1.350842
2055,1805,2465,4449325,2,16446,4113,1,105793400,105793400,6166,2055,4111,2055,0,1,2057,1535822,1.535822
2455,1805,2465,4449325,2,19646,4913,1,119457400,119457400,7366,2455,4911,2455,0,1,2457,2149862,2.149862
2855,1805,2465,4449325,2,22846,5713,1,133121400,133121400,8566,2855,5711,2855,0,1,2857,378136,0.378136
3255,1805,2465,4449325,2,26046,6513,1,146785400,146785400,9766,3255,6511,3255,0,1,3257,964368,0.964368
3655,1805,2465,4449325,2,29246,7313,1,160449400,160449400,10966,3655,7311,3655,0,1,3657,825804,0.825804
4055,1805,2465,4449325,2,32446,8113,1,174113400,174113400,12166,4055,8111,4055,0,1,4057,408293,0.408293
4455,1805,2465,4449325,2,35646,8913,1,187777400,187777400,13366,4455,8911,4455,0,1,4457,2318826,2.318826
4855,1805,2465,4449325,2,38846,9713,1,201441400,201441400,14566,4855,9711,4855,0,1,4857,565164,0.565164
5255,1805,2465,4449325,2,42046,10513,1,215105400,215105400,15766,5255,10511,5255,0,1,5257,1583055,1.583055
5655,1805,2465,4449325,2,45246,11313,1,228769400,228769400,16966,5655,11311,5655,0,1,5657,673977,0.673977
6055,1805,2465,4449325,2,48446,12113,1,242433400,242433400,18166,6055,12111,6055,0,1,6057,293313,0.293313
6455,1805,2465,4449325,2,51646,12913,1,256097400,256097400,19366,6455,12911,6455,0,1,6457,1415050,1.41505
6855,1805,2465,4449325,2,54846,13713,1,269761400,269761400,20566,6855,13711,6855,0,1,6857,2782657,2.782657
40,1050,4240,4452000,2,326,83,1,37308800,37308800,121,40,81,40,0,1,42,11830,0.01183
440,1050,4240,4452000,2,3526,883,1,54236800,54236800,1321,440,881,440,0,1,442,490,0.00049
840,1050,4240,4452000,2,6726,1683,1,71164800,71164800,2521,840,1681,840,0,1,842,23298,0.023298
1240,1050,4240,4452000,2,9926,2483,1,88092800,88092800,3721,1240,2481,1240,0,1,1242,100892,0.100892
1640,1050,4240,4452000,2,13126,3283,1,105020800,105020800,4921,1640,3281,1640,0,1,1642,282704,0.282704
2040,1050,4240,4452000,2,16326,4083,1,121948800,121948800,6121,2040,4081,2040,0,1,2042,296869,0.296869
2440,1050,4240,4452000,2,19526,4883,1,138876800,138876800,7321,2440,4881,2440,0,1,2442,21255,0.021255
2840,1050,4240,4452000,2,22726,5683,1,155804800,155804800,8521,2840,5681,2840,0,1,2842,140081,0.140081
3240,1050,4240,4452000,2,25926,6483,1,172732800,172732800,9721,3240,6481,3240,0,1,3242,594060,0.59406
3640,1050,4240,4452000,2,29126,7283,1,189660800,189660800,10921,3640,7281,3640,0,1,3642,405217,0.405217
4040,1050,4240,4452000,2,32326,8083,1,206588800,206588800,12121,4040,8081,4040,0,1,4042,26203,0.026203
4440,1050,4240,4452000,2,35526,8883,1,223516800,223516800,13321,4440,8881,4440,0,1,4442,310991,0.310991
4840,1050,4240,4452000,2,38726,9683,1,240444800,240444800,14521,4840,9681,4840,0,1,4842,42421,0.042421
5240,1050,4240,4452000,2,41926,10483,1,257372800,257372800,15721,5240,10481,5240,0,1,5242,198130,0.19813
5640,1050,4240,4452000,2,45126,11283,1,274300800,274300800,16921,5640,11281,5640,0,1,5642,1977183,1.977183
6040,1050,4240,4452000,2,48326,12083,1,291228800,291228800,18121,6040,12081,6040,0,1,6042,347713,0.347713
6440,1050,4240,4452000,2,51526,12883,1,308156800,308156800,19321,6440,12881,6440,0,1,6442,509082,0.509082
6840,1050,4240,4452000,2,54726,13683,1,325084800,325084800,20521,6840,13681,6840,0,1,6842,1209768,1.209768
55,3555,1265,4497075,2,446,113,1,38097400,38097400,166,55,111,55,0,1,57,91267,0.091267
455,3555,1265,4497075,2,3646,913,1,53521400,53521400,1366,455,911,455,0,1,457,433815,0.433815
855,3555,1265,4497075,2,6846,1713,1,68945400,68945400,2566,855,1711,855,0,1,857,564684,0.564684
1255,3555,1265,4497075,2,10046,2513,1,84369400,84369400,3766,1255,2511,1255,0,1,1257,889872,0.889872
1655,3555,1265,4497075,2,13246,3313,1,99793400,99793400,4966,1655,3311,1655,0,1,1657,1473727,1.473727
2055,3555,1265,4497075,2,16446,4113,1,115217400,115217400,6166,2055,4111,2055,0,1,2057,1828918,1.828918
2455,3555,1265,4497075,2,19646,4913,1,130641400,130641400,7366,2455,4911,2455,0,1,2457,143925,0.143925
2855,3555,1265,4497075,2,22846,5713,1,146065400,146065400,8566,2855,5711,2855,0,1,2857,1035601,1.035601
3255,3555,1265,4497075,2,26046,6513,1,161489400,161489400,9766,3255,6511,3255,0,1,3257,8105,0.008105
3655,3555,1265,4497075,2,29246,7313,1,176913400,176913400,10966,3655,7311,3655,0,1,3657,3025891,3.025891
4055,3555,1265,4497075,2,32446,8113,1,192337400,192337400,12166,4055,8111,4055,0,1,4057,2494943,2.494943
4455,3555,1265,4497075,2,35646,8913,1,207761400,207761400,13366,4455,8911,4455,0,1,4457,1175020,1.17502
4855,3555,1265,4497075,2,38846,9713,1,223185400,223185400,14566,4855,9711,4855,0,1,4857,2532126,2.532126
5255,3555,1265,4497075,2,42046,10513,1,238609400,238609400,15766,5255,10511,5255,0,1,5257,574729,0.574729
5655,3555,1265,4497075,2,45246,11313,1,254033400,254033400,16966,5655,11311,5655,0,1,5657,401970,0.40197
6055,3555,1265,4497075,2,48446,12113,1,269457400,269457400,18166,6055,12111,6055,0,1,6057,1219883,1.219883
6455,3555,1265,4497075,2,51646,12913,1,284881400,284881400,19366,6455,12911,6455,0,1,6457,655700,0.6557
6855,3555,1265,4497075,2,54846,13713,1,300305400,300305400,20566,6855,13711,6855,0,1,6857,364451,0.364451
55,1055,4265,4499575,2,446,113,1,38337400,38337400,166,55,111,55,0,1,57,6770,0.00677
455,1055,4265,4499575,2,3646,913,1,55361400,55361400,1366,455,911,455,0,1,457,150877,0.150877
855,1055,4265,4499575,2,6846,1713,1,72385400,72385400,2566,855,1711,855,0,1,857,190743,0.190743
1255,1055,4265,4499575,2,10046,2513,1,89409400,89409400,3766,1255,2511,1255,0,1,1257,42534,0.042534
1655,1055,4265,4499575,2,13246,3313,1,106433400,106433400,4966,1655,3311,1655,0,1,1657,154056,0.154056
2055,1055,4265,4499575,2,16446,4113,1,123457400,123457400,6166,2055,4111,2055,0,1,2057,114655,0.114655
2455,1055,4265,4499575,2,19646,4913,1,140481400,140481400,7366,2455,4911,2455,0,1,2457,19172,0.019172
2855,1055,4265,4499575,2,22846,5713,1,157505400,157505400,8566,2855,5711,2855,0,1,2857,158305,0.158305
3255,1055,4265,4499575,2,26046,6513,1,174529400,174529400,9766,3255,6511,3255,0,1,3257,10359,0.010359
3655,1055,4265,4499575,2,29246,7313,1,191553400,191553400,10966,3655,7311,3655,0,1,3657,115736,0.115736
4055,1055,4265,4499575,2,32446,8113,1,208577400,208577400,12166,4055,8111,4055,0,1,4057,242164,0.242164
4455,1055,4265,4499575,2,35646,8913,1,225601400,225601400,13366,4455,8911,4455,0,1,4457,333683,0.333683
4855,1055,4265,4499575,2,38846,9713,1,242625400,242625400,14566,4855,9711,4855,0,1,4857,194664,0.194664
5255,1055,4265,4499575,2,42046,10513,1,259649400,259649400,15766,5255,10511,5255,0,1,5257,604810,0.60481
5655,1055,4265,4499575,2,45246,11313,1,276673400,276673400,16966,5655,11311,5655,0,1,5657,910951,0.910951
6055,1055,4265,4499575,2,48446,12113,1,293697400,293697400,18166,6055,12111,6055,0,1,6057,1628521,1.628521
6455,1055,4265,4499575,2,51646,12913,1,310721400,310721400,19366,6455,12911,6455,0,1,6457,673753,0.673753
6855,1055,4265,4499575,2,54846,13713,1,327745400,327745400,20566,6855,13711,6855,0,1,6857,267804,0.267804
40,4800,940,4512000,2,326,83,1,37932800,37932800,121,40,81,40,0,1,42,82552,0.082552
440,4800,940,4512000,2,3526,883,1,56300800,56300800,1321,440,881,440,0,1,442,405756,0.405756
840,4800,940,4512000,2,6726,1683,1,74668800,74668800,2521,840,1681,840,0,1,842,118378,0.118378
1240,4800,940,4512000,2,9926,2483,1,93036800,93036800,3721,1240,2481,1240,0,1,1242,1077047,1.077047
1640,4800,940,4512000,2,13126,3283,1,111404800,111404800,4921,1640,3281,1640,0,1,1642,384925,0.384925
2040,4800,940,4512000,2,16326,4083,1,129772800,129772800,6121,2040,4081,2040,0,1,2042,1748391,1.748391
2440,4800,940,4512000,2,19526,4883,1,148140800,148140800,7321,2440,4881,2440,0,1,2442,1835249,1.835249
2840,4800,940,4512000,2,22726,5683,1,166508800,166508800,8521,2840,5681,2840,0,1,2842,2417905,2.417905
3240,4800,940,4512000,2,25926,6483,1,184876800,184876800,9721,3240,6481,3240,0,1,3242,787885,0.787885
40,7050,640,4512000,2,326,83,1,38556800,38556800,121,40,81,40,0,1,42,76137,0.076137
440,7050,640,4512000,2,3526,883,1,63164800,63164800,1321,440,881,440,0,1,442,403661,0.403661
3640,4800,940,4512000,2,29126,7283,1,203244800,203244800,10921,3640,7281,3640,0,1,3642,1545506,1.545506
840,7050,640,4512000,2,6726,1683,1,87772800,87772800,2521,840,1681,840,0,1,842,750312,0.750312
1240,7050,640,4512000,2,9926,2483,1,112380800,112380800,3721,1240,2481,1240,0,1,1242,1093064,1.093064
1640,7050,640,4512000,2,13126,3283,1,136988800,136988800,4921,1640,3281,1640,0,1,1642,873549,0.873549
4040,4800,940,4512000,2,32326,8083,1,221612800,221612800,12121,4040,8081,4040,0,1,4042,2700999,2.700999
2040,7050,640,4512000,2,16326,4083,1,161596800,161596800,6121,2040,4081,2040,0,1,2042,1781004,1.781004
4440,4800,940,4512000,2,35526,8883,1,239980800,239980800,13321,4440,8881,4440,0,1,4442,369916,0.369916
2440,7050,640,4512000,2,19526,4883,1,186204800,186204800,7321,2440,4881,2440,0,1,2442,2145403,2.145403
4840,4800,940,4512000,2,38726,9683,1,258348800,258348800,14521,4840,9681,4840,0,1,4842,4123460,4.12346
2840,7050,640,4512000,2,22726,5683,1,210812800,210812800,8521,2840,5681,2840,0,1,2842,2493265,2.493265
5240,4800,940,4512000,2,41926,10483,1,276716800,276716800,15721,5240,10481,5240,0,1,5242,4459260,4.45926
3240,7050,640,4512000,2,25926,6483,1,235420800,235420800,9721,3240,6481,3240,0,1,3242,355006,0.355006
5640,4800,940,4512000,2,45126,11283,1,295084800,295084800,16921,5640,11281,5640,0,1,5642,4796789,4.796789
3640,7050,640,4512000,2,29126,7283,1,260028800,260028800,10921,3640,7281,3640,0,1,3642,3164958,3.164958
6040,4800,940,4512000,2,48326,12083,1,313452800,313452800,18121,6040,12081,6040,0,1,6042,53320,0.05332
4040,7050,640,4512000,2,32326,8083,1,284636800,284636800,12121,4040,8081,4040,0,1,4042,2281986,2.281986
6440,4800,940,4512000,2,51526,12883,1,331820800,331820800,19321,6440,12881,6440,0,1,6442,5448593,5.448593
4440,7050,640,4512000,2,35526,8883,1,309244800,309244800,13321,4440,8881,4440,0,1,4442,568838,0.568838
6840,4800,940,4512000,2,54726,13683,1,350188800,350188800,20521,6840,13681,6840,0,1,6842,702137,0.702137
4840,7050,640,4512000,2,38726,9683,1,333852800,333852800,14521,4840,9681,4840,0,1,4842,220394,0.220394
5240,7050,640,4512000,2,41926,10483,1,358460800,358460800,15721,5240,10481,5240,0,1,5242,4568555,4.568555
5640,7050,640,4512000,2,45126,11283,1,383068800,383068800,16921,5640,11281,5640,0,1,5642,4912699,4.912699
6040,7050,640,4512000,2,48326,12083,1,407676800,407676800,18121,6040,12081,6040,0,1,6042,5263181,5.263181
6440,7050,640,4512000,2,51526,12883,1,432284800,432284800,19321,6440,12881,6440,0,1,6442,5634415,5.634415
6840,7050,640,4512000,2,54726,13683,1,456892800,456892800,20521,6840,13681,6840,0,1,6842,5994572,5.994572
55,6805,665,4525325,2,446,113,1,39489400,39489400,166,55,111,55,0,1,57,88688,0.088688
455,6805,665,4525325,2,3646,913,1,63393400,63393400,1366,455,911,455,0,1,457,431750,0.43175
855,6805,665,4525325,2,6846,1713,1,87297400,87297400,2566,855,1711,855,0,1,857,793506,0.793506
1255,6805,665,4525325,2,10046,2513,1,111201400,111201400,3766,1255,2511,1255,0,1,1257,366613,0.366613
1655,6805,665,4525325,2,13246,3313,1,135105400,135105400,4966,1655,3311,1655,0,1,1657,37927,0.037927
2055,6805,665,4525325,2,16446,4113,1,159009400,159009400,6166,2055,4111,2055,0,1,2057,1859181,1.859181
2455,6805,665,4525325,2,19646,4913,1,182913400,182913400,7366,2455,4911,2455,0,1,2457,2212006,2.212006
2855,6805,665,4525325,2,22846,5713,1,206817400,206817400,8566,2855,5711,2855,0,1,2857,2568816,2.568816
3255,6805,665,4525325,2,26046,6513,1,230721400,230721400,9766,3255,6511,3255,0,1,3257,439804,0.439804
3655,6805,665,4525325,2,29246,7313,1,254625400,254625400,10966,3655,7311,3655,0,1,3657,700250,0.70025
4055,6805,665,4525325,2,32446,8113,1,278529400,278529400,12166,4055,8111,4055,0,1,4057,1243342,1.243342
4455,6805,665,4525325,2,35646,8913,1,302433400,302433400,13366,4455,8911,4455,0,1,4457,2967766,2.967766
4855,6805,665,4525325,2,38846,9713,1,326337400,326337400,14566,4855,9711,4855,0,1,4857,4382999,4.382999
5255,6805,665,4525325,2,42046,10513,1,350241400,350241400,15766,5255,10511,5255,0,1,5257,4718718,4.718718
5655,6805,665,4525325,2,45246,11313,1,374145400,374145400,16966,5655,11311,5655,0,1,5657,599604,0.599604
6055,6805,665,4525325,2,48446,12113,1,398049400,398049400,18166,6055,12111,6055,0,1,6057,5430765,5.430765
6455,6805,665,4525325,2,51646,12913,1,421953400,421953400,19366,6455,12911,6455,0,1,6457,1312967,1.312967
6855,6805,665,4525325,2,54846,13713,1,445857400,445857400,20566,6855,13711,6855,0,1,6857,633652,0.633652
39,2243,2041,4577963,2,318,81,1,37960312,37960312,118,39,79,39,0,1,41,12972,0.012972
539,2243,2041,4577963,2,4318,1081,1,55096312,55096312,1618,539,1079,539,0,1,541,4317,0.004317
1039,2243,2041,4577963,2,8318,2081,1,72232312,72232312,3118,1039,2079,1039,0,1,1041,14210,0.01421
1539,2243,2041,4577963,2,12318,3081,1,89368312,89368312,4618,1539,3079,1539,0,1,1541,89996,0.089996
2039,2243,2041,4577963,2,16318,4081,1,106504312,106504312,6118,2039,4079,2039,0,1,2041,353076,0.353076
2539,2243,2041,4577963,2,20318,5081,1,123640312,123640312,7618,2539,5079,2539,0,1,2541,21039,0.021039
3039,2243,2041,4577963,2,24318,6081,1,140776312,140776312,9118,3039,6079,3039,0,1,3041,38394,0.038394
3539,2243,2041,4577963,2,28318,7081,1,157912312,157912312,10618,3539,7079,3539,0,1,3541,1536696,1.536696
4039,2243,2041,4577963,2,32318,8081,1,175048312,175048312,12118,4039,8079,4039,0,1,4041,206078,0.206078
4539,2243,2041,4577963,2,36318,9081,1,192184312,192184312,13618,4539,9079,4539,0,1,4541,734878,0.734878
5039,2243,2041,4577963,2,40318,10081,1,209320312,209320312,15118,5039,10079,5039,0,1,5041,2986187,2.986187
5539,2243,2041,4577963,2,44318,11081,1,226456312,226456312,16618,5539,11079,5539,0,1,5541,720993,0.720993
6039,2243,2041,4577963,2,48318,12081,1,243592312,243592312,18118,6039,12079,6039,0,1,6041,2269291,2.269291
6539,2243,2041,4577963,2,52318,13081,1,260728312,260728312,19618,6539,13079,6539,0,1,6541,240894,0.240894
7039,2243,2041,4577963,2,56318,14081,1,277864312,277864312,21118,7039,14079,7039,0,1,7041,259139,0.259139
35,2240,2045,4580800,2,286,73,1,37846200,37846200,106,35,71,35,0,1,37,92682,0.092682
535,2240,2045,4580800,2,4286,1073,1,54986200,54986200,1606,535,1071,535,0,1,537,492243,0.492243
1035,2240,2045,4580800,2,8286,2073,1,72126200,72126200,3106,1035,2071,1035,0,1,1037,934424,0.934424
1535,2240,2045,4580800,2,12286,3073,1,89266200,89266200,4606,1535,3071,1535,0,1,1537,1351155,1.351155
2035,2240,2045,4580800,2,16286,4073,1,106406200,106406200,6106,2035,4071,2035,0,1,2037,1793444,1.793444
2535,2240,2045,4580800,2,20286,5073,1,123546200,123546200,7606,2535,5071,2535,0,1,2537,2213534,2.213534
40,800,5740,4592000,2,326,83,1,38828800,38828800,121,40,81,40,0,1,42,83035,0.083035
440,800,5740,4592000,2,3526,883,1,59756800,59756800,1321,440,881,440,0,1,442,94813,0.094813
840,800,5740,4592000,2,6726,1683,1,80684800,80684800,2521,840,1681,840,0,1,842,262239,0.262239
1240,800,5740,4592000,2,9926,2483,1,101612800,101612800,3721,1240,2481,1240,0,1,1242,112676,0.112676
1640,800,5740,4592000,2,13126,3283,1,122540800,122540800,4921,1640,3281,1640,0,1,1642,980211,0.980211
2040,800,5740,4592000,2,16326,4083,1,143468800,143468800,6121,2040,4081,2040,0,1,2042,394288,0.394288
2440,800,5740,4592000,2,19526,4883,1,164396800,164396800,7321,2440,4881,2440,0,1,2442,1279435,1.279435
2840,800,5740,4592000,2,22726,5683,1,185324800,185324800,8521,2840,5681,2840,0,1,2842,809986,0.809986
3240,800,5740,4592000,2,25926,6483,1,206252800,206252800,9721,3240,6481,3240,0,1,3242,156954,0.156954
3640,800,5740,4592000,2,29126,7283,1,227180800,227180800,10921,3640,7281,3640,0,1,3642,1397667,1.397667
4040,800,5740,4592000,2,32326,8083,1,248108800,248108800,12121,4040,8081,4040,0,1,4042,149769,0.149769
4440,800,5740,4592000,2,35526,8883,1,269036800,269036800,13321,4440,8881,4440,0,1,4442,325684,0.325684
4840,800,5740,4592000,2,38726,9683,1,289964800,289964800,14521,4840,9681,4840,0,1,4842,999494,0.999494
5240,800,5740,4592000,2,41926,10483,1,310892800,310892800,15721,5240,10481,5240,0,1,5242,150846,0.150846
5640,800,5740,4592000,2,45126,11283,1,331820800,331820800,16921,5640,11281,5640,0,1,5642,93270,0.09327
6040,800,5740,4592000,2,48326,12083,1,352748800,352748800,18121,6040,12081,6040,0,1,6042,1520047,1.520047
6440,800,5740,4592000,2,51526,12883,1,373676800,373676800,19321,6440,12881,6440,0,1,6442,118318,0.118318
6840,800,5740,4592000,2,54726,13683,1,394604800,394604800,20521,6840,13681,6840,0,1,6842,570539,0.570539
35,4400,1045,4598000,2,286,73,1,38308600,38308600,106,35,71,35,0,1,37,77874,0.077874
535,4400,1045,4598000,2,4286,1073,1,60088600,60088600,1606,535,1071,535,0,1,537,13480,0.01348
1035,4400,1045,4598000,2,8286,2073,1,81868600,81868600,3106,1035,2071,1035,0,1,1037,805441,0.805441
1535,4400,1045,4598000,2,12286,3073,1,103648600,103648600,4606,1535,3071,1535,0,1,1537,1381048,1.381048
2035,4400,1045,4598000,2,16286,4073,1,125428600,125428600,6106,2035,4071,2035,0,1,2037,456043,0.456043
2535,4400,1045,4598000,2,20286,5073,1,147208600,147208600,7606,2535,5071,2535,0,1,2537,1228899,1.228899
3035,4400,1045,4598000,2,24286,6073,1,168988600,168988600,9106,3035,6071,3035,0,1,3037,65617,0.065617
3535,4400,1045,4598000,2,28286,7073,1,190768600,190768600,10606,3535,7071,3535,0,1,3537,2332160,2.33216
4035,4400,1045,4598000,2,32286,8073,1,212548600,212548600,12106,4035,8071,4035,0,1,4037,3568569,3.568569
4535,4400,1045,4598000,2,36286,9073,1,234328600,234328600,13606,4535,9071,4535,0,1,4537,1197968,1.197968
5035,4400,1045,4598000,2,40286,10073,1,256108600,256108600,15106,5035,10071,5035,0,1,5037,4474522,4.474522
5535,4400,1045,4598000,2,44286,11073,1,277888600,277888600,16606,5535,11071,5535,0,1,5537,3800146,3.800146
6035,4400,1045,4598000,2,48286,12073,1,299668600,299668600,18106,6035,12071,6035,0,1,6037,1839577,1.839577
6535,4400,1045,4598000,2,52286,13073,1,321448600,321448600,19606,6535,13071,6535,0,1,6537,5811682,5.811682
7035,4400,1045,4598000,2,56286,14073,1,343228600,343228600,21106,7035,14071,7035,0,1,7037,6252515,6.252515
35,1140,4045,4611300,2,286,73,1,38342200,38342200,106,35,71,35,0,1,37,92119,0.092119
535,1140,4045,4611300,2,4286,1073,1,59082200,59082200,1606,535,1071,535,0,1,537,499627,0.499627
1035,1140,4045,4611300,2,8286,2073,1,79822200,79822200,3106,1035,2071,1035,0,1,1037,923082,0.923082
1535,1140,4045,4611300,2,12286,3073,1,100562200,100562200,4606,1535,3071,1535,0,1,1537,1368499,1.368499
2035,1140,4045,4611300,2,16286,4073,1,121302200,121302200,6106,2035,4071,2035,0,1,2037,1796547,1.796547
2535,1140,4045,4611300,2,20286,5073,1,142042200,142042200,7606,2535,5071,2535,0,1,2537,2234141,2.234141
3035,1140,4045,4611300,2,24286,6073,1,162782200,162782200,9106,3035,6071,3035,0,1,3037,2667640,2.66764
3535,1140,4045,4611300,2,28286,7073,1,183522200,183522200,10606,3535,7071,3535,0,1,3537,3109916,3.109916
4035,1140,4045,4611300,2,32286,8073,1,204262200,204262200,12106,4035,8071,4035,0,1,4037,3538934,3.538934
39,1143,4041,4618863,2,318,81,1,38568312,38568312,118,39,79,39,0,1,41,20199,0.020199
539,1143,4041,4618863,2,4318,1081,1,59304312,59304312,1618,539,1079,539,0,1,541,29259,0.029259
1039,1143,4041,4618863,2,8318,2081,1,80040312,80040312,3118,1039,2079,1039,0,1,1041,18377,0.018377
1539,1143,4041,4618863,2,12318,3081,1,100776312,100776312,4618,1539,3079,1539,0,1,1541,44720,0.04472
2039,1143,4041,4618863,2,16318,4081,1,121512312,121512312,6118,2039,4079,2039,0,1,2041,104861,0.104861
2539,1143,4041,4618863,2,20318,5081,1,142248312,142248312,7618,2539,5079,2539,0,1,2541,186454,0.186454
3039,1143,4041,4618863,2,24318,6081,1,162984312,162984312,9118,3039,6079,3039,0,1,3041,645491,0.645491
3539,1143,4041,4618863,2,28318,7081,1,183720312,183720312,10618,3539,7079,3539,0,1,3541,59465,0.059465
4039,1143,4041,4618863,2,32318,8081,1,204456312,204456312,12118,4039,8079,4039,0,1,4041,201543,0.201543
4539,1143,4041,4618863,2,36318,9081,1,225192312,225192312,13618,4539,9079,4539,0,1,4541,505537,0.505537
5039,1143,4041,4618863,2,40318,10081,1,245928312,245928312,15118,5039,10079,5039,0,1,5041,23665,0.023665
5539,1143,4041,4618863,2,44318,11081,1,266664312,266664312,16618,5539,11079,5539,0,1,5541,1231835,1.231835
6039,1143,4041,4618863,2,48318,12081,1,287400312,287400312,18118,6039,12079,6039,0,1,6041,2828766,2.828766
6539,1143,4041,4618863,2,52318,13081,1,308136312,308136312,19618,6539,13079,6539,0,1,6541,648317,0.648317
7039,1143,4041,4618863,2,56318,14081,1,328872312,328872312,21118,7039,14079,7039,0,1,7041,21199,0.021199
39,4443,1041,4625163,2,318,81,1,38712312,38712312,118,39,79,39,0,1,41,10030,0.01003
539,4443,1041,4625163,2,4318,1081,1,60648312,60648312,1618,539,1079,539,0,1,541,5409,0.005409
1039,4443,1041,4625163,2,8318,2081,1,82584312,82584312,3118,1039,2079,1039,0,1,1041,58684,0.058684
1539,4443,1041,4625163,2,12318,3081,1,104520312,104520312,4618,1539,3079,1539,0,1,1541,71910,0.07191
2039,4443,1041,4625163,2,16318,4081,1,126456312,126456312,6118,2039,4079,2039,0,1,2041,289497,0.289497
2539,4443,1041,4625163,2,20318,5081,1,148392312,148392312,7618,2539,5079,2539,0,1,2541,879691,0.879691
3039,4443,1041,4625163,2,24318,6081,1,170328312,170328312,9118,3039,6079,3039,0,1,3041,1856489,1.856489
3539,4443,1041,4625163,2,28318,7081,1,192264312,192264312,10618,3539,7079,3539,0,1,3541,893144,0.893144
4039,4443,1041,4625163,2,32318,8081,1,214200312,214200312,12118,4039,8079,4039,0,1,4041,127260,0.12726
4539,4443,1041,4625163,2,36318,9081,1,236136312,236136312,13618,4539,9079,4539,0,1,4541,2961972,2.961972
5039,4443,1041,4625163,2,40318,10081,1,258072312,258072312,15118,5039,10079,5039,0,1,5041,2858667,2.858667
5539,4443,1041,4625163,2,44318,11081,1,280008312,280008312,16618,5539,11079,5539,0,1,5541,2523176,2.523176
6039,4443,1041,4625163,2,48318,12081,1,301944312,301944312,18118,6039,12079,6039,0,1,6041,2153207,2.153207
6539,4443,1041,4625163,2,52318,13081,1,323880312,323880312,19618,6539,13079,6539,0,1,6541,5798094,5.798094
7039,4443,1041,4625163,2,56318,14081,1,345816312,345816312,21118,7039,14079,7039,0,1,7041,6241565,6.241565
44,2253,2055,4629915,2,358,91,1,38555736,38555736,133,44,89,44,0,1,46,23791,0.023791
544,2253,2055,4629915,2,4358,1091,1,55787736,55787736,1633,544,1089,544,0,1,546,33935,0.033935
1044,2253,2055,4629915,2,8358,2091,1,73019736,73019736,3133,1044,2089,1044,0,1,1046,51850,0.05185
1544,2253,2055,4629915,2,12358,3091,1,90251736,90251736,4633,1544,3089,1544,0,1,1546,33479,0.033479
2044,2253,2055,4629915,2,16358,4091,1,107483736,107483736,6133,2044,4089,2044,0,1,2046,208609,0.208609
2544,2253,2055,4629915,2,20358,5091,1,124715736,124715736,7633,2544,5089,2544,0,1,2546,7378,0.007378
3044,2253,2055,4629915,2,24358,6091,1,141947736,141947736,9133,3044,6089,3044,0,1,3046,763910,0.76391
3544,2253,2055,4629915,2,28358,7091,1,159179736,159179736,10633,3544,7089,3544,0,1,3546,364955,0.364955
4044,2253,2055,4629915,2,32358,8091,1,176411736,176411736,12133,4044,8089,4044,0,1,4046,1537296,1.537296
4544,2253,2055,4629915,2,36358,9091,1,193643736,193643736,13633,4544,9089,4544,0,1,4546,2365957,2.365957
5044,2253,2055,4629915,2,40358,10091,1,210875736,210875736,15133,5044,10089,5044,0,1,5046,3646393,3.646393
5544,2253,2055,4629915,2,44358,11091,1,228107736,228107736,16633,5544,11089,5544,0,1,5546,73466,0.073466
6044,2253,2055,4629915,2,48358,12091,1,245339736,245339736,18133,6044,12089,6044,0,1,6046,259450,0.25945
6544,2253,2055,4629915,2,52358,13091,1,262571736,262571736,19633,6544,13089,6544,0,1,6546,261666,0.261666
7044,2253,2055,4629915,2,56358,14091,1,279803736,279803736,21133,7044,14089,7044,0,1,7046,69111,0.069111
55,4805,965,4636825,2,446,113,1,39633400,39633400,166,55,111,55,0,1,57,92494,0.092494
455,4805,965,4636825,2,3646,913,1,58097400,58097400,1366,455,911,455,0,1,457,428283,0.428283
855,4805,965,4636825,2,6846,1713,1,76561400,76561400,2566,855,1711,855,0,1,857,785004,0.785004
1255,4805,965,4636825,2,10046,2513,1,95025400,95025400,3766,1255,2511,1255,0,1,1257,971065,0.971065
1655,4805,965,4636825,2,13246,3313,1,113489400,113489400,4966,1655,3311,1655,0,1,1657,1477114,1.477114
2055,4805,965,4636825,2,16446,4113,1,131953400,131953400,6166,2055,4111,2055,0,1,2057,1822075,1.822075
2455,4805,965,4636825,2,19646,4913,1,150417400,150417400,7366,2455,4911,2455,0,1,2457,2176180,2.17618
2855,4805,965,4636825,2,22846,5713,1,168881400,168881400,8566,2855,5711,2855,0,1,2857,1097251,1.097251
3255,4805,965,4636825,2,26046,6513,1,187345400,187345400,9766,3255,6511,3255,0,1,3257,1328044,1.328044
3655,4805,965,4636825,2,29246,7313,1,205809400,205809400,10966,3655,7311,3655,0,1,3657,2772405,2.772405
4055,4805,965,4636825,2,32446,8113,1,224273400,224273400,12166,4055,8111,4055,0,1,4057,2491444,2.491444
4455,4805,965,4636825,2,35646,8913,1,242737400,242737400,13366,4455,8911,4455,0,1,4457,3944760,3.94476
4855,4805,965,4636825,2,38846,9713,1,261201400,261201400,14566,4855,9711,4855,0,1,4857,4334263,4.334263
5255,4805,965,4636825,2,42046,10513,1,279665400,279665400,15766,5255,10511,5255,0,1,5257,4637164,4.637164
5655,4805,965,4636825,2,45246,11313,1,298129400,298129400,16966,5655,11311,5655,0,1,5657,5012552,5.012552
6055,4805,965,4636825,2,48446,12113,1,316593400,316593400,18166,6055,12111,6055,0,1,6057,5376558,5.376558
6455,4805,965,4636825,2,51646,12913,1,335057400,335057400,19366,6455,12911,6455,0,1,6457,5665074,5.665074
6855,4805,965,4636825,2,54846,13713,1,353521400,353521400,20566,6855,13711,6855,0,1,6857,5132864,5.132864
35,4440,1045,4639800,2,286,73,1,38654200,38654200,106,35,71,35,0,1,37,107217,0.107217
535,4440,1045,4639800,2,4286,1073,1,60594200,60594200,1606,535,1071,535,0,1,537,501312,0.501312
1035,4440,1045,4639800,2,8286,2073,1,82534200,82534200,3106,1035,2071,1035,0,1,1037,947227,0.947227
1535,4440,1045,4639800,2,12286,3073,1,104474200,104474200,4606,1535,3071,1535,0,1,1537,1375812,1.375812
2035,4440,1045,4639800,2,16286,4073,1,126414200,126414200,6106,2035,4071,2035,0,1,2037,1827531,1.827531
55,805,5765,4640825,2,446,113,1,40017400,40017400,166,55,111,55,0,1,57,96354,0.096354
455,805,5765,4640825,2,3646,913,1,61041400,61041400,1366,455,911,455,0,1,457,382363,0.382363
855,805,5765,4640825,2,6846,1713,1,82065400,82065400,2566,855,1711,855,0,1,857,120418,0.120418
1255,805,5765,4640825,2,10046,2513,1,103089400,103089400,3766,1255,2511,1255,0,1,1257,1144046,1.144046
1655,805,5765,4640825,2,13246,3313,1,124113400,124113400,4966,1655,3311,1655,0,1,1657,1342236,1.342236
2055,805,5765,4640825,2,16446,4113,1,145137400,145137400,6166,2055,4111,2055,0,1,2057,1847209,1.847209
2455,805,5765,4640825,2,19646,4913,1,166161400,166161400,7366,2455,4911,2455,0,1,2457,1873556,1.873556
2855,805,5765,4640825,2,22846,5713,1,187185400,187185400,8566,2855,5711,2855,0,1,2857,742059,0.742059
3255,805,5765,4640825,2,26046,6513,1,208209400,208209400,9766,3255,6511,3255,0,1,3257,1030946,1.030946
3655,805,5765,4640825,2,29246,7313,1,229233400,229233400,10966,3655,7311,3655,0,1,3657,22332,0.022332
4055,805,5765,4640825,2,32446,8113,1,250257400,250257400,12166,4055,8111,4055,0,1,4057,527265,0.527265
4455,805,5765,4640825,2,35646,8913,1,271281400,271281400,13366,4455,8911,4455,0,1,4457,349313,0.349313
4855,805,5765,4640825,2,38846,9713,1,292305400,292305400,14566,4855,9711,4855,0,1,4857,215242,0.215242
5255,805,5765,4640825,2,42046,10513,1,313329400,313329400,15766,5255,10511,5255,0,1,5257,1676322,1.676322
5655,805,5765,4640825,2,45246,11313,1,334353400,334353400,16966,5655,11311,5655,0,1,5657,179931,0.179931
6055,805,5765,4640825,2,48446,12113,1,355377400,355377400,18166,6055,12111,6055,0,1,6057,1040749,1.040749
6455,805,5765,4640825,2,51646,12913,1,376401400,376401400,19366,6455,12911,6455,0,1,6457,753144,0.753144
6855,805,5765,4640825,2,54846,13713,1,397425400,397425400,20566,6855,13711,6855,0,1,6857,3195056,3.195056
44,1153,4055,4675415,2,358,91,1,39236536,39236536,133,44,89,44,0,1,46,44184,0.044184
544,1153,4055,4675415,2,4358,1091,1,60068536,60068536,1633,544,1089,544,0,1,546,32066,0.032066
1044,1153,4055,4675415,2,8358,2091,1,80900536,80900536,3133,1044,2089,1044,0,1,1046,98734,0.098734
1544,1153,4055,4675415,2,12358,3091,1,101732536,101732536,4633,1544,3089,1544,0,1,1546,481914,0.481914
2044,1153,4055,4675415,2,16358,4091,1,122564536,122564536,6133,2044,4089,2044,0,1,2046,17137,0.017137
2544,1153,4055,4675415,2,20358,5091,1,143396536,143396536,7633,2544,5089,2544,0,1,2546,132069,0.132069
3044,1153,4055,4675415,2,24358,6091,1,164228536,164228536,9133,3044,6089,3044,0,1,3046,68359,0.068359
3544,1153,4055,4675415,2,28358,7091,1,185060536,185060536,10633,3544,7089,3544,0,1,3546,314336,0.314336
4044,1153,4055,4675415,2,32358,8091,1,205892536,205892536,12133,4044,8089,4044,0,1,4046,1472065,1.472065
4544,1153,4055,4675415,2,36358,9091,1,226724536,226724536,13633,4544,9089,4544,0,1,4546,275647,0.275647
5044,1153,4055,4675415,2,40358,10091,1,247556536,247556536,15133,5044,10089,5044,0,1,5046,310509,0.310509
5544,1153,4055,4675415,2,44358,11091,1,268388536,268388536,16633,5544,11089,5544,0,1,5546,453512,0.453512
6044,1153,4055,4675415,2,48358,12091,1,289220536,289220536,18133,6044,12089,6044,0,1,6046,68541,0.068541
6544,1153,4055,4675415,2,52358,13091,1,310052536,310052536,19633,6544,13089,6544,0,1,6546,623363,0.623363
7044,1153,4055,4675415,2,56358,14091,1,330884536,330884536,21133,7044,14089,7044,0,1,7046,1101561,1.101561
55,7055,665,4691575,2,446,113,1,40929400,40929400,166,55,111,55,0,1,57,92531,0.092531
455,7055,665,4691575,2,3646,913,1,65633400,65633400,1366,455,911,455,0,1,457,446398,0.446398
855,7055,665,4691575,2,6846,1713,1,90337400,90337400,2566,855,1711,855,0,1,857,818393,0.818393
1255,7055,665,4691575,2,10046,2513,1,115041400,115041400,3766,1255,2511,1255,0,1,1257,1192511,1.192511
1655,7055,665,4691575,2,13246,3313,1,139745400,139745400,4966,1655,3311,1655,0,1,1657,1554129,1.554129
2055,7055,665,4691575,2,16446,4113,1,164449400,164449400,6166,2055,4111,2055,0,1,2057,1920782,1.920782
2455,7055,665,4691575,2,19646,4913,1,189153400,189153400,7366,2455,4911,2455,0,1,2457,2297176,2.297176
2855,7055,665,4691575,2,22846,5713,1,213857400,213857400,8566,2855,5711,2855,0,1,2857,2664645,2.664645
3255,7055,665,4691575,2,26046,6513,1,238561400,238561400,9766,3255,6511,3255,0,1,3257,2045481,2.045481
3655,7055,665,4691575,2,29246,7313,1,263265400,263265400,10966,3655,7311,3655,0,1,3657,3430637,3.430637
4055,7055,665,4691575,2,32446,8113,1,287969400,287969400,12166,4055,8111,4055,0,1,4057,27421,0.027421
4455,7055,665,4691575,2,35646,8913,1,312673400,312673400,13366,4455,8911,4455,0,1,4457,915879,0.915879
4855,7055,665,4691575,2,38846,9713,1,337377400,337377400,14566,4855,9711,4855,0,1,4857,4553940,4.55394
5255,7055,665,4691575,2,42046,10513,1,362081400,362081400,15766,5255,10511,5255,0,1,5257,4884497,4.884497
5655,7055,665,4691575,2,45246,11313,1,386785400,386785400,16966,5655,11311,5655,0,1,5657,5315285,5.315285
6055,7055,665,4691575,2,48446,12113,1,411489400,411489400,18166,6055,12111,6055,0,1,6057,5639841,5.639841
6455,7055,665,4691575,2,51646,12913,1,436193400,436193400,19366,6455,12911,6455,0,1,6457,6031552,6.031552
6855,7055,665,4691575,2,54846,13713,1,460897400,460897400,20566,6855,13711,6855,0,1,6857,6401803,6.401803
40,2550,1840,4692000,2,326,83,1,38940800,38940800,121,40,81,40,0,1,42,86227,0.086227
440,2550,1840,4692000,2,3526,883,1,52988800,52988800,1321,440,881,440,0,1,442,414716,0.414716
840,2550,1840,4692000,2,6726,1683,1,67036800,67036800,2521,840,1681,840,0,1,842,190852,0.190852
1240,2550,1840,4692000,2,9926,2483,1,81084800,81084800,3721,1240,2481,1240,0,1,1242,213095,0.213095
1640,2550,1840,4692000,2,13126,3283,1,95132800,95132800,4921,1640,3281,1640,0,1,1642,1440553,1.440553
2040,2550,1840,4692000,2,16326,4083,1,109180800,109180800,6121,2040,4081,2040,0,1,2042,1785868,1.785868
2440,2550,1840,4692000,2,19526,4883,1,123228800,123228800,7321,2440,4881,2440,0,1,2442,496259,0.496259
2840,2550,1840,4692000,2,22726,5683,1,137276800,137276800,8521,2840,5681,2840,0,1,2842,2467522,2.467522
3240,2550,1840,4692000,2,25926,6483,1,151324800,151324800,9721,3240,6481,3240,0,1,3242,866512,0.866512
3640,2550,1840,4692000,2,29126,7283,1,165372800,165372800,10921,3640,7281,3640,0,1,3642,3156041,3.156041
4040,2550,1840,4692000,2,32326,8083,1,179420800,179420800,12121,4040,8081,4040,0,1,4042,2207099,2.207099
4440,2550,1840,4692000,2,35526,8883,1,193468800,193468800,13321,4440,8881,4440,0,1,4442,1204363,1.204363
4840,2550,1840,4692000,2,38726,9683,1,207516800,207516800,14521,4840,9681,4840,0,1,4842,4202800,4.2028
5240,2550,1840,4692000,2,41926,10483,1,221564800,221564800,15721,5240,10481,5240,0,1,5242,879959,0.879959
5640,2550,1840,4692000,2,45126,11283,1,235612800,235612800,16921,5640,11281,5640,0,1,5642,113600,0.1136
6040,2550,1840,4692000,2,48326,12083,1,249660800,249660800,18121,6040,12081,6040,0,1,6042,2871102,2.871102
6440,2550,1840,4692000,2,51526,12883,1,263708800,263708800,19321,6440,12881,6440,0,1,6442,59704,0.059704
6840,2550,1840,4692000,2,54726,13683,1,277756800,277756800,20521,6840,13681,6840,0,1,6842,328170,0.32817
40,3050,1540,4697000,2,326,83,1,39044800,39044800,121,40,81,40,0,1,42,21442,0.021442
440,3050,1540,4697000,2,3526,883,1,53732800,53732800,1321,440,881,440,0,1,442,6849,0.006849
840,3050,1540,4697000,2,6726,1683,1,68420800,68420800,2521,840,1681,840,0,1,842,109142,0.109142
1240,3050,1540,4697000,2,9926,2483,1,83108800,83108800,3721,1240,2481,1240,0,1,1242,152677,0.152677
1640,3050,1540,4697000,2,13126,3283,1,97796800,97796800,4921,1640,3281,1640,0,1,1642,31993,0.031993
2040,3050,1540,4697000,2,16326,4083,1,112484800,112484800,6121,2040,4081,2040,0,1,2042,776183,0.776183
2440,3050,1540,4697000,2,19526,4883,1,127172800,127172800,7321,2440,4881,2440,0,1,2442,797963,0.797963
2840,3050,1540,4697000,2,22726,5683,1,141860800,141860800,8521,2840,5681,2840,0,1,2842,591726,0.591726
3240,3050,1540,4697000,2,25926,6483,1,156548800,156548800,9721,3240,6481,3240,0,1,3242,559586,0.559586
3640,3050,1540,4697000,2,29126,7283,1,171236800,171236800,10921,3640,7281,3640,0,1,3642,347729,0.347729
4040,3050,1540,4697000,2,32326,8083,1,185924800,185924800,12121,4040,8081,4040,0,1,4042,324408,0.324408
4440,3050,1540,4697000,2,35526,8883,1,200612800,200612800,13321,4440,8881,4440,0,1,4442,62014,0.062014
4840,3050,1540,4697000,2,38726,9683,1,215300800,215300800,14521,4840,9681,4840,0,1,4842,181441,0.181441
5240,3050,1540,4697000,2,41926,10483,1,229988800,229988800,15721,5240,10481,5240,0,1,5242,998190,0.99819
5640,3050,1540,4697000,2,45126,11283,1,244676800,244676800,16921,5640,11281,5640,0,1,5642,26322,0.026322
6040,3050,1540,4697000,2,48326,12083,1,259364800,259364800,18121,6040,12081,6040,0,1,6042,586817,0.586817
6440,3050,1540,4697000,2,51526,12883,1,274052800,274052800,19321,6440,12881,6440,0,1,6442,86811,0.086811
6840,3050,1540,4697000,2,54726,13683,1,288740800,288740800,20521,6840,13681,6840,0,1,6842,3284062,3.284062
44,4453,1055,4697915,2,358,91,1,39522136,39522136,133,44,89,44,0,1,46,9165,0.009165
544,4453,1055,4697915,2,4358,1091,1,61554136,61554136,1633,544,1089,544,0,1,546,57944,0.057944
1044,4453,1055,4697915,2,8358,2091,1,83586136,83586136,3133,1044,2089,1044,0,1,1046,79822,0.079822
1544,4453,1055,4697915,2,12358,3091,1,105618136,105618136,4633,1544,3089,1544,0,1,1546,817509,0.817509
2044,4453,1055,4697915,2,16358,4091,1,127650136,127650136,6133,2044,4089,2044,0,1,2046,353994,0.353994
2544,4453,1055,4697915,2,20358,5091,1,149682136,149682136,7633,2544,5089,2544,0,1,2546,805951,0.805951
3044,4453,1055,4697915,2,24358,6091,1,171714136,171714136,9133,3044,6089,3044,0,1,3046,94109,0.094109
3544,4453,1055,4697915,2,28358,7091,1,193746136,193746136,10633,3544,7089,3544,0,1,3546,823921,0.823921
4044,4453,1055,4697915,2,32358,8091,1,215778136,215778136,12133,4044,8089,4044,0,1,4046,71063,0.071063
4544,4453,1055,4697915,2,36358,9091,1,237810136,237810136,13633,4544,9089,4544,0,1,4546,3579882,3.579882
5044,4453,1055,4697915,2,40358,10091,1,259842136,259842136,15133,5044,10089,5044,0,1,5046,4504835,4.504835
5544,4453,1055,4697915,2,44358,11091,1,281874136,281874136,16633,5544,11089,5544,0,1,5546,409554,0.409554
6044,4453,1055,4697915,2,48358,12091,1,303906136,303906136,18133,6044,12089,6044,0,1,6046,2717462,2.717462
6544,4453,1055,4697915,2,52358,13091,1,325938136,325938136,19633,6544,13089,6544,0,1,6546,4430890,4.43089
7044,4453,1055,4697915,2,56358,14091,1,347970136,347970136,21133,7044,14089,7044,0,1,7046,241370,0.24137
40,1550,3040,4712000,2,326,83,1,39164800,39164800,121,40,81,40,0,1,42,87247,0.087247
440,1550,3040,4712000,2,3526,883,1,53852800,53852800,1321,440,881,440,0,1,442,428813,0.428813
840,1550,3040,4712000,2,6726,1683,1,68540800,68540800,2521,840,1681,840,0,1,842,480082,0.480082
1240,1550,3040,4712000,2,9926,2483,1,83228800,83228800,3721,1240,2481,1240,0,1,1242,657366,0.657366
1640,1550,3040,4712000,2,13126,3283,1,97916800,97916800,4921,1640,3281,1640,0,1,1642,1484055,1.484055
2040,1550,3040,4712000,2,16326,4083,1,112604800,112604800,6121,2040,4081,2040,0,1,2042,488146,0.488146
2440,1550,3040,4712000,2,19526,4883,1,127292800,127292800,7321,2440,4881,2440,0,1,2442,574909,0.574909
2840,1550,3040,4712000,2,22726,5683,1,141980800,141980800,8521,2840,5681,2840,0,1,2842,466097,0.466097
3240,1550,3040,4712000,2,25926,6483,1,156668800,156668800,9721,3240,6481,3240,0,1,3242,1988285,1.988285
3640,1550,3040,4712000,2,29126,7283,1,171356800,171356800,10921,3640,7281,3640,0,1,3642,259334,0.259334
4040,1550,3040,4712000,2,32326,8083,1,186044800,186044800,12121,4040,8081,4040,0,1,4042,3607336,3.607336
4440,1550,3040,4712000,2,35526,8883,1,200732800,200732800,13321,4440,8881,4440,0,1,4442,2622685,2.622685
4840,1550,3040,4712000,2,38726,9683,1,215420800,215420800,14521,4840,9681,4840,0,1,4842,234096,0.234096
5240,1550,3040,4712000,2,41926,10483,1,230108800,230108800,15721,5240,10481,5240,0,1,5242,2055827,2.055827
5640,1550,3040,4712000,2,45126,11283,1,244796800,244796800,16921,5640,11281,5640,0,1,5642,4008432,4.008432
6040,1550,3040,4712000,2,48326,12083,1,259484800,259484800,18121,6040,12081,6040,0,1,6042,22533,0.022533
6440,1550,3040,4712000,2,51526,12883,1,274172800,274172800,19321,6440,12881,6440,0,1,6442,539103,0.539103
6840,1550,3040,4712000,2,54726,13683,1,288860800,288860800,20521,6840,13681,6840,0,1,6842,2130832,2.130832
40,3800,1240,4712000,2,326,83,1,39308800,39308800,121,40,81,40,0,1,42,83618,0.083618
440,3800,1240,4712000,2,3526,883,1,55436800,55436800,1321,440,881,440,0,1,442,434490,0.43449
840,3800,1240,4712000,2,6726,1683,1,71564800,71564800,2521,840,1681,840,0,1,842,84630,0.08463
1240,3800,1240,4712000,2,9926,2483,1,87692800,87692800,3721,1240,2481,1240,0,1,1242,600719,0.600719
1640,3800,1240,4712000,2,13126,3283,1,103820800,103820800,4921,1640,3281,1640,0,1,1642,1510515,1.510515
2040,3800,1240,4712000,2,16326,4083,1,119948800,119948800,6121,2040,4081,2040,0,1,2042,1865485,1.865485
2440,3800,1240,4712000,2,19526,4883,1,136076800,136076800,7321,2440,4881,2440,0,1,2442,2230404,2.230404
2840,3800,1240,4712000,2,22726,5683,1,152204800,152204800,8521,2840,5681,2840,0,1,2842,155451,0.155451
3240,3800,1240,4712000,2,25926,6483,1,168332800,168332800,9721,3240,6481,3240,0,1,3242,253780,0.25378
3640,3800,1240,4712000,2,29126,7283,1,184460800,184460800,10921,3640,7281,3640,0,1,3642,412920,0.41292
4040,3800,1240,4712000,2,32326,8083,1,200588800,200588800,12121,4040,8081,4040,0,1,4042,3666622,3.666622
4440,3800,1240,4712000,2,35526,8883,1,216716800,216716800,13321,4440,8881,4440,0,1,4442,4014210,4.01421
4840,3800,1240,4712000,2,38726,9683,1,232844800,232844800,14521,4840,9681,4840,0,1,4842,1805981,1.805981
5240,3800,1240,4712000,2,41926,10483,1,248972800,248972800,15721,5240,10481,5240,0,1,5242,1178613,1.178613
5640,3800,1240,4712000,2,45126,11283,1,265100800,265100800,16921,5640,11281,5640,0,1,5642,2351818,2.351818
6040,3800,1240,4712000,2,48326,12083,1,281228800,281228800,18121,6040,12081,6040,0,1,6042,841378,0.841378
6440,3800,1240,4712000,2,51526,12883,1,297356800,297356800,19321,6440,12881,6440,0,1,6442,1428277,1.428277
6840,3800,1240,4712000,2,54726,13683,1,313484800,313484800,20521,6840,13681,6840,0,1,6842,1444783,1.444783
40,1300,3640,4732000,2,326,83,1,39436800,39436800,121,40,81,40,0,1,42,89575,0.089575
440,1300,3640,4732000,2,3526,883,1,55244800,55244800,1321,440,881,440,0,1,442,235452,0.235452
840,1300,3640,4732000,2,6726,1683,1,71052800,71052800,2521,840,1681,840,0,1,842,800784,0.800784
1240,1300,3640,4732000,2,9926,2483,1,86860800,86860800,3721,1240,2481,1240,0,1,1242,44847,0.044847
1640,1300,3640,4732000,2,13126,3283,1,102668800,102668800,4921,1640,3281,1640,0,1,1642,1518116,1.518116
2040,1300,3640,4732000,2,16326,4083,1,118476800,118476800,6121,2040,4081,2040,0,1,2042,932709,0.932709
2440,1300,3640,4732000,2,19526,4883,1,134284800,134284800,7321,2440,4881,2440,0,1,2442,1294687,1.294687
2840,1300,3640,4732000,2,22726,5683,1,150092800,150092800,8521,2840,5681,2840,0,1,2842,19822,0.019822
3240,1300,3640,4732000,2,25926,6483,1,165900800,165900800,9721,3240,6481,3240,0,1,3242,621945,0.621945
3640,1300,3640,4732000,2,29126,7283,1,181708800,181708800,10921,3640,7281,3640,0,1,3642,1294434,1.294434
4040,1300,3640,4732000,2,32326,8083,1,197516800,197516800,12121,4040,8081,4040,0,1,4042,801591,0.801591
4440,1300,3640,4732000,2,35526,8883,1,213324800,213324800,13321,4440,8881,4440,0,1,4442,1692399,1.692399
4840,1300,3640,4732000,2,38726,9683,1,229132800,229132800,14521,4840,9681,4840,0,1,4842,801268,0.801268
5240,1300,3640,4732000,2,41926,10483,1,244940800,244940800,15721,5240,10481,5240,0,1,5242,115715,0.115715
5640,1300,3640,4732000,2,45126,11283,1,260748800,260748800,16921,5640,11281,5640,0,1,5642,1854466,1.854466
6040,1300,3640,4732000,2,48326,12083,1,276556800,276556800,18121,6040,12081,6040,0,1,6042,1223900,1.2239
6440,1300,3640,4732000,2,51526,12883,1,292364800,292364800,19321,6440,12881,6440,0,1,6442,946837,0.946837
6840,1300,3640,4732000,2,54726,13683,1,308172800,308172800,20521,6840,13681,6840,0,1,6842,629330,0.62933
40,5050,940,4747000,2,326,83,1,39892800,39892800,121,40,81,40,0,1,42,11905,0.011905
440,5050,940,4747000,2,3526,883,1,59060800,59060800,1321,440,881,440,0,1,442,53196,0.053196
840,5050,940,4747000,2,6726,1683,1,78228800,78228800,2521,840,1681,840,0,1,842,144554,0.144554
1240,5050,940,4747000,2,9926,2483,1,97396800,97396800,3721,1240,2481,1240,0,1,1242,436822,0.436822
1640,5050,940,4747000,2,13126,3283,1,116564800,116564800,4921,1640,3281,1640,0,1,1642,290371,0.290371
2040,5050,940,4747000,2,16326,4083,1,135732800,135732800,6121,2040,4081,2040,0,1,2042,6575,0.006575
2440,5050,940,4747000,2,19526,4883,1,154900800,154900800,7321,2440,4881,2440,0,1,2442,216637,0.216637
2840,5050,940,4747000,2,22726,5683,1,174068800,174068800,8521,2840,5681,2840,0,1,2842,15050,0.01505
3240,5050,940,4747000,2,25926,6483,1,193236800,193236800,9721,3240,6481,3240,0,1,3242,39139,0.039139
3640,5050,940,4747000,2,29126,7283,1,212404800,212404800,10921,3640,7281,3640,0,1,3642,1351084,1.351084
4040,5050,940,4747000,2,32326,8083,1,231572800,231572800,12121,4040,8081,4040,0,1,4042,3768083,3.768083
4440,5050,940,4747000,2,35526,8883,1,250740800,250740800,13321,4440,8881,4440,0,1,4442,13230,0.01323
4840,5050,940,4747000,2,38726,9683,1,269908800,269908800,14521,4840,9681,4840,0,1,4842,1010759,1.010759
5240,5050,940,4747000,2,41926,10483,1,289076800,289076800,15721,5240,10481,5240,0,1,5242,778420,0.77842
5640,5050,940,4747000,2,45126,11283,1,308244800,308244800,16921,5640,11281,5640,0,1,5642,340539,0.340539
6040,5050,940,4747000,2,48326,12083,1,327412800,327412800,18121,6040,12081,6040,0,1,6042,41902,0.041902
6440,5050,940,4747000,2,51526,12883,1,346580800,346580800,19321,6440,12881,6440,0,1,6442,165141,0.165141
6840,5050,940,4747000,2,54726,13683,1,365748800,365748800,20521,6840,13681,6840,0,1,6842,1203172,1.203172
55,2555,1865,4765075,2,446,113,1,40065400,40065400,166,55,111,55,0,1,57,97016,0.097016
455,2555,1865,4765075,2,3646,913,1,54209400,54209400,1366,455,911,455,0,1,457,443693,0.443693
855,2555,1865,4765075,2,6846,1713,1,68353400,68353400,2566,855,1711,855,0,1,857,799674,0.799674
1255,2555,1865,4765075,2,10046,2513,1,82497400,82497400,3766,1255,2511,1255,0,1,1257,1151729,1.151729
1655,2555,1865,4765075,2,13246,3313,1,96641400,96641400,4966,1655,3311,1655,0,1,1657,1507350,1.50735
2055,2555,1865,4765075,2,16446,4113,1,110785400,110785400,6166,2055,4111,2055,0,1,2057,549310,0.54931
2455,2555,1865,4765075,2,19646,4913,1,124929400,124929400,7366,2455,4911,2455,0,1,2457,2216286,2.216286
2855,2555,1865,4765075,2,22846,5713,1,139073400,139073400,8566,2855,5711,2855,0,1,2857,2580465,2.580465
3255,2555,1865,4765075,2,26046,6513,1,153217400,153217400,9766,3255,6511,3255,0,1,3257,508814,0.508814
3655,2555,1865,4765075,2,29246,7313,1,167361400,167361400,10966,3655,7311,3655,0,1,3657,3192409,3.192409
4055,2555,1865,4765075,2,32446,8113,1,181505400,181505400,12166,4055,8111,4055,0,1,4057,1546554,1.546554
4455,2555,1865,4765075,2,35646,8913,1,195649400,195649400,13366,4455,8911,4455,0,1,4457,1310371,1.310371
4855,2555,1865,4765075,2,38846,9713,1,209793400,209793400,14566,4855,9711,4855,0,1,4857,3152223,3.152223
5255,2555,1865,4765075,2,42046,10513,1,223937400,223937400,15766,5255,10511,5255,0,1,5257,4404398,4.404398
5655,2555,1865,4765075,2,45246,11313,1,238081400,238081400,16966,5655,11311,5655,0,1,5657,543861,0.543861
6055,2555,1865,4765075,2,48446,12113,1,252225400,252225400,18166,6055,12111,6055,0,1,6057,5143679,5.143679
6455,2555,1865,4765075,2,51646,12913,1,266369400,266369400,19366,6455,12911,6455,0,1,6457,1301280,1.30128
6855,2555,1865,4765075,2,54846,13713,1,280513400,280513400,20566,6855,13711,6855,0,1,6857,890952,0.890952
55,1555,3065,4766075,2,446,113,1,40161400,40161400,166,55,111,55,0,1,57,98580,0.09858
455,1555,3065,4766075,2,3646,913,1,54945400,54945400,1366,455,911,455,0,1,457,458384,0.458384
855,1555,3065,4766075,2,6846,1713,1,69729400,69729400,2566,855,1711,855,0,1,857,826236,0.826236
1255,1555,3065,4766075,2,10046,2513,1,84513400,84513400,3766,1255,2511,1255,0,1,1257,1192430,1.19243
1655,1555,3065,4766075,2,13246,3313,1,99297400,99297400,4966,1655,3311,1655,0,1,1657,418007,0.418007
2055,1555,3065,4766075,2,16446,4113,1,114081400,114081400,6166,2055,4111,2055,0,1,2057,1932265,1.932265
2455,1555,3065,4766075,2,19646,4913,1,128865400,128865400,7366,2455,4911,2455,0,1,2457,1208487,1.208487
2855,1555,3065,4766075,2,22846,5713,1,143649400,143649400,8566,2855,5711,2855,0,1,2857,2668777,2.668777
3255,1555,3065,4766075,2,26046,6513,1,158433400,158433400,9766,3255,6511,3255,0,1,3257,181941,0.181941
3655,1555,3065,4766075,2,29246,7313,1,173217400,173217400,10966,3655,7311,3655,0,1,3657,2884180,2.88418
4055,1555,3065,4766075,2,32446,8113,1,188001400,188001400,12166,4055,8111,4055,0,1,4057,127972,0.127972
4455,1555,3065,4766075,2,35646,8913,1,202785400,202785400,13366,4455,8911,4455,0,1,4457,2236520,2.23652
4855,1555,3065,4766075,2,38846,9713,1,217569400,217569400,14566,4855,9711,4855,0,1,4857,1630556,1.630556
5255,1555,3065,4766075,2,42046,10513,1,232353400,232353400,15766,5255,10511,5255,0,1,5257,663740,0.66374
5655,1555,3065,4766075,2,45246,11313,1,247137400,247137400,16966,5655,11311,5655,0,1,5657,856213,0.856213
6055,1555,3065,4766075,2,48446,12113,1,261921400,261921400,18166,6055,12111,6055,0,1,6057,1706637,1.706637
6455,1555,3065,4766075,2,51646,12913,1,276705400,276705400,19366,6455,12911,6455,0,1,6457,1184347,1.184347
6855,1555,3065,4766075,2,54846,13713,1,291489400,291489400,20566,6855,13711,6855,0,1,6857,3622273,3.622273
40,1050,4540,4767000,2,326,83,1,39924800,39924800,121,40,81,40,0,1,42,249,0.000249
440,1050,4540,4767000,2,3526,883,1,57812800,57812800,1321,440,881,440,0,1,442,30026,0.030026
840,1050,4540,4767000,2,6726,1683,1,75700800,75700800,2521,840,1681,840,0,1,842,76232,0.076232
1240,1050,4540,4767000,2,9926,2483,1,93588800,93588800,3721,1240,2481,1240,0,1,1242,32366,0.032366
1640,1050,4540,4767000,2,13126,3283,1,111476800,111476800,4921,1640,3281,1640,0,1,1642,12476,0.012476
2040,1050,4540,4767000,2,16326,4083,1,129364800,129364800,6121,2040,4081,2040,0,1,2042,87394,0.087394
2440,1050,4540,4767000,2,19526,4883,1,147252800,147252800,7321,2440,4881,2440,0,1,2442,75265,0.075265
2840,1050,4540,4767000,2,22726,5683,1,165140800,165140800,8521,2840,5681,2840,0,1,2842,149560,0.14956
3240,1050,4540,4767000,2,25926,6483,1,183028800,183028800,9721,3240,6481,3240,0,1,3242,126358,0.126358
3640,1050,4540,4767000,2,29126,7283,1,200916800,200916800,10921,3640,7281,3640,0,1,3642,579243,0.579243
4040,1050,4540,4767000,2,32326,8083,1,218804800,218804800,12121,4040,8081,4040,0,1,4042,481347,0.481347
4440,1050,4540,4767000,2,35526,8883,1,236692800,236692800,13321,4440,8881,4440,0,1,4442,139264,0.139264
4840,1050,4540,4767000,2,38726,9683,1,254580800,254580800,14521,4840,9681,4840,0,1,4842,1122400,1.1224
5240,1050,4540,4767000,2,41926,10483,1,272468800,272468800,15721,5240,10481,5240,0,1,5242,965723,0.965723
5640,1050,4540,4767000,2,45126,11283,1,290356800,290356800,16921,5640,11281,5640,0,1,5642,1395152,1.395152
6040,1050,4540,4767000,2,48326,12083,1,308244800,308244800,18121,6040,12081,6040,0,1,6042,2480755,2.480755
6440,1050,4540,4767000,2,51526,12883,1,326132800,326132800,19321,6440,12881,6440,0,1,6442,530735,0.530735
6840,1050,4540,4767000,2,54726,13683,1,344020800,344020800,20521,6840,13681,6840,0,1,6842,237090,0.23709
55,3055,1565,4781075,2,446,113,1,40281400,40281400,166,55,111,55,0,1,57,10411,0.010411
455,3055,1565,4781075,2,3646,913,1,55065400,55065400,1366,455,911,455,0,1,457,52658,0.052658
855,3055,1565,4781075,2,6846,1713,1,69849400,69849400,2566,855,1711,855,0,1,857,22747,0.022747
1255,3055,1565,4781075,2,10046,2513,1,84633400,84633400,3766,1255,2511,1255,0,1,1257,46180,0.04618
1655,3055,1565,4781075,2,13246,3313,1,99417400,99417400,4966,1655,3311,1655,0,1,1657,56119,0.056119
2055,3055,1565,4781075,2,16446,4113,1,114201400,114201400,6166,2055,4111,2055,0,1,2057,490,0.00049
2455,3055,1565,4781075,2,19646,4913,1,128985400,128985400,7366,2455,4911,2455,0,1,2457,28122,0.028122
2855,3055,1565,4781075,2,22846,5713,1,143769400,143769400,8566,2855,5711,2855,0,1,2857,15515,0.015515
3255,3055,1565,4781075,2,26046,6513,1,158553400,158553400,9766,3255,6511,3255,0,1,3257,572902,0.572902
3655,3055,1565,4781075,2,29246,7313,1,173337400,173337400,10966,3655,7311,3655,0,1,3657,1113390,1.11339
4055,3055,1565,4781075,2,32446,8113,1,188121400,188121400,12166,4055,8111,4055,0,1,4057,891918,0.891918
4455,3055,1565,4781075,2,35646,8913,1,202905400,202905400,13366,4455,8911,4455,0,1,4457,35682,0.035682
4855,3055,1565,4781075,2,38846,9713,1,217689400,217689400,14566,4855,9711,4855,0,1,4857,858981,0.858981
5255,3055,1565,4781075,2,42046,10513,1,232473400,232473400,15766,5255,10511,5255,0,1,5257,1535637,1.535637
5655,3055,1565,4781075,2,45246,11313,1,247257400,247257400,16966,5655,11311,5655,0,1,5657,2626374,2.626374
6055,3055,1565,4781075,2,48446,12113,1,262041400,262041400,18166,6055,12111,6055,0,1,6057,188389,0.188389
6455,3055,1565,4781075,2,51646,12913,1,276825400,276825400,19366,6455,12911,6455,0,1,6457,71409,0.071409
6855,3055,1565,4781075,2,54846,13713,1,291609400,291609400,20566,6855,13711,6855,0,1,6857,1379112,1.379112
55,1305,3665,4782825,2,446,113,1,40449400,40449400,166,55,111,55,0,1,57,97644,0.097644
455,1305,3665,4782825,2,3646,913,1,56353400,56353400,1366,455,911,455,0,1,457,462551,0.462551
855,1305,3665,4782825,2,6846,1713,1,72257400,72257400,2566,855,1711,855,0,1,857,828061,0.828061
1255,1305,3665,4782825,2,10046,2513,1,88161400,88161400,3766,1255,2511,1255,0,1,1257,831237,0.831237
1655,1305,3665,4782825,2,13246,3313,1,104065400,104065400,4966,1655,3311,1655,0,1,1657,901401,0.901401
2055,1305,3665,4782825,2,16446,4113,1,119969400,119969400,6166,2055,4111,2055,0,1,2057,1941505,1.941505
2455,1305,3665,4782825,2,19646,4913,1,135873400,135873400,7366,2455,4911,2455,0,1,2457,1152798,1.152798
2855,1305,3665,4782825,2,22846,5713,1,151777400,151777400,8566,2855,5711,2855,0,1,2857,605321,0.605321
3255,1305,3665,4782825,2,26046,6513,1,167681400,167681400,9766,3255,6511,3255,0,1,3257,2540878,2.540878
3655,1305,3665,4782825,2,29246,7313,1,183585400,183585400,10966,3655,7311,3655,0,1,3657,2540276,2.540276
4055,1305,3665,4782825,2,32446,8113,1,199489400,199489400,12166,4055,8111,4055,0,1,4057,2129041,2.129041
4455,1305,3665,4782825,2,35646,8913,1,215393400,215393400,13366,4455,8911,4455,0,1,4457,401208,0.401208
4855,1305,3665,4782825,2,38846,9713,1,231297400,231297400,14566,4855,9711,4855,0,1,4857,1206131,1.206131
5255,1305,3665,4782825,2,42046,10513,1,247201400,247201400,15766,5255,10511,5255,0,1,5257,45216,0.045216
5655,1305,3665,4782825,2,45246,11313,1,263105400,263105400,16966,5655,11311,5655,0,1,5657,373145,0.373145
6055,1305,3665,4782825,2,48446,12113,1,279009400,279009400,18166,6055,12111,6055,0,1,6057,510865,0.510865
6455,1305,3665,4782825,2,51646,12913,1,294913400,294913400,19366,6455,12911,6455,0,1,6457,1238964,1.238964
6855,1305,3665,4782825,2,54846,13713,1,310817400,310817400,20566,6855,13711,6855,0,1,6857,143347,0.143347
55,3805,1265,4813325,2,446,113,1,40737400,40737400,166,55,111,55,0,1,57,99065,0.099065
455,3805,1265,4813325,2,3646,913,1,56961400,56961400,1366,455,911,455,0,1,457,466953,0.466953
855,3805,1265,4813325,2,6846,1713,1,73185400,73185400,2566,855,1711,855,0,1,857,844034,0.844034
1255,3805,1265,4813325,2,10046,2513,1,89409400,89409400,3766,1255,2511,1255,0,1,1257,922913,0.922913
1655,3805,1265,4813325,2,13246,3313,1,105633400,105633400,4966,1655,3311,1655,0,1,1657,28969,0.028969
2055,3805,1265,4813325,2,16446,4113,1,121857400,121857400,6166,2055,4111,2055,0,1,2057,1955585,1.955585
2455,3805,1265,4813325,2,19646,4913,1,138081400,138081400,7366,2455,4911,2455,0,1,2457,2329877,2.329877
2855,3805,1265,4813325,2,22846,5713,1,154305400,154305400,8566,2855,5711,2855,0,1,2857,153548,0.153548
3255,3805,1265,4813325,2,26046,6513,1,170529400,170529400,9766,3255,6511,3255,0,1,3257,71759,0.071759
3655,3805,1265,4813325,2,29246,7313,1,186753400,186753400,10966,3655,7311,3655,0,1,3657,3462108,3.462108
4055,3805,1265,4813325,2,32446,8113,1,202977400,202977400,12166,4055,8111,4055,0,1,4057,3769317,3.769317
4455,3805,1265,4813325,2,35646,8913,1,219201400,219201400,13366,4455,8911,4455,0,1,4457,988101,0.988101
4855,3805,1265,4813325,2,38846,9713,1,235425400,235425400,14566,4855,9711,4855,0,1,4857,2733316,2.733316
5255,3805,1265,4813325,2,42046,10513,1,251649400,251649400,15766,5255,10511,5255,0,1,5257,370182,0.370182
5655,3805,1265,4813325,2,45246,11313,1,267873400,267873400,16966,5655,11311,5655,0,1,5657,5334999,5.334999
6055,3805,1265,4813325,2,48446,12113,1,284097400,284097400,18166,6055,12111,6055,0,1,6057,938902,0.938902
6455,3805,1265,4813325,2,51646,12913,1,300321400,300321400,19366,6455,12911,6455,0,1,6457,5033101,5.033101
6855,3805,1265,4813325,2,54846,13713,1,316545400,316545400,20566,6855,13711,6855,0,1,6857,6487645,6.487645
55,1055,4565,4816075,2,446,113,1,41001400,41001400,166,55,111,55,0,1,57,8095,0.008095
455,1055,4565,4816075,2,3646,913,1,58985400,58985400,1366,455,911,455,0,1,457,7495,0.007495
855,1055,4565,4816075,2,6846,1713,1,76969400,76969400,2566,855,1711,855,0,1,857,28357,0.028357
1255,1055,4565,4816075,2,10046,2513,1,94953400,94953400,3766,1255,2511,1255,0,1,1257,51924,0.051924
1655,1055,4565,4816075,2,13246,3313,1,112937400,112937400,4966,1655,3311,1655,0,1,1657,37139,0.037139
2055,1055,4565,4816075,2,16446,4113,1,130921400,130921400,6166,2055,4111,2055,0,1,2057,52846,0.052846
2455,1055,4565,4816075,2,19646,4913,1,148905400,148905400,7366,2455,4911,2455,0,1,2457,139163,0.139163
2855,1055,4565,4816075,2,22846,5713,1,166889400,166889400,8566,2855,5711,2855,0,1,2857,376364,0.376364
3255,1055,4565,4816075,2,26046,6513,1,184873400,184873400,9766,3255,6511,3255,0,1,3257,264016,0.264016
3655,1055,4565,4816075,2,29246,7313,1,202857400,202857400,10966,3655,7311,3655,0,1,3657,402553,0.402553
4055,1055,4565,4816075,2,32446,8113,1,220841400,220841400,12166,4055,8111,4055,0,1,4057,516755,0.516755
4455,1055,4565,4816075,2,35646,8913,1,238825400,238825400,13366,4455,8911,4455,0,1,4457,91847,0.091847
4855,1055,4565,4816075,2,38846,9713,1,256809400,256809400,14566,4855,9711,4855,0,1,4857,196369,0.196369
5255,1055,4565,4816075,2,42046,10513,1,274793400,274793400,15766,5255,10511,5255,0,1,5257,822319,0.822319
5655,1055,4565,4816075,2,45246,11313,1,292777400,292777400,16966,5655,11311,5655,0,1,5657,469694,0.469694
6055,1055,4565,4816075,2,48446,12113,1,310761400,310761400,18166,6055,12111,6055,0,1,6057,29258,0.029258
6455,1055,4565,4816075,2,51646,12913,1,328745400,328745400,19366,6455,12911,6455,0,1,6457,1294555,1.294555
6855,1055,4565,4816075,2,54846,13713,1,346729400,346729400,20566,6855,13711,6855,0,1,6857,461992,0.461992
40,800,6040,4832000,2,326,83,1,40844800,40844800,121,40,81,40,0,1,42,89079,0.089079
440,800,6040,4832000,2,3526,883,1,62732800,62732800,1321,440,881,440,0,1,442,435128,0.435128
840,800,6040,4832000,2,6726,1683,1,84620800,84620800,2521,840,1681,840,0,1,842,565805,0.565805
1240,800,6040,4832000,2,9926,2483,1,106508800,106508800,3721,1240,2481,1240,0,1,1242,1033506,1.033506
1640,800,6040,4832000,2,13126,3283,1,128396800,128396800,4921,1640,3281,1640,0,1,1642,19794,0.019794
2040,800,6040,4832000,2,16326,4083,1,150284800,150284800,6121,2040,4081,2040,0,1,2042,1342286,1.342286
2440,800,6040,4832000,2,19526,4883,1,172172800,172172800,7321,2440,4881,2440,0,1,2442,1207626,1.207626
2840,800,6040,4832000,2,22726,5683,1,194060800,194060800,8521,2840,5681,2840,0,1,2842,1019783,1.019783
3240,800,6040,4832000,2,25926,6483,1,215948800,215948800,9721,3240,6481,3240,0,1,3242,213448,0.213448
3640,800,6040,4832000,2,29126,7283,1,237836800,237836800,10921,3640,7281,3640,0,1,3642,893748,0.893748
4040,800,6040,4832000,2,32326,8083,1,259724800,259724800,12121,4040,8081,4040,0,1,4042,452576,0.452576
4440,800,6040,4832000,2,35526,8883,1,281612800,281612800,13321,4440,8881,4440,0,1,4442,233319,0.233319
4840,800,6040,4832000,2,38726,9683,1,303500800,303500800,14521,4840,9681,4840,0,1,4842,139209,0.139209
5240,800,6040,4832000,2,41926,10483,1,325388800,325388800,15721,5240,10481,5240,0,1,5242,3117613,3.117613
5640,800,6040,4832000,2,45126,11283,1,347276800,347276800,16921,5640,11281,5640,0,1,5642,410594,0.410594
6040,800,6040,4832000,2,48326,12083,1,369164800,369164800,18121,6040,12081,6040,0,1,6042,1662263,1.662263
6440,800,6040,4832000,2,51526,12883,1,391052800,391052800,19321,6440,12881,6440,0,1,6442,928789,0.928789
6840,800,6040,4832000,2,54726,13683,1,412940800,412940800,20521,6840,13681,6840,0,1,6842,173166,0.173166
55,5055,965,4878075,2,446,113,1,41673400,41673400,166,55,111,55,0,1,57,1053,0.001053
455,5055,965,4878075,2,3646,913,1,60937400,60937400,1366,455,911,455,0,1,457,48753,0.048753
855,5055,965,4878075,2,6846,1713,1,80201400,80201400,2566,855,1711,855,0,1,857,95887,0.095887
1255,5055,965,4878075,2,10046,2513,1,99465400,99465400,3766,1255,2511,1255,0,1,1257,556794,0.556794
1655,5055,965,4878075,2,13246,3313,1,118729400,118729400,4966,1655,3311,1655,0,1,1657,385166,0.385166
2055,5055,965,4878075,2,16446,4113,1,137993400,137993400,6166,2055,4111,2055,0,1,2057,221738,0.221738
2455,5055,965,4878075,2,19646,4913,1,157257400,157257400,7366,2455,4911,2455,0,1,2457,596902,0.596902
2855,5055,965,4878075,2,22846,5713,1,176521400,176521400,8566,2855,5711,2855,0,1,2857,406440,0.40644
3255,5055,965,4878075,2,26046,6513,1,195785400,195785400,9766,3255,6511,3255,0,1,3257,363472,0.363472
3655,5055,965,4878075,2,29246,7313,1,215049400,215049400,10966,3655,7311,3655,0,1,3657,833575,0.833575
4055,5055,965,4878075,2,32446,8113,1,234313400,234313400,12166,4055,8111,4055,0,1,4057,1071027,1.071027
4455,5055,965,4878075,2,35646,8913,1,253577400,253577400,13366,4455,8911,4455,0,1,4457,209190,0.20919
4855,5055,965,4878075,2,38846,9713,1,272841400,272841400,14566,4855,9711,4855,0,1,4857,4489782,4.489782
5255,5055,965,4878075,2,42046,10513,1,292105400,292105400,15766,5255,10511,5255,0,1,5257,613537,0.613537
5655,5055,965,4878075,2,45246,11313,1,311369400,311369400,16966,5655,11311,5655,0,1,5657,3629232,3.629232
6055,5055,965,4878075,2,48446,12113,1,330633400,330633400,18166,6055,12111,6055,0,1,6057,1389441,1.389441
6455,5055,965,4878075,2,51646,12913,1,349897400,349897400,19366,6455,12911,6455,0,1,6457,1357309,1.357309
6855,5055,965,4878075,2,54846,13713,1,369161400,369161400,20566,6855,13711,6855,0,1,6857,1303503,1.303503
55,805,6065,4882325,2,446,113,1,42081400,42081400,166,55,111,55,0,1,57,100405,0.100405
455,805,6065,4882325,2,3646,913,1,64065400,64065400,1366,455,911,455,0,1,457,461170,0.46117
855,805,6065,4882325,2,6846,1713,1,86049400,86049400,2566,855,1711,855,0,1,857,830801,0.830801
1255,805,6065,4882325,2,10046,2513,1,108033400,108033400,3766,1255,2511,1255,0,1,1257,1201377,1.201377
1655,805,6065,4882325,2,13246,3313,1,130017400,130017400,4966,1655,3311,1655,0,1,1657,240066,0.240066
2055,805,6065,4882325,2,16446,4113,1,152001400,152001400,6166,2055,4111,2055,0,1,2057,1148749,1.148749
2455,805,6065,4882325,2,19646,4913,1,173985400,173985400,7366,2455,4911,2455,0,1,2457,2317372,2.317372
2855,805,6065,4882325,2,22846,5713,1,195969400,195969400,8566,2855,5711,2855,0,1,2857,130979,0.130979
3255,805,6065,4882325,2,26046,6513,1,217953400,217953400,9766,3255,6511,3255,0,1,3257,29081,0.029081
3655,805,6065,4882325,2,29246,7313,1,239937400,239937400,10966,3655,7311,3655,0,1,3657,631940,0.63194
4055,805,6065,4882325,2,32446,8113,1,261921400,261921400,12166,4055,8111,4055,0,1,4057,218662,0.218662
4455,805,6065,4882325,2,35646,8913,1,283905400,283905400,13366,4455,8911,4455,0,1,4457,850092,0.850092
4855,805,6065,4882325,2,38846,9713,1,305889400,305889400,14566,4855,9711,4855,0,1,4857,512616,0.512616
5255,805,6065,4882325,2,42046,10513,1,327873400,327873400,15766,5255,10511,5255,0,1,5257,1547303,1.547303
5655,805,6065,4882325,2,45246,11313,1,349857400,349857400,16966,5655,11311,5655,0,1,5657,1913047,1.913047
6055,805,6065,4882325,2,48446,12113,1,371841400,371841400,18166,6055,12111,6055,0,1,6057,883846,0.883846
6455,805,6065,4882325,2,51646,12913,1,393825400,393825400,19366,6455,12911,6455,0,1,6457,2317536,2.317536
6855,805,6065,4882325,2,54846,13713,1,415809400,415809400,20566,6855,13711,6855,0,1,6857,2978101,2.978101
40,2300,2140,4922000,2,326,83,1,40796800,40796800,121,40,81,40,0,1,42,91735,0.091735
440,2300,2140,4922000,2,3526,883,1,55004800,55004800,1321,440,881,440,0,1,442,34442,0.034442
840,2300,2140,4922000,2,6726,1683,1,69212800,69212800,2521,840,1681,840,0,1,842,339179,0.339179
1240,2300,2140,4922000,2,9926,2483,1,83420800,83420800,3721,1240,2481,1240,0,1,1242,1181596,1.181596
1640,2300,2140,4922000,2,13126,3283,1,97628800,97628800,4921,1640,3281,1640,0,1,1642,291448,0.291448
2040,2300,2140,4922000,2,16326,4083,1,111836800,111836800,6121,2040,4081,2040,0,1,2042,188987,0.188987
2440,2300,2140,4922000,2,19526,4883,1,126044800,126044800,7321,2440,4881,2440,0,1,2442,781888,0.781888
2840,2300,2140,4922000,2,22726,5683,1,140252800,140252800,8521,2840,5681,2840,0,1,2842,2656735,2.656735
3240,2300,2140,4922000,2,25926,6483,1,154460800,154460800,9721,3240,6481,3240,0,1,3242,1210990,1.21099
3640,2300,2140,4922000,2,29126,7283,1,168668800,168668800,10921,3640,7281,3640,0,1,3642,513358,0.513358
4040,2300,2140,4922000,2,32326,8083,1,182876800,182876800,12121,4040,8081,4040,0,1,4042,842634,0.842634
4440,2300,2140,4922000,2,35526,8883,1,197084800,197084800,13321,4440,8881,4440,0,1,4442,3527492,3.527492
4840,2300,2140,4922000,2,38726,9683,1,211292800,211292800,14521,4840,9681,4840,0,1,4842,3872394,3.872394
5240,2300,2140,4922000,2,41926,10483,1,225500800,225500800,15721,5240,10481,5240,0,1,5242,971958,0.971958
5640,2300,2140,4922000,2,45126,11283,1,239708800,239708800,16921,5640,11281,5640,0,1,5642,494677,0.494677
6040,2300,2140,4922000,2,48326,12083,1,253916800,253916800,18121,6040,12081,6040,0,1,6042,37212,0.037212
6440,2300,2140,4922000,2,51526,12883,1,268124800,268124800,19321,6440,12881,6440,0,1,6442,3961481,3.961481
6840,2300,2140,4922000,2,54726,13683,1,282332800,282332800,20521,6840,13681,6840,0,1,6842,398942,0.398942
40,1800,2740,4932000,2,326,83,1,40908800,40908800,121,40,81,40,0,1,42,92791,0.092791
440,1800,2740,4932000,2,3526,883,1,55436800,55436800,1321,440,881,440,0,1,442,460235,0.460235
840,1800,2740,4932000,2,6726,1683,1,69964800,69964800,2521,840,1681,840,0,1,842,835566,0.835566
1240,1800,2740,4932000,2,9926,2483,1,84492800,84492800,3721,1240,2481,1240,0,1,1242,1214071,1.214071
1640,1800,2740,4932000,2,13126,3283,1,99020800,99020800,4921,1640,3281,1640,0,1,1642,1588233,1.588233
2040,1800,2740,4932000,2,16326,4083,1,113548800,113548800,6121,2040,4081,2040,0,1,2042,1975277,1.975277
2440,1800,2740,4932000,2,19526,4883,1,128076800,128076800,7321,2440,4881,2440,0,1,2442,2345775,2.345775
2840,1800,2740,4932000,2,22726,5683,1,142604800,142604800,8521,2840,5681,2840,0,1,2842,1427125,1.427125
3240,1800,2740,4932000,2,25926,6483,1,157132800,157132800,9721,3240,6481,3240,0,1,3242,958419,0.958419
3640,1800,2740,4932000,2,29126,7283,1,171660800,171660800,10921,3640,7281,3640,0,1,3642,3401771,3.401771
4040,1800,2740,4932000,2,32326,8083,1,186188800,186188800,12121,4040,8081,4040,0,1,4042,588143,0.588143
4440,1800,2740,4932000,2,35526,8883,1,200716800,200716800,13321,4440,8881,4440,0,1,4442,196751,0.196751
4840,1800,2740,4932000,2,38726,9683,1,215244800,215244800,14521,4840,9681,4840,0,1,4842,333658,0.333658
5240,1800,2740,4932000,2,41926,10483,1,229772800,229772800,15721,5240,10481,5240,0,1,5242,2372201,2.372201
5640,1800,2740,4932000,2,45126,11283,1,244300800,244300800,16921,5640,11281,5640,0,1,5642,1595315,1.595315
6040,1800,2740,4932000,2,48326,12083,1,258828800,258828800,18121,6040,12081,6040,0,1,6042,1215871,1.215871
6440,1800,2740,4932000,2,51526,12883,1,273356800,273356800,19321,6440,12881,6440,0,1,6442,405483,0.405483
6840,1800,2740,4932000,2,54726,13683,1,287884800,287884800,20521,6840,13681,6840,0,1,6842,1668590,1.66859
40,5300,940,4982000,2,326,83,1,41852800,41852800,121,40,81,40,0,1,42,89833,0.089833
440,5300,940,4982000,2,3526,883,1,61820800,61820800,1321,440,881,440,0,1,442,460236,0.460236
840,5300,940,4982000,2,6726,1683,1,81788800,81788800,2521,840,1681,840,0,1,842,850255,0.850255
1240,5300,940,4982000,2,9926,2483,1,101756800,101756800,3721,1240,2481,1240,0,1,1242,1231793,1.231793
1640,5300,940,4982000,2,13126,3283,1,121724800,121724800,4921,1640,3281,1640,0,1,1642,169962,0.169962
2040,5300,940,4982000,2,16326,4083,1,141692800,141692800,6121,2040,4081,2040,0,1,2042,1883910,1.88391
2440,5300,940,4982000,2,19526,4883,1,161660800,161660800,7321,2440,4881,2440,0,1,2442,89630,0.08963
2840,5300,940,4982000,2,22726,5683,1,181628800,181628800,8521,2840,5681,2840,0,1,2842,1716964,1.716964
3240,5300,940,4982000,2,25926,6483,1,201596800,201596800,9721,3240,6481,3240,0,1,3242,1179546,1.179546
3640,5300,940,4982000,2,29126,7283,1,221564800,221564800,10921,3640,7281,3640,0,1,3642,313006,0.313006
4040,5300,940,4982000,2,32326,8083,1,241532800,241532800,12121,4040,8081,4040,0,1,4042,643193,0.643193
4440,5300,940,4982000,2,35526,8883,1,261500800,261500800,13321,4440,8881,4440,0,1,4442,2934335,2.934335
4840,5300,940,4982000,2,38726,9683,1,281468800,281468800,14521,4840,9681,4840,0,1,4842,284306,0.284306
5240,5300,940,4982000,2,41926,10483,1,301436800,301436800,15721,5240,10481,5240,0,1,5242,2710011,2.710011
5640,5300,940,4982000,2,45126,11283,1,321404800,321404800,16921,5640,11281,5640,0,1,5642,824632,0.824632
6040,5300,940,4982000,2,48326,12083,1,341372800,341372800,18121,6040,12081,6040,0,1,6042,536914,0.536914
6440,5300,940,4982000,2,51526,12883,1,361340800,361340800,19321,6440,12881,6440,0,1,6442,2953527,2.953527
6840,5300,940,4982000,2,54726,13683,1,381308800,381308800,20521,6840,13681,6840,0,1,6842,6690498,6.690498
55,2305,2165,4990325,2,446,113,1,41889400,41889400,166,55,111,55,0,1,57,101126,0.101126
455,2305,2165,4990325,2,3646,913,1,56193400,56193400,1366,455,911,455,0,1,457,462897,0.462897
855,2305,2165,4990325,2,6846,1713,1,70497400,70497400,2566,855,1711,855,0,1,857,319104,0.319104
1255,2305,2165,4990325,2,10046,2513,1,84801400,84801400,3766,1255,2511,1255,0,1,1257,436307,0.436307
1655,2305,2165,4990325,2,13246,3313,1,99105400,99105400,4966,1655,3311,1655,0,1,1657,94335,0.094335
2055,2305,2165,4990325,2,16446,4113,1,113409400,113409400,6166,2055,4111,2055,0,1,2057,590245,0.590245
2455,2305,2165,4990325,2,19646,4913,1,127713400,127713400,7366,2455,4911,2455,0,1,2457,204784,0.204784
2855,2305,2165,4990325,2,22846,5713,1,142017400,142017400,8566,2855,5711,2855,0,1,2857,1833691,1.833691
3255,2305,2165,4990325,2,26046,6513,1,156321400,156321400,9766,3255,6511,3255,0,1,3257,263546,0.263546
3655,2305,2165,4990325,2,29246,7313,1,170625400,170625400,10966,3655,7311,3655,0,1,3657,28038,0.028038
4055,2305,2165,4990325,2,32446,8113,1,184929400,184929400,12166,4055,8111,4055,0,1,4057,3506757,3.506757
4455,2305,2165,4990325,2,35646,8913,1,199233400,199233400,13366,4455,8911,4455,0,1,4457,4187977,4.187977
4855,2305,2165,4990325,2,38846,9713,1,213537400,213537400,14566,4855,9711,4855,0,1,4857,561164,0.561164
5255,2305,2165,4990325,2,42046,10513,1,227841400,227841400,15766,5255,10511,5255,0,1,5257,768112,0.768112
5655,2305,2165,4990325,2,45246,11313,1,242145400,242145400,16966,5655,11311,5655,0,1,5657,31425,0.031425
6055,2305,2165,4990325,2,48446,12113,1,256449400,256449400,18166,6055,12111,6055,0,1,6057,1019232,1.019232
6455,2305,2165,4990325,2,51646,12913,1,270753400,270753400,19366,6455,12911,6455,0,1,6457,1015354,1.015354
6855,2305,2165,4990325,2,54846,13713,1,285057400,285057400,20566,6855,13711,6855,0,1,6857,655557,0.655557
55,1805,2765,4990825,2,446,113,1,41937400,41937400,166,55,111,55,0,1,57,104906,0.104906
455,1805,2765,4990825,2,3646,913,1,56561400,56561400,1366,455,911,455,0,1,457,424365,0.424365
855,1805,2765,4990825,2,6846,1713,1,71185400,71185400,2566,855,1711,855,0,1,857,795256,0.795256
1255,1805,2765,4990825,2,10046,2513,1,85809400,85809400,3766,1255,2511,1255,0,1,1257,363489,0.363489
1655,1805,2765,4990825,2,13246,3313,1,100433400,100433400,4966,1655,3311,1655,0,1,1657,1348290,1.34829
2055,1805,2765,4990825,2,16446,4113,1,115057400,115057400,6166,2055,4111,2055,0,1,2057,719694,0.719694
2455,1805,2765,4990825,2,19646,4913,1,129681400,129681400,7366,2455,4911,2455,0,1,2457,1091102,1.091102
2855,1805,2765,4990825,2,22846,5713,1,144305400,144305400,8566,2855,5711,2855,0,1,2857,399205,0.399205
3255,1805,2765,4990825,2,26046,6513,1,158929400,158929400,9766,3255,6511,3255,0,1,3257,611151,0.611151
3655,1805,2765,4990825,2,29246,7313,1,173553400,173553400,10966,3655,7311,3655,0,1,3657,1644166,1.644166
4055,1805,2765,4990825,2,32446,8113,1,188177400,188177400,12166,4055,8111,4055,0,1,4057,1342017,1.342017
4455,1805,2765,4990825,2,35646,8913,1,202801400,202801400,13366,4455,8911,4455,0,1,4457,1076330,1.07633
4855,1805,2765,4990825,2,38846,9713,1,217425400,217425400,14566,4855,9711,4855,0,1,4857,2236177,2.236177
5255,1805,2765,4990825,2,42046,10513,1,232049400,232049400,15766,5255,10511,5255,0,1,5257,1218853,1.218853
5655,1805,2765,4990825,2,45246,11313,1,246673400,246673400,16966,5655,11311,5655,0,1,5657,312333,0.312333
6055,1805,2765,4990825,2,48446,12113,1,261297400,261297400,18166,6055,12111,6055,0,1,6057,2452893,2.452893
6455,1805,2765,4990825,2,51646,12913,1,275921400,275921400,19366,6455,12911,6455,0,1,6457,1969701,1.969701
6855,1805,2765,4990825,2,54846,13713,1,290545400,290545400,20566,6855,13711,6855,0,1,6857,1763755,1.763755
40,2050,2440,5002000,2,326,83,1,41452800,41452800,121,40,81,40,0,1,42,5179,0.005179
440,2050,2440,5002000,2,3526,883,1,55820800,55820800,1321,440,881,440,0,1,442,653,0.000653
840,2050,2440,5002000,2,6726,1683,1,70188800,70188800,2521,840,1681,840,0,1,842,17502,0.017502
1240,2050,2440,5002000,2,9926,2483,1,84556800,84556800,3721,1240,2481,1240,0,1,1242,14827,0.014827
1640,2050,2440,5002000,2,13126,3283,1,98924800,98924800,4921,1640,3281,1640,0,1,1642,372623,0.372623
2040,2050,2440,5002000,2,16326,4083,1,113292800,113292800,6121,2040,4081,2040,0,1,2042,39152,0.039152
2440,2050,2440,5002000,2,19526,4883,1,127660800,127660800,7321,2440,4881,2440,0,1,2442,1001677,1.001677
2840,2050,2440,5002000,2,22726,5683,1,142028800,142028800,8521,2840,5681,2840,0,1,2842,111913,0.111913
3240,2050,2440,5002000,2,25926,6483,1,156396800,156396800,9721,3240,6481,3240,0,1,3242,12792,0.012792
3640,2050,2440,5002000,2,29126,7283,1,170764800,170764800,10921,3640,7281,3640,0,1,3642,227631,0.227631
4040,2050,2440,5002000,2,32326,8083,1,185132800,185132800,12121,4040,8081,4040,0,1,4042,485914,0.485914
4440,2050,2440,5002000,2,35526,8883,1,199500800,199500800,13321,4440,8881,4440,0,1,4442,308621,0.308621
4840,2050,2440,5002000,2,38726,9683,1,213868800,213868800,14521,4840,9681,4840,0,1,4842,980939,0.980939
5240,2050,2440,5002000,2,41926,10483,1,228236800,228236800,15721,5240,10481,5240,0,1,5242,396307,0.396307
5640,2050,2440,5002000,2,45126,11283,1,242604800,242604800,16921,5640,11281,5640,0,1,5642,149447,0.149447
6040,2050,2440,5002000,2,48326,12083,1,256972800,256972800,18121,6040,12081,6040,0,1,6042,14076,0.014076
6440,2050,2440,5002000,2,51526,12883,1,271340800,271340800,19321,6440,12881,6440,0,1,6442,284729,0.284729
6840,2050,2440,5002000,2,54726,13683,1,285708800,285708800,20521,6840,13681,6840,0,1,6842,6399594,6.399594
40,4050,1240,5022000,2,326,83,1,41868800,41868800,121,40,81,40,0,1,42,850,0.00085
440,4050,1240,5022000,2,3526,883,1,58796800,58796800,1321,440,881,440,0,1,442,17346,0.017346
840,4050,1240,5022000,2,6726,1683,1,75724800,75724800,2521,840,1681,840,0,1,842,41724,0.041724
1240,4050,1240,5022000,2,9926,2483,1,92652800,92652800,3721,1240,2481,1240,0,1,1242,256330,0.25633
1640,4050,1240,5022000,2,13126,3283,1,109580800,109580800,4921,1640,3281,1640,0,1,1642,389264,0.389264
2040,4050,1240,5022000,2,16326,4083,1,126508800,126508800,6121,2040,4081,2040,0,1,2042,261276,0.261276
2440,4050,1240,5022000,2,19526,4883,1,143436800,143436800,7321,2440,4881,2440,0,1,2442,34512,0.034512
2840,4050,1240,5022000,2,22726,5683,1,160364800,160364800,8521,2840,5681,2840,0,1,2842,1260788,1.260788
3240,4050,1240,5022000,2,25926,6483,1,177292800,177292800,9721,3240,6481,3240,0,1,3242,478251,0.478251
3640,4050,1240,5022000,2,29126,7283,1,194220800,194220800,10921,3640,7281,3640,0,1,3642,683621,0.683621
4040,4050,1240,5022000,2,32326,8083,1,211148800,211148800,12121,4040,8081,4040,0,1,4042,2249709,2.249709
4440,4050,1240,5022000,2,35526,8883,1,228076800,228076800,13321,4440,8881,4440,0,1,4442,4031983,4.031983
4840,4050,1240,5022000,2,38726,9683,1,245004800,245004800,14521,4840,9681,4840,0,1,4842,3345985,3.345985
5240,4050,1240,5022000,2,41926,10483,1,261932800,261932800,15721,5240,10481,5240,0,1,5242,137541,0.137541
5640,4050,1240,5022000,2,45126,11283,1,278860800,278860800,16921,5640,11281,5640,0,1,5642,11363,0.011363
6040,4050,1240,5022000,2,48326,12083,1,295788800,295788800,18121,6040,12081,6040,0,1,6042,510641,0.510641
6440,4050,1240,5022000,2,51526,12883,1,312716800,312716800,19321,6440,12881,6440,0,1,6442,1318459,1.318459
6840,4050,1240,5022000,2,54726,13683,1,329644800,329644800,20521,6840,13681,6840,0,1,6842,2636615,2.636615
55,2055,2465,5065575,2,446,113,1,42513400,42513400,166,55,111,55,0,1,57,4146,0.004146
455,2055,2465,5065575,2,3646,913,1,56977400,56977400,1366,455,911,455,0,1,457,23307,0.023307
855,2055,2465,5065575,2,6846,1713,1,71441400,71441400,2566,855,1711,855,0,1,857,6443,0.006443
1255,2055,2465,5065575,2,10046,2513,1,85905400,85905400,3766,1255,2511,1255,0,1,1257,71363,0.071363
1655,2055,2465,5065575,2,13246,3313,1,100369400,100369400,4966,1655,3311,1655,0,1,1657,100598,0.100598
2055,2055,2465,5065575,2,16446,4113,1,114833400,114833400,6166,2055,4111,2055,0,1,2057,215409,0.215409
2455,2055,2465,5065575,2,19646,4913,1,129297400,129297400,7366,2455,4911,2455,0,1,2457,70863,0.070863
2855,2055,2465,5065575,2,22846,5713,1,143761400,143761400,8566,2855,5711,2855,0,1,2857,504880,0.50488
3255,2055,2465,5065575,2,26046,6513,1,158225400,158225400,9766,3255,6511,3255,0,1,3257,138141,0.138141
3655,2055,2465,5065575,2,29246,7313,1,172689400,172689400,10966,3655,7311,3655,0,1,3657,203065,0.203065
4055,2055,2465,5065575,2,32446,8113,1,187153400,187153400,12166,4055,8111,4055,0,1,4057,57170,0.05717
4455,2055,2465,5065575,2,35646,8913,1,201617400,201617400,13366,4455,8911,4455,0,1,4457,11260,0.01126
4855,2055,2465,5065575,2,38846,9713,1,216081400,216081400,14566,4855,9711,4855,0,1,4857,596924,0.596924
5255,2055,2465,5065575,2,42046,10513,1,230545400,230545400,15766,5255,10511,5255,0,1,5257,809422,0.809422
5655,2055,2465,5065575,2,45246,11313,1,245009400,245009400,16966,5655,11311,5655,0,1,5657,1197869,1.197869
6055,2055,2465,5065575,2,48446,12113,1,259473400,259473400,18166,6055,12111,6055,0,1,6057,475873,0.475873
6455,2055,2465,5065575,2,51646,12913,1,273937400,273937400,19366,6455,12911,6455,0,1,6457,809121,0.809121
6855,2055,2465,5065575,2,54846,13713,1,288401400,288401400,20566,6855,13711,6855,0,1,6857,3752400,3.7524
40,800,6340,5072000,2,326,83,1,42860800,42860800,121,40,81,40,0,1,42,91549,0.091549
440,800,6340,5072000,2,3526,883,1,65708800,65708800,1321,440,881,440,0,1,442,461137,0.461137
840,800,6340,5072000,2,6726,1683,1,88556800,88556800,2521,840,1681,840,0,1,842,840493,0.840493
1240,800,6340,5072000,2,9926,2483,1,111404800,111404800,3721,1240,2481,1240,0,1,1242,750354,0.750354
1640,800,6340,5072000,2,13126,3283,1,134252800,134252800,4921,1640,3281,1640,0,1,1642,1601709,1.601709
2040,800,6340,5072000,2,16326,4083,1,157100800,157100800,6121,2040,4081,2040,0,1,2042,1983908,1.983908
2440,800,6340,5072000,2,19526,4883,1,179948800,179948800,7321,2440,4881,2440,0,1,2442,708906,0.708906
2840,800,6340,5072000,2,22726,5683,1,202796800,202796800,8521,2840,5681,2840,0,1,2842,803152,0.803152
3240,800,6340,5072000,2,25926,6483,1,225644800,225644800,9721,3240,6481,3240,0,1,3242,923461,0.923461
3640,800,6340,5072000,2,29126,7283,1,248492800,248492800,10921,3640,7281,3640,0,1,3642,1064023,1.064023
4040,800,6340,5072000,2,32326,8083,1,271340800,271340800,12121,4040,8081,4040,0,1,4042,120090,0.12009
4440,800,6340,5072000,2,35526,8883,1,294188800,294188800,13321,4440,8881,4440,0,1,4442,1104593,1.104593
4840,800,6340,5072000,2,38726,9683,1,317036800,317036800,14521,4840,9681,4840,0,1,4842,1207466,1.207466
5240,800,6340,5072000,2,41926,10483,1,339884800,339884800,15721,5240,10481,5240,0,1,5242,64336,0.064336
5640,800,6340,5072000,2,45126,11283,1,362732800,362732800,16921,5640,11281,5640,0,1,5642,2890965,2.890965
6040,800,6340,5072000,2,48326,12083,1,385580800,385580800,18121,6040,12081,6040,0,1,6042,1045013,1.045013
6440,800,6340,5072000,2,51526,12883,1,408428800,408428800,19321,6440,12881,6440,0,1,6442,1522514,1.522514
6840,800,6340,5072000,2,54726,13683,1,431276800,431276800,20521,6840,13681,6840,0,1,6842,1375974,1.375974
40,1050,4840,5082000,2,326,83,1,42540800,42540800,121,40,81,40,0,1,42,14976,0.014976
440,1050,4840,5082000,2,3526,883,1,61388800,61388800,1321,440,881,440,0,1,442,38178,0.038178
840,1050,4840,5082000,2,6726,1683,1,80236800,80236800,2521,840,1681,840,0,1,842,41700,0.0417
1240,1050,4840,5082000,2,9926,2483,1,99084800,99084800,3721,1240,2481,1240,0,1,1242,10963,0.010963
1640,1050,4840,5082000,2,13126,3283,1,117932800,117932800,4921,1640,3281,1640,0,1,1642,6583,0.006583
2040,1050,4840,5082000,2,16326,4083,1,136780800,136780800,6121,2040,4081,2040,0,1,2042,488283,0.488283
2440,1050,4840,5082000,2,19526,4883,1,155628800,155628800,7321,2440,4881,2440,0,1,2442,53210,0.05321
2840,1050,4840,5082000,2,22726,5683,1,174476800,174476800,8521,2840,5681,2840,0,1,2842,1030546,1.030546
3240,1050,4840,5082000,2,25926,6483,1,193324800,193324800,9721,3240,6481,3240,0,1,3242,463652,0.463652
3640,1050,4840,5082000,2,29126,7283,1,212172800,212172800,10921,3640,7281,3640,0,1,3642,16345,0.016345
4040,1050,4840,5082000,2,32326,8083,1,231020800,231020800,12121,4040,8081,4040,0,1,4042,966822,0.966822
4440,1050,4840,5082000,2,35526,8883,1,249868800,249868800,13321,4440,8881,4440,0,1,4442,589679,0.589679
4840,1050,4840,5082000,2,38726,9683,1,268716800,268716800,14521,4840,9681,4840,0,1,4842,245026,0.245026
5240,1050,4840,5082000,2,41926,10483,1,287564800,287564800,15721,5240,10481,5240,0,1,5242,67664,0.067664
5640,1050,4840,5082000,2,45126,11283,1,306412800,306412800,16921,5640,11281,5640,0,1,5642,411968,0.411968
6040,1050,4840,5082000,2,48326,12083,1,325260800,325260800,18121,6040,12081,6040,0,1,6042,1765162,1.765162
6440,1050,4840,5082000,2,51526,12883,1,344108800,344108800,19321,6440,12881,6440,0,1,6442,654830,0.65483
6840,1050,4840,5082000,2,54726,13683,1,362956800,362956800,20521,6840,13681,6840,0,1,6842,269577,0.269577
40,3300,1540,5082000,2,326,83,1,42204800,42204800,121,40,81,40,0,1,42,88807,0.088807
440,3300,1540,5082000,2,3526,883,1,57692800,57692800,1321,440,881,440,0,1,442,387119,0.387119
840,3300,1540,5082000,2,6726,1683,1,73180800,73180800,2521,840,1681,840,0,1,842,861326,0.861326
1240,3300,1540,5082000,2,9926,2483,1,88668800,88668800,3721,1240,2481,1240,0,1,1242,1246058,1.246058
1640,3300,1540,5082000,2,13126,3283,1,104156800,104156800,4921,1640,3281,1640,0,1,1642,1396413,1.396413
2040,3300,1540,5082000,2,16326,4083,1,119644800,119644800,6121,2040,4081,2040,0,1,2042,511779,0.511779
2440,3300,1540,5082000,2,19526,4883,1,135132800,135132800,7321,2440,4881,2440,0,1,2442,369603,0.369603
2840,3300,1540,5082000,2,22726,5683,1,150620800,150620800,8521,2840,5681,2840,0,1,2842,1987248,1.987248
3240,3300,1540,5082000,2,25926,6483,1,166108800,166108800,9721,3240,6481,3240,0,1,3242,3180667,3.180667
3640,3300,1540,5082000,2,29126,7283,1,181596800,181596800,10921,3640,7281,3640,0,1,3642,3568963,3.568963
4040,3300,1540,5082000,2,32326,8083,1,197084800,197084800,12121,4040,8081,4040,0,1,4042,1519262,1.519262
4440,3300,1540,5082000,2,35526,8883,1,212572800,212572800,13321,4440,8881,4440,0,1,4442,94259,0.094259
4840,3300,1540,5082000,2,38726,9683,1,228060800,228060800,14521,4840,9681,4840,0,1,4842,1192198,1.192198
5240,3300,1540,5082000,2,41926,10483,1,243548800,243548800,15721,5240,10481,5240,0,1,5242,1979602,1.979602
5640,3300,1540,5082000,2,45126,11283,1,259036800,259036800,16921,5640,11281,5640,0,1,5642,1707978,1.707978
6040,3300,1540,5082000,2,48326,12083,1,274524800,274524800,18121,6040,12081,6040,0,1,6042,394599,0.394599
6440,3300,1540,5082000,2,51526,12883,1,290012800,290012800,19321,6440,12881,6440,0,1,6442,746871,0.746871
6840,3300,1540,5082000,2,54726,13683,1,305500800,305500800,20521,6840,13681,6840,0,1,6842,1963085,1.963085
55,5305,965,5119325,2,446,113,1,43713400,43713400,166,55,111,55,0,1,57,40568,0.040568
455,5305,965,5119325,2,3646,913,1,63777400,63777400,1366,455,911,455,0,1,457,485395,0.485395
855,5305,965,5119325,2,6846,1713,1,83841400,83841400,2566,855,1711,855,0,1,857,879990,0.87999
1255,5305,965,5119325,2,10046,2513,1,103905400,103905400,3766,1255,2511,1255,0,1,1257,1272603,1.272603
1655,5305,965,5119325,2,13246,3313,1,123969400,123969400,4966,1655,3311,1655,0,1,1657,40978,0.040978
2055,5305,965,5119325,2,16446,4113,1,144033400,144033400,6166,2055,4111,2055,0,1,2057,2062376,2.062376
2455,5305,965,5119325,2,19646,4913,1,164097400,164097400,7366,2455,4911,2455,0,1,2457,1023886,1.023886
2855,5305,965,5119325,2,22846,5713,1,184161400,184161400,8566,2855,5711,2855,0,1,2857,873649,0.873649
3255,5305,965,5119325,2,26046,6513,1,204225400,204225400,9766,3255,6511,3255,0,1,3257,180276,0.180276
3655,5305,965,5119325,2,29246,7313,1,224289400,224289400,10966,3655,7311,3655,0,1,3657,3646508,3.646508
4055,5305,965,5119325,2,32446,8113,1,244353400,244353400,12166,4055,8111,4055,0,1,4057,1012808,1.012808
4455,5305,965,5119325,2,35646,8913,1,264417400,264417400,13366,4455,8911,4455,0,1,4457,1670375,1.670375
4855,5305,965,5119325,2,38846,9713,1,284481400,284481400,14566,4855,9711,4855,0,1,4857,1311280,1.31128
5255,5305,965,5119325,2,42046,10513,1,304545400,304545400,15766,5255,10511,5255,0,1,5257,2537001,2.537001
5655,5305,965,5119325,2,45246,11313,1,324609400,324609400,16966,5655,11311,5655,0,1,5657,869142,0.869142
6055,5305,965,5119325,2,48446,12113,1,344673400,344673400,18166,6055,12111,6055,0,1,6057,953141,0.953141
6455,5305,965,5119325,2,51646,12913,1,364737400,364737400,19366,6455,12911,6455,0,1,6457,2915582,2.915582
6855,5305,965,5119325,2,54846,13713,1,384801400,384801400,20566,6855,13711,6855,0,1,6857,5666984,5.666984
40,1300,3940,5122000,2,326,83,1,42652800,42652800,121,40,81,40,0,1,42,95905,0.095905
440,1300,3940,5122000,2,3526,883,1,59420800,59420800,1321,440,881,440,0,1,442,474393,0.474393
840,1300,3940,5122000,2,6726,1683,1,76188800,76188800,2521,840,1681,840,0,1,842,466851,0.466851
1240,1300,3940,5122000,2,9926,2483,1,92956800,92956800,3721,1240,2481,1240,0,1,1242,1262372,1.262372
1640,1300,3940,5122000,2,13126,3283,1,109724800,109724800,4921,1640,3281,1640,0,1,1642,346140,0.34614
2040,1300,3940,5122000,2,16326,4083,1,126492800,126492800,6121,2040,4081,2040,0,1,2042,929874,0.929874
2440,1300,3940,5122000,2,19526,4883,1,143260800,143260800,7321,2440,4881,2440,0,1,2442,645588,0.645588
2840,1300,3940,5122000,2,22726,5683,1,160028800,160028800,8521,2840,5681,2840,0,1,2842,1167804,1.167804
3240,1300,3940,5122000,2,25926,6483,1,176796800,176796800,9721,3240,6481,3240,0,1,3242,757131,0.757131
3640,1300,3940,5122000,2,29126,7283,1,193564800,193564800,10921,3640,7281,3640,0,1,3642,389305,0.389305
4040,1300,3940,5122000,2,32326,8083,1,210332800,210332800,12121,4040,8081,4040,0,1,4042,1746658,1.746658
4440,1300,3940,5122000,2,35526,8883,1,227100800,227100800,13321,4440,8881,4440,0,1,4442,85979,0.085979
4840,1300,3940,5122000,2,38726,9683,1,243868800,243868800,14521,4840,9681,4840,0,1,4842,2338013,2.338013
5240,1300,3940,5122000,2,41926,10483,1,260636800,260636800,15721,5240,10481,5240,0,1,5242,3945099,3.945099
5640,1300,3940,5122000,2,45126,11283,1,277404800,277404800,16921,5640,11281,5640,0,1,5642,957987,0.957987
6040,1300,3940,5122000,2,48326,12083,1,294172800,294172800,18121,6040,12081,6040,0,1,6042,417392,0.417392
6440,1300,3940,5122000,2,51526,12883,1,310940800,310940800,19321,6440,12881,6440,0,1,6442,3687085,3.687085
6840,1300,3940,5122000,2,54726,13683,1,327708800,327708800,20521,6840,13681,6840,0,1,6842,1545423,1.545423
55,805,6365,5123825,2,446,113,1,44145400,44145400,166,55,111,55,0,1,57,105415,0.105415
455,805,6365,5123825,2,3646,913,1,67089400,67089400,1366,455,911,455,0,1,457,486308,0.486308
855,805,6365,5123825,2,6846,1713,1,90033400,90033400,2566,855,1711,855,0,1,857,134467,0.134467
1255,805,6365,5123825,2,10046,2513,1,112977400,112977400,3766,1255,2511,1255,0,1,1257,69741,0.069741
1655,805,6365,5123825,2,13246,3313,1,135921400,135921400,4966,1655,3311,1655,0,1,1657,419427,0.419427
2055,805,6365,5123825,2,16446,4113,1,158865400,158865400,6166,2055,4111,2055,0,1,2057,1390290,1.39029
2455,805,6365,5123825,2,19646,4913,1,181809400,181809400,7366,2455,4911,2455,0,1,2457,907001,0.907001
2855,805,6365,5123825,2,22846,5713,1,204753400,204753400,8566,2855,5711,2855,0,1,2857,498982,0.498982
3255,805,6365,5123825,2,26046,6513,1,227697400,227697400,9766,3255,6511,3255,0,1,3257,42910,0.04291
3655,805,6365,5123825,2,29246,7313,1,250641400,250641400,10966,3655,7311,3655,0,1,3657,510358,0.510358
4055,805,6365,5123825,2,32446,8113,1,273585400,273585400,12166,4055,8111,4055,0,1,4057,587573,0.587573
4455,805,6365,5123825,2,35646,8913,1,296529400,296529400,13366,4455,8911,4455,0,1,4457,886229,0.886229
4855,805,6365,5123825,2,38846,9713,1,319473400,319473400,14566,4855,9711,4855,0,1,4857,2248013,2.248013
5255,805,6365,5123825,2,42046,10513,1,342417400,342417400,15766,5255,10511,5255,0,1,5257,818905,0.818905
5655,805,6365,5123825,2,45246,11313,1,365361400,365361400,16966,5655,11311,5655,0,1,5657,896988,0.896988
6055,805,6365,5123825,2,48446,12113,1,388305400,388305400,18166,6055,12111,6055,0,1,6057,1623178,1.623178
6455,805,6365,5123825,2,51646,12913,1,411249400,411249400,19366,6455,12911,6455,0,1,6457,1125651,1.125651
6855,805,6365,5123825,2,54846,13713,1,434193400,434193400,20566,6855,13711,6855,0,1,6857,276977,0.276977
55,4055,1265,5129575,2,446,113,1,43377400,43377400,166,55,111,55,0,1,57,783,0.000783
455,4055,1265,5129575,2,3646,913,1,60401400,60401400,1366,455,911,455,0,1,457,33035,0.033035
855,4055,1265,5129575,2,6846,1713,1,77425400,77425400,2566,855,1711,855,0,1,857,4935,0.004935
1255,4055,1265,5129575,2,10046,2513,1,94449400,94449400,3766,1255,2511,1255,0,1,1257,280517,0.280517
1655,4055,1265,5129575,2,13246,3313,1,111473400,111473400,4966,1655,3311,1655,0,1,1657,482135,0.482135
2055,4055,1265,5129575,2,16446,4113,1,128497400,128497400,6166,2055,4111,2055,0,1,2057,103303,0.103303
2455,4055,1265,5129575,2,19646,4913,1,145521400,145521400,7366,2455,4911,2455,0,1,2457,621270,0.62127
2855,4055,1265,5129575,2,22846,5713,1,162545400,162545400,8566,2855,5711,2855,0,1,2857,1447327,1.447327
3255,4055,1265,5129575,2,26046,6513,1,179569400,179569400,9766,3255,6511,3255,0,1,3257,996131,0.996131
3655,4055,1265,5129575,2,29246,7313,1,196593400,196593400,10966,3655,7311,3655,0,1,3657,219961,0.219961
4055,4055,1265,5129575,2,32446,8113,1,213617400,213617400,12166,4055,8111,4055,0,1,4057,1402611,1.402611
4455,4055,1265,5129575,2,35646,8913,1,230641400,230641400,13366,4455,8911,4455,0,1,4457,1155208,1.155208
4855,4055,1265,5129575,2,38846,9713,1,247665400,247665400,14566,4855,9711,4855,0,1,4857,1565945,1.565945
5255,4055,1265,5129575,2,42046,10513,1,264689400,264689400,15766,5255,10511,5255,0,1,5257,65307,0.065307
5655,4055,1265,5129575,2,45246,11313,1,281713400,281713400,16966,5655,11311,5655,0,1,5657,1308208,1.308208
6055,4055,1265,5129575,2,48446,12113,1,298737400,298737400,18166,6055,12111,6055,0,1,6057,2127997,2.127997
6455,4055,1265,5129575,2,51646,12913,1,315761400,315761400,19366,6455,12911,6455,0,1,6457,1781535,1.781535
6855,4055,1265,5129575,2,54846,13713,1,332785400,332785400,20566,6855,13711,6855,0,1,6857,339100,0.3391
55,1055,4865,5132575,2,446,113,1,43665400,43665400,166,55,111,55,0,1,57,8578,0.008578
455,1055,4865,5132575,2,3646,913,1,62609400,62609400,1366,455,911,455,0,1,457,63322,0.063322
855,1055,4865,5132575,2,6846,1713,1,81553400,81553400,2566,855,1711,855,0,1,857,60917,0.060917
1255,1055,4865,5132575,2,10046,2513,1,100497400,100497400,3766,1255,2511,1255,0,1,1257,48909,0.048909
1655,1055,4865,5132575,2,13246,3313,1,119441400,119441400,4966,1655,3311,1655,0,1,1657,31526,0.031526
2055,1055,4865,5132575,2,16446,4113,1,138385400,138385400,6166,2055,4111,2055,0,1,2057,20895,0.020895
2455,1055,4865,5132575,2,19646,4913,1,157329400,157329400,7366,2455,4911,2455,0,1,2457,184337,0.184337
2855,1055,4865,5132575,2,22846,5713,1,176273400,176273400,8566,2855,5711,2855,0,1,2857,546727,0.546727
3255,1055,4865,5132575,2,26046,6513,1,195217400,195217400,9766,3255,6511,3255,0,1,3257,82126,0.082126
3655,1055,4865,5132575,2,29246,7313,1,214161400,214161400,10966,3655,7311,3655,0,1,3657,354760,0.35476
4055,1055,4865,5132575,2,32446,8113,1,233105400,233105400,12166,4055,8111,4055,0,1,4057,826370,0.82637
4455,1055,4865,5132575,2,35646,8913,1,252049400,252049400,13366,4455,8911,4455,0,1,4457,816590,0.81659
4855,1055,4865,5132575,2,38846,9713,1,270993400,270993400,14566,4855,9711,4855,0,1,4857,589883,0.589883
5255,1055,4865,5132575,2,42046,10513,1,289937400,289937400,15766,5255,10511,5255,0,1,5257,533891,0.533891
5655,1055,4865,5132575,2,45246,11313,1,308881400,308881400,16966,5655,11311,5655,0,1,5657,494971,0.494971
6055,1055,4865,5132575,2,48446,12113,1,327825400,327825400,18166,6055,12111,6055,0,1,6057,1439996,1.439996
6455,1055,4865,5132575,2,51646,12913,1,346769400,346769400,19366,6455,12911,6455,0,1,6457,342095,0.342095
6855,1055,4865,5132575,2,54846,13713,1,365713400,365713400,20566,6855,13711,6855,0,1,6857,515593,0.515593
39,1693,3041,5148413,2,318,81,1,42664312,42664312,118,39,79,39,0,1,41,91558,0.091558
539,1693,3041,5148413,2,4318,1081,1,61600312,61600312,1618,539,1079,539,0,1,541,588733,0.588733
1039,1693,3041,5148413,2,8318,2081,1,80536312,80536312,3118,1039,2079,1039,0,1,1041,1084355,1.084355
1539,1693,3041,5148413,2,12318,3081,1,99472312,99472312,4618,1539,3079,1539,0,1,1541,564107,0.564107
2039,1693,3041,5148413,2,16318,4081,1,118408312,118408312,6118,2039,4079,2039,0,1,2041,240675,0.240675
2539,1693,3041,5148413,2,20318,5081,1,137344312,137344312,7618,2539,5079,2539,0,1,2541,2577864,2.577864
3039,1693,3041,5148413,2,24318,6081,1,156280312,156280312,9118,3039,6079,3039,0,1,3041,2035637,2.035637
3539,1693,3041,5148413,2,28318,7081,1,175216312,175216312,10618,3539,7079,3539,0,1,3541,863007,0.863007
4039,1693,3041,5148413,2,32318,8081,1,194152312,194152312,12118,4039,8079,4039,0,1,4041,3243712,3.243712
4539,1693,3041,5148413,2,36318,9081,1,213088312,213088312,13618,4539,9079,4539,0,1,4541,2286720,2.28672
5039,1693,3041,5148413,2,40318,10081,1,232024312,232024312,15118,5039,10079,5039,0,1,5041,238374,0.238374
5539,1693,3041,5148413,2,44318,11081,1,250960312,250960312,16618,5539,11079,5539,0,1,5541,191790,0.19179
6039,1693,3041,5148413,2,48318,12081,1,269896312,269896312,18118,6039,12079,6039,0,1,6041,1008841,1.008841
6539,1693,3041,5148413,2,52318,13081,1,288832312,288832312,19618,6539,13079,6539,0,1,6541,203937,0.203937
7039,1693,3041,5148413,2,56318,14081,1,307768312,307768312,21118,7039,14079,7039,0,1,7041,123489,0.123489
39,3343,1541,5151563,2,318,81,1,42736312,42736312,118,39,79,39,0,1,41,5250,0.00525
539,3343,1541,5151563,2,4318,1081,1,62272312,62272312,1618,539,1079,539,0,1,541,14627,0.014627
1039,3343,1541,5151563,2,8318,2081,1,81808312,81808312,3118,1039,2079,1039,0,1,1041,117073,0.117073
1539,3343,1541,5151563,2,12318,3081,1,101344312,101344312,4618,1539,3079,1539,0,1,1541,119418,0.119418
2039,3343,1541,5151563,2,16318,4081,1,120880312,120880312,6118,2039,4079,2039,0,1,2041,419089,0.419089
2539,3343,1541,5151563,2,20318,5081,1,140416312,140416312,7618,2539,5079,2539,0,1,2541,592267,0.592267
3039,3343,1541,5151563,2,24318,6081,1,159952312,159952312,9118,3039,6079,3039,0,1,3041,895650,0.89565
3539,3343,1541,5151563,2,28318,7081,1,179488312,179488312,10618,3539,7079,3539,0,1,3541,1021364,1.021364
4039,3343,1541,5151563,2,32318,8081,1,199024312,199024312,12118,4039,8079,4039,0,1,4041,1029544,1.029544
4539,3343,1541,5151563,2,36318,9081,1,218560312,218560312,13618,4539,9079,4539,0,1,4541,491771,0.491771
5039,3343,1541,5151563,2,40318,10081,1,238096312,238096312,15118,5039,10079,5039,0,1,5041,643105,0.643105
5539,3343,1541,5151563,2,44318,11081,1,257632312,257632312,16618,5539,11079,5539,0,1,5541,791114,0.791114
6039,3343,1541,5151563,2,48318,12081,1,277168312,277168312,18118,6039,12079,6039,0,1,6041,1574982,1.574982
6539,3343,1541,5151563,2,52318,13081,1,296704312,296704312,19618,6539,13079,6539,0,1,6541,616165,0.616165
7039,3343,1541,5151563,2,56318,14081,1,316240312,316240312,21118,7039,14079,7039,0,1,7041,946953,0.946953
40,2800,1840,5152000,2,326,83,1,42700800,42700800,121,40,81,40,0,1,42,95321,0.095321
440,2800,1840,5152000,2,3526,883,1,57548800,57548800,1321,440,881,440,0,1,442,479281,0.479281
840,2800,1840,5152000,2,6726,1683,1,72396800,72396800,2521,840,1681,840,0,1,842,182270,0.18227
1240,2800,1840,5152000,2,9926,2483,1,87244800,87244800,3721,1240,2481,1240,0,1,1242,931928,0.931928
1640,2800,1840,5152000,2,13126,3283,1,102092800,102092800,4921,1640,3281,1640,0,1,1642,1580603,1.580603
2040,2800,1840,5152000,2,16326,4083,1,116940800,116940800,6121,2040,4081,2040,0,1,2042,1131528,1.131528
2440,2800,1840,5152000,2,19526,4883,1,131788800,131788800,7321,2440,4881,2440,0,1,2442,258237,0.258237
2840,2800,1840,5152000,2,22726,5683,1,146636800,146636800,8521,2840,5681,2840,0,1,2842,2230022,2.230022
3240,2800,1840,5152000,2,25926,6483,1,161484800,161484800,9721,3240,6481,3240,0,1,3242,2160976,2.160976
3640,2800,1840,5152000,2,29126,7283,1,176332800,176332800,10921,3640,7281,3640,0,1,3642,3269753,3.269753
4040,2800,1840,5152000,2,32326,8083,1,191180800,191180800,12121,4040,8081,4040,0,1,4042,2185395,2.185395
4440,2800,1840,5152000,2,35526,8883,1,206028800,206028800,13321,4440,8881,4440,0,1,4442,402364,0.402364
4840,2800,1840,5152000,2,38726,9683,1,220876800,220876800,14521,4840,9681,4840,0,1,4842,2590399,2.590399
5240,2800,1840,5152000,2,41926,10483,1,235724800,235724800,15721,5240,10481,5240,0,1,5242,297886,0.297886
5640,2800,1840,5152000,2,45126,11283,1,250572800,250572800,16921,5640,11281,5640,0,1,5642,1245625,1.245625
6040,2800,1840,5152000,2,48326,12083,1,265420800,265420800,18121,6040,12081,6040,0,1,6042,3327416,3.327416
6440,2800,1840,5152000,2,51526,12883,1,280268800,280268800,19321,6440,12881,6440,0,1,6442,1694065,1.694065
6840,2800,1840,5152000,2,54726,13683,1,295116800,295116800,20521,6840,13681,6840,0,1,6842,2089482,2.089482
35,3340,1545,5160300,2,286,73,1,42650200,42650200,106,35,71,35,0,1,37,116878,0.116878
535,3340,1545,5160300,2,4286,1073,1,62190200,62190200,1606,535,1071,535,0,1,537,554677,0.554677
1035,3340,1545,5160300,2,8286,2073,1,81730200,81730200,3106,1035,2071,1035,0,1,1037,1040075,1.040075
1535,3340,1545,5160300,2,12286,3073,1,101270200,101270200,4606,1535,3071,1535,0,1,1537,1527577,1.527577
2035,3340,1545,5160300,2,16286,4073,1,120810200,120810200,6106,2035,4071,2035,0,1,2037,2013529,2.013529
55,3305,1565,5172325,2,446,113,1,43521400,43521400,166,55,111,55,0,1,57,104606,0.104606
455,3305,1565,5172325,2,3646,913,1,59105400,59105400,1366,455,911,455,0,1,457,69768,0.069768
855,3305,1565,5172325,2,6846,1713,1,74689400,74689400,2566,855,1711,855,0,1,857,372756,0.372756
1255,3305,1565,5172325,2,10046,2513,1,90273400,90273400,3766,1255,2511,1255,0,1,1257,1300932,1.300932
1655,3305,1565,5172325,2,13246,3313,1,105857400,105857400,4966,1655,3311,1655,0,1,1657,714782,0.714782
2055,3305,1565,5172325,2,16446,4113,1,121441400,121441400,6166,2055,4111,2055,0,1,2057,1275470,1.27547
2455,3305,1565,5172325,2,19646,4913,1,137025400,137025400,7366,2455,4911,2455,0,1,2457,30962,0.030962
2855,3305,1565,5172325,2,22846,5713,1,152609400,152609400,8566,2855,5711,2855,0,1,2857,589185,0.589185
3255,3305,1565,5172325,2,26046,6513,1,168193400,168193400,9766,3255,6511,3255,0,1,3257,3300540,3.30054
3655,3305,1565,5172325,2,29246,7313,1,183777400,183777400,10966,3655,7311,3655,0,1,3657,3698758,3.698758
4055,3305,1565,5172325,2,32446,8113,1,199361400,199361400,12166,4055,8111,4055,0,1,4057,2394210,2.39421
4455,3305,1565,5172325,2,35646,8913,1,214945400,214945400,13366,4455,8911,4455,0,1,4457,956449,0.956449
4855,3305,1565,5172325,2,38846,9713,1,230529400,230529400,14566,4855,9711,4855,0,1,4857,3538204,3.538204
5255,3305,1565,5172325,2,42046,10513,1,246113400,246113400,15766,5255,10511,5255,0,1,5257,3000508,3.000508
5655,3305,1565,5172325,2,45246,11313,1,261697400,261697400,16966,5655,11311,5655,0,1,5657,2145154,2.145154
6055,3305,1565,5172325,2,48446,12113,1,277281400,277281400,18166,6055,12111,6055,0,1,6057,2102872,2.102872
6455,3305,1565,5172325,2,51646,12913,1,292865400,292865400,19366,6455,12911,6455,0,1,6457,1437576,1.437576
6855,3305,1565,5172325,2,54846,13713,1,308449400,308449400,20566,6855,13711,6855,0,1,6857,4117312,4.117312
35,4950,1045,5172750,2,286,73,1,43060600,43060600,106,35,71,35,0,1,37,11687,0.011687
535,4950,1045,5172750,2,4286,1073,1,67040600,67040600,1606,535,1071,535,0,1,537,209806,0.209806
1035,4950,1045,5172750,2,8286,2073,1,91020600,91020600,3106,1035,2071,1035,0,1,1037,1083993,1.083993
1535,4950,1045,5172750,2,12286,3073,1,115000600,115000600,4606,1535,3071,1535,0,1,1537,1584252,1.584252
2035,4950,1045,5172750,2,16286,4073,1,138980600,138980600,6106,2035,4071,2035,0,1,2037,338649,0.338649
2535,4950,1045,5172750,2,20286,5073,1,162960600,162960600,7606,2535,5071,2535,0,1,2537,2233082,2.233082
3035,4950,1045,5172750,2,24286,6073,1,186940600,186940600,9106,3035,6071,3035,0,1,3037,3101452,3.101452
3535,4950,1045,5172750,2,28286,7073,1,210920600,210920600,10606,3535,7071,3535,0,1,3537,3610274,3.610274
4035,4950,1045,5172750,2,32286,8073,1,234900600,234900600,12106,4035,8071,4035,0,1,4037,3055615,3.055615
4535,4950,1045,5172750,2,36286,9073,1,258880600,258880600,13606,4535,9071,4535,0,1,4537,117751,0.117751
5035,4950,1045,5172750,2,40286,10073,1,282860600,282860600,15106,5035,10071,5035,0,1,5037,1700965,1.700965
5535,4950,1045,5172750,2,44286,11073,1,306840600,306840600,16606,5535,11071,5535,0,1,5537,1320966,1.320966
6035,4950,1045,5172750,2,48286,12073,1,330820600,330820600,18106,6035,12071,6035,0,1,6037,1652395,1.652395
6535,4950,1045,5172750,2,52286,13073,1,354800600,354800600,19606,6535,13071,6535,0,1,6537,6636538,6.636538
7035,4950,1045,5172750,2,56286,14073,1,378780600,378780600,21106,7035,14071,7035,0,1,7037,7156799,7.156799
55,1305,3965,5174325,2,446,113,1,43713400,43713400,166,55,111,55,0,1,57,104803,0.104803
455,1305,3965,5174325,2,3646,913,1,60577400,60577400,1366,455,911,455,0,1,457,497690,0.49769
855,1305,3965,5174325,2,6846,1713,1,77441400,77441400,2566,855,1711,855,0,1,857,899903,0.899903
1255,1305,3965,5174325,2,10046,2513,1,94305400,94305400,3766,1255,2511,1255,0,1,1257,1057280,1.05728
1655,1305,3965,5174325,2,13246,3313,1,111169400,111169400,4966,1655,3311,1655,0,1,1657,1364195,1.364195
2055,1305,3965,5174325,2,16446,4113,1,128033400,128033400,6166,2055,4111,2055,0,1,2057,613190,0.61319
2455,1305,3965,5174325,2,19646,4913,1,144897400,144897400,7366,2455,4911,2455,0,1,2457,523720,0.52372
2855,1305,3965,5174325,2,22846,5713,1,161761400,161761400,8566,2855,5711,2855,0,1,2857,1703498,1.703498
3255,1305,3965,5174325,2,26046,6513,1,178625400,178625400,9766,3255,6511,3255,0,1,3257,119541,0.119541
3655,1305,3965,5174325,2,29246,7313,1,195489400,195489400,10966,3655,7311,3655,0,1,3657,816686,0.816686
4055,1305,3965,5174325,2,32446,8113,1,212353400,212353400,12166,4055,8111,4055,0,1,4057,929271,0.929271
4455,1305,3965,5174325,2,35646,8913,1,229217400,229217400,13366,4455,8911,4455,0,1,4457,296883,0.296883
4855,1305,3965,5174325,2,38846,9713,1,246081400,246081400,14566,4855,9711,4855,0,1,4857,2360228,2.360228
5255,1305,3965,5174325,2,42046,10513,1,262945400,262945400,15766,5255,10511,5255,0,1,5257,154728,0.154728
5655,1305,3965,5174325,2,45246,11313,1,279809400,279809400,16966,5655,11311,5655,0,1,5657,2175336,2.175336
6055,1305,3965,5174325,2,48446,12113,1,296673400,296673400,18166,6055,12111,6055,0,1,6057,1351486,1.351486
6455,1305,3965,5174325,2,51646,12913,1,313537400,313537400,19366,6455,12911,6455,0,1,6457,840874,0.840874
6855,1305,3965,5174325,2,54846,13713,1,330401400,330401400,20566,6855,13711,6855,0,1,6857,630113,0.630113
40,1550,3340,5177000,2,326,83,1,42980800,42980800,121,40,81,40,0,1,42,97602,0.097602
440,1550,3340,5177000,2,3526,883,1,58628800,58628800,1321,440,881,440,0,1,442,476000,0.476
840,1550,3340,5177000,2,6726,1683,1,74276800,74276800,2521,840,1681,840,0,1,842,872116,0.872116
1240,1550,3340,5177000,2,9926,2483,1,89924800,89924800,3721,1240,2481,1240,0,1,1242,1270477,1.270477
1640,1550,3340,5177000,2,13126,3283,1,105572800,105572800,4921,1640,3281,1640,0,1,1642,88575,0.088575
2040,1550,3340,5177000,2,16326,4083,1,121220800,121220800,6121,2040,4081,2040,0,1,2042,238436,0.238436
2440,1550,3340,5177000,2,19526,4883,1,136868800,136868800,7321,2440,4881,2440,0,1,2442,1526739,1.526739
2840,1550,3340,5177000,2,22726,5683,1,152516800,152516800,8521,2840,5681,2840,0,1,2842,2862197,2.862197
3240,1550,3340,5177000,2,25926,6483,1,168164800,168164800,9721,3240,6481,3240,0,1,3242,2542383,2.542383
3640,1550,3340,5177000,2,29126,7283,1,183812800,183812800,10921,3640,7281,3640,0,1,3642,3373442,3.373442
4040,1550,3340,5177000,2,32326,8083,1,199460800,199460800,12121,4040,8081,4040,0,1,4042,3785347,3.785347
4440,1550,3340,5177000,2,35526,8883,1,215108800,215108800,13321,4440,8881,4440,0,1,4442,4467905,4.467905
4840,1550,3340,5177000,2,38726,9683,1,230756800,230756800,14521,4840,9681,4840,0,1,4842,1290663,1.290663
5240,1550,3340,5177000,2,41926,10483,1,246404800,246404800,15721,5240,10481,5240,0,1,5242,2379377,2.379377
5640,1550,3340,5177000,2,45126,11283,1,262052800,262052800,16921,5640,11281,5640,0,1,5642,3711287,3.711287
6040,1550,3340,5177000,2,48326,12083,1,277700800,277700800,18121,6040,12081,6040,0,1,6042,818946,0.818946
6440,1550,3340,5177000,2,51526,12883,1,293348800,293348800,19321,6440,12881,6440,0,1,6442,368375,0.368375
6840,1550,3340,5177000,2,54726,13683,1,308996800,308996800,20521,6840,13681,6840,0,1,6842,760912,0.760912
35,1140,4545,5181300,2,286,73,1,43042200,43042200,106,35,71,35,0,1,37,101526,0.101526
535,1140,4545,5181300,2,4286,1073,1,65782200,65782200,1606,535,1071,535,0,1,537,561643,0.561643
1035,1140,4545,5181300,2,8286,2073,1,88522200,88522200,3106,1035,2071,1035,0,1,1037,1037145,1.037145
1535,1140,4545,5181300,2,12286,3073,1,111262200,111262200,4606,1535,3071,1535,0,1,1537,1533308,1.533308
2035,1140,4545,5181300,2,16286,4073,1,134002200,134002200,6106,2035,4071,2035,0,1,2037,2018236,2.018236
2535,1140,4545,5181300,2,20286,5073,1,156742200,156742200,7606,2535,5071,2535,0,1,2537,2507431,2.507431
3035,1140,4545,5181300,2,24286,6073,1,179482200,179482200,9106,3035,6071,3035,0,1,3037,2993862,2.993862
3535,1140,4545,5181300,2,28286,7073,1,202222200,202222200,10606,3535,7071,3535,0,1,3537,3496732,3.496732
4035,1140,4545,5181300,2,32286,8073,1,224962200,224962200,12106,4035,8071,4035,0,1,4037,3974487,3.974487
39,1143,4541,5190363,2,318,81,1,43296312,43296312,118,39,79,39,0,1,41,20459,0.020459
539,1143,4541,5190363,2,4318,1081,1,66032312,66032312,1618,539,1079,539,0,1,541,70542,0.070542
1039,1143,4541,5190363,2,8318,2081,1,88768312,88768312,3118,1039,2079,1039,0,1,1041,26757,0.026757
1539,1143,4541,5190363,2,12318,3081,1,111504312,111504312,4618,1539,3079,1539,0,1,1541,29500,0.0295
2039,1143,4541,5190363,2,16318,4081,1,134240312,134240312,6118,2039,4079,2039,0,1,2041,179592,0.179592
2539,1143,4541,5190363,2,20318,5081,1,156976312,156976312,7618,2539,5079,2539,0,1,2541,139595,0.139595
3039,1143,4541,5190363,2,24318,6081,1,179712312,179712312,9118,3039,6079,3039,0,1,3041,325828,0.325828
3539,1143,4541,5190363,2,28318,7081,1,202448312,202448312,10618,3539,7079,3539,0,1,3541,506735,0.506735
4039,1143,4541,5190363,2,32318,8081,1,225184312,225184312,12118,4039,8079,4039,0,1,4041,56065,0.056065
4539,1143,4541,5190363,2,36318,9081,1,247920312,247920312,13618,4539,9079,4539,0,1,4541,1192275,1.192275
5039,1143,4541,5190363,2,40318,10081,1,270656312,270656312,15118,5039,10079,5039,0,1,5041,412088,0.412088
5539,1143,4541,5190363,2,44318,11081,1,293392312,293392312,16618,5539,11079,5539,0,1,5541,1280754,1.280754
6039,1143,4541,5190363,2,48318,12081,1,316128312,316128312,18118,6039,12079,6039,0,1,6041,476516,0.476516
6539,1143,4541,5190363,2,52318,13081,1,338864312,338864312,19618,6539,13079,6539,0,1,6541,859178,0.859178
7039,1143,4541,5190363,2,56318,14081,1,361600312,361600312,21118,7039,14079,7039,0,1,7041,5308907,5.308907
39,4993,1041,5197713,2,318,81,1,43464312,43464312,118,39,79,39,0,1,41,90719,0.090719
539,4993,1041,5197713,2,4318,1081,1,67600312,67600312,1618,539,1079,539,0,1,541,565870,0.56587
1039,4993,1041,5197713,2,8318,2081,1,91736312,91736312,3118,1039,2079,1039,0,1,1041,1053997,1.053997
1539,4993,1041,5197713,2,12318,3081,1,115872312,115872312,4618,1539,3079,1539,0,1,1541,1544732,1.544732
2039,4993,1041,5197713,2,16318,4081,1,140008312,140008312,6118,2039,4079,2039,0,1,2041,1028490,1.02849
2539,4993,1041,5197713,2,20318,5081,1,164144312,164144312,7618,2539,5079,2539,0,1,2541,1887032,1.887032
3039,4993,1041,5197713,2,24318,6081,1,188280312,188280312,9118,3039,6079,3039,0,1,3041,3027477,3.027477
3539,4993,1041,5197713,2,28318,7081,1,212416312,212416312,10618,3539,7079,3539,0,1,3541,3513163,3.513163
4039,4993,1041,5197713,2,32318,8081,1,236552312,236552312,12118,4039,8079,4039,0,1,4041,874419,0.874419
4539,4993,1041,5197713,2,36318,9081,1,260688312,260688312,13618,4539,9079,4539,0,1,4541,1293109,1.293109
5039,4993,1041,5197713,2,40318,10081,1,284824312,284824312,15118,5039,10079,5039,0,1,5041,2364640,2.36464
5539,4993,1041,5197713,2,44318,11081,1,308960312,308960312,16618,5539,11079,5539,0,1,5541,5446870,5.44687
6039,4993,1041,5197713,2,48318,12081,1,333096312,333096312,18118,6039,12079,6039,0,1,6041,5945516,5.945516
6539,4993,1041,5197713,2,52318,13081,1,357232312,357232312,19618,6539,13079,6539,0,1,6541,6434562,6.434562
7039,4993,1041,5197713,2,56318,14081,1,381368312,381368312,21118,7039,14079,7039,0,1,7041,6945013,6.945013
44,1703,3055,5202665,2,358,91,1,43296136,43296136,133,44,89,44,0,1,46,96694,0.096694
544,1703,3055,5202665,2,4358,1091,1,62328136,62328136,1633,544,1089,544,0,1,546,123359,0.123359
1044,1703,3055,5202665,2,8358,2091,1,81360136,81360136,3133,1044,2089,1044,0,1,1046,58443,0.058443
1544,1703,3055,5202665,2,12358,3091,1,100392136,100392136,4633,1544,3089,1544,0,1,1546,269589,0.269589
2044,1703,3055,5202665,2,16358,4091,1,119424136,119424136,6133,2044,4089,2044,0,1,2046,1698232,1.698232
2544,1703,3055,5202665,2,20358,5091,1,138456136,138456136,7633,2544,5089,2544,0,1,2546,1012475,1.012475
3044,1703,3055,5202665,2,24358,6091,1,157488136,157488136,9133,3044,6089,3044,0,1,3046,3119438,3.119438
3544,1703,3055,5202665,2,28358,7091,1,176520136,176520136,10633,3544,7089,3544,0,1,3546,903529,0.903529
4044,1703,3055,5202665,2,32358,8091,1,195552136,195552136,12133,4044,8089,4044,0,1,4046,1751164,1.751164
4544,1703,3055,5202665,2,36358,9091,1,214584136,214584136,13633,4544,9089,4544,0,1,4546,2255175,2.255175
5044,1703,3055,5202665,2,40358,10091,1,233616136,233616136,15133,5044,10089,5044,0,1,5046,3480398,3.480398
5544,1703,3055,5202665,2,44358,11091,1,252648136,252648136,16633,5544,11089,5544,0,1,5546,2746812,2.746812
6044,1703,3055,5202665,2,48358,12091,1,271680136,271680136,18133,6044,12089,6044,0,1,6046,1273760,1.27376
6544,1703,3055,5202665,2,52358,13091,1,290712136,290712136,19633,6544,13089,6544,0,1,6546,2863506,2.863506
7044,1703,3055,5202665,2,56358,14091,1,309744136,309744136,21133,7044,14089,7044,0,1,7046,309903,0.309903
44,3353,1555,5213915,2,358,91,1,43438936,43438936,133,44,89,44,0,1,46,8399,0.008399
544,3353,1555,5213915,2,4358,1091,1,63070936,63070936,1633,544,1089,544,0,1,546,19616,0.019616
1044,3353,1555,5213915,2,8358,2091,1,82702936,82702936,3133,1044,2089,1044,0,1,1046,163532,0.163532
1544,3353,1555,5213915,2,12358,3091,1,102334936,102334936,4633,1544,3089,1544,0,1,1546,337913,0.337913
2044,3353,1555,5213915,2,16358,4091,1,121966936,121966936,6133,2044,4089,2044,0,1,2046,822708,0.822708
2544,3353,1555,5213915,2,20358,5091,1,141598936,141598936,7633,2544,5089,2544,0,1,2546,309729,0.309729
3044,3353,1555,5213915,2,24358,6091,1,161230936,161230936,9133,3044,6089,3044,0,1,3046,5539,0.005539
3544,3353,1555,5213915,2,28358,7091,1,180862936,180862936,10633,3544,7089,3544,0,1,3546,516908,0.516908
4044,3353,1555,5213915,2,32358,8091,1,200494936,200494936,12133,4044,8089,4044,0,1,4046,1034273,1.034273
4544,3353,1555,5213915,2,36358,9091,1,220126936,220126936,13633,4544,9089,4544,0,1,4546,39502,0.039502
5044,3353,1555,5213915,2,40358,10091,1,239758936,239758936,15133,5044,10089,5044,0,1,5046,2332864,2.332864
5544,3353,1555,5213915,2,44358,11091,1,259390936,259390936,16633,5544,11089,5544,0,1,5546,2316665,2.316665
6044,3353,1555,5213915,2,48358,12091,1,279022936,279022936,18133,6044,12089,6044,0,1,6046,1172103,1.172103
6544,3353,1555,5213915,2,52358,13091,1,298654936,298654936,19633,6544,13089,6544,0,1,6546,4045667,4.045667
7044,3353,1555,5213915,2,56358,14091,1,318286936,318286936,21133,7044,14089,7044,0,1,7046,1228925,1.228925
40,5550,940,5217000,2,326,83,1,43812800,43812800,121,40,81,40,0,1,42,94412,0.094412
440,5550,940,5217000,2,3526,883,1,64580800,64580800,1321,440,881,440,0,1,442,485973,0.485973
840,5550,940,5217000,2,6726,1683,1,85348800,85348800,2521,840,1681,840,0,1,842,148466,0.148466
1240,5550,940,5217000,2,9926,2483,1,106116800,106116800,3721,1240,2481,1240,0,1,1242,741707,0.741707
1640,5550,940,5217000,2,13126,3283,1,126884800,126884800,4921,1640,3281,1640,0,1,1642,1690883,1.690883
2040,5550,940,5217000,2,16326,4083,1,147652800,147652800,6121,2040,4081,2040,0,1,2042,157615,0.157615
2440,5550,940,5217000,2,19526,4883,1,168420800,168420800,7321,2440,4881,2440,0,1,2442,2296973,2.296973
2840,5550,940,5217000,2,22726,5683,1,189188800,189188800,8521,2840,5681,2840,0,1,2842,2931940,2.93194
3240,5550,940,5217000,2,25926,6483,1,209956800,209956800,9721,3240,6481,3240,0,1,3242,17478,0.017478
3640,5550,940,5217000,2,29126,7283,1,230724800,230724800,10921,3640,7281,3640,0,1,3642,3722207,3.722207
4040,5550,940,5217000,2,32326,8083,1,251492800,251492800,12121,4040,8081,4040,0,1,4042,2821146,2.821146
4440,5550,940,5217000,2,35526,8883,1,272260800,272260800,13321,4440,8881,4440,0,1,4442,4537239,4.537239
4840,5550,940,5217000,2,38726,9683,1,293028800,293028800,14521,4840,9681,4840,0,1,4842,4942092,4.942092
5240,5550,940,5217000,2,41926,10483,1,313796800,313796800,15721,5240,10481,5240,0,1,5242,439634,0.439634
5640,5550,940,5217000,2,45126,11283,1,334564800,334564800,16921,5640,11281,5640,0,1,5642,4168200,4.1682
6040,5550,940,5217000,2,48326,12083,1,355332800,355332800,18121,6040,12081,6040,0,1,6042,5118231,5.118231
6440,5550,940,5217000,2,51526,12883,1,376100800,376100800,19321,6440,12881,6440,0,1,6442,5289008,5.289008
6840,5550,940,5217000,2,54726,13683,1,396868800,396868800,20521,6840,13681,6840,0,1,6842,7017216,7.017216
55,2805,1865,5231325,2,446,113,1,43905400,43905400,166,55,111,55,0,1,57,105085,0.105085
455,2805,1865,5231325,2,3646,913,1,58849400,58849400,1366,455,911,455,0,1,457,485924,0.485924
855,2805,1865,5231325,2,6846,1713,1,73793400,73793400,2566,855,1711,855,0,1,857,818421,0.818421
1255,2805,1865,5231325,2,10046,2513,1,88737400,88737400,3766,1255,2511,1255,0,1,1257,167503,0.167503
1655,2805,1865,5231325,2,13246,3313,1,103681400,103681400,4966,1655,3311,1655,0,1,1657,1652558,1.652558
2055,2805,1865,5231325,2,16446,4113,1,118625400,118625400,6166,2055,4111,2055,0,1,2057,1546891,1.546891
2455,2805,1865,5231325,2,19646,4913,1,133569400,133569400,7366,2455,4911,2455,0,1,2457,1252448,1.252448
2855,2805,1865,5231325,2,22846,5713,1,148513400,148513400,8566,2855,5711,2855,0,1,2857,2818160,2.81816
3255,2805,1865,5231325,2,26046,6513,1,163457400,163457400,9766,3255,6511,3255,0,1,3257,76364,0.076364
3655,2805,1865,5231325,2,29246,7313,1,178401400,178401400,10966,3655,7311,3655,0,1,3657,3599813,3.599813
4055,2805,1865,5231325,2,32446,8113,1,193345400,193345400,12166,4055,8111,4055,0,1,4057,3991241,3.991241
4455,2805,1865,5231325,2,35646,8913,1,208289400,208289400,13366,4455,8911,4455,0,1,4457,1681577,1.681577
4855,2805,1865,5231325,2,38846,9713,1,223233400,223233400,14566,4855,9711,4855,0,1,4857,3975694,3.975694
5255,2805,1865,5231325,2,42046,10513,1,238177400,238177400,15766,5255,10511,5255,0,1,5257,3921917,3.921917
5655,2805,1865,5231325,2,45246,11313,1,253121400,253121400,16966,5655,11311,5655,0,1,5657,1276560,1.27656
6055,2805,1865,5231325,2,48446,12113,1,268065400,268065400,18166,6055,12111,6055,0,1,6057,255661,0.255661
6455,2805,1865,5231325,2,51646,12913,1,283009400,283009400,19366,6455,12911,6455,0,1,6457,789566,0.789566
6855,2805,1865,5231325,2,54846,13713,1,297953400,297953400,20566,6855,13711,6855,0,1,6857,6753248,6.753248
55,1555,3365,5232575,2,446,113,1,44025400,44025400,166,55,111,55,0,1,57,108305,0.108305
455,1555,3365,5232575,2,3646,913,1,59769400,59769400,1366,455,911,455,0,1,457,504358,0.504358
855,1555,3365,5232575,2,6846,1713,1,75513400,75513400,2566,855,1711,855,0,1,857,580080,0.58008
1255,1555,3365,5232575,2,10046,2513,1,91257400,91257400,3766,1255,2511,1255,0,1,1257,41133,0.041133
1655,1555,3365,5232575,2,13246,3313,1,107001400,107001400,4966,1655,3311,1655,0,1,1657,1710395,1.710395
2055,1555,3365,5232575,2,16446,4113,1,122745400,122745400,6166,2055,4111,2055,0,1,2057,99133,0.099133
2455,1555,3365,5232575,2,19646,4913,1,138489400,138489400,7366,2455,4911,2455,0,1,2457,2522774,2.522774
2855,1555,3365,5232575,2,22846,5713,1,154233400,154233400,8566,2855,5711,2855,0,1,2857,283591,0.283591
3255,1555,3365,5232575,2,26046,6513,1,169977400,169977400,9766,3255,6511,3255,0,1,3257,1937136,1.937136
3655,1555,3365,5232575,2,29246,7313,1,185721400,185721400,10966,3655,7311,3655,0,1,3657,3746674,3.746674
4055,1555,3365,5232575,2,32446,8113,1,201465400,201465400,12166,4055,8111,4055,0,1,4057,1926474,1.926474
4455,1555,3365,5232575,2,35646,8913,1,217209400,217209400,13366,4455,8911,4455,0,1,4457,3883573,3.883573
4855,1555,3365,5232575,2,38846,9713,1,232953400,232953400,14566,4855,9711,4855,0,1,4857,196697,0.196697
5255,1555,3365,5232575,2,42046,10513,1,248697400,248697400,15766,5255,10511,5255,0,1,5257,2326221,2.326221
5655,1555,3365,5232575,2,45246,11313,1,264441400,264441400,16966,5655,11311,5655,0,1,5657,86792,0.086792
6055,1555,3365,5232575,2,48446,12113,1,280185400,280185400,18166,6055,12111,6055,0,1,6057,661150,0.66115
6455,1555,3365,5232575,2,51646,12913,1,295929400,295929400,19366,6455,12911,6455,0,1,6457,6599524,6.599524
6855,1555,3365,5232575,2,54846,13713,1,311673400,311673400,20566,6855,13711,6855,0,1,6857,2014033,2.014033
44,1153,4555,5251915,2,358,91,1,44024536,44024536,133,44,89,44,0,1,46,33368,0.033368
544,1153,4555,5251915,2,4358,1091,1,66856536,66856536,1633,544,1089,544,0,1,546,12190,0.01219
1044,1153,4555,5251915,2,8358,2091,1,89688536,89688536,3133,1044,2089,1044,0,1,1046,81584,0.081584
1544,1153,4555,5251915,2,12358,3091,1,112520536,112520536,4633,1544,3089,1544,0,1,1546,260388,0.260388
2044,1153,4555,5251915,2,16358,4091,1,135352536,135352536,6133,2044,4089,2044,0,1,2046,155428,0.155428
2544,1153,4555,5251915,2,20358,5091,1,158184536,158184536,7633,2544,5089,2544,0,1,2546,202134,0.202134
3044,1153,4555,5251915,2,24358,6091,1,181016536,181016536,9133,3044,6089,3044,0,1,3046,673593,0.673593
3544,1153,4555,5251915,2,28358,7091,1,203848536,203848536,10633,3544,7089,3544,0,1,3546,872358,0.872358
4044,1153,4555,5251915,2,32358,8091,1,226680536,226680536,12133,4044,8089,4044,0,1,4046,407799,0.407799
4544,1153,4555,5251915,2,36358,9091,1,249512536,249512536,13633,4544,9089,4544,0,1,4546,35722,0.035722
5044,1153,4555,5251915,2,40358,10091,1,272344536,272344536,15133,5044,10089,5044,0,1,5046,256664,0.256664
5544,1153,4555,5251915,2,44358,11091,1,295176536,295176536,16633,5544,11089,5544,0,1,5546,88562,0.088562
6044,1153,4555,5251915,2,48358,12091,1,318008536,318008536,18133,6044,12089,6044,0,1,6046,2087296,2.087296
6544,1153,4555,5251915,2,52358,13091,1,340840536,340840536,19633,6544,13089,6544,0,1,6546,2132079,2.132079
7044,1153,4555,5251915,2,56358,14091,1,363672536,363672536,21133,7044,14089,7044,0,1,7046,156614,0.156614
44,5003,1055,5278165,2,358,91,1,44357736,44357736,133,44,89,44,0,1,46,96263,0.096263
544,5003,1055,5278165,2,4358,1091,1,68589736,68589736,1633,544,1089,544,0,1,546,9717,0.009717
1044,5003,1055,5278165,2,8358,2091,1,92821736,92821736,3133,1044,2089,1044,0,1,1046,1076657,1.076657
1544,5003,1055,5278165,2,12358,3091,1,117053736,117053736,4633,1544,3089,1544,0,1,1546,1216222,1.216222
2044,5003,1055,5278165,2,16358,4091,1,141285736,141285736,6133,2044,4089,2044,0,1,2046,1384766,1.384766
2544,5003,1055,5278165,2,20358,5091,1,165517736,165517736,7633,2544,5089,2544,0,1,2546,1320796,1.320796
3044,5003,1055,5278165,2,24358,6091,1,189749736,189749736,9133,3044,6089,3044,0,1,3046,3076503,3.076503
3544,5003,1055,5278165,2,28358,7091,1,213981736,213981736,10633,3544,7089,3544,0,1,3546,2221949,2.221949
4044,5003,1055,5278165,2,32358,8091,1,238213736,238213736,12133,4044,8089,4044,0,1,4046,521813,0.521813
4544,5003,1055,5278165,2,36358,9091,1,262445736,262445736,13633,4544,9089,4544,0,1,4546,4556796,4.556796
5044,5003,1055,5278165,2,40358,10091,1,286677736,286677736,15133,5044,10089,5044,0,1,5046,5091661,5.091661
5544,5003,1055,5278165,2,44358,11091,1,310909736,310909736,16633,5544,11089,5544,0,1,5546,5557134,5.557134
6044,5003,1055,5278165,2,48358,12091,1,335141736,335141736,18133,6044,12089,6044,0,1,6046,6075687,6.075687
6544,5003,1055,5278165,2,52358,13091,1,359373736,359373736,19633,6544,13089,6544,0,1,6546,6619095,6.619095
7044,5003,1055,5278165,2,56358,14091,1,383605736,383605736,21133,7044,14089,7044,0,1,7046,7051615,7.051615
40,800,6640,5312000,2,326,83,1,44876800,44876800,121,40,81,40,0,1,42,96134,0.096134
440,800,6640,5312000,2,3526,883,1,68684800,68684800,1321,440,881,440,0,1,442,113206,0.113206
840,800,6640,5312000,2,6726,1683,1,92492800,92492800,2521,840,1681,840,0,1,842,21780,0.02178
1240,800,6640,5312000,2,9926,2483,1,116300800,116300800,3721,1240,2481,1240,0,1,1242,485280,0.48528
1640,800,6640,5312000,2,13126,3283,1,140108800,140108800,4921,1640,3281,1640,0,1,1642,827288,0.827288
2040,800,6640,5312000,2,16326,4083,1,163916800,163916800,6121,2040,4081,2040,0,1,2042,258886,0.258886
2440,800,6640,5312000,2,19526,4883,1,187724800,187724800,7321,2440,4881,2440,0,1,2442,2419669,2.419669
2840,800,6640,5312000,2,22726,5683,1,211532800,211532800,8521,2840,5681,2840,0,1,2842,177106,0.177106
3240,800,6640,5312000,2,25926,6483,1,235340800,235340800,9721,3240,6481,3240,0,1,3242,1340199,1.340199
3640,800,6640,5312000,2,29126,7283,1,259148800,259148800,10921,3640,7281,3640,0,1,3642,100446,0.100446
4040,800,6640,5312000,2,32326,8083,1,282956800,282956800,12121,4040,8081,4040,0,1,4042,666790,0.66679
4440,800,6640,5312000,2,35526,8883,1,306764800,306764800,13321,4440,8881,4440,0,1,4442,875315,0.875315
4840,800,6640,5312000,2,38726,9683,1,330572800,330572800,14521,4840,9681,4840,0,1,4842,737609,0.737609
5240,800,6640,5312000,2,41926,10483,1,354380800,354380800,15721,5240,10481,5240,0,1,5242,597082,0.597082
5640,800,6640,5312000,2,45126,11283,1,378188800,378188800,16921,5640,11281,5640,0,1,5642,1002002,1.002002
6040,800,6640,5312000,2,48326,12083,1,401996800,401996800,18121,6040,12081,6040,0,1,6042,389304,0.389304
6440,800,6640,5312000,2,51526,12883,1,425804800,425804800,19321,6440,12881,6440,0,1,6442,2692119,2.692119
6840,800,6640,5312000,2,54726,13683,1,449612800,449612800,20521,6840,13681,6840,0,1,6842,1384754,1.384754
40,4300,1240,5332000,2,326,83,1,44428800,44428800,121,40,81,40,0,1,42,29680,0.02968
440,4300,1240,5332000,2,3526,883,1,62156800,62156800,1321,440,881,440,0,1,442,478551,0.478551
840,4300,1240,5332000,2,6726,1683,1,79884800,79884800,2521,840,1681,840,0,1,842,169432,0.169432
1240,4300,1240,5332000,2,9926,2483,1,97612800,97612800,3721,1240,2481,1240,0,1,1242,150170,0.15017
1640,4300,1240,5332000,2,13126,3283,1,115340800,115340800,4921,1640,3281,1640,0,1,1642,1648757,1.648757
2040,4300,1240,5332000,2,16326,4083,1,133068800,133068800,6121,2040,4081,2040,0,1,2042,1147653,1.147653
2440,4300,1240,5332000,2,19526,4883,1,150796800,150796800,7321,2440,4881,2440,0,1,2442,248124,0.248124
2840,4300,1240,5332000,2,22726,5683,1,168524800,168524800,8521,2840,5681,2840,0,1,2842,1035643,1.035643
3240,4300,1240,5332000,2,25926,6483,1,186252800,186252800,9721,3240,6481,3240,0,1,3242,1770766,1.770766
3640,4300,1240,5332000,2,29126,7283,1,203980800,203980800,10921,3640,7281,3640,0,1,3642,689232,0.689232
4040,4300,1240,5332000,2,32326,8083,1,221708800,221708800,12121,4040,8081,4040,0,1,4042,67622,0.067622
4440,4300,1240,5332000,2,35526,8883,1,239436800,239436800,13321,4440,8881,4440,0,1,4442,887306,0.887306
4840,4300,1240,5332000,2,38726,9683,1,257164800,257164800,14521,4840,9681,4840,0,1,4842,4232496,4.232496
5240,4300,1240,5332000,2,41926,10483,1,274892800,274892800,15721,5240,10481,5240,0,1,5242,394453,0.394453
5640,4300,1240,5332000,2,45126,11283,1,292620800,292620800,16921,5640,11281,5640,0,1,5642,1776593,1.776593
6040,4300,1240,5332000,2,48326,12083,1,310348800,310348800,18121,6040,12081,6040,0,1,6042,274809,0.274809
6440,4300,1240,5332000,2,51526,12883,1,328076800,328076800,19321,6440,12881,6440,0,1,6442,1181678,1.181678
6840,4300,1240,5332000,2,54726,13683,1,345804800,345804800,20521,6840,13681,6840,0,1,6842,1323484,1.323484
55,5555,965,5360575,2,446,113,1,45753400,45753400,166,55,111,55,0,1,57,105782,0.105782
455,5555,965,5360575,2,3646,913,1,66617400,66617400,1366,455,911,455,0,1,457,512347,0.512347
855,5555,965,5360575,2,6846,1713,1,87481400,87481400,2566,855,1711,855,0,1,857,925265,0.925265
1255,5555,965,5360575,2,10046,2513,1,108345400,108345400,3766,1255,2511,1255,0,1,1257,554761,0.554761
1655,5555,965,5360575,2,13246,3313,1,129209400,129209400,4966,1655,3311,1655,0,1,1657,1592980,1.59298
2055,5555,965,5360575,2,16446,4113,1,150073400,150073400,6166,2055,4111,2055,0,1,2057,2157008,2.157008
2455,5555,965,5360575,2,19646,4913,1,170937400,170937400,7366,2455,4911,2455,0,1,2457,2583920,2.58392
2855,5555,965,5360575,2,22846,5713,1,191801400,191801400,8566,2855,5711,2855,0,1,2857,2997739,2.997739
3255,5555,965,5360575,2,26046,6513,1,212665400,212665400,9766,3255,6511,3255,0,1,3257,34811,0.034811
3655,5555,965,5360575,2,29246,7313,1,233529400,233529400,10966,3655,7311,3655,0,1,3657,3742499,3.742499
4055,5555,965,5360575,2,32446,8113,1,254393400,254393400,12166,4055,8111,4055,0,1,4057,1190050,1.19005
4455,5555,965,5360575,2,35646,8913,1,275257400,275257400,13366,4455,8911,4455,0,1,4457,4665427,4.665427
4855,5555,965,5360575,2,38846,9713,1,296121400,296121400,14566,4855,9711,4855,0,1,4857,1992416,1.992416
5255,5555,965,5360575,2,42046,10513,1,316985400,316985400,15766,5255,10511,5255,0,1,5257,5118744,5.118744
5655,5555,965,5360575,2,45246,11313,1,337849400,337849400,16966,5655,11311,5655,0,1,5657,672310,0.67231
6055,5555,965,5360575,2,48446,12113,1,358713400,358713400,18166,6055,12111,6055,0,1,6057,635769,0.635769
6455,5555,965,5360575,2,51646,12913,1,379577400,379577400,19366,6455,12911,6455,0,1,6457,2219575,2.219575
6855,5555,965,5360575,2,54846,13713,1,400441400,400441400,20566,6855,13711,6855,0,1,6857,402758,0.402758
55,805,6665,5365325,2,446,113,1,46209400,46209400,166,55,111,55,0,1,57,111295,0.111295
455,805,6665,5365325,2,3646,913,1,70113400,70113400,1366,455,911,455,0,1,457,510779,0.510779
855,805,6665,5365325,2,6846,1713,1,94017400,94017400,2566,855,1711,855,0,1,857,327660,0.32766
1255,805,6665,5365325,2,10046,2513,1,117921400,117921400,3766,1255,2511,1255,0,1,1257,980619,0.980619
1655,805,6665,5365325,2,13246,3313,1,141825400,141825400,4966,1655,3311,1655,0,1,1657,1724012,1.724012
2055,805,6665,5365325,2,16446,4113,1,165729400,165729400,6166,2055,4111,2055,0,1,2057,530319,0.530319
2455,805,6665,5365325,2,19646,4913,1,189633400,189633400,7366,2455,4911,2455,0,1,2457,1848889,1.848889
2855,805,6665,5365325,2,22846,5713,1,213537400,213537400,8566,2855,5711,2855,0,1,2857,267950,0.26795
3255,805,6665,5365325,2,26046,6513,1,237441400,237441400,9766,3255,6511,3255,0,1,3257,28851,0.028851
3655,805,6665,5365325,2,29246,7313,1,261345400,261345400,10966,3655,7311,3655,0,1,3657,567417,0.567417
4055,805,6665,5365325,2,32446,8113,1,285249400,285249400,12166,4055,8111,4055,0,1,4057,976543,0.976543
4455,805,6665,5365325,2,35646,8913,1,309153400,309153400,13366,4455,8911,4455,0,1,4457,1041773,1.041773
4855,805,6665,5365325,2,38846,9713,1,333057400,333057400,14566,4855,9711,4855,0,1,4857,404367,0.404367
5255,805,6665,5365325,2,42046,10513,1,356961400,356961400,15766,5255,10511,5255,0,1,5257,832174,0.832174
5655,805,6665,5365325,2,45246,11313,1,380865400,380865400,16966,5655,11311,5655,0,1,5657,2405005,2.405005
6055,805,6665,5365325,2,48446,12113,1,404769400,404769400,18166,6055,12111,6055,0,1,6057,1009345,1.009345
6455,805,6665,5365325,2,51646,12913,1,428673400,428673400,19366,6455,12911,6455,0,1,6457,714551,0.714551
6855,805,6665,5365325,2,54846,13713,1,452577400,452577400,20566,6855,13711,6855,0,1,6857,903315,0.903315
40,1050,5140,5397000,2,326,83,1,45156800,45156800,121,40,81,40,0,1,42,11511,0.011511
440,1050,5140,5397000,2,3526,883,1,64964800,64964800,1321,440,881,440,0,1,442,23491,0.023491
840,1050,5140,5397000,2,6726,1683,1,84772800,84772800,2521,840,1681,840,0,1,842,132778,0.132778
1240,1050,5140,5397000,2,9926,2483,1,104580800,104580800,3721,1240,2481,1240,0,1,1242,11757,0.011757
1640,1050,5140,5397000,2,13126,3283,1,124388800,124388800,4921,1640,3281,1640,0,1,1642,137741,0.137741
2040,1050,5140,5397000,2,16326,4083,1,144196800,144196800,6121,2040,4081,2040,0,1,2042,84573,0.084573
2440,1050,5140,5397000,2,19526,4883,1,164004800,164004800,7321,2440,4881,2440,0,1,2442,223723,0.223723
2840,1050,5140,5397000,2,22726,5683,1,183812800,183812800,8521,2840,5681,2840,0,1,2842,192364,0.192364
3240,1050,5140,5397000,2,25926,6483,1,203620800,203620800,9721,3240,6481,3240,0,1,3242,185036,0.185036
3640,1050,5140,5397000,2,29126,7283,1,223428800,223428800,10921,3640,7281,3640,0,1,3642,198681,0.198681
4040,1050,5140,5397000,2,32326,8083,1,243236800,243236800,12121,4040,8081,4040,0,1,4042,473042,0.473042
4440,1050,5140,5397000,2,35526,8883,1,263044800,263044800,13321,4440,8881,4440,0,1,4442,83251,0.083251
4840,1050,5140,5397000,2,38726,9683,1,282852800,282852800,14521,4840,9681,4840,0,1,4842,72342,0.072342
5240,1050,5140,5397000,2,41926,10483,1,302660800,302660800,15721,5240,10481,5240,0,1,5242,464056,0.464056
5640,1050,5140,5397000,2,45126,11283,1,322468800,322468800,16921,5640,11281,5640,0,1,5642,962773,0.962773
6040,1050,5140,5397000,2,48326,12083,1,342276800,342276800,18121,6040,12081,6040,0,1,6042,645374,0.645374
6440,1050,5140,5397000,2,51526,12883,1,362084800,362084800,19321,6440,12881,6440,0,1,6442,854144,0.854144
6840,1050,5140,5397000,2,54726,13683,1,381892800,381892800,20521,6840,13681,6840,0,1,6842,312130,0.31213
55,4305,1265,5445825,2,446,113,1,46017400,46017400,166,55,111,55,0,1,57,110051,0.110051
455,4305,1265,5445825,2,3646,913,1,63841400,63841400,1366,455,911,455,0,1,457,505967,0.505967
855,4305,1265,5445825,2,6846,1713,1,81665400,81665400,2566,855,1711,855,0,1,857,433210,0.43321
1255,4305,1265,5445825,2,10046,2513,1,99489400,99489400,3766,1255,2511,1255,0,1,1257,113872,0.113872
1655,4305,1265,5445825,2,13246,3313,1,117313400,117313400,4966,1655,3311,1655,0,1,1657,1744223,1.744223
2055,4305,1265,5445825,2,16446,4113,1,135137400,135137400,6166,2055,4111,2055,0,1,2057,664252,0.664252
2455,4305,1265,5445825,2,19646,4913,1,152961400,152961400,7366,2455,4911,2455,0,1,2457,1543655,1.543655
2855,4305,1265,5445825,2,22846,5713,1,170785400,170785400,8566,2855,5711,2855,0,1,2857,251550,0.25155
3255,4305,1265,5445825,2,26046,6513,1,188609400,188609400,9766,3255,6511,3255,0,1,3257,1335724,1.335724
3655,4305,1265,5445825,2,29246,7313,1,206433400,206433400,10966,3655,7311,3655,0,1,3657,944328,0.944328
4055,4305,1265,5445825,2,32446,8113,1,224257400,224257400,12166,4055,8111,4055,0,1,4057,2318028,2.318028
4455,4305,1265,5445825,2,35646,8913,1,242081400,242081400,13366,4455,8911,4455,0,1,4457,4634673,4.634673
4855,4305,1265,5445825,2,38846,9713,1,259905400,259905400,14566,4855,9711,4855,0,1,4857,18485,0.018485
5255,4305,1265,5445825,2,42046,10513,1,277729400,277729400,15766,5255,10511,5255,0,1,5257,1227640,1.22764
5655,4305,1265,5445825,2,45246,11313,1,295553400,295553400,16966,5655,11311,5655,0,1,5657,403080,0.40308
6055,4305,1265,5445825,2,48446,12113,1,313377400,313377400,18166,6055,12111,6055,0,1,6057,107694,0.107694
6455,4305,1265,5445825,2,51646,12913,1,331201400,331201400,19366,6455,12911,6455,0,1,6457,1698201,1.698201
6855,4305,1265,5445825,2,54846,13713,1,349025400,349025400,20566,6855,13711,6855,0,1,6857,7110603,7.110603
55,1055,5165,5449075,2,446,113,1,46329400,46329400,166,55,111,55,0,1,57,32115,0.032115
455,1055,5165,5449075,2,3646,913,1,66233400,66233400,1366,455,911,455,0,1,457,16674,0.016674
855,1055,5165,5449075,2,6846,1713,1,86137400,86137400,2566,855,1711,855,0,1,857,6125,0.006125
1255,1055,5165,5449075,2,10046,2513,1,106041400,106041400,3766,1255,2511,1255,0,1,1257,192024,0.192024
1655,1055,5165,5449075,2,13246,3313,1,125945400,125945400,4966,1655,3311,1655,0,1,1657,80887,0.080887
2055,1055,5165,5449075,2,16446,4113,1,145849400,145849400,6166,2055,4111,2055,0,1,2057,136595,0.136595
2455,1055,5165,5449075,2,19646,4913,1,165753400,165753400,7366,2455,4911,2455,0,1,2457,9363,0.009363
2855,1055,5165,5449075,2,22846,5713,1,185657400,185657400,8566,2855,5711,2855,0,1,2857,559713,0.559713
3255,1055,5165,5449075,2,26046,6513,1,205561400,205561400,9766,3255,6511,3255,0,1,3257,613202,0.613202
3655,1055,5165,5449075,2,29246,7313,1,225465400,225465400,10966,3655,7311,3655,0,1,3657,347617,0.347617
4055,1055,5165,5449075,2,32446,8113,1,245369400,245369400,12166,4055,8111,4055,0,1,4057,903443,0.903443
4455,1055,5165,5449075,2,35646,8913,1,265273400,265273400,13366,4455,8911,4455,0,1,4457,145535,0.145535
4855,1055,5165,5449075,2,38846,9713,1,285177400,285177400,14566,4855,9711,4855,0,1,4857,933131,0.933131
5255,1055,5165,5449075,2,42046,10513,1,305081400,305081400,15766,5255,10511,5255,0,1,5257,305556,0.305556
5655,1055,5165,5449075,2,45246,11313,1,324985400,324985400,16966,5655,11311,5655,0,1,5657,772887,0.772887
6055,1055,5165,5449075,2,48446,12113,1,344889400,344889400,18166,6055,12111,6055,0,1,6057,69614,0.069614
6455,1055,5165,5449075,2,51646,12913,1,364793400,364793400,19366,6455,12911,6455,0,1,6457,893237,0.893237
6855,1055,5165,5449075,2,54846,13713,1,384697400,384697400,20566,6855,13711,6855,0,1,6857,649377,0.649377
40,5800,940,5452000,2,326,83,1,45772800,45772800,121,40,81,40,0,1,42,5407,0.005407
440,5800,940,5452000,2,3526,883,1,67340800,67340800,1321,440,881,440,0,1,442,159541,0.159541
840,5800,940,5452000,2,6726,1683,1,88908800,88908800,2521,840,1681,840,0,1,842,73290,0.07329
1240,5800,940,5452000,2,9926,2483,1,110476800,110476800,3721,1240,2481,1240,0,1,1242,233899,0.233899
1640,5800,940,5452000,2,13126,3283,1,132044800,132044800,4921,1640,3281,1640,0,1,1642,269257,0.269257
2040,5800,940,5452000,2,16326,4083,1,153612800,153612800,6121,2040,4081,2040,0,1,2042,216467,0.216467
2440,5800,940,5452000,2,19526,4883,1,175180800,175180800,7321,2440,4881,2440,0,1,2442,56092,0.056092
2840,5800,940,5452000,2,22726,5683,1,196748800,196748800,8521,2840,5681,2840,0,1,2842,451270,0.45127
3240,5800,940,5452000,2,25926,6483,1,218316800,218316800,9721,3240,6481,3240,0,1,3242,205020,0.20502
3640,5800,940,5452000,2,29126,7283,1,239884800,239884800,10921,3640,7281,3640,0,1,3642,281686,0.281686
4040,5800,940,5452000,2,32326,8083,1,261452800,261452800,12121,4040,8081,4040,0,1,4042,3382610,3.38261
4440,5800,940,5452000,2,35526,8883,1,283020800,283020800,13321,4440,8881,4440,0,1,4442,1055767,1.055767
4840,5800,940,5452000,2,38726,9683,1,304588800,304588800,14521,4840,9681,4840,0,1,4842,749199,0.749199
5240,5800,940,5452000,2,41926,10483,1,326156800,326156800,15721,5240,10481,5240,0,1,5242,19939,0.019939
5640,5800,940,5452000,2,45126,11283,1,347724800,347724800,16921,5640,11281,5640,0,1,5642,1627065,1.627065
6040,5800,940,5452000,2,48326,12083,1,369292800,369292800,18121,6040,12081,6040,0,1,6042,26135,0.026135
6440,5800,940,5452000,2,51526,12883,1,390860800,390860800,19321,6440,12881,6440,0,1,6442,1655448,1.655448
6840,5800,940,5452000,2,54726,13683,1,412428800,412428800,20521,6840,13681,6840,0,1,6842,449527,0.449527
40,2550,2140,5457000,2,326,83,1,45156800,45156800,121,40,81,40,0,1,42,101470,0.10147
440,2550,2140,5457000,2,3526,883,1,60164800,60164800,1321,440,881,440,0,1,442,3796,0.003796
840,2550,2140,5457000,2,6726,1683,1,75172800,75172800,2521,840,1681,840,0,1,842,394157,0.394157
1240,2550,2140,5457000,2,9926,2483,1,90180800,90180800,3721,1240,2481,1240,0,1,1242,893897,0.893897
1640,2550,2140,5457000,2,13126,3283,1,105188800,105188800,4921,1640,3281,1640,0,1,1642,1711206,1.711206
2040,2550,2140,5457000,2,16326,4083,1,120196800,120196800,6121,2040,4081,2040,0,1,2042,2047074,2.047074
2440,2550,2140,5457000,2,19526,4883,1,135204800,135204800,7321,2440,4881,2440,0,1,2442,1695250,1.69525
2840,2550,2140,5457000,2,22726,5683,1,150212800,150212800,8521,2840,5681,2840,0,1,2842,1002627,1.002627
3240,2550,2140,5457000,2,25926,6483,1,165220800,165220800,9721,3240,6481,3240,0,1,3242,1036941,1.036941
3640,2550,2140,5457000,2,29126,7283,1,180228800,180228800,10921,3640,7281,3640,0,1,3642,645970,0.64597
4040,2550,2140,5457000,2,32326,8083,1,195236800,195236800,12121,4040,8081,4040,0,1,4042,689299,0.689299
4440,2550,2140,5457000,2,35526,8883,1,210244800,210244800,13321,4440,8881,4440,0,1,4442,3605746,3.605746
4840,2550,2140,5457000,2,38726,9683,1,225252800,225252800,14521,4840,9681,4840,0,1,4842,420918,0.420918
5240,2550,2140,5457000,2,41926,10483,1,240260800,240260800,15721,5240,10481,5240,0,1,5242,633659,0.633659
5640,2550,2140,5457000,2,45126,11283,1,255268800,255268800,16921,5640,11281,5640,0,1,5642,168215,0.168215
6040,2550,2140,5457000,2,48326,12083,1,270276800,270276800,18121,6040,12081,6040,0,1,6042,324771,0.324771
6440,2550,2140,5457000,2,51526,12883,1,285284800,285284800,19321,6440,12881,6440,0,1,6442,1885040,1.88504
6840,2550,2140,5457000,2,54726,13683,1,300292800,300292800,20521,6840,13681,6840,0,1,6842,1491874,1.491874
40,3550,1540,5467000,2,326,83,1,45364800,45364800,121,40,81,40,0,1,42,102029,0.102029
440,3550,1540,5467000,2,3526,883,1,61652800,61652800,1321,440,881,440,0,1,442,501322,0.501322
840,3550,1540,5467000,2,6726,1683,1,77940800,77940800,2521,840,1681,840,0,1,842,921099,0.921099
1240,3550,1540,5467000,2,9926,2483,1,94228800,94228800,3721,1240,2481,1240,0,1,1242,707341,0.707341
1640,3550,1540,5467000,2,13126,3283,1,110516800,110516800,4921,1640,3281,1640,0,1,1642,555690,0.55569
2040,3550,1540,5467000,2,16326,4083,1,126804800,126804800,6121,2040,4081,2040,0,1,2042,1444139,1.444139
2440,3550,1540,5467000,2,19526,4883,1,143092800,143092800,7321,2440,4881,2440,0,1,2442,1001757,1.001757
2840,3550,1540,5467000,2,22726,5683,1,159380800,159380800,8521,2840,5681,2840,0,1,2842,2483330,2.48333
3240,3550,1540,5467000,2,25926,6483,1,175668800,175668800,9721,3240,6481,3240,0,1,3242,13462,0.013462
3640,3550,1540,5467000,2,29126,7283,1,191956800,191956800,10921,3640,7281,3640,0,1,3642,640312,0.640312
4040,3550,1540,5467000,2,32326,8083,1,208244800,208244800,12121,4040,8081,4040,0,1,4042,331390,0.33139
4440,3550,1540,5467000,2,35526,8883,1,224532800,224532800,13321,4440,8881,4440,0,1,4442,539168,0.539168
4840,3550,1540,5467000,2,38726,9683,1,240820800,240820800,14521,4840,9681,4840,0,1,4842,508599,0.508599
5240,3550,1540,5467000,2,41926,10483,1,257108800,257108800,15721,5240,10481,5240,0,1,5242,1720902,1.720902
5640,3550,1540,5467000,2,45126,11283,1,273396800,273396800,16921,5640,11281,5640,0,1,5642,265923,0.265923
6040,3550,1540,5467000,2,48326,12083,1,289684800,289684800,18121,6040,12081,6040,0,1,6042,4500791,4.500791
6440,3550,1540,5467000,2,51526,12883,1,305972800,305972800,19321,6440,12881,6440,0,1,6442,1551198,1.551198
6840,3550,1540,5467000,2,54726,13683,1,322260800,322260800,20521,6840,13681,6840,0,1,6842,7236103,7.236103
40,1800,3040,5472000,2,326,83,1,45324800,45324800,121,40,81,40,0,1,42,100514,0.100514
440,1800,3040,5472000,2,3526,883,1,60812800,60812800,1321,440,881,440,0,1,442,500242,0.500242
840,1800,3040,5472000,2,6726,1683,1,76300800,76300800,2521,840,1681,840,0,1,842,730926,0.730926
1240,1800,3040,5472000,2,9926,2483,1,91788800,91788800,3721,1240,2481,1240,0,1,1242,3702,0.003702
1640,1800,3040,5472000,2,13126,3283,1,107276800,107276800,4921,1640,3281,1640,0,1,1642,262729,0.262729
2040,1800,3040,5472000,2,16326,4083,1,122764800,122764800,6121,2040,4081,2040,0,1,2042,915825,0.915825
2440,1800,3040,5472000,2,19526,4883,1,138252800,138252800,7321,2440,4881,2440,0,1,2442,256823,0.256823
2840,1800,3040,5472000,2,22726,5683,1,153740800,153740800,8521,2840,5681,2840,0,1,2842,1413833,1.413833
3240,1800,3040,5472000,2,25926,6483,1,169228800,169228800,9721,3240,6481,3240,0,1,3242,517082,0.517082
3640,1800,3040,5472000,2,29126,7283,1,184716800,184716800,10921,3640,7281,3640,0,1,3642,2171721,2.171721
4040,1800,3040,5472000,2,32326,8083,1,200204800,200204800,12121,4040,8081,4040,0,1,4042,723958,0.723958
4440,1800,3040,5472000,2,35526,8883,1,215692800,215692800,13321,4440,8881,4440,0,1,4442,2312389,2.312389
4840,1800,3040,5472000,2,38726,9683,1,231180800,231180800,14521,4840,9681,4840,0,1,4842,119147,0.119147
5240,1800,3040,5472000,2,41926,10483,1,246668800,246668800,15721,5240,10481,5240,0,1,5242,585412,0.585412
5640,1800,3040,5472000,2,45126,11283,1,262156800,262156800,16921,5640,11281,5640,0,1,5642,4817860,4.81786
6040,1800,3040,5472000,2,48326,12083,1,277644800,277644800,18121,6040,12081,6040,0,1,6042,2415587,2.415587
6440,1800,3040,5472000,2,51526,12883,1,293132800,293132800,19321,6440,12881,6440,0,1,6442,1134224,1.134224
6840,1800,3040,5472000,2,54726,13683,1,308620800,308620800,20521,6840,13681,6840,0,1,6842,1462828,1.462828
40,1300,4240,5512000,2,326,83,1,45868800,45868800,121,40,81,40,0,1,42,101051,0.101051
440,1300,4240,5512000,2,3526,883,1,63596800,63596800,1321,440,881,440,0,1,442,60468,0.060468
840,1300,4240,5512000,2,6726,1683,1,81324800,81324800,2521,840,1681,840,0,1,842,920695,0.920695
1240,1300,4240,5512000,2,9926,2483,1,99052800,99052800,3721,1240,2481,1240,0,1,1242,406385,0.406385
1640,1300,4240,5512000,2,13126,3283,1,116780800,116780800,4921,1640,3281,1640,0,1,1642,690658,0.690658
2040,1300,4240,5512000,2,16326,4083,1,134508800,134508800,6121,2040,4081,2040,0,1,2042,53981,0.053981
2440,1300,4240,5512000,2,19526,4883,1,152236800,152236800,7321,2440,4881,2440,0,1,2442,1360865,1.360865
2840,1300,4240,5512000,2,22726,5683,1,169964800,169964800,8521,2840,5681,2840,0,1,2842,1141197,1.141197
3240,1300,4240,5512000,2,25926,6483,1,187692800,187692800,9721,3240,6481,3240,0,1,3242,23929,0.023929
3640,1300,4240,5512000,2,29126,7283,1,205420800,205420800,10921,3640,7281,3640,0,1,3642,905529,0.905529
4040,1300,4240,5512000,2,32326,8083,1,223148800,223148800,12121,4040,8081,4040,0,1,4042,2646882,2.646882
4440,1300,4240,5512000,2,35526,8883,1,240876800,240876800,13321,4440,8881,4440,0,1,4442,283265,0.283265
4840,1300,4240,5512000,2,38726,9683,1,258604800,258604800,14521,4840,9681,4840,0,1,4842,2755931,2.755931
5240,1300,4240,5512000,2,41926,10483,1,276332800,276332800,15721,5240,10481,5240,0,1,5242,1209123,1.209123
5640,1300,4240,5512000,2,45126,11283,1,294060800,294060800,16921,5640,11281,5640,0,1,5642,256954,0.256954
6040,1300,4240,5512000,2,48326,12083,1,311788800,311788800,18121,6040,12081,6040,0,1,6042,403997,0.403997
6440,1300,4240,5512000,2,51526,12883,1,329516800,329516800,19321,6440,12881,6440,0,1,6442,820462,0.820462
6840,1300,4240,5512000,2,54726,13683,1,347244800,347244800,20521,6840,13681,6840,0,1,6842,1209271,1.209271
55,2555,2165,5531575,2,446,113,1,46329400,46329400,166,55,111,55,0,1,57,69371,0.069371
455,2555,2165,5531575,2,3646,913,1,61433400,61433400,1366,455,911,455,0,1,457,515052,0.515052
855,2555,2165,5531575,2,6846,1713,1,76537400,76537400,2566,855,1711,855,0,1,857,111960,0.11196
1255,2555,2165,5531575,2,10046,2513,1,91641400,91641400,3766,1255,2511,1255,0,1,1257,595493,0.595493
1655,2555,2165,5531575,2,13246,3313,1,106745400,106745400,4966,1655,3311,1655,0,1,1657,826515,0.826515
2055,2555,2165,5531575,2,16446,4113,1,121849400,121849400,6166,2055,4111,2055,0,1,2057,2155916,2.155916
2455,2555,2165,5531575,2,19646,4913,1,136953400,136953400,7366,2455,4911,2455,0,1,2457,1194778,1.194778
2855,2555,2165,5531575,2,22846,5713,1,152057400,152057400,8566,2855,5711,2855,0,1,2857,1342506,1.342506
3255,2555,2165,5531575,2,26046,6513,1,167161400,167161400,9766,3255,6511,3255,0,1,3257,1900661,1.900661
3655,2555,2165,5531575,2,29246,7313,1,182265400,182265400,10966,3655,7311,3655,0,1,3657,1347422,1.347422
4055,2555,2165,5531575,2,32446,8113,1,197369400,197369400,12166,4055,8111,4055,0,1,4057,4249939,4.249939
4455,2555,2165,5531575,2,35646,8913,1,212473400,212473400,13366,4455,8911,4455,0,1,4457,1387241,1.387241
4855,2555,2165,5531575,2,38846,9713,1,227577400,227577400,14566,4855,9711,4855,0,1,4857,1526491,1.526491
5255,2555,2165,5531575,2,42046,10513,1,242681400,242681400,15766,5255,10511,5255,0,1,5257,1210770,1.21077
5655,2555,2165,5531575,2,45246,11313,1,257785400,257785400,16966,5655,11311,5655,0,1,5657,454252,0.454252
6055,2555,2165,5531575,2,48446,12113,1,272889400,272889400,18166,6055,12111,6055,0,1,6057,454646,0.454646
6455,2555,2165,5531575,2,51646,12913,1,287993400,287993400,19366,6455,12911,6455,0,1,6457,1770032,1.770032
6855,2555,2165,5531575,2,54846,13713,1,303097400,303097400,20566,6855,13711,6855,0,1,6857,1959181,1.959181
55,1805,3065,5532325,2,446,113,1,46401400,46401400,166,55,111,55,0,1,57,115580,0.11558
455,1805,3065,5532325,2,3646,913,1,61985400,61985400,1366,455,911,455,0,1,457,536585,0.536585
855,1805,3065,5532325,2,6846,1713,1,77569400,77569400,2566,855,1711,855,0,1,857,633376,0.633376
1255,1805,3065,5532325,2,10046,2513,1,93153400,93153400,3766,1255,2511,1255,0,1,1257,1389192,1.389192
1655,1805,3065,5532325,2,13246,3313,1,108737400,108737400,4966,1655,3311,1655,0,1,1657,67397,0.067397
2055,1805,3065,5532325,2,16446,4113,1,124321400,124321400,6166,2055,4111,2055,0,1,2057,1237866,1.237866
2455,1805,3065,5532325,2,19646,4913,1,139905400,139905400,7366,2455,4911,2455,0,1,2457,2665864,2.665864
2855,1805,3065,5532325,2,22846,5713,1,155489400,155489400,8566,2855,5711,2855,0,1,2857,649010,0.64901
3255,1805,3065,5532325,2,26046,6513,1,171073400,171073400,9766,3255,6511,3255,0,1,3257,404358,0.404358
3655,1805,3065,5532325,2,29246,7313,1,186657400,186657400,10966,3655,7311,3655,0,1,3657,1788525,1.788525
4055,1805,3065,5532325,2,32446,8113,1,202241400,202241400,12166,4055,8111,4055,0,1,4057,553443,0.553443
4455,1805,3065,5532325,2,35646,8913,1,217825400,217825400,13366,4455,8911,4455,0,1,4457,1375129,1.375129
4855,1805,3065,5532325,2,38846,9713,1,233409400,233409400,14566,4855,9711,4855,0,1,4857,212862,0.212862
5255,1805,3065,5532325,2,42046,10513,1,248993400,248993400,15766,5255,10511,5255,0,1,5257,92989,0.092989
5655,1805,3065,5532325,2,45246,11313,1,264577400,264577400,16966,5655,11311,5655,0,1,5657,1156668,1.156668
6055,1805,3065,5532325,2,48446,12113,1,280161400,280161400,18166,6055,12111,6055,0,1,6057,390645,0.390645
6455,1805,3065,5532325,2,51646,12913,1,295745400,295745400,19366,6455,12911,6455,0,1,6457,800249,0.800249
6855,1805,3065,5532325,2,54846,13713,1,311329400,311329400,20566,6855,13711,6855,0,1,6857,3596708,3.596708
40,800,6940,5552000,2,326,83,1,46892800,46892800,121,40,81,40,0,1,42,108306,0.108306
440,800,6940,5552000,2,3526,883,1,71660800,71660800,1321,440,881,440,0,1,442,507088,0.507088
840,800,6940,5552000,2,6726,1683,1,96428800,96428800,2521,840,1681,840,0,1,842,927553,0.927553
1240,800,6940,5552000,2,9926,2483,1,121196800,121196800,3721,1240,2481,1240,0,1,1242,491904,0.491904
1640,800,6940,5552000,2,13126,3283,1,145964800,145964800,4921,1640,3281,1640,0,1,1642,571923,0.571923
2040,800,6940,5552000,2,16326,4083,1,170732800,170732800,6121,2040,4081,2040,0,1,2042,1077809,1.077809
2440,800,6940,5552000,2,19526,4883,1,195500800,195500800,7321,2440,4881,2440,0,1,2442,831836,0.831836
2840,800,6940,5552000,2,22726,5683,1,220268800,220268800,8521,2840,5681,2840,0,1,2842,402666,0.402666
3240,800,6940,5552000,2,25926,6483,1,245036800,245036800,9721,3240,6481,3240,0,1,3242,573198,0.573198
3640,800,6940,5552000,2,29126,7283,1,269804800,269804800,10921,3640,7281,3640,0,1,3642,508933,0.508933
4040,800,6940,5552000,2,32326,8083,1,294572800,294572800,12121,4040,8081,4040,0,1,4042,387865,0.387865
4440,800,6940,5552000,2,35526,8883,1,319340800,319340800,13321,4440,8881,4440,0,1,4442,1443517,1.443517
4840,800,6940,5552000,2,38726,9683,1,344108800,344108800,14521,4840,9681,4840,0,1,4842,521194,0.521194
5240,800,6940,5552000,2,41926,10483,1,368876800,368876800,15721,5240,10481,5240,0,1,5242,329989,0.329989
5640,800,6940,5552000,2,45126,11283,1,393644800,393644800,16921,5640,11281,5640,0,1,5642,885327,0.885327
6040,800,6940,5552000,2,48326,12083,1,418412800,418412800,18121,6040,12081,6040,0,1,6042,3093826,3.093826
6440,800,6940,5552000,2,51526,12883,1,443180800,443180800,19321,6440,12881,6440,0,1,6442,3005577,3.005577
6840,800,6940,5552000,2,54726,13683,1,467948800,467948800,20521,6840,13681,6840,0,1,6842,787491,0.787491
55,3555,1565,5563575,2,446,113,1,46761400,46761400,166,55,111,55,0,1,57,110066,0.110066
455,3555,1565,5563575,2,3646,913,1,63145400,63145400,1366,455,911,455,0,1,457,307250,0.30725
855,3555,1565,5563575,2,6846,1713,1,79529400,79529400,2566,855,1711,855,0,1,857,279070,0.27907
1255,3555,1565,5563575,2,10046,2513,1,95913400,95913400,3766,1255,2511,1255,0,1,1257,361482,0.361482
1655,3555,1565,5563575,2,13246,3313,1,112297400,112297400,4966,1655,3311,1655,0,1,1657,1822200,1.8222
2055,3555,1565,5563575,2,16446,4113,1,128681400,128681400,6166,2055,4111,2055,0,1,2057,810485,0.810485
2455,3555,1565,5563575,2,19646,4913,1,145065400,145065400,7366,2455,4911,2455,0,1,2457,272779,0.272779
2855,3555,1565,5563575,2,22846,5713,1,161449400,161449400,8566,2855,5711,2855,0,1,2857,923460,0.92346
3255,3555,1565,5563575,2,26046,6513,1,177833400,177833400,9766,3255,6511,3255,0,1,3257,463838,0.463838
3655,3555,1565,5563575,2,29246,7313,1,194217400,194217400,10966,3655,7311,3655,0,1,3657,38067,0.038067
4055,3555,1565,5563575,2,32446,8113,1,210601400,210601400,12166,4055,8111,4055,0,1,4057,2058731,2.058731
4455,3555,1565,5563575,2,35646,8913,1,226985400,226985400,13366,4455,8911,4455,0,1,4457,542844,0.542844
4855,3555,1565,5563575,2,38846,9713,1,243369400,243369400,14566,4855,9711,4855,0,1,4857,2639665,2.639665
5255,3555,1565,5563575,2,42046,10513,1,259753400,259753400,15766,5255,10511,5255,0,1,5257,501920,0.50192
5655,3555,1565,5563575,2,45246,11313,1,276137400,276137400,16966,5655,11311,5655,0,1,5657,4328526,4.328526
6055,3555,1565,5563575,2,48446,12113,1,292521400,292521400,18166,6055,12111,6055,0,1,6057,2314600,2.3146
6455,3555,1565,5563575,2,51646,12913,1,308905400,308905400,19366,6455,12911,6455,0,1,6457,1967965,1.967965
6855,3555,1565,5563575,2,54846,13713,1,325289400,325289400,20566,6855,13711,6855,0,1,6857,2162384,2.162384
55,1305,4265,5565825,2,446,113,1,46977400,46977400,166,55,111,55,0,1,57,114230,0.11423
455,1305,4265,5565825,2,3646,913,1,64801400,64801400,1366,455,911,455,0,1,457,220518,0.220518
855,1305,4265,5565825,2,6846,1713,1,82625400,82625400,2566,855,1711,855,0,1,857,697040,0.69704
1255,1305,4265,5565825,2,10046,2513,1,100449400,100449400,3766,1255,2511,1255,0,1,1257,1229249,1.229249
1655,1305,4265,5565825,2,13246,3313,1,118273400,118273400,4966,1655,3311,1655,0,1,1657,92926,0.092926
2055,1305,4265,5565825,2,16446,4113,1,136097400,136097400,6166,2055,4111,2055,0,1,2057,1063157,1.063157
2455,1305,4265,5565825,2,19646,4913,1,153921400,153921400,7366,2455,4911,2455,0,1,2457,1800248,1.800248
2855,1305,4265,5565825,2,22846,5713,1,171745400,171745400,8566,2855,5711,2855,0,1,2857,2230337,2.230337
3255,1305,4265,5565825,2,26046,6513,1,189569400,189569400,9766,3255,6511,3255,0,1,3257,376717,0.376717
3655,1305,4265,5565825,2,29246,7313,1,207393400,207393400,10966,3655,7311,3655,0,1,3657,1756705,1.756705
4055,1305,4265,5565825,2,32446,8113,1,225217400,225217400,12166,4055,8111,4055,0,1,4057,334989,0.334989
4455,1305,4265,5565825,2,35646,8913,1,243041400,243041400,13366,4455,8911,4455,0,1,4457,1002239,1.002239
4855,1305,4265,5565825,2,38846,9713,1,260865400,260865400,14566,4855,9711,4855,0,1,4857,3420014,3.420014
5255,1305,4265,5565825,2,42046,10513,1,278689400,278689400,15766,5255,10511,5255,0,1,5257,177518,0.177518
5655,1305,4265,5565825,2,45246,11313,1,296513400,296513400,16966,5655,11311,5655,0,1,5657,5977537,5.977537
6055,1305,4265,5565825,2,48446,12113,1,314337400,314337400,18166,6055,12111,6055,0,1,6057,1174884,1.174884
6455,1305,4265,5565825,2,51646,12913,1,332161400,332161400,19366,6455,12911,6455,0,1,6457,632692,0.632692
6855,1305,4265,5565825,2,54846,13713,1,349985400,349985400,20566,6855,13711,6855,0,1,6857,1334227,1.334227
55,5805,965,5601825,2,446,113,1,47793400,47793400,166,55,111,55,0,1,57,19117,0.019117
455,5805,965,5601825,2,3646,913,1,69457400,69457400,1366,455,911,455,0,1,457,40142,0.040142
855,5805,965,5601825,2,6846,1713,1,91121400,91121400,2566,855,1711,855,0,1,857,172074,0.172074
1255,5805,965,5601825,2,10046,2513,1,112785400,112785400,3766,1255,2511,1255,0,1,1257,26884,0.026884
1655,5805,965,5601825,2,13246,3313,1,134449400,134449400,4966,1655,3311,1655,0,1,1657,839611,0.839611
2055,5805,965,5601825,2,16446,4113,1,156113400,156113400,6166,2055,4111,2055,0,1,2057,226371,0.226371
2455,5805,965,5601825,2,19646,4913,1,177777400,177777400,7366,2455,4911,2455,0,1,2457,588026,0.588026
2855,5805,965,5601825,2,22846,5713,1,199441400,199441400,8566,2855,5711,2855,0,1,2857,290735,0.290735
3255,5805,965,5601825,2,26046,6513,1,221105400,221105400,9766,3255,6511,3255,0,1,3257,617209,0.617209
3655,5805,965,5601825,2,29246,7313,1,242769400,242769400,10966,3655,7311,3655,0,1,3657,217287,0.217287
4055,5805,965,5601825,2,32446,8113,1,264433400,264433400,12166,4055,8111,4055,0,1,4057,12413,0.012413
4455,5805,965,5601825,2,35646,8913,1,286097400,286097400,13366,4455,8911,4455,0,1,4457,694962,0.694962
4855,5805,965,5601825,2,38846,9713,1,307761400,307761400,14566,4855,9711,4855,0,1,4857,849958,0.849958
5255,5805,965,5601825,2,42046,10513,1,329425400,329425400,15766,5255,10511,5255,0,1,5257,98709,0.098709
5655,5805,965,5601825,2,45246,11313,1,351089400,351089400,16966,5655,11311,5655,0,1,5657,57845,0.057845
6055,5805,965,5601825,2,48446,12113,1,372753400,372753400,18166,6055,12111,6055,0,1,6057,103061,0.103061
6455,5805,965,5601825,2,51646,12913,1,394417400,394417400,19366,6455,12911,6455,0,1,6457,937188,0.937188
6855,5805,965,5601825,2,54846,13713,1,416081400,416081400,20566,6855,13711,6855,0,1,6857,645978,0.645978
55,805,6965,5606825,2,446,113,1,48273400,48273400,166,55,111,55,0,1,57,115223,0.115223
455,805,6965,5606825,2,3646,913,1,73137400,73137400,1366,455,911,455,0,1,457,11332,0.011332
855,805,6965,5606825,2,6846,1713,1,98001400,98001400,2566,855,1711,855,0,1,857,589098,0.589098
1255,805,6965,5606825,2,10046,2513,1,122865400,122865400,3766,1255,2511,1255,0,1,1257,1376719,1.376719
1655,805,6965,5606825,2,13246,3313,1,147729400,147729400,4966,1655,3311,1655,0,1,1657,830721,0.830721
2055,805,6965,5606825,2,16446,4113,1,172593400,172593400,6166,2055,4111,2055,0,1,2057,22654,0.022654
2455,805,6965,5606825,2,19646,4913,1,197457400,197457400,7366,2455,4911,2455,0,1,2457,1212291,1.212291
2855,805,6965,5606825,2,22846,5713,1,222321400,222321400,8566,2855,5711,2855,0,1,2857,145613,0.145613
3255,805,6965,5606825,2,26046,6513,1,247185400,247185400,9766,3255,6511,3255,0,1,3257,526551,0.526551
3655,805,6965,5606825,2,29246,7313,1,272049400,272049400,10966,3655,7311,3655,0,1,3657,158687,0.158687
4055,805,6965,5606825,2,32446,8113,1,296913400,296913400,12166,4055,8111,4055,0,1,4057,1538468,1.538468
4455,805,6965,5606825,2,35646,8913,1,321777400,321777400,13366,4455,8911,4455,0,1,4457,272664,0.272664
4855,805,6965,5606825,2,38846,9713,1,346641400,346641400,14566,4855,9711,4855,0,1,4857,1844978,1.844978
5255,805,6965,5606825,2,42046,10513,1,371505400,371505400,15766,5255,10511,5255,0,1,5257,875147,0.875147
5655,805,6965,5606825,2,45246,11313,1,396369400,396369400,16966,5655,11311,5655,0,1,5657,340793,0.340793
6055,805,6965,5606825,2,48446,12113,1,421233400,421233400,18166,6055,12111,6055,0,1,6057,571998,0.571998
6455,805,6965,5606825,2,51646,12913,1,446097400,446097400,19366,6455,12911,6455,0,1,6457,693119,0.693119
6855,805,6965,5606825,2,54846,13713,1,470961400,470961400,20566,6855,13711,6855,0,1,6857,683921,0.683921
40,3050,1840,5612000,2,326,83,1,46460800,46460800,121,40,81,40,0,1,42,197,0.000197
440,3050,1840,5612000,2,3526,883,1,62108800,62108800,1321,440,881,440,0,1,442,53451,0.053451
840,3050,1840,5612000,2,6726,1683,1,77756800,77756800,2521,840,1681,840,0,1,842,80587,0.080587
1240,3050,1840,5612000,2,9926,2483,1,93404800,93404800,3721,1240,2481,1240,0,1,1242,201104,0.201104
1640,3050,1840,5612000,2,13126,3283,1,109052800,109052800,4921,1640,3281,1640,0,1,1642,25186,0.025186
2040,3050,1840,5612000,2,16326,4083,1,124700800,124700800,6121,2040,4081,2040,0,1,2042,18788,0.018788
2440,3050,1840,5612000,2,19526,4883,1,140348800,140348800,7321,2440,4881,2440,0,1,2442,300582,0.300582
2840,3050,1840,5612000,2,22726,5683,1,155996800,155996800,8521,2840,5681,2840,0,1,2842,1026662,1.026662
3240,3050,1840,5612000,2,25926,6483,1,171644800,171644800,9721,3240,6481,3240,0,1,3242,2045680,2.04568
3640,3050,1840,5612000,2,29126,7283,1,187292800,187292800,10921,3640,7281,3640,0,1,3642,32792,0.032792
4040,3050,1840,5612000,2,32326,8083,1,202940800,202940800,12121,4040,8081,4040,0,1,4042,20872,0.020872
4440,3050,1840,5612000,2,35526,8883,1,218588800,218588800,13321,4440,8881,4440,0,1,4442,863099,0.863099
4840,3050,1840,5612000,2,38726,9683,1,234236800,234236800,14521,4840,9681,4840,0,1,4842,191558,0.191558
5240,3050,1840,5612000,2,41926,10483,1,249884800,249884800,15721,5240,10481,5240,0,1,5242,1555732,1.555732
5640,3050,1840,5612000,2,45126,11283,1,265532800,265532800,16921,5640,11281,5640,0,1,5642,3357867,3.357867
40,2300,2440,5612000,2,326,83,1,46412800,46412800,121,40,81,40,0,1,42,104195,0.104195
440,2300,2440,5612000,2,3526,883,1,61580800,61580800,1321,440,881,440,0,1,442,36570,0.03657
840,2300,2440,5612000,2,6726,1683,1,76748800,76748800,2521,840,1681,840,0,1,842,917849,0.917849
1240,2300,2440,5612000,2,9926,2483,1,91916800,91916800,3721,1240,2481,1240,0,1,1242,1329823,1.329823
1640,2300,2440,5612000,2,13126,3283,1,107084800,107084800,4921,1640,3281,1640,0,1,1642,1604479,1.604479
6040,3050,1840,5612000,2,48326,12083,1,281180800,281180800,18121,6040,12081,6040,0,1,6042,1379810,1.37981
2040,2300,2440,5612000,2,16326,4083,1,122252800,122252800,6121,2040,4081,2040,0,1,2042,1001408,1.001408
2440,2300,2440,5612000,2,19526,4883,1,137420800,137420800,7321,2440,4881,2440,0,1,2442,2584612,2.584612
2840,2300,2440,5612000,2,22726,5683,1,152588800,152588800,8521,2840,5681,2840,0,1,2842,267076,0.267076
6440,3050,1840,5612000,2,51526,12883,1,296828800,296828800,19321,6440,12881,6440,0,1,6442,18553,0.018553
3240,2300,2440,5612000,2,25926,6483,1,167756800,167756800,9721,3240,6481,3240,0,1,3242,363642,0.363642
3640,2300,2440,5612000,2,29126,7283,1,182924800,182924800,10921,3640,7281,3640,0,1,3642,994685,0.994685
4040,2300,2440,5612000,2,32326,8083,1,198092800,198092800,12121,4040,8081,4040,0,1,4042,877885,0.877885
6840,3050,1840,5612000,2,54726,13683,1,312476800,312476800,20521,6840,13681,6840,0,1,6842,709634,0.709634
4440,2300,2440,5612000,2,35526,8883,1,213260800,213260800,13321,4440,8881,4440,0,1,4442,967703,0.967703
4840,2300,2440,5612000,2,38726,9683,1,228428800,228428800,14521,4840,9681,4840,0,1,4842,2095636,2.095636
5240,2300,2440,5612000,2,41926,10483,1,243596800,243596800,15721,5240,10481,5240,0,1,5242,277707,0.277707
5640,2300,2440,5612000,2,45126,11283,1,258764800,258764800,16921,5640,11281,5640,0,1,5642,5071686,5.071686
6040,2300,2440,5612000,2,48326,12083,1,273932800,273932800,18121,6040,12081,6040,0,1,6042,2077723,2.077723
6440,2300,2440,5612000,2,51526,12883,1,289100800,289100800,19321,6440,12881,6440,0,1,6442,3674763,3.674763
6840,2300,2440,5612000,2,54726,13683,1,304268800,304268800,20521,6840,13681,6840,0,1,6842,419443,0.419443
40,2050,2740,5617000,2,326,83,1,46468800,46468800,121,40,81,40,0,1,42,7338,0.007338
440,2050,2740,5617000,2,3526,883,1,61796800,61796800,1321,440,881,440,0,1,442,44145,0.044145
840,2050,2740,5617000,2,6726,1683,1,77124800,77124800,2521,840,1681,840,0,1,842,20973,0.020973
1240,2050,2740,5617000,2,9926,2483,1,92452800,92452800,3721,1240,2481,1240,0,1,1242,131665,0.131665
1640,2050,2740,5617000,2,13126,3283,1,107780800,107780800,4921,1640,3281,1640,0,1,1642,132793,0.132793
2040,2050,2740,5617000,2,16326,4083,1,123108800,123108800,6121,2040,4081,2040,0,1,2042,296,0.000296
2440,2050,2740,5617000,2,19526,4883,1,138436800,138436800,7321,2440,4881,2440,0,1,2442,29860,0.02986
2840,2050,2740,5617000,2,22726,5683,1,153764800,153764800,8521,2840,5681,2840,0,1,2842,899793,0.899793
3240,2050,2740,5617000,2,25926,6483,1,169092800,169092800,9721,3240,6481,3240,0,1,3242,197150,0.19715
3640,2050,2740,5617000,2,29126,7283,1,184420800,184420800,10921,3640,7281,3640,0,1,3642,20826,0.020826
4040,2050,2740,5617000,2,32326,8083,1,199748800,199748800,12121,4040,8081,4040,0,1,4042,855231,0.855231
4440,2050,2740,5617000,2,35526,8883,1,215076800,215076800,13321,4440,8881,4440,0,1,4442,160891,0.160891
4840,2050,2740,5617000,2,38726,9683,1,230404800,230404800,14521,4840,9681,4840,0,1,4842,158458,0.158458
5240,2050,2740,5617000,2,41926,10483,1,245732800,245732800,15721,5240,10481,5240,0,1,5242,321603,0.321603
5640,2050,2740,5617000,2,45126,11283,1,261060800,261060800,16921,5640,11281,5640,0,1,5642,681604,0.681604
6040,2050,2740,5617000,2,48326,12083,1,276388800,276388800,18121,6040,12081,6040,0,1,6042,1062387,1.062387
6440,2050,2740,5617000,2,51526,12883,1,291716800,291716800,19321,6440,12881,6440,0,1,6442,901876,0.901876
6840,2050,2740,5617000,2,54726,13683,1,307044800,307044800,20521,6840,13681,6840,0,1,6842,554307,0.554307
40,1550,3640,5642000,2,326,83,1,46796800,46796800,121,40,81,40,0,1,42,105850,0.10585
440,1550,3640,5642000,2,3526,883,1,63404800,63404800,1321,440,881,440,0,1,442,22905,0.022905
840,1550,3640,5642000,2,6726,1683,1,80012800,80012800,2521,840,1681,840,0,1,842,946935,0.946935
1240,1550,3640,5642000,2,9926,2483,1,96620800,96620800,3721,1240,2481,1240,0,1,1242,1311959,1.311959
1640,1550,3640,5642000,2,13126,3283,1,113228800,113228800,4921,1640,3281,1640,0,1,1642,633667,0.633667
2040,1550,3640,5642000,2,16326,4083,1,129836800,129836800,6121,2040,4081,2040,0,1,2042,2230923,2.230923
2440,1550,3640,5642000,2,19526,4883,1,146444800,146444800,7321,2440,4881,2440,0,1,2442,1560436,1.560436
2840,1550,3640,5642000,2,22726,5683,1,163052800,163052800,8521,2840,5681,2840,0,1,2842,2318224,2.318224
3240,1550,3640,5642000,2,25926,6483,1,179660800,179660800,9721,3240,6481,3240,0,1,3242,168913,0.168913
3640,1550,3640,5642000,2,29126,7283,1,196268800,196268800,10921,3640,7281,3640,0,1,3642,1883006,1.883006
4040,1550,3640,5642000,2,32326,8083,1,212876800,212876800,12121,4040,8081,4040,0,1,4042,304477,0.304477
4440,1550,3640,5642000,2,35526,8883,1,229484800,229484800,13321,4440,8881,4440,0,1,4442,1566374,1.566374
4840,1550,3640,5642000,2,38726,9683,1,246092800,246092800,14521,4840,9681,4840,0,1,4842,2077336,2.077336
5240,1550,3640,5642000,2,41926,10483,1,262700800,262700800,15721,5240,10481,5240,0,1,5242,708219,0.708219
5640,1550,3640,5642000,2,45126,11283,1,279308800,279308800,16921,5640,11281,5640,0,1,5642,51113,0.051113
6040,1550,3640,5642000,2,48326,12083,1,295916800,295916800,18121,6040,12081,6040,0,1,6042,415138,0.415138
6440,1550,3640,5642000,2,51526,12883,1,312524800,312524800,19321,6440,12881,6440,0,1,6442,57335,0.057335
6840,1550,3640,5642000,2,54726,13683,1,329132800,329132800,20521,6840,13681,6840,0,1,6842,1977626,1.977626
40,4550,1240,5642000,2,326,83,1,46988800,46988800,121,40,81,40,0,1,42,100679,0.100679
440,4550,1240,5642000,2,3526,883,1,65516800,65516800,1321,440,881,440,0,1,442,505866,0.505866
840,4550,1240,5642000,2,6726,1683,1,84044800,84044800,2521,840,1681,840,0,1,842,917939,0.917939
1240,4550,1240,5642000,2,9926,2483,1,102572800,102572800,3721,1240,2481,1240,0,1,1242,1331882,1.331882
1640,4550,1240,5642000,2,13126,3283,1,121100800,121100800,4921,1640,3281,1640,0,1,1642,1737737,1.737737
2040,4550,1240,5642000,2,16326,4083,1,139628800,139628800,6121,2040,4081,2040,0,1,2042,300249,0.300249
2440,4550,1240,5642000,2,19526,4883,1,158156800,158156800,7321,2440,4881,2440,0,1,2442,1917444,1.917444
2840,4550,1240,5642000,2,22726,5683,1,176684800,176684800,8521,2840,5681,2840,0,1,2842,458637,0.458637
3240,4550,1240,5642000,2,25926,6483,1,195212800,195212800,9721,3240,6481,3240,0,1,3242,1494190,1.49419
3640,4550,1240,5642000,2,29126,7283,1,213740800,213740800,10921,3640,7281,3640,0,1,3642,2251322,2.251322
4040,4550,1240,5642000,2,32326,8083,1,232268800,232268800,12121,4040,8081,4040,0,1,4042,347583,0.347583
4440,4550,1240,5642000,2,35526,8883,1,250796800,250796800,13321,4440,8881,4440,0,1,4442,4655926,4.655926
4840,4550,1240,5642000,2,38726,9683,1,269324800,269324800,14521,4840,9681,4840,0,1,4842,2186709,2.186709
5240,4550,1240,5642000,2,41926,10483,1,287852800,287852800,15721,5240,10481,5240,0,1,5242,5492290,5.49229
5640,4550,1240,5642000,2,45126,11283,1,306380800,306380800,16921,5640,11281,5640,0,1,5642,3942616,3.942616
6040,4550,1240,5642000,2,48326,12083,1,324908800,324908800,18121,6040,12081,6040,0,1,6042,3620077,3.620077
6440,4550,1240,5642000,2,51526,12883,1,343436800,343436800,19321,6440,12881,6440,0,1,6442,1044816,1.044816
6840,4550,1240,5642000,2,54726,13683,1,361964800,361964800,20521,6840,13681,6840,0,1,6842,1240167,1.240167
55,2305,2465,5681825,2,446,113,1,47553400,47553400,166,55,111,55,0,1,57,114891,0.114891
455,2305,2465,5681825,2,3646,913,1,62817400,62817400,1366,455,911,455,0,1,457,526060,0.52606
855,2305,2465,5681825,2,6846,1713,1,78081400,78081400,2566,855,1711,855,0,1,857,921418,0.921418
1255,2305,2465,5681825,2,10046,2513,1,93345400,93345400,3766,1255,2511,1255,0,1,1257,207205,0.207205
1655,2305,2465,5681825,2,13246,3313,1,108609400,108609400,4966,1655,3311,1655,0,1,1657,857605,0.857605
2055,2305,2465,5681825,2,16446,4113,1,123873400,123873400,6166,2055,4111,2055,0,1,2057,532210,0.53221
2455,2305,2465,5681825,2,19646,4913,1,139137400,139137400,7366,2455,4911,2455,0,1,2457,2641684,2.641684
2855,2305,2465,5681825,2,22846,5713,1,154401400,154401400,8566,2855,5711,2855,0,1,2857,1854767,1.854767
3255,2305,2465,5681825,2,26046,6513,1,169665400,169665400,9766,3255,6511,3255,0,1,3257,598176,0.598176
3655,2305,2465,5681825,2,29246,7313,1,184929400,184929400,10966,3655,7311,3655,0,1,3657,909391,0.909391
4055,2305,2465,5681825,2,32446,8113,1,200193400,200193400,12166,4055,8111,4055,0,1,4057,2059592,2.059592
4455,2305,2465,5681825,2,35646,8913,1,215457400,215457400,13366,4455,8911,4455,0,1,4457,417224,0.417224
4855,2305,2465,5681825,2,38846,9713,1,230721400,230721400,14566,4855,9711,4855,0,1,4857,1005384,1.005384
5255,2305,2465,5681825,2,42046,10513,1,245985400,245985400,15766,5255,10511,5255,0,1,5257,1583902,1.583902
5655,2305,2465,5681825,2,45246,11313,1,261249400,261249400,16966,5655,11311,5655,0,1,5657,1703214,1.703214
6055,2305,2465,5681825,2,48446,12113,1,276513400,276513400,18166,6055,12111,6055,0,1,6057,2347504,2.347504
6455,2305,2465,5681825,2,51646,12913,1,291777400,291777400,19366,6455,12911,6455,0,1,6457,1394859,1.394859
6855,2305,2465,5681825,2,54846,13713,1,307041400,307041400,20566,6855,13711,6855,0,1,6857,77564,0.077564
55,2055,2765,5682075,2,446,113,1,47577400,47577400,166,55,111,55,0,1,57,27827,0.027827
455,2055,2765,5682075,2,3646,913,1,63001400,63001400,1366,455,911,455,0,1,457,20812,0.020812
855,2055,2765,5682075,2,6846,1713,1,78425400,78425400,2566,855,1711,855,0,1,857,226606,0.226606
1255,2055,2765,5682075,2,10046,2513,1,93849400,93849400,3766,1255,2511,1255,0,1,1257,100224,0.100224
1655,2055,2765,5682075,2,13246,3313,1,109273400,109273400,4966,1655,3311,1655,0,1,1657,263921,0.263921
2055,2055,2765,5682075,2,16446,4113,1,124697400,124697400,6166,2055,4111,2055,0,1,2057,60088,0.060088
2455,2055,2765,5682075,2,19646,4913,1,140121400,140121400,7366,2455,4911,2455,0,1,2457,210601,0.210601
2855,2055,2765,5682075,2,22846,5713,1,155545400,155545400,8566,2855,5711,2855,0,1,2857,568784,0.568784
3255,2055,2765,5682075,2,26046,6513,1,170969400,170969400,9766,3255,6511,3255,0,1,3257,54201,0.054201
3655,2055,2765,5682075,2,29246,7313,1,186393400,186393400,10966,3655,7311,3655,0,1,3657,1010145,1.010145
4055,2055,2765,5682075,2,32446,8113,1,201817400,201817400,12166,4055,8111,4055,0,1,4057,1329642,1.329642
4455,2055,2765,5682075,2,35646,8913,1,217241400,217241400,13366,4455,8911,4455,0,1,4457,644623,0.644623
4855,2055,2765,5682075,2,38846,9713,1,232665400,232665400,14566,4855,9711,4855,0,1,4857,253153,0.253153
5255,2055,2765,5682075,2,42046,10513,1,248089400,248089400,15766,5255,10511,5255,0,1,5257,950690,0.95069
5655,2055,2765,5682075,2,45246,11313,1,263513400,263513400,16966,5655,11311,5655,0,1,5657,1389377,1.389377
6055,2055,2765,5682075,2,48446,12113,1,278937400,278937400,18166,6055,12111,6055,0,1,6057,1472651,1.472651
6455,2055,2765,5682075,2,51646,12913,1,294361400,294361400,19366,6455,12911,6455,0,1,6457,944384,0.944384
6855,2055,2765,5682075,2,54846,13713,1,309785400,309785400,20566,6855,13711,6855,0,1,6857,3314474,3.314474
40,6050,940,5687000,2,326,83,1,47732800,47732800,121,40,81,40,0,1,42,65233,0.065233
440,6050,940,5687000,2,3526,883,1,70100800,70100800,1321,440,881,440,0,1,442,508401,0.508401
840,6050,940,5687000,2,6726,1683,1,92468800,92468800,2521,840,1681,840,0,1,842,500561,0.500561
1240,6050,940,5687000,2,9926,2483,1,114836800,114836800,3721,1240,2481,1240,0,1,1242,603737,0.603737
1640,6050,940,5687000,2,13126,3283,1,137204800,137204800,4921,1640,3281,1640,0,1,1642,1779741,1.779741
2040,6050,940,5687000,2,16326,4083,1,159572800,159572800,6121,2040,4081,2040,0,1,2042,2196985,2.196985
2440,6050,940,5687000,2,19526,4883,1,181940800,181940800,7321,2440,4881,2440,0,1,2442,2627969,2.627969
2840,6050,940,5687000,2,22726,5683,1,204308800,204308800,8521,2840,5681,2840,0,1,2842,1537063,1.537063
3240,6050,940,5687000,2,25926,6483,1,226676800,226676800,9721,3240,6481,3240,0,1,3242,2768429,2.768429
3640,6050,940,5687000,2,29126,7283,1,249044800,249044800,10921,3640,7281,3640,0,1,3642,508074,0.508074
4040,6050,940,5687000,2,32326,8083,1,271412800,271412800,12121,4040,8081,4040,0,1,4042,321437,0.321437
4440,6050,940,5687000,2,35526,8883,1,293780800,293780800,13321,4440,8881,4440,0,1,4442,3188514,3.188514
4840,6050,940,5687000,2,38726,9683,1,316148800,316148800,14521,4840,9681,4840,0,1,4842,61180,0.06118
5240,6050,940,5687000,2,41926,10483,1,338516800,338516800,15721,5240,10481,5240,0,1,5242,83940,0.08394
5640,6050,940,5687000,2,45126,11283,1,360884800,360884800,16921,5640,11281,5640,0,1,5642,147894,0.147894
6040,6050,940,5687000,2,48326,12083,1,383252800,383252800,18121,6040,12081,6040,0,1,6042,652508,0.652508
6440,6050,940,5687000,2,51526,12883,1,405620800,405620800,19321,6440,12881,6440,0,1,6442,1621625,1.621625
6840,6050,940,5687000,2,54726,13683,1,427988800,427988800,20521,6840,13681,6840,0,1,6842,3082575,3.082575
55,3055,1865,5697575,2,446,113,1,47745400,47745400,166,55,111,55,0,1,57,18667,0.018667
455,3055,1865,5697575,2,3646,913,1,63489400,63489400,1366,455,911,455,0,1,457,19003,0.019003
855,3055,1865,5697575,2,6846,1713,1,79233400,79233400,2566,855,1711,855,0,1,857,67682,0.067682
1255,3055,1865,5697575,2,10046,2513,1,94977400,94977400,3766,1255,2511,1255,0,1,1257,27801,0.027801
1655,3055,1865,5697575,2,13246,3313,1,110721400,110721400,4966,1655,3311,1655,0,1,1657,456542,0.456542
2055,3055,1865,5697575,2,16446,4113,1,126465400,126465400,6166,2055,4111,2055,0,1,2057,91611,0.091611
2455,3055,1865,5697575,2,19646,4913,1,142209400,142209400,7366,2455,4911,2455,0,1,2457,293511,0.293511
2855,3055,1865,5697575,2,22846,5713,1,157953400,157953400,8566,2855,5711,2855,0,1,2857,445976,0.445976
3255,3055,1865,5697575,2,26046,6513,1,173697400,173697400,9766,3255,6511,3255,0,1,3257,209946,0.209946
3655,3055,1865,5697575,2,29246,7313,1,189441400,189441400,10966,3655,7311,3655,0,1,3657,578295,0.578295
4055,3055,1865,5697575,2,32446,8113,1,205185400,205185400,12166,4055,8111,4055,0,1,4057,20795,0.020795
4455,3055,1865,5697575,2,35646,8913,1,220929400,220929400,13366,4455,8911,4455,0,1,4457,121540,0.12154
4855,3055,1865,5697575,2,38846,9713,1,236673400,236673400,14566,4855,9711,4855,0,1,4857,1068735,1.068735
5255,3055,1865,5697575,2,42046,10513,1,252417400,252417400,15766,5255,10511,5255,0,1,5257,984456,0.984456
5655,3055,1865,5697575,2,45246,11313,1,268161400,268161400,16966,5655,11311,5655,0,1,5657,404117,0.404117
6055,3055,1865,5697575,2,48446,12113,1,283905400,283905400,18166,6055,12111,6055,0,1,6057,1085909,1.085909
6455,3055,1865,5697575,2,51646,12913,1,299649400,299649400,19366,6455,12911,6455,0,1,6457,406449,0.406449
6855,3055,1865,5697575,2,54846,13713,1,315393400,315393400,20566,6855,13711,6855,0,1,6857,384365,0.384365
55,1555,3665,5699075,2,446,113,1,47889400,47889400,166,55,111,55,0,1,57,117839,0.117839
455,1555,3665,5699075,2,3646,913,1,64593400,64593400,1366,455,911,455,0,1,457,549026,0.549026
855,1555,3665,5699075,2,6846,1713,1,81297400,81297400,2566,855,1711,855,0,1,857,254258,0.254258
1255,1555,3665,5699075,2,10046,2513,1,98001400,98001400,3766,1255,2511,1255,0,1,1257,387496,0.387496
1655,1555,3665,5699075,2,13246,3313,1,114705400,114705400,4966,1655,3311,1655,0,1,1657,80334,0.080334
2055,1555,3665,5699075,2,16446,4113,1,131409400,131409400,6166,2055,4111,2055,0,1,2057,2303394,2.303394
2455,1555,3665,5699075,2,19646,4913,1,148113400,148113400,7366,2455,4911,2455,0,1,2457,682059,0.682059
2855,1555,3665,5699075,2,22846,5713,1,164817400,164817400,8566,2855,5711,2855,0,1,2857,754422,0.754422
3255,1555,3665,5699075,2,26046,6513,1,181521400,181521400,9766,3255,6511,3255,0,1,3257,1635371,1.635371
3655,1555,3665,5699075,2,29246,7313,1,198225400,198225400,10966,3655,7311,3655,0,1,3657,3421503,3.421503
4055,1555,3665,5699075,2,32446,8113,1,214929400,214929400,12166,4055,8111,4055,0,1,4057,2231366,2.231366
4455,1555,3665,5699075,2,35646,8913,1,231633400,231633400,13366,4455,8911,4455,0,1,4457,2479884,2.479884
4855,1555,3665,5699075,2,38846,9713,1,248337400,248337400,14566,4855,9711,4855,0,1,4857,530946,0.530946
5255,1555,3665,5699075,2,42046,10513,1,265041400,265041400,15766,5255,10511,5255,0,1,5257,195312,0.195312
5655,1555,3665,5699075,2,45246,11313,1,281745400,281745400,16966,5655,11311,5655,0,1,5657,6337817,6.337817
6055,1555,3665,5699075,2,48446,12113,1,298449400,298449400,18166,6055,12111,6055,0,1,6057,97682,0.097682
6455,1555,3665,5699075,2,51646,12913,1,315153400,315153400,19366,6455,12911,6455,0,1,6457,85125,0.085125
6855,1555,3665,5699075,2,54846,13713,1,331857400,331857400,20566,6855,13711,6855,0,1,6857,791393,0.791393
39,2243,2541,5699463,2,318,81,1,47088312,47088312,118,39,79,39,0,1,41,16327,0.016327
539,2243,2541,5699463,2,4318,1081,1,66224312,66224312,1618,539,1079,539,0,1,541,15355,0.015355
1039,2243,2541,5699463,2,8318,2081,1,85360312,85360312,3118,1039,2079,1039,0,1,1041,29044,0.029044
1539,2243,2541,5699463,2,12318,3081,1,104496312,104496312,4618,1539,3079,1539,0,1,1541,125408,0.125408
2039,2243,2541,5699463,2,16318,4081,1,123632312,123632312,6118,2039,4079,2039,0,1,2041,130757,0.130757
2539,2243,2541,5699463,2,20318,5081,1,142768312,142768312,7618,2539,5079,2539,0,1,2541,740332,0.740332
3039,2243,2541,5699463,2,24318,6081,1,161904312,161904312,9118,3039,6079,3039,0,1,3041,20631,0.020631
3539,2243,2541,5699463,2,28318,7081,1,181040312,181040312,10618,3539,7079,3539,0,1,3541,2239816,2.239816
4039,2243,2541,5699463,2,32318,8081,1,200176312,200176312,12118,4039,8079,4039,0,1,4041,1142674,1.142674
4539,2243,2541,5699463,2,36318,9081,1,219312312,219312312,13618,4539,9079,4539,0,1,4541,1139264,1.139264
5039,2243,2541,5699463,2,40318,10081,1,238448312,238448312,15118,5039,10079,5039,0,1,5041,4765134,4.765134
5539,2243,2541,5699463,2,44318,11081,1,257584312,257584312,16618,5539,11079,5539,0,1,5541,415305,0.415305
6039,2243,2541,5699463,2,48318,12081,1,276720312,276720312,18118,6039,12079,6039,0,1,6041,327228,0.327228
6539,2243,2541,5699463,2,52318,13081,1,295856312,295856312,19618,6539,13079,6539,0,1,6541,3779026,3.779026
7039,2243,2541,5699463,2,56318,14081,1,314992312,314992312,21118,7039,14079,7039,0,1,7041,1573450,1.57345
39,2793,2041,5700513,2,318,81,1,47112312,47112312,118,39,79,39,0,1,41,106758,0.106758
539,2793,2041,5700513,2,4318,1081,1,66448312,66448312,1618,539,1079,539,0,1,541,632240,0.63224
1039,2793,2041,5700513,2,8318,2081,1,85784312,85784312,3118,1039,2079,1039,0,1,1041,1159758,1.159758
1539,2793,2041,5700513,2,12318,3081,1,105120312,105120312,4618,1539,3079,1539,0,1,1541,1705545,1.705545
2039,2793,2041,5700513,2,16318,4081,1,124456312,124456312,6118,2039,4079,2039,0,1,2041,2242964,2.242964
2539,2793,2041,5700513,2,20318,5081,1,143792312,143792312,7618,2539,5079,2539,0,1,2541,2777987,2.777987
3039,2793,2041,5700513,2,24318,6081,1,163128312,163128312,9118,3039,6079,3039,0,1,3041,1021698,1.021698
3539,2793,2041,5700513,2,28318,7081,1,182464312,182464312,10618,3539,7079,3539,0,1,3541,2789538,2.789538
4039,2793,2041,5700513,2,32318,8081,1,201800312,201800312,12118,4039,8079,4039,0,1,4041,3801953,3.801953
4539,2793,2041,5700513,2,36318,9081,1,221136312,221136312,13618,4539,9079,4539,0,1,4541,4947936,4.947936
5039,2793,2041,5700513,2,40318,10081,1,240472312,240472312,15118,5039,10079,5039,0,1,5041,8873,0.008873
5539,2793,2041,5700513,2,44318,11081,1,259808312,259808312,16618,5539,11079,5539,0,1,5541,1325605,1.325605
6039,2793,2041,5700513,2,48318,12081,1,279144312,279144312,18118,6039,12079,6039,0,1,6041,2427611,2.427611
6539,2793,2041,5700513,2,52318,13081,1,298480312,298480312,19618,6539,13079,6539,0,1,6541,2898645,2.898645
7039,2793,2041,5700513,2,56318,14081,1,317816312,317816312,21118,7039,14079,7039,0,1,7041,1002267,1.002267
35,2240,2545,5700800,2,286,73,1,46946200,46946200,106,35,71,35,0,1,37,111800,0.1118
535,2240,2545,5700800,2,4286,1073,1,66086200,66086200,1606,535,1071,535,0,1,537,611500,0.6115
1035,2240,2545,5700800,2,8286,2073,1,85226200,85226200,3106,1035,2071,1035,0,1,1037,1145154,1.145154
1535,2240,2545,5700800,2,12286,3073,1,104366200,104366200,4606,1535,3071,1535,0,1,1537,1677794,1.677794
2035,2240,2545,5700800,2,16286,4073,1,123506200,123506200,6106,2035,4071,2035,0,1,2037,2215037,2.215037
2535,2240,2545,5700800,2,20286,5073,1,142646200,142646200,7606,2535,5071,2535,0,1,2537,2748595,2.748595
40,1050,5440,5712000,2,326,83,1,47772800,47772800,121,40,81,40,0,1,42,6323,0.006323
440,1050,5440,5712000,2,3526,883,1,68540800,68540800,1321,440,881,440,0,1,442,6207,0.006207
840,1050,5440,5712000,2,6726,1683,1,89308800,89308800,2521,840,1681,840,0,1,842,208899,0.208899
1240,1050,5440,5712000,2,9926,2483,1,110076800,110076800,3721,1240,2481,1240,0,1,1242,9258,0.009258
1640,1050,5440,5712000,2,13126,3283,1,130844800,130844800,4921,1640,3281,1640,0,1,1642,83380,0.08338
2040,1050,5440,5712000,2,16326,4083,1,151612800,151612800,6121,2040,4081,2040,0,1,2042,306823,0.306823
2440,1050,5440,5712000,2,19526,4883,1,172380800,172380800,7321,2440,4881,2440,0,1,2442,104049,0.104049
2840,1050,5440,5712000,2,22726,5683,1,193148800,193148800,8521,2840,5681,2840,0,1,2842,291572,0.291572
3240,1050,5440,5712000,2,25926,6483,1,213916800,213916800,9721,3240,6481,3240,0,1,3242,228467,0.228467
3640,1050,5440,5712000,2,29126,7283,1,234684800,234684800,10921,3640,7281,3640,0,1,3642,756233,0.756233
4040,1050,5440,5712000,2,32326,8083,1,255452800,255452800,12121,4040,8081,4040,0,1,4042,1135893,1.135893
4440,1050,5440,5712000,2,35526,8883,1,276220800,276220800,13321,4440,8881,4440,0,1,4442,578258,0.578258
4840,1050,5440,5712000,2,38726,9683,1,296988800,296988800,14521,4840,9681,4840,0,1,4842,1133196,1.133196
5240,1050,5440,5712000,2,41926,10483,1,317756800,317756800,15721,5240,10481,5240,0,1,5242,872234,0.872234
5640,1050,5440,5712000,2,45126,11283,1,338524800,338524800,16921,5640,11281,5640,0,1,5642,208306,0.208306
6040,1050,5440,5712000,2,48326,12083,1,359292800,359292800,18121,6040,12081,6040,0,1,6042,2255035,2.255035
6440,1050,5440,5712000,2,51526,12883,1,380060800,380060800,19321,6440,12881,6440,0,1,6442,1737995,1.737995
6840,1050,5440,5712000,2,54726,13683,1,400828800,400828800,20521,6840,13681,6840,0,1,6842,925926,0.925926
35,5500,1045,5747500,2,286,73,1,47812600,47812600,106,35,71,35,0,1,37,25338,0.025338
535,5500,1045,5747500,2,4286,1073,1,73992600,73992600,1606,535,1071,535,0,1,537,340084,0.340084
1035,5500,1045,5747500,2,8286,2073,1,100172600,100172600,3106,1035,2071,1035,0,1,1037,981010,0.98101
1535,5500,1045,5747500,2,12286,3073,1,126352600,126352600,4606,1535,3071,1535,0,1,1537,1226415,1.226415
2035,5500,1045,5747500,2,16286,4073,1,152532600,152532600,6106,2035,4071,2035,0,1,2037,57791,0.057791
2535,5500,1045,5747500,2,20286,5073,1,178712600,178712600,7606,2535,5071,2535,0,1,2537,2779543,2.779543
3035,5500,1045,5747500,2,24286,6073,1,204892600,204892600,9106,3035,6071,3035,0,1,3037,158730,0.15873
3535,5500,1045,5747500,2,28286,7073,1,231072600,231072600,10606,3535,7071,3535,0,1,3537,10967,0.010967
4035,5500,1045,5747500,2,32286,8073,1,257252600,257252600,12106,4035,8071,4035,0,1,4037,2368697,2.368697
4535,5500,1045,5747500,2,36286,9073,1,283432600,283432600,13606,4535,9071,4535,0,1,4537,4939404,4.939404
5035,5500,1045,5747500,2,40286,10073,1,309612600,309612600,15106,5035,10071,5035,0,1,5037,1834735,1.834735
5535,5500,1045,5747500,2,44286,11073,1,335792600,335792600,16606,5535,11071,5535,0,1,5537,6015795,6.015795
6035,5500,1045,5747500,2,48286,12073,1,361972600,361972600,18106,6035,12071,6035,0,1,6037,686675,0.686675
6535,5500,1045,5747500,2,52286,13073,1,388152600,388152600,19606,6535,13071,6535,0,1,6537,2956519,2.956519
7035,5500,1045,5747500,2,56286,14073,1,414332600,414332600,21106,7035,14071,7035,0,1,7037,1138301,1.138301
35,1140,5045,5751300,2,286,73,1,47742200,47742200,106,35,71,35,0,1,37,106876,0.106876
535,1140,5045,5751300,2,4286,1073,1,72482200,72482200,1606,535,1071,535,0,1,537,623127,0.623127
1035,1140,5045,5751300,2,8286,2073,1,97222200,97222200,3106,1035,2071,1035,0,1,1037,1147370,1.14737
1535,1140,5045,5751300,2,12286,3073,1,121962200,121962200,4606,1535,3071,1535,0,1,1537,1720643,1.720643
2035,1140,5045,5751300,2,16286,4073,1,146702200,146702200,6106,2035,4071,2035,0,1,2037,2241098,2.241098
2535,1140,5045,5751300,2,20286,5073,1,171442200,171442200,7606,2535,5071,2535,0,1,2537,2784743,2.784743
3035,1140,5045,5751300,2,24286,6073,1,196182200,196182200,9106,3035,6071,3035,0,1,3037,3324496,3.324496
3535,1140,5045,5751300,2,28286,7073,1,220922200,220922200,10606,3535,7071,3535,0,1,3537,3866701,3.866701
4035,1140,5045,5751300,2,32286,8073,1,245662200,245662200,12106,4035,8071,4035,0,1,4037,4412527,4.412527
44,2253,2555,5756415,2,358,91,1,47743736,47743736,133,44,89,44,0,1,46,7732,0.007732
544,2253,2555,5756415,2,4358,1091,1,66975736,66975736,1633,544,1089,544,0,1,546,4927,0.004927
1044,2253,2555,5756415,2,8358,2091,1,86207736,86207736,3133,1044,2089,1044,0,1,1046,62077,0.062077
1544,2253,2555,5756415,2,12358,3091,1,105439736,105439736,4633,1544,3089,1544,0,1,1546,142490,0.14249
2044,2253,2555,5756415,2,16358,4091,1,124671736,124671736,6133,2044,4089,2044,0,1,2046,784309,0.784309
2544,2253,2555,5756415,2,20358,5091,1,143903736,143903736,7633,2544,5089,2544,0,1,2546,343922,0.343922
3044,2253,2555,5756415,2,24358,6091,1,163135736,163135736,9133,3044,6089,3044,0,1,3046,386010,0.38601
3544,2253,2555,5756415,2,28358,7091,1,182367736,182367736,10633,3544,7089,3544,0,1,3546,1055699,1.055699
4044,2253,2555,5756415,2,32358,8091,1,201599736,201599736,12133,4044,8089,4044,0,1,4046,835856,0.835856
4544,2253,2555,5756415,2,36358,9091,1,220831736,220831736,13633,4544,9089,4544,0,1,4546,1464344,1.464344
5044,2253,2555,5756415,2,40358,10091,1,240063736,240063736,15133,5044,10089,5044,0,1,5046,176317,0.176317
5544,2253,2555,5756415,2,44358,11091,1,259295736,259295736,16633,5544,11089,5544,0,1,5546,1196776,1.196776
6044,2253,2555,5756415,2,48358,12091,1,278527736,278527736,18133,6044,12089,6044,0,1,6046,2773492,2.773492
6544,2253,2555,5756415,2,52358,13091,1,297759736,297759736,19633,6544,13089,6544,0,1,6546,2653149,2.653149
7044,2253,2555,5756415,2,56358,14091,1,316991736,316991736,21133,7044,14089,7044,0,1,7046,43986,0.043986
44,2803,2055,5760165,2,358,91,1,47791336,47791336,133,44,89,44,0,1,46,107435,0.107435
544,2803,2055,5760165,2,4358,1091,1,67223336,67223336,1633,544,1089,544,0,1,546,630276,0.630276
1044,2803,2055,5760165,2,8358,2091,1,86655336,86655336,3133,1044,2089,1044,0,1,1046,1163771,1.163771
1544,2803,2055,5760165,2,12358,3091,1,106087336,106087336,4633,1544,3089,1544,0,1,1546,239778,0.239778
2044,2803,2055,5760165,2,16358,4091,1,125519336,125519336,6133,2044,4089,2044,0,1,2046,2269423,2.269423
2544,2803,2055,5760165,2,20358,5091,1,144951336,144951336,7633,2544,5089,2544,0,1,2546,1803398,1.803398
3044,2803,2055,5760165,2,24358,6091,1,164383336,164383336,9133,3044,6089,3044,0,1,3046,2197900,2.1979
3544,2803,2055,5760165,2,28358,7091,1,183815336,183815336,10633,3544,7089,3544,0,1,3546,2904067,2.904067
4044,2803,2055,5760165,2,32358,8091,1,203247336,203247336,12133,4044,8089,4044,0,1,4046,2499170,2.49917
4544,2803,2055,5760165,2,36358,9091,1,222679336,222679336,13633,4544,9089,4544,0,1,4546,3276099,3.276099
5044,2803,2055,5760165,2,40358,10091,1,242111336,242111336,15133,5044,10089,5044,0,1,5046,723152,0.723152
5544,2803,2055,5760165,2,44358,11091,1,261543336,261543336,16633,5544,11089,5544,0,1,5546,4030260,4.03026
6044,2803,2055,5760165,2,48358,12091,1,280975336,280975336,18133,6044,12089,6044,0,1,6046,6562577,6.562577
6544,2803,2055,5760165,2,52358,13091,1,300407336,300407336,19633,6544,13089,6544,0,1,6546,1154538,1.154538
7044,2803,2055,5760165,2,56358,14091,1,319839336,319839336,21133,7044,14089,7044,0,1,7046,3585731,3.585731
39,1143,5041,5761863,2,318,81,1,48024312,48024312,118,39,79,39,0,1,41,417,0.000417
539,1143,5041,5761863,2,4318,1081,1,72760312,72760312,1618,539,1079,539,0,1,541,5721,0.005721
1039,1143,5041,5761863,2,8318,2081,1,97496312,97496312,3118,1039,2079,1039,0,1,1041,98988,0.098988
1539,1143,5041,5761863,2,12318,3081,1,122232312,122232312,4618,1539,3079,1539,0,1,1541,44994,0.044994
2039,1143,5041,5761863,2,16318,4081,1,146968312,146968312,6118,2039,4079,2039,0,1,2041,91342,0.091342
2539,1143,5041,5761863,2,20318,5081,1,171704312,171704312,7618,2539,5079,2539,0,1,2541,107608,0.107608
3039,1143,5041,5761863,2,24318,6081,1,196440312,196440312,9118,3039,6079,3039,0,1,3041,83383,0.083383
3539,1143,5041,5761863,2,28318,7081,1,221176312,221176312,10618,3539,7079,3539,0,1,3541,1792579,1.792579
4039,1143,5041,5761863,2,32318,8081,1,245912312,245912312,12118,4039,8079,4039,0,1,4041,887882,0.887882
4539,1143,5041,5761863,2,36318,9081,1,270648312,270648312,13618,4539,9079,4539,0,1,4541,292870,0.29287
5039,1143,5041,5761863,2,40318,10081,1,295384312,295384312,15118,5039,10079,5039,0,1,5041,511907,0.511907
5539,1143,5041,5761863,2,44318,11081,1,320120312,320120312,16618,5539,11079,5539,0,1,5541,428766,0.428766
6039,1143,5041,5761863,2,48318,12081,1,344856312,344856312,18118,6039,12079,6039,0,1,6041,1412902,1.412902
6539,1143,5041,5761863,2,52318,13081,1,369592312,369592312,19618,6539,13079,6539,0,1,6541,977686,0.977686
7039,1143,5041,5761863,2,56318,14081,1,394328312,394328312,21118,7039,14079,7039,0,1,7041,3650522,3.650522
55,4555,1265,5762075,2,446,113,1,48657400,48657400,166,55,111,55,0,1,57,118226,0.118226
455,4555,1265,5762075,2,3646,913,1,67281400,67281400,1366,455,911,455,0,1,457,543378,0.543378
855,4555,1265,5762075,2,6846,1713,1,85905400,85905400,2566,855,1711,855,0,1,857,468587,0.468587
1255,4555,1265,5762075,2,10046,2513,1,104529400,104529400,3766,1255,2511,1255,0,1,1257,252135,0.252135
1655,4555,1265,5762075,2,13246,3313,1,123153400,123153400,4966,1655,3311,1655,0,1,1657,1837377,1.837377
2055,4555,1265,5762075,2,16446,4113,1,141777400,141777400,6166,2055,4111,2055,0,1,2057,2270997,2.270997
2455,4555,1265,5762075,2,19646,4913,1,160401400,160401400,7366,2455,4911,2455,0,1,2457,685524,0.685524
2855,4555,1265,5762075,2,22846,5713,1,179025400,179025400,8566,2855,5711,2855,0,1,2857,1890266,1.890266
3255,4555,1265,5762075,2,26046,6513,1,197649400,197649400,9766,3255,6511,3255,0,1,3257,3572961,3.572961
3655,4555,1265,5762075,2,29246,7313,1,216273400,216273400,10966,3655,7311,3655,0,1,3657,170151,0.170151
4055,4555,1265,5762075,2,32446,8113,1,234897400,234897400,12166,4055,8111,4055,0,1,4057,4448387,4.448387
4455,4555,1265,5762075,2,35646,8913,1,253521400,253521400,13366,4455,8911,4455,0,1,4457,3426174,3.426174
4855,4555,1265,5762075,2,38846,9713,1,272145400,272145400,14566,4855,9711,4855,0,1,4857,3169728,3.169728
5255,4555,1265,5762075,2,42046,10513,1,290769400,290769400,15766,5255,10511,5255,0,1,5257,1444256,1.444256
5655,4555,1265,5762075,2,45246,11313,1,309393400,309393400,16966,5655,11311,5655,0,1,5657,4340263,4.340263
6055,4555,1265,5762075,2,48446,12113,1,328017400,328017400,18166,6055,12111,6055,0,1,6057,1462130,1.46213
6455,4555,1265,5762075,2,51646,12913,1,346641400,346641400,19366,6455,12911,6455,0,1,6457,3723063,3.723063
6855,4555,1265,5762075,2,54846,13713,1,365265400,365265400,20566,6855,13711,6855,0,1,6857,345980,0.34598
55,1055,5465,5765575,2,446,113,1,48993400,48993400,166,55,111,55,0,1,57,9615,0.009615
455,1055,5465,5765575,2,3646,913,1,69857400,69857400,1366,455,911,455,0,1,457,92793,0.092793
855,1055,5465,5765575,2,6846,1713,1,90721400,90721400,2566,855,1711,855,0,1,857,48405,0.048405
1255,1055,5465,5765575,2,10046,2513,1,111585400,111585400,3766,1255,2511,1255,0,1,1257,264064,0.264064
1655,1055,5465,5765575,2,13246,3313,1,132449400,132449400,4966,1655,3311,1655,0,1,1657,75736,0.075736
2055,1055,5465,5765575,2,16446,4113,1,153313400,153313400,6166,2055,4111,2055,0,1,2057,369317,0.369317
2455,1055,5465,5765575,2,19646,4913,1,174177400,174177400,7366,2455,4911,2455,0,1,2457,432864,0.432864
2855,1055,5465,5765575,2,22846,5713,1,195041400,195041400,8566,2855,5711,2855,0,1,2857,133868,0.133868
3255,1055,5465,5765575,2,26046,6513,1,215905400,215905400,9766,3255,6511,3255,0,1,3257,691597,0.691597
3655,1055,5465,5765575,2,29246,7313,1,236769400,236769400,10966,3655,7311,3655,0,1,3657,854098,0.854098
4055,1055,5465,5765575,2,32446,8113,1,257633400,257633400,12166,4055,8111,4055,0,1,4057,1575314,1.575314
4455,1055,5465,5765575,2,35646,8913,1,278497400,278497400,13366,4455,8911,4455,0,1,4457,1111297,1.111297
4855,1055,5465,5765575,2,38846,9713,1,299361400,299361400,14566,4855,9711,4855,0,1,4857,148519,0.148519
5255,1055,5465,5765575,2,42046,10513,1,320225400,320225400,15766,5255,10511,5255,0,1,5257,246761,0.246761
5655,1055,5465,5765575,2,45246,11313,1,341089400,341089400,16966,5655,11311,5655,0,1,5657,2618387,2.618387
6055,1055,5465,5765575,2,48446,12113,1,361953400,361953400,18166,6055,12111,6055,0,1,6057,486090,0.48609
6455,1055,5465,5765575,2,51646,12913,1,382817400,382817400,19366,6455,12911,6455,0,1,6457,1453180,1.45318
6855,1055,5465,5765575,2,54846,13713,1,403681400,403681400,20566,6855,13711,6855,0,1,6857,82439,0.082439
39,5543,1041,5770263,2,318,81,1,48216312,48216312,118,39,79,39,0,1,41,8118,0.008118
539,5543,1041,5770263,2,4318,1081,1,74552312,74552312,1618,539,1079,539,0,1,541,7618,0.007618
1039,5543,1041,5770263,2,8318,2081,1,100888312,100888312,3118,1039,2079,1039,0,1,1041,244344,0.244344
1539,5543,1041,5770263,2,12318,3081,1,127224312,127224312,4618,1539,3079,1539,0,1,1541,261720,0.26172
2039,5543,1041,5770263,2,16318,4081,1,153560312,153560312,6118,2039,4079,2039,0,1,2041,926071,0.926071
2539,5543,1041,5770263,2,20318,5081,1,179896312,179896312,7618,2539,5079,2539,0,1,2541,327882,0.327882
3039,5543,1041,5770263,2,24318,6081,1,206232312,206232312,9118,3039,6079,3039,0,1,3041,680092,0.680092
3539,5543,1041,5770263,2,28318,7081,1,232568312,232568312,10618,3539,7079,3539,0,1,3541,4051168,4.051168
4039,5543,1041,5770263,2,32318,8081,1,258904312,258904312,12118,4039,8079,4039,0,1,4041,2129443,2.129443
4539,5543,1041,5770263,2,36318,9081,1,285240312,285240312,13618,4539,9079,4539,0,1,4541,234520,0.23452
5039,5543,1041,5770263,2,40318,10081,1,311576312,311576312,15118,5039,10079,5039,0,1,5041,430734,0.430734
5539,5543,1041,5770263,2,44318,11081,1,337912312,337912312,16618,5539,11079,5539,0,1,5541,593855,0.593855
6039,5543,1041,5770263,2,48318,12081,1,364248312,364248312,18118,6039,12079,6039,0,1,6041,2253057,2.253057
6539,5543,1041,5770263,2,52318,13081,1,390584312,390584312,19618,6539,13079,6539,0,1,6541,1020054,1.020054
7039,5543,1041,5770263,2,56318,14081,1,416920312,416920312,21118,7039,14079,7039,0,1,7041,2312461,2.312461
35,5540,1045,5789300,2,286,73,1,48158200,48158200,106,35,71,35,0,1,37,135422,0.135422
535,5540,1045,5789300,2,4286,1073,1,74498200,74498200,1606,535,1071,535,0,1,537,61445,0.061445
1035,5540,1045,5789300,2,8286,2073,1,100838200,100838200,3106,1035,2071,1035,0,1,1037,1174937,1.174937
1535,5540,1045,5789300,2,12286,3073,1,127178200,127178200,4606,1535,3071,1535,0,1,1537,1716267,1.716267
44,1153,5055,5828415,2,358,91,1,48812536,48812536,133,44,89,44,0,1,46,17130,0.01713
544,1153,5055,5828415,2,4358,1091,1,73644536,73644536,1633,544,1089,544,0,1,546,16119,0.016119
1044,1153,5055,5828415,2,8358,2091,1,98476536,98476536,3133,1044,2089,1044,0,1,1046,21237,0.021237
1544,1153,5055,5828415,2,12358,3091,1,123308536,123308536,4633,1544,3089,1544,0,1,1546,13473,0.013473
2044,1153,5055,5828415,2,16358,4091,1,148140536,148140536,6133,2044,4089,2044,0,1,2046,292601,0.292601
2544,1153,5055,5828415,2,20358,5091,1,172972536,172972536,7633,2544,5089,2544,0,1,2546,478492,0.478492
3044,1153,5055,5828415,2,24358,6091,1,197804536,197804536,9133,3044,6089,3044,0,1,3046,1356315,1.356315
3544,1153,5055,5828415,2,28358,7091,1,222636536,222636536,10633,3544,7089,3544,0,1,3546,688369,0.688369
4044,1153,5055,5828415,2,32358,8091,1,247468536,247468536,12133,4044,8089,4044,0,1,4046,778396,0.778396
4544,1153,5055,5828415,2,36358,9091,1,272300536,272300536,13633,4544,9089,4544,0,1,4546,187886,0.187886
5044,1153,5055,5828415,2,40358,10091,1,297132536,297132536,15133,5044,10089,5044,0,1,5046,736652,0.736652
5544,1153,5055,5828415,2,44358,11091,1,321964536,321964536,16633,5544,11089,5544,0,1,5546,28915,0.028915
6044,1153,5055,5828415,2,48358,12091,1,346796536,346796536,18133,6044,12089,6044,0,1,6046,3924927,3.924927
6544,1153,5055,5828415,2,52358,13091,1,371628536,371628536,19633,6544,13089,6544,0,1,6546,1018578,1.018578
7044,1153,5055,5828415,2,56358,14091,1,396460536,396460536,21133,7044,14089,7044,0,1,7046,1317225,1.317225
55,6055,965,5843075,2,446,113,1,49833400,49833400,166,55,111,55,0,1,57,113040,0.11304
455,6055,965,5843075,2,3646,913,1,72297400,72297400,1366,455,911,455,0,1,457,547872,0.547872
855,6055,965,5843075,2,6846,1713,1,94761400,94761400,2566,855,1711,855,0,1,857,471860,0.47186
1255,6055,965,5843075,2,10046,2513,1,117225400,117225400,3766,1255,2511,1255,0,1,1257,843976,0.843976
1655,6055,965,5843075,2,13246,3313,1,139689400,139689400,4966,1655,3311,1655,0,1,1657,1883499,1.883499
2055,6055,965,5843075,2,16446,4113,1,162153400,162153400,6166,2055,4111,2055,0,1,2057,2327226,2.327226
2455,6055,965,5843075,2,19646,4913,1,184617400,184617400,7366,2455,4911,2455,0,1,2457,2777064,2.777064
2855,6055,965,5843075,2,22846,5713,1,207081400,207081400,8566,2855,5711,2855,0,1,2857,140549,0.140549
3255,6055,965,5843075,2,26046,6513,1,229545400,229545400,9766,3255,6511,3255,0,1,3257,55240,0.05524
3655,6055,965,5843075,2,29246,7313,1,252009400,252009400,10966,3655,7311,3655,0,1,3657,944489,0.944489
4055,6055,965,5843075,2,32446,8113,1,274473400,274473400,12166,4055,8111,4055,0,1,4057,4571175,4.571175
4455,6055,965,5843075,2,35646,8913,1,296937400,296937400,13366,4455,8911,4455,0,1,4457,802102,0.802102
4855,6055,965,5843075,2,38846,9713,1,319401400,319401400,14566,4855,9711,4855,0,1,4857,5497436,5.497436
5255,6055,965,5843075,2,42046,10513,1,341865400,341865400,15766,5255,10511,5255,0,1,5257,1902943,1.902943
5655,6055,965,5843075,2,45246,11313,1,364329400,364329400,16966,5655,11311,5655,0,1,5657,1120069,1.120069
6055,6055,965,5843075,2,48446,12113,1,386793400,386793400,18166,6055,12111,6055,0,1,6057,6816302,6.816302
6455,6055,965,5843075,2,51646,12913,1,409257400,409257400,19366,6455,12911,6455,0,1,6457,779344,0.779344
6855,6055,965,5843075,2,54846,13713,1,431721400,431721400,20566,6855,13711,6855,0,1,6857,7720239,7.720239
40,3800,1540,5852000,2,326,83,1,48524800,48524800,121,40,81,40,0,1,42,104377,0.104377
440,3800,1540,5852000,2,3526,883,1,65612800,65612800,1321,440,881,440,0,1,442,545308,0.545308
840,3800,1540,5852000,2,6726,1683,1,82700800,82700800,2521,840,1681,840,0,1,842,991149,0.991149
1240,3800,1540,5852000,2,9926,2483,1,99788800,99788800,3721,1240,2481,1240,0,1,1242,1448060,1.44806
1640,3800,1540,5852000,2,13126,3283,1,116876800,116876800,4921,1640,3281,1640,0,1,1642,1893045,1.893045
2040,3800,1540,5852000,2,16326,4083,1,133964800,133964800,6121,2040,4081,2040,0,1,2042,305066,0.305066
2440,3800,1540,5852000,2,19526,4883,1,151052800,151052800,7321,2440,4881,2440,0,1,2442,2800280,2.80028
2840,3800,1540,5852000,2,22726,5683,1,168140800,168140800,8521,2840,5681,2840,0,1,2842,1681097,1.681097
3240,3800,1540,5852000,2,25926,6483,1,185228800,185228800,9721,3240,6481,3240,0,1,3242,3702744,3.702744
3640,3800,1540,5852000,2,29126,7283,1,202316800,202316800,10921,3640,7281,3640,0,1,3642,1155704,1.155704
4040,3800,1540,5852000,2,32326,8083,1,219404800,219404800,12121,4040,8081,4040,0,1,4042,215719,0.215719
4440,3800,1540,5852000,2,35526,8883,1,236492800,236492800,13321,4440,8881,4440,0,1,4442,2013222,2.013222
4840,3800,1540,5852000,2,38726,9683,1,253580800,253580800,14521,4840,9681,4840,0,1,4842,2623946,2.623946
5240,3800,1540,5852000,2,41926,10483,1,270668800,270668800,15721,5240,10481,5240,0,1,5242,643389,0.643389
5640,3800,1540,5852000,2,45126,11283,1,287756800,287756800,16921,5640,11281,5640,0,1,5642,5000048,5.000048
6040,3800,1540,5852000,2,48326,12083,1,304844800,304844800,18121,6040,12081,6040,0,1,6042,897459,0.897459
6440,3800,1540,5852000,2,51526,12883,1,321932800,321932800,19321,6440,12881,6440,0,1,6442,4094970,4.09497
6840,3800,1540,5852000,2,54726,13683,1,339020800,339020800,20521,6840,13681,6840,0,1,6842,327834,0.327834
44,5553,1055,5858415,2,358,91,1,49193336,49193336,133,44,89,44,0,1,46,11110,0.01111
544,5553,1055,5858415,2,4358,1091,1,75625336,75625336,1633,544,1089,544,0,1,546,90484,0.090484
1044,5553,1055,5858415,2,8358,2091,1,102057336,102057336,3133,1044,2089,1044,0,1,1046,174487,0.174487
1544,5553,1055,5858415,2,12358,3091,1,128489336,128489336,4633,1544,3089,1544,0,1,1546,514669,0.514669
2044,5553,1055,5858415,2,16358,4091,1,154921336,154921336,6133,2044,4089,2044,0,1,2046,11272,0.011272
2544,5553,1055,5858415,2,20358,5091,1,181353336,181353336,7633,2544,5089,2544,0,1,2546,2763216,2.763216
3044,5553,1055,5858415,2,24358,6091,1,207785336,207785336,9133,3044,6089,3044,0,1,3046,15847,0.015847
3544,5553,1055,5858415,2,28358,7091,1,234217336,234217336,10633,3544,7089,3544,0,1,3546,1973522,1.973522
4044,5553,1055,5858415,2,32358,8091,1,260649336,260649336,12133,4044,8089,4044,0,1,4046,491306,0.491306
4544,5553,1055,5858415,2,36358,9091,1,287081336,287081336,13633,4544,9089,4544,0,1,4546,1318321,1.318321
5044,5553,1055,5858415,2,40358,10091,1,313513336,313513336,15133,5044,10089,5044,0,1,5046,3360023,3.360023
5544,5553,1055,5858415,2,44358,11091,1,339945336,339945336,16633,5544,11089,5544,0,1,5546,989198,0.989198
6044,5553,1055,5858415,2,48358,12091,1,366377336,366377336,18133,6044,12089,6044,0,1,6046,854458,0.854458
6544,5553,1055,5858415,2,52358,13091,1,392809336,392809336,19633,6544,13089,6544,0,1,6546,805552,0.805552
7044,5553,1055,5858415,2,56358,14091,1,419241336,419241336,21133,7044,14089,7044,0,1,7046,549964,0.549964
40,1300,4540,5902000,2,326,83,1,49084800,49084800,121,40,81,40,0,1,42,110335,0.110335
440,1300,4540,5902000,2,3526,883,1,67772800,67772800,1321,440,881,440,0,1,442,123037,0.123037
840,1300,4540,5902000,2,6726,1683,1,86460800,86460800,2521,840,1681,840,0,1,842,618403,0.618403
1240,1300,4540,5902000,2,9926,2483,1,105148800,105148800,3721,1240,2481,1240,0,1,1242,383593,0.383593
1640,1300,4540,5902000,2,13126,3283,1,123836800,123836800,4921,1640,3281,1640,0,1,1642,551216,0.551216
2040,1300,4540,5902000,2,16326,4083,1,142524800,142524800,6121,2040,4081,2040,0,1,2042,703067,0.703067
2440,1300,4540,5902000,2,19526,4883,1,161212800,161212800,7321,2440,4881,2440,0,1,2442,2182574,2.182574
2840,1300,4540,5902000,2,22726,5683,1,179900800,179900800,8521,2840,5681,2840,0,1,2842,196251,0.196251
3240,1300,4540,5902000,2,25926,6483,1,198588800,198588800,9721,3240,6481,3240,0,1,3242,1394910,1.39491
3640,1300,4540,5902000,2,29126,7283,1,217276800,217276800,10921,3640,7281,3640,0,1,3642,3050244,3.050244
4040,1300,4540,5902000,2,32326,8083,1,235964800,235964800,12121,4040,8081,4040,0,1,4042,1232429,1.232429
4440,1300,4540,5902000,2,35526,8883,1,254652800,254652800,13321,4440,8881,4440,0,1,4442,651912,0.651912
4840,1300,4540,5902000,2,38726,9683,1,273340800,273340800,14521,4840,9681,4840,0,1,4842,977936,0.977936
5240,1300,4540,5902000,2,41926,10483,1,292028800,292028800,15721,5240,10481,5240,0,1,5242,1075802,1.075802
5640,1300,4540,5902000,2,45126,11283,1,310716800,310716800,16921,5640,11281,5640,0,1,5642,17758,0.017758
6040,1300,4540,5902000,2,48326,12083,1,329404800,329404800,18121,6040,12081,6040,0,1,6042,383681,0.383681
6440,1300,4540,5902000,2,51526,12883,1,348092800,348092800,19321,6440,12881,6440,0,1,6442,1046094,1.046094
6840,1300,4540,5902000,2,54726,13683,1,366780800,366780800,20521,6840,13681,6840,0,1,6842,1420508,1.420508
40,6300,940,5922000,2,326,83,1,49692800,49692800,121,40,81,40,0,1,42,107935,0.107935
440,6300,940,5922000,2,3526,883,1,72860800,72860800,1321,440,881,440,0,1,442,535939,0.535939
840,6300,940,5922000,2,6726,1683,1,96028800,96028800,2521,840,1681,840,0,1,842,984371,0.984371
1240,6300,940,5922000,2,9926,2483,1,119196800,119196800,3721,1240,2481,1240,0,1,1242,1449732,1.449732
1640,6300,940,5922000,2,13126,3283,1,142364800,142364800,4921,1640,3281,1640,0,1,1642,1879291,1.879291
2040,6300,940,5922000,2,16326,4083,1,165532800,165532800,6121,2040,4081,2040,0,1,2042,2283911,2.283911
2440,6300,940,5922000,2,19526,4883,1,188700800,188700800,7321,2440,4881,2440,0,1,2442,1316134,1.316134
2840,6300,940,5922000,2,22726,5683,1,211868800,211868800,8521,2840,5681,2840,0,1,2842,3168142,3.168142
3240,6300,940,5922000,2,25926,6483,1,235036800,235036800,9721,3240,6481,3240,0,1,3242,547328,0.547328
3640,6300,940,5922000,2,29126,7283,1,258204800,258204800,10921,3640,7281,3640,0,1,3642,4106787,4.106787
4040,6300,940,5922000,2,32326,8083,1,281372800,281372800,12121,4040,8081,4040,0,1,4042,363895,0.363895
4440,6300,940,5922000,2,35526,8883,1,304540800,304540800,13321,4440,8881,4440,0,1,4442,4553023,4.553023
4840,6300,940,5922000,2,38726,9683,1,327708800,327708800,14521,4840,9681,4840,0,1,4842,4414224,4.414224
5240,6300,940,5922000,2,41926,10483,1,350876800,350876800,15721,5240,10481,5240,0,1,5242,3143938,3.143938
5640,6300,940,5922000,2,45126,11283,1,374044800,374044800,16921,5640,11281,5640,0,1,5642,6368939,6.368939
6040,6300,940,5922000,2,48326,12083,1,397212800,397212800,18121,6040,12081,6040,0,1,6042,5052163,5.052163
6440,6300,940,5922000,2,51526,12883,1,420380800,420380800,19321,6440,12881,6440,0,1,6442,5433915,5.433915
6840,6300,940,5922000,2,54726,13683,1,443548800,443548800,20521,6840,13681,6840,0,1,6842,7764184,7.764184
40,4800,1240,5952000,2,326,83,1,49548800,49548800,121,40,81,40,0,1,42,107021,0.107021
440,4800,1240,5952000,2,3526,883,1,68876800,68876800,1321,440,881,440,0,1,442,530133,0.530133
840,4800,1240,5952000,2,6726,1683,1,88204800,88204800,2521,840,1681,840,0,1,842,970701,0.970701
1240,4800,1240,5952000,2,9926,2483,1,107532800,107532800,3721,1240,2481,1240,0,1,1242,1400443,1.400443
1640,4800,1240,5952000,2,13126,3283,1,126860800,126860800,4921,1640,3281,1640,0,1,1642,1843391,1.843391
2040,4800,1240,5952000,2,16326,4083,1,146188800,146188800,6121,2040,4081,2040,0,1,2042,2272620,2.27262
2440,4800,1240,5952000,2,19526,4883,1,165516800,165516800,7321,2440,4881,2440,0,1,2442,850468,0.850468
2840,4800,1240,5952000,2,22726,5683,1,184844800,184844800,8521,2840,5681,2840,0,1,2842,3144501,3.144501
3240,4800,1240,5952000,2,25926,6483,1,204172800,204172800,9721,3240,6481,3240,0,1,3242,3584505,3.584505
3640,4800,1240,5952000,2,29126,7283,1,223500800,223500800,10921,3640,7281,3640,0,1,3642,1822592,1.822592
4040,4800,1240,5952000,2,32326,8083,1,242828800,242828800,12121,4040,8081,4040,0,1,4042,828586,0.828586
4440,4800,1240,5952000,2,35526,8883,1,262156800,262156800,13321,4440,8881,4440,0,1,4442,4907917,4.907917
4840,4800,1240,5952000,2,38726,9683,1,281484800,281484800,14521,4840,9681,4840,0,1,4842,2665873,2.665873
5240,4800,1240,5952000,2,41926,10483,1,300812800,300812800,15721,5240,10481,5240,0,1,5242,2198268,2.198268
5640,4800,1240,5952000,2,45126,11283,1,320140800,320140800,16921,5640,11281,5640,0,1,5642,6237169,6.237169
6040,4800,1240,5952000,2,48326,12083,1,339468800,339468800,18121,6040,12081,6040,0,1,6042,6635688,6.635688
6440,4800,1240,5952000,2,51526,12883,1,358796800,358796800,19321,6440,12881,6440,0,1,6442,7078666,7.078666
6840,4800,1240,5952000,2,54726,13683,1,378124800,378124800,20521,6840,13681,6840,0,1,6842,7537220,7.53722
55,3805,1565,5954825,2,446,113,1,50001400,50001400,166,55,111,55,0,1,57,122658,0.122658
455,3805,1565,5954825,2,3646,913,1,67185400,67185400,1366,455,911,455,0,1,457,578211,0.578211
855,3805,1565,5954825,2,6846,1713,1,84369400,84369400,2566,855,1711,855,0,1,857,1039395,1.039395
1255,3805,1565,5954825,2,10046,2513,1,101553400,101553400,3766,1255,2511,1255,0,1,1257,1508764,1.508764
1655,3805,1565,5954825,2,13246,3313,1,118737400,118737400,4966,1655,3311,1655,0,1,1657,1763254,1.763254
2055,3805,1565,5954825,2,16446,4113,1,135921400,135921400,6166,2055,4111,2055,0,1,2057,2413899,2.413899
2455,3805,1565,5954825,2,19646,4913,1,153105400,153105400,7366,2455,4911,2455,0,1,2457,578221,0.578221
2855,3805,1565,5954825,2,22846,5713,1,170289400,170289400,8566,2855,5711,2855,0,1,2857,1742653,1.742653
3255,3805,1565,5954825,2,26046,6513,1,187473400,187473400,9766,3255,6511,3255,0,1,3257,2029871,2.029871
3655,3805,1565,5954825,2,29246,7313,1,204657400,204657400,10966,3655,7311,3655,0,1,3657,4297747,4.297747
4055,3805,1565,5954825,2,32446,8113,1,221841400,221841400,12166,4055,8111,4055,0,1,4057,4737920,4.73792
4455,3805,1565,5954825,2,35646,8913,1,239025400,239025400,13366,4455,8911,4455,0,1,4457,3463368,3.463368
4855,3805,1565,5954825,2,38846,9713,1,256209400,256209400,14566,4855,9711,4855,0,1,4857,5663579,5.663579
5255,3805,1565,5954825,2,42046,10513,1,273393400,273393400,15766,5255,10511,5255,0,1,5257,3323186,3.323186
5655,3805,1565,5954825,2,45246,11313,1,290577400,290577400,16966,5655,11311,5655,0,1,5657,6584560,6.58456
6055,3805,1565,5954825,2,48446,12113,1,307761400,307761400,18166,6055,12111,6055,0,1,6057,1420489,1.420489
6455,3805,1565,5954825,2,51646,12913,1,324945400,324945400,19366,6455,12911,6455,0,1,6457,5523471,5.523471
6855,3805,1565,5954825,2,54846,13713,1,342129400,342129400,20566,6855,13711,6855,0,1,6857,839107,0.839107
55,1305,4565,5957325,2,446,113,1,50241400,50241400,166,55,111,55,0,1,57,121698,0.121698
455,1305,4565,5957325,2,3646,913,1,69025400,69025400,1366,455,911,455,0,1,457,572727,0.572727
855,1305,4565,5957325,2,6846,1713,1,87809400,87809400,2566,855,1711,855,0,1,857,196853,0.196853
1255,1305,4565,5957325,2,10046,2513,1,106593400,106593400,3766,1255,2511,1255,0,1,1257,268296,0.268296
1655,1305,4565,5957325,2,13246,3313,1,125377400,125377400,4966,1655,3311,1655,0,1,1657,428606,0.428606
2055,1305,4565,5957325,2,16446,4113,1,144161400,144161400,6166,2055,4111,2055,0,1,2057,111470,0.11147
2455,1305,4565,5957325,2,19646,4913,1,162945400,162945400,7366,2455,4911,2455,0,1,2457,1740904,1.740904
2855,1305,4565,5957325,2,22846,5713,1,181729400,181729400,8566,2855,5711,2855,0,1,2857,168847,0.168847
3255,1305,4565,5957325,2,26046,6513,1,200513400,200513400,9766,3255,6511,3255,0,1,3257,571497,0.571497
3655,1305,4565,5957325,2,29246,7313,1,219297400,219297400,10966,3655,7311,3655,0,1,3657,413362,0.413362
4055,1305,4565,5957325,2,32446,8113,1,238081400,238081400,12166,4055,8111,4055,0,1,4057,1268507,1.268507
4455,1305,4565,5957325,2,35646,8913,1,256865400,256865400,13366,4455,8911,4455,0,1,4457,1153455,1.153455
4855,1305,4565,5957325,2,38846,9713,1,275649400,275649400,14566,4855,9711,4855,0,1,4857,1341487,1.341487
5255,1305,4565,5957325,2,42046,10513,1,294433400,294433400,15766,5255,10511,5255,0,1,5257,1504175,1.504175
5655,1305,4565,5957325,2,45246,11313,1,313217400,313217400,16966,5655,11311,5655,0,1,5657,3172551,3.172551
6055,1305,4565,5957325,2,48446,12113,1,332001400,332001400,18166,6055,12111,6055,0,1,6057,605516,0.605516
6455,1305,4565,5957325,2,51646,12913,1,350785400,350785400,19366,6455,12911,6455,0,1,6457,1748524,1.748524
6855,1305,4565,5957325,2,54846,13713,1,369569400,369569400,20566,6855,13711,6855,0,1,6857,2244120,2.24412
40,2800,2140,5992000,2,326,83,1,49516800,49516800,121,40,81,40,0,1,42,106945,0.106945
440,2800,2140,5992000,2,3526,883,1,65324800,65324800,1321,440,881,440,0,1,442,541520,0.54152
840,2800,2140,5992000,2,6726,1683,1,81132800,81132800,2521,840,1681,840,0,1,842,987941,0.987941
1240,2800,2140,5992000,2,9926,2483,1,96940800,96940800,3721,1240,2481,1240,0,1,1242,1431661,1.431661
1640,2800,2140,5992000,2,13126,3283,1,112748800,112748800,4921,1640,3281,1640,0,1,1642,1203204,1.203204
2040,2800,2140,5992000,2,16326,4083,1,128556800,128556800,6121,2040,4081,2040,0,1,2042,372119,0.372119
2440,2800,2140,5992000,2,19526,4883,1,144364800,144364800,7321,2440,4881,2440,0,1,2442,2778776,2.778776
2840,2800,2140,5992000,2,22726,5683,1,160172800,160172800,8521,2840,5681,2840,0,1,2842,3228987,3.228987
3240,2800,2140,5992000,2,25926,6483,1,175980800,175980800,9721,3240,6481,3240,0,1,3242,3673328,3.673328
3640,2800,2140,5992000,2,29126,7283,1,191788800,191788800,10921,3640,7281,3640,0,1,3642,2049020,2.04902
4040,2800,2140,5992000,2,32326,8083,1,207596800,207596800,12121,4040,8081,4040,0,1,4042,3481515,3.481515
4440,2800,2140,5992000,2,35526,8883,1,223404800,223404800,13321,4440,8881,4440,0,1,4442,2009152,2.009152
4840,2800,2140,5992000,2,38726,9683,1,239212800,239212800,14521,4840,9681,4840,0,1,4842,1057941,1.057941
5240,2800,2140,5992000,2,41926,10483,1,255020800,255020800,15721,5240,10481,5240,0,1,5242,2004702,2.004702
5640,2800,2140,5992000,2,45126,11283,1,270828800,270828800,16921,5640,11281,5640,0,1,5642,1806274,1.806274
6040,2800,2140,5992000,2,48326,12083,1,286636800,286636800,18121,6040,12081,6040,0,1,6042,5510329,5.510329
6440,2800,2140,5992000,2,51526,12883,1,302444800,302444800,19321,6440,12881,6440,0,1,6442,4898668,4.898668
6840,2800,2140,5992000,2,54726,13683,1,318252800,318252800,20521,6840,13681,6840,0,1,6842,15955,0.015955
39,1693,3541,5994913,2,318,81,1,49592312,49592312,118,39,79,39,0,1,41,106466,0.106466
539,1693,3541,5994913,2,4318,1081,1,70528312,70528312,1618,539,1079,539,0,1,541,675442,0.675442
1039,1693,3541,5994913,2,8318,2081,1,91464312,91464312,3118,1039,2079,1039,0,1,1041,1103815,1.103815
1539,1693,3541,5994913,2,12318,3081,1,112400312,112400312,4618,1539,3079,1539,0,1,1541,1285469,1.285469
2039,1693,3541,5994913,2,16318,4081,1,133336312,133336312,6118,2039,4079,2039,0,1,2041,664064,0.664064
2539,1693,3541,5994913,2,20318,5081,1,154272312,154272312,7618,2539,5079,2539,0,1,2541,2338072,2.338072
3039,1693,3541,5994913,2,24318,6081,1,175208312,175208312,9118,3039,6079,3039,0,1,3041,1036837,1.036837
3539,1693,3541,5994913,2,28318,7081,1,196144312,196144312,10618,3539,7079,3539,0,1,3541,25078,0.025078
4039,1693,3541,5994913,2,32318,8081,1,217080312,217080312,12118,4039,8079,4039,0,1,4041,101041,0.101041
4539,1693,3541,5994913,2,36318,9081,1,238016312,238016312,13618,4539,9079,4539,0,1,4541,4836321,4.836321
5039,1693,3541,5994913,2,40318,10081,1,258952312,258952312,15118,5039,10079,5039,0,1,5041,1453058,1.453058
5539,1693,3541,5994913,2,44318,11081,1,279888312,279888312,16618,5539,11079,5539,0,1,5541,5009199,5.009199
6039,1693,3541,5994913,2,48318,12081,1,300824312,300824312,18118,6039,12079,6039,0,1,6041,402431,0.402431
6539,1693,3541,5994913,2,52318,13081,1,321760312,321760312,19618,6539,13079,6539,0,1,6541,569677,0.569677
7039,1693,3541,5994913,2,56318,14081,1,342696312,342696312,21118,7039,14079,7039,0,1,7041,467192,0.467192
39,3893,1541,5999113,2,318,81,1,49688312,49688312,118,39,79,39,0,1,41,109262,0.109262
539,3893,1541,5999113,2,4318,1081,1,71424312,71424312,1618,539,1079,539,0,1,541,681417,0.681417
1039,3893,1541,5999113,2,8318,2081,1,93160312,93160312,3118,1039,2079,1039,0,1,1041,1269632,1.269632
1539,3893,1541,5999113,2,12318,3081,1,114896312,114896312,4618,1539,3079,1539,0,1,1541,1841907,1.841907
2039,3893,1541,5999113,2,16318,4081,1,136632312,136632312,6118,2039,4079,2039,0,1,2041,2429477,2.429477
2539,3893,1541,5999113,2,20318,5081,1,158368312,158368312,7618,2539,5079,2539,0,1,2541,84242,0.084242
3039,3893,1541,5999113,2,24318,6081,1,180104312,180104312,9118,3039,6079,3039,0,1,3041,1172416,1.172416
3539,3893,1541,5999113,2,28318,7081,1,201840312,201840312,10618,3539,7079,3539,0,1,3541,4177417,4.177417
4039,3893,1541,5999113,2,32318,8081,1,223576312,223576312,12118,4039,8079,4039,0,1,4041,885381,0.885381
4539,3893,1541,5999113,2,36318,9081,1,245312312,245312312,13618,4539,9079,4539,0,1,4541,1614651,1.614651
5039,3893,1541,5999113,2,40318,10081,1,267048312,267048312,15118,5039,10079,5039,0,1,5041,2368502,2.368502
5539,3893,1541,5999113,2,44318,11081,1,288784312,288784312,16618,5539,11079,5539,0,1,5541,3935109,3.935109
6039,3893,1541,5999113,2,48318,12081,1,310520312,310520312,18118,6039,12079,6039,0,1,6041,7149878,7.149878
6539,3893,1541,5999113,2,52318,13081,1,332256312,332256312,19618,6539,13079,6539,0,1,6541,2431460,2.43146
7039,3893,1541,5999113,2,56318,14081,1,353992312,353992312,21118,7039,14079,7039,0,1,7041,6569922,6.569922
40,1800,3340,6012000,2,326,83,1,49740800,49740800,121,40,81,40,0,1,42,112741,0.112741
440,1800,3340,6012000,2,3526,883,1,66188800,66188800,1321,440,881,440,0,1,442,562940,0.56294
840,1800,3340,6012000,2,6726,1683,1,82636800,82636800,2521,840,1681,840,0,1,842,1017580,1.01758
1240,1800,3340,6012000,2,9926,2483,1,99084800,99084800,3721,1240,2481,1240,0,1,1242,373400,0.3734
1640,1800,3340,6012000,2,13126,3283,1,115532800,115532800,4921,1640,3281,1640,0,1,1642,303982,0.303982
2040,1800,3340,6012000,2,16326,4083,1,131980800,131980800,6121,2040,4081,2040,0,1,2042,691051,0.691051
2440,1800,3340,6012000,2,19526,4883,1,148428800,148428800,7321,2440,4881,2440,0,1,2442,2863220,2.86322
2840,1800,3340,6012000,2,22726,5683,1,164876800,164876800,8521,2840,5681,2840,0,1,2842,1179126,1.179126
3240,1800,3340,6012000,2,25926,6483,1,181324800,181324800,9721,3240,6481,3240,0,1,3242,149614,0.149614
3640,1800,3340,6012000,2,29126,7283,1,197772800,197772800,10921,3640,7281,3640,0,1,3642,63188,0.063188
4040,1800,3340,6012000,2,32326,8083,1,214220800,214220800,12121,4040,8081,4040,0,1,4042,1802006,1.802006
4440,1800,3340,6012000,2,35526,8883,1,230668800,230668800,13321,4440,8881,4440,0,1,4442,436792,0.436792
4840,1800,3340,6012000,2,38726,9683,1,247116800,247116800,14521,4840,9681,4840,0,1,4842,128269,0.128269
5240,1800,3340,6012000,2,41926,10483,1,263564800,263564800,15721,5240,10481,5240,0,1,5242,937571,0.937571
5640,1800,3340,6012000,2,45126,11283,1,280012800,280012800,16921,5640,11281,5640,0,1,5642,1140537,1.140537
6040,1800,3340,6012000,2,48326,12083,1,296460800,296460800,18121,6040,12081,6040,0,1,6042,1577746,1.577746
6440,1800,3340,6012000,2,51526,12883,1,312908800,312908800,19321,6440,12881,6440,0,1,6442,227370,0.22737
6840,1800,3340,6012000,2,54726,13683,1,329356800,329356800,20521,6840,13681,6840,0,1,6842,33275,0.033275
40,1050,5740,6027000,2,326,83,1,50388800,50388800,121,40,81,40,0,1,42,25576,0.025576
440,1050,5740,6027000,2,3526,883,1,72116800,72116800,1321,440,881,440,0,1,442,32784,0.032784
840,1050,5740,6027000,2,6726,1683,1,93844800,93844800,2521,840,1681,840,0,1,842,7069,0.007069
1240,1050,5740,6027000,2,9926,2483,1,115572800,115572800,3721,1240,2481,1240,0,1,1242,45020,0.04502
1640,1050,5740,6027000,2,13126,3283,1,137300800,137300800,4921,1640,3281,1640,0,1,1642,47812,0.047812
2040,1050,5740,6027000,2,16326,4083,1,159028800,159028800,6121,2040,4081,2040,0,1,2042,357931,0.357931
2440,1050,5740,6027000,2,19526,4883,1,180756800,180756800,7321,2440,4881,2440,0,1,2442,69992,0.069992
2840,1050,5740,6027000,2,22726,5683,1,202484800,202484800,8521,2840,5681,2840,0,1,2842,582490,0.58249
3240,1050,5740,6027000,2,25926,6483,1,224212800,224212800,9721,3240,6481,3240,0,1,3242,105150,0.10515
3640,1050,5740,6027000,2,29126,7283,1,245940800,245940800,10921,3640,7281,3640,0,1,3642,249830,0.24983
4040,1050,5740,6027000,2,32326,8083,1,267668800,267668800,12121,4040,8081,4040,0,1,4042,16781,0.016781
4440,1050,5740,6027000,2,35526,8883,1,289396800,289396800,13321,4440,8881,4440,0,1,4442,365159,0.365159
4840,1050,5740,6027000,2,38726,9683,1,311124800,311124800,14521,4840,9681,4840,0,1,4842,1441102,1.441102
5240,1050,5740,6027000,2,41926,10483,1,332852800,332852800,15721,5240,10481,5240,0,1,5242,185766,0.185766
5640,1050,5740,6027000,2,45126,11283,1,354580800,354580800,16921,5640,11281,5640,0,1,5642,595107,0.595107
6040,1050,5740,6027000,2,48326,12083,1,376308800,376308800,18121,6040,12081,6040,0,1,6042,326002,0.326002
6440,1050,5740,6027000,2,51526,12883,1,398036800,398036800,19321,6440,12881,6440,0,1,6442,1681339,1.681339
6840,1050,5740,6027000,2,54726,13683,1,419764800,419764800,20521,6840,13681,6840,0,1,6842,1652898,1.652898
44,1703,3555,6054165,2,358,91,1,50284136,50284136,133,44,89,44,0,1,46,112665,0.112665
544,1703,3555,6054165,2,4358,1091,1,71316136,71316136,1633,544,1089,544,0,1,546,684745,0.684745
1044,1703,3555,6054165,2,8358,2091,1,92348136,92348136,3133,1044,2089,1044,0,1,1046,1264827,1.264827
1544,1703,3555,6054165,2,12358,3091,1,113380136,113380136,4633,1544,3089,1544,0,1,1546,730301,0.730301
2044,1703,3555,6054165,2,16358,4091,1,134412136,134412136,6133,2044,4089,2044,0,1,2046,2429421,2.429421
2544,1703,3555,6054165,2,20358,5091,1,155444136,155444136,7633,2544,5089,2544,0,1,2546,3011694,3.011694
3044,1703,3555,6054165,2,24358,6091,1,176476136,176476136,9133,3044,6089,3044,0,1,3046,1026814,1.026814
3544,1703,3555,6054165,2,28358,7091,1,197508136,197508136,10633,3544,7089,3544,0,1,3546,2086776,2.086776
4044,1703,3555,6054165,2,32358,8091,1,218540136,218540136,12133,4044,8089,4044,0,1,4046,1101053,1.101053
4544,1703,3555,6054165,2,36358,9091,1,239572136,239572136,13633,4544,9089,4544,0,1,4546,1985355,1.985355
5044,1703,3555,6054165,2,40358,10091,1,260604136,260604136,15133,5044,10089,5044,0,1,5046,309898,0.309898
5544,1703,3555,6054165,2,44358,11091,1,281636136,281636136,16633,5544,11089,5544,0,1,5546,207204,0.207204
6044,1703,3555,6054165,2,48358,12091,1,302668136,302668136,18133,6044,12089,6044,0,1,6046,1729713,1.729713
6544,1703,3555,6054165,2,52358,13091,1,323700136,323700136,19633,6544,13089,6544,0,1,6546,410761,0.410761
7044,1703,3555,6054165,2,56358,14091,1,344732136,344732136,21133,7044,14089,7044,0,1,7046,1165162,1.165162
44,3903,1555,6069165,2,358,91,1,50474536,50474536,133,44,89,44,0,1,46,26476,0.026476
544,3903,1555,6069165,2,4358,1091,1,72306536,72306536,1633,544,1089,544,0,1,546,691946,0.691946
1044,3903,1555,6069165,2,8358,2091,1,94138536,94138536,3133,1044,2089,1044,0,1,1046,1277427,1.277427
1544,3903,1555,6069165,2,12358,3091,1,115970536,115970536,4633,1544,3089,1544,0,1,1546,1860239,1.860239
2044,3903,1555,6069165,2,16358,4091,1,137802536,137802536,6133,2044,4089,2044,0,1,2046,2416623,2.416623
2544,3903,1555,6069165,2,20358,5091,1,159634536,159634536,7633,2544,5089,2544,0,1,2546,1829218,1.829218
3044,3903,1555,6069165,2,24358,6091,1,181466536,181466536,9133,3044,6089,3044,0,1,3046,3612743,3.612743
3544,3903,1555,6069165,2,28358,7091,1,203298536,203298536,10633,3544,7089,3544,0,1,3546,1813934,1.813934
4044,3903,1555,6069165,2,32358,8091,1,225130536,225130536,12133,4044,8089,4044,0,1,4046,541564,0.541564
4544,3903,1555,6069165,2,36358,9091,1,246962536,246962536,13633,4544,9089,4544,0,1,4546,181129,0.181129
5044,3903,1555,6069165,2,40358,10091,1,268794536,268794536,15133,5044,10089,5044,0,1,5046,4969877,4.969877
5544,3903,1555,6069165,2,44358,11091,1,290626536,290626536,16633,5544,11089,5544,0,1,5546,6632444,6.632444
6044,3903,1555,6069165,2,48358,12091,1,312458536,312458536,18133,6044,12089,6044,0,1,6046,7167991,7.167991
6544,3903,1555,6069165,2,52358,13091,1,334290536,334290536,19633,6544,13089,6544,0,1,6546,7842628,7.842628
7044,3903,1555,6069165,2,56358,14091,1,356122536,356122536,21133,7044,14089,7044,0,1,7046,8418243,8.418243
40,3300,1840,6072000,2,326,83,1,50220800,50220800,121,40,81,40,0,1,42,104330,0.10433
440,3300,1840,6072000,2,3526,883,1,66668800,66668800,1321,440,881,440,0,1,442,549109,0.549109
840,3300,1840,6072000,2,6726,1683,1,83116800,83116800,2521,840,1681,840,0,1,842,655742,0.655742
1240,3300,1840,6072000,2,9926,2483,1,99564800,99564800,3721,1240,2481,1240,0,1,1242,1448526,1.448526
1640,3300,1840,6072000,2,13126,3283,1,116012800,116012800,4921,1640,3281,1640,0,1,1642,1904659,1.904659
2040,3300,1840,6072000,2,16326,4083,1,132460800,132460800,6121,2040,4081,2040,0,1,2042,2355947,2.355947
2440,3300,1840,6072000,2,19526,4883,1,148908800,148908800,7321,2440,4881,2440,0,1,2442,204395,0.204395
2840,3300,1840,6072000,2,22726,5683,1,165356800,165356800,8521,2840,5681,2840,0,1,2842,720822,0.720822
3240,3300,1840,6072000,2,25926,6483,1,181804800,181804800,9721,3240,6481,3240,0,1,3242,1458342,1.458342
3640,3300,1840,6072000,2,29126,7283,1,198252800,198252800,10921,3640,7281,3640,0,1,3642,4155694,4.155694
4040,3300,1840,6072000,2,32326,8083,1,214700800,214700800,12121,4040,8081,4040,0,1,4042,350694,0.350694
4440,3300,1840,6072000,2,35526,8883,1,231148800,231148800,13321,4440,8881,4440,0,1,4442,221374,0.221374
4840,3300,1840,6072000,2,38726,9683,1,247596800,247596800,14521,4840,9681,4840,0,1,4842,275651,0.275651
5240,3300,1840,6072000,2,41926,10483,1,264044800,264044800,15721,5240,10481,5240,0,1,5242,1289915,1.289915
5640,3300,1840,6072000,2,45126,11283,1,280492800,280492800,16921,5640,11281,5640,0,1,5642,2413068,2.413068
6040,3300,1840,6072000,2,48326,12083,1,296940800,296940800,18121,6040,12081,6040,0,1,6042,4741106,4.741106
6440,3300,1840,6072000,2,51526,12883,1,313388800,313388800,19321,6440,12881,6440,0,1,6442,429193,0.429193
6840,3300,1840,6072000,2,54726,13683,1,329836800,329836800,20521,6840,13681,6840,0,1,6842,4249533,4.249533
55,2805,2165,6072825,2,446,113,1,50769400,50769400,166,55,111,55,0,1,57,122426,0.122426
455,2805,2165,6072825,2,3646,913,1,66673400,66673400,1366,455,911,455,0,1,457,562891,0.562891
855,2805,2165,6072825,2,6846,1713,1,82577400,82577400,2566,855,1711,855,0,1,857,624843,0.624843
1255,2805,2165,6072825,2,10046,2513,1,98481400,98481400,3766,1255,2511,1255,0,1,1257,1459981,1.459981
1655,2805,2165,6072825,2,13246,3313,1,114385400,114385400,4966,1655,3311,1655,0,1,1657,784363,0.784363
2055,2805,2165,6072825,2,16446,4113,1,130289400,130289400,6166,2055,4111,2055,0,1,2057,1079957,1.079957
2455,2805,2165,6072825,2,19646,4913,1,146193400,146193400,7366,2455,4911,2455,0,1,2457,2814362,2.814362
2855,2805,2165,6072825,2,22846,5713,1,162097400,162097400,8566,2855,5711,2855,0,1,2857,1656340,1.65634
3255,2805,2165,6072825,2,26046,6513,1,178001400,178001400,9766,3255,6511,3255,0,1,3257,3175261,3.175261
3655,2805,2165,6072825,2,29246,7313,1,193905400,193905400,10966,3655,7311,3655,0,1,3657,2676444,2.676444
4055,2805,2165,6072825,2,32446,8113,1,209809400,209809400,12166,4055,8111,4055,0,1,4057,1110939,1.110939
4455,2805,2165,6072825,2,35646,8913,1,225713400,225713400,13366,4455,8911,4455,0,1,4457,3904570,3.90457
4855,2805,2165,6072825,2,38846,9713,1,241617400,241617400,14566,4855,9711,4855,0,1,4857,2967889,2.967889
5255,2805,2165,6072825,2,42046,10513,1,257521400,257521400,15766,5255,10511,5255,0,1,5257,6024496,6.024496
5655,2805,2165,6072825,2,45246,11313,1,273425400,273425400,16966,5655,11311,5655,0,1,5657,85179,0.085179
6055,2805,2165,6072825,2,48446,12113,1,289329400,289329400,18166,6055,12111,6055,0,1,6057,990395,0.990395
6455,2805,2165,6072825,2,51646,12913,1,305233400,305233400,19366,6455,12911,6455,0,1,6457,1234074,1.234074
6855,2805,2165,6072825,2,54846,13713,1,321137400,321137400,20566,6855,13711,6855,0,1,6857,1885220,1.88522
55,1805,3365,6073825,2,446,113,1,50865400,50865400,166,55,111,55,0,1,57,130714,0.130714
455,1805,3365,6073825,2,3646,913,1,67409400,67409400,1366,455,911,455,0,1,457,587276,0.587276
855,1805,3365,6073825,2,6846,1713,1,83953400,83953400,2566,855,1711,855,0,1,857,278709,0.278709
1255,1805,3365,6073825,2,10046,2513,1,100497400,100497400,3766,1255,2511,1255,0,1,1257,1107063,1.107063
1655,1805,3365,6073825,2,13246,3313,1,117041400,117041400,4966,1655,3311,1655,0,1,1657,944096,0.944096
2055,1805,3365,6073825,2,16446,4113,1,133585400,133585400,6166,2055,4111,2055,0,1,2057,1418596,1.418596
2455,1805,3365,6073825,2,19646,4913,1,150129400,150129400,7366,2455,4911,2455,0,1,2457,1190293,1.190293
2855,1805,3365,6073825,2,22846,5713,1,166673400,166673400,8566,2855,5711,2855,0,1,2857,583298,0.583298
3255,1805,3365,6073825,2,26046,6513,1,183217400,183217400,9766,3255,6511,3255,0,1,3257,367796,0.367796
3655,1805,3365,6073825,2,29246,7313,1,199761400,199761400,10966,3655,7311,3655,0,1,3657,3548019,3.548019
4055,1805,3365,6073825,2,32446,8113,1,216305400,216305400,12166,4055,8111,4055,0,1,4057,1379060,1.37906
4455,1805,3365,6073825,2,35646,8913,1,232849400,232849400,13366,4455,8911,4455,0,1,4457,1886361,1.886361
4855,1805,3365,6073825,2,38846,9713,1,249393400,249393400,14566,4855,9711,4855,0,1,4857,364442,0.364442
5255,1805,3365,6073825,2,42046,10513,1,265937400,265937400,15766,5255,10511,5255,0,1,5257,6228628,6.228628
5655,1805,3365,6073825,2,45246,11313,1,282481400,282481400,16966,5655,11311,5655,0,1,5657,1516359,1.516359
6055,1805,3365,6073825,2,48446,12113,1,299025400,299025400,18166,6055,12111,6055,0,1,6057,1707540,1.70754
6455,1805,3365,6073825,2,51646,12913,1,315569400,315569400,19366,6455,12911,6455,0,1,6457,1993562,1.993562
6855,1805,3365,6073825,2,54846,13713,1,332113400,332113400,20566,6855,13711,6855,0,1,6857,2525396,2.525396
55,4805,1265,6078325,2,446,113,1,51297400,51297400,166,55,111,55,0,1,57,119857,0.119857
455,4805,1265,6078325,2,3646,913,1,70721400,70721400,1366,455,911,455,0,1,457,379948,0.379948
855,4805,1265,6078325,2,6846,1713,1,90145400,90145400,2566,855,1711,855,0,1,857,1026616,1.026616
1255,4805,1265,6078325,2,10046,2513,1,109569400,109569400,3766,1255,2511,1255,0,1,1257,284927,0.284927
1655,4805,1265,6078325,2,13246,3313,1,128993400,128993400,4966,1655,3311,1655,0,1,1657,1942542,1.942542
2055,4805,1265,6078325,2,16446,4113,1,148417400,148417400,6166,2055,4111,2055,0,1,2057,1102772,1.102772
2455,4805,1265,6078325,2,19646,4913,1,167841400,167841400,7366,2455,4911,2455,0,1,2457,2129908,2.129908
2855,4805,1265,6078325,2,22846,5713,1,187265400,187265400,8566,2855,5711,2855,0,1,2857,3301323,3.301323
3255,4805,1265,6078325,2,26046,6513,1,206689400,206689400,9766,3255,6511,3255,0,1,3257,1546005,1.546005
3655,4805,1265,6078325,2,29246,7313,1,226113400,226113400,10966,3655,7311,3655,0,1,3657,2494629,2.494629
4055,4805,1265,6078325,2,32446,8113,1,245537400,245537400,12166,4055,8111,4055,0,1,4057,4689610,4.68961
4455,4805,1265,6078325,2,35646,8913,1,264961400,264961400,13366,4455,8911,4455,0,1,4457,185092,0.185092
4855,4805,1265,6078325,2,38846,9713,1,284385400,284385400,14566,4855,9711,4855,0,1,4857,770425,0.770425
5255,4805,1265,6078325,2,42046,10513,1,303809400,303809400,15766,5255,10511,5255,0,1,5257,1169401,1.169401
5655,4805,1265,6078325,2,45246,11313,1,323233400,323233400,16966,5655,11311,5655,0,1,5657,5084094,5.084094
6055,4805,1265,6078325,2,48446,12113,1,342657400,342657400,18166,6055,12111,6055,0,1,6057,4053788,4.053788
6455,4805,1265,6078325,2,51646,12913,1,362081400,362081400,19366,6455,12911,6455,0,1,6457,749702,0.749702
6855,4805,1265,6078325,2,54846,13713,1,381505400,381505400,20566,6855,13711,6855,0,1,6857,7880191,7.880191
55,1055,5765,6082075,2,446,113,1,51657400,51657400,166,55,111,55,0,1,57,14947,0.014947
455,1055,5765,6082075,2,3646,913,1,73481400,73481400,1366,455,911,455,0,1,457,44330,0.04433
855,1055,5765,6082075,2,6846,1713,1,95305400,95305400,2566,855,1711,855,0,1,857,89034,0.089034
1255,1055,5765,6082075,2,10046,2513,1,117129400,117129400,3766,1255,2511,1255,0,1,1257,43610,0.04361
1655,1055,5765,6082075,2,13246,3313,1,138953400,138953400,4966,1655,3311,1655,0,1,1657,265544,0.265544
2055,1055,5765,6082075,2,16446,4113,1,160777400,160777400,6166,2055,4111,2055,0,1,2057,432853,0.432853
2455,1055,5765,6082075,2,19646,4913,1,182601400,182601400,7366,2455,4911,2455,0,1,2457,478398,0.478398
2855,1055,5765,6082075,2,22846,5713,1,204425400,204425400,8566,2855,5711,2855,0,1,2857,231112,0.231112
3255,1055,5765,6082075,2,26046,6513,1,226249400,226249400,9766,3255,6511,3255,0,1,3257,804904,0.804904
3655,1055,5765,6082075,2,29246,7313,1,248073400,248073400,10966,3655,7311,3655,0,1,3657,105730,0.10573
4055,1055,5765,6082075,2,32446,8113,1,269897400,269897400,12166,4055,8111,4055,0,1,4057,233141,0.233141
4455,1055,5765,6082075,2,35646,8913,1,291721400,291721400,13366,4455,8911,4455,0,1,4457,151850,0.15185
4855,1055,5765,6082075,2,38846,9713,1,313545400,313545400,14566,4855,9711,4855,0,1,4857,1040149,1.040149
5255,1055,5765,6082075,2,42046,10513,1,335369400,335369400,15766,5255,10511,5255,0,1,5257,182177,0.182177
5655,1055,5765,6082075,2,45246,11313,1,357193400,357193400,16966,5655,11311,5655,0,1,5657,243915,0.243915
6055,1055,5765,6082075,2,48446,12113,1,379017400,379017400,18166,6055,12111,6055,0,1,6057,1340469,1.340469
6455,1055,5765,6082075,2,51646,12913,1,400841400,400841400,19366,6455,12911,6455,0,1,6457,1290137,1.290137
6855,1055,5765,6082075,2,54846,13713,1,422665400,422665400,20566,6855,13711,6855,0,1,6857,834907,0.834907
55,6305,965,6084325,2,446,113,1,51873400,51873400,166,55,111,55,0,1,57,122219,0.122219
455,6305,965,6084325,2,3646,913,1,75137400,75137400,1366,455,911,455,0,1,457,237820,0.23782
855,6305,965,6084325,2,6846,1713,1,98401400,98401400,2566,855,1711,855,0,1,857,1039389,1.039389
1255,6305,965,6084325,2,10046,2513,1,121665400,121665400,3766,1255,2511,1255,0,1,1257,1499971,1.499971
1655,6305,965,6084325,2,13246,3313,1,144929400,144929400,4966,1655,3311,1655,0,1,1657,1962362,1.962362
2055,6305,965,6084325,2,16446,4113,1,168193400,168193400,6166,2055,4111,2055,0,1,2057,340001,0.340001
2455,6305,965,6084325,2,19646,4913,1,191457400,191457400,7366,2455,4911,2455,0,1,2457,939681,0.939681
2855,6305,965,6084325,2,22846,5713,1,214721400,214721400,8566,2855,5711,2855,0,1,2857,501090,0.50109
3255,6305,965,6084325,2,26046,6513,1,237985400,237985400,9766,3255,6511,3255,0,1,3257,3820292,3.820292
3655,6305,965,6084325,2,29246,7313,1,261249400,261249400,10966,3655,7311,3655,0,1,3657,4309175,4.309175
4055,6305,965,6084325,2,32446,8113,1,284513400,284513400,12166,4055,8111,4055,0,1,4057,416598,0.416598
4455,6305,965,6084325,2,35646,8913,1,307777400,307777400,13366,4455,8911,4455,0,1,4457,2742008,2.742008
4855,6305,965,6084325,2,38846,9713,1,331041400,331041400,14566,4855,9711,4855,0,1,4857,2219082,2.219082
5255,6305,965,6084325,2,42046,10513,1,354305400,354305400,15766,5255,10511,5255,0,1,5257,4422423,4.422423
5655,6305,965,6084325,2,45246,11313,1,377569400,377569400,16966,5655,11311,5655,0,1,5657,3610978,3.610978
6055,6305,965,6084325,2,48446,12113,1,400833400,400833400,18166,6055,12111,6055,0,1,6057,7120541,7.120541
6455,6305,965,6084325,2,51646,12913,1,424097400,424097400,19366,6455,12911,6455,0,1,6457,7564184,7.564184
6855,6305,965,6084325,2,54846,13713,1,447361400,447361400,20566,6855,13711,6855,0,1,6857,8069046,8.069046
40,1550,3940,6107000,2,326,83,1,50612800,50612800,121,40,81,40,0,1,42,114577,0.114577
440,1550,3940,6107000,2,3526,883,1,68180800,68180800,1321,440,881,440,0,1,442,565434,0.565434
840,1550,3940,6107000,2,6726,1683,1,85748800,85748800,2521,840,1681,840,0,1,842,938637,0.938637
1240,1550,3940,6107000,2,9926,2483,1,103316800,103316800,3721,1240,2481,1240,0,1,1242,1247269,1.247269
1640,1550,3940,6107000,2,13126,3283,1,120884800,120884800,4921,1640,3281,1640,0,1,1642,413657,0.413657
2040,1550,3940,6107000,2,16326,4083,1,138452800,138452800,6121,2040,4081,2040,0,1,2042,28666,0.028666
2440,1550,3940,6107000,2,19526,4883,1,156020800,156020800,7321,2440,4881,2440,0,1,2442,2670801,2.670801
2840,1550,3940,6107000,2,22726,5683,1,173588800,173588800,8521,2840,5681,2840,0,1,2842,1699311,1.699311
3240,1550,3940,6107000,2,25926,6483,1,191156800,191156800,9721,3240,6481,3240,0,1,3242,2504859,2.504859
3640,1550,3940,6107000,2,29126,7283,1,208724800,208724800,10921,3640,7281,3640,0,1,3642,2365669,2.365669
4040,1550,3940,6107000,2,32326,8083,1,226292800,226292800,12121,4040,8081,4040,0,1,4042,4327844,4.327844
4440,1550,3940,6107000,2,35526,8883,1,243860800,243860800,13321,4440,8881,4440,0,1,4442,4921718,4.921718
4840,1550,3940,6107000,2,38726,9683,1,261428800,261428800,14521,4840,9681,4840,0,1,4842,1245993,1.245993
5240,1550,3940,6107000,2,41926,10483,1,278996800,278996800,15721,5240,10481,5240,0,1,5242,3391310,3.39131
5640,1550,3940,6107000,2,45126,11283,1,296564800,296564800,16921,5640,11281,5640,0,1,5642,1198821,1.198821
6040,1550,3940,6107000,2,48326,12083,1,314132800,314132800,18121,6040,12081,6040,0,1,6042,167658,0.167658
6440,1550,3940,6107000,2,51526,12883,1,331700800,331700800,19321,6440,12881,6440,0,1,6442,4873965,4.873965
6840,1550,3940,6107000,2,54726,13683,1,349268800,349268800,20521,6840,13681,6840,0,1,6842,1838349,1.838349
40,6550,940,6157000,2,326,83,1,51652800,51652800,121,40,81,40,0,1,42,11943,0.011943
440,6550,940,6157000,2,3526,883,1,75620800,75620800,1321,440,881,440,0,1,442,16149,0.016149
840,6550,940,6157000,2,6726,1683,1,99588800,99588800,2521,840,1681,840,0,1,842,5532,0.005532
1240,6550,940,6157000,2,9926,2483,1,123556800,123556800,3721,1240,2481,1240,0,1,1242,21617,0.021617
1640,6550,940,6157000,2,13126,3283,1,147524800,147524800,4921,1640,3281,1640,0,1,1642,44420,0.04442
2040,6550,940,6157000,2,16326,4083,1,171492800,171492800,6121,2040,4081,2040,0,1,2042,741555,0.741555
2440,6550,940,6157000,2,19526,4883,1,195460800,195460800,7321,2440,4881,2440,0,1,2442,172212,0.172212
2840,6550,940,6157000,2,22726,5683,1,219428800,219428800,8521,2840,5681,2840,0,1,2842,116951,0.116951
3240,6550,940,6157000,2,25926,6483,1,243396800,243396800,9721,3240,6481,3240,0,1,3242,152276,0.152276
3640,6550,940,6157000,2,29126,7283,1,267364800,267364800,10921,3640,7281,3640,0,1,3642,522624,0.522624
4040,6550,940,6157000,2,32326,8083,1,291332800,291332800,12121,4040,8081,4040,0,1,4042,2986106,2.986106
4440,6550,940,6157000,2,35526,8883,1,315300800,315300800,13321,4440,8881,4440,0,1,4442,1062821,1.062821
4840,6550,940,6157000,2,38726,9683,1,339268800,339268800,14521,4840,9681,4840,0,1,4842,1751318,1.751318
5240,6550,940,6157000,2,41926,10483,1,363236800,363236800,15721,5240,10481,5240,0,1,5242,786733,0.786733
5640,6550,940,6157000,2,45126,11283,1,387204800,387204800,16921,5640,11281,5640,0,1,5642,214248,0.214248
6040,6550,940,6157000,2,48326,12083,1,411172800,411172800,18121,6040,12081,6040,0,1,6042,4385043,4.385043
6440,6550,940,6157000,2,51526,12883,1,435140800,435140800,19321,6440,12881,6440,0,1,6442,959968,0.959968
6840,6550,940,6157000,2,54726,13683,1,459108800,459108800,20521,6840,13681,6840,0,1,6842,1801678,1.801678
55,3305,1865,6163825,2,446,113,1,51585400,51585400,166,55,111,55,0,1,57,124778,0.124778
455,3305,1865,6163825,2,3646,913,1,68129400,68129400,1366,455,911,455,0,1,457,593187,0.593187
855,3305,1865,6163825,2,6846,1713,1,84673400,84673400,2566,855,1711,855,0,1,857,1066651,1.066651
1255,3305,1865,6163825,2,10046,2513,1,101217400,101217400,3766,1255,2511,1255,0,1,1257,285345,0.285345
1655,3305,1865,6163825,2,13246,3313,1,117761400,117761400,4966,1655,3311,1655,0,1,1657,2017238,2.017238
2055,3305,1865,6163825,2,16446,4113,1,134305400,134305400,6166,2055,4111,2055,0,1,2057,2499579,2.499579
2455,3305,1865,6163825,2,19646,4913,1,150849400,150849400,7366,2455,4911,2455,0,1,2457,2341886,2.341886
2855,3305,1865,6163825,2,22846,5713,1,167393400,167393400,8566,2855,5711,2855,0,1,2857,1112496,1.112496
3255,3305,1865,6163825,2,26046,6513,1,183937400,183937400,9766,3255,6511,3255,0,1,3257,2538644,2.538644
3655,3305,1865,6163825,2,29246,7313,1,200481400,200481400,10966,3655,7311,3655,0,1,3657,4402957,4.402957
4055,3305,1865,6163825,2,32446,8113,1,217025400,217025400,12166,4055,8111,4055,0,1,4057,36476,0.036476
4455,3305,1865,6163825,2,35646,8913,1,233569400,233569400,13366,4455,8911,4455,0,1,4457,663990,0.66399
4855,3305,1865,6163825,2,38846,9713,1,250113400,250113400,14566,4855,9711,4855,0,1,4857,36579,0.036579
5255,3305,1865,6163825,2,42046,10513,1,266657400,266657400,15766,5255,10511,5255,0,1,5257,443561,0.443561
5655,3305,1865,6163825,2,45246,11313,1,283201400,283201400,16966,5655,11311,5655,0,1,5657,900939,0.900939
6055,3305,1865,6163825,2,48446,12113,1,299745400,299745400,18166,6055,12111,6055,0,1,6057,601768,0.601768
6455,3305,1865,6163825,2,51646,12913,1,316289400,316289400,19366,6455,12911,6455,0,1,6457,129798,0.129798
6855,3305,1865,6163825,2,54846,13713,1,332833400,332833400,20566,6855,13711,6855,0,1,6857,2978043,2.978043
55,1555,3965,6165575,2,446,113,1,51753400,51753400,166,55,111,55,0,1,57,127152,0.127152
455,1555,3965,6165575,2,3646,913,1,69417400,69417400,1366,455,911,455,0,1,457,594526,0.594526
855,1555,3965,6165575,2,6846,1713,1,87081400,87081400,2566,855,1711,855,0,1,857,893965,0.893965
1255,1555,3965,6165575,2,10046,2513,1,104745400,104745400,3766,1255,2511,1255,0,1,1257,1477273,1.477273
1655,1555,3965,6165575,2,13246,3313,1,122409400,122409400,4966,1655,3311,1655,0,1,1657,2022988,2.022988
2055,1555,3965,6165575,2,16446,4113,1,140073400,140073400,6166,2055,4111,2055,0,1,2057,2492989,2.492989
2455,1555,3965,6165575,2,19646,4913,1,157737400,157737400,7366,2455,4911,2455,0,1,2457,2967504,2.967504
2855,1555,3965,6165575,2,22846,5713,1,175401400,175401400,8566,2855,5711,2855,0,1,2857,2042797,2.042797
3255,1555,3965,6165575,2,26046,6513,1,193065400,193065400,9766,3255,6511,3255,0,1,3257,2559638,2.559638
3655,1555,3965,6165575,2,29246,7313,1,210729400,210729400,10966,3655,7311,3655,0,1,3657,1958460,1.95846
4055,1555,3965,6165575,2,32446,8113,1,228393400,228393400,12166,4055,8111,4055,0,1,4057,1047094,1.047094
4455,1555,3965,6165575,2,35646,8913,1,246057400,246057400,13366,4455,8911,4455,0,1,4457,3306089,3.306089
4855,1555,3965,6165575,2,38846,9713,1,263721400,263721400,14566,4855,9711,4855,0,1,4857,212891,0.212891
5255,1555,3965,6165575,2,42046,10513,1,281385400,281385400,15766,5255,10511,5255,0,1,5257,2356608,2.356608
5655,1555,3965,6165575,2,45246,11313,1,299049400,299049400,16966,5655,11311,5655,0,1,5657,5712026,5.712026
6055,1555,3965,6165575,2,48446,12113,1,316713400,316713400,18166,6055,12111,6055,0,1,6057,2273248,2.273248
6455,1555,3965,6165575,2,51646,12913,1,334377400,334377400,19366,6455,12911,6455,0,1,6457,285525,0.285525
6855,1555,3965,6165575,2,54846,13713,1,352041400,352041400,20566,6855,13711,6855,0,1,6857,4475799,4.475799
40,2550,2440,6222000,2,326,83,1,51372800,51372800,121,40,81,40,0,1,42,21710,0.02171
440,2550,2440,6222000,2,3526,883,1,67340800,67340800,1321,440,881,440,0,1,442,561113,0.561113
840,2550,2440,6222000,2,6726,1683,1,83308800,83308800,2521,840,1681,840,0,1,842,828584,0.828584
1240,2550,2440,6222000,2,9926,2483,1,99276800,99276800,3721,1240,2481,1240,0,1,1242,1473226,1.473226
1640,2550,2440,6222000,2,13126,3283,1,115244800,115244800,4921,1640,3281,1640,0,1,1642,1934048,1.934048
2040,2550,2440,6222000,2,16326,4083,1,131212800,131212800,6121,2040,4081,2040,0,1,2042,212255,0.212255
2440,2550,2440,6222000,2,19526,4883,1,147180800,147180800,7321,2440,4881,2440,0,1,2442,2231631,2.231631
2840,2550,2440,6222000,2,22726,5683,1,163148800,163148800,8521,2840,5681,2840,0,1,2842,513272,0.513272
3240,2550,2440,6222000,2,25926,6483,1,179116800,179116800,9721,3240,6481,3240,0,1,3242,2701763,2.701763
3640,2550,2440,6222000,2,29126,7283,1,195084800,195084800,10921,3640,7281,3640,0,1,3642,1999320,1.99932
4040,2550,2440,6222000,2,32326,8083,1,211052800,211052800,12121,4040,8081,4040,0,1,4042,386804,0.386804
4440,2550,2440,6222000,2,35526,8883,1,227020800,227020800,13321,4440,8881,4440,0,1,4442,232352,0.232352
4840,2550,2440,6222000,2,38726,9683,1,242988800,242988800,14521,4840,9681,4840,0,1,4842,242874,0.242874
5240,2550,2440,6222000,2,41926,10483,1,258956800,258956800,15721,5240,10481,5240,0,1,5242,2055778,2.055778
5640,2550,2440,6222000,2,45126,11283,1,274924800,274924800,16921,5640,11281,5640,0,1,5642,1713863,1.713863
6040,2550,2440,6222000,2,48326,12083,1,290892800,290892800,18121,6040,12081,6040,0,1,6042,1320509,1.320509
6440,2550,2440,6222000,2,51526,12883,1,306860800,306860800,19321,6440,12881,6440,0,1,6442,5592624,5.592624
6840,2550,2440,6222000,2,54726,13683,1,322828800,322828800,20521,6840,13681,6840,0,1,6842,2267462,2.267462
40,2050,3040,6232000,2,326,83,1,51484800,51484800,121,40,81,40,0,1,42,25503,0.025503
440,2050,3040,6232000,2,3526,883,1,67772800,67772800,1321,440,881,440,0,1,442,78391,0.078391
840,2050,3040,6232000,2,6726,1683,1,84060800,84060800,2521,840,1681,840,0,1,842,236620,0.23662
1240,2050,3040,6232000,2,9926,2483,1,100348800,100348800,3721,1240,2481,1240,0,1,1242,25544,0.025544
1640,2050,3040,6232000,2,13126,3283,1,116636800,116636800,4921,1640,3281,1640,0,1,1642,105887,0.105887
2040,2050,3040,6232000,2,16326,4083,1,132924800,132924800,6121,2040,4081,2040,0,1,2042,283302,0.283302
2440,2050,3040,6232000,2,19526,4883,1,149212800,149212800,7321,2440,4881,2440,0,1,2442,248133,0.248133
2840,2050,3040,6232000,2,22726,5683,1,165500800,165500800,8521,2840,5681,2840,0,1,2842,1072928,1.072928
3240,2050,3040,6232000,2,25926,6483,1,181788800,181788800,9721,3240,6481,3240,0,1,3242,269111,0.269111
3640,2050,3040,6232000,2,29126,7283,1,198076800,198076800,10921,3640,7281,3640,0,1,3642,290325,0.290325
4040,2050,3040,6232000,2,32326,8083,1,214364800,214364800,12121,4040,8081,4040,0,1,4042,478505,0.478505
4440,2050,3040,6232000,2,35526,8883,1,230652800,230652800,13321,4440,8881,4440,0,1,4442,9625,0.009625
4840,2050,3040,6232000,2,38726,9683,1,246940800,246940800,14521,4840,9681,4840,0,1,4842,1020837,1.020837
5240,2050,3040,6232000,2,41926,10483,1,263228800,263228800,15721,5240,10481,5240,0,1,5242,72896,0.072896
5640,2050,3040,6232000,2,45126,11283,1,279516800,279516800,16921,5640,11281,5640,0,1,5642,851664,0.851664
6040,2050,3040,6232000,2,48326,12083,1,295804800,295804800,18121,6040,12081,6040,0,1,6042,1040604,1.040604
6440,2050,3040,6232000,2,51526,12883,1,312092800,312092800,19321,6440,12881,6440,0,1,6442,705479,0.705479
6840,2050,3040,6232000,2,54726,13683,1,328380800,328380800,20521,6840,13681,6840,0,1,6842,311275,0.311275
40,4050,1540,6237000,2,326,83,1,51684800,51684800,121,40,81,40,0,1,42,9304,0.009304
440,4050,1540,6237000,2,3526,883,1,69572800,69572800,1321,440,881,440,0,1,442,8250,0.00825
840,4050,1540,6237000,2,6726,1683,1,87460800,87460800,2521,840,1681,840,0,1,842,255631,0.255631
1240,4050,1540,6237000,2,9926,2483,1,105348800,105348800,3721,1240,2481,1240,0,1,1242,264998,0.264998
1640,4050,1540,6237000,2,13126,3283,1,123236800,123236800,4921,1640,3281,1640,0,1,1642,14700,0.0147
2040,4050,1540,6237000,2,16326,4083,1,141124800,141124800,6121,2040,4081,2040,0,1,2042,947166,0.947166
2440,4050,1540,6237000,2,19526,4883,1,159012800,159012800,7321,2440,4881,2440,0,1,2442,101596,0.101596
2840,4050,1540,6237000,2,22726,5683,1,176900800,176900800,8521,2840,5681,2840,0,1,2842,1706867,1.706867
3240,4050,1540,6237000,2,25926,6483,1,194788800,194788800,9721,3240,6481,3240,0,1,3242,178588,0.178588
3640,4050,1540,6237000,2,29126,7283,1,212676800,212676800,10921,3640,7281,3640,0,1,3642,202300,0.2023
4040,4050,1540,6237000,2,32326,8083,1,230564800,230564800,12121,4040,8081,4040,0,1,4042,889748,0.889748
4440,4050,1540,6237000,2,35526,8883,1,248452800,248452800,13321,4440,8881,4440,0,1,4442,4020698,4.020698
4840,4050,1540,6237000,2,38726,9683,1,266340800,266340800,14521,4840,9681,4840,0,1,4842,1299130,1.29913
5240,4050,1540,6237000,2,41926,10483,1,284228800,284228800,15721,5240,10481,5240,0,1,5242,338553,0.338553
5640,4050,1540,6237000,2,45126,11283,1,302116800,302116800,16921,5640,11281,5640,0,1,5642,2719917,2.719917
6040,4050,1540,6237000,2,48326,12083,1,320004800,320004800,18121,6040,12081,6040,0,1,6042,273690,0.27369
6440,4050,1540,6237000,2,51526,12883,1,337892800,337892800,19321,6440,12881,6440,0,1,6442,279964,0.279964
6840,4050,1540,6237000,2,54726,13683,1,355780800,355780800,20521,6840,13681,6840,0,1,6842,1241556,1.241556
40,5050,1240,6262000,2,326,83,1,52108800,52108800,121,40,81,40,0,1,42,20964,0.020964
440,5050,1240,6262000,2,3526,883,1,72236800,72236800,1321,440,881,440,0,1,442,23446,0.023446
840,5050,1240,6262000,2,6726,1683,1,92364800,92364800,2521,840,1681,840,0,1,842,73657,0.073657
1240,5050,1240,6262000,2,9926,2483,1,112492800,112492800,3721,1240,2481,1240,0,1,1242,14788,0.014788
1640,5050,1240,6262000,2,13126,3283,1,132620800,132620800,4921,1640,3281,1640,0,1,1642,331974,0.331974
2040,5050,1240,6262000,2,16326,4083,1,152748800,152748800,6121,2040,4081,2040,0,1,2042,102543,0.102543
2440,5050,1240,6262000,2,19526,4883,1,172876800,172876800,7321,2440,4881,2440,0,1,2442,1925534,1.925534
2840,5050,1240,6262000,2,22726,5683,1,193004800,193004800,8521,2840,5681,2840,0,1,2842,64982,0.064982
3240,5050,1240,6262000,2,25926,6483,1,213132800,213132800,9721,3240,6481,3240,0,1,3242,301274,0.301274
3640,5050,1240,6262000,2,29126,7283,1,233260800,233260800,10921,3640,7281,3640,0,1,3642,787193,0.787193
4040,5050,1240,6262000,2,32326,8083,1,253388800,253388800,12121,4040,8081,4040,0,1,4042,2186500,2.1865
4440,5050,1240,6262000,2,35526,8883,1,273516800,273516800,13321,4440,8881,4440,0,1,4442,1948387,1.948387
4840,5050,1240,6262000,2,38726,9683,1,293644800,293644800,14521,4840,9681,4840,0,1,4842,366811,0.366811
5240,5050,1240,6262000,2,41926,10483,1,313772800,313772800,15721,5240,10481,5240,0,1,5242,661522,0.661522
5640,5050,1240,6262000,2,45126,11283,1,333900800,333900800,16921,5640,11281,5640,0,1,5642,451860,0.45186
6040,5050,1240,6262000,2,48326,12083,1,354028800,354028800,18121,6040,12081,6040,0,1,6042,171649,0.171649
6440,5050,1240,6262000,2,51526,12883,1,374156800,374156800,19321,6440,12881,6440,0,1,6442,535567,0.535567
6840,5050,1240,6262000,2,54726,13683,1,394284800,394284800,20521,6840,13681,6840,0,1,6842,540391,0.540391
40,1300,4840,6292000,2,326,83,1,52300800,52300800,121,40,81,40,0,1,42,116792,0.116792
440,1300,4840,6292000,2,3526,883,1,71948800,71948800,1321,440,881,440,0,1,442,234819,0.234819
840,1300,4840,6292000,2,6726,1683,1,91596800,91596800,2521,840,1681,840,0,1,842,481081,0.481081
1240,1300,4840,6292000,2,9926,2483,1,111244800,111244800,3721,1240,2481,1240,0,1,1242,195584,0.195584
1640,1300,4840,6292000,2,13126,3283,1,130892800,130892800,4921,1640,3281,1640,0,1,1642,1189454,1.189454
2040,1300,4840,6292000,2,16326,4083,1,150540800,150540800,6121,2040,4081,2040,0,1,2042,749845,0.749845
2440,1300,4840,6292000,2,19526,4883,1,170188800,170188800,7321,2440,4881,2440,0,1,2442,311775,0.311775
2840,1300,4840,6292000,2,22726,5683,1,189836800,189836800,8521,2840,5681,2840,0,1,2842,992341,0.992341
3240,1300,4840,6292000,2,25926,6483,1,209484800,209484800,9721,3240,6481,3240,0,1,3242,2470480,2.47048
3640,1300,4840,6292000,2,29126,7283,1,229132800,229132800,10921,3640,7281,3640,0,1,3642,995699,0.995699
4040,1300,4840,6292000,2,32326,8083,1,248780800,248780800,12121,4040,8081,4040,0,1,4042,538653,0.538653
4440,1300,4840,6292000,2,35526,8883,1,268428800,268428800,13321,4440,8881,4440,0,1,4442,977391,0.977391
4840,1300,4840,6292000,2,38726,9683,1,288076800,288076800,14521,4840,9681,4840,0,1,4842,778006,0.778006
5240,1300,4840,6292000,2,41926,10483,1,307724800,307724800,15721,5240,10481,5240,0,1,5242,417008,0.417008
5640,1300,4840,6292000,2,45126,11283,1,327372800,327372800,16921,5640,11281,5640,0,1,5642,397402,0.397402
6040,1300,4840,6292000,2,48326,12083,1,347020800,347020800,18121,6040,12081,6040,0,1,6042,710539,0.710539
6440,1300,4840,6292000,2,51526,12883,1,366668800,366668800,19321,6440,12881,6440,0,1,6442,3491443,3.491443
6840,1300,4840,6292000,2,54726,13683,1,386316800,386316800,20521,6840,13681,6840,0,1,6842,1565194,1.565194
55,2555,2465,6298075,2,446,113,1,52593400,52593400,166,55,111,55,0,1,57,129013,0.129013
455,2555,2465,6298075,2,3646,913,1,68657400,68657400,1366,455,911,455,0,1,457,208469,0.208469
855,2555,2465,6298075,2,6846,1713,1,84721400,84721400,2566,855,1711,855,0,1,857,1051540,1.05154
1255,2555,2465,6298075,2,10046,2513,1,100785400,100785400,3766,1255,2511,1255,0,1,1257,709089,0.709089
1655,2555,2465,6298075,2,13246,3313,1,116849400,116849400,4966,1655,3311,1655,0,1,1657,106745,0.106745
2055,2555,2465,6298075,2,16446,4113,1,132913400,132913400,6166,2055,4111,2055,0,1,2057,173746,0.173746
2455,2555,2465,6298075,2,19646,4913,1,148977400,148977400,7366,2455,4911,2455,0,1,2457,92685,0.092685
2855,2555,2465,6298075,2,22846,5713,1,165041400,165041400,8566,2855,5711,2855,0,1,2857,922527,0.922527
3255,2555,2465,6298075,2,26046,6513,1,181105400,181105400,9766,3255,6511,3255,0,1,3257,3862174,3.862174
3655,2555,2465,6298075,2,29246,7313,1,197169400,197169400,10966,3655,7311,3655,0,1,3657,2006161,2.006161
4055,2555,2465,6298075,2,32446,8113,1,213233400,213233400,12166,4055,8111,4055,0,1,4057,479614,0.479614
4455,2555,2465,6298075,2,35646,8913,1,229297400,229297400,13366,4455,8911,4455,0,1,4457,2176806,2.176806
4855,2555,2465,6298075,2,38846,9713,1,245361400,245361400,14566,4855,9711,4855,0,1,4857,5173833,5.173833
5255,2555,2465,6298075,2,42046,10513,1,261425400,261425400,15766,5255,10511,5255,0,1,5257,2966364,2.966364
5655,2555,2465,6298075,2,45246,11313,1,277489400,277489400,16966,5655,11311,5655,0,1,5657,877735,0.877735
6055,2555,2465,6298075,2,48446,12113,1,293553400,293553400,18166,6055,12111,6055,0,1,6057,7152596,7.152596
6455,2555,2465,6298075,2,51646,12913,1,309617400,309617400,19366,6455,12911,6455,0,1,6457,2556842,2.556842
6855,2555,2465,6298075,2,54846,13713,1,325681400,325681400,20566,6855,13711,6855,0,1,6857,1052311,1.052311
55,2055,3065,6298575,2,446,113,1,52641400,52641400,166,55,111,55,0,1,57,17115,0.017115
455,2055,3065,6298575,2,3646,913,1,69025400,69025400,1366,455,911,455,0,1,457,12299,0.012299
855,2055,3065,6298575,2,6846,1713,1,85409400,85409400,2566,855,1711,855,0,1,857,89266,0.089266
1255,2055,3065,6298575,2,10046,2513,1,101793400,101793400,3766,1255,2511,1255,0,1,1257,50855,0.050855
1655,2055,3065,6298575,2,13246,3313,1,118177400,118177400,4966,1655,3311,1655,0,1,1657,259182,0.259182
2055,2055,3065,6298575,2,16446,4113,1,134561400,134561400,6166,2055,4111,2055,0,1,2057,31920,0.03192
2455,2055,3065,6298575,2,19646,4913,1,150945400,150945400,7366,2455,4911,2455,0,1,2457,420284,0.420284
2855,2055,3065,6298575,2,22846,5713,1,167329400,167329400,8566,2855,5711,2855,0,1,2857,1261057,1.261057
3255,2055,3065,6298575,2,26046,6513,1,183713400,183713400,9766,3255,6511,3255,0,1,3257,300570,0.30057
3655,2055,3065,6298575,2,29246,7313,1,200097400,200097400,10966,3655,7311,3655,0,1,3657,1132089,1.132089
4055,2055,3065,6298575,2,32446,8113,1,216481400,216481400,12166,4055,8111,4055,0,1,4057,53284,0.053284
4455,2055,3065,6298575,2,35646,8913,1,232865400,232865400,13366,4455,8911,4455,0,1,4457,1445776,1.445776
4855,2055,3065,6298575,2,38846,9713,1,249249400,249249400,14566,4855,9711,4855,0,1,4857,259026,0.259026
5255,2055,3065,6298575,2,42046,10513,1,265633400,265633400,15766,5255,10511,5255,0,1,5257,59781,0.059781
5655,2055,3065,6298575,2,45246,11313,1,282017400,282017400,16966,5655,11311,5655,0,1,5657,11946,0.011946
6055,2055,3065,6298575,2,48446,12113,1,298401400,298401400,18166,6055,12111,6055,0,1,6057,1311374,1.311374
6455,2055,3065,6298575,2,51646,12913,1,314785400,314785400,19366,6455,12911,6455,0,1,6457,2504721,2.504721
6855,2055,3065,6298575,2,54846,13713,1,331169400,331169400,20566,6855,13711,6855,0,1,6857,6378115,6.378115
40,2300,2740,6302000,2,326,83,1,52028800,52028800,121,40,81,40,0,1,42,117956,0.117956
440,2300,2740,6302000,2,3526,883,1,68156800,68156800,1321,440,881,440,0,1,442,348585,0.348585
840,2300,2740,6302000,2,6726,1683,1,84284800,84284800,2521,840,1681,840,0,1,842,329849,0.329849
1240,2300,2740,6302000,2,9926,2483,1,100412800,100412800,3721,1240,2481,1240,0,1,1242,402503,0.402503
1640,2300,2740,6302000,2,13126,3283,1,116540800,116540800,4921,1640,3281,1640,0,1,1642,49101,0.049101
2040,2300,2740,6302000,2,16326,4083,1,132668800,132668800,6121,2040,4081,2040,0,1,2042,604327,0.604327
2440,2300,2740,6302000,2,19526,4883,1,148796800,148796800,7321,2440,4881,2440,0,1,2442,2093698,2.093698
2840,2300,2740,6302000,2,22726,5683,1,164924800,164924800,8521,2840,5681,2840,0,1,2842,178352,0.178352
3240,2300,2740,6302000,2,25926,6483,1,181052800,181052800,9721,3240,6481,3240,0,1,3242,263495,0.263495
3640,2300,2740,6302000,2,29126,7283,1,197180800,197180800,10921,3640,7281,3640,0,1,3642,514646,0.514646
4040,2300,2740,6302000,2,32326,8083,1,213308800,213308800,12121,4040,8081,4040,0,1,4042,1339502,1.339502
4440,2300,2740,6302000,2,35526,8883,1,229436800,229436800,13321,4440,8881,4440,0,1,4442,549151,0.549151
4840,2300,2740,6302000,2,38726,9683,1,245564800,245564800,14521,4840,9681,4840,0,1,4842,289344,0.289344
5240,2300,2740,6302000,2,41926,10483,1,261692800,261692800,15721,5240,10481,5240,0,1,5242,576420,0.57642
5640,2300,2740,6302000,2,45126,11283,1,277820800,277820800,16921,5640,11281,5640,0,1,5642,1146323,1.146323
6040,2300,2740,6302000,2,48326,12083,1,293948800,293948800,18121,6040,12081,6040,0,1,6042,459340,0.45934
6440,2300,2740,6302000,2,51526,12883,1,310076800,310076800,19321,6440,12881,6440,0,1,6442,5436475,5.436475
6840,2300,2740,6302000,2,54726,13683,1,326204800,326204800,20521,6840,13681,6840,0,1,6842,248051,0.248051
35,1140,5545,6321300,2,286,73,1,52442200,52442200,106,35,71,35,0,1,37,122736,0.122736
535,1140,5545,6321300,2,4286,1073,1,79182200,79182200,1606,535,1071,535,0,1,537,684231,0.684231
1035,1140,5545,6321300,2,8286,2073,1,105922200,105922200,3106,1035,2071,1035,0,1,1037,1259875,1.259875
1535,1140,5545,6321300,2,12286,3073,1,132662200,132662200,4606,1535,3071,1535,0,1,1537,1890715,1.890715
2035,1140,5545,6321300,2,16286,4073,1,159402200,159402200,6106,2035,4071,2035,0,1,2037,2463746,2.463746
2535,1140,5545,6321300,2,20286,5073,1,186142200,186142200,7606,2535,5071,2535,0,1,2537,3054971,3.054971
3035,1140,5545,6321300,2,24286,6073,1,212882200,212882200,9106,3035,6071,3035,0,1,3037,3653530,3.65353
3535,1140,5545,6321300,2,28286,7073,1,239622200,239622200,10606,3535,7071,3535,0,1,3537,4254536,4.254536
4035,1140,5545,6321300,2,32286,8073,1,266362200,266362200,12106,4035,8071,4035,0,1,4037,4852380,4.85238
35,6050,1045,6322250,2,286,73,1,52564600,52564600,106,35,71,35,0,1,37,7457,0.007457
535,6050,1045,6322250,2,4286,1073,1,80944600,80944600,1606,535,1071,535,0,1,537,93474,0.093474
1035,6050,1045,6322250,2,8286,2073,1,109324600,109324600,3106,1035,2071,1035,0,1,1037,1254186,1.254186
1535,6050,1045,6322250,2,12286,3073,1,137704600,137704600,4606,1535,3071,1535,0,1,1537,961947,0.961947
2035,6050,1045,6322250,2,16286,4073,1,166084600,166084600,6106,2035,4071,2035,0,1,2037,2561408,2.561408
2535,6050,1045,6322250,2,20286,5073,1,194464600,194464600,7606,2535,5071,2535,0,1,2537,2333618,2.333618
3035,6050,1045,6322250,2,24286,6073,1,222844600,222844600,9106,3035,6071,3035,0,1,3037,1541546,1.541546
3535,6050,1045,6322250,2,28286,7073,1,251224600,251224600,10606,3535,7071,3535,0,1,3537,4410566,4.410566
4035,6050,1045,6322250,2,32286,8073,1,279604600,279604600,12106,4035,8071,4035,0,1,4037,390613,0.390613
4535,6050,1045,6322250,2,36286,9073,1,307984600,307984600,13606,4535,9071,4535,0,1,4537,5646462,5.646462
5035,6050,1045,6322250,2,40286,10073,1,336364600,336364600,15106,5035,10071,5035,0,1,5037,4943805,4.943805
5535,6050,1045,6322250,2,44286,11073,1,364744600,364744600,16606,5535,11071,5535,0,1,5537,956110,0.95611
6035,6050,1045,6322250,2,48286,12073,1,393124600,393124600,18106,6035,12071,6035,0,1,6037,7476175,7.476175
6535,6050,1045,6322250,2,52286,13073,1,421504600,421504600,19606,6535,13071,6535,0,1,6537,3770147,3.770147
7035,6050,1045,6322250,2,56286,14073,1,449884600,449884600,21106,7035,14071,7035,0,1,7037,8742764,8.742764
55,6555,965,6325575,2,446,113,1,53913400,53913400,166,55,111,55,0,1,57,16370,0.01637
455,6555,965,6325575,2,3646,913,1,77977400,77977400,1366,455,911,455,0,1,457,106862,0.106862
855,6555,965,6325575,2,6846,1713,1,102041400,102041400,2566,855,1711,855,0,1,857,298110,0.29811
1255,6555,965,6325575,2,10046,2513,1,126105400,126105400,3766,1255,2511,1255,0,1,1257,192935,0.192935
1655,6555,965,6325575,2,13246,3313,1,150169400,150169400,4966,1655,3311,1655,0,1,1657,131772,0.131772
2055,6555,965,6325575,2,16446,4113,1,174233400,174233400,6166,2055,4111,2055,0,1,2057,1200173,1.200173
2455,6555,965,6325575,2,19646,4913,1,198297400,198297400,7366,2455,4911,2455,0,1,2457,670395,0.670395
2855,6555,965,6325575,2,22846,5713,1,222361400,222361400,8566,2855,5711,2855,0,1,2857,12368,0.012368
3255,6555,965,6325575,2,26046,6513,1,246425400,246425400,9766,3255,6511,3255,0,1,3257,964453,0.964453
3655,6555,965,6325575,2,29246,7313,1,270489400,270489400,10966,3655,7311,3655,0,1,3657,328869,0.328869
4055,6555,965,6325575,2,32446,8113,1,294553400,294553400,12166,4055,8111,4055,0,1,4057,102855,0.102855
4455,6555,965,6325575,2,35646,8913,1,318617400,318617400,13366,4455,8911,4455,0,1,4457,816877,0.816877
4855,6555,965,6325575,2,38846,9713,1,342681400,342681400,14566,4855,9711,4855,0,1,4857,3836724,3.836724
5255,6555,965,6325575,2,42046,10513,1,366745400,366745400,15766,5255,10511,5255,0,1,5257,231714,0.231714
5655,6555,965,6325575,2,45246,11313,1,390809400,390809400,16966,5655,11311,5655,0,1,5657,59864,0.059864
6055,6555,965,6325575,2,48446,12113,1,414873400,414873400,18166,6055,12111,6055,0,1,6057,2647078,2.647078
6455,6555,965,6325575,2,51646,12913,1,438937400,438937400,19366,6455,12911,6455,0,1,6457,1987810,1.98781
6855,6555,965,6325575,2,54846,13713,1,463001400,463001400,20566,6855,13711,6855,0,1,6857,2873170,2.87317
39,1143,5541,6333363,2,318,81,1,52752312,52752312,118,39,79,39,0,1,41,5293,0.005293
539,1143,5541,6333363,2,4318,1081,1,79488312,79488312,1618,539,1079,539,0,1,541,54468,0.054468
1039,1143,5541,6333363,2,8318,2081,1,106224312,106224312,3118,1039,2079,1039,0,1,1041,85477,0.085477
1539,1143,5541,6333363,2,12318,3081,1,132960312,132960312,4618,1539,3079,1539,0,1,1541,48044,0.048044
2039,1143,5541,6333363,2,16318,4081,1,159696312,159696312,6118,2039,4079,2039,0,1,2041,136106,0.136106
2539,1143,5541,6333363,2,20318,5081,1,186432312,186432312,7618,2539,5079,2539,0,1,2541,213554,0.213554
3039,1143,5541,6333363,2,24318,6081,1,213168312,213168312,9118,3039,6079,3039,0,1,3041,374714,0.374714
3539,1143,5541,6333363,2,28318,7081,1,239904312,239904312,10618,3539,7079,3539,0,1,3541,758921,0.758921
4039,1143,5541,6333363,2,32318,8081,1,266640312,266640312,12118,4039,8079,4039,0,1,4041,883569,0.883569
4539,1143,5541,6333363,2,36318,9081,1,293376312,293376312,13618,4539,9079,4539,0,1,4541,1310641,1.310641
5039,1143,5541,6333363,2,40318,10081,1,320112312,320112312,15118,5039,10079,5039,0,1,5041,238100,0.2381
5539,1143,5541,6333363,2,44318,11081,1,346848312,346848312,16618,5539,11079,5539,0,1,5541,274445,0.274445
6039,1143,5541,6333363,2,48318,12081,1,373584312,373584312,18118,6039,12079,6039,0,1,6041,2049467,2.049467
6539,1143,5541,6333363,2,52318,13081,1,400320312,400320312,19618,6539,13079,6539,0,1,6541,1272335,1.272335
7039,1143,5541,6333363,2,56318,14081,1,427056312,427056312,21118,7039,14079,7039,0,1,7041,331799,0.331799
40,1050,6040,6342000,2,326,83,1,53004800,53004800,121,40,81,40,0,1,42,36795,0.036795
440,1050,6040,6342000,2,3526,883,1,75692800,75692800,1321,440,881,440,0,1,442,55691,0.055691
840,1050,6040,6342000,2,6726,1683,1,98380800,98380800,2521,840,1681,840,0,1,842,164930,0.16493
1240,1050,6040,6342000,2,9926,2483,1,121068800,121068800,3721,1240,2481,1240,0,1,1242,74929,0.074929
1640,1050,6040,6342000,2,13126,3283,1,143756800,143756800,4921,1640,3281,1640,0,1,1642,11190,0.01119
2040,1050,6040,6342000,2,16326,4083,1,166444800,166444800,6121,2040,4081,2040,0,1,2042,143351,0.143351
2440,1050,6040,6342000,2,19526,4883,1,189132800,189132800,7321,2440,4881,2440,0,1,2442,156303,0.156303
2840,1050,6040,6342000,2,22726,5683,1,211820800,211820800,8521,2840,5681,2840,0,1,2842,137182,0.137182
3240,1050,6040,6342000,2,25926,6483,1,234508800,234508800,9721,3240,6481,3240,0,1,3242,1229371,1.229371
3640,1050,6040,6342000,2,29126,7283,1,257196800,257196800,10921,3640,7281,3640,0,1,3642,640643,0.640643
4040,1050,6040,6342000,2,32326,8083,1,279884800,279884800,12121,4040,8081,4040,0,1,4042,31618,0.031618
4440,1050,6040,6342000,2,35526,8883,1,302572800,302572800,13321,4440,8881,4440,0,1,4442,1398938,1.398938
4840,1050,6040,6342000,2,38726,9683,1,325260800,325260800,14521,4840,9681,4840,0,1,4842,1258164,1.258164
5240,1050,6040,6342000,2,41926,10483,1,347948800,347948800,15721,5240,10481,5240,0,1,5242,27381,0.027381
5640,1050,6040,6342000,2,45126,11283,1,370636800,370636800,16921,5640,11281,5640,0,1,5642,303371,0.303371
6040,1050,6040,6342000,2,48326,12083,1,393324800,393324800,18121,6040,12081,6040,0,1,6042,31601,0.031601
6440,1050,6040,6342000,2,51526,12883,1,416012800,416012800,19321,6440,12881,6440,0,1,6442,77905,0.077905
6840,1050,6040,6342000,2,54726,13683,1,438700800,438700800,20521,6840,13681,6840,0,1,6842,257003,0.257003
39,6093,1041,6342813,2,318,81,1,52968312,52968312,118,39,79,39,0,1,41,6603,0.006603
539,6093,1041,6342813,2,4318,1081,1,81504312,81504312,1618,539,1079,539,0,1,541,91197,0.091197
1039,6093,1041,6342813,2,8318,2081,1,110040312,110040312,3118,1039,2079,1039,0,1,1041,88702,0.088702
1539,6093,1041,6342813,2,12318,3081,1,138576312,138576312,4618,1539,3079,1539,0,1,1541,538247,0.538247
2039,6093,1041,6342813,2,16318,4081,1,167112312,167112312,6118,2039,4079,2039,0,1,2041,457768,0.457768
2539,6093,1041,6342813,2,20318,5081,1,195648312,195648312,7618,2539,5079,2539,0,1,2541,1059713,1.059713
3039,6093,1041,6342813,2,24318,6081,1,224184312,224184312,9118,3039,6079,3039,0,1,3041,1189469,1.189469
3539,6093,1041,6342813,2,28318,7081,1,252720312,252720312,10618,3539,7079,3539,0,1,3541,1927627,1.927627
4039,6093,1041,6342813,2,32318,8081,1,281256312,281256312,12118,4039,8079,4039,0,1,4041,1475183,1.475183
4539,6093,1041,6342813,2,36318,9081,1,309792312,309792312,13618,4539,9079,4539,0,1,4541,3566352,3.566352
5039,6093,1041,6342813,2,40318,10081,1,338328312,338328312,15118,5039,10079,5039,0,1,5041,1067502,1.067502
5539,6093,1041,6342813,2,44318,11081,1,366864312,366864312,16618,5539,11079,5539,0,1,5541,2206592,2.206592
6039,6093,1041,6342813,2,48318,12081,1,395400312,395400312,18118,6039,12079,6039,0,1,6041,3336696,3.336696
6539,6093,1041,6342813,2,52318,13081,1,423936312,423936312,19618,6539,13079,6539,0,1,6541,812762,0.812762
7039,6093,1041,6342813,2,56318,14081,1,452472312,452472312,21118,7039,14079,7039,0,1,7041,2904260,2.90426
55,4055,1565,6346075,2,446,113,1,53241400,53241400,166,55,111,55,0,1,57,17025,0.017025
455,4055,1565,6346075,2,3646,913,1,71225400,71225400,1366,455,911,455,0,1,457,45121,0.045121
855,4055,1565,6346075,2,6846,1713,1,89209400,89209400,2566,855,1711,855,0,1,857,217674,0.217674
1255,4055,1565,6346075,2,10046,2513,1,107193400,107193400,3766,1255,2511,1255,0,1,1257,207874,0.207874
1655,4055,1565,6346075,2,13246,3313,1,125177400,125177400,4966,1655,3311,1655,0,1,1657,6633,0.006633
2055,4055,1565,6346075,2,16446,4113,1,143161400,143161400,6166,2055,4111,2055,0,1,2057,94960,0.09496
2455,4055,1565,6346075,2,19646,4913,1,161145400,161145400,7366,2455,4911,2455,0,1,2457,583760,0.58376
2855,4055,1565,6346075,2,22846,5713,1,179129400,179129400,8566,2855,5711,2855,0,1,2857,604347,0.604347
3255,4055,1565,6346075,2,26046,6513,1,197113400,197113400,9766,3255,6511,3255,0,1,3257,1070453,1.070453
3655,4055,1565,6346075,2,29246,7313,1,215097400,215097400,10966,3655,7311,3655,0,1,3657,246693,0.246693
4055,4055,1565,6346075,2,32446,8113,1,233081400,233081400,12166,4055,8111,4055,0,1,4057,109748,0.109748
4455,4055,1565,6346075,2,35646,8913,1,251065400,251065400,13366,4455,8911,4455,0,1,4457,2245247,2.245247
4855,4055,1565,6346075,2,38846,9713,1,269049400,269049400,14566,4855,9711,4855,0,1,4857,694784,0.694784
5255,4055,1565,6346075,2,42046,10513,1,287033400,287033400,15766,5255,10511,5255,0,1,5257,764797,0.764797
5655,4055,1565,6346075,2,45246,11313,1,305017400,305017400,16966,5655,11311,5655,0,1,5657,5942873,5.942873
6055,4055,1565,6346075,2,48446,12113,1,323001400,323001400,18166,6055,12111,6055,0,1,6057,2242314,2.242314
6455,4055,1565,6346075,2,51646,12913,1,340985400,340985400,19366,6455,12911,6455,0,1,6457,156349,0.156349
6855,4055,1565,6346075,2,54846,13713,1,358969400,358969400,20566,6855,13711,6855,0,1,6857,1508725,1.508725
55,1305,4865,6348825,2,446,113,1,53505400,53505400,166,55,111,55,0,1,57,129721,0.129721
455,1305,4865,6348825,2,3646,913,1,73249400,73249400,1366,455,911,455,0,1,457,431309,0.431309
855,1305,4865,6348825,2,6846,1713,1,92993400,92993400,2566,855,1711,855,0,1,857,1100329,1.100329
1255,1305,4865,6348825,2,10046,2513,1,112737400,112737400,3766,1255,2511,1255,0,1,1257,22237,0.022237
1655,1305,4865,6348825,2,13246,3313,1,132481400,132481400,4966,1655,3311,1655,0,1,1657,616229,0.616229
2055,1305,4865,6348825,2,16446,4113,1,152225400,152225400,6166,2055,4111,2055,0,1,2057,42387,0.042387
2455,1305,4865,6348825,2,19646,4913,1,171969400,171969400,7366,2455,4911,2455,0,1,2457,236724,0.236724
2855,1305,4865,6348825,2,22846,5713,1,191713400,191713400,8566,2855,5711,2855,0,1,2857,749114,0.749114
3255,1305,4865,6348825,2,26046,6513,1,211457400,211457400,9766,3255,6511,3255,0,1,3257,471988,0.471988
3655,1305,4865,6348825,2,29246,7313,1,231201400,231201400,10966,3655,7311,3655,0,1,3657,17513,0.017513
4055,1305,4865,6348825,2,32446,8113,1,250945400,250945400,12166,4055,8111,4055,0,1,4057,787988,0.787988
4455,1305,4865,6348825,2,35646,8913,1,270689400,270689400,13366,4455,8911,4455,0,1,4457,354624,0.354624
4855,1305,4865,6348825,2,38846,9713,1,290433400,290433400,14566,4855,9711,4855,0,1,4857,535537,0.535537
5255,1305,4865,6348825,2,42046,10513,1,310177400,310177400,15766,5255,10511,5255,0,1,5257,1491436,1.491436
5655,1305,4865,6348825,2,45246,11313,1,329921400,329921400,16966,5655,11311,5655,0,1,5657,5109423,5.109423
6055,1305,4865,6348825,2,48446,12113,1,349665400,349665400,18166,6055,12111,6055,0,1,6057,831707,0.831707
6455,1305,4865,6348825,2,51646,12913,1,369409400,369409400,19366,6455,12911,6455,0,1,6457,3483262,3.483262
6855,1305,4865,6348825,2,54846,13713,1,389153400,389153400,20566,6855,13711,6855,0,1,6857,736356,0.736356
35,6090,1045,6364050,2,286,73,1,52910200,52910200,106,35,71,35,0,1,37,6496,0.006496
535,6090,1045,6364050,2,4286,1073,1,81450200,81450200,1606,535,1071,535,0,1,537,665741,0.665741
1035,6090,1045,6364050,2,8286,2073,1,109990200,109990200,3106,1035,2071,1035,0,1,1037,1205140,1.20514
1535,6090,1045,6364050,2,12286,3073,1,138530200,138530200,4606,1535,3071,1535,0,1,1537,1955361,1.955361
55,2305,2765,6373325,2,446,113,1,53217400,53217400,166,55,111,55,0,1,57,129035,0.129035
455,2305,2765,6373325,2,3646,913,1,69441400,69441400,1366,455,911,455,0,1,457,590571,0.590571
855,2305,2765,6373325,2,6846,1713,1,85665400,85665400,2566,855,1711,855,0,1,857,1059744,1.059744
1255,2305,2765,6373325,2,10046,2513,1,101889400,101889400,3766,1255,2511,1255,0,1,1257,1531032,1.531032
1655,2305,2765,6373325,2,13246,3313,1,118113400,118113400,4966,1655,3311,1655,0,1,1657,2015948,2.015948
2055,2305,2765,6373325,2,16446,4113,1,134337400,134337400,6166,2055,4111,2055,0,1,2057,1184615,1.184615
2455,2305,2765,6373325,2,19646,4913,1,150561400,150561400,7366,2455,4911,2455,0,1,2457,2936172,2.936172
2855,2305,2765,6373325,2,22846,5713,1,166785400,166785400,8566,2855,5711,2855,0,1,2857,3433147,3.433147
3255,2305,2765,6373325,2,26046,6513,1,183009400,183009400,9766,3255,6511,3255,0,1,3257,924127,0.924127
3655,2305,2765,6373325,2,29246,7313,1,199233400,199233400,10966,3655,7311,3655,0,1,3657,30820,0.03082
4055,2305,2765,6373325,2,32446,8113,1,215457400,215457400,12166,4055,8111,4055,0,1,4057,427153,0.427153
4455,2305,2765,6373325,2,35646,8913,1,231681400,231681400,13366,4455,8911,4455,0,1,4457,1480184,1.480184
4855,2305,2765,6373325,2,38846,9713,1,247905400,247905400,14566,4855,9711,4855,0,1,4857,2059416,2.059416
5255,2305,2765,6373325,2,42046,10513,1,264129400,264129400,15766,5255,10511,5255,0,1,5257,2068993,2.068993
5655,2305,2765,6373325,2,45246,11313,1,280353400,280353400,16966,5655,11311,5655,0,1,5657,100259,0.100259
6055,2305,2765,6373325,2,48446,12113,1,296577400,296577400,18166,6055,12111,6055,0,1,6057,595923,0.595923
6455,2305,2765,6373325,2,51646,12913,1,312801400,312801400,19366,6455,12911,6455,0,1,6457,999742,0.999742
6855,2305,2765,6373325,2,54846,13713,1,329025400,329025400,20566,6855,13711,6855,0,1,6857,285652,0.285652
40,6800,940,6392000,2,326,83,1,53612800,53612800,121,40,81,40,0,1,42,110697,0.110697
440,6800,940,6392000,2,3526,883,1,78380800,78380800,1321,440,881,440,0,1,442,597199,0.597199
840,6800,940,6392000,2,6726,1683,1,103148800,103148800,2521,840,1681,840,0,1,842,23874,0.023874
1240,6800,940,6392000,2,9926,2483,1,127916800,127916800,3721,1240,2481,1240,0,1,1242,357483,0.357483
1640,6800,940,6392000,2,13126,3283,1,152684800,152684800,4921,1640,3281,1640,0,1,1642,59347,0.059347
2040,6800,940,6392000,2,16326,4083,1,177452800,177452800,6121,2040,4081,2040,0,1,2042,2590541,2.590541
2440,6800,940,6392000,2,19526,4883,1,202220800,202220800,7321,2440,4881,2440,0,1,2442,3114262,3.114262
2840,6800,940,6392000,2,22726,5683,1,226988800,226988800,8521,2840,5681,2840,0,1,2842,264123,0.264123
3240,6800,940,6392000,2,25926,6483,1,251756800,251756800,9721,3240,6481,3240,0,1,3242,1093310,1.09331
3640,6800,940,6392000,2,29126,7283,1,276524800,276524800,10921,3640,7281,3640,0,1,3642,403309,0.403309
4040,6800,940,6392000,2,32326,8083,1,301292800,301292800,12121,4040,8081,4040,0,1,4042,16305,0.016305
4440,6800,940,6392000,2,35526,8883,1,326060800,326060800,13321,4440,8881,4440,0,1,4442,668901,0.668901
4840,6800,940,6392000,2,38726,9683,1,350828800,350828800,14521,4840,9681,4840,0,1,4842,3424941,3.424941
5240,6800,940,6392000,2,41926,10483,1,375596800,375596800,15721,5240,10481,5240,0,1,5242,158750,0.15875
5640,6800,940,6392000,2,45126,11283,1,400364800,400364800,16921,5640,11281,5640,0,1,5642,2525891,2.525891
6040,6800,940,6392000,2,48326,12083,1,425132800,425132800,18121,6040,12081,6040,0,1,6042,7661349,7.661349
6440,6800,940,6392000,2,51526,12883,1,449900800,449900800,19321,6440,12881,6440,0,1,6442,210647,0.210647
6840,6800,940,6392000,2,54726,13683,1,474668800,474668800,20521,6840,13681,6840,0,1,6842,1143404,1.143404
55,5055,1265,6394575,2,446,113,1,53937400,53937400,166,55,111,55,0,1,57,17735,0.017735
455,5055,1265,6394575,2,3646,913,1,74161400,74161400,1366,455,911,455,0,1,457,24202,0.024202
855,5055,1265,6394575,2,6846,1713,1,94385400,94385400,2566,855,1711,855,0,1,857,38342,0.038342
1255,5055,1265,6394575,2,10046,2513,1,114609400,114609400,3766,1255,2511,1255,0,1,1257,436854,0.436854
1655,5055,1265,6394575,2,13246,3313,1,134833400,134833400,4966,1655,3311,1655,0,1,1657,32238,0.032238
2055,5055,1265,6394575,2,16446,4113,1,155057400,155057400,6166,2055,4111,2055,0,1,2057,44331,0.044331
2455,5055,1265,6394575,2,19646,4913,1,175281400,175281400,7366,2455,4911,2455,0,1,2457,814706,0.814706
2855,5055,1265,6394575,2,22846,5713,1,195505400,195505400,8566,2855,5711,2855,0,1,2857,230278,0.230278
3255,5055,1265,6394575,2,26046,6513,1,215729400,215729400,9766,3255,6511,3255,0,1,3257,16847,0.016847
3655,5055,1265,6394575,2,29246,7313,1,235953400,235953400,10966,3655,7311,3655,0,1,3657,404937,0.404937
4055,5055,1265,6394575,2,32446,8113,1,256177400,256177400,12166,4055,8111,4055,0,1,4057,925112,0.925112
4455,5055,1265,6394575,2,35646,8913,1,276401400,276401400,13366,4455,8911,4455,0,1,4457,159696,0.159696
4855,5055,1265,6394575,2,38846,9713,1,296625400,296625400,14566,4855,9711,4855,0,1,4857,2259389,2.259389
5255,5055,1265,6394575,2,42046,10513,1,316849400,316849400,15766,5255,10511,5255,0,1,5257,1101600,1.1016
5655,5055,1265,6394575,2,45246,11313,1,337073400,337073400,16966,5655,11311,5655,0,1,5657,2217898,2.217898
6055,5055,1265,6394575,2,48446,12113,1,357297400,357297400,18166,6055,12111,6055,0,1,6057,1014771,1.014771
6455,5055,1265,6394575,2,51646,12913,1,377521400,377521400,19366,6455,12911,6455,0,1,6457,328681,0.328681
6855,5055,1265,6394575,2,54846,13713,1,397745400,397745400,20566,6855,13711,6855,0,1,6857,425824,0.425824
55,1055,6065,6398575,2,446,113,1,54321400,54321400,166,55,111,55,0,1,57,4546,0.004546
455,1055,6065,6398575,2,3646,913,1,77105400,77105400,1366,455,911,455,0,1,457,26876,0.026876
855,1055,6065,6398575,2,6846,1713,1,99889400,99889400,2566,855,1711,855,0,1,857,12135,0.012135
1255,1055,6065,6398575,2,10046,2513,1,122673400,122673400,3766,1255,2511,1255,0,1,1257,37968,0.037968
1655,1055,6065,6398575,2,13246,3313,1,145457400,145457400,4966,1655,3311,1655,0,1,1657,144602,0.144602
2055,1055,6065,6398575,2,16446,4113,1,168241400,168241400,6166,2055,4111,2055,0,1,2057,29418,0.029418
2455,1055,6065,6398575,2,19646,4913,1,191025400,191025400,7366,2455,4911,2455,0,1,2457,316174,0.316174
2855,1055,6065,6398575,2,22846,5713,1,213809400,213809400,8566,2855,5711,2855,0,1,2857,861764,0.861764
3255,1055,6065,6398575,2,26046,6513,1,236593400,236593400,9766,3255,6511,3255,0,1,3257,270621,0.270621
3655,1055,6065,6398575,2,29246,7313,1,259377400,259377400,10966,3655,7311,3655,0,1,3657,475966,0.475966
4055,1055,6065,6398575,2,32446,8113,1,282161400,282161400,12166,4055,8111,4055,0,1,4057,376545,0.376545
4455,1055,6065,6398575,2,35646,8913,1,304945400,304945400,13366,4455,8911,4455,0,1,4457,64306,0.064306
4855,1055,6065,6398575,2,38846,9713,1,327729400,327729400,14566,4855,9711,4855,0,1,4857,89872,0.089872
5255,1055,6065,6398575,2,42046,10513,1,350513400,350513400,15766,5255,10511,5255,0,1,5257,22842,0.022842
5655,1055,6065,6398575,2,45246,11313,1,373297400,373297400,16966,5655,11311,5655,0,1,5657,96464,0.096464
6055,1055,6065,6398575,2,48446,12113,1,396081400,396081400,18166,6055,12111,6055,0,1,6057,443455,0.443455
6455,1055,6065,6398575,2,51646,12913,1,418865400,418865400,19366,6455,12911,6455,0,1,6457,653295,0.653295
6855,1055,6065,6398575,2,54846,13713,1,441649400,441649400,20566,6855,13711,6855,0,1,6857,696705,0.696705
44,1153,5555,6404915,2,358,91,1,53600536,53600536,133,44,89,44,0,1,46,24850,0.02485
544,1153,5555,6404915,2,4358,1091,1,80432536,80432536,1633,544,1089,544,0,1,546,25825,0.025825
1044,1153,5555,6404915,2,8358,2091,1,107264536,107264536,3133,1044,2089,1044,0,1,1046,32632,0.032632
1544,1153,5555,6404915,2,12358,3091,1,134096536,134096536,4633,1544,3089,1544,0,1,1546,11037,0.011037
2044,1153,5555,6404915,2,16358,4091,1,160928536,160928536,6133,2044,4089,2044,0,1,2046,558189,0.558189
2544,1153,5555,6404915,2,20358,5091,1,187760536,187760536,7633,2544,5089,2544,0,1,2546,311909,0.311909
3044,1153,5555,6404915,2,24358,6091,1,214592536,214592536,9133,3044,6089,3044,0,1,3046,1143812,1.143812
3544,1153,5555,6404915,2,28358,7091,1,241424536,241424536,10633,3544,7089,3544,0,1,3546,218465,0.218465
4044,1153,5555,6404915,2,32358,8091,1,268256536,268256536,12133,4044,8089,4044,0,1,4046,262795,0.262795
4544,1153,5555,6404915,2,36358,9091,1,295088536,295088536,13633,4544,9089,4544,0,1,4546,334699,0.334699
5044,1153,5555,6404915,2,40358,10091,1,321920536,321920536,15133,5044,10089,5044,0,1,5046,25305,0.025305
5544,1153,5555,6404915,2,44358,11091,1,348752536,348752536,16633,5544,11089,5544,0,1,5546,5127406,5.127406
6044,1153,5555,6404915,2,48358,12091,1,375584536,375584536,18133,6044,12089,6044,0,1,6046,1368398,1.368398
6544,1153,5555,6404915,2,52358,13091,1,402416536,402416536,19633,6544,13089,6544,0,1,6546,765768,0.765768
7044,1153,5555,6404915,2,56358,14091,1,429248536,429248536,21133,7044,14089,7044,0,1,7046,1065048,1.065048
44,6103,1055,6438665,2,358,91,1,54028936,54028936,133,44,89,44,0,1,46,16195,0.016195
544,6103,1055,6438665,2,4358,1091,1,82660936,82660936,1633,544,1089,544,0,1,546,5175,0.005175
1044,6103,1055,6438665,2,8358,2091,1,111292936,111292936,3133,1044,2089,1044,0,1,1046,105659,0.105659
1544,6103,1055,6438665,2,12358,3091,1,139924936,139924936,4633,1544,3089,1544,0,1,1546,494615,0.494615
2044,6103,1055,6438665,2,16358,4091,1,168556936,168556936,6133,2044,4089,2044,0,1,2046,953806,0.953806
2544,6103,1055,6438665,2,20358,5091,1,197188936,197188936,7633,2544,5089,2544,0,1,2546,428557,0.428557
3044,6103,1055,6438665,2,24358,6091,1,225820936,225820936,9133,3044,6089,3044,0,1,3046,207724,0.207724
3544,6103,1055,6438665,2,28358,7091,1,254452936,254452936,10633,3544,7089,3544,0,1,3546,634645,0.634645
4044,6103,1055,6438665,2,32358,8091,1,283084936,283084936,12133,4044,8089,4044,0,1,4046,13709,0.013709
4544,6103,1055,6438665,2,36358,9091,1,311716936,311716936,13633,4544,9089,4544,0,1,4546,568030,0.56803
5044,6103,1055,6438665,2,40358,10091,1,340348936,340348936,15133,5044,10089,5044,0,1,5046,1116029,1.116029
5544,6103,1055,6438665,2,44358,11091,1,368980936,368980936,16633,5544,11089,5544,0,1,5546,1002623,1.002623
6044,6103,1055,6438665,2,48358,12091,1,397612936,397612936,18133,6044,12089,6044,0,1,6046,505281,0.505281
6544,6103,1055,6438665,2,52358,13091,1,426244936,426244936,19633,6544,13089,6544,0,1,6546,3490605,3.490605
7044,6103,1055,6438665,2,56358,14091,1,454876936,454876936,21133,7044,14089,7044,0,1,7046,8684420,8.68442
40,3050,2140,6527000,2,326,83,1,53876800,53876800,121,40,81,40,0,1,42,5630,0.00563
440,3050,2140,6527000,2,3526,883,1,70484800,70484800,1321,440,881,440,0,1,442,54499,0.054499
840,3050,2140,6527000,2,6726,1683,1,87092800,87092800,2521,840,1681,840,0,1,842,284791,0.284791
1240,3050,2140,6527000,2,9926,2483,1,103700800,103700800,3721,1240,2481,1240,0,1,1242,158647,0.158647
1640,3050,2140,6527000,2,13126,3283,1,120308800,120308800,4921,1640,3281,1640,0,1,1642,137542,0.137542
2040,3050,2140,6527000,2,16326,4083,1,136916800,136916800,6121,2040,4081,2040,0,1,2042,573657,0.573657
2440,3050,2140,6527000,2,19526,4883,1,153524800,153524800,7321,2440,4881,2440,0,1,2442,142914,0.142914
2840,3050,2140,6527000,2,22726,5683,1,170132800,170132800,8521,2840,5681,2840,0,1,2842,13801,0.013801
3240,3050,2140,6527000,2,25926,6483,1,186740800,186740800,9721,3240,6481,3240,0,1,3242,690903,0.690903
3640,3050,2140,6527000,2,29126,7283,1,203348800,203348800,10921,3640,7281,3640,0,1,3642,98054,0.098054
4040,3050,2140,6527000,2,32326,8083,1,219956800,219956800,12121,4040,8081,4040,0,1,4042,496538,0.496538
4440,3050,2140,6527000,2,35526,8883,1,236564800,236564800,13321,4440,8881,4440,0,1,4442,608812,0.608812
4840,3050,2140,6527000,2,38726,9683,1,253172800,253172800,14521,4840,9681,4840,0,1,4842,224282,0.224282
5240,3050,2140,6527000,2,41926,10483,1,269780800,269780800,15721,5240,10481,5240,0,1,5242,250259,0.250259
5640,3050,2140,6527000,2,45126,11283,1,286388800,286388800,16921,5640,11281,5640,0,1,5642,862760,0.86276
6040,3050,2140,6527000,2,48326,12083,1,302996800,302996800,18121,6040,12081,6040,0,1,6042,1673583,1.673583
6440,3050,2140,6527000,2,51526,12883,1,319604800,319604800,19321,6440,12881,6440,0,1,6442,764664,0.764664
6840,3050,2140,6527000,2,54726,13683,1,336212800,336212800,20521,6840,13681,6840,0,1,6842,3717548,3.717548
40,3550,1840,6532000,2,326,83,1,53980800,53980800,121,40,81,40,0,1,42,119925,0.119925
440,3550,1840,6532000,2,3526,883,1,71228800,71228800,1321,440,881,440,0,1,442,588255,0.588255
840,3550,1840,6532000,2,6726,1683,1,88476800,88476800,2521,840,1681,840,0,1,842,620352,0.620352
1240,3550,1840,6532000,2,9926,2483,1,105724800,105724800,3721,1240,2481,1240,0,1,1242,1057878,1.057878
1640,3550,1840,6532000,2,13126,3283,1,122972800,122972800,4921,1640,3281,1640,0,1,1642,2052868,2.052868
2040,3550,1840,6532000,2,16326,4083,1,140220800,140220800,6121,2040,4081,2040,0,1,2042,2525243,2.525243
2440,3550,1840,6532000,2,19526,4883,1,157468800,157468800,7321,2440,4881,2440,0,1,2442,222351,0.222351
2840,3550,1840,6532000,2,22726,5683,1,174716800,174716800,8521,2840,5681,2840,0,1,2842,2705209,2.705209
3240,3550,1840,6532000,2,25926,6483,1,191964800,191964800,9721,3240,6481,3240,0,1,3242,95932,0.095932
3640,3550,1840,6532000,2,29126,7283,1,209212800,209212800,10921,3640,7281,3640,0,1,3642,4470355,4.470355
4040,3550,1840,6532000,2,32326,8083,1,226460800,226460800,12121,4040,8081,4040,0,1,4042,191116,0.191116
4440,3550,1840,6532000,2,35526,8883,1,243708800,243708800,13321,4440,8881,4440,0,1,4442,4034936,4.034936
4840,3550,1840,6532000,2,38726,9683,1,260956800,260956800,14521,4840,9681,4840,0,1,4842,3017451,3.017451
5240,3550,1840,6532000,2,41926,10483,1,278204800,278204800,15721,5240,10481,5240,0,1,5242,826122,0.826122
5640,3550,1840,6532000,2,45126,11283,1,295452800,295452800,16921,5640,11281,5640,0,1,5642,1447946,1.447946
6040,3550,1840,6532000,2,48326,12083,1,312700800,312700800,18121,6040,12081,6040,0,1,6042,574376,0.574376
6440,3550,1840,6532000,2,51526,12883,1,329948800,329948800,19321,6440,12881,6440,0,1,6442,845542,0.845542
6840,3550,1840,6532000,2,54726,13683,1,347196800,347196800,20521,6840,13681,6840,0,1,6842,887627,0.887627
40,1800,3640,6552000,2,326,83,1,54156800,54156800,121,40,81,40,0,1,42,122255,0.122255
440,1800,3640,6552000,2,3526,883,1,71564800,71564800,1321,440,881,440,0,1,442,91891,0.091891
840,1800,3640,6552000,2,6726,1683,1,88972800,88972800,2521,840,1681,840,0,1,842,506089,0.506089
1240,1800,3640,6552000,2,9926,2483,1,106380800,106380800,3721,1240,2481,1240,0,1,1242,1591888,1.591888
1640,1800,3640,6552000,2,13126,3283,1,123788800,123788800,4921,1640,3281,1640,0,1,1642,322338,0.322338
2040,1800,3640,6552000,2,16326,4083,1,141196800,141196800,6121,2040,4081,2040,0,1,2042,2587295,2.587295
2440,1800,3640,6552000,2,19526,4883,1,158604800,158604800,7321,2440,4881,2440,0,1,2442,426220,0.42622
2840,1800,3640,6552000,2,22726,5683,1,176012800,176012800,8521,2840,5681,2840,0,1,2842,774404,0.774404
3240,1800,3640,6552000,2,25926,6483,1,193420800,193420800,9721,3240,6481,3240,0,1,3242,248209,0.248209
3640,1800,3640,6552000,2,29126,7283,1,210828800,210828800,10921,3640,7281,3640,0,1,3642,423401,0.423401
4040,1800,3640,6552000,2,32326,8083,1,228236800,228236800,12121,4040,8081,4040,0,1,4042,37243,0.037243
4440,1800,3640,6552000,2,35526,8883,1,245644800,245644800,13321,4440,8881,4440,0,1,4442,1016242,1.016242
4840,1800,3640,6552000,2,38726,9683,1,263052800,263052800,14521,4840,9681,4840,0,1,4842,74977,0.074977
5240,1800,3640,6552000,2,41926,10483,1,280460800,280460800,15721,5240,10481,5240,0,1,5242,1256309,1.256309
5640,1800,3640,6552000,2,45126,11283,1,297868800,297868800,16921,5640,11281,5640,0,1,5642,3518402,3.518402
6040,1800,3640,6552000,2,48326,12083,1,315276800,315276800,18121,6040,12081,6040,0,1,6042,4078202,4.078202
6440,1800,3640,6552000,2,51526,12883,1,332684800,332684800,19321,6440,12881,6440,0,1,6442,280370,0.28037
6840,1800,3640,6552000,2,54726,13683,1,350092800,350092800,20521,6840,13681,6840,0,1,6842,529361,0.529361
55,6805,965,6566825,2,446,113,1,55953400,55953400,166,55,111,55,0,1,57,127081,0.127081
455,6805,965,6566825,2,3646,913,1,80817400,80817400,1366,455,911,455,0,1,457,129759,0.129759
855,6805,965,6566825,2,6846,1713,1,105681400,105681400,2566,855,1711,855,0,1,857,325624,0.325624
1255,6805,965,6566825,2,10046,2513,1,130545400,130545400,3766,1255,2511,1255,0,1,1257,1075494,1.075494
1655,6805,965,6566825,2,13246,3313,1,155409400,155409400,4966,1655,3311,1655,0,1,1657,491986,0.491986
2055,6805,965,6566825,2,16446,4113,1,180273400,180273400,6166,2055,4111,2055,0,1,2057,1441840,1.44184
2455,6805,965,6566825,2,19646,4913,1,205137400,205137400,7366,2455,4911,2455,0,1,2457,3056737,3.056737
2855,6805,965,6566825,2,22846,5713,1,230001400,230001400,8566,2855,5711,2855,0,1,2857,699331,0.699331
3255,6805,965,6566825,2,26046,6513,1,254865400,254865400,9766,3255,6511,3255,0,1,3257,2069214,2.069214
3655,6805,965,6566825,2,29246,7313,1,279729400,279729400,10966,3655,7311,3655,0,1,3657,529474,0.529474
4055,6805,965,6566825,2,32446,8113,1,304593400,304593400,12166,4055,8111,4055,0,1,4057,451737,0.451737
4455,6805,965,6566825,2,35646,8913,1,329457400,329457400,13366,4455,8911,4455,0,1,4457,4978909,4.978909
4855,6805,965,6566825,2,38846,9713,1,354321400,354321400,14566,4855,9711,4855,0,1,4857,5361565,5.361565
5255,6805,965,6566825,2,42046,10513,1,379185400,379185400,15766,5255,10511,5255,0,1,5257,2581676,2.581676
5655,6805,965,6566825,2,45246,11313,1,404049400,404049400,16966,5655,11311,5655,0,1,5657,3013071,3.013071
6055,6805,965,6566825,2,48446,12113,1,428913400,428913400,18166,6055,12111,6055,0,1,6057,7828584,7.828584
6455,6805,965,6566825,2,51646,12913,1,453777400,453777400,19366,6455,12911,6455,0,1,6457,1847456,1.847456
6855,6805,965,6566825,2,54846,13713,1,478641400,478641400,20566,6855,13711,6855,0,1,6857,534427,0.534427
40,1550,4240,6572000,2,326,83,1,54428800,54428800,121,40,81,40,0,1,42,121689,0.121689
440,1550,4240,6572000,2,3526,883,1,72956800,72956800,1321,440,881,440,0,1,442,598212,0.598212
840,1550,4240,6572000,2,6726,1683,1,91484800,91484800,2521,840,1681,840,0,1,842,527179,0.527179
1240,1550,4240,6572000,2,9926,2483,1,110012800,110012800,3721,1240,2481,1240,0,1,1242,804067,0.804067
1640,1550,4240,6572000,2,13126,3283,1,128540800,128540800,4921,1640,3281,1640,0,1,1642,1218344,1.218344
2040,1550,4240,6572000,2,16326,4083,1,147068800,147068800,6121,2040,4081,2040,0,1,2042,2377031,2.377031
2440,1550,4240,6572000,2,19526,4883,1,165596800,165596800,7321,2440,4881,2440,0,1,2442,1882413,1.882413
2840,1550,4240,6572000,2,22726,5683,1,184124800,184124800,8521,2840,5681,2840,0,1,2842,1089047,1.089047
3240,1550,4240,6572000,2,25926,6483,1,202652800,202652800,9721,3240,6481,3240,0,1,3242,2802326,2.802326
3640,1550,4240,6572000,2,29126,7283,1,221180800,221180800,10921,3640,7281,3640,0,1,3642,1539413,1.539413
4040,1550,4240,6572000,2,32326,8083,1,239708800,239708800,12121,4040,8081,4040,0,1,4042,330155,0.330155
4440,1550,4240,6572000,2,35526,8883,1,258236800,258236800,13321,4440,8881,4440,0,1,4442,442474,0.442474
4840,1550,4240,6572000,2,38726,9683,1,276764800,276764800,14521,4840,9681,4840,0,1,4842,2921909,2.921909
5240,1550,4240,6572000,2,41926,10483,1,295292800,295292800,15721,5240,10481,5240,0,1,5242,85462,0.085462
5640,1550,4240,6572000,2,45126,11283,1,313820800,313820800,16921,5640,11281,5640,0,1,5642,403179,0.403179
6040,1550,4240,6572000,2,48326,12083,1,332348800,332348800,18121,6040,12081,6040,0,1,6042,3662094,3.662094
6440,1550,4240,6572000,2,51526,12883,1,350876800,350876800,19321,6440,12881,6440,0,1,6442,1136970,1.13697
6840,1550,4240,6572000,2,54726,13683,1,369404800,369404800,20521,6840,13681,6840,0,1,6842,1067761,1.067761
40,5300,1240,6572000,2,326,83,1,54668800,54668800,121,40,81,40,0,1,42,119721,0.119721
440,5300,1240,6572000,2,3526,883,1,75596800,75596800,1321,440,881,440,0,1,442,314829,0.314829
840,5300,1240,6572000,2,6726,1683,1,96524800,96524800,2521,840,1681,840,0,1,842,492348,0.492348
1240,5300,1240,6572000,2,9926,2483,1,117452800,117452800,3721,1240,2481,1240,0,1,1242,302920,0.30292
1640,5300,1240,6572000,2,13126,3283,1,138380800,138380800,4921,1640,3281,1640,0,1,1642,727154,0.727154
2040,5300,1240,6572000,2,16326,4083,1,159308800,159308800,6121,2040,4081,2040,0,1,2042,2057053,2.057053
2440,5300,1240,6572000,2,19526,4883,1,180236800,180236800,7321,2440,4881,2440,0,1,2442,630150,0.63015
2840,5300,1240,6572000,2,22726,5683,1,201164800,201164800,8521,2840,5681,2840,0,1,2842,44739,0.044739
3240,5300,1240,6572000,2,25926,6483,1,222092800,222092800,9721,3240,6481,3240,0,1,3242,1425735,1.425735
3640,5300,1240,6572000,2,29126,7283,1,243020800,243020800,10921,3640,7281,3640,0,1,3642,1153059,1.153059
4040,5300,1240,6572000,2,32326,8083,1,263948800,263948800,12121,4040,8081,4040,0,1,4042,1758089,1.758089
4440,5300,1240,6572000,2,35526,8883,1,284876800,284876800,13321,4440,8881,4440,0,1,4442,680711,0.680711
4840,5300,1240,6572000,2,38726,9683,1,305804800,305804800,14521,4840,9681,4840,0,1,4842,318576,0.318576
5240,5300,1240,6572000,2,41926,10483,1,326732800,326732800,15721,5240,10481,5240,0,1,5242,6677439,6.677439
5640,5300,1240,6572000,2,45126,11283,1,347660800,347660800,16921,5640,11281,5640,0,1,5642,6876,0.006876
6040,5300,1240,6572000,2,48326,12083,1,368588800,368588800,18121,6040,12081,6040,0,1,6042,735166,0.735166
6440,5300,1240,6572000,2,51526,12883,1,389516800,389516800,19321,6440,12881,6440,0,1,6442,1757997,1.757997
6840,5300,1240,6572000,2,54726,13683,1,410444800,410444800,20521,6840,13681,6840,0,1,6842,4414270,4.41427
55,3055,2165,6614075,2,446,113,1,55209400,55209400,166,55,111,55,0,1,57,5868,0.005868
455,3055,2165,6614075,2,3646,913,1,71913400,71913400,1366,455,911,455,0,1,457,117348,0.117348
855,3055,2165,6614075,2,6846,1713,1,88617400,88617400,2566,855,1711,855,0,1,857,87986,0.087986
1255,3055,2165,6614075,2,10046,2513,1,105321400,105321400,3766,1255,2511,1255,0,1,1257,191350,0.19135
1655,3055,2165,6614075,2,13246,3313,1,122025400,122025400,4966,1655,3311,1655,0,1,1657,218314,0.218314
2055,3055,2165,6614075,2,16446,4113,1,138729400,138729400,6166,2055,4111,2055,0,1,2057,812393,0.812393
2455,3055,2165,6614075,2,19646,4913,1,155433400,155433400,7366,2455,4911,2455,0,1,2457,1076057,1.076057
2855,3055,2165,6614075,2,22846,5713,1,172137400,172137400,8566,2855,5711,2855,0,1,2857,890991,0.890991
3255,3055,2165,6614075,2,26046,6513,1,188841400,188841400,9766,3255,6511,3255,0,1,3257,180446,0.180446
3655,3055,2165,6614075,2,29246,7313,1,205545400,205545400,10966,3655,7311,3655,0,1,3657,205065,0.205065
4055,3055,2165,6614075,2,32446,8113,1,222249400,222249400,12166,4055,8111,4055,0,1,4057,56786,0.056786
4455,3055,2165,6614075,2,35646,8913,1,238953400,238953400,13366,4455,8911,4455,0,1,4457,143686,0.143686
4855,3055,2165,6614075,2,38846,9713,1,255657400,255657400,14566,4855,9711,4855,0,1,4857,869467,0.869467
5255,3055,2165,6614075,2,42046,10513,1,272361400,272361400,15766,5255,10511,5255,0,1,5257,696352,0.696352
5655,3055,2165,6614075,2,45246,11313,1,289065400,289065400,16966,5655,11311,5655,0,1,5657,878428,0.878428
6055,3055,2165,6614075,2,48446,12113,1,305769400,305769400,18166,6055,12111,6055,0,1,6057,171548,0.171548
6455,3055,2165,6614075,2,51646,12913,1,322473400,322473400,19366,6455,12911,6455,0,1,6457,15188,0.015188
6855,3055,2165,6614075,2,54846,13713,1,339177400,339177400,20566,6855,13711,6855,0,1,6857,1075097,1.075097
55,1805,3665,6615325,2,446,113,1,55329400,55329400,166,55,111,55,0,1,57,141795,0.141795
455,1805,3665,6615325,2,3646,913,1,72833400,72833400,1366,455,911,455,0,1,457,533740,0.53374
855,1805,3665,6615325,2,6846,1713,1,90337400,90337400,2566,855,1711,855,0,1,857,252358,0.252358
1255,1805,3665,6615325,2,10046,2513,1,107841400,107841400,3766,1255,2511,1255,0,1,1257,434558,0.434558
1655,1805,3665,6615325,2,13246,3313,1,125345400,125345400,4966,1655,3311,1655,0,1,1657,552362,0.552362
2055,1805,3665,6615325,2,16446,4113,1,142849400,142849400,6166,2055,4111,2055,0,1,2057,2674217,2.674217
2455,1805,3665,6615325,2,19646,4913,1,160353400,160353400,7366,2455,4911,2455,0,1,2457,2475770,2.47577
2855,1805,3665,6615325,2,22846,5713,1,177857400,177857400,8566,2855,5711,2855,0,1,2857,177212,0.177212
3255,1805,3665,6615325,2,26046,6513,1,195361400,195361400,9766,3255,6511,3255,0,1,3257,490280,0.49028
3655,1805,3665,6615325,2,29246,7313,1,212865400,212865400,10966,3655,7311,3655,0,1,3657,696156,0.696156
4055,1805,3665,6615325,2,32446,8113,1,230369400,230369400,12166,4055,8111,4055,0,1,4057,374169,0.374169
4455,1805,3665,6615325,2,35646,8913,1,247873400,247873400,13366,4455,8911,4455,0,1,4457,1535968,1.535968
4855,1805,3665,6615325,2,38846,9713,1,265377400,265377400,14566,4855,9711,4855,0,1,4857,1052936,1.052936
5255,1805,3665,6615325,2,42046,10513,1,282881400,282881400,15766,5255,10511,5255,0,1,5257,2467099,2.467099
5655,1805,3665,6615325,2,45246,11313,1,300385400,300385400,16966,5655,11311,5655,0,1,5657,1356218,1.356218
6055,1805,3665,6615325,2,48446,12113,1,317889400,317889400,18166,6055,12111,6055,0,1,6057,691820,0.69182
6455,1805,3665,6615325,2,51646,12913,1,335393400,335393400,19366,6455,12911,6455,0,1,6457,3608013,3.608013
6855,1805,3665,6615325,2,54846,13713,1,352897400,352897400,20566,6855,13711,6855,0,1,6857,1419256,1.419256
40,4300,1540,6622000,2,326,83,1,54844800,54844800,121,40,81,40,0,1,42,119035,0.119035
440,4300,1540,6622000,2,3526,883,1,73532800,73532800,1321,440,881,440,0,1,442,414648,0.414648
840,4300,1540,6622000,2,6726,1683,1,92220800,92220800,2521,840,1681,840,0,1,842,274444,0.274444
1240,4300,1540,6622000,2,9926,2483,1,110908800,110908800,3721,1240,2481,1240,0,1,1242,466282,0.466282
1640,4300,1540,6622000,2,13126,3283,1,129596800,129596800,4921,1640,3281,1640,0,1,1642,1550570,1.55057
2040,4300,1540,6622000,2,16326,4083,1,148284800,148284800,6121,2040,4081,2040,0,1,2042,1301602,1.301602
2440,4300,1540,6622000,2,19526,4883,1,166972800,166972800,7321,2440,4881,2440,0,1,2442,1119644,1.119644
2840,4300,1540,6622000,2,22726,5683,1,185660800,185660800,8521,2840,5681,2840,0,1,2842,189466,0.189466
3240,4300,1540,6622000,2,25926,6483,1,204348800,204348800,9721,3240,6481,3240,0,1,3242,4031209,4.031209
3640,4300,1540,6622000,2,29126,7283,1,223036800,223036800,10921,3640,7281,3640,0,1,3642,4345780,4.34578
4040,4300,1540,6622000,2,32326,8083,1,241724800,241724800,12121,4040,8081,4040,0,1,4042,1456769,1.456769
4440,4300,1540,6622000,2,35526,8883,1,260412800,260412800,13321,4440,8881,4440,0,1,4442,3179787,3.179787
4840,4300,1540,6622000,2,38726,9683,1,279100800,279100800,14521,4840,9681,4840,0,1,4842,1210164,1.210164
5240,4300,1540,6622000,2,41926,10483,1,297788800,297788800,15721,5240,10481,5240,0,1,5242,5596572,5.596572
5640,4300,1540,6622000,2,45126,11283,1,316476800,316476800,16921,5640,11281,5640,0,1,5642,500018,0.500018
6040,4300,1540,6622000,2,48326,12083,1,335164800,335164800,18121,6040,12081,6040,0,1,6042,799133,0.799133
6440,4300,1540,6622000,2,51526,12883,1,353852800,353852800,19321,6440,12881,6440,0,1,6442,253297,0.253297
6840,4300,1540,6622000,2,54726,13683,1,372540800,372540800,20521,6840,13681,6840,0,1,6842,3471388,3.471388
40,7050,940,6627000,2,326,83,1,55572800,55572800,121,40,81,40,0,1,42,113658,0.113658
440,7050,940,6627000,2,3526,883,1,81140800,81140800,1321,440,881,440,0,1,442,622526,0.622526
840,7050,940,6627000,2,6726,1683,1,106708800,106708800,2521,840,1681,840,0,1,842,1133226,1.133226
1240,7050,940,6627000,2,9926,2483,1,132276800,132276800,3721,1240,2481,1240,0,1,1242,1649028,1.649028
1640,7050,940,6627000,2,13126,3283,1,157844800,157844800,4921,1640,3281,1640,0,1,1642,745308,0.745308
2040,7050,940,6627000,2,16326,4083,1,183412800,183412800,6121,2040,4081,2040,0,1,2042,2685219,2.685219
2440,7050,940,6627000,2,19526,4883,1,208980800,208980800,7321,2440,4881,2440,0,1,2442,188609,0.188609
2840,7050,940,6627000,2,22726,5683,1,234548800,234548800,8521,2840,5681,2840,0,1,2842,3746520,3.74652
3240,7050,940,6627000,2,25926,6483,1,260116800,260116800,9721,3240,6481,3240,0,1,3242,1026933,1.026933
3640,7050,940,6627000,2,29126,7283,1,285684800,285684800,10921,3640,7281,3640,0,1,3642,3978034,3.978034
4040,7050,940,6627000,2,32326,8083,1,311252800,311252800,12121,4040,8081,4040,0,1,4042,2663666,2.663666
4440,7050,940,6627000,2,35526,8883,1,336820800,336820800,13321,4440,8881,4440,0,1,4442,5833164,5.833164
4840,7050,940,6627000,2,38726,9683,1,362388800,362388800,14521,4840,9681,4840,0,1,4842,6367623,6.367623
5240,7050,940,6627000,2,41926,10483,1,387956800,387956800,15721,5240,10481,5240,0,1,5242,6854695,6.854695
5640,7050,940,6627000,2,45126,11283,1,413524800,413524800,16921,5640,11281,5640,0,1,5642,7381102,7.381102
6040,7050,940,6627000,2,48326,12083,1,439092800,439092800,18121,6040,12081,6040,0,1,6042,7903202,7.903202
6440,7050,940,6627000,2,51526,12883,1,464660800,464660800,19321,6440,12881,6440,0,1,6442,8461702,8.461702
6840,7050,940,6627000,2,54726,13683,1,490228800,490228800,20521,6840,13681,6840,0,1,6842,8995140,8.99514
55,3555,1865,6630075,2,446,113,1,55425400,55425400,166,55,111,55,0,1,57,131530,0.13153
455,3555,1865,6630075,2,3646,913,1,72769400,72769400,1366,455,911,455,0,1,457,638396,0.638396
855,3555,1865,6630075,2,6846,1713,1,90113400,90113400,2566,855,1711,855,0,1,857,1145618,1.145618
1255,3555,1865,6630075,2,10046,2513,1,107457400,107457400,3766,1255,2511,1255,0,1,1257,1656880,1.65688
1655,3555,1865,6630075,2,13246,3313,1,124801400,124801400,4966,1655,3311,1655,0,1,1657,82675,0.082675
2055,3555,1865,6630075,2,16446,4113,1,142145400,142145400,6166,2055,4111,2055,0,1,2057,740588,0.740588
2455,3555,1865,6630075,2,19646,4913,1,159489400,159489400,7366,2455,4911,2455,0,1,2457,429104,0.429104
2855,3555,1865,6630075,2,22846,5713,1,176833400,176833400,8566,2855,5711,2855,0,1,2857,466292,0.466292
3255,3555,1865,6630075,2,26046,6513,1,194177400,194177400,9766,3255,6511,3255,0,1,3257,1018668,1.018668
3655,3555,1865,6630075,2,29246,7313,1,211521400,211521400,10966,3655,7311,3655,0,1,3657,3633015,3.633015
4055,3555,1865,6630075,2,32446,8113,1,228865400,228865400,12166,4055,8111,4055,0,1,4057,5252070,5.25207
4455,3555,1865,6630075,2,35646,8913,1,246209400,246209400,13366,4455,8911,4455,0,1,4457,926736,0.926736
4855,3555,1865,6630075,2,38846,9713,1,263553400,263553400,14566,4855,9711,4855,0,1,4857,445083,0.445083
5255,3555,1865,6630075,2,42046,10513,1,280897400,280897400,15766,5255,10511,5255,0,1,5257,378696,0.378696
5655,3555,1865,6630075,2,45246,11313,1,298241400,298241400,16966,5655,11311,5655,0,1,5657,917925,0.917925
6055,3555,1865,6630075,2,48446,12113,1,315585400,315585400,18166,6055,12111,6055,0,1,6057,750468,0.750468
6455,3555,1865,6630075,2,51646,12913,1,332929400,332929400,19366,6455,12911,6455,0,1,6457,683011,0.683011
6855,3555,1865,6630075,2,54846,13713,1,350273400,350273400,20566,6855,13711,6855,0,1,6857,2928054,2.928054
55,1555,4265,6632075,2,446,113,1,55617400,55617400,166,55,111,55,0,1,57,136428,0.136428
455,1555,4265,6632075,2,3646,913,1,74241400,74241400,1366,455,911,455,0,1,457,640530,0.64053
855,1555,4265,6632075,2,6846,1713,1,92865400,92865400,2566,855,1711,855,0,1,857,1147217,1.147217
1255,1555,4265,6632075,2,10046,2513,1,111489400,111489400,3766,1255,2511,1255,0,1,1257,789960,0.78996
1655,1555,4265,6632075,2,13246,3313,1,130113400,130113400,4966,1655,3311,1655,0,1,1657,448871,0.448871
2055,1555,4265,6632075,2,16446,4113,1,148737400,148737400,6166,2055,4111,2055,0,1,2057,29753,0.029753
2455,1555,4265,6632075,2,19646,4913,1,167361400,167361400,7366,2455,4911,2455,0,1,2457,573962,0.573962
2855,1555,4265,6632075,2,22846,5713,1,185985400,185985400,8566,2855,5711,2855,0,1,2857,584133,0.584133
3255,1555,4265,6632075,2,26046,6513,1,204609400,204609400,9766,3255,6511,3255,0,1,3257,2701714,2.701714
3655,1555,4265,6632075,2,29246,7313,1,223233400,223233400,10966,3655,7311,3655,0,1,3657,84477,0.084477
4055,1555,4265,6632075,2,32446,8113,1,241857400,241857400,12166,4055,8111,4055,0,1,4057,2844816,2.844816
4455,1555,4265,6632075,2,35646,8913,1,260481400,260481400,13366,4455,8911,4455,0,1,4457,1465619,1.465619
4855,1555,4265,6632075,2,38846,9713,1,279105400,279105400,14566,4855,9711,4855,0,1,4857,1648816,1.648816
5255,1555,4265,6632075,2,42046,10513,1,297729400,297729400,15766,5255,10511,5255,0,1,5257,1281533,1.281533
5655,1555,4265,6632075,2,45246,11313,1,316353400,316353400,16966,5655,11311,5655,0,1,5657,618519,0.618519
6055,1555,4265,6632075,2,48446,12113,1,334977400,334977400,18166,6055,12111,6055,0,1,6057,959143,0.959143
6455,1555,4265,6632075,2,51646,12913,1,353601400,353601400,19366,6455,12911,6455,0,1,6457,4333454,4.333454
6855,1555,4265,6632075,2,54846,13713,1,372225400,372225400,20566,6855,13711,6855,0,1,6857,2237814,2.237814
40,1050,6340,6657000,2,326,83,1,55620800,55620800,121,40,81,40,0,1,42,34901,0.034901
440,1050,6340,6657000,2,3526,883,1,79268800,79268800,1321,440,881,440,0,1,442,24581,0.024581
840,1050,6340,6657000,2,6726,1683,1,102916800,102916800,2521,840,1681,840,0,1,842,136510,0.13651
1240,1050,6340,6657000,2,9926,2483,1,126564800,126564800,3721,1240,2481,1240,0,1,1242,144963,0.144963
1640,1050,6340,6657000,2,13126,3283,1,150212800,150212800,4921,1640,3281,1640,0,1,1642,126668,0.126668
2040,1050,6340,6657000,2,16326,4083,1,173860800,173860800,6121,2040,4081,2040,0,1,2042,114976,0.114976
2440,1050,6340,6657000,2,19526,4883,1,197508800,197508800,7321,2440,4881,2440,0,1,2442,362506,0.362506
2840,1050,6340,6657000,2,22726,5683,1,221156800,221156800,8521,2840,5681,2840,0,1,2842,480532,0.480532
3240,1050,6340,6657000,2,25926,6483,1,244804800,244804800,9721,3240,6481,3240,0,1,3242,130330,0.13033
3640,1050,6340,6657000,2,29126,7283,1,268452800,268452800,10921,3640,7281,3640,0,1,3642,520769,0.520769
4040,1050,6340,6657000,2,32326,8083,1,292100800,292100800,12121,4040,8081,4040,0,1,4042,27422,0.027422
4440,1050,6340,6657000,2,35526,8883,1,315748800,315748800,13321,4440,8881,4440,0,1,4442,47501,0.047501
4840,1050,6340,6657000,2,38726,9683,1,339396800,339396800,14521,4840,9681,4840,0,1,4842,385779,0.385779
5240,1050,6340,6657000,2,41926,10483,1,363044800,363044800,15721,5240,10481,5240,0,1,5242,450360,0.45036
5640,1050,6340,6657000,2,45126,11283,1,386692800,386692800,16921,5640,11281,5640,0,1,5642,1131977,1.131977
6040,1050,6340,6657000,2,48326,12083,1,410340800,410340800,18121,6040,12081,6040,0,1,6042,315893,0.315893
6440,1050,6340,6657000,2,51526,12883,1,433988800,433988800,19321,6440,12881,6440,0,1,6442,73861,0.073861
6840,1050,6340,6657000,2,54726,13683,1,457636800,457636800,20521,6840,13681,6840,0,1,6842,553968,0.553968
40,1300,5140,6682000,2,326,83,1,55516800,55516800,121,40,81,40,0,1,42,124711,0.124711
440,1300,5140,6682000,2,3526,883,1,76124800,76124800,1321,440,881,440,0,1,442,245414,0.245414
840,1300,5140,6682000,2,6726,1683,1,96732800,96732800,2521,840,1681,840,0,1,842,51331,0.051331
1240,1300,5140,6682000,2,9926,2483,1,117340800,117340800,3721,1240,2481,1240,0,1,1242,1648588,1.648588
1640,1300,5140,6682000,2,13126,3283,1,137948800,137948800,4921,1640,3281,1640,0,1,1642,987109,0.987109
2040,1300,5140,6682000,2,16326,4083,1,158556800,158556800,6121,2040,4081,2040,0,1,2042,277194,0.277194
2440,1300,5140,6682000,2,19526,4883,1,179164800,179164800,7321,2440,4881,2440,0,1,2442,982820,0.98282
2840,1300,5140,6682000,2,22726,5683,1,199772800,199772800,8521,2840,5681,2840,0,1,2842,725800,0.7258
3240,1300,5140,6682000,2,25926,6483,1,220380800,220380800,9721,3240,6481,3240,0,1,3242,846266,0.846266
3640,1300,5140,6682000,2,29126,7283,1,240988800,240988800,10921,3640,7281,3640,0,1,3642,1132405,1.132405
4040,1300,5140,6682000,2,32326,8083,1,261596800,261596800,12121,4040,8081,4040,0,1,4042,1337696,1.337696
4440,1300,5140,6682000,2,35526,8883,1,282204800,282204800,13321,4440,8881,4440,0,1,4442,1152428,1.152428
4840,1300,5140,6682000,2,38726,9683,1,302812800,302812800,14521,4840,9681,4840,0,1,4842,332884,0.332884
5240,1300,5140,6682000,2,41926,10483,1,323420800,323420800,15721,5240,10481,5240,0,1,5242,2683279,2.683279
5640,1300,5140,6682000,2,45126,11283,1,344028800,344028800,16921,5640,11281,5640,0,1,5642,61217,0.061217
6040,1300,5140,6682000,2,48326,12083,1,364636800,364636800,18121,6040,12081,6040,0,1,6042,654860,0.65486
6440,1300,5140,6682000,2,51526,12883,1,385244800,385244800,19321,6440,12881,6440,0,1,6442,1728936,1.728936
6840,1300,5140,6682000,2,54726,13683,1,405852800,405852800,20521,6840,13681,6840,0,1,6842,827190,0.82719
55,5305,1265,6710825,2,446,113,1,56577400,56577400,166,55,111,55,0,1,57,131386,0.131386
455,5305,1265,6710825,2,3646,913,1,77601400,77601400,1366,455,911,455,0,1,457,638739,0.638739
855,5305,1265,6710825,2,6846,1713,1,98625400,98625400,2566,855,1711,855,0,1,857,645509,0.645509
1255,5305,1265,6710825,2,10046,2513,1,119649400,119649400,3766,1255,2511,1255,0,1,1257,355847,0.355847
1655,5305,1265,6710825,2,13246,3313,1,140673400,140673400,4966,1655,3311,1655,0,1,1657,2190784,2.190784
2055,5305,1265,6710825,2,16446,4113,1,161697400,161697400,6166,2055,4111,2055,0,1,2057,1238665,1.238665
2455,5305,1265,6710825,2,19646,4913,1,182721400,182721400,7366,2455,4911,2455,0,1,2457,1976290,1.97629
2855,5305,1265,6710825,2,22846,5713,1,203745400,203745400,8566,2855,5711,2855,0,1,2857,2613059,2.613059
3255,5305,1265,6710825,2,26046,6513,1,224769400,224769400,9766,3255,6511,3255,0,1,3257,677345,0.677345
3655,5305,1265,6710825,2,29246,7313,1,245793400,245793400,10966,3655,7311,3655,0,1,3657,1376458,1.376458
4055,5305,1265,6710825,2,32446,8113,1,266817400,266817400,12166,4055,8111,4055,0,1,4057,936192,0.936192
4455,5305,1265,6710825,2,35646,8913,1,287841400,287841400,13366,4455,8911,4455,0,1,4457,820381,0.820381
4855,5305,1265,6710825,2,38846,9713,1,308865400,308865400,14566,4855,9711,4855,0,1,4857,4504458,4.504458
5255,5305,1265,6710825,2,42046,10513,1,329889400,329889400,15766,5255,10511,5255,0,1,5257,73286,0.073286
5655,5305,1265,6710825,2,45246,11313,1,350913400,350913400,16966,5655,11311,5655,0,1,5657,671140,0.67114
6055,5305,1265,6710825,2,48446,12113,1,371937400,371937400,18166,6055,12111,6055,0,1,6057,559736,0.559736
6455,5305,1265,6710825,2,51646,12913,1,392961400,392961400,19366,6455,12911,6455,0,1,6457,249606,0.249606
6855,5305,1265,6710825,2,54846,13713,1,413985400,413985400,20566,6855,13711,6855,0,1,6857,8932225,8.932225
55,1055,6365,6715075,2,446,113,1,56985400,56985400,166,55,111,55,0,1,57,5328,0.005328
455,1055,6365,6715075,2,3646,913,1,80729400,80729400,1366,455,911,455,0,1,457,64474,0.064474
855,1055,6365,6715075,2,6846,1713,1,104473400,104473400,2566,855,1711,855,0,1,857,140632,0.140632
1255,1055,6365,6715075,2,10046,2513,1,128217400,128217400,3766,1255,2511,1255,0,1,1257,28944,0.028944
1655,1055,6365,6715075,2,13246,3313,1,151961400,151961400,4966,1655,3311,1655,0,1,1657,123881,0.123881
2055,1055,6365,6715075,2,16446,4113,1,175705400,175705400,6166,2055,4111,2055,0,1,2057,423992,0.423992
2455,1055,6365,6715075,2,19646,4913,1,199449400,199449400,7366,2455,4911,2455,0,1,2457,158798,0.158798
2855,1055,6365,6715075,2,22846,5713,1,223193400,223193400,8566,2855,5711,2855,0,1,2857,1188147,1.188147
3255,1055,6365,6715075,2,26046,6513,1,246937400,246937400,9766,3255,6511,3255,0,1,3257,266536,0.266536
3655,1055,6365,6715075,2,29246,7313,1,270681400,270681400,10966,3655,7311,3655,0,1,3657,184264,0.184264
4055,1055,6365,6715075,2,32446,8113,1,294425400,294425400,12166,4055,8111,4055,0,1,4057,351267,0.351267
4455,1055,6365,6715075,2,35646,8913,1,318169400,318169400,13366,4455,8911,4455,0,1,4457,833892,0.833892
4855,1055,6365,6715075,2,38846,9713,1,341913400,341913400,14566,4855,9711,4855,0,1,4857,903711,0.903711
5255,1055,6365,6715075,2,42046,10513,1,365657400,365657400,15766,5255,10511,5255,0,1,5257,60864,0.060864
5655,1055,6365,6715075,2,45246,11313,1,389401400,389401400,16966,5655,11311,5655,0,1,5657,342329,0.342329
6055,1055,6365,6715075,2,48446,12113,1,413145400,413145400,18166,6055,12111,6055,0,1,6057,383872,0.383872
6455,1055,6365,6715075,2,51646,12913,1,436889400,436889400,19366,6455,12911,6455,0,1,6457,1469279,1.469279
6855,1055,6365,6715075,2,54846,13713,1,460633400,460633400,20566,6855,13711,6855,0,1,6857,692347,0.692347
55,4305,1565,6737325,2,446,113,1,56481400,56481400,166,55,111,55,0,1,57,136053,0.136053
455,4305,1565,6737325,2,3646,913,1,75265400,75265400,1366,455,911,455,0,1,457,67930,0.06793
855,4305,1565,6737325,2,6846,1713,1,94049400,94049400,2566,855,1711,855,0,1,857,543405,0.543405
1255,4305,1565,6737325,2,10046,2513,1,112833400,112833400,3766,1255,2511,1255,0,1,1257,288792,0.288792
1655,4305,1565,6737325,2,13246,3313,1,131617400,131617400,4966,1655,3311,1655,0,1,1657,1286475,1.286475
2055,4305,1565,6737325,2,16446,4113,1,150401400,150401400,6166,2055,4111,2055,0,1,2057,276259,0.276259
2455,4305,1565,6737325,2,19646,4913,1,169185400,169185400,7366,2455,4911,2455,0,1,2457,2494786,2.494786
2855,4305,1565,6737325,2,22846,5713,1,187969400,187969400,8566,2855,5711,2855,0,1,2857,586303,0.586303
3255,4305,1565,6737325,2,26046,6513,1,206753400,206753400,9766,3255,6511,3255,0,1,3257,3758550,3.75855
3655,4305,1565,6737325,2,29246,7313,1,225537400,225537400,10966,3655,7311,3655,0,1,3657,4676135,4.676135
4055,4305,1565,6737325,2,32446,8113,1,244321400,244321400,12166,4055,8111,4055,0,1,4057,4646,0.004646
4455,4305,1565,6737325,2,35646,8913,1,263105400,263105400,13366,4455,8911,4455,0,1,4457,780223,0.780223
4855,4305,1565,6737325,2,38846,9713,1,281889400,281889400,14566,4855,9711,4855,0,1,4857,2054668,2.054668
5255,4305,1565,6737325,2,42046,10513,1,300673400,300673400,15766,5255,10511,5255,0,1,5257,1431514,1.431514
5655,4305,1565,6737325,2,45246,11313,1,319457400,319457400,16966,5655,11311,5655,0,1,5657,1803157,1.803157
6055,4305,1565,6737325,2,48446,12113,1,338241400,338241400,18166,6055,12111,6055,0,1,6057,185126,0.185126
6455,4305,1565,6737325,2,51646,12913,1,357025400,357025400,19366,6455,12911,6455,0,1,6457,1022312,1.022312
6855,4305,1565,6737325,2,54846,13713,1,375809400,375809400,20566,6855,13711,6855,0,1,6857,1233630,1.23363
55,1305,5165,6740325,2,446,113,1,56769400,56769400,166,55,111,55,0,1,57,137516,0.137516
455,1305,5165,6740325,2,3646,913,1,77473400,77473400,1366,455,911,455,0,1,457,650245,0.650245
855,1305,5165,6740325,2,6846,1713,1,98177400,98177400,2566,855,1711,855,0,1,857,342866,0.342866
1255,1305,5165,6740325,2,10046,2513,1,118881400,118881400,3766,1255,2511,1255,0,1,1257,863940,0.86394
1655,1305,5165,6740325,2,13246,3313,1,139585400,139585400,4966,1655,3311,1655,0,1,1657,602540,0.60254
2055,1305,5165,6740325,2,16446,4113,1,160289400,160289400,6166,2055,4111,2055,0,1,2057,312861,0.312861
2455,1305,5165,6740325,2,19646,4913,1,180993400,180993400,7366,2455,4911,2455,0,1,2457,416444,0.416444
2855,1305,5165,6740325,2,22846,5713,1,201697400,201697400,8566,2855,5711,2855,0,1,2857,937017,0.937017
3255,1305,5165,6740325,2,26046,6513,1,222401400,222401400,9766,3255,6511,3255,0,1,3257,913536,0.913536
3655,1305,5165,6740325,2,29246,7313,1,243105400,243105400,10966,3655,7311,3655,0,1,3657,233010,0.23301
4055,1305,5165,6740325,2,32446,8113,1,263809400,263809400,12166,4055,8111,4055,0,1,4057,445314,0.445314
4455,1305,5165,6740325,2,35646,8913,1,284513400,284513400,13366,4455,8911,4455,0,1,4457,1751675,1.751675
4855,1305,5165,6740325,2,38846,9713,1,305217400,305217400,14566,4855,9711,4855,0,1,4857,1437191,1.437191
5255,1305,5165,6740325,2,42046,10513,1,325921400,325921400,15766,5255,10511,5255,0,1,5257,1091220,1.09122
5655,1305,5165,6740325,2,45246,11313,1,346625400,346625400,16966,5655,11311,5655,0,1,5657,2400919,2.400919
6055,1305,5165,6740325,2,48446,12113,1,367329400,367329400,18166,6055,12111,6055,0,1,6057,1158623,1.158623
6455,1305,5165,6740325,2,51646,12913,1,388033400,388033400,19366,6455,12911,6455,0,1,6457,521541,0.521541
6855,1305,5165,6740325,2,54846,13713,1,408737400,408737400,20566,6855,13711,6855,0,1,6857,55125,0.055125
35,4400,1545,6798000,2,286,73,1,56048600,56048600,106,35,71,35,0,1,37,73613,0.073613
535,4400,1545,6798000,2,4286,1073,1,79828600,79828600,1606,535,1071,535,0,1,537,22084,0.022084
1035,4400,1545,6798000,2,8286,2073,1,103608600,103608600,3106,1035,2071,1035,0,1,1037,18464,0.018464
1535,4400,1545,6798000,2,12286,3073,1,127388600,127388600,4606,1535,3071,1535,0,1,1537,424266,0.424266
2035,4400,1545,6798000,2,16286,4073,1,151168600,151168600,6106,2035,4071,2035,0,1,2037,1684620,1.68462
2535,4400,1545,6798000,2,20286,5073,1,174948600,174948600,7606,2535,5071,2535,0,1,2537,667759,0.667759
3035,4400,1545,6798000,2,24286,6073,1,198728600,198728600,9106,3035,6071,3035,0,1,3037,2386379,2.386379
3535,4400,1545,6798000,2,28286,7073,1,222508600,222508600,10606,3535,7071,3535,0,1,3537,1571813,1.571813
4035,4400,1545,6798000,2,32286,8073,1,246288600,246288600,12106,4035,8071,4035,0,1,4037,944041,0.944041
4535,4400,1545,6798000,2,36286,9073,1,270068600,270068600,13606,4535,9071,4535,0,1,4537,5897678,5.897678
5035,4400,1545,6798000,2,40286,10073,1,293848600,293848600,15106,5035,10071,5035,0,1,5037,2886421,2.886421
5535,4400,1545,6798000,2,44286,11073,1,317628600,317628600,16606,5535,11071,5535,0,1,5537,1782575,1.782575
6035,4400,1545,6798000,2,48286,12073,1,341408600,341408600,18106,6035,12071,6035,0,1,6037,1295342,1.295342
6535,4400,1545,6798000,2,52286,13073,1,365188600,365188600,19606,6535,13071,6535,0,1,6537,1945040,1.94504
7035,4400,1545,6798000,2,56286,14073,1,388968600,388968600,21106,7035,14071,7035,0,1,7037,231441,0.231441
55,7055,965,6808075,2,446,113,1,57993400,57993400,166,55,111,55,0,1,57,140186,0.140186
455,7055,965,6808075,2,3646,913,1,83657400,83657400,1366,455,911,455,0,1,457,52982,0.052982
855,7055,965,6808075,2,6846,1713,1,109321400,109321400,2566,855,1711,855,0,1,857,1180276,1.180276
1255,7055,965,6808075,2,10046,2513,1,134985400,134985400,3766,1255,2511,1255,0,1,1257,1707724,1.707724
1655,7055,965,6808075,2,13246,3313,1,160649400,160649400,4966,1655,3311,1655,0,1,1657,2246520,2.24652
2055,7055,965,6808075,2,16446,4113,1,186313400,186313400,6166,2055,4111,2055,0,1,2057,106488,0.106488
2455,7055,965,6808075,2,19646,4913,1,211977400,211977400,7366,2455,4911,2455,0,1,2457,1915639,1.915639
2855,7055,965,6808075,2,22846,5713,1,237641400,237641400,8566,2855,5711,2855,0,1,2857,3374064,3.374064
3255,7055,965,6808075,2,26046,6513,1,263305400,263305400,9766,3255,6511,3255,0,1,3257,402061,0.402061
3655,7055,965,6808075,2,29246,7313,1,288969400,288969400,10966,3655,7311,3655,0,1,3657,684940,0.68494
4055,7055,965,6808075,2,32446,8113,1,314633400,314633400,12166,4055,8111,4055,0,1,4057,5449263,5.449263
4455,7055,965,6808075,2,35646,8913,1,340297400,340297400,13366,4455,8911,4455,0,1,4457,2651057,2.651057
4855,7055,965,6808075,2,38846,9713,1,365961400,365961400,14566,4855,9711,4855,0,1,4857,6543776,6.543776
5255,7055,965,6808075,2,42046,10513,1,391625400,391625400,15766,5255,10511,5255,0,1,5257,4145021,4.145021
5655,7055,965,6808075,2,45246,11313,1,417289400,417289400,16966,5655,11311,5655,0,1,5657,7630537,7.630537
6055,7055,965,6808075,2,48446,12113,1,442953400,442953400,18166,6055,12111,6055,0,1,6057,8132000,8.132
6455,7055,965,6808075,2,51646,12913,1,468617400,468617400,19366,6455,12911,6455,0,1,6457,8689556,8.689556
6855,7055,965,6808075,2,54846,13713,1,494281400,494281400,20566,6855,13711,6855,0,1,6857,9260366,9.260366
35,2240,3045,6820800,2,286,73,1,56046200,56046200,106,35,71,35,0,1,37,130344,0.130344
535,2240,3045,6820800,2,4286,1073,1,77186200,77186200,1606,535,1071,535,0,1,537,730129,0.730129
1035,2240,3045,6820800,2,8286,2073,1,98326200,98326200,3106,1035,2071,1035,0,1,1037,1373058,1.373058
1535,2240,3045,6820800,2,12286,3073,1,119466200,119466200,4606,1535,3071,1535,0,1,1537,2007681,2.007681
2035,2240,3045,6820800,2,16286,4073,1,140606200,140606200,6106,2035,4071,2035,0,1,2037,2646875,2.646875
2535,2240,3045,6820800,2,20286,5073,1,161746200,161746200,7606,2535,5071,2535,0,1,2537,3286262,3.286262
39,2243,3041,6820963,2,318,81,1,56216312,56216312,118,39,79,39,0,1,41,6685,0.006685
539,2243,3041,6820963,2,4318,1081,1,77352312,77352312,1618,539,1079,539,0,1,541,6158,0.006158
1039,2243,3041,6820963,2,8318,2081,1,98488312,98488312,3118,1039,2079,1039,0,1,1041,131320,0.13132
1539,2243,3041,6820963,2,12318,3081,1,119624312,119624312,4618,1539,3079,1539,0,1,1541,122316,0.122316
2039,2243,3041,6820963,2,16318,4081,1,140760312,140760312,6118,2039,4079,2039,0,1,2041,128907,0.128907
2539,2243,3041,6820963,2,20318,5081,1,161896312,161896312,7618,2539,5079,2539,0,1,2541,770625,0.770625
3039,2243,3041,6820963,2,24318,6081,1,183032312,183032312,9118,3039,6079,3039,0,1,3041,296877,0.296877
3539,2243,3041,6820963,2,28318,7081,1,204168312,204168312,10618,3539,7079,3539,0,1,3541,317681,0.317681
4039,2243,3041,6820963,2,32318,8081,1,225304312,225304312,12118,4039,8079,4039,0,1,4041,574851,0.574851
4539,2243,3041,6820963,2,36318,9081,1,246440312,246440312,13618,4539,9079,4539,0,1,4541,4837714,4.837714
5039,2243,3041,6820963,2,40318,10081,1,267576312,267576312,15118,5039,10079,5039,0,1,5041,861784,0.861784
5539,2243,3041,6820963,2,44318,11081,1,288712312,288712312,16618,5539,11079,5539,0,1,5541,819770,0.81977
6039,2243,3041,6820963,2,48318,12081,1,309848312,309848312,18118,6039,12079,6039,0,1,6041,2543628,2.543628
6539,2243,3041,6820963,2,52318,13081,1,330984312,330984312,19618,6539,13079,6539,0,1,6541,1035454,1.035454
7039,2243,3041,6820963,2,56318,14081,1,352120312,352120312,21118,7039,14079,7039,0,1,7041,114847,0.114847
39,3343,2041,6823063,2,318,81,1,56264312,56264312,118,39,79,39,0,1,41,16160,0.01616
539,3343,2041,6823063,2,4318,1081,1,77800312,77800312,1618,539,1079,539,0,1,541,341,0.000341
1039,3343,2041,6823063,2,8318,2081,1,99336312,99336312,3118,1039,2079,1039,0,1,1041,197587,0.197587
1539,3343,2041,6823063,2,12318,3081,1,120872312,120872312,4618,1539,3079,1539,0,1,1541,90083,0.090083
2039,3343,2041,6823063,2,16318,4081,1,142408312,142408312,6118,2039,4079,2039,0,1,2041,143681,0.143681
2539,3343,2041,6823063,2,20318,5081,1,163944312,163944312,7618,2539,5079,2539,0,1,2541,1366133,1.366133
3039,3343,2041,6823063,2,24318,6081,1,185480312,185480312,9118,3039,6079,3039,0,1,3041,337309,0.337309
3539,3343,2041,6823063,2,28318,7081,1,207016312,207016312,10618,3539,7079,3539,0,1,3541,3593137,3.593137
4039,3343,2041,6823063,2,32318,8081,1,228552312,228552312,12118,4039,8079,4039,0,1,4041,2656517,2.656517
4539,3343,2041,6823063,2,36318,9081,1,250088312,250088312,13618,4539,9079,4539,0,1,4541,278209,0.278209
5039,3343,2041,6823063,2,40318,10081,1,271624312,271624312,15118,5039,10079,5039,0,1,5041,508674,0.508674
5539,3343,2041,6823063,2,44318,11081,1,293160312,293160312,16618,5539,11079,5539,0,1,5541,635640,0.63564
6039,3343,2041,6823063,2,48318,12081,1,314696312,314696312,18118,6039,12079,6039,0,1,6041,1070336,1.070336
6539,3343,2041,6823063,2,52318,13081,1,336232312,336232312,19618,6539,13079,6539,0,1,6541,2219691,2.219691
7039,3343,2041,6823063,2,56318,14081,1,357768312,357768312,21118,7039,14079,7039,0,1,7041,383065,0.383065
35,3340,2045,6830300,2,286,73,1,56150200,56150200,106,35,71,35,0,1,37,142368,0.142368
535,3340,2045,6830300,2,4286,1073,1,77690200,77690200,1606,535,1071,535,0,1,537,732292,0.732292
1035,3340,2045,6830300,2,8286,2073,1,99230200,99230200,3106,1035,2071,1035,0,1,1037,1373751,1.373751
1535,3340,2045,6830300,2,12286,3073,1,120770200,120770200,4606,1535,3071,1535,0,1,1537,2016630,2.01663
2035,3340,2045,6830300,2,16286,4073,1,142310200,142310200,6106,2035,4071,2035,0,1,2037,2656124,2.656124
40,2800,2440,6832000,2,326,83,1,56332800,56332800,121,40,81,40,0,1,42,123631,0.123631
440,2800,2440,6832000,2,3526,883,1,73100800,73100800,1321,440,881,440,0,1,442,414011,0.414011
840,2800,2440,6832000,2,6726,1683,1,89868800,89868800,2521,840,1681,840,0,1,842,625653,0.625653
1240,2800,2440,6832000,2,9926,2483,1,106636800,106636800,3721,1240,2481,1240,0,1,1242,1618730,1.61873
1640,2800,2440,6832000,2,13126,3283,1,123404800,123404800,4921,1640,3281,1640,0,1,1642,1613953,1.613953
2040,2800,2440,6832000,2,16326,4083,1,140172800,140172800,6121,2040,4081,2040,0,1,2042,1357072,1.357072
2440,2800,2440,6832000,2,19526,4883,1,156940800,156940800,7321,2440,4881,2440,0,1,2442,880739,0.880739
2840,2800,2440,6832000,2,22726,5683,1,173708800,173708800,8521,2840,5681,2840,0,1,2842,1610442,1.610442
3240,2800,2440,6832000,2,25926,6483,1,190476800,190476800,9721,3240,6481,3240,0,1,3242,2224820,2.22482
3640,2800,2440,6832000,2,29126,7283,1,207244800,207244800,10921,3640,7281,3640,0,1,3642,249897,0.249897
4040,2800,2440,6832000,2,32326,8083,1,224012800,224012800,12121,4040,8081,4040,0,1,4042,4668509,4.668509
4440,2800,2440,6832000,2,35526,8883,1,240780800,240780800,13321,4440,8881,4440,0,1,4442,5677996,5.677996
4840,2800,2440,6832000,2,38726,9683,1,257548800,257548800,14521,4840,9681,4840,0,1,4842,28229,0.028229
5240,2800,2440,6832000,2,41926,10483,1,274316800,274316800,15721,5240,10481,5240,0,1,5242,646409,0.646409
5640,2800,2440,6832000,2,45126,11283,1,291084800,291084800,16921,5640,11281,5640,0,1,5642,2721531,2.721531
6040,2800,2440,6832000,2,48326,12083,1,307852800,307852800,18121,6040,12081,6040,0,1,6042,1425360,1.42536
6440,2800,2440,6832000,2,51526,12883,1,324620800,324620800,19321,6440,12881,6440,0,1,6442,706394,0.706394
6840,2800,2440,6832000,2,54726,13683,1,341388800,341388800,20521,6840,13681,6840,0,1,6842,1744789,1.744789
39,1693,4041,6841413,2,318,81,1,56520312,56520312,118,39,79,39,0,1,41,121532,0.121532
539,1693,4041,6841413,2,4318,1081,1,79456312,79456312,1618,539,1079,539,0,1,541,18619,0.018619
1039,1693,4041,6841413,2,8318,2081,1,102392312,102392312,3118,1039,2079,1039,0,1,1041,1025928,1.025928
1539,1693,4041,6841413,2,12318,3081,1,125328312,125328312,4618,1539,3079,1539,0,1,1541,161328,0.161328
2039,1693,4041,6841413,2,16318,4081,1,148264312,148264312,6118,2039,4079,2039,0,1,2041,2761329,2.761329
2539,1693,4041,6841413,2,20318,5081,1,171200312,171200312,7618,2539,5079,2539,0,1,2541,1032120,1.03212
3039,1693,4041,6841413,2,24318,6081,1,194136312,194136312,9118,3039,6079,3039,0,1,3041,520286,0.520286
3539,1693,4041,6841413,2,28318,7081,1,217072312,217072312,10618,3539,7079,3539,0,1,3541,91751,0.091751
4039,1693,4041,6841413,2,32318,8081,1,240008312,240008312,12118,4039,8079,4039,0,1,4041,3337932,3.337932
4539,1693,4041,6841413,2,36318,9081,1,262944312,262944312,13618,4539,9079,4539,0,1,4541,5303501,5.303501
5039,1693,4041,6841413,2,40318,10081,1,285880312,285880312,15118,5039,10079,5039,0,1,5041,1102955,1.102955
5539,1693,4041,6841413,2,44318,11081,1,308816312,308816312,16618,5539,11079,5539,0,1,5541,1062233,1.062233
6039,1693,4041,6841413,2,48318,12081,1,331752312,331752312,18118,6039,12079,6039,0,1,6041,852735,0.852735
6539,1693,4041,6841413,2,52318,13081,1,354688312,354688312,19618,6539,13079,6539,0,1,6541,2785584,2.785584
7039,1693,4041,6841413,2,56318,14081,1,377624312,377624312,21118,7039,14079,7039,0,1,7041,152024,0.152024
39,4443,1541,6846663,2,318,81,1,56640312,56640312,118,39,79,39,0,1,41,7131,0.007131
539,4443,1541,6846663,2,4318,1081,1,80576312,80576312,1618,539,1079,539,0,1,541,87419,0.087419
1039,4443,1541,6846663,2,8318,2081,1,104512312,104512312,3118,1039,2079,1039,0,1,1041,9832,0.009832
1539,4443,1541,6846663,2,12318,3081,1,128448312,128448312,4618,1539,3079,1539,0,1,1541,386432,0.386432
2039,4443,1541,6846663,2,16318,4081,1,152384312,152384312,6118,2039,4079,2039,0,1,2041,40099,0.040099
2539,4443,1541,6846663,2,20318,5081,1,176320312,176320312,7618,2539,5079,2539,0,1,2541,337766,0.337766
3039,4443,1541,6846663,2,24318,6081,1,200256312,200256312,9118,3039,6079,3039,0,1,3041,1307214,1.307214
3539,4443,1541,6846663,2,28318,7081,1,224192312,224192312,10618,3539,7079,3539,0,1,3541,26003,0.026003
4039,4443,1541,6846663,2,32318,8081,1,248128312,248128312,12118,4039,8079,4039,0,1,4041,154720,0.15472
4539,4443,1541,6846663,2,36318,9081,1,272064312,272064312,13618,4539,9079,4539,0,1,4541,295094,0.295094
5039,4443,1541,6846663,2,40318,10081,1,296000312,296000312,15118,5039,10079,5039,0,1,5041,4401644,4.401644
5539,4443,1541,6846663,2,44318,11081,1,319936312,319936312,16618,5539,11079,5539,0,1,5541,1347102,1.347102
6039,4443,1541,6846663,2,48318,12081,1,343872312,343872312,18118,6039,12079,6039,0,1,6041,2946744,2.946744
6539,4443,1541,6846663,2,52318,13081,1,367808312,367808312,19618,6539,13079,6539,0,1,6541,4069801,4.069801
7039,4443,1541,6846663,2,56318,14081,1,391744312,391744312,21118,7039,14079,7039,0,1,7041,1250583,1.250583
40,2050,3340,6847000,2,326,83,1,56500800,56500800,121,40,81,40,0,1,42,5892,0.005892
440,2050,3340,6847000,2,3526,883,1,73748800,73748800,1321,440,881,440,0,1,442,74828,0.074828
840,2050,3340,6847000,2,6726,1683,1,90996800,90996800,2521,840,1681,840,0,1,842,7191,0.007191
1240,2050,3340,6847000,2,9926,2483,1,108244800,108244800,3721,1240,2481,1240,0,1,1242,35371,0.035371
1640,2050,3340,6847000,2,13126,3283,1,125492800,125492800,4921,1640,3281,1640,0,1,1642,439012,0.439012
2040,2050,3340,6847000,2,16326,4083,1,142740800,142740800,6121,2040,4081,2040,0,1,2042,57932,0.057932
2440,2050,3340,6847000,2,19526,4883,1,159988800,159988800,7321,2440,4881,2440,0,1,2442,253482,0.253482
2840,2050,3340,6847000,2,22726,5683,1,177236800,177236800,8521,2840,5681,2840,0,1,2842,31140,0.03114
3240,2050,3340,6847000,2,25926,6483,1,194484800,194484800,9721,3240,6481,3240,0,1,3242,45749,0.045749
3640,2050,3340,6847000,2,29126,7283,1,211732800,211732800,10921,3640,7281,3640,0,1,3642,568802,0.568802
4040,2050,3340,6847000,2,32326,8083,1,228980800,228980800,12121,4040,8081,4040,0,1,4042,941840,0.94184
4440,2050,3340,6847000,2,35526,8883,1,246228800,246228800,13321,4440,8881,4440,0,1,4442,1478533,1.478533
4840,2050,3340,6847000,2,38726,9683,1,263476800,263476800,14521,4840,9681,4840,0,1,4842,740914,0.740914
5240,2050,3340,6847000,2,41926,10483,1,280724800,280724800,15721,5240,10481,5240,0,1,5242,624388,0.624388
5640,2050,3340,6847000,2,45126,11283,1,297972800,297972800,16921,5640,11281,5640,0,1,5642,1072947,1.072947
6040,2050,3340,6847000,2,48326,12083,1,315220800,315220800,18121,6040,12081,6040,0,1,6042,806113,0.806113
6440,2050,3340,6847000,2,51526,12883,1,332468800,332468800,19321,6440,12881,6440,0,1,6442,31240,0.03124
6840,2050,3340,6847000,2,54726,13683,1,349716800,349716800,20521,6840,13681,6840,0,1,6842,5072579,5.072579
35,4440,1545,6859800,2,286,73,1,56554200,56554200,106,35,71,35,0,1,37,148965,0.148965
535,4440,1545,6859800,2,4286,1073,1,80494200,80494200,1606,535,1071,535,0,1,537,738082,0.738082
1035,4440,1545,6859800,2,8286,2073,1,104434200,104434200,3106,1035,2071,1035,0,1,1037,1371727,1.371727
1535,4440,1545,6859800,2,12286,3073,1,128374200,128374200,4606,1535,3071,1535,0,1,1537,2022870,2.02287
2035,4440,1545,6859800,2,16286,4073,1,152314200,152314200,6106,2035,4071,2035,0,1,2037,2682975,2.682975
40,5550,1240,6882000,2,326,83,1,57228800,57228800,121,40,81,40,0,1,42,124499,0.124499
440,5550,1240,6882000,2,3526,883,1,78956800,78956800,1321,440,881,440,0,1,442,638090,0.63809
840,5550,1240,6882000,2,6726,1683,1,100684800,100684800,2521,840,1681,840,0,1,842,1150514,1.150514
1240,5550,1240,6882000,2,9926,2483,1,122412800,122412800,3721,1240,2481,1240,0,1,1242,1676519,1.676519
1640,5550,1240,6882000,2,13126,3283,1,144140800,144140800,4921,1640,3281,1640,0,1,1642,2201309,2.201309
2040,5550,1240,6882000,2,16326,4083,1,165868800,165868800,6121,2040,4081,2040,0,1,2042,141175,0.141175
2440,5550,1240,6882000,2,19526,4883,1,187596800,187596800,7321,2440,4881,2440,0,1,2442,3259052,3.259052
2840,5550,1240,6882000,2,22726,5683,1,209324800,209324800,8521,2840,5681,2840,0,1,2842,3806046,3.806046
3240,5550,1240,6882000,2,25926,6483,1,231052800,231052800,9721,3240,6481,3240,0,1,3242,60901,0.060901
3640,5550,1240,6882000,2,29126,7283,1,252780800,252780800,10921,3640,7281,3640,0,1,3642,987143,0.987143
4040,5550,1240,6882000,2,32326,8083,1,274508800,274508800,12121,4040,8081,4040,0,1,4042,203170,0.20317
4440,5550,1240,6882000,2,35526,8883,1,296236800,296236800,13321,4440,8881,4440,0,1,4442,829333,0.829333
4840,5550,1240,6882000,2,38726,9683,1,317964800,317964800,14521,4840,9681,4840,0,1,4842,3640198,3.640198
5240,5550,1240,6882000,2,41926,10483,1,339692800,339692800,15721,5240,10481,5240,0,1,5242,111105,0.111105
5640,5550,1240,6882000,2,45126,11283,1,361420800,361420800,16921,5640,11281,5640,0,1,5642,1556179,1.556179
6040,5550,1240,6882000,2,48326,12083,1,383148800,383148800,18121,6040,12081,6040,0,1,6042,8017556,8.017556
6440,5550,1240,6882000,2,51526,12883,1,404876800,404876800,19321,6440,12881,6440,0,1,6442,4860153,4.860153
6840,5550,1240,6882000,2,54726,13683,1,426604800,426604800,20521,6840,13681,6840,0,1,6842,2749636,2.749636
44,2253,3055,6882915,2,358,91,1,56931736,56931736,133,44,89,44,0,1,46,27074,0.027074
544,2253,3055,6882915,2,4358,1091,1,78163736,78163736,1633,544,1089,544,0,1,546,55026,0.055026
1044,2253,3055,6882915,2,8358,2091,1,99395736,99395736,3133,1044,2089,1044,0,1,1046,35028,0.035028
1544,2253,3055,6882915,2,12358,3091,1,120627736,120627736,4633,1544,3089,1544,0,1,1546,103522,0.103522
2044,2253,3055,6882915,2,16358,4091,1,141859736,141859736,6133,2044,4089,2044,0,1,2046,138341,0.138341
2544,2253,3055,6882915,2,20358,5091,1,163091736,163091736,7633,2544,5089,2544,0,1,2546,17089,0.017089
3044,2253,3055,6882915,2,24358,6091,1,184323736,184323736,9133,3044,6089,3044,0,1,3046,540909,0.540909
3544,2253,3055,6882915,2,28358,7091,1,205555736,205555736,10633,3544,7089,3544,0,1,3546,75176,0.075176
4044,2253,3055,6882915,2,32358,8091,1,226787736,226787736,12133,4044,8089,4044,0,1,4046,174179,0.174179
4544,2253,3055,6882915,2,36358,9091,1,248019736,248019736,13633,4544,9089,4544,0,1,4546,1932935,1.932935
5044,2253,3055,6882915,2,40358,10091,1,269251736,269251736,15133,5044,10089,5044,0,1,5046,623388,0.623388
5544,2253,3055,6882915,2,44358,11091,1,290483736,290483736,16633,5544,11089,5544,0,1,5546,603055,0.603055
6044,2253,3055,6882915,2,48358,12091,1,311715736,311715736,18133,6044,12089,6044,0,1,6046,1284606,1.284606
6544,2253,3055,6882915,2,52358,13091,1,332947736,332947736,19633,6544,13089,6544,0,1,6546,520579,0.520579
7044,2253,3055,6882915,2,56358,14091,1,354179736,354179736,21133,7044,14089,7044,0,1,7046,4071426,4.071426
44,3353,2055,6890415,2,358,91,1,57026936,57026936,133,44,89,44,0,1,46,27299,0.027299
544,3353,2055,6890415,2,4358,1091,1,78658936,78658936,1633,544,1089,544,0,1,546,57588,0.057588
1044,3353,2055,6890415,2,8358,2091,1,100290936,100290936,3133,1044,2089,1044,0,1,1046,6898,0.006898
1544,3353,2055,6890415,2,12358,3091,1,121922936,121922936,4633,1544,3089,1544,0,1,1546,85993,0.085993
2044,3353,2055,6890415,2,16358,4091,1,143554936,143554936,6133,2044,4089,2044,0,1,2046,293309,0.293309
2544,3353,2055,6890415,2,20358,5091,1,165186936,165186936,7633,2544,5089,2544,0,1,2546,305100,0.3051
3044,3353,2055,6890415,2,24358,6091,1,186818936,186818936,9133,3044,6089,3044,0,1,3046,608404,0.608404
3544,3353,2055,6890415,2,28358,7091,1,208450936,208450936,10633,3544,7089,3544,0,1,3546,2932902,2.932902
4044,3353,2055,6890415,2,32358,8091,1,230082936,230082936,12133,4044,8089,4044,0,1,4046,4826898,4.826898
4544,3353,2055,6890415,2,36358,9091,1,251714936,251714936,13633,4544,9089,4544,0,1,4546,708413,0.708413
5044,3353,2055,6890415,2,40358,10091,1,273346936,273346936,15133,5044,10089,5044,0,1,5046,3238788,3.238788
5544,3353,2055,6890415,2,44358,11091,1,294978936,294978936,16633,5544,11089,5544,0,1,5546,1492151,1.492151
6044,3353,2055,6890415,2,48358,12091,1,316610936,316610936,18133,6044,12089,6044,0,1,6046,9389,0.009389
6544,3353,2055,6890415,2,52358,13091,1,338242936,338242936,19633,6544,13089,6544,0,1,6546,7142743,7.142743
7044,3353,2055,6890415,2,56358,14091,1,359874936,359874936,21133,7044,14089,7044,0,1,7046,1666676,1.666676
35,1140,6045,6891300,2,286,73,1,57142200,57142200,106,35,71,35,0,1,37,130362,0.130362
535,1140,6045,6891300,2,4286,1073,1,85882200,85882200,1606,535,1071,535,0,1,537,748320,0.74832
1035,1140,6045,6891300,2,8286,2073,1,114622200,114622200,3106,1035,2071,1035,0,1,1037,1374830,1.37483
1535,1140,6045,6891300,2,12286,3073,1,143362200,143362200,4606,1535,3071,1535,0,1,1537,2043635,2.043635
2035,1140,6045,6891300,2,16286,4073,1,172102200,172102200,6106,2035,4071,2035,0,1,2037,2685933,2.685933
2535,1140,6045,6891300,2,20286,5073,1,200842200,200842200,7606,2535,5071,2535,0,1,2537,3331205,3.331205
3035,1140,6045,6891300,2,24286,6073,1,229582200,229582200,9106,3035,6071,3035,0,1,3037,3980246,3.980246
3535,1140,6045,6891300,2,28286,7073,1,258322200,258322200,10606,3535,7071,3535,0,1,3537,4631847,4.631847
4035,1140,6045,6891300,2,32286,8073,1,287062200,287062200,12106,4035,8071,4035,0,1,4037,5297140,5.29714
35,6600,1045,6897000,2,286,73,1,57316600,57316600,106,35,71,35,0,1,37,27439,0.027439
535,6600,1045,6897000,2,4286,1073,1,87896600,87896600,1606,535,1071,535,0,1,537,388442,0.388442
1035,6600,1045,6897000,2,8286,2073,1,118476600,118476600,3106,1035,2071,1035,0,1,1037,22164,0.022164
1535,6600,1045,6897000,2,12286,3073,1,149056600,149056600,4606,1535,3071,1535,0,1,1537,863265,0.863265
2035,6600,1045,6897000,2,16286,4073,1,179636600,179636600,6106,2035,4071,2035,0,1,2037,1514965,1.514965
2535,6600,1045,6897000,2,20286,5073,1,210216600,210216600,7606,2535,5071,2535,0,1,2537,1477240,1.47724
3035,6600,1045,6897000,2,24286,6073,1,240796600,240796600,9106,3035,6071,3035,0,1,3037,4000939,4.000939
3535,6600,1045,6897000,2,28286,7073,1,271376600,271376600,10606,3535,7071,3535,0,1,3537,4656811,4.656811
4035,6600,1045,6897000,2,32286,8073,1,301956600,301956600,12106,4035,8071,4035,0,1,4037,1499419,1.499419
4535,6600,1045,6897000,2,36286,9073,1,332536600,332536600,13606,4535,9071,4535,0,1,4537,1462921,1.462921
5035,6600,1045,6897000,2,40286,10073,1,363116600,363116600,15106,5035,10071,5035,0,1,5037,4447927,4.447927
5535,6600,1045,6897000,2,44286,11073,1,393696600,393696600,16606,5535,11071,5535,0,1,5537,4029778,4.029778
6035,6600,1045,6897000,2,48286,12073,1,424276600,424276600,18106,6035,12071,6035,0,1,6037,6180907,6.180907
6535,6600,1045,6897000,2,52286,13073,1,454856600,454856600,19606,6535,13071,6535,0,1,6537,8612572,8.612572
7035,6600,1045,6897000,2,56286,14073,1,485436600,485436600,21106,7035,14071,7035,0,1,7037,9216805,9.216805
39,1143,6041,6904863,2,318,81,1,57480312,57480312,118,39,79,39,0,1,41,16910,0.01691
539,1143,6041,6904863,2,4318,1081,1,86216312,86216312,1618,539,1079,539,0,1,541,10262,0.010262
1039,1143,6041,6904863,2,8318,2081,1,114952312,114952312,3118,1039,2079,1039,0,1,1041,326470,0.32647
1539,1143,6041,6904863,2,12318,3081,1,143688312,143688312,4618,1539,3079,1539,0,1,1541,163181,0.163181
2039,1143,6041,6904863,2,16318,4081,1,172424312,172424312,6118,2039,4079,2039,0,1,2041,27398,0.027398
2539,1143,6041,6904863,2,20318,5081,1,201160312,201160312,7618,2539,5079,2539,0,1,2541,389013,0.389013
3039,1143,6041,6904863,2,24318,6081,1,229896312,229896312,9118,3039,6079,3039,0,1,3041,478765,0.478765
3539,1143,6041,6904863,2,28318,7081,1,258632312,258632312,10618,3539,7079,3539,0,1,3541,1141580,1.14158
4039,1143,6041,6904863,2,32318,8081,1,287368312,287368312,12118,4039,8079,4039,0,1,4041,620251,0.620251
4539,1143,6041,6904863,2,36318,9081,1,316104312,316104312,13618,4539,9079,4539,0,1,4541,268894,0.268894
5039,1143,6041,6904863,2,40318,10081,1,344840312,344840312,15118,5039,10079,5039,0,1,5041,837275,0.837275
5539,1143,6041,6904863,2,44318,11081,1,373576312,373576312,16618,5539,11079,5539,0,1,5541,226693,0.226693
6039,1143,6041,6904863,2,48318,12081,1,402312312,402312312,18118,6039,12079,6039,0,1,6041,750070,0.75007
6539,1143,6041,6904863,2,52318,13081,1,431048312,431048312,19618,6539,13079,6539,0,1,6541,233587,0.233587
7039,1143,6041,6904863,2,56318,14081,1,459784312,459784312,21118,7039,14079,7039,0,1,7041,8979598,8.979598
44,1703,4055,6905665,2,358,91,1,57272136,57272136,133,44,89,44,0,1,46,128544,0.128544
544,1703,4055,6905665,2,4358,1091,1,80304136,80304136,1633,544,1089,544,0,1,546,702828,0.702828
1044,1703,4055,6905665,2,8358,2091,1,103336136,103336136,3133,1044,2089,1044,0,1,1046,616308,0.616308
1544,1703,4055,6905665,2,12358,3091,1,126368136,126368136,4633,1544,3089,1544,0,1,1546,1465568,1.465568
2044,1703,4055,6905665,2,16358,4091,1,149400136,149400136,6133,2044,4089,2044,0,1,2046,329765,0.329765
2544,1703,4055,6905665,2,20358,5091,1,172432136,172432136,7633,2544,5089,2544,0,1,2546,1825152,1.825152
3044,1703,4055,6905665,2,24358,6091,1,195464136,195464136,9133,3044,6089,3044,0,1,3046,2460118,2.460118
3544,1703,4055,6905665,2,28358,7091,1,218496136,218496136,10633,3544,7089,3544,0,1,3546,4773003,4.773003
4044,1703,4055,6905665,2,32358,8091,1,241528136,241528136,12133,4044,8089,4044,0,1,4046,5457241,5.457241
4544,1703,4055,6905665,2,36358,9091,1,264560136,264560136,13633,4544,9089,4544,0,1,4546,654118,0.654118
5044,1703,4055,6905665,2,40358,10091,1,287592136,287592136,15133,5044,10089,5044,0,1,5046,1153637,1.153637
5544,1703,4055,6905665,2,44358,11091,1,310624136,310624136,16633,5544,11089,5544,0,1,5546,815125,0.815125
6044,1703,4055,6905665,2,48358,12091,1,333656136,333656136,18133,6044,12089,6044,0,1,6046,2376317,2.376317
6544,1703,4055,6905665,2,52358,13091,1,356688136,356688136,19633,6544,13089,6544,0,1,6546,1825912,1.825912
7044,1703,4055,6905665,2,56358,14091,1,379720136,379720136,21133,7044,14089,7044,0,1,7046,869714,0.869714
55,2805,2465,6914325,2,446,113,1,57633400,57633400,166,55,111,55,0,1,57,139592,0.139592
455,2805,2465,6914325,2,3646,913,1,74497400,74497400,1366,455,911,455,0,1,457,639914,0.639914
855,2805,2465,6914325,2,6846,1713,1,91361400,91361400,2566,855,1711,855,0,1,857,270181,0.270181
1255,2805,2465,6914325,2,10046,2513,1,108225400,108225400,3766,1255,2511,1255,0,1,1257,1524114,1.524114
1655,2805,2465,6914325,2,13246,3313,1,125089400,125089400,4966,1655,3311,1655,0,1,1657,1299444,1.299444
2055,2805,2465,6914325,2,16446,4113,1,141953400,141953400,6166,2055,4111,2055,0,1,2057,274776,0.274776
2455,2805,2465,6914325,2,19646,4913,1,158817400,158817400,7366,2455,4911,2455,0,1,2457,893505,0.893505
2855,2805,2465,6914325,2,22846,5713,1,175681400,175681400,8566,2855,5711,2855,0,1,2857,2625982,2.625982
3255,2805,2465,6914325,2,26046,6513,1,192545400,192545400,9766,3255,6511,3255,0,1,3257,4233858,4.233858
3655,2805,2465,6914325,2,29246,7313,1,209409400,209409400,10966,3655,7311,3655,0,1,3657,4308225,4.308225
4055,2805,2465,6914325,2,32446,8113,1,226273400,226273400,12166,4055,8111,4055,0,1,4057,4840618,4.840618
4455,2805,2465,6914325,2,35646,8913,1,243137400,243137400,13366,4455,8911,4455,0,1,4457,467931,0.467931
4855,2805,2465,6914325,2,38846,9713,1,260001400,260001400,14566,4855,9711,4855,0,1,4857,1183236,1.183236
5255,2805,2465,6914325,2,42046,10513,1,276865400,276865400,15766,5255,10511,5255,0,1,5257,1373098,1.373098
5655,2805,2465,6914325,2,45246,11313,1,293729400,293729400,16966,5655,11311,5655,0,1,5657,3627100,3.6271
6055,2805,2465,6914325,2,48446,12113,1,310593400,310593400,18166,6055,12111,6055,0,1,6057,1579731,1.579731
6455,2805,2465,6914325,2,51646,12913,1,327457400,327457400,19366,6455,12911,6455,0,1,6457,4099258,4.099258
6855,2805,2465,6914325,2,54846,13713,1,344321400,344321400,20566,6855,13711,6855,0,1,6857,513716,0.513716
55,2055,3365,6915075,2,446,113,1,57705400,57705400,166,55,111,55,0,1,57,7328,0.007328
455,2055,3365,6915075,2,3646,913,1,75049400,75049400,1366,455,911,455,0,1,457,27930,0.02793
855,2055,3365,6915075,2,6846,1713,1,92393400,92393400,2566,855,1711,855,0,1,857,5274,0.005274
1255,2055,3365,6915075,2,10046,2513,1,109737400,109737400,3766,1255,2511,1255,0,1,1257,16638,0.016638
1655,2055,3365,6915075,2,13246,3313,1,127081400,127081400,4966,1655,3311,1655,0,1,1657,60868,0.060868
2055,2055,3365,6915075,2,16446,4113,1,144425400,144425400,6166,2055,4111,2055,0,1,2057,56084,0.056084
2455,2055,3365,6915075,2,19646,4913,1,161769400,161769400,7366,2455,4911,2455,0,1,2457,138096,0.138096
2855,2055,3365,6915075,2,22846,5713,1,179113400,179113400,8566,2855,5711,2855,0,1,2857,669151,0.669151
3255,2055,3365,6915075,2,26046,6513,1,196457400,196457400,9766,3255,6511,3255,0,1,3257,95450,0.09545
3655,2055,3365,6915075,2,29246,7313,1,213801400,213801400,10966,3655,7311,3655,0,1,3657,480474,0.480474
4055,2055,3365,6915075,2,32446,8113,1,231145400,231145400,12166,4055,8111,4055,0,1,4057,115259,0.115259
4455,2055,3365,6915075,2,35646,8913,1,248489400,248489400,13366,4455,8911,4455,0,1,4457,160373,0.160373
4855,2055,3365,6915075,2,38846,9713,1,265833400,265833400,14566,4855,9711,4855,0,1,4857,109596,0.109596
5255,2055,3365,6915075,2,42046,10513,1,283177400,283177400,15766,5255,10511,5255,0,1,5257,995866,0.995866
5655,2055,3365,6915075,2,45246,11313,1,300521400,300521400,16966,5655,11311,5655,0,1,5657,133047,0.133047
6055,2055,3365,6915075,2,48446,12113,1,317865400,317865400,18166,6055,12111,6055,0,1,6057,350644,0.350644
6455,2055,3365,6915075,2,51646,12913,1,335209400,335209400,19366,6455,12911,6455,0,1,6457,270566,0.270566
6855,2055,3365,6915075,2,54846,13713,1,352553400,352553400,20566,6855,13711,6855,0,1,6857,573822,0.573822
39,6643,1041,6915363,2,318,81,1,57720312,57720312,118,39,79,39,0,1,41,8070,0.00807
539,6643,1041,6915363,2,4318,1081,1,88456312,88456312,1618,539,1079,539,0,1,541,79341,0.079341
1039,6643,1041,6915363,2,8318,2081,1,119192312,119192312,3118,1039,2079,1039,0,1,1041,523519,0.523519
1539,6643,1041,6915363,2,12318,3081,1,149928312,149928312,4618,1539,3079,1539,0,1,1541,750856,0.750856
2039,6643,1041,6915363,2,16318,4081,1,180664312,180664312,6118,2039,4079,2039,0,1,2041,603579,0.603579
2539,6643,1041,6915363,2,20318,5081,1,211400312,211400312,7618,2539,5079,2539,0,1,2541,3104115,3.104115
3039,6643,1041,6915363,2,24318,6081,1,242136312,242136312,9118,3039,6079,3039,0,1,3041,7954,0.007954
3539,6643,1041,6915363,2,28318,7081,1,272872312,272872312,10618,3539,7079,3539,0,1,3541,1056768,1.056768
4039,6643,1041,6915363,2,32318,8081,1,303608312,303608312,12118,4039,8079,4039,0,1,4041,3242422,3.242422
4539,6643,1041,6915363,2,36318,9081,1,334344312,334344312,13618,4539,9079,4539,0,1,4541,4926755,4.926755
5039,6643,1041,6915363,2,40318,10081,1,365080312,365080312,15118,5039,10079,5039,0,1,5041,1206434,1.206434
5539,6643,1041,6915363,2,44318,11081,1,395816312,395816312,16618,5539,11079,5539,0,1,5541,3745189,3.745189
6039,6643,1041,6915363,2,48318,12081,1,426552312,426552312,18118,6039,12079,6039,0,1,6041,2099869,2.099869
6539,6643,1041,6915363,2,52318,13081,1,457288312,457288312,19618,6539,13079,6539,0,1,6541,366495,0.366495
7039,6643,1041,6915363,2,56318,14081,1,488024312,488024312,21118,7039,14079,7039,0,1,7041,765066,0.765066
44,4453,1555,6924415,2,358,91,1,57510136,57510136,133,44,89,44,0,1,46,11652,0.011652
544,4453,1555,6924415,2,4358,1091,1,81542136,81542136,1633,544,1089,544,0,1,546,36741,0.036741
1044,4453,1555,6924415,2,8358,2091,1,105574136,105574136,3133,1044,2089,1044,0,1,1046,37742,0.037742
1544,4453,1555,6924415,2,12358,3091,1,129606136,129606136,4633,1544,3089,1544,0,1,1546,748542,0.748542
2044,4453,1555,6924415,2,16358,4091,1,153638136,153638136,6133,2044,4089,2044,0,1,2046,251483,0.251483
2544,4453,1555,6924415,2,20358,5091,1,177670136,177670136,7633,2544,5089,2544,0,1,2546,3346173,3.346173
3044,4453,1555,6924415,2,24358,6091,1,201702136,201702136,9133,3044,6089,3044,0,1,3046,174047,0.174047
3544,4453,1555,6924415,2,28358,7091,1,225734136,225734136,10633,3544,7089,3544,0,1,3546,211802,0.211802
4044,4453,1555,6924415,2,32358,8091,1,249766136,249766136,12133,4044,8089,4044,0,1,4046,221637,0.221637
4544,4453,1555,6924415,2,36358,9091,1,273798136,273798136,13633,4544,9089,4544,0,1,4546,1962454,1.962454
5044,4453,1555,6924415,2,40358,10091,1,297830136,297830136,15133,5044,10089,5044,0,1,5046,583816,0.583816
5544,4453,1555,6924415,2,44358,11091,1,321862136,321862136,16633,5544,11089,5544,0,1,5546,3992853,3.992853
6044,4453,1555,6924415,2,48358,12091,1,345894136,345894136,18133,6044,12089,6044,0,1,6046,3871617,3.871617
6544,4453,1555,6924415,2,52358,13091,1,369926136,369926136,19633,6544,13089,6544,0,1,6546,2022159,2.022159
7044,4453,1555,6924415,2,56358,14091,1,393958136,393958136,21133,7044,14089,7044,0,1,7046,240710,0.24071
40,1050,6640,6972000,2,326,83,1,58236800,58236800,121,40,81,40,0,1,42,4859,0.004859
440,1050,6640,6972000,2,3526,883,1,82844800,82844800,1321,440,881,440,0,1,442,6803,0.006803
840,1050,6640,6972000,2,6726,1683,1,107452800,107452800,2521,840,1681,840,0,1,842,263023,0.263023
1240,1050,6640,6972000,2,9926,2483,1,132060800,132060800,3721,1240,2481,1240,0,1,1242,143652,0.143652
1640,1050,6640,6972000,2,13126,3283,1,156668800,156668800,4921,1640,3281,1640,0,1,1642,28995,0.028995
2040,1050,6640,6972000,2,16326,4083,1,181276800,181276800,6121,2040,4081,2040,0,1,2042,67628,0.067628
2440,1050,6640,6972000,2,19526,4883,1,205884800,205884800,7321,2440,4881,2440,0,1,2442,718860,0.71886
2840,1050,6640,6972000,2,22726,5683,1,230492800,230492800,8521,2840,5681,2840,0,1,2842,298420,0.29842
3240,1050,6640,6972000,2,25926,6483,1,255100800,255100800,9721,3240,6481,3240,0,1,3242,408188,0.408188
3640,1050,6640,6972000,2,29126,7283,1,279708800,279708800,10921,3640,7281,3640,0,1,3642,191598,0.191598
4040,1050,6640,6972000,2,32326,8083,1,304316800,304316800,12121,4040,8081,4040,0,1,4042,150790,0.15079
4440,1050,6640,6972000,2,35526,8883,1,328924800,328924800,13321,4440,8881,4440,0,1,4442,443854,0.443854
4840,1050,6640,6972000,2,38726,9683,1,353532800,353532800,14521,4840,9681,4840,0,1,4842,205429,0.205429
5240,1050,6640,6972000,2,41926,10483,1,378140800,378140800,15721,5240,10481,5240,0,1,5242,231140,0.23114
5640,1050,6640,6972000,2,45126,11283,1,402748800,402748800,16921,5640,11281,5640,0,1,5642,480624,0.480624
6040,1050,6640,6972000,2,48326,12083,1,427356800,427356800,18121,6040,12081,6040,0,1,6042,162352,0.162352
6440,1050,6640,6972000,2,51526,12883,1,451964800,451964800,19321,6440,12881,6440,0,1,6442,838428,0.838428
6840,1050,6640,6972000,2,54726,13683,1,476572800,476572800,20521,6840,13681,6840,0,1,6842,418882,0.418882
44,1153,6055,6981415,2,358,91,1,58388536,58388536,133,44,89,44,0,1,46,5135,0.005135
544,1153,6055,6981415,2,4358,1091,1,87220536,87220536,1633,544,1089,544,0,1,546,77210,0.07721
1044,1153,6055,6981415,2,8358,2091,1,116052536,116052536,3133,1044,2089,1044,0,1,1046,81876,0.081876
1544,1153,6055,6981415,2,12358,3091,1,144884536,144884536,4633,1544,3089,1544,0,1,1546,171334,0.171334
2044,1153,6055,6981415,2,16358,4091,1,173716536,173716536,6133,2044,4089,2044,0,1,2046,43884,0.043884
2544,1153,6055,6981415,2,20358,5091,1,202548536,202548536,7633,2544,5089,2544,0,1,2546,120936,0.120936
3044,1153,6055,6981415,2,24358,6091,1,231380536,231380536,9133,3044,6089,3044,0,1,3046,436767,0.436767
3544,1153,6055,6981415,2,28358,7091,1,260212536,260212536,10633,3544,7089,3544,0,1,3546,1026814,1.026814
4044,1153,6055,6981415,2,32358,8091,1,289044536,289044536,12133,4044,8089,4044,0,1,4046,346156,0.346156
4544,1153,6055,6981415,2,36358,9091,1,317876536,317876536,13633,4544,9089,4544,0,1,4546,559796,0.559796
5044,1153,6055,6981415,2,40358,10091,1,346708536,346708536,15133,5044,10089,5044,0,1,5046,2063572,2.063572
5544,1153,6055,6981415,2,44358,11091,1,375540536,375540536,16633,5544,11089,5544,0,1,5546,717176,0.717176
6044,1153,6055,6981415,2,48358,12091,1,404372536,404372536,18133,6044,12089,6044,0,1,6046,313710,0.31371
6544,1153,6055,6981415,2,52358,13091,1,433204536,433204536,19633,6544,13089,6544,0,1,6546,3313286,3.313286
7044,1153,6055,6981415,2,56358,14091,1,462036536,462036536,21133,7044,14089,7044,0,1,7046,494666,0.494666
40,2550,2740,6987000,2,326,83,1,57588800,57588800,121,40,81,40,0,1,42,129020,0.12902
440,2550,2740,6987000,2,3526,883,1,74516800,74516800,1321,440,881,440,0,1,442,629247,0.629247
840,2550,2740,6987000,2,6726,1683,1,91444800,91444800,2521,840,1681,840,0,1,842,1085282,1.085282
1240,2550,2740,6987000,2,9926,2483,1,108372800,108372800,3721,1240,2481,1240,0,1,1242,887685,0.887685
1640,2550,2740,6987000,2,13126,3283,1,125300800,125300800,4921,1640,3281,1640,0,1,1642,1719342,1.719342
2040,2550,2740,6987000,2,16326,4083,1,142228800,142228800,6121,2040,4081,2040,0,1,2042,2589137,2.589137
2440,2550,2740,6987000,2,19526,4883,1,159156800,159156800,7321,2440,4881,2440,0,1,2442,20599,0.020599
2840,2550,2740,6987000,2,22726,5683,1,176084800,176084800,8521,2840,5681,2840,0,1,2842,2634894,2.634894
3240,2550,2740,6987000,2,25926,6483,1,193012800,193012800,9721,3240,6481,3240,0,1,3242,383129,0.383129
3640,2550,2740,6987000,2,29126,7283,1,209940800,209940800,10921,3640,7281,3640,0,1,3642,1694881,1.694881
4040,2550,2740,6987000,2,32326,8083,1,226868800,226868800,12121,4040,8081,4040,0,1,4042,142822,0.142822
4440,2550,2740,6987000,2,35526,8883,1,243796800,243796800,13321,4440,8881,4440,0,1,4442,93288,0.093288
4840,2550,2740,6987000,2,38726,9683,1,260724800,260724800,14521,4840,9681,4840,0,1,4842,675430,0.67543
5240,2550,2740,6987000,2,41926,10483,1,277652800,277652800,15721,5240,10481,5240,0,1,5242,1534105,1.534105
5640,2550,2740,6987000,2,45126,11283,1,294580800,294580800,16921,5640,11281,5640,0,1,5642,3252924,3.252924
6040,2550,2740,6987000,2,48326,12083,1,311508800,311508800,18121,6040,12081,6040,0,1,6042,1310574,1.310574
6440,2550,2740,6987000,2,51526,12883,1,328436800,328436800,19321,6440,12881,6440,0,1,6442,5200234,5.200234
6840,2550,2740,6987000,2,54726,13683,1,345364800,345364800,20521,6840,13681,6840,0,1,6842,2691676,2.691676
40,2300,3040,6992000,2,326,83,1,57644800,57644800,121,40,81,40,0,1,42,128165,0.128165
440,2300,3040,6992000,2,3526,883,1,74732800,74732800,1321,440,881,440,0,1,442,102593,0.102593
840,2300,3040,6992000,2,6726,1683,1,91820800,91820800,2521,840,1681,840,0,1,842,715709,0.715709
1240,2300,3040,6992000,2,9926,2483,1,108908800,108908800,3721,1240,2481,1240,0,1,1242,1627489,1.627489
1640,2300,3040,6992000,2,13126,3283,1,125996800,125996800,4921,1640,3281,1640,0,1,1642,1550816,1.550816
2040,2300,3040,6992000,2,16326,4083,1,143084800,143084800,6121,2040,4081,2040,0,1,2042,387830,0.38783
2440,2300,3040,6992000,2,19526,4883,1,160172800,160172800,7321,2440,4881,2440,0,1,2442,504428,0.504428
2840,2300,3040,6992000,2,22726,5683,1,177260800,177260800,8521,2840,5681,2840,0,1,2842,573812,0.573812
3240,2300,3040,6992000,2,25926,6483,1,194348800,194348800,9721,3240,6481,3240,0,1,3242,1582369,1.582369
3640,2300,3040,6992000,2,29126,7283,1,211436800,211436800,10921,3640,7281,3640,0,1,3642,428706,0.428706
4040,2300,3040,6992000,2,32326,8083,1,228524800,228524800,12121,4040,8081,4040,0,1,4042,877976,0.877976
4440,2300,3040,6992000,2,35526,8883,1,245612800,245612800,13321,4440,8881,4440,0,1,4442,799943,0.799943
4840,2300,3040,6992000,2,38726,9683,1,262700800,262700800,14521,4840,9681,4840,0,1,4842,4851630,4.85163
5240,2300,3040,6992000,2,41926,10483,1,279788800,279788800,15721,5240,10481,5240,0,1,5242,2558580,2.55858
5640,2300,3040,6992000,2,45126,11283,1,296876800,296876800,16921,5640,11281,5640,0,1,5642,2578462,2.578462
6040,2300,3040,6992000,2,48326,12083,1,313964800,313964800,18121,6040,12081,6040,0,1,6042,3357914,3.357914
6440,2300,3040,6992000,2,51526,12883,1,331052800,331052800,19321,6440,12881,6440,0,1,6442,1161020,1.16102
6840,2300,3040,6992000,2,54726,13683,1,348140800,348140800,20521,6840,13681,6840,0,1,6842,1009556,1.009556
40,3800,1840,6992000,2,326,83,1,57740800,57740800,121,40,81,40,0,1,42,122310,0.12231
440,3800,1840,6992000,2,3526,883,1,75788800,75788800,1321,440,881,440,0,1,442,55878,0.055878
840,3800,1840,6992000,2,6726,1683,1,93836800,93836800,2521,840,1681,840,0,1,842,334944,0.334944
1240,3800,1840,6992000,2,9926,2483,1,111884800,111884800,3721,1240,2481,1240,0,1,1242,1674381,1.674381
1640,3800,1840,6992000,2,13126,3283,1,129932800,129932800,4921,1640,3281,1640,0,1,1642,1240169,1.240169
2040,3800,1840,6992000,2,16326,4083,1,147980800,147980800,6121,2040,4081,2040,0,1,2042,2713550,2.71355
2440,3800,1840,6992000,2,19526,4883,1,166028800,166028800,7321,2440,4881,2440,0,1,2442,3255351,3.255351
2840,3800,1840,6992000,2,22726,5683,1,184076800,184076800,8521,2840,5681,2840,0,1,2842,1373433,1.373433
3240,3800,1840,6992000,2,25926,6483,1,202124800,202124800,9721,3240,6481,3240,0,1,3242,535647,0.535647
3640,3800,1840,6992000,2,29126,7283,1,220172800,220172800,10921,3640,7281,3640,0,1,3642,3221788,3.221788
4040,3800,1840,6992000,2,32326,8083,1,238220800,238220800,12121,4040,8081,4040,0,1,4042,5324332,5.324332
4440,3800,1840,6992000,2,35526,8883,1,256268800,256268800,13321,4440,8881,4440,0,1,4442,4820073,4.820073
4840,3800,1840,6992000,2,38726,9683,1,274316800,274316800,14521,4840,9681,4840,0,1,4842,2557593,2.557593
5240,3800,1840,6992000,2,41926,10483,1,292364800,292364800,15721,5240,10481,5240,0,1,5242,4867568,4.867568
5640,3800,1840,6992000,2,45126,11283,1,310412800,310412800,16921,5640,11281,5640,0,1,5642,544900,0.5449
6040,3800,1840,6992000,2,48326,12083,1,328460800,328460800,18121,6040,12081,6040,0,1,6042,452575,0.452575
6440,3800,1840,6992000,2,51526,12883,1,346508800,346508800,19321,6440,12881,6440,0,1,6442,1650437,1.650437
6840,3800,1840,6992000,2,54726,13683,1,364556800,364556800,20521,6840,13681,6840,0,1,6842,543947,0.543947
40,4550,1540,7007000,2,326,83,1,58004800,58004800,121,40,81,40,0,1,42,125879,0.125879
440,4550,1540,7007000,2,3526,883,1,77492800,77492800,1321,440,881,440,0,1,442,627895,0.627895
840,4550,1540,7007000,2,6726,1683,1,96980800,96980800,2521,840,1681,840,0,1,842,1147115,1.147115
1240,4550,1540,7007000,2,9926,2483,1,116468800,116468800,3721,1240,2481,1240,0,1,1242,831603,0.831603
1640,4550,1540,7007000,2,13126,3283,1,135956800,135956800,4921,1640,3281,1640,0,1,1642,1051440,1.05144
2040,4550,1540,7007000,2,16326,4083,1,155444800,155444800,6121,2040,4081,2040,0,1,2042,2697222,2.697222
2440,4550,1540,7007000,2,19526,4883,1,174932800,174932800,7321,2440,4881,2440,0,1,2442,3211539,3.211539
2840,4550,1540,7007000,2,22726,5683,1,194420800,194420800,8521,2840,5681,2840,0,1,2842,780875,0.780875
3240,4550,1540,7007000,2,25926,6483,1,213908800,213908800,9721,3240,6481,3240,0,1,3242,398861,0.398861
3640,4550,1540,7007000,2,29126,7283,1,233396800,233396800,10921,3640,7281,3640,0,1,3642,722098,0.722098
4040,4550,1540,7007000,2,32326,8083,1,252884800,252884800,12121,4040,8081,4040,0,1,4042,3921855,3.921855
4440,4550,1540,7007000,2,35526,8883,1,272372800,272372800,13321,4440,8881,4440,0,1,4442,1360510,1.36051
4840,4550,1540,7007000,2,38726,9683,1,291860800,291860800,14521,4840,9681,4840,0,1,4842,4047729,4.047729
5240,4550,1540,7007000,2,41926,10483,1,311348800,311348800,15721,5240,10481,5240,0,1,5242,1755268,1.755268
5640,4550,1540,7007000,2,45126,11283,1,330836800,330836800,16921,5640,11281,5640,0,1,5642,2383260,2.38326
6040,4550,1540,7007000,2,48326,12083,1,350324800,350324800,18121,6040,12081,6040,0,1,6042,4851018,4.851018
6440,4550,1540,7007000,2,51526,12883,1,369812800,369812800,19321,6440,12881,6440,0,1,6442,601372,0.601372
6840,4550,1540,7007000,2,54726,13683,1,389300800,389300800,20521,6840,13681,6840,0,1,6842,1015202,1.015202
44,6653,1055,7018915,2,358,91,1,58864536,58864536,133,44,89,44,0,1,46,415,0.000415
544,6653,1055,7018915,2,4358,1091,1,89696536,89696536,1633,544,1089,544,0,1,546,234826,0.234826
1044,6653,1055,7018915,2,8358,2091,1,120528536,120528536,3133,1044,2089,1044,0,1,1046,136840,0.13684
1544,6653,1055,7018915,2,12358,3091,1,151360536,151360536,4633,1544,3089,1544,0,1,1546,417979,0.417979
2044,6653,1055,7018915,2,16358,4091,1,182192536,182192536,6133,2044,4089,2044,0,1,2046,1037691,1.037691
2544,6653,1055,7018915,2,20358,5091,1,213024536,213024536,7633,2544,5089,2544,0,1,2546,845571,0.845571
3044,6653,1055,7018915,2,24358,6091,1,243856536,243856536,9133,3044,6089,3044,0,1,3046,1691887,1.691887
3544,6653,1055,7018915,2,28358,7091,1,274688536,274688536,10633,3544,7089,3544,0,1,3546,1814803,1.814803
4044,6653,1055,7018915,2,32358,8091,1,305520536,305520536,12133,4044,8089,4044,0,1,4046,3653497,3.653497
4544,6653,1055,7018915,2,36358,9091,1,336352536,336352536,13633,4544,9089,4544,0,1,4546,2492911,2.492911
5044,6653,1055,7018915,2,40358,10091,1,367184536,367184536,15133,5044,10089,5044,0,1,5046,1875056,1.875056
5544,6653,1055,7018915,2,44358,11091,1,398016536,398016536,16633,5544,11089,5544,0,1,5546,2090023,2.090023
6044,6653,1055,7018915,2,48358,12091,1,428848536,428848536,18133,6044,12089,6044,0,1,6046,1528252,1.528252
6544,6653,1055,7018915,2,52358,13091,1,459680536,459680536,19633,6544,13089,6544,0,1,6546,8272747,8.272747
7044,6653,1055,7018915,2,56358,14091,1,490512536,490512536,21133,7044,14089,7044,0,1,7046,9711347,9.711347
55,5555,1265,7027075,2,446,113,1,59217400,59217400,166,55,111,55,0,1,57,139178,0.139178
455,5555,1265,7027075,2,3646,913,1,81041400,81041400,1366,455,911,455,0,1,457,591946,0.591946
855,5555,1265,7027075,2,6846,1713,1,102865400,102865400,2566,855,1711,855,0,1,857,1210852,1.210852
1255,5555,1265,7027075,2,10046,2513,1,124689400,124689400,3766,1255,2511,1255,0,1,1257,1049765,1.049765
1655,5555,1265,7027075,2,13246,3313,1,146513400,146513400,4966,1655,3311,1655,0,1,1657,540636,0.540636
2055,5555,1265,7027075,2,16446,4113,1,168337400,168337400,6166,2055,4111,2055,0,1,2057,2826678,2.826678
2455,5555,1265,7027075,2,19646,4913,1,190161400,190161400,7366,2455,4911,2455,0,1,2457,1487182,1.487182
2855,5555,1265,7027075,2,22846,5713,1,211985400,211985400,8566,2855,5711,2855,0,1,2857,642312,0.642312
3255,5555,1265,7027075,2,26046,6513,1,233809400,233809400,9766,3255,6511,3255,0,1,3257,4439501,4.439501
3655,5555,1265,7027075,2,29246,7313,1,255633400,255633400,10966,3655,7311,3655,0,1,3657,3326065,3.326065
4055,5555,1265,7027075,2,32446,8113,1,277457400,277457400,12166,4055,8111,4055,0,1,4057,458033,0.458033
4455,5555,1265,7027075,2,35646,8913,1,299281400,299281400,13366,4455,8911,4455,0,1,4457,3917455,3.917455
4855,5555,1265,7027075,2,38846,9713,1,321105400,321105400,14566,4855,9711,4855,0,1,4857,1180154,1.180154
5255,5555,1265,7027075,2,42046,10513,1,342929400,342929400,15766,5255,10511,5255,0,1,5257,1452930,1.45293
5655,5555,1265,7027075,2,45246,11313,1,364753400,364753400,16966,5655,11311,5655,0,1,5657,1684401,1.684401
6055,5555,1265,7027075,2,48446,12113,1,386577400,386577400,18166,6055,12111,6055,0,1,6057,8264986,8.264986
6455,5555,1265,7027075,2,51646,12913,1,408401400,408401400,19366,6455,12911,6455,0,1,6457,5958829,5.958829
6855,5555,1265,7027075,2,54846,13713,1,430225400,430225400,20566,6855,13711,6855,0,1,6857,9352701,9.352701
55,1055,6665,7031575,2,446,113,1,59649400,59649400,166,55,111,55,0,1,57,6002,0.006002
455,1055,6665,7031575,2,3646,913,1,84353400,84353400,1366,455,911,455,0,1,457,16278,0.016278
855,1055,6665,7031575,2,6846,1713,1,109057400,109057400,2566,855,1711,855,0,1,857,57649,0.057649
1255,1055,6665,7031575,2,10046,2513,1,133761400,133761400,3766,1255,2511,1255,0,1,1257,111408,0.111408
1655,1055,6665,7031575,2,13246,3313,1,158465400,158465400,4966,1655,3311,1655,0,1,1657,89249,0.089249
2055,1055,6665,7031575,2,16446,4113,1,183169400,183169400,6166,2055,4111,2055,0,1,2057,101759,0.101759
2455,1055,6665,7031575,2,19646,4913,1,207873400,207873400,7366,2455,4911,2455,0,1,2457,385244,0.385244
2855,1055,6665,7031575,2,22846,5713,1,232577400,232577400,8566,2855,5711,2855,0,1,2857,967314,0.967314
3255,1055,6665,7031575,2,26046,6513,1,257281400,257281400,9766,3255,6511,3255,0,1,3257,1219425,1.219425
3655,1055,6665,7031575,2,29246,7313,1,281985400,281985400,10966,3655,7311,3655,0,1,3657,358254,0.358254
4055,1055,6665,7031575,2,32446,8113,1,306689400,306689400,12166,4055,8111,4055,0,1,4057,69872,0.069872
4455,1055,6665,7031575,2,35646,8913,1,331393400,331393400,13366,4455,8911,4455,0,1,4457,73024,0.073024
4855,1055,6665,7031575,2,38846,9713,1,356097400,356097400,14566,4855,9711,4855,0,1,4857,1668358,1.668358
5255,1055,6665,7031575,2,42046,10513,1,380801400,380801400,15766,5255,10511,5255,0,1,5257,62631,0.062631
5655,1055,6665,7031575,2,45246,11313,1,405505400,405505400,16966,5655,11311,5655,0,1,5657,506977,0.506977
6055,1055,6665,7031575,2,48446,12113,1,430209400,430209400,18166,6055,12111,6055,0,1,6057,132583,0.132583
6455,1055,6665,7031575,2,51646,12913,1,454913400,454913400,19366,6455,12911,6455,0,1,6457,248433,0.248433
6855,1055,6665,7031575,2,54846,13713,1,479617400,479617400,20566,6855,13711,6855,0,1,6857,931831,0.931831
40,1550,4540,7037000,2,326,83,1,58244800,58244800,121,40,81,40,0,1,42,132164,0.132164
440,1550,4540,7037000,2,3526,883,1,77732800,77732800,1321,440,881,440,0,1,442,658510,0.65851
840,1550,4540,7037000,2,6726,1683,1,97220800,97220800,2521,840,1681,840,0,1,842,1189148,1.189148
1240,1550,4540,7037000,2,9926,2483,1,116708800,116708800,3721,1240,2481,1240,0,1,1242,280521,0.280521
1640,1550,4540,7037000,2,13126,3283,1,136196800,136196800,4921,1640,3281,1640,0,1,1642,898331,0.898331
2040,1550,4540,7037000,2,16326,4083,1,155684800,155684800,6121,2040,4081,2040,0,1,2042,2817179,2.817179
2440,1550,4540,7037000,2,19526,4883,1,175172800,175172800,7321,2440,4881,2440,0,1,2442,2829451,2.829451
2840,1550,4540,7037000,2,22726,5683,1,194660800,194660800,8521,2840,5681,2840,0,1,2842,786024,0.786024
3240,1550,4540,7037000,2,25926,6483,1,214148800,214148800,9721,3240,6481,3240,0,1,3242,2419951,2.419951
3640,1550,4540,7037000,2,29126,7283,1,233636800,233636800,10921,3640,7281,3640,0,1,3642,1423818,1.423818
4040,1550,4540,7037000,2,32326,8083,1,253124800,253124800,12121,4040,8081,4040,0,1,4042,1005182,1.005182
4440,1550,4540,7037000,2,35526,8883,1,272612800,272612800,13321,4440,8881,4440,0,1,4442,1283720,1.28372
4840,1550,4540,7037000,2,38726,9683,1,292100800,292100800,14521,4840,9681,4840,0,1,4842,3016676,3.016676
5240,1550,4540,7037000,2,41926,10483,1,311588800,311588800,15721,5240,10481,5240,0,1,5242,249616,0.249616
5640,1550,4540,7037000,2,45126,11283,1,331076800,331076800,16921,5640,11281,5640,0,1,5642,73117,0.073117
6040,1550,4540,7037000,2,48326,12083,1,350564800,350564800,18121,6040,12081,6040,0,1,6042,811757,0.811757
6440,1550,4540,7037000,2,51526,12883,1,370052800,370052800,19321,6440,12881,6440,0,1,6442,2240604,2.240604
6840,1550,4540,7037000,2,54726,13683,1,389540800,389540800,20521,6840,13681,6840,0,1,6842,360991,0.360991
40,3300,2140,7062000,2,326,83,1,58236800,58236800,121,40,81,40,0,1,42,123648,0.123648
440,3300,2140,7062000,2,3526,883,1,75644800,75644800,1321,440,881,440,0,1,442,650224,0.650224
840,3300,2140,7062000,2,6726,1683,1,93052800,93052800,2521,840,1681,840,0,1,842,1189498,1.189498
1240,3300,2140,7062000,2,9926,2483,1,110460800,110460800,3721,1240,2481,1240,0,1,1242,456139,0.456139
1640,3300,2140,7062000,2,13126,3283,1,127868800,127868800,4921,1640,3281,1640,0,1,1642,1604389,1.604389
2040,3300,2140,7062000,2,16326,4083,1,145276800,145276800,6121,2040,4081,2040,0,1,2042,2797853,2.797853
2440,3300,2140,7062000,2,19526,4883,1,162684800,162684800,7321,2440,4881,2440,0,1,2442,3335138,3.335138
2840,3300,2140,7062000,2,22726,5683,1,180092800,180092800,8521,2840,5681,2840,0,1,2842,413491,0.413491
3240,3300,2140,7062000,2,25926,6483,1,197500800,197500800,9721,3240,6481,3240,0,1,3242,3508911,3.508911
3640,3300,2140,7062000,2,29126,7283,1,214908800,214908800,10921,3640,7281,3640,0,1,3642,3000502,3.000502
4040,3300,2140,7062000,2,32326,8083,1,232316800,232316800,12121,4040,8081,4040,0,1,4042,1565660,1.56566
4440,3300,2140,7062000,2,35526,8883,1,249724800,249724800,13321,4440,8881,4440,0,1,4442,414227,0.414227
4840,3300,2140,7062000,2,38726,9683,1,267132800,267132800,14521,4840,9681,4840,0,1,4842,334308,0.334308
5240,3300,2140,7062000,2,41926,10483,1,284540800,284540800,15721,5240,10481,5240,0,1,5242,3597829,3.597829
5640,3300,2140,7062000,2,45126,11283,1,301948800,301948800,16921,5640,11281,5640,0,1,5642,1023260,1.02326
6040,3300,2140,7062000,2,48326,12083,1,319356800,319356800,18121,6040,12081,6040,0,1,6042,110660,0.11066
6440,3300,2140,7062000,2,51526,12883,1,336764800,336764800,19321,6440,12881,6440,0,1,6442,1385311,1.385311
6840,3300,2140,7062000,2,54726,13683,1,354172800,354172800,20521,6840,13681,6840,0,1,6842,950701,0.950701
55,2555,2765,7064575,2,446,113,1,58857400,58857400,166,55,111,55,0,1,57,145489,0.145489
455,2555,2765,7064575,2,3646,913,1,75881400,75881400,1366,455,911,455,0,1,457,657957,0.657957
855,2555,2765,7064575,2,6846,1713,1,92905400,92905400,2566,855,1711,855,0,1,857,500036,0.500036
1255,2555,2765,7064575,2,10046,2513,1,109929400,109929400,3766,1255,2511,1255,0,1,1257,1010779,1.010779
1655,2555,2765,7064575,2,13246,3313,1,126953400,126953400,4966,1655,3311,1655,0,1,1657,545157,0.545157
2055,2555,2765,7064575,2,16446,4113,1,143977400,143977400,6166,2055,4111,2055,0,1,2057,1922854,1.922854
2455,2555,2765,7064575,2,19646,4913,1,161001400,161001400,7366,2455,4911,2455,0,1,2457,3273963,3.273963
2855,2555,2765,7064575,2,22846,5713,1,178025400,178025400,8566,2855,5711,2855,0,1,2857,1161819,1.161819
3255,2555,2765,7064575,2,26046,6513,1,195049400,195049400,9766,3255,6511,3255,0,1,3257,3067653,3.067653
3655,2555,2765,7064575,2,29246,7313,1,212073400,212073400,10966,3655,7311,3655,0,1,3657,3271847,3.271847
4055,2555,2765,7064575,2,32446,8113,1,229097400,229097400,12166,4055,8111,4055,0,1,4057,1355955,1.355955
4455,2555,2765,7064575,2,35646,8913,1,246121400,246121400,13366,4455,8911,4455,0,1,4457,296565,0.296565
4855,2555,2765,7064575,2,38846,9713,1,263145400,263145400,14566,4855,9711,4855,0,1,4857,2301523,2.301523
5255,2555,2765,7064575,2,42046,10513,1,280169400,280169400,15766,5255,10511,5255,0,1,5257,624526,0.624526
5655,2555,2765,7064575,2,45246,11313,1,297193400,297193400,16966,5655,11311,5655,0,1,5657,450570,0.45057
6055,2555,2765,7064575,2,48446,12113,1,314217400,314217400,18166,6055,12111,6055,0,1,6057,217763,0.217763
6455,2555,2765,7064575,2,51646,12913,1,331241400,331241400,19366,6455,12911,6455,0,1,6457,1068785,1.068785
6855,2555,2765,7064575,2,54846,13713,1,348265400,348265400,20566,6855,13711,6855,0,1,6857,629692,0.629692
55,2305,3065,7064825,2,446,113,1,58881400,58881400,166,55,111,55,0,1,57,143385,0.143385
455,2305,3065,7064825,2,3646,913,1,76065400,76065400,1366,455,911,455,0,1,457,99291,0.099291
855,2305,3065,7064825,2,6846,1713,1,93249400,93249400,2566,855,1711,855,0,1,857,1173384,1.173384
1255,2305,3065,7064825,2,10046,2513,1,110433400,110433400,3766,1255,2511,1255,0,1,1257,83955,0.083955
1655,2305,3065,7064825,2,13246,3313,1,127617400,127617400,4966,1655,3311,1655,0,1,1657,20716,0.020716
2055,2305,3065,7064825,2,16446,4113,1,144801400,144801400,6166,2055,4111,2055,0,1,2057,2759206,2.759206
2455,2305,3065,7064825,2,19646,4913,1,161985400,161985400,7366,2455,4911,2455,0,1,2457,3272512,3.272512
2855,2305,3065,7064825,2,22846,5713,1,179169400,179169400,8566,2855,5711,2855,0,1,2857,3802831,3.802831
3255,2305,3065,7064825,2,26046,6513,1,196353400,196353400,9766,3255,6511,3255,0,1,3257,620599,0.620599
3655,2305,3065,7064825,2,29246,7313,1,213537400,213537400,10966,3655,7311,3655,0,1,3657,1337911,1.337911
4055,2305,3065,7064825,2,32446,8113,1,230721400,230721400,12166,4055,8111,4055,0,1,4057,1342110,1.34211
4455,2305,3065,7064825,2,35646,8913,1,247905400,247905400,13366,4455,8911,4455,0,1,4457,2074226,2.074226
4855,2305,3065,7064825,2,38846,9713,1,265089400,265089400,14566,4855,9711,4855,0,1,4857,3135392,3.135392
5255,2305,3065,7064825,2,42046,10513,1,282273400,282273400,15766,5255,10511,5255,0,1,5257,679665,0.679665
5655,2305,3065,7064825,2,45246,11313,1,299457400,299457400,16966,5655,11311,5655,0,1,5657,745835,0.745835
6055,2305,3065,7064825,2,48446,12113,1,316641400,316641400,18166,6055,12111,6055,0,1,6057,491483,0.491483
6455,2305,3065,7064825,2,51646,12913,1,333825400,333825400,19366,6455,12911,6455,0,1,6457,119174,0.119174
6855,2305,3065,7064825,2,54846,13713,1,351009400,351009400,20566,6855,13711,6855,0,1,6857,44338,0.044338
40,1300,5440,7072000,2,326,83,1,58732800,58732800,121,40,81,40,0,1,42,12997,0.012997
440,1300,5440,7072000,2,3526,883,1,80300800,80300800,1321,440,881,440,0,1,442,120197,0.120197
840,1300,5440,7072000,2,6726,1683,1,101868800,101868800,2521,840,1681,840,0,1,842,1169583,1.169583
1240,1300,5440,7072000,2,9926,2483,1,123436800,123436800,3721,1240,2481,1240,0,1,1242,55306,0.055306
1640,1300,5440,7072000,2,13126,3283,1,145004800,145004800,4921,1640,3281,1640,0,1,1642,21119,0.021119
2040,1300,5440,7072000,2,16326,4083,1,166572800,166572800,6121,2040,4081,2040,0,1,2042,436573,0.436573
2440,1300,5440,7072000,2,19526,4883,1,188140800,188140800,7321,2440,4881,2440,0,1,2442,796849,0.796849
2840,1300,5440,7072000,2,22726,5683,1,209708800,209708800,8521,2840,5681,2840,0,1,2842,77789,0.077789
3240,1300,5440,7072000,2,25926,6483,1,231276800,231276800,9721,3240,6481,3240,0,1,3242,243602,0.243602
3640,1300,5440,7072000,2,29126,7283,1,252844800,252844800,10921,3640,7281,3640,0,1,3642,1101940,1.10194
4040,1300,5440,7072000,2,32326,8083,1,274412800,274412800,12121,4040,8081,4040,0,1,4042,2009441,2.009441
4440,1300,5440,7072000,2,35526,8883,1,295980800,295980800,13321,4440,8881,4440,0,1,4442,394448,0.394448
4840,1300,5440,7072000,2,38726,9683,1,317548800,317548800,14521,4840,9681,4840,0,1,4842,2605110,2.60511
5240,1300,5440,7072000,2,41926,10483,1,339116800,339116800,15721,5240,10481,5240,0,1,5242,4130684,4.130684
5640,1300,5440,7072000,2,45126,11283,1,360684800,360684800,16921,5640,11281,5640,0,1,5642,1329645,1.329645
6040,1300,5440,7072000,2,48326,12083,1,382252800,382252800,18121,6040,12081,6040,0,1,6042,98335,0.098335
6440,1300,5440,7072000,2,51526,12883,1,403820800,403820800,19321,6440,12881,6440,0,1,6442,1206497,1.206497
6840,1300,5440,7072000,2,54726,13683,1,425388800,425388800,20521,6840,13681,6840,0,1,6842,486783,0.486783
40,1800,3940,7092000,2,326,83,1,58572800,58572800,121,40,81,40,0,1,42,133145,0.133145
440,1800,3940,7092000,2,3526,883,1,76940800,76940800,1321,440,881,440,0,1,442,656723,0.656723
840,1800,3940,7092000,2,6726,1683,1,95308800,95308800,2521,840,1681,840,0,1,842,1198737,1.198737
1240,1800,3940,7092000,2,9926,2483,1,113676800,113676800,3721,1240,2481,1240,0,1,1242,625266,0.625266
1640,1800,3940,7092000,2,13126,3283,1,132044800,132044800,4921,1640,3281,1640,0,1,1642,203054,0.203054
2040,1800,3940,7092000,2,16326,4083,1,150412800,150412800,6121,2040,4081,2040,0,1,2042,2167319,2.167319
2440,1800,3940,7092000,2,19526,4883,1,168780800,168780800,7321,2440,4881,2440,0,1,2442,2539530,2.53953
2840,1800,3940,7092000,2,22726,5683,1,187148800,187148800,8521,2840,5681,2840,0,1,2842,170156,0.170156
3240,1800,3940,7092000,2,25926,6483,1,205516800,205516800,9721,3240,6481,3240,0,1,3242,1995415,1.995415
3640,1800,3940,7092000,2,29126,7283,1,223884800,223884800,10921,3640,7281,3640,0,1,3642,860845,0.860845
4040,1800,3940,7092000,2,32326,8083,1,242252800,242252800,12121,4040,8081,4040,0,1,4042,180639,0.180639
4440,1800,3940,7092000,2,35526,8883,1,260620800,260620800,13321,4440,8881,4440,0,1,4442,3506824,3.506824
4840,1800,3940,7092000,2,38726,9683,1,278988800,278988800,14521,4840,9681,4840,0,1,4842,265144,0.265144
5240,1800,3940,7092000,2,41926,10483,1,297356800,297356800,15721,5240,10481,5240,0,1,5242,190010,0.19001
5640,1800,3940,7092000,2,45126,11283,1,315724800,315724800,16921,5640,11281,5640,0,1,5642,296044,0.296044
6040,1800,3940,7092000,2,48326,12083,1,334092800,334092800,18121,6040,12081,6040,0,1,6042,919069,0.919069
6440,1800,3940,7092000,2,51526,12883,1,352460800,352460800,19321,6440,12881,6440,0,1,6442,753809,0.753809
6840,1800,3940,7092000,2,54726,13683,1,370828800,370828800,20521,6840,13681,6840,0,1,6842,147864,0.147864
55,3805,1865,7096325,2,446,113,1,59265400,59265400,166,55,111,55,0,1,57,146879,0.146879
455,3805,1865,7096325,2,3646,913,1,77409400,77409400,1366,455,911,455,0,1,457,685079,0.685079
855,3805,1865,7096325,2,6846,1713,1,95553400,95553400,2566,855,1711,855,0,1,857,1238847,1.238847
1255,3805,1865,7096325,2,10046,2513,1,113697400,113697400,3766,1255,2511,1255,0,1,1257,610433,0.610433
1655,3805,1865,7096325,2,13246,3313,1,131841400,131841400,4966,1655,3311,1655,0,1,1657,1793484,1.793484
2055,3805,1865,7096325,2,16446,4113,1,149985400,149985400,6166,2055,4111,2055,0,1,2057,2867222,2.867222
2455,3805,1865,7096325,2,19646,4913,1,168129400,168129400,7366,2455,4911,2455,0,1,2457,3426563,3.426563
2855,3805,1865,7096325,2,22846,5713,1,186273400,186273400,8566,2855,5711,2855,0,1,2857,610444,0.610444
3255,3805,1865,7096325,2,26046,6513,1,204417400,204417400,9766,3255,6511,3255,0,1,3257,1259820,1.25982
3655,3805,1865,7096325,2,29246,7313,1,222561400,222561400,10966,3655,7311,3655,0,1,3657,4418949,4.418949
4055,3805,1865,7096325,2,32446,8113,1,240705400,240705400,12166,4055,8111,4055,0,1,4057,3848795,3.848795
4455,3805,1865,7096325,2,35646,8913,1,258849400,258849400,13366,4455,8911,4455,0,1,4457,4420358,4.420358
4855,3805,1865,7096325,2,38846,9713,1,276993400,276993400,14566,4855,9711,4855,0,1,4857,3154634,3.154634
5255,3805,1865,7096325,2,42046,10513,1,295137400,295137400,15766,5255,10511,5255,0,1,5257,2474123,2.474123
5655,3805,1865,7096325,2,45246,11313,1,313281400,313281400,16966,5655,11311,5655,0,1,5657,4538042,4.538042
6055,3805,1865,7096325,2,48446,12113,1,331425400,331425400,18166,6055,12111,6055,0,1,6057,2258170,2.25817
6455,3805,1865,7096325,2,51646,12913,1,349569400,349569400,19366,6455,12911,6455,0,1,6457,2173118,2.173118
6855,3805,1865,7096325,2,54846,13713,1,367713400,367713400,20566,6855,13711,6855,0,1,6857,113998,0.113998
39,2793,2541,7097013,2,318,81,1,58440312,58440312,118,39,79,39,0,1,41,133056,0.133056
539,2793,2541,7097013,2,4318,1081,1,79776312,79776312,1618,539,1079,539,0,1,541,316045,0.316045
1039,2793,2541,7097013,2,8318,2081,1,101112312,101112312,3118,1039,2079,1039,0,1,1041,109916,0.109916
1539,2793,2541,7097013,2,12318,3081,1,122448312,122448312,4618,1539,3079,1539,0,1,1541,766168,0.766168
2039,2793,2541,7097013,2,16318,4081,1,143784312,143784312,6118,2039,4079,2039,0,1,2041,308444,0.308444
2539,2793,2541,7097013,2,20318,5081,1,165120312,165120312,7618,2539,5079,2539,0,1,2541,1873491,1.873491
3039,2793,2541,7097013,2,24318,6081,1,186456312,186456312,9118,3039,6079,3039,0,1,3041,4117448,4.117448
3539,2793,2541,7097013,2,28318,7081,1,207792312,207792312,10618,3539,7079,3539,0,1,3541,1111314,1.111314
4039,2793,2541,7097013,2,32318,8081,1,229128312,229128312,12118,4039,8079,4039,0,1,4041,5089277,5.089277
4539,2793,2541,7097013,2,36318,9081,1,250464312,250464312,13618,4539,9079,4539,0,1,4541,2685775,2.685775
5039,2793,2541,7097013,2,40318,10081,1,271800312,271800312,15118,5039,10079,5039,0,1,5041,1124407,1.124407
5539,2793,2541,7097013,2,44318,11081,1,293136312,293136312,16618,5539,11079,5539,0,1,5541,2221397,2.221397
6039,2793,2541,7097013,2,48318,12081,1,314472312,314472312,18118,6039,12079,6039,0,1,6041,2246353,2.246353
6539,2793,2541,7097013,2,52318,13081,1,335808312,335808312,19618,6539,13079,6539,0,1,6541,2391583,2.391583
7039,2793,2541,7097013,2,56318,14081,1,357144312,357144312,21118,7039,14079,7039,0,1,7041,1559371,1.559371
55,1555,4565,7098575,2,446,113,1,59481400,59481400,166,55,111,55,0,1,57,145293,0.145293
455,1555,4565,7098575,2,3646,913,1,79065400,79065400,1366,455,911,455,0,1,457,682721,0.682721
855,1555,4565,7098575,2,6846,1713,1,98649400,98649400,2566,855,1711,855,0,1,857,1098339,1.098339
1255,1555,4565,7098575,2,10046,2513,1,118233400,118233400,3766,1255,2511,1255,0,1,1257,1149421,1.149421
1655,1555,4565,7098575,2,13246,3313,1,137817400,137817400,4966,1655,3311,1655,0,1,1657,2322096,2.322096
2055,1555,4565,7098575,2,16446,4113,1,157401400,157401400,6166,2055,4111,2055,0,1,2057,20626,0.020626
2455,1555,4565,7098575,2,19646,4913,1,176985400,176985400,7366,2455,4911,2455,0,1,2457,3416472,3.416472
2855,1555,4565,7098575,2,22846,5713,1,196569400,196569400,8566,2855,5711,2855,0,1,2857,1897773,1.897773
3255,1555,4565,7098575,2,26046,6513,1,216153400,216153400,9766,3255,6511,3255,0,1,3257,1515687,1.515687
3655,1555,4565,7098575,2,29246,7313,1,235737400,235737400,10966,3655,7311,3655,0,1,3657,158046,0.158046
4055,1555,4565,7098575,2,32446,8113,1,255321400,255321400,12166,4055,8111,4055,0,1,4057,1522409,1.522409
4455,1555,4565,7098575,2,35646,8913,1,274905400,274905400,13366,4455,8911,4455,0,1,4457,1046793,1.046793
4855,1555,4565,7098575,2,38846,9713,1,294489400,294489400,14566,4855,9711,4855,0,1,4857,595604,0.595604
5255,1555,4565,7098575,2,42046,10513,1,314073400,314073400,15766,5255,10511,5255,0,1,5257,841696,0.841696
5655,1555,4565,7098575,2,45246,11313,1,333657400,333657400,16966,5655,11311,5655,0,1,5657,3680541,3.680541
6055,1555,4565,7098575,2,48446,12113,1,353241400,353241400,18166,6055,12111,6055,0,1,6057,782458,0.782458
6455,1555,4565,7098575,2,51646,12913,1,372825400,372825400,19366,6455,12911,6455,0,1,6457,4945560,4.94556
6855,1555,4565,7098575,2,54846,13713,1,392409400,392409400,20566,6855,13711,6855,0,1,6857,231466,0.231466
55,4555,1565,7128575,2,446,113,1,59721400,59721400,166,55,111,55,0,1,57,146053,0.146053
455,4555,1565,7128575,2,3646,913,1,79305400,79305400,1366,455,911,455,0,1,457,669093,0.669093
855,4555,1565,7128575,2,6846,1713,1,98889400,98889400,2566,855,1711,855,0,1,857,1202233,1.202233
1255,4555,1565,7128575,2,10046,2513,1,118473400,118473400,3766,1255,2511,1255,0,1,1257,1182316,1.182316
1655,4555,1565,7128575,2,13246,3313,1,138057400,138057400,4966,1655,3311,1655,0,1,1657,829774,0.829774
2055,4555,1565,7128575,2,16446,4113,1,157641400,157641400,6166,2055,4111,2055,0,1,2057,2797634,2.797634
2455,4555,1565,7128575,2,19646,4913,1,177225400,177225400,7366,2455,4911,2455,0,1,2457,2333457,2.333457
2855,4555,1565,7128575,2,22846,5713,1,196809400,196809400,8566,2855,5711,2855,0,1,2857,577476,0.577476
3255,4555,1565,7128575,2,26046,6513,1,216393400,216393400,9766,3255,6511,3255,0,1,3257,4393011,4.393011
3655,4555,1565,7128575,2,29246,7313,1,235977400,235977400,10966,3655,7311,3655,0,1,3657,2193848,2.193848
4055,4555,1565,7128575,2,32446,8113,1,255561400,255561400,12166,4055,8111,4055,0,1,4057,5500512,5.500512
4455,4555,1565,7128575,2,35646,8913,1,275145400,275145400,13366,4455,8911,4455,0,1,4457,4506331,4.506331
4855,4555,1565,7128575,2,38846,9713,1,294729400,294729400,14566,4855,9711,4855,0,1,4857,2998284,2.998284
5255,4555,1565,7128575,2,42046,10513,1,314313400,314313400,15766,5255,10511,5255,0,1,5257,1379168,1.379168
5655,4555,1565,7128575,2,45246,11313,1,333897400,333897400,16966,5655,11311,5655,0,1,5657,7425939,7.425939
6055,4555,1565,7128575,2,48446,12113,1,353481400,353481400,18166,6055,12111,6055,0,1,6057,1748348,1.748348
6455,4555,1565,7128575,2,51646,12913,1,373065400,373065400,19366,6455,12911,6455,0,1,6457,2855078,2.855078
6855,4555,1565,7128575,2,54846,13713,1,392649400,392649400,20566,6855,13711,6855,0,1,6857,127026,0.127026
55,1305,5465,7131825,2,446,113,1,60033400,60033400,166,55,111,55,0,1,57,144526,0.144526
455,1305,5465,7131825,2,3646,913,1,81697400,81697400,1366,455,911,455,0,1,457,320370,0.32037
855,1305,5465,7131825,2,6846,1713,1,103361400,103361400,2566,855,1711,855,0,1,857,432985,0.432985
1255,1305,5465,7131825,2,10046,2513,1,125025400,125025400,3766,1255,2511,1255,0,1,1257,1153947,1.153947
1655,1305,5465,7131825,2,13246,3313,1,146689400,146689400,4966,1655,3311,1655,0,1,1657,836258,0.836258
2055,1305,5465,7131825,2,16446,4113,1,168353400,168353400,6166,2055,4111,2055,0,1,2057,1458670,1.45867
2455,1305,5465,7131825,2,19646,4913,1,190017400,190017400,7366,2455,4911,2455,0,1,2457,1059310,1.05931
2855,1305,5465,7131825,2,22846,5713,1,211681400,211681400,8566,2855,5711,2855,0,1,2857,98706,0.098706
3255,1305,5465,7131825,2,26046,6513,1,233345400,233345400,9766,3255,6511,3255,0,1,3257,575097,0.575097
3655,1305,5465,7131825,2,29246,7313,1,255009400,255009400,10966,3655,7311,3655,0,1,3657,1946211,1.946211
4055,1305,5465,7131825,2,32446,8113,1,276673400,276673400,12166,4055,8111,4055,0,1,4057,1474508,1.474508
4455,1305,5465,7131825,2,35646,8913,1,298337400,298337400,13366,4455,8911,4455,0,1,4457,1169883,1.169883
4855,1305,5465,7131825,2,38846,9713,1,320001400,320001400,14566,4855,9711,4855,0,1,4857,929654,0.929654
5255,1305,5465,7131825,2,42046,10513,1,341665400,341665400,15766,5255,10511,5255,0,1,5257,300524,0.300524
5655,1305,5465,7131825,2,45246,11313,1,363329400,363329400,16966,5655,11311,5655,0,1,5657,295514,0.295514
6055,1305,5465,7131825,2,48446,12113,1,384993400,384993400,18166,6055,12111,6055,0,1,6057,1134593,1.134593
6455,1305,5465,7131825,2,51646,12913,1,406657400,406657400,19366,6455,12911,6455,0,1,6457,534934,0.534934
6855,1305,5465,7131825,2,54846,13713,1,428321400,428321400,20566,6855,13711,6855,0,1,6857,54346,0.054346
55,3305,2165,7155325,2,446,113,1,59649400,59649400,166,55,111,55,0,1,57,145347,0.145347
455,3305,2165,7155325,2,3646,913,1,77153400,77153400,1366,455,911,455,0,1,457,53767,0.053767
855,3305,2165,7155325,2,6846,1713,1,94657400,94657400,2566,855,1711,855,0,1,857,1243756,1.243756
1255,3305,2165,7155325,2,10046,2513,1,112161400,112161400,3766,1255,2511,1255,0,1,1257,1794675,1.794675
1655,3305,2165,7155325,2,13246,3313,1,129665400,129665400,4966,1655,3311,1655,0,1,1657,13827,0.013827
2055,3305,2165,7155325,2,16446,4113,1,147169400,147169400,6166,2055,4111,2055,0,1,2057,2166169,2.166169
2455,3305,2165,7155325,2,19646,4913,1,164673400,164673400,7366,2455,4911,2455,0,1,2457,2811428,2.811428
2855,3305,2165,7155325,2,22846,5713,1,182177400,182177400,8566,2855,5711,2855,0,1,2857,400385,0.400385
3255,3305,2165,7155325,2,26046,6513,1,199681400,199681400,9766,3255,6511,3255,0,1,3257,4563959,4.563959
3655,3305,2165,7155325,2,29246,7313,1,217185400,217185400,10966,3655,7311,3655,0,1,3657,1557754,1.557754
4055,3305,2165,7155325,2,32446,8113,1,234689400,234689400,12166,4055,8111,4055,0,1,4057,1321697,1.321697
4455,3305,2165,7155325,2,35646,8913,1,252193400,252193400,13366,4455,8911,4455,0,1,4457,1689442,1.689442
4855,3305,2165,7155325,2,38846,9713,1,269697400,269697400,14566,4855,9711,4855,0,1,4857,1085111,1.085111
5255,3305,2165,7155325,2,42046,10513,1,287201400,287201400,15766,5255,10511,5255,0,1,5257,2152617,2.152617
5655,3305,2165,7155325,2,45246,11313,1,304705400,304705400,16966,5655,11311,5655,0,1,5657,770411,0.770411
6055,3305,2165,7155325,2,48446,12113,1,322209400,322209400,18166,6055,12111,6055,0,1,6057,360757,0.360757
6455,3305,2165,7155325,2,51646,12913,1,339713400,339713400,19366,6455,12911,6455,0,1,6457,73300,0.0733
6855,3305,2165,7155325,2,54846,13713,1,357217400,357217400,20566,6855,13711,6855,0,1,6857,592296,0.592296
55,1805,3965,7156825,2,446,113,1,59793400,59793400,166,55,111,55,0,1,57,152972,0.152972
455,1805,3965,7156825,2,3646,913,1,78257400,78257400,1366,455,911,455,0,1,457,363863,0.363863
855,1805,3965,7156825,2,6846,1713,1,96721400,96721400,2566,855,1711,855,0,1,857,532318,0.532318
1255,1805,3965,7156825,2,10046,2513,1,115185400,115185400,3766,1255,2511,1255,0,1,1257,1378262,1.378262
1655,1805,3965,7156825,2,13246,3313,1,133649400,133649400,4966,1655,3311,1655,0,1,1657,30487,0.030487
2055,1805,3965,7156825,2,16446,4113,1,152113400,152113400,6166,2055,4111,2055,0,1,2057,1676073,1.676073
2455,1805,3965,7156825,2,19646,4913,1,170577400,170577400,7366,2455,4911,2455,0,1,2457,2129796,2.129796
2855,1805,3965,7156825,2,22846,5713,1,189041400,189041400,8566,2855,5711,2855,0,1,2857,682616,0.682616
3255,1805,3965,7156825,2,26046,6513,1,207505400,207505400,9766,3255,6511,3255,0,1,3257,63410,0.06341
3655,1805,3965,7156825,2,29246,7313,1,225969400,225969400,10966,3655,7311,3655,0,1,3657,730476,0.730476
4055,1805,3965,7156825,2,32446,8113,1,244433400,244433400,12166,4055,8111,4055,0,1,4057,472046,0.472046
4455,1805,3965,7156825,2,35646,8913,1,262897400,262897400,13366,4455,8911,4455,0,1,4457,378225,0.378225
4855,1805,3965,7156825,2,38846,9713,1,281361400,281361400,14566,4855,9711,4855,0,1,4857,2740616,2.740616
5255,1805,3965,7156825,2,42046,10513,1,299825400,299825400,15766,5255,10511,5255,0,1,5257,888448,0.888448
5655,1805,3965,7156825,2,45246,11313,1,318289400,318289400,16966,5655,11311,5655,0,1,5657,755125,0.755125
6055,1805,3965,7156825,2,48446,12113,1,336753400,336753400,18166,6055,12111,6055,0,1,6057,160193,0.160193
6455,1805,3965,7156825,2,51646,12913,1,355217400,355217400,19366,6455,12911,6455,0,1,6457,4257402,4.257402
6855,1805,3965,7156825,2,54846,13713,1,373681400,373681400,20566,6855,13711,6855,0,1,6857,286619,0.286619
44,2803,2555,7161665,2,358,91,1,59179336,59179336,133,44,89,44,0,1,46,137794,0.137794
544,2803,2555,7161665,2,4358,1091,1,80611336,80611336,1633,544,1089,544,0,1,546,782412,0.782412
1044,2803,2555,7161665,2,8358,2091,1,102043336,102043336,3133,1044,2089,1044,0,1,1046,1443717,1.443717
1544,2803,2555,7161665,2,12358,3091,1,123475336,123475336,4633,1544,3089,1544,0,1,1546,2106334,2.106334
2044,2803,2555,7161665,2,16358,4091,1,144907336,144907336,6133,2044,4089,2044,0,1,2046,2708650,2.70865
2544,2803,2555,7161665,2,20358,5091,1,166339336,166339336,7633,2544,5089,2544,0,1,2546,3443905,3.443905
3044,2803,2555,7161665,2,24358,6091,1,187771336,187771336,9133,3044,6089,3044,0,1,3046,3949320,3.94932
3544,2803,2555,7161665,2,28358,7091,1,209203336,209203336,10633,3544,7089,3544,0,1,3546,896914,0.896914
4044,2803,2555,7161665,2,32358,8091,1,230635336,230635336,12133,4044,8089,4044,0,1,4046,743572,0.743572
4544,2803,2555,7161665,2,36358,9091,1,252067336,252067336,13633,4544,9089,4544,0,1,4546,1674100,1.6741
5044,2803,2555,7161665,2,40358,10091,1,273499336,273499336,15133,5044,10089,5044,0,1,5046,765656,0.765656
5544,2803,2555,7161665,2,44358,11091,1,294931336,294931336,16633,5544,11089,5544,0,1,5546,1137471,1.137471
6044,2803,2555,7161665,2,48358,12091,1,316363336,316363336,18133,6044,12089,6044,0,1,6046,7998810,7.99881
6544,2803,2555,7161665,2,52358,13091,1,337795336,337795336,19633,6544,13089,6544,0,1,6546,1580921,1.580921
7044,2803,2555,7161665,2,56358,14091,1,359227336,359227336,21133,7044,14089,7044,0,1,7046,842429,0.842429
40,5800,1240,7192000,2,326,83,1,59788800,59788800,121,40,81,40,0,1,42,6957,0.006957
440,5800,1240,7192000,2,3526,883,1,82316800,82316800,1321,440,881,440,0,1,442,8524,0.008524
840,5800,1240,7192000,2,6726,1683,1,104844800,104844800,2521,840,1681,840,0,1,842,101906,0.101906
1240,5800,1240,7192000,2,9926,2483,1,127372800,127372800,3721,1240,2481,1240,0,1,1242,6399,0.006399
1640,5800,1240,7192000,2,13126,3283,1,149900800,149900800,4921,1640,3281,1640,0,1,1642,259433,0.259433
2040,5800,1240,7192000,2,16326,4083,1,172428800,172428800,6121,2040,4081,2040,0,1,2042,430049,0.430049
2440,5800,1240,7192000,2,19526,4883,1,194956800,194956800,7321,2440,4881,2440,0,1,2442,422476,0.422476
2840,5800,1240,7192000,2,22726,5683,1,217484800,217484800,8521,2840,5681,2840,0,1,2842,167150,0.16715
3240,5800,1240,7192000,2,25926,6483,1,240012800,240012800,9721,3240,6481,3240,0,1,3242,20784,0.020784
3640,5800,1240,7192000,2,29126,7283,1,262540800,262540800,10921,3640,7281,3640,0,1,3642,81952,0.081952
4040,5800,1240,7192000,2,32326,8083,1,285068800,285068800,12121,4040,8081,4040,0,1,4042,2228072,2.228072
4440,5800,1240,7192000,2,35526,8883,1,307596800,307596800,13321,4440,8881,4440,0,1,4442,129354,0.129354
4840,5800,1240,7192000,2,38726,9683,1,330124800,330124800,14521,4840,9681,4840,0,1,4842,1367714,1.367714
5240,5800,1240,7192000,2,41926,10483,1,352652800,352652800,15721,5240,10481,5240,0,1,5242,576793,0.576793
5640,5800,1240,7192000,2,45126,11283,1,375180800,375180800,16921,5640,11281,5640,0,1,5642,4751816,4.751816
6040,5800,1240,7192000,2,48326,12083,1,397708800,397708800,18121,6040,12081,6040,0,1,6042,3462083,3.462083
6440,5800,1240,7192000,2,51526,12883,1,420236800,420236800,19321,6440,12881,6440,0,1,6442,1364015,1.364015
6840,5800,1240,7192000,2,54726,13683,1,442764800,442764800,20521,6840,13681,6840,0,1,6842,1645449,1.645449
40,1050,6940,7287000,2,326,83,1,60852800,60852800,121,40,81,40,0,1,42,35461,0.035461
440,1050,6940,7287000,2,3526,883,1,86420800,86420800,1321,440,881,440,0,1,442,14074,0.014074
840,1050,6940,7287000,2,6726,1683,1,111988800,111988800,2521,840,1681,840,0,1,842,11586,0.011586
1240,1050,6940,7287000,2,9926,2483,1,137556800,137556800,3721,1240,2481,1240,0,1,1242,31812,0.031812
1640,1050,6940,7287000,2,13126,3283,1,163124800,163124800,4921,1640,3281,1640,0,1,1642,158845,0.158845
2040,1050,6940,7287000,2,16326,4083,1,188692800,188692800,6121,2040,4081,2040,0,1,2042,83051,0.083051
2440,1050,6940,7287000,2,19526,4883,1,214260800,214260800,7321,2440,4881,2440,0,1,2442,168130,0.16813
2840,1050,6940,7287000,2,22726,5683,1,239828800,239828800,8521,2840,5681,2840,0,1,2842,307592,0.307592
3240,1050,6940,7287000,2,25926,6483,1,265396800,265396800,9721,3240,6481,3240,0,1,3242,333591,0.333591
3640,1050,6940,7287000,2,29126,7283,1,290964800,290964800,10921,3640,7281,3640,0,1,3642,303513,0.303513
4040,1050,6940,7287000,2,32326,8083,1,316532800,316532800,12121,4040,8081,4040,0,1,4042,214128,0.214128
4440,1050,6940,7287000,2,35526,8883,1,342100800,342100800,13321,4440,8881,4440,0,1,4442,243428,0.243428
4840,1050,6940,7287000,2,38726,9683,1,367668800,367668800,14521,4840,9681,4840,0,1,4842,791768,0.791768
5240,1050,6940,7287000,2,41926,10483,1,393236800,393236800,15721,5240,10481,5240,0,1,5242,65697,0.065697
5640,1050,6940,7287000,2,45126,11283,1,418804800,418804800,16921,5640,11281,5640,0,1,5642,633826,0.633826
6040,1050,6940,7287000,2,48326,12083,1,444372800,444372800,18121,6040,12081,6040,0,1,6042,1447472,1.447472
6440,1050,6940,7287000,2,51526,12883,1,469940800,469940800,19321,6440,12881,6440,0,1,6442,207803,0.207803
6840,1050,6940,7287000,2,54726,13683,1,495508800,495508800,20521,6840,13681,6840,0,1,6842,33709,0.033709
55,5805,1265,7343325,2,446,113,1,61857400,61857400,166,55,111,55,0,1,57,7091,0.007091
455,5805,1265,7343325,2,3646,913,1,84481400,84481400,1366,455,911,455,0,1,457,92060,0.09206
855,5805,1265,7343325,2,6846,1713,1,107105400,107105400,2566,855,1711,855,0,1,857,6231,0.006231
1255,5805,1265,7343325,2,10046,2513,1,129729400,129729400,3766,1255,2511,1255,0,1,1257,550165,0.550165
1655,5805,1265,7343325,2,13246,3313,1,152353400,152353400,4966,1655,3311,1655,0,1,1657,259233,0.259233
2055,5805,1265,7343325,2,16446,4113,1,174977400,174977400,6166,2055,4111,2055,0,1,2057,558257,0.558257
2455,5805,1265,7343325,2,19646,4913,1,197601400,197601400,7366,2455,4911,2455,0,1,2457,157199,0.157199
2855,5805,1265,7343325,2,22846,5713,1,220225400,220225400,8566,2855,5711,2855,0,1,2857,342485,0.342485
3255,5805,1265,7343325,2,26046,6513,1,242849400,242849400,9766,3255,6511,3255,0,1,3257,307729,0.307729
3655,5805,1265,7343325,2,29246,7313,1,265473400,265473400,10966,3655,7311,3655,0,1,3657,20034,0.020034
4055,5805,1265,7343325,2,32446,8113,1,288097400,288097400,12166,4055,8111,4055,0,1,4057,3139508,3.139508
4455,5805,1265,7343325,2,35646,8913,1,310721400,310721400,13366,4455,8911,4455,0,1,4457,2210447,2.210447
4855,5805,1265,7343325,2,38846,9713,1,333345400,333345400,14566,4855,9711,4855,0,1,4857,1119832,1.119832
5255,5805,1265,7343325,2,42046,10513,1,355969400,355969400,15766,5255,10511,5255,0,1,5257,837832,0.837832
5655,5805,1265,7343325,2,45246,11313,1,378593400,378593400,16966,5655,11311,5655,0,1,5657,1910708,1.910708
6055,5805,1265,7343325,2,48446,12113,1,401217400,401217400,18166,6055,12111,6055,0,1,6057,111909,0.111909
6455,5805,1265,7343325,2,51646,12913,1,423841400,423841400,19366,6455,12911,6455,0,1,6457,921338,0.921338
6855,5805,1265,7343325,2,54846,13713,1,446465400,446465400,20566,6855,13711,6855,0,1,6857,1277382,1.277382
55,1055,6965,7348075,2,446,113,1,62313400,62313400,166,55,111,55,0,1,57,75001,0.075001
455,1055,6965,7348075,2,3646,913,1,87977400,87977400,1366,455,911,455,0,1,457,25069,0.025069
855,1055,6965,7348075,2,6846,1713,1,113641400,113641400,2566,855,1711,855,0,1,857,24415,0.024415
1255,1055,6965,7348075,2,10046,2513,1,139305400,139305400,3766,1255,2511,1255,0,1,1257,88847,0.088847
1655,1055,6965,7348075,2,13246,3313,1,164969400,164969400,4966,1655,3311,1655,0,1,1657,148003,0.148003
2055,1055,6965,7348075,2,16446,4113,1,190633400,190633400,6166,2055,4111,2055,0,1,2057,632200,0.6322
2455,1055,6965,7348075,2,19646,4913,1,216297400,216297400,7366,2455,4911,2455,0,1,2457,238595,0.238595
2855,1055,6965,7348075,2,22846,5713,1,241961400,241961400,8566,2855,5711,2855,0,1,2857,199709,0.199709
3255,1055,6965,7348075,2,26046,6513,1,267625400,267625400,9766,3255,6511,3255,0,1,3257,227802,0.227802
3655,1055,6965,7348075,2,29246,7313,1,293289400,293289400,10966,3655,7311,3655,0,1,3657,483716,0.483716
4055,1055,6965,7348075,2,32446,8113,1,318953400,318953400,12166,4055,8111,4055,0,1,4057,253522,0.253522
4455,1055,6965,7348075,2,35646,8913,1,344617400,344617400,13366,4455,8911,4455,0,1,4457,534563,0.534563
4855,1055,6965,7348075,2,38846,9713,1,370281400,370281400,14566,4855,9711,4855,0,1,4857,248537,0.248537
5255,1055,6965,7348075,2,42046,10513,1,395945400,395945400,15766,5255,10511,5255,0,1,5257,256003,0.256003
5655,1055,6965,7348075,2,45246,11313,1,421609400,421609400,16966,5655,11311,5655,0,1,5657,892264,0.892264
6055,1055,6965,7348075,2,48446,12113,1,447273400,447273400,18166,6055,12111,6055,0,1,6057,1233433,1.233433
6455,1055,6965,7348075,2,51646,12913,1,472937400,472937400,19366,6455,12911,6455,0,1,6457,89506,0.089506
6855,1055,6965,7348075,2,54846,13713,1,498601400,498601400,20566,6855,13711,6855,0,1,6857,353271,0.353271
40,4800,1540,7392000,2,326,83,1,61164800,61164800,121,40,81,40,0,1,42,134365,0.134365
440,4800,1540,7392000,2,3526,883,1,81452800,81452800,1321,440,881,440,0,1,442,664653,0.664653
840,4800,1540,7392000,2,6726,1683,1,101740800,101740800,2521,840,1681,840,0,1,842,1208450,1.20845
1240,4800,1540,7392000,2,9926,2483,1,122028800,122028800,3721,1240,2481,1240,0,1,1242,1751788,1.751788
1640,4800,1540,7392000,2,13126,3283,1,142316800,142316800,4921,1640,3281,1640,0,1,1642,2302943,2.302943
2040,4800,1540,7392000,2,16326,4083,1,162604800,162604800,6121,2040,4081,2040,0,1,2042,1266698,1.266698
2440,4800,1540,7392000,2,19526,4883,1,182892800,182892800,7321,2440,4881,2440,0,1,2442,3401807,3.401807
2840,4800,1540,7392000,2,22726,5683,1,203180800,203180800,8521,2840,5681,2840,0,1,2842,3930593,3.930593
3240,4800,1540,7392000,2,25926,6483,1,223468800,223468800,9721,3240,6481,3240,0,1,3242,4481491,4.481491
3640,4800,1540,7392000,2,29126,7283,1,243756800,243756800,10921,3640,7281,3640,0,1,3642,2295536,2.295536
4040,4800,1540,7392000,2,32326,8083,1,264044800,264044800,12121,4040,8081,4040,0,1,4042,2300436,2.300436
4440,4800,1540,7392000,2,35526,8883,1,284332800,284332800,13321,4440,8881,4440,0,1,4442,4455604,4.455604
4840,4800,1540,7392000,2,38726,9683,1,304620800,304620800,14521,4840,9681,4840,0,1,4842,2605774,2.605774
5240,4800,1540,7392000,2,41926,10483,1,324908800,324908800,15721,5240,10481,5240,0,1,5242,5061423,5.061423
5640,4800,1540,7392000,2,45126,11283,1,345196800,345196800,16921,5640,11281,5640,0,1,5642,3523314,3.523314
6040,4800,1540,7392000,2,48326,12083,1,365484800,365484800,18121,6040,12081,6040,0,1,6042,712496,0.712496
6440,4800,1540,7392000,2,51526,12883,1,385772800,385772800,19321,6440,12881,6440,0,1,6442,8898397,8.898397
6840,4800,1540,7392000,2,54726,13683,1,406060800,406060800,20521,6840,13681,6840,0,1,6842,9426812,9.426812
40,3050,2440,7442000,2,326,83,1,61292800,61292800,121,40,81,40,0,1,42,148,0.000148
440,3050,2440,7442000,2,3526,883,1,78860800,78860800,1321,440,881,440,0,1,442,6560,0.00656
840,3050,2440,7442000,2,6726,1683,1,96428800,96428800,2521,840,1681,840,0,1,842,97809,0.097809
1240,3050,2440,7442000,2,9926,2483,1,113996800,113996800,3721,1240,2481,1240,0,1,1242,16274,0.016274
1640,3050,2440,7442000,2,13126,3283,1,131564800,131564800,4921,1640,3281,1640,0,1,1642,556419,0.556419
2040,3050,2440,7442000,2,16326,4083,1,149132800,149132800,6121,2040,4081,2040,0,1,2042,339955,0.339955
2440,3050,2440,7442000,2,19526,4883,1,166700800,166700800,7321,2440,4881,2440,0,1,2442,1361700,1.3617
2840,3050,2440,7442000,2,22726,5683,1,184268800,184268800,8521,2840,5681,2840,0,1,2842,137859,0.137859
3240,3050,2440,7442000,2,25926,6483,1,201836800,201836800,9721,3240,6481,3240,0,1,3242,485194,0.485194
3640,3050,2440,7442000,2,29126,7283,1,219404800,219404800,10921,3640,7281,3640,0,1,3642,948003,0.948003
4040,3050,2440,7442000,2,32326,8083,1,236972800,236972800,12121,4040,8081,4040,0,1,4042,333316,0.333316
4440,3050,2440,7442000,2,35526,8883,1,254540800,254540800,13321,4440,8881,4440,0,1,4442,627855,0.627855
4840,3050,2440,7442000,2,38726,9683,1,272108800,272108800,14521,4840,9681,4840,0,1,4842,1537034,1.537034
5240,3050,2440,7442000,2,41926,10483,1,289676800,289676800,15721,5240,10481,5240,0,1,5242,166156,0.166156
5640,3050,2440,7442000,2,45126,11283,1,307244800,307244800,16921,5640,11281,5640,0,1,5642,905446,0.905446
6040,3050,2440,7442000,2,48326,12083,1,324812800,324812800,18121,6040,12081,6040,0,1,6042,1365455,1.365455
6440,3050,2440,7442000,2,51526,12883,1,342380800,342380800,19321,6440,12881,6440,0,1,6442,246596,0.246596
6840,3050,2440,7442000,2,54726,13683,1,359948800,359948800,20521,6840,13681,6840,0,1,6842,243043,0.243043
40,4050,1840,7452000,2,326,83,1,61500800,61500800,121,40,81,40,0,1,42,15698,0.015698
440,4050,1840,7452000,2,3526,883,1,80348800,80348800,1321,440,881,440,0,1,442,6012,0.006012
840,4050,1840,7452000,2,6726,1683,1,99196800,99196800,2521,840,1681,840,0,1,842,158805,0.158805
1240,4050,1840,7452000,2,9926,2483,1,118044800,118044800,3721,1240,2481,1240,0,1,1242,75619,0.075619
1640,4050,1840,7452000,2,13126,3283,1,136892800,136892800,4921,1640,3281,1640,0,1,1642,553105,0.553105
2040,4050,1840,7452000,2,16326,4083,1,155740800,155740800,6121,2040,4081,2040,0,1,2042,9324,0.009324
2440,4050,1840,7452000,2,19526,4883,1,174588800,174588800,7321,2440,4881,2440,0,1,2442,604492,0.604492
2840,4050,1840,7452000,2,22726,5683,1,193436800,193436800,8521,2840,5681,2840,0,1,2842,480057,0.480057
3240,4050,1840,7452000,2,25926,6483,1,212284800,212284800,9721,3240,6481,3240,0,1,3242,569267,0.569267
3640,4050,1840,7452000,2,29126,7283,1,231132800,231132800,10921,3640,7281,3640,0,1,3642,315358,0.315358
4040,4050,1840,7452000,2,32326,8083,1,249980800,249980800,12121,4040,8081,4040,0,1,4042,150545,0.150545
4440,4050,1840,7452000,2,35526,8883,1,268828800,268828800,13321,4440,8881,4440,0,1,4442,775347,0.775347
4840,4050,1840,7452000,2,38726,9683,1,287676800,287676800,14521,4840,9681,4840,0,1,4842,1685799,1.685799
5240,4050,1840,7452000,2,41926,10483,1,306524800,306524800,15721,5240,10481,5240,0,1,5242,178902,0.178902
5640,4050,1840,7452000,2,45126,11283,1,325372800,325372800,16921,5640,11281,5640,0,1,5642,375132,0.375132
6040,4050,1840,7452000,2,48326,12083,1,344220800,344220800,18121,6040,12081,6040,0,1,6042,2201167,2.201167
6440,4050,1840,7452000,2,51526,12883,1,363068800,363068800,19321,6440,12881,6440,0,1,6442,1117639,1.117639
6840,4050,1840,7452000,2,54726,13683,1,381916800,381916800,20521,6840,13681,6840,0,1,6842,1535349,1.535349
35,1140,6545,7461300,2,286,73,1,61842200,61842200,106,35,71,35,0,1,37,140473,0.140473
535,1140,6545,7461300,2,4286,1073,1,92582200,92582200,1606,535,1071,535,0,1,537,804654,0.804654
1035,1140,6545,7461300,2,8286,2073,1,123322200,123322200,3106,1035,2071,1035,0,1,1037,1488953,1.488953
1535,1140,6545,7461300,2,12286,3073,1,154062200,154062200,4606,1535,3071,1535,0,1,1537,2204596,2.204596
2035,1140,6545,7461300,2,16286,4073,1,184802200,184802200,6106,2035,4071,2035,0,1,2037,2903826,2.903826
2535,1140,6545,7461300,2,20286,5073,1,215542200,215542200,7606,2535,5071,2535,0,1,2537,3605466,3.605466
3035,1140,6545,7461300,2,24286,6073,1,246282200,246282200,9106,3035,6071,3035,0,1,3037,4308463,4.308463
3535,1140,6545,7461300,2,28286,7073,1,277022200,277022200,10606,3535,7071,3535,0,1,3537,5022854,5.022854
4035,1140,6545,7461300,2,32286,8073,1,307762200,307762200,12106,4035,8071,4035,0,1,4037,5719688,5.719688
40,2050,3640,7462000,2,326,83,1,61516800,61516800,121,40,81,40,0,1,42,17273,0.017273
440,2050,3640,7462000,2,3526,883,1,79724800,79724800,1321,440,881,440,0,1,442,6521,0.006521
840,2050,3640,7462000,2,6726,1683,1,97932800,97932800,2521,840,1681,840,0,1,842,66560,0.06656
1240,2050,3640,7462000,2,9926,2483,1,116140800,116140800,3721,1240,2481,1240,0,1,1242,63957,0.063957
1640,2050,3640,7462000,2,13126,3283,1,134348800,134348800,4921,1640,3281,1640,0,1,1642,430182,0.430182
2040,2050,3640,7462000,2,16326,4083,1,152556800,152556800,6121,2040,4081,2040,0,1,2042,244880,0.24488
2440,2050,3640,7462000,2,19526,4883,1,170764800,170764800,7321,2440,4881,2440,0,1,2442,106935,0.106935
2840,2050,3640,7462000,2,22726,5683,1,188972800,188972800,8521,2840,5681,2840,0,1,2842,8697,0.008697
3240,2050,3640,7462000,2,25926,6483,1,207180800,207180800,9721,3240,6481,3240,0,1,3242,943758,0.943758
3640,2050,3640,7462000,2,29126,7283,1,225388800,225388800,10921,3640,7281,3640,0,1,3642,1155769,1.155769
4040,2050,3640,7462000,2,32326,8083,1,243596800,243596800,12121,4040,8081,4040,0,1,4042,776125,0.776125
4440,2050,3640,7462000,2,35526,8883,1,261804800,261804800,13321,4440,8881,4440,0,1,4442,150501,0.150501
4840,2050,3640,7462000,2,38726,9683,1,280012800,280012800,14521,4840,9681,4840,0,1,4842,37795,0.037795
40,1300,5740,7462000,2,326,83,1,61948800,61948800,121,40,81,40,0,1,42,70132,0.070132
440,1300,5740,7462000,2,3526,883,1,84476800,84476800,1321,440,881,440,0,1,442,70889,0.070889
5240,2050,3640,7462000,2,41926,10483,1,298220800,298220800,15721,5240,10481,5240,0,1,5242,379026,0.379026
840,1300,5740,7462000,2,6726,1683,1,107004800,107004800,2521,840,1681,840,0,1,842,594566,0.594566
1240,1300,5740,7462000,2,9926,2483,1,129532800,129532800,3721,1240,2481,1240,0,1,1242,116856,0.116856
1640,1300,5740,7462000,2,13126,3283,1,152060800,152060800,4921,1640,3281,1640,0,1,1642,215552,0.215552
2040,1300,5740,7462000,2,16326,4083,1,174588800,174588800,6121,2040,4081,2040,0,1,2042,237782,0.237782
2440,1300,5740,7462000,2,19526,4883,1,197116800,197116800,7321,2440,4881,2440,0,1,2442,872731,0.872731
5640,2050,3640,7462000,2,45126,11283,1,316428800,316428800,16921,5640,11281,5640,0,1,5642,225935,0.225935
2840,1300,5740,7462000,2,22726,5683,1,219644800,219644800,8521,2840,5681,2840,0,1,2842,859688,0.859688
3240,1300,5740,7462000,2,25926,6483,1,242172800,242172800,9721,3240,6481,3240,0,1,3242,1072981,1.072981
3640,1300,5740,7462000,2,29126,7283,1,264700800,264700800,10921,3640,7281,3640,0,1,3642,3084122,3.084122
6040,2050,3640,7462000,2,48326,12083,1,334636800,334636800,18121,6040,12081,6040,0,1,6042,242771,0.242771
4040,1300,5740,7462000,2,32326,8083,1,287228800,287228800,12121,4040,8081,4040,0,1,4042,3008311,3.008311
4440,1300,5740,7462000,2,35526,8883,1,309756800,309756800,13321,4440,8881,4440,0,1,4442,2208162,2.208162
6440,2050,3640,7462000,2,51526,12883,1,352844800,352844800,19321,6440,12881,6440,0,1,6442,248318,0.248318
4840,1300,5740,7462000,2,38726,9683,1,332284800,332284800,14521,4840,9681,4840,0,1,4842,663180,0.66318
5240,1300,5740,7462000,2,41926,10483,1,354812800,354812800,15721,5240,10481,5240,0,1,5242,464007,0.464007
6840,2050,3640,7462000,2,54726,13683,1,371052800,371052800,20521,6840,13681,6840,0,1,6842,3611035,3.611035
5640,1300,5740,7462000,2,45126,11283,1,377340800,377340800,16921,5640,11281,5640,0,1,5642,3304096,3.304096
6040,1300,5740,7462000,2,48326,12083,1,399868800,399868800,18121,6040,12081,6040,0,1,6042,705585,0.705585
6440,1300,5740,7462000,2,51526,12883,1,422396800,422396800,19321,6440,12881,6440,0,1,6442,858866,0.858866
6840,1300,5740,7462000,2,54726,13683,1,444924800,444924800,20521,6840,13681,6840,0,1,6842,230611,0.230611
39,1143,6541,7476363,2,318,81,1,62208312,62208312,118,39,79,39,0,1,41,20628,0.020628
539,1143,6541,7476363,2,4318,1081,1,92944312,92944312,1618,539,1079,539,0,1,541,63956,0.063956
1039,1143,6541,7476363,2,8318,2081,1,123680312,123680312,3118,1039,2079,1039,0,1,1041,100207,0.100207
1539,1143,6541,7476363,2,12318,3081,1,154416312,154416312,4618,1539,3079,1539,0,1,1541,157034,0.157034
2039,1143,6541,7476363,2,16318,4081,1,185152312,185152312,6118,2039,4079,2039,0,1,2041,292568,0.292568
2539,1143,6541,7476363,2,20318,5081,1,215888312,215888312,7618,2539,5079,2539,0,1,2541,205206,0.205206
3039,1143,6541,7476363,2,24318,6081,1,246624312,246624312,9118,3039,6079,3039,0,1,3041,1356729,1.356729
3539,1143,6541,7476363,2,28318,7081,1,277360312,277360312,10618,3539,7079,3539,0,1,3541,1265660,1.26566
4039,1143,6541,7476363,2,32318,8081,1,308096312,308096312,12118,4039,8079,4039,0,1,4041,293249,0.293249
4539,1143,6541,7476363,2,36318,9081,1,338832312,338832312,13618,4539,9079,4539,0,1,4541,742173,0.742173
5039,1143,6541,7476363,2,40318,10081,1,369568312,369568312,15118,5039,10079,5039,0,1,5041,606777,0.606777
5539,1143,6541,7476363,2,44318,11081,1,400304312,400304312,16618,5539,11079,5539,0,1,5541,242906,0.242906
6039,1143,6541,7476363,2,48318,12081,1,431040312,431040312,18118,6039,12079,6039,0,1,6041,2464112,2.464112
6539,1143,6541,7476363,2,52318,13081,1,461776312,461776312,19618,6539,13079,6539,0,1,6541,3380546,3.380546
7039,1143,6541,7476363,2,56318,14081,1,492512312,492512312,21118,7039,14079,7039,0,1,7041,2989552,2.989552
40,1550,4840,7502000,2,326,83,1,62060800,62060800,121,40,81,40,0,1,42,140230,0.14023
440,1550,4840,7502000,2,3526,883,1,82508800,82508800,1321,440,881,440,0,1,442,690077,0.690077
840,1550,4840,7502000,2,6726,1683,1,102956800,102956800,2521,840,1681,840,0,1,842,880371,0.880371
1240,1550,4840,7502000,2,9926,2483,1,123404800,123404800,3721,1240,2481,1240,0,1,1242,1826695,1.826695
1640,1550,4840,7502000,2,13126,3283,1,143852800,143852800,4921,1640,3281,1640,0,1,1642,808991,0.808991
2040,1550,4840,7502000,2,16326,4083,1,164300800,164300800,6121,2040,4081,2040,0,1,2042,111442,0.111442
2440,1550,4840,7502000,2,19526,4883,1,184748800,184748800,7321,2440,4881,2440,0,1,2442,2543632,2.543632
2840,1550,4840,7502000,2,22726,5683,1,205196800,205196800,8521,2840,5681,2840,0,1,2842,1585830,1.58583
3240,1550,4840,7502000,2,25926,6483,1,225644800,225644800,9721,3240,6481,3240,0,1,3242,55810,0.05581
3640,1550,4840,7502000,2,29126,7283,1,246092800,246092800,10921,3640,7281,3640,0,1,3642,3254633,3.254633
4040,1550,4840,7502000,2,32326,8083,1,266540800,266540800,12121,4040,8081,4040,0,1,4042,142544,0.142544
4440,1550,4840,7502000,2,35526,8883,1,286988800,286988800,13321,4440,8881,4440,0,1,4442,629118,0.629118
4840,1550,4840,7502000,2,38726,9683,1,307436800,307436800,14521,4840,9681,4840,0,1,4842,1779550,1.77955
5240,1550,4840,7502000,2,41926,10483,1,327884800,327884800,15721,5240,10481,5240,0,1,5242,3777609,3.777609
5640,1550,4840,7502000,2,45126,11283,1,348332800,348332800,16921,5640,11281,5640,0,1,5642,2288033,2.288033
6040,1550,4840,7502000,2,48326,12083,1,368780800,368780800,18121,6040,12081,6040,0,1,6042,3460069,3.460069
6440,1550,4840,7502000,2,51526,12883,1,389228800,389228800,19321,6440,12881,6440,0,1,6442,100867,0.100867
6840,1550,4840,7502000,2,54726,13683,1,409676800,409676800,20521,6840,13681,6840,0,1,6842,1187231,1.187231
40,6050,1240,7502000,2,326,83,1,62348800,62348800,121,40,81,40,0,1,42,136819,0.136819
440,6050,1240,7502000,2,3526,883,1,85676800,85676800,1321,440,881,440,0,1,442,139952,0.139952
840,6050,1240,7502000,2,6726,1683,1,109004800,109004800,2521,840,1681,840,0,1,842,1224891,1.224891
1240,6050,1240,7502000,2,9926,2483,1,132332800,132332800,3721,1240,2481,1240,0,1,1242,553636,0.553636
1640,6050,1240,7502000,2,13126,3283,1,155660800,155660800,4921,1640,3281,1640,0,1,1642,1962149,1.962149
2040,6050,1240,7502000,2,16326,4083,1,178988800,178988800,6121,2040,4081,2040,0,1,2042,793312,0.793312
2440,6050,1240,7502000,2,19526,4883,1,202316800,202316800,7321,2440,4881,2440,0,1,2442,3418435,3.418435
2840,6050,1240,7502000,2,22726,5683,1,225644800,225644800,8521,2840,5681,2840,0,1,2842,1552511,1.552511
3240,6050,1240,7502000,2,25926,6483,1,248972800,248972800,9721,3240,6481,3240,0,1,3242,694421,0.694421
3640,6050,1240,7502000,2,29126,7283,1,272300800,272300800,10921,3640,7281,3640,0,1,3642,2690100,2.6901
4040,6050,1240,7502000,2,32326,8083,1,295628800,295628800,12121,4040,8081,4040,0,1,4042,54993,0.054993
4440,6050,1240,7502000,2,35526,8883,1,318956800,318956800,13321,4440,8881,4440,0,1,4442,739073,0.739073
4840,6050,1240,7502000,2,38726,9683,1,342284800,342284800,14521,4840,9681,4840,0,1,4842,1246401,1.246401
5240,6050,1240,7502000,2,41926,10483,1,365612800,365612800,15721,5240,10481,5240,0,1,5242,7335043,7.335043
5640,6050,1240,7502000,2,45126,11283,1,388940800,388940800,16921,5640,11281,5640,0,1,5642,2273775,2.273775
6040,6050,1240,7502000,2,48326,12083,1,412268800,412268800,18121,6040,12081,6040,0,1,6042,2182288,2.182288
6440,6050,1240,7502000,2,51526,12883,1,435596800,435596800,19321,6440,12881,6440,0,1,6442,2093846,2.093846
6840,6050,1240,7502000,2,54726,13683,1,458924800,458924800,20521,6840,13681,6840,0,1,6842,4066482,4.066482
55,4805,1565,7519825,2,446,113,1,62961400,62961400,166,55,111,55,0,1,57,148416,0.148416
455,4805,1565,7519825,2,3646,913,1,83345400,83345400,1366,455,911,455,0,1,457,695631,0.695631
855,4805,1565,7519825,2,6846,1713,1,103729400,103729400,2566,855,1711,855,0,1,857,1267352,1.267352
1255,4805,1565,7519825,2,10046,2513,1,124113400,124113400,3766,1255,2511,1255,0,1,1257,1830846,1.830846
1655,4805,1565,7519825,2,13246,3313,1,144497400,144497400,4966,1655,3311,1655,0,1,1657,1140087,1.140087
2055,4805,1565,7519825,2,16446,4113,1,164881400,164881400,6166,2055,4111,2055,0,1,2057,2940358,2.940358
2455,4805,1565,7519825,2,19646,4913,1,185265400,185265400,7366,2455,4911,2455,0,1,2457,3263803,3.263803
2855,4805,1565,7519825,2,22846,5713,1,205649400,205649400,8566,2855,5711,2855,0,1,2857,4072332,4.072332
3255,4805,1565,7519825,2,26046,6513,1,226033400,226033400,9766,3255,6511,3255,0,1,3257,1861899,1.861899
3655,4805,1565,7519825,2,29246,7313,1,246417400,246417400,10966,3655,7311,3655,0,1,3657,4407110,4.40711
4055,4805,1565,7519825,2,32446,8113,1,266801400,266801400,12166,4055,8111,4055,0,1,4057,3311614,3.311614
4455,4805,1565,7519825,2,35646,8913,1,287185400,287185400,13366,4455,8911,4455,0,1,4457,5844742,5.844742
4855,4805,1565,7519825,2,38846,9713,1,307569400,307569400,14566,4855,9711,4855,0,1,4857,6896916,6.896916
5255,4805,1565,7519825,2,42046,10513,1,327953400,327953400,15766,5255,10511,5255,0,1,5257,1320293,1.320293
5655,4805,1565,7519825,2,45246,11313,1,348337400,348337400,16966,5655,11311,5655,0,1,5657,8098597,8.098597
6055,4805,1565,7519825,2,48446,12113,1,368721400,368721400,18166,6055,12111,6055,0,1,6057,8599069,8.599069
6455,4805,1565,7519825,2,51646,12913,1,389105400,389105400,19366,6455,12911,6455,0,1,6457,4735022,4.735022
6855,4805,1565,7519825,2,54846,13713,1,409489400,409489400,20566,6855,13711,6855,0,1,6857,9743440,9.74344
55,1305,5765,7523325,2,446,113,1,63297400,63297400,166,55,111,55,0,1,57,152575,0.152575
455,1305,5765,7523325,2,3646,913,1,85921400,85921400,1366,455,911,455,0,1,457,726877,0.726877
855,1305,5765,7523325,2,6846,1713,1,108545400,108545400,2566,855,1711,855,0,1,857,627249,0.627249
1255,1305,5765,7523325,2,10046,2513,1,131169400,131169400,3766,1255,2511,1255,0,1,1257,497655,0.497655
1655,1305,5765,7523325,2,13246,3313,1,153793400,153793400,4966,1655,3311,1655,0,1,1657,729644,0.729644
2055,1305,5765,7523325,2,16446,4113,1,176417400,176417400,6166,2055,4111,2055,0,1,2057,432503,0.432503
2455,1305,5765,7523325,2,19646,4913,1,199041400,199041400,7366,2455,4911,2455,0,1,2457,1061201,1.061201
2855,1305,5765,7523325,2,22846,5713,1,221665400,221665400,8566,2855,5711,2855,0,1,2857,946329,0.946329
3255,1305,5765,7523325,2,26046,6513,1,244289400,244289400,9766,3255,6511,3255,0,1,3257,1634576,1.634576
3655,1305,5765,7523325,2,29246,7313,1,266913400,266913400,10966,3655,7311,3655,0,1,3657,758536,0.758536
4055,1305,5765,7523325,2,32446,8113,1,289537400,289537400,12166,4055,8111,4055,0,1,4057,199496,0.199496
4455,1305,5765,7523325,2,35646,8913,1,312161400,312161400,13366,4455,8911,4455,0,1,4457,36491,0.036491
4855,1305,5765,7523325,2,38846,9713,1,334785400,334785400,14566,4855,9711,4855,0,1,4857,1608834,1.608834
5255,1305,5765,7523325,2,42046,10513,1,357409400,357409400,15766,5255,10511,5255,0,1,5257,3192767,3.192767
5655,1305,5765,7523325,2,45246,11313,1,380033400,380033400,16966,5655,11311,5655,0,1,5657,2563385,2.563385
6055,1305,5765,7523325,2,48446,12113,1,402657400,402657400,18166,6055,12111,6055,0,1,6057,312880,0.31288
6455,1305,5765,7523325,2,51646,12913,1,425281400,425281400,19366,6455,12911,6455,0,1,6457,666003,0.666003
6855,1305,5765,7523325,2,54846,13713,1,447905400,447905400,20566,6855,13711,6855,0,1,6857,1862518,1.862518
55,3055,2465,7530575,2,446,113,1,62673400,62673400,166,55,111,55,0,1,57,18182,0.018182
455,3055,2465,7530575,2,3646,913,1,80337400,80337400,1366,455,911,455,0,1,457,82919,0.082919
855,3055,2465,7530575,2,6846,1713,1,98001400,98001400,2566,855,1711,855,0,1,857,24904,0.024904
1255,3055,2465,7530575,2,10046,2513,1,115665400,115665400,3766,1255,2511,1255,0,1,1257,30810,0.03081
1655,3055,2465,7530575,2,13246,3313,1,133329400,133329400,4966,1655,3311,1655,0,1,1657,12255,0.012255
2055,3055,2465,7530575,2,16446,4113,1,150993400,150993400,6166,2055,4111,2055,0,1,2057,214229,0.214229
2455,3055,2465,7530575,2,19646,4913,1,168657400,168657400,7366,2455,4911,2455,0,1,2457,990833,0.990833
2855,3055,2465,7530575,2,22846,5713,1,186321400,186321400,8566,2855,5711,2855,0,1,2857,299931,0.299931
3255,3055,2465,7530575,2,26046,6513,1,203985400,203985400,9766,3255,6511,3255,0,1,3257,15385,0.015385
3655,3055,2465,7530575,2,29246,7313,1,221649400,221649400,10966,3655,7311,3655,0,1,3657,497129,0.497129
4055,3055,2465,7530575,2,32446,8113,1,239313400,239313400,12166,4055,8111,4055,0,1,4057,11253,0.011253
4455,3055,2465,7530575,2,35646,8913,1,256977400,256977400,13366,4455,8911,4455,0,1,4457,200927,0.200927
4855,3055,2465,7530575,2,38846,9713,1,274641400,274641400,14566,4855,9711,4855,0,1,4857,734421,0.734421
5255,3055,2465,7530575,2,42046,10513,1,292305400,292305400,15766,5255,10511,5255,0,1,5257,9926,0.009926
5655,3055,2465,7530575,2,45246,11313,1,309969400,309969400,16966,5655,11311,5655,0,1,5657,2486239,2.486239
6055,3055,2465,7530575,2,48446,12113,1,327633400,327633400,18166,6055,12111,6055,0,1,6057,1051859,1.051859
6455,3055,2465,7530575,2,51646,12913,1,345297400,345297400,19366,6455,12911,6455,0,1,6457,663960,0.66396
6855,3055,2465,7530575,2,54846,13713,1,362961400,362961400,20566,6855,13711,6855,0,1,6857,2358849,2.358849
55,2055,3665,7531575,2,446,113,1,62769400,62769400,166,55,111,55,0,1,57,14533,0.014533
455,2055,3665,7531575,2,3646,913,1,81073400,81073400,1366,455,911,455,0,1,457,18127,0.018127
855,2055,3665,7531575,2,6846,1713,1,99377400,99377400,2566,855,1711,855,0,1,857,49876,0.049876
1255,2055,3665,7531575,2,10046,2513,1,117681400,117681400,3766,1255,2511,1255,0,1,1257,296877,0.296877
1655,2055,3665,7531575,2,13246,3313,1,135985400,135985400,4966,1655,3311,1655,0,1,1657,55800,0.0558
2055,2055,3665,7531575,2,16446,4113,1,154289400,154289400,6166,2055,4111,2055,0,1,2057,241753,0.241753
2455,2055,3665,7531575,2,19646,4913,1,172593400,172593400,7366,2455,4911,2455,0,1,2457,27632,0.027632
2855,2055,3665,7531575,2,22846,5713,1,190897400,190897400,8566,2855,5711,2855,0,1,2857,889170,0.88917
3255,2055,3665,7531575,2,26046,6513,1,209201400,209201400,9766,3255,6511,3255,0,1,3257,195080,0.19508
3655,2055,3665,7531575,2,29246,7313,1,227505400,227505400,10966,3655,7311,3655,0,1,3657,1079822,1.079822
4055,2055,3665,7531575,2,32446,8113,1,245809400,245809400,12166,4055,8111,4055,0,1,4057,1197463,1.197463
4455,2055,3665,7531575,2,35646,8913,1,264113400,264113400,13366,4455,8911,4455,0,1,4457,431232,0.431232
4855,2055,3665,7531575,2,38846,9713,1,282417400,282417400,14566,4855,9711,4855,0,1,4857,709239,0.709239
5255,2055,3665,7531575,2,42046,10513,1,300721400,300721400,15766,5255,10511,5255,0,1,5257,381631,0.381631
5655,2055,3665,7531575,2,45246,11313,1,319025400,319025400,16966,5655,11311,5655,0,1,5657,877094,0.877094
6055,2055,3665,7531575,2,48446,12113,1,337329400,337329400,18166,6055,12111,6055,0,1,6057,1958087,1.958087
6455,2055,3665,7531575,2,51646,12913,1,355633400,355633400,19366,6455,12911,6455,0,1,6457,447274,0.447274
6855,2055,3665,7531575,2,54846,13713,1,373937400,373937400,20566,6855,13711,6855,0,1,6857,668939,0.668939
44,1153,6555,7557915,2,358,91,1,63176536,63176536,133,44,89,44,0,1,46,73307,0.073307
544,1153,6555,7557915,2,4358,1091,1,94008536,94008536,1633,544,1089,544,0,1,546,9107,0.009107
1044,1153,6555,7557915,2,8358,2091,1,124840536,124840536,3133,1044,2089,1044,0,1,1046,49879,0.049879
1544,1153,6555,7557915,2,12358,3091,1,155672536,155672536,4633,1544,3089,1544,0,1,1546,385511,0.385511
2044,1153,6555,7557915,2,16358,4091,1,186504536,186504536,6133,2044,4089,2044,0,1,2046,52851,0.052851
2544,1153,6555,7557915,2,20358,5091,1,217336536,217336536,7633,2544,5089,2544,0,1,2546,107926,0.107926
3044,1153,6555,7557915,2,24358,6091,1,248168536,248168536,9133,3044,6089,3044,0,1,3046,300820,0.30082
3544,1153,6555,7557915,2,28358,7091,1,279000536,279000536,10633,3544,7089,3544,0,1,3546,716801,0.716801
4044,1153,6555,7557915,2,32358,8091,1,309832536,309832536,12133,4044,8089,4044,0,1,4046,590084,0.590084
4544,1153,6555,7557915,2,36358,9091,1,340664536,340664536,13633,4544,9089,4544,0,1,4546,133077,0.133077
5044,1153,6555,7557915,2,40358,10091,1,371496536,371496536,15133,5044,10089,5044,0,1,5046,891957,0.891957
5544,1153,6555,7557915,2,44358,11091,1,402328536,402328536,16633,5544,11089,5544,0,1,5546,251337,0.251337
6044,1153,6555,7557915,2,48358,12091,1,433160536,433160536,18133,6044,12089,6044,0,1,6046,1396117,1.396117
6544,1153,6555,7557915,2,52358,13091,1,463992536,463992536,19633,6544,13089,6544,0,1,6546,48557,0.048557
7044,1153,6555,7557915,2,56358,14091,1,494824536,494824536,21133,7044,14089,7044,0,1,7046,889577,0.889577
55,4055,1865,7562575,2,446,113,1,63105400,63105400,166,55,111,55,0,1,57,16897,0.016897
455,4055,1865,7562575,2,3646,913,1,82049400,82049400,1366,455,911,455,0,1,457,5533,0.005533
855,4055,1865,7562575,2,6846,1713,1,100993400,100993400,2566,855,1711,855,0,1,857,82297,0.082297
1255,4055,1865,7562575,2,10046,2513,1,119937400,119937400,3766,1255,2511,1255,0,1,1257,251735,0.251735
1655,4055,1865,7562575,2,13246,3313,1,138881400,138881400,4966,1655,3311,1655,0,1,1657,7767,0.007767
2055,4055,1865,7562575,2,16446,4113,1,157825400,157825400,6166,2055,4111,2055,0,1,2057,337306,0.337306
2455,4055,1865,7562575,2,19646,4913,1,176769400,176769400,7366,2455,4911,2455,0,1,2457,127470,0.12747
2855,4055,1865,7562575,2,22846,5713,1,195713400,195713400,8566,2855,5711,2855,0,1,2857,694623,0.694623
3255,4055,1865,7562575,2,26046,6513,1,214657400,214657400,9766,3255,6511,3255,0,1,3257,1356150,1.35615
3655,4055,1865,7562575,2,29246,7313,1,233601400,233601400,10966,3655,7311,3655,0,1,3657,607898,0.607898
4055,4055,1865,7562575,2,32446,8113,1,252545400,252545400,12166,4055,8111,4055,0,1,4057,2217779,2.217779
4455,4055,1865,7562575,2,35646,8913,1,271489400,271489400,13366,4455,8911,4455,0,1,4457,1437573,1.437573
4855,4055,1865,7562575,2,38846,9713,1,290433400,290433400,14566,4855,9711,4855,0,1,4857,2569196,2.569196
5255,4055,1865,7562575,2,42046,10513,1,309377400,309377400,15766,5255,10511,5255,0,1,5257,15721,0.015721
5655,4055,1865,7562575,2,45246,11313,1,328321400,328321400,16966,5655,11311,5655,0,1,5657,146122,0.146122
6055,4055,1865,7562575,2,48446,12113,1,347265400,347265400,18166,6055,12111,6055,0,1,6057,890382,0.890382
6455,4055,1865,7562575,2,51646,12913,1,366209400,366209400,19366,6455,12911,6455,0,1,6457,563836,0.563836
6855,4055,1865,7562575,2,54846,13713,1,385153400,385153400,20566,6855,13711,6855,0,1,6857,3398701,3.398701
55,1555,4865,7565075,2,446,113,1,63345400,63345400,166,55,111,55,0,1,57,155527,0.155527
455,1555,4865,7565075,2,3646,913,1,83889400,83889400,1366,455,911,455,0,1,457,727589,0.727589
855,1555,4865,7565075,2,6846,1713,1,104433400,104433400,2566,855,1711,855,0,1,857,1303678,1.303678
1255,1555,4865,7565075,2,10046,2513,1,124977400,124977400,3766,1255,2511,1255,0,1,1257,1888695,1.888695
1655,1555,4865,7565075,2,13246,3313,1,145521400,145521400,4966,1655,3311,1655,0,1,1657,2477031,2.477031
2055,1555,4865,7565075,2,16446,4113,1,166065400,166065400,6166,2055,4111,2055,0,1,2057,911017,0.911017
2455,1555,4865,7565075,2,19646,4913,1,186609400,186609400,7366,2455,4911,2455,0,1,2457,890289,0.890289
2855,1555,4865,7565075,2,22846,5713,1,207153400,207153400,8566,2855,5711,2855,0,1,2857,4227336,4.227336
3255,1555,4865,7565075,2,26046,6513,1,227697400,227697400,9766,3255,6511,3255,0,1,3257,627841,0.627841
3655,1555,4865,7565075,2,29246,7313,1,248241400,248241400,10966,3655,7311,3655,0,1,3657,1595658,1.595658
4055,1555,4865,7565075,2,32446,8113,1,268785400,268785400,12166,4055,8111,4055,0,1,4057,215423,0.215423
4455,1555,4865,7565075,2,35646,8913,1,289329400,289329400,13366,4455,8911,4455,0,1,4457,386355,0.386355
4855,1555,4865,7565075,2,38846,9713,1,309873400,309873400,14566,4855,9711,4855,0,1,4857,324429,0.324429
5255,1555,4865,7565075,2,42046,10513,1,330417400,330417400,15766,5255,10511,5255,0,1,5257,3690949,3.690949
5655,1555,4865,7565075,2,45246,11313,1,350961400,350961400,16966,5655,11311,5655,0,1,5657,2337759,2.337759
6055,1555,4865,7565075,2,48446,12113,1,371505400,371505400,18166,6055,12111,6055,0,1,6057,84308,0.084308
6455,1555,4865,7565075,2,51646,12913,1,392049400,392049400,19366,6455,12911,6455,0,1,6457,60499,0.060499
6855,1555,4865,7565075,2,54846,13713,1,412593400,412593400,20566,6855,13711,6855,0,1,6857,4947564,4.947564
40,3550,2140,7597000,2,326,83,1,62596800,62596800,121,40,81,40,0,1,42,141578,0.141578
440,3550,2140,7597000,2,3526,883,1,80804800,80804800,1321,440,881,440,0,1,442,702092,0.702092
840,3550,2140,7597000,2,6726,1683,1,99012800,99012800,2521,840,1681,840,0,1,842,1273831,1.273831
1240,3550,2140,7597000,2,9926,2483,1,117220800,117220800,3721,1240,2481,1240,0,1,1242,1853858,1.853858
1640,3550,2140,7597000,2,13126,3283,1,135428800,135428800,4921,1640,3281,1640,0,1,1642,2439439,2.439439
2040,3550,2140,7597000,2,16326,4083,1,153636800,153636800,6121,2040,4081,2040,0,1,2042,3016313,3.016313
2440,3550,2140,7597000,2,19526,4883,1,171844800,171844800,7321,2440,4881,2440,0,1,2442,119190,0.11919
2840,3550,2140,7597000,2,22726,5683,1,190052800,190052800,8521,2840,5681,2840,0,1,2842,26549,0.026549
3240,3550,2140,7597000,2,25926,6483,1,208260800,208260800,9721,3240,6481,3240,0,1,3242,55484,0.055484
3640,3550,2140,7597000,2,29126,7283,1,226468800,226468800,10921,3640,7281,3640,0,1,3642,908969,0.908969
4040,3550,2140,7597000,2,32326,8083,1,244676800,244676800,12121,4040,8081,4040,0,1,4042,383223,0.383223
4440,3550,2140,7597000,2,35526,8883,1,262884800,262884800,13321,4440,8881,4440,0,1,4442,886020,0.88602
4840,3550,2140,7597000,2,38726,9683,1,281092800,281092800,14521,4840,9681,4840,0,1,4842,6537808,6.537808
5240,3550,2140,7597000,2,41926,10483,1,299300800,299300800,15721,5240,10481,5240,0,1,5242,11311,0.011311
5640,3550,2140,7597000,2,45126,11283,1,317508800,317508800,16921,5640,11281,5640,0,1,5642,5431908,5.431908
6040,3550,2140,7597000,2,48326,12083,1,335716800,335716800,18121,6040,12081,6040,0,1,6042,2257951,2.257951
6440,3550,2140,7597000,2,51526,12883,1,353924800,353924800,19321,6440,12881,6440,0,1,6442,1483903,1.483903
6840,3550,2140,7597000,2,54726,13683,1,372132800,372132800,20521,6840,13681,6840,0,1,6842,9979931,9.979931
40,1800,4240,7632000,2,326,83,1,62988800,62988800,121,40,81,40,0,1,42,140480,0.14048
440,1800,4240,7632000,2,3526,883,1,82316800,82316800,1321,440,881,440,0,1,442,701592,0.701592
840,1800,4240,7632000,2,6726,1683,1,101644800,101644800,2521,840,1681,840,0,1,842,431928,0.431928
1240,1800,4240,7632000,2,9926,2483,1,120972800,120972800,3721,1240,2481,1240,0,1,1242,1839299,1.839299
1640,1800,4240,7632000,2,13126,3283,1,140300800,140300800,4921,1640,3281,1640,0,1,1642,1614754,1.614754
2040,1800,4240,7632000,2,16326,4083,1,159628800,159628800,6121,2040,4081,2040,0,1,2042,2986144,2.986144
2440,1800,4240,7632000,2,19526,4883,1,178956800,178956800,7321,2440,4881,2440,0,1,2442,489337,0.489337
2840,1800,4240,7632000,2,22726,5683,1,198284800,198284800,8521,2840,5681,2840,0,1,2842,4132703,4.132703
3240,1800,4240,7632000,2,25926,6483,1,217612800,217612800,9721,3240,6481,3240,0,1,3242,811663,0.811663
3640,1800,4240,7632000,2,29126,7283,1,236940800,236940800,10921,3640,7281,3640,0,1,3642,1378061,1.378061
4040,1800,4240,7632000,2,32326,8083,1,256268800,256268800,12121,4040,8081,4040,0,1,4042,633671,0.633671
4440,1800,4240,7632000,2,35526,8883,1,275596800,275596800,13321,4440,8881,4440,0,1,4442,4979911,4.979911
4840,1800,4240,7632000,2,38726,9683,1,294924800,294924800,14521,4840,9681,4840,0,1,4842,182269,0.182269
5240,1800,4240,7632000,2,41926,10483,1,314252800,314252800,15721,5240,10481,5240,0,1,5242,57849,0.057849
5640,1800,4240,7632000,2,45126,11283,1,333580800,333580800,16921,5640,11281,5640,0,1,5642,119262,0.119262
6040,1800,4240,7632000,2,48326,12083,1,352908800,352908800,18121,6040,12081,6040,0,1,6042,824146,0.824146
6440,1800,4240,7632000,2,51526,12883,1,372236800,372236800,19321,6440,12881,6440,0,1,6442,3523990,3.52399
6840,1800,4240,7632000,2,54726,13683,1,391564800,391564800,20521,6840,13681,6840,0,1,6842,242118,0.242118
35,4950,1545,7647750,2,286,73,1,63000600,63000600,106,35,71,35,0,1,37,15806,0.015806
535,4950,1545,7647750,2,4286,1073,1,88980600,88980600,1606,535,1071,535,0,1,537,295525,0.295525
1035,4950,1545,7647750,2,8286,2073,1,114960600,114960600,3106,1035,2071,1035,0,1,1037,170708,0.170708
1535,4950,1545,7647750,2,12286,3073,1,140940600,140940600,4606,1535,3071,1535,0,1,1537,2199455,2.199455
2035,4950,1545,7647750,2,16286,4073,1,166920600,166920600,6106,2035,4071,2035,0,1,2037,3060296,3.060296
2535,4950,1545,7647750,2,20286,5073,1,192900600,192900600,7606,2535,5071,2535,0,1,2537,3370819,3.370819
3035,4950,1545,7647750,2,24286,6073,1,218880600,218880600,9106,3035,6071,3035,0,1,3037,2899024,2.899024
3535,4950,1545,7647750,2,28286,7073,1,244860600,244860600,10606,3535,7071,3535,0,1,3537,5305977,5.305977
4035,4950,1545,7647750,2,32286,8073,1,270840600,270840600,12106,4035,8071,4035,0,1,4037,6070588,6.070588
4535,4950,1545,7647750,2,36286,9073,1,296820600,296820600,13606,4535,9071,4535,0,1,4537,3818441,3.818441
5035,4950,1545,7647750,2,40286,10073,1,322800600,322800600,15106,5035,10071,5035,0,1,5037,507846,0.507846
5535,4950,1545,7647750,2,44286,11073,1,348780600,348780600,16606,5535,11071,5535,0,1,5537,3347796,3.347796
6035,4950,1545,7647750,2,48286,12073,1,374760600,374760600,18106,6035,12071,6035,0,1,6037,7042001,7.042001
6535,4950,1545,7647750,2,52286,13073,1,400740600,400740600,19606,6535,13071,6535,0,1,6537,517926,0.517926
7035,4950,1545,7647750,2,56286,14073,1,426720600,426720600,21106,7035,14071,7035,0,1,7037,2246174,2.246174
55,6055,1265,7659575,2,446,113,1,64497400,64497400,166,55,111,55,0,1,57,19697,0.019697
455,6055,1265,7659575,2,3646,913,1,87921400,87921400,1366,455,911,455,0,1,457,718945,0.718945
855,6055,1265,7659575,2,6846,1713,1,111345400,111345400,2566,855,1711,855,0,1,857,280730,0.28073
1255,6055,1265,7659575,2,10046,2513,1,134769400,134769400,3766,1255,2511,1255,0,1,1257,1876965,1.876965
1655,6055,1265,7659575,2,13246,3313,1,158193400,158193400,4966,1655,3311,1655,0,1,1657,35355,0.035355
2055,6055,1265,7659575,2,16446,4113,1,181617400,181617400,6166,2055,4111,2055,0,1,2057,3040999,3.040999
2455,6055,1265,7659575,2,19646,4913,1,205041400,205041400,7366,2455,4911,2455,0,1,2457,240706,0.240706
2855,6055,1265,7659575,2,22846,5713,1,228465400,228465400,8566,2855,5711,2855,0,1,2857,115061,0.115061
3255,6055,1265,7659575,2,26046,6513,1,251889400,251889400,9766,3255,6511,3255,0,1,3257,654083,0.654083
3655,6055,1265,7659575,2,29246,7313,1,275313400,275313400,10966,3655,7311,3655,0,1,3657,718868,0.718868
4055,6055,1265,7659575,2,32446,8113,1,298737400,298737400,12166,4055,8111,4055,0,1,4057,60177,0.060177
4455,6055,1265,7659575,2,35646,8913,1,322161400,322161400,13366,4455,8911,4455,0,1,4457,2281474,2.281474
4855,6055,1265,7659575,2,38846,9713,1,345585400,345585400,14566,4855,9711,4855,0,1,4857,445997,0.445997
5255,6055,1265,7659575,2,42046,10513,1,369009400,369009400,15766,5255,10511,5255,0,1,5257,1772812,1.772812
5655,6055,1265,7659575,2,45246,11313,1,392433400,392433400,16966,5655,11311,5655,0,1,5657,841316,0.841316
6055,6055,1265,7659575,2,48446,12113,1,415857400,415857400,18166,6055,12111,6055,0,1,6057,320479,0.320479
6455,6055,1265,7659575,2,51646,12913,1,439281400,439281400,19366,6455,12911,6455,0,1,6457,2473243,2.473243
6855,6055,1265,7659575,2,54846,13713,1,462705400,462705400,20566,6855,13711,6855,0,1,6857,2881804,2.881804
40,2800,2740,7672000,2,326,83,1,63148800,63148800,121,40,81,40,0,1,42,138959,0.138959
440,2800,2740,7672000,2,3526,883,1,80876800,80876800,1321,440,881,440,0,1,442,317232,0.317232
840,2800,2740,7672000,2,6726,1683,1,98604800,98604800,2521,840,1681,840,0,1,842,1259511,1.259511
1240,2800,2740,7672000,2,9926,2483,1,116332800,116332800,3721,1240,2481,1240,0,1,1242,249173,0.249173
1640,2800,2740,7672000,2,13126,3283,1,134060800,134060800,4921,1640,3281,1640,0,1,1642,707425,0.707425
2040,2800,2740,7672000,2,16326,4083,1,151788800,151788800,6121,2040,4081,2040,0,1,2042,2972540,2.97254
2440,2800,2740,7672000,2,19526,4883,1,169516800,169516800,7321,2440,4881,2440,0,1,2442,1499327,1.499327
2840,2800,2740,7672000,2,22726,5683,1,187244800,187244800,8521,2840,5681,2840,0,1,2842,1268534,1.268534
3240,2800,2740,7672000,2,25926,6483,1,204972800,204972800,9721,3240,6481,3240,0,1,3242,2837759,2.837759
3640,2800,2740,7672000,2,29126,7283,1,222700800,222700800,10921,3640,7281,3640,0,1,3642,3511919,3.511919
4040,2800,2740,7672000,2,32326,8083,1,240428800,240428800,12121,4040,8081,4040,0,1,4042,4171486,4.171486
4440,2800,2740,7672000,2,35526,8883,1,258156800,258156800,13321,4440,8881,4440,0,1,4442,381341,0.381341
4840,2800,2740,7672000,2,38726,9683,1,275884800,275884800,14521,4840,9681,4840,0,1,4842,7003926,7.003926
5240,2800,2740,7672000,2,41926,10483,1,293612800,293612800,15721,5240,10481,5240,0,1,5242,43463,0.043463
5640,2800,2740,7672000,2,45126,11283,1,311340800,311340800,16921,5640,11281,5640,0,1,5642,3236681,3.236681
6040,2800,2740,7672000,2,48326,12083,1,329068800,329068800,18121,6040,12081,6040,0,1,6042,141924,0.141924
6440,2800,2740,7672000,2,51526,12883,1,346796800,346796800,19321,6440,12881,6440,0,1,6442,2228966,2.228966
6840,2800,2740,7672000,2,54726,13683,1,364524800,364524800,20521,6840,13681,6840,0,1,6842,1304575,1.304575
40,2300,3340,7682000,2,326,83,1,63260800,63260800,121,40,81,40,0,1,42,143449,0.143449
440,2300,3340,7682000,2,3526,883,1,81308800,81308800,1321,440,881,440,0,1,442,706014,0.706014
840,2300,3340,7682000,2,6726,1683,1,99356800,99356800,2521,840,1681,840,0,1,842,1272650,1.27265
1240,2300,3340,7682000,2,9926,2483,1,117404800,117404800,3721,1240,2481,1240,0,1,1242,941416,0.941416
1640,2300,3340,7682000,2,13126,3283,1,135452800,135452800,4921,1640,3281,1640,0,1,1642,107292,0.107292
2040,2300,3340,7682000,2,16326,4083,1,153500800,153500800,6121,2040,4081,2040,0,1,2042,158579,0.158579
2440,2300,3340,7682000,2,19526,4883,1,171548800,171548800,7321,2440,4881,2440,0,1,2442,3556767,3.556767
2840,2300,3340,7682000,2,22726,5683,1,189596800,189596800,8521,2840,5681,2840,0,1,2842,2515465,2.515465
3240,2300,3340,7682000,2,25926,6483,1,207644800,207644800,9721,3240,6481,3240,0,1,3242,851102,0.851102
3640,2300,3340,7682000,2,29126,7283,1,225692800,225692800,10921,3640,7281,3640,0,1,3642,3817471,3.817471
4040,2300,3340,7682000,2,32326,8083,1,243740800,243740800,12121,4040,8081,4040,0,1,4042,2771559,2.771559
4440,2300,3340,7682000,2,35526,8883,1,261788800,261788800,13321,4440,8881,4440,0,1,4442,275123,0.275123
4840,2300,3340,7682000,2,38726,9683,1,279836800,279836800,14521,4840,9681,4840,0,1,4842,6347461,6.347461
5240,2300,3340,7682000,2,41926,10483,1,297884800,297884800,15721,5240,10481,5240,0,1,5242,593259,0.593259
5640,2300,3340,7682000,2,45126,11283,1,315932800,315932800,16921,5640,11281,5640,0,1,5642,868412,0.868412
6040,2300,3340,7682000,2,48326,12083,1,333980800,333980800,18121,6040,12081,6040,0,1,6042,485544,0.485544
6440,2300,3340,7682000,2,51526,12883,1,352028800,352028800,19321,6440,12881,6440,0,1,6442,7464291,7.464291
6840,2300,3340,7682000,2,54726,13683,1,370076800,370076800,20521,6840,13681,6840,0,1,6842,171823,0.171823
39,1693,4541,7687913,2,318,81,1,63448312,63448312,118,39,79,39,0,1,41,136473,0.136473
539,1693,4541,7687913,2,4318,1081,1,88384312,88384312,1618,539,1079,539,0,1,541,868302,0.868302
1039,1693,4541,7687913,2,8318,2081,1,113320312,113320312,3118,1039,2079,1039,0,1,1041,139737,0.139737
1539,1693,4541,7687913,2,12318,3081,1,138256312,138256312,4618,1539,3079,1539,0,1,1541,41266,0.041266
2039,1693,4541,7687913,2,16318,4081,1,163192312,163192312,6118,2039,4079,2039,0,1,2041,983717,0.983717
2539,1693,4541,7687913,2,20318,5081,1,188128312,188128312,7618,2539,5079,2539,0,1,2541,3838643,3.838643
3039,1693,4541,7687913,2,24318,6081,1,213064312,213064312,9118,3039,6079,3039,0,1,3041,53785,0.053785
3539,1693,4541,7687913,2,28318,7081,1,238000312,238000312,10618,3539,7079,3539,0,1,3541,2958414,2.958414
4039,1693,4541,7687913,2,32318,8081,1,262936312,262936312,12118,4039,8079,4039,0,1,4041,2315686,2.315686
4539,1693,4541,7687913,2,36318,9081,1,287872312,287872312,13618,4539,9079,4539,0,1,4541,1069012,1.069012
5039,1693,4541,7687913,2,40318,10081,1,312808312,312808312,15118,5039,10079,5039,0,1,5041,1650034,1.650034
5539,1693,4541,7687913,2,44318,11081,1,337744312,337744312,16618,5539,11079,5539,0,1,5541,1095582,1.095582
6039,1693,4541,7687913,2,48318,12081,1,362680312,362680312,18118,6039,12079,6039,0,1,6041,3663602,3.663602
6539,1693,4541,7687913,2,52318,13081,1,387616312,387616312,19618,6539,13079,6539,0,1,6541,2251721,2.251721
7039,1693,4541,7687913,2,56318,14081,1,412552312,412552312,21118,7039,14079,7039,0,1,7041,184251,0.184251
39,4993,1541,7694213,2,318,81,1,63592312,63592312,118,39,79,39,0,1,41,44166,0.044166
539,4993,1541,7694213,2,4318,1081,1,89728312,89728312,1618,539,1079,539,0,1,541,837432,0.837432
1039,4993,1541,7694213,2,8318,2081,1,115864312,115864312,3118,1039,2079,1039,0,1,1041,1554888,1.554888
1539,4993,1541,7694213,2,12318,3081,1,142000312,142000312,4618,1539,3079,1539,0,1,1541,2273045,2.273045
2039,4993,1541,7694213,2,16318,4081,1,168136312,168136312,6118,2039,4079,2039,0,1,2041,2993262,2.993262
2539,4993,1541,7694213,2,20318,5081,1,194272312,194272312,7618,2539,5079,2539,0,1,2541,2042961,2.042961
3039,4993,1541,7694213,2,24318,6081,1,220408312,220408312,9118,3039,6079,3039,0,1,3041,2472114,2.472114
3539,4993,1541,7694213,2,28318,7081,1,246544312,246544312,10618,3539,7079,3539,0,1,3541,5166796,5.166796
4039,4993,1541,7694213,2,32318,8081,1,272680312,272680312,12118,4039,8079,4039,0,1,4041,5892944,5.892944
4539,4993,1541,7694213,2,36318,9081,1,298816312,298816312,13618,4539,9079,4539,0,1,4541,6575948,6.575948
5039,4993,1541,7694213,2,40318,10081,1,324952312,324952312,15118,5039,10079,5039,0,1,5041,2535578,2.535578
5539,4993,1541,7694213,2,44318,11081,1,351088312,351088312,16618,5539,11079,5539,0,1,5541,2056217,2.056217
6039,4993,1541,7694213,2,48318,12081,1,377224312,377224312,18118,6039,12079,6039,0,1,6041,8754279,8.754279
6539,4993,1541,7694213,2,52318,13081,1,403360312,403360312,19618,6539,13079,6539,0,1,6541,9476484,9.476484
7039,4993,1541,7694213,2,56318,14081,1,429496312,429496312,21118,7039,14079,7039,0,1,7041,10219058,10.219058
55,3555,2165,7696575,2,446,113,1,64089400,64089400,166,55,111,55,0,1,57,157762,0.157762
455,3555,2165,7696575,2,3646,913,1,82393400,82393400,1366,455,911,455,0,1,457,741239,0.741239
855,3555,2165,7696575,2,6846,1713,1,100697400,100697400,2566,855,1711,855,0,1,857,524815,0.524815
1255,3555,2165,7696575,2,10046,2513,1,119001400,119001400,3766,1255,2511,1255,0,1,1257,1506658,1.506658
1655,3555,2165,7696575,2,13246,3313,1,137305400,137305400,4966,1655,3311,1655,0,1,1657,2512246,2.512246
2055,3555,2165,7696575,2,16446,4113,1,155609400,155609400,6166,2055,4111,2055,0,1,2057,753920,0.75392
2455,3555,2165,7696575,2,19646,4913,1,173913400,173913400,7366,2455,4911,2455,0,1,2457,1874389,1.874389
2855,3555,2165,7696575,2,22846,5713,1,192217400,192217400,8566,2855,5711,2855,0,1,2857,660477,0.660477
3255,3555,2165,7696575,2,26046,6513,1,210521400,210521400,9766,3255,6511,3255,0,1,3257,3394962,3.394962
3655,3555,2165,7696575,2,29246,7313,1,228825400,228825400,10966,3655,7311,3655,0,1,3657,2149620,2.14962
4055,3555,2165,7696575,2,32446,8113,1,247129400,247129400,12166,4055,8111,4055,0,1,4057,1158409,1.158409
4455,3555,2165,7696575,2,35646,8913,1,265433400,265433400,13366,4455,8911,4455,0,1,4457,733751,0.733751
4855,3555,2165,7696575,2,38846,9713,1,283737400,283737400,14566,4855,9711,4855,0,1,4857,4604151,4.604151
5255,3555,2165,7696575,2,42046,10513,1,302041400,302041400,15766,5255,10511,5255,0,1,5257,1184035,1.184035
5655,3555,2165,7696575,2,45246,11313,1,320345400,320345400,16966,5655,11311,5655,0,1,5657,8474595,8.474595
6055,3555,2165,7696575,2,48446,12113,1,338649400,338649400,18166,6055,12111,6055,0,1,6057,9117480,9.11748
6455,3555,2165,7696575,2,51646,12913,1,356953400,356953400,19366,6455,12911,6455,0,1,6457,2782427,2.782427
6855,3555,2165,7696575,2,54846,13713,1,375257400,375257400,20566,6855,13711,6855,0,1,6857,1108203,1.108203
55,1805,4265,7698325,2,446,113,1,64257400,64257400,166,55,111,55,0,1,57,162925,0.162925
455,1805,4265,7698325,2,3646,913,1,83681400,83681400,1366,455,911,455,0,1,457,747823,0.747823
855,1805,4265,7698325,2,6846,1713,1,103105400,103105400,2566,855,1711,855,0,1,857,513079,0.513079
1255,1805,4265,7698325,2,10046,2513,1,122529400,122529400,3766,1255,2511,1255,0,1,1257,715510,0.71551
1655,1805,4265,7698325,2,13246,3313,1,141953400,141953400,4966,1655,3311,1655,0,1,1657,2517349,2.517349
2055,1805,4265,7698325,2,16446,4113,1,161377400,161377400,6166,2055,4111,2055,0,1,2057,3109000,3.109
2455,1805,4265,7698325,2,19646,4913,1,180801400,180801400,7366,2455,4911,2455,0,1,2457,2997175,2.997175
2855,1805,4265,7698325,2,22846,5713,1,200225400,200225400,8566,2855,5711,2855,0,1,2857,812370,0.81237
3255,1805,4265,7698325,2,26046,6513,1,219649400,219649400,9766,3255,6511,3255,0,1,3257,161325,0.161325
3655,1805,4265,7698325,2,29246,7313,1,239073400,239073400,10966,3655,7311,3655,0,1,3657,2540066,2.540066
4055,1805,4265,7698325,2,32446,8113,1,258497400,258497400,12166,4055,8111,4055,0,1,4057,97723,0.097723
4455,1805,4265,7698325,2,35646,8913,1,277921400,277921400,13366,4455,8911,4455,0,1,4457,6138955,6.138955
4855,1805,4265,7698325,2,38846,9713,1,297345400,297345400,14566,4855,9711,4855,0,1,4857,470230,0.47023
5255,1805,4265,7698325,2,42046,10513,1,316769400,316769400,15766,5255,10511,5255,0,1,5257,499574,0.499574
5655,1805,4265,7698325,2,45246,11313,1,336193400,336193400,16966,5655,11311,5655,0,1,5657,515604,0.515604
6055,1805,4265,7698325,2,48446,12113,1,355617400,355617400,18166,6055,12111,6055,0,1,6057,3374103,3.374103
6455,1805,4265,7698325,2,51646,12913,1,375041400,375041400,19366,6455,12911,6455,0,1,6457,4956945,4.956945
6855,1805,4265,7698325,2,54846,13713,1,394465400,394465400,20566,6855,13711,6855,0,1,6857,10279143,10.279143
40,2550,3040,7752000,2,326,83,1,63804800,63804800,121,40,81,40,0,1,42,136996,0.136996
440,2550,3040,7752000,2,3526,883,1,81692800,81692800,1321,440,881,440,0,1,442,395140,0.39514
840,2550,3040,7752000,2,6726,1683,1,99580800,99580800,2521,840,1681,840,0,1,842,924235,0.924235
1240,2550,3040,7752000,2,9926,2483,1,117468800,117468800,3721,1240,2481,1240,0,1,1242,1330887,1.330887
1640,2550,3040,7752000,2,13126,3283,1,135356800,135356800,4921,1640,3281,1640,0,1,1642,794310,0.79431
2040,2550,3040,7752000,2,16326,4083,1,153244800,153244800,6121,2040,4081,2040,0,1,2042,2941819,2.941819
2440,2550,3040,7752000,2,19526,4883,1,171132800,171132800,7321,2440,4881,2440,0,1,2442,3422546,3.422546
2840,2550,3040,7752000,2,22726,5683,1,189020800,189020800,8521,2840,5681,2840,0,1,2842,3623131,3.623131
3240,2550,3040,7752000,2,25926,6483,1,206908800,206908800,9721,3240,6481,3240,0,1,3242,2318661,2.318661
3640,2550,3040,7752000,2,29126,7283,1,224796800,224796800,10921,3640,7281,3640,0,1,3642,3584602,3.584602
4040,2550,3040,7752000,2,32326,8083,1,242684800,242684800,12121,4040,8081,4040,0,1,4042,147111,0.147111
4440,2550,3040,7752000,2,35526,8883,1,260572800,260572800,13321,4440,8881,4440,0,1,4442,448284,0.448284
4840,2550,3040,7752000,2,38726,9683,1,278460800,278460800,14521,4840,9681,4840,0,1,4842,543295,0.543295
5240,2550,3040,7752000,2,41926,10483,1,296348800,296348800,15721,5240,10481,5240,0,1,5242,1250604,1.250604
5640,2550,3040,7752000,2,45126,11283,1,314236800,314236800,16921,5640,11281,5640,0,1,5642,2347688,2.347688
6040,2550,3040,7752000,2,48326,12083,1,332124800,332124800,18121,6040,12081,6040,0,1,6042,359300,0.3593
6440,2550,3040,7752000,2,51526,12883,1,350012800,350012800,19321,6440,12881,6440,0,1,6442,3991522,3.991522
6840,2550,3040,7752000,2,54726,13683,1,367900800,367900800,20521,6840,13681,6840,0,1,6842,2566007,2.566007
55,2805,2765,7755825,2,446,113,1,64497400,64497400,166,55,111,55,0,1,57,163930,0.16393
455,2805,2765,7755825,2,3646,913,1,82321400,82321400,1366,455,911,455,0,1,457,717308,0.717308
855,2805,2765,7755825,2,6846,1713,1,100145400,100145400,2566,855,1711,855,0,1,857,1288108,1.288108
1255,2805,2765,7755825,2,10046,2513,1,117969400,117969400,3766,1255,2511,1255,0,1,1257,686392,0.686392
1655,2805,2765,7755825,2,13246,3313,1,135793400,135793400,4966,1655,3311,1655,0,1,1657,96838,0.096838
2055,2805,2765,7755825,2,16446,4113,1,153617400,153617400,6166,2055,4111,2055,0,1,2057,1037765,1.037765
2455,2805,2765,7755825,2,19646,4913,1,171441400,171441400,7366,2455,4911,2455,0,1,2457,3244809,3.244809
2855,2805,2765,7755825,2,22846,5713,1,189265400,189265400,8566,2855,5711,2855,0,1,2857,1620559,1.620559
3255,2805,2765,7755825,2,26046,6513,1,207089400,207089400,9766,3255,6511,3255,0,1,3257,1089596,1.089596
3655,2805,2765,7755825,2,29246,7313,1,224913400,224913400,10966,3655,7311,3655,0,1,3657,772452,0.772452
4055,2805,2765,7755825,2,32446,8113,1,242737400,242737400,12166,4055,8111,4055,0,1,4057,1149648,1.149648
4455,2805,2765,7755825,2,35646,8913,1,260561400,260561400,13366,4455,8911,4455,0,1,4457,17067,0.017067
4855,2805,2765,7755825,2,38846,9713,1,278385400,278385400,14566,4855,9711,4855,0,1,4857,1784511,1.784511
5255,2805,2765,7755825,2,42046,10513,1,296209400,296209400,15766,5255,10511,5255,0,1,5257,140509,0.140509
5655,2805,2765,7755825,2,45246,11313,1,314033400,314033400,16966,5655,11311,5655,0,1,5657,874308,0.874308
6055,2805,2765,7755825,2,48446,12113,1,331857400,331857400,18166,6055,12111,6055,0,1,6057,598171,0.598171
6455,2805,2765,7755825,2,51646,12913,1,349681400,349681400,19366,6455,12911,6455,0,1,6457,1866110,1.86611
6855,2805,2765,7755825,2,54846,13713,1,367505400,367505400,20566,6855,13711,6855,0,1,6857,3011735,3.011735
55,2305,3365,7756325,2,446,113,1,64545400,64545400,166,55,111,55,0,1,57,53807,0.053807
455,2305,3365,7756325,2,3646,913,1,82689400,82689400,1366,455,911,455,0,1,457,722446,0.722446
855,2305,3365,7756325,2,6846,1713,1,100833400,100833400,2566,855,1711,855,0,1,857,1287247,1.287247
1255,2305,3365,7756325,2,10046,2513,1,118977400,118977400,3766,1255,2511,1255,0,1,1257,112314,0.112314
1655,2305,3365,7756325,2,13246,3313,1,137121400,137121400,4966,1655,3311,1655,0,1,1657,2435423,2.435423
2055,2305,3365,7756325,2,16446,4113,1,155265400,155265400,6166,2055,4111,2055,0,1,2057,1270210,1.27021
2455,2305,3365,7756325,2,19646,4913,1,173409400,173409400,7366,2455,4911,2455,0,1,2457,389511,0.389511
2855,2305,3365,7756325,2,22846,5713,1,191553400,191553400,8566,2855,5711,2855,0,1,2857,3692016,3.692016
3255,2305,3365,7756325,2,26046,6513,1,209697400,209697400,9766,3255,6511,3255,0,1,3257,1303536,1.303536
3655,2305,3365,7756325,2,29246,7313,1,227841400,227841400,10966,3655,7311,3655,0,1,3657,1090068,1.090068
4055,2305,3365,7756325,2,32446,8113,1,245985400,245985400,12166,4055,8111,4055,0,1,4057,772357,0.772357
4455,2305,3365,7756325,2,35646,8913,1,264129400,264129400,13366,4455,8911,4455,0,1,4457,1497446,1.497446
4855,2305,3365,7756325,2,38846,9713,1,282273400,282273400,14566,4855,9711,4855,0,1,4857,48418,0.048418
5255,2305,3365,7756325,2,42046,10513,1,300417400,300417400,15766,5255,10511,5255,0,1,5257,871856,0.871856
5655,2305,3365,7756325,2,45246,11313,1,318561400,318561400,16966,5655,11311,5655,0,1,5657,1696984,1.696984
6055,2305,3365,7756325,2,48446,12113,1,336705400,336705400,18166,6055,12111,6055,0,1,6057,2995049,2.995049
6455,2305,3365,7756325,2,51646,12913,1,354849400,354849400,19366,6455,12911,6455,0,1,6457,1050209,1.050209
6855,2305,3365,7756325,2,54846,13713,1,372993400,372993400,20566,6855,13711,6855,0,1,6857,180278,0.180278
44,1703,4555,7757165,2,358,91,1,64260136,64260136,133,44,89,44,0,1,46,144199,0.144199
544,1703,4555,7757165,2,4358,1091,1,89292136,89292136,1633,544,1089,544,0,1,546,779202,0.779202
1044,1703,4555,7757165,2,8358,2091,1,114324136,114324136,3133,1044,2089,1044,0,1,1046,905069,0.905069
1544,1703,4555,7757165,2,12358,3091,1,139356136,139356136,4633,1544,3089,1544,0,1,1546,2363408,2.363408
2044,1703,4555,7757165,2,16358,4091,1,164388136,164388136,6133,2044,4089,2044,0,1,2046,2449201,2.449201
2544,1703,4555,7757165,2,20358,5091,1,189420136,189420136,7633,2544,5089,2544,0,1,2546,3857684,3.857684
3044,1703,4555,7757165,2,24358,6091,1,214452136,214452136,9133,3044,6089,3044,0,1,3046,57695,0.057695
3544,1703,4555,7757165,2,28358,7091,1,239484136,239484136,10633,3544,7089,3544,0,1,3546,47962,0.047962
4044,1703,4555,7757165,2,32358,8091,1,264516136,264516136,12133,4044,8089,4044,0,1,4046,1073226,1.073226
4544,1703,4555,7757165,2,36358,9091,1,289548136,289548136,13633,4544,9089,4544,0,1,4546,217867,0.217867
5044,1703,4555,7757165,2,40358,10091,1,314580136,314580136,15133,5044,10089,5044,0,1,5046,4107005,4.107005
5544,1703,4555,7757165,2,44358,11091,1,339612136,339612136,16633,5544,11089,5544,0,1,5546,877495,0.877495
6044,1703,4555,7757165,2,48358,12091,1,364644136,364644136,18133,6044,12089,6044,0,1,6046,371262,0.371262
6544,1703,4555,7757165,2,52358,13091,1,389676136,389676136,19633,6544,13089,6544,0,1,6546,460274,0.460274
7044,1703,4555,7757165,2,56358,14091,1,414708136,414708136,21133,7044,14089,7044,0,1,7046,939813,0.939813
40,5050,1540,7777000,2,326,83,1,64324800,64324800,121,40,81,40,0,1,42,16002,0.016002
440,5050,1540,7777000,2,3526,883,1,85412800,85412800,1321,440,881,440,0,1,442,6510,0.00651
840,5050,1540,7777000,2,6726,1683,1,106500800,106500800,2521,840,1681,840,0,1,842,61531,0.061531
1240,5050,1540,7777000,2,9926,2483,1,127588800,127588800,3721,1240,2481,1240,0,1,1242,191085,0.191085
1640,5050,1540,7777000,2,13126,3283,1,148676800,148676800,4921,1640,3281,1640,0,1,1642,61555,0.061555
2040,5050,1540,7777000,2,16326,4083,1,169764800,169764800,6121,2040,4081,2040,0,1,2042,640755,0.640755
2440,5050,1540,7777000,2,19526,4883,1,190852800,190852800,7321,2440,4881,2440,0,1,2442,24333,0.024333
2840,5050,1540,7777000,2,22726,5683,1,211940800,211940800,8521,2840,5681,2840,0,1,2842,816932,0.816932
3240,5050,1540,7777000,2,25926,6483,1,233028800,233028800,9721,3240,6481,3240,0,1,3242,745093,0.745093
3640,5050,1540,7777000,2,29126,7283,1,254116800,254116800,10921,3640,7281,3640,0,1,3642,726233,0.726233
4040,5050,1540,7777000,2,32326,8083,1,275204800,275204800,12121,4040,8081,4040,0,1,4042,2440457,2.440457
4440,5050,1540,7777000,2,35526,8883,1,296292800,296292800,13321,4440,8881,4440,0,1,4442,1324234,1.324234
4840,5050,1540,7777000,2,38726,9683,1,317380800,317380800,14521,4840,9681,4840,0,1,4842,1413890,1.41389
5240,5050,1540,7777000,2,41926,10483,1,338468800,338468800,15721,5240,10481,5240,0,1,5242,1194821,1.194821
5640,5050,1540,7777000,2,45126,11283,1,359556800,359556800,16921,5640,11281,5640,0,1,5642,867091,0.867091
6040,5050,1540,7777000,2,48326,12083,1,380644800,380644800,18121,6040,12081,6040,0,1,6042,113479,0.113479
6440,5050,1540,7777000,2,51526,12883,1,401732800,401732800,19321,6440,12881,6440,0,1,6442,425484,0.425484
6840,5050,1540,7777000,2,54726,13683,1,422820800,422820800,20521,6840,13681,6840,0,1,6842,945367,0.945367
44,5003,1555,7779665,2,358,91,1,64545736,64545736,133,44,89,44,0,1,46,142301,0.142301
544,5003,1555,7779665,2,4358,1091,1,90777736,90777736,1633,544,1089,544,0,1,546,856502,0.856502
1044,5003,1555,7779665,2,8358,2091,1,117009736,117009736,3133,1044,2089,1044,0,1,1046,184302,0.184302
1544,5003,1555,7779665,2,12358,3091,1,143241736,143241736,4633,1544,3089,1544,0,1,1546,537160,0.53716
2044,5003,1555,7779665,2,16358,4091,1,169473736,169473736,6133,2044,4089,2044,0,1,2046,3042688,3.042688
2544,5003,1555,7779665,2,20358,5091,1,195705736,195705736,7633,2544,5089,2544,0,1,2546,3767143,3.767143
3044,5003,1555,7779665,2,24358,6091,1,221937736,221937736,9133,3044,6089,3044,0,1,3046,1466927,1.466927
3544,5003,1555,7779665,2,28358,7091,1,248169736,248169736,10633,3544,7089,3544,0,1,3546,3665639,3.665639
4044,5003,1555,7779665,2,32358,8091,1,274401736,274401736,12133,4044,8089,4044,0,1,4046,5923961,5.923961
4544,5003,1555,7779665,2,36358,9091,1,300633736,300633736,13633,4544,9089,4544,0,1,4546,1851740,1.85174
5044,5003,1555,7779665,2,40358,10091,1,326865736,326865736,15133,5044,10089,5044,0,1,5046,23278,0.023278
5544,5003,1555,7779665,2,44358,11091,1,353097736,353097736,16633,5544,11089,5544,0,1,5546,2998640,2.99864
6044,5003,1555,7779665,2,48358,12091,1,379329736,379329736,18133,6044,12089,6044,0,1,6046,8917014,8.917014
6544,5003,1555,7779665,2,52358,13091,1,405561736,405561736,19633,6544,13089,6544,0,1,6546,9641605,9.641605
7044,5003,1555,7779665,2,56358,14091,1,431793736,431793736,21133,7044,14089,7044,0,1,7046,10353224,10.353224
40,6300,1240,7812000,2,326,83,1,64908800,64908800,121,40,81,40,0,1,42,142326,0.142326
440,6300,1240,7812000,2,3526,883,1,89036800,89036800,1321,440,881,440,0,1,442,700767,0.700767
840,6300,1240,7812000,2,6726,1683,1,113164800,113164800,2521,840,1681,840,0,1,842,1272424,1.272424
1240,6300,1240,7812000,2,9926,2483,1,137292800,137292800,3721,1240,2481,1240,0,1,1242,1851485,1.851485
1640,6300,1240,7812000,2,13126,3283,1,161420800,161420800,4921,1640,3281,1640,0,1,1642,863800,0.8638
2040,6300,1240,7812000,2,16326,4083,1,185548800,185548800,6121,2040,4081,2040,0,1,2042,2974240,2.97424
2440,6300,1240,7812000,2,19526,4883,1,209676800,209676800,7321,2440,4881,2440,0,1,2442,726282,0.726282
2840,6300,1240,7812000,2,22726,5683,1,233804800,233804800,8521,2840,5681,2840,0,1,2842,1362121,1.362121
3240,6300,1240,7812000,2,25926,6483,1,257932800,257932800,9721,3240,6481,3240,0,1,3242,155160,0.15516
3640,6300,1240,7812000,2,29126,7283,1,282060800,282060800,10921,3640,7281,3640,0,1,3642,1055712,1.055712
4040,6300,1240,7812000,2,32326,8083,1,306188800,306188800,12121,4040,8081,4040,0,1,4042,40098,0.040098
4440,6300,1240,7812000,2,35526,8883,1,330316800,330316800,13321,4440,8881,4440,0,1,4442,1629028,1.629028
4840,6300,1240,7812000,2,38726,9683,1,354444800,354444800,14521,4840,9681,4840,0,1,4842,247591,0.247591
5240,6300,1240,7812000,2,41926,10483,1,378572800,378572800,15721,5240,10481,5240,0,1,5242,2398987,2.398987
5640,6300,1240,7812000,2,45126,11283,1,402700800,402700800,16921,5640,11281,5640,0,1,5642,3377066,3.377066
6040,6300,1240,7812000,2,48326,12083,1,426828800,426828800,18121,6040,12081,6040,0,1,6042,2063032,2.063032
6440,6300,1240,7812000,2,51526,12883,1,450956800,450956800,19321,6440,12881,6440,0,1,6442,3546983,3.546983
6840,6300,1240,7812000,2,54726,13683,1,475084800,475084800,20521,6840,13681,6840,0,1,6842,3835322,3.835322
55,2555,3065,7831075,2,446,113,1,65121400,65121400,166,55,111,55,0,1,57,161298,0.161298
455,2555,3065,7831075,2,3646,913,1,83105400,83105400,1366,455,911,455,0,1,457,728107,0.728107
855,2555,3065,7831075,2,6846,1713,1,101089400,101089400,2566,855,1711,855,0,1,857,1314027,1.314027
1255,2555,3065,7831075,2,10046,2513,1,119073400,119073400,3766,1255,2511,1255,0,1,1257,1357379,1.357379
1655,2555,3065,7831075,2,13246,3313,1,137057400,137057400,4966,1655,3311,1655,0,1,1657,2464763,2.464763
2055,2555,3065,7831075,2,16446,4113,1,155041400,155041400,6166,2055,4111,2055,0,1,2057,68697,0.068697
2455,2555,3065,7831075,2,19646,4913,1,173025400,173025400,7366,2455,4911,2455,0,1,2457,303313,0.303313
2855,2555,3065,7831075,2,22846,5713,1,191009400,191009400,8566,2855,5711,2855,0,1,2857,4207954,4.207954
3255,2555,3065,7831075,2,26046,6513,1,208993400,208993400,9766,3255,6511,3255,0,1,3257,909925,0.909925
3655,2555,3065,7831075,2,29246,7313,1,226977400,226977400,10966,3655,7311,3655,0,1,3657,2417569,2.417569
4055,2555,3065,7831075,2,32446,8113,1,244961400,244961400,12166,4055,8111,4055,0,1,4057,1175830,1.17583
4455,2555,3065,7831075,2,35646,8913,1,262945400,262945400,13366,4455,8911,4455,0,1,4457,3742310,3.74231
4855,2555,3065,7831075,2,38846,9713,1,280929400,280929400,14566,4855,9711,4855,0,1,4857,7166532,7.166532
5255,2555,3065,7831075,2,42046,10513,1,298913400,298913400,15766,5255,10511,5255,0,1,5257,114704,0.114704
5655,2555,3065,7831075,2,45246,11313,1,316897400,316897400,16966,5655,11311,5655,0,1,5657,2930287,2.930287
6055,2555,3065,7831075,2,48446,12113,1,334881400,334881400,18166,6055,12111,6055,0,1,6057,2423493,2.423493
6455,2555,3065,7831075,2,51646,12913,1,352865400,352865400,19366,6455,12911,6455,0,1,6457,472925,0.472925
6855,2555,3065,7831075,2,54846,13713,1,370849400,370849400,20566,6855,13711,6855,0,1,6857,414038,0.414038
40,1300,6040,7852000,2,326,83,1,65164800,65164800,121,40,81,40,0,1,42,86105,0.086105
440,1300,6040,7852000,2,3526,883,1,88652800,88652800,1321,440,881,440,0,1,442,649741,0.649741
840,1300,6040,7852000,2,6726,1683,1,112140800,112140800,2521,840,1681,840,0,1,842,661267,0.661267
1240,1300,6040,7852000,2,9926,2483,1,135628800,135628800,3721,1240,2481,1240,0,1,1242,166793,0.166793
1640,1300,6040,7852000,2,13126,3283,1,159116800,159116800,4921,1640,3281,1640,0,1,1642,1620710,1.62071
2040,1300,6040,7852000,2,16326,4083,1,182604800,182604800,6121,2040,4081,2040,0,1,2042,91881,0.091881
2440,1300,6040,7852000,2,19526,4883,1,206092800,206092800,7321,2440,4881,2440,0,1,2442,1590158,1.590158
2840,1300,6040,7852000,2,22726,5683,1,229580800,229580800,8521,2840,5681,2840,0,1,2842,1634182,1.634182
3240,1300,6040,7852000,2,25926,6483,1,253068800,253068800,9721,3240,6481,3240,0,1,3242,2243435,2.243435
3640,1300,6040,7852000,2,29126,7283,1,276556800,276556800,10921,3640,7281,3640,0,1,3642,583812,0.583812
4040,1300,6040,7852000,2,32326,8083,1,300044800,300044800,12121,4040,8081,4040,0,1,4042,430410,0.43041
4440,1300,6040,7852000,2,35526,8883,1,323532800,323532800,13321,4440,8881,4440,0,1,4442,447297,0.447297
4840,1300,6040,7852000,2,38726,9683,1,347020800,347020800,14521,4840,9681,4840,0,1,4842,1187604,1.187604
5240,1300,6040,7852000,2,41926,10483,1,370508800,370508800,15721,5240,10481,5240,0,1,5242,39458,0.039458
5640,1300,6040,7852000,2,45126,11283,1,393996800,393996800,16921,5640,11281,5640,0,1,5642,2057374,2.057374
6040,1300,6040,7852000,2,48326,12083,1,417484800,417484800,18121,6040,12081,6040,0,1,6042,626478,0.626478
6440,1300,6040,7852000,2,51526,12883,1,440972800,440972800,19321,6440,12881,6440,0,1,6442,953275,0.953275
6840,1300,6040,7852000,2,54726,13683,1,464460800,464460800,20521,6840,13681,6840,0,1,6842,796171,0.796171
55,5055,1565,7911075,2,446,113,1,66201400,66201400,166,55,111,55,0,1,57,9152,0.009152
455,5055,1565,7911075,2,3646,913,1,87385400,87385400,1366,455,911,455,0,1,457,37107,0.037107
855,5055,1565,7911075,2,6846,1713,1,108569400,108569400,2566,855,1711,855,0,1,857,169697,0.169697
1255,5055,1565,7911075,2,10046,2513,1,129753400,129753400,3766,1255,2511,1255,0,1,1257,198921,0.198921
1655,5055,1565,7911075,2,13246,3313,1,150937400,150937400,4966,1655,3311,1655,0,1,1657,384789,0.384789
2055,5055,1565,7911075,2,16446,4113,1,172121400,172121400,6166,2055,4111,2055,0,1,2057,1195805,1.195805
2455,5055,1565,7911075,2,19646,4913,1,193305400,193305400,7366,2455,4911,2455,0,1,2457,1008653,1.008653
2855,5055,1565,7911075,2,22846,5713,1,214489400,214489400,8566,2855,5711,2855,0,1,2857,761633,0.761633
3255,5055,1565,7911075,2,26046,6513,1,235673400,235673400,9766,3255,6511,3255,0,1,3257,107803,0.107803
3655,5055,1565,7911075,2,29246,7313,1,256857400,256857400,10966,3655,7311,3655,0,1,3657,142293,0.142293
4055,5055,1565,7911075,2,32446,8113,1,278041400,278041400,12166,4055,8111,4055,0,1,4057,319627,0.319627
4455,5055,1565,7911075,2,35646,8913,1,299225400,299225400,13366,4455,8911,4455,0,1,4457,2665750,2.66575
4855,5055,1565,7911075,2,38846,9713,1,320409400,320409400,14566,4855,9711,4855,0,1,4857,1644133,1.644133
5255,5055,1565,7911075,2,42046,10513,1,341593400,341593400,15766,5255,10511,5255,0,1,5257,1007531,1.007531
5655,5055,1565,7911075,2,45246,11313,1,362777400,362777400,16966,5655,11311,5655,0,1,5657,1876340,1.87634
6055,5055,1565,7911075,2,48446,12113,1,383961400,383961400,18166,6055,12111,6055,0,1,6057,3208327,3.208327
6455,5055,1565,7911075,2,51646,12913,1,405145400,405145400,19366,6455,12911,6455,0,1,6457,865796,0.865796
6855,5055,1565,7911075,2,54846,13713,1,426329400,426329400,20566,6855,13711,6855,0,1,6857,8336,0.008336
40,4300,1840,7912000,2,326,83,1,65260800,65260800,121,40,81,40,0,1,42,139062,0.139062
440,4300,1840,7912000,2,3526,883,1,84908800,84908800,1321,440,881,440,0,1,442,693900,0.6939
840,4300,1840,7912000,2,6726,1683,1,104556800,104556800,2521,840,1681,840,0,1,842,284482,0.284482
1240,4300,1840,7912000,2,9926,2483,1,124204800,124204800,3721,1240,2481,1240,0,1,1242,1186160,1.18616
1640,4300,1840,7912000,2,13126,3283,1,143852800,143852800,4921,1640,3281,1640,0,1,1642,260518,0.260518
2040,4300,1840,7912000,2,16326,4083,1,163500800,163500800,6121,2040,4081,2040,0,1,2042,1536472,1.536472
2440,4300,1840,7912000,2,19526,4883,1,183148800,183148800,7321,2440,4881,2440,0,1,2442,67082,0.067082
2840,4300,1840,7912000,2,22726,5683,1,202796800,202796800,8521,2840,5681,2840,0,1,2842,355279,0.355279
3240,4300,1840,7912000,2,25926,6483,1,222444800,222444800,9721,3240,6481,3240,0,1,3242,3531139,3.531139
3640,4300,1840,7912000,2,29126,7283,1,242092800,242092800,10921,3640,7281,3640,0,1,3642,1103749,1.103749
4040,4300,1840,7912000,2,32326,8083,1,261740800,261740800,12121,4040,8081,4040,0,1,4042,1569743,1.569743
4440,4300,1840,7912000,2,35526,8883,1,281388800,281388800,13321,4440,8881,4440,0,1,4442,2613349,2.613349
4840,4300,1840,7912000,2,38726,9683,1,301036800,301036800,14521,4840,9681,4840,0,1,4842,1615071,1.615071
5240,4300,1840,7912000,2,41926,10483,1,320684800,320684800,15721,5240,10481,5240,0,1,5242,596176,0.596176
5640,4300,1840,7912000,2,45126,11283,1,340332800,340332800,16921,5640,11281,5640,0,1,5642,685969,0.685969
6040,4300,1840,7912000,2,48326,12083,1,359980800,359980800,18121,6040,12081,6040,0,1,6042,443218,0.443218
6440,4300,1840,7912000,2,51526,12883,1,379628800,379628800,19321,6440,12881,6440,0,1,6442,232495,0.232495
6840,4300,1840,7912000,2,54726,13683,1,399276800,399276800,20521,6840,13681,6840,0,1,6842,2318519,2.318519
55,1305,6065,7914825,2,446,113,1,66561400,66561400,166,55,111,55,0,1,57,50706,0.050706
455,1305,6065,7914825,2,3646,913,1,90145400,90145400,1366,455,911,455,0,1,457,763440,0.76344
855,1305,6065,7914825,2,6846,1713,1,113729400,113729400,2566,855,1711,855,0,1,857,253373,0.253373
1255,1305,6065,7914825,2,10046,2513,1,137313400,137313400,3766,1255,2511,1255,0,1,1257,955366,0.955366
1655,1305,6065,7914825,2,13246,3313,1,160897400,160897400,4966,1655,3311,1655,0,1,1657,887641,0.887641
2055,1305,6065,7914825,2,16446,4113,1,184481400,184481400,6166,2055,4111,2055,0,1,2057,1322249,1.322249
2455,1305,6065,7914825,2,19646,4913,1,208065400,208065400,7366,2455,4911,2455,0,1,2457,438928,0.438928
2855,1305,6065,7914825,2,22846,5713,1,231649400,231649400,8566,2855,5711,2855,0,1,2857,538575,0.538575
3255,1305,6065,7914825,2,26046,6513,1,255233400,255233400,9766,3255,6511,3255,0,1,3257,1015461,1.015461
3655,1305,6065,7914825,2,29246,7313,1,278817400,278817400,10966,3655,7311,3655,0,1,3657,311500,0.3115
4055,1305,6065,7914825,2,32446,8113,1,302401400,302401400,12166,4055,8111,4055,0,1,4057,819511,0.819511
4455,1305,6065,7914825,2,35646,8913,1,325985400,325985400,13366,4455,8911,4455,0,1,4457,2284360,2.28436
4855,1305,6065,7914825,2,38846,9713,1,349569400,349569400,14566,4855,9711,4855,0,1,4857,493859,0.493859
5255,1305,6065,7914825,2,42046,10513,1,373153400,373153400,15766,5255,10511,5255,0,1,5257,182655,0.182655
5655,1305,6065,7914825,2,45246,11313,1,396737400,396737400,16966,5655,11311,5655,0,1,5657,1040070,1.04007
6055,1305,6065,7914825,2,48446,12113,1,420321400,420321400,18166,6055,12111,6055,0,1,6057,645282,0.645282
6455,1305,6065,7914825,2,51646,12913,1,443905400,443905400,19366,6455,12911,6455,0,1,6457,4564644,4.564644
6855,1305,6065,7914825,2,54846,13713,1,467489400,467489400,20566,6855,13711,6855,0,1,6857,2294927,2.294927
35,2240,3545,7940800,2,286,73,1,65146200,65146200,106,35,71,35,0,1,37,144676,0.144676
535,2240,3545,7940800,2,4286,1073,1,88286200,88286200,1606,535,1071,535,0,1,537,849137,0.849137
1035,2240,3545,7940800,2,8286,2073,1,111426200,111426200,3106,1035,2071,1035,0,1,1037,1595940,1.59594
1535,2240,3545,7940800,2,12286,3073,1,134566200,134566200,4606,1535,3071,1535,0,1,1537,2334432,2.334432
2035,2240,3545,7940800,2,16286,4073,1,157706200,157706200,6106,2035,4071,2035,0,1,2037,3077149,3.077149
2535,2240,3545,7940800,2,20286,5073,1,180846200,180846200,7606,2535,5071,2535,0,1,2537,3825122,3.825122
39,2243,3541,7942463,2,318,81,1,65344312,65344312,118,39,79,39,0,1,41,6980,0.00698
539,2243,3541,7942463,2,4318,1081,1,88480312,88480312,1618,539,1079,539,0,1,541,47637,0.047637
1039,2243,3541,7942463,2,8318,2081,1,111616312,111616312,3118,1039,2079,1039,0,1,1041,122666,0.122666
1539,2243,3541,7942463,2,12318,3081,1,134752312,134752312,4618,1539,3079,1539,0,1,1541,249140,0.24914
2039,2243,3541,7942463,2,16318,4081,1,157888312,157888312,6118,2039,4079,2039,0,1,2041,33562,0.033562
2539,2243,3541,7942463,2,20318,5081,1,181024312,181024312,7618,2539,5079,2539,0,1,2541,593468,0.593468
3039,2243,3541,7942463,2,24318,6081,1,204160312,204160312,9118,3039,6079,3039,0,1,3041,1454485,1.454485
3539,2243,3541,7942463,2,28318,7081,1,227296312,227296312,10618,3539,7079,3539,0,1,3541,1178147,1.178147
4039,2243,3541,7942463,2,32318,8081,1,250432312,250432312,12118,4039,8079,4039,0,1,4041,473822,0.473822
4539,2243,3541,7942463,2,36318,9081,1,273568312,273568312,13618,4539,9079,4539,0,1,4541,523500,0.5235
5039,2243,3541,7942463,2,40318,10081,1,296704312,296704312,15118,5039,10079,5039,0,1,5041,2657441,2.657441
5539,2243,3541,7942463,2,44318,11081,1,319840312,319840312,16618,5539,11079,5539,0,1,5541,604555,0.604555
6039,2243,3541,7942463,2,48318,12081,1,342976312,342976312,18118,6039,12079,6039,0,1,6041,989216,0.989216
6539,2243,3541,7942463,2,52318,13081,1,366112312,366112312,19618,6539,13079,6539,0,1,6541,179297,0.179297
7039,2243,3541,7942463,2,56318,14081,1,389248312,389248312,21118,7039,14079,7039,0,1,7041,585638,0.585638
39,3893,2041,7945613,2,318,81,1,65416312,65416312,118,39,79,39,0,1,41,146088,0.146088
539,3893,2041,7945613,2,4318,1081,1,89152312,89152312,1618,539,1079,539,0,1,541,895944,0.895944
1039,3893,2041,7945613,2,8318,2081,1,112888312,112888312,3118,1039,2079,1039,0,1,1041,540069,0.540069
1539,3893,2041,7945613,2,12318,3081,1,136624312,136624312,4618,1539,3079,1539,0,1,1541,2435400,2.4354
2039,3893,2041,7945613,2,16318,4081,1,160360312,160360312,6118,2039,4079,2039,0,1,2041,1608044,1.608044
2539,3893,2041,7945613,2,20318,5081,1,184096312,184096312,7618,2539,5079,2539,0,1,2541,2728742,2.728742
3039,3893,2041,7945613,2,24318,6081,1,207832312,207832312,9118,3039,6079,3039,0,1,3041,4758420,4.75842
3539,3893,2041,7945613,2,28318,7081,1,231568312,231568312,10618,3539,7079,3539,0,1,3541,2039303,2.039303
4039,3893,2041,7945613,2,32318,8081,1,255304312,255304312,12118,4039,8079,4039,0,1,4041,1308579,1.308579
4539,3893,2041,7945613,2,36318,9081,1,279040312,279040312,13618,4539,9079,4539,0,1,4541,3074419,3.074419
5039,3893,2041,7945613,2,40318,10081,1,302776312,302776312,15118,5039,10079,5039,0,1,5041,113628,0.113628
5539,3893,2041,7945613,2,44318,11081,1,326512312,326512312,16618,5539,11079,5539,0,1,5541,2521646,2.521646
6039,3893,2041,7945613,2,48318,12081,1,350248312,350248312,18118,6039,12079,6039,0,1,6041,8675365,8.675365
6539,3893,2041,7945613,2,52318,13081,1,373984312,373984312,19618,6539,13079,6539,0,1,6541,10232837,10.232837
7039,3893,2041,7945613,2,56318,14081,1,397720312,397720312,21118,7039,14079,7039,0,1,7041,11009140,11.00914
40,1550,5140,7967000,2,326,83,1,65876800,65876800,121,40,81,40,0,1,42,149564,0.149564
440,1550,5140,7967000,2,3526,883,1,87284800,87284800,1321,440,881,440,0,1,442,563954,0.563954
840,1550,5140,7967000,2,6726,1683,1,108692800,108692800,2521,840,1681,840,0,1,842,1343771,1.343771
1240,1550,5140,7967000,2,9926,2483,1,130100800,130100800,3721,1240,2481,1240,0,1,1242,892530,0.89253
1640,1550,5140,7967000,2,13126,3283,1,151508800,151508800,4921,1640,3281,1640,0,1,1642,2568640,2.56864
2040,1550,5140,7967000,2,16326,4083,1,172916800,172916800,6121,2040,4081,2040,0,1,2042,639190,0.63919
2440,1550,5140,7967000,2,19526,4883,1,194324800,194324800,7321,2440,4881,2440,0,1,2442,1990984,1.990984
2840,1550,5140,7967000,2,22726,5683,1,215732800,215732800,8521,2840,5681,2840,0,1,2842,247285,0.247285
3240,1550,5140,7967000,2,25926,6483,1,237140800,237140800,9721,3240,6481,3240,0,1,3242,488170,0.48817
3640,1550,5140,7967000,2,29126,7283,1,258548800,258548800,10921,3640,7281,3640,0,1,3642,1065804,1.065804
4040,1550,5140,7967000,2,32326,8083,1,279956800,279956800,12121,4040,8081,4040,0,1,4042,1887081,1.887081
4440,1550,5140,7967000,2,35526,8883,1,301364800,301364800,13321,4440,8881,4440,0,1,4442,2983473,2.983473
4840,1550,5140,7967000,2,38726,9683,1,322772800,322772800,14521,4840,9681,4840,0,1,4842,1277614,1.277614
5240,1550,5140,7967000,2,41926,10483,1,344180800,344180800,15721,5240,10481,5240,0,1,5242,1518120,1.51812
5640,1550,5140,7967000,2,45126,11283,1,365588800,365588800,16921,5640,11281,5640,0,1,5642,2037129,2.037129
6040,1550,5140,7967000,2,48326,12083,1,386996800,386996800,18121,6040,12081,6040,0,1,6042,1127535,1.127535
6440,1550,5140,7967000,2,51526,12883,1,408404800,408404800,19321,6440,12881,6440,0,1,6442,2764257,2.764257
6840,1550,5140,7967000,2,54726,13683,1,429812800,429812800,20521,6840,13681,6840,0,1,6842,1229487,1.229487
55,6305,1265,7975825,2,446,113,1,67137400,67137400,166,55,111,55,0,1,57,160458,0.160458
455,6305,1265,7975825,2,3646,913,1,91361400,91361400,1366,455,911,455,0,1,457,750916,0.750916
855,6305,1265,7975825,2,6846,1713,1,115585400,115585400,2566,855,1711,855,0,1,857,1369080,1.36908
1255,6305,1265,7975825,2,10046,2513,1,139809400,139809400,3766,1255,2511,1255,0,1,1257,1961220,1.96122
1655,6305,1265,7975825,2,13246,3313,1,164033400,164033400,4966,1655,3311,1655,0,1,1657,2571807,2.571807
2055,6305,1265,7975825,2,16446,4113,1,188257400,188257400,6166,2055,4111,2055,0,1,2057,533953,0.533953
2455,6305,1265,7975825,2,19646,4913,1,212481400,212481400,7366,2455,4911,2455,0,1,2457,3793405,3.793405
2855,6305,1265,7975825,2,22846,5713,1,236705400,236705400,8566,2855,5711,2855,0,1,2857,1203187,1.203187
3255,6305,1265,7975825,2,26046,6513,1,260929400,260929400,9766,3255,6511,3255,0,1,3257,87287,0.087287
3655,6305,1265,7975825,2,29246,7313,1,285153400,285153400,10966,3655,7311,3655,0,1,3657,964382,0.964382
4055,6305,1265,7975825,2,32446,8113,1,309377400,309377400,12166,4055,8111,4055,0,1,4057,1151274,1.151274
4455,6305,1265,7975825,2,35646,8913,1,333601400,333601400,13366,4455,8911,4455,0,1,4457,4265747,4.265747
4855,6305,1265,7975825,2,38846,9713,1,357825400,357825400,14566,4855,9711,4855,0,1,4857,7442213,7.442213
5255,6305,1265,7975825,2,42046,10513,1,382049400,382049400,15766,5255,10511,5255,0,1,5257,4765397,4.765397
5655,6305,1265,7975825,2,45246,11313,1,406273400,406273400,16966,5655,11311,5655,0,1,5657,5243424,5.243424
6055,6305,1265,7975825,2,48446,12113,1,430497400,430497400,18166,6055,12111,6055,0,1,6057,9263702,9.263702
6455,6305,1265,7975825,2,51646,12913,1,454721400,454721400,19366,6455,12911,6455,0,1,6457,5205733,5.205733
6855,6305,1265,7975825,2,54846,13713,1,478945400,478945400,20566,6855,13711,6855,0,1,6857,10491060,10.49106
44,2253,3555,8009415,2,358,91,1,66119736,66119736,133,44,89,44,0,1,46,217,0.000217
544,2253,3555,8009415,2,4358,1091,1,89351736,89351736,1633,544,1089,544,0,1,546,7381,0.007381
1044,2253,3555,8009415,2,8358,2091,1,112583736,112583736,3133,1044,2089,1044,0,1,1046,100981,0.100981
1544,2253,3555,8009415,2,12358,3091,1,135815736,135815736,4633,1544,3089,1544,0,1,1546,173468,0.173468
2044,2253,3555,8009415,2,16358,4091,1,159047736,159047736,6133,2044,4089,2044,0,1,2046,68546,0.068546
2544,2253,3555,8009415,2,20358,5091,1,182279736,182279736,7633,2544,5089,2544,0,1,2546,254679,0.254679
3044,2253,3555,8009415,2,24358,6091,1,205511736,205511736,9133,3044,6089,3044,0,1,3046,862572,0.862572
3544,2253,3555,8009415,2,28358,7091,1,228743736,228743736,10633,3544,7089,3544,0,1,3546,1951885,1.951885
4044,2253,3555,8009415,2,32358,8091,1,251975736,251975736,12133,4044,8089,4044,0,1,4046,319413,0.319413
4544,2253,3555,8009415,2,36358,9091,1,275207736,275207736,13633,4544,9089,4544,0,1,4546,1872636,1.872636
5044,2253,3555,8009415,2,40358,10091,1,298439736,298439736,15133,5044,10089,5044,0,1,5046,2133115,2.133115
5544,2253,3555,8009415,2,44358,11091,1,321671736,321671736,16633,5544,11089,5544,0,1,5546,1093892,1.093892
6044,2253,3555,8009415,2,48358,12091,1,344903736,344903736,18133,6044,12089,6044,0,1,6046,2439669,2.439669
6544,2253,3555,8009415,2,52358,13091,1,368135736,368135736,19633,6544,13089,6544,0,1,6546,1041580,1.04158
7044,2253,3555,8009415,2,56358,14091,1,391367736,391367736,21133,7044,14089,7044,0,1,7046,3513457,3.513457
44,3903,2055,8020665,2,358,91,1,66262536,66262536,133,44,89,44,0,1,46,155063,0.155063
544,3903,2055,8020665,2,4358,1091,1,90094536,90094536,1633,544,1089,544,0,1,546,913962,0.913962
1044,3903,2055,8020665,2,8358,2091,1,113926536,113926536,3133,1044,2089,1044,0,1,1046,1685162,1.685162
1544,3903,2055,8020665,2,12358,3091,1,137758536,137758536,4633,1544,3089,1544,0,1,1546,1371997,1.371997
2044,3903,2055,8020665,2,16358,4091,1,161590536,161590536,6133,2044,4089,2044,0,1,2046,2535229,2.535229
2544,3903,2055,8020665,2,20358,5091,1,185422536,185422536,7633,2544,5089,2544,0,1,2546,3777274,3.777274
3044,3903,2055,8020665,2,24358,6091,1,209254536,209254536,9133,3044,6089,3044,0,1,3046,2649971,2.649971
3544,3903,2055,8020665,2,28358,7091,1,233086536,233086536,10633,3544,7089,3544,0,1,3546,5564380,5.56438
4044,3903,2055,8020665,2,32358,8091,1,256918536,256918536,12133,4044,8089,4044,0,1,4046,767912,0.767912
4544,3903,2055,8020665,2,36358,9091,1,280750536,280750536,13633,4544,9089,4544,0,1,4546,2540647,2.540647
5044,3903,2055,8020665,2,40358,10091,1,304582536,304582536,15133,5044,10089,5044,0,1,5046,220564,0.220564
5544,3903,2055,8020665,2,44358,11091,1,328414536,328414536,16633,5544,11089,5544,0,1,5546,4847529,4.847529
6044,3903,2055,8020665,2,48358,12091,1,352246536,352246536,18133,6044,12089,6044,0,1,6046,995803,0.995803
6544,3903,2055,8020665,2,52358,13091,1,376078536,376078536,19633,6544,13089,6544,0,1,6546,7557743,7.557743
7044,3903,2055,8020665,2,56358,14091,1,399910536,399910536,21133,7044,14089,7044,0,1,7046,11070840,11.07084
55,4305,1865,8028825,2,446,113,1,66945400,66945400,166,55,111,55,0,1,57,120390,0.12039
455,4305,1865,8028825,2,3646,913,1,86689400,86689400,1366,455,911,455,0,1,457,744205,0.744205
855,4305,1865,8028825,2,6846,1713,1,106433400,106433400,2566,855,1711,855,0,1,857,545425,0.545425
1255,4305,1865,8028825,2,10046,2513,1,126177400,126177400,3766,1255,2511,1255,0,1,1257,600248,0.600248
1655,4305,1865,8028825,2,13246,3313,1,145921400,145921400,4966,1655,3311,1655,0,1,1657,2019294,2.019294
2055,4305,1865,8028825,2,16446,4113,1,165665400,165665400,6166,2055,4111,2055,0,1,2057,449673,0.449673
2455,4305,1865,8028825,2,19646,4913,1,185409400,185409400,7366,2455,4911,2455,0,1,2457,800968,0.800968
2855,4305,1865,8028825,2,22846,5713,1,205153400,205153400,8566,2855,5711,2855,0,1,2857,1197625,1.197625
3255,4305,1865,8028825,2,26046,6513,1,224897400,224897400,9766,3255,6511,3255,0,1,3257,835072,0.835072
3655,4305,1865,8028825,2,29246,7313,1,244641400,244641400,10966,3655,7311,3655,0,1,3657,272250,0.27225
4055,4305,1865,8028825,2,32446,8113,1,264385400,264385400,12166,4055,8111,4055,0,1,4057,801931,0.801931
4455,4305,1865,8028825,2,35646,8913,1,284129400,284129400,13366,4455,8911,4455,0,1,4457,105323,0.105323
4855,4305,1865,8028825,2,38846,9713,1,303873400,303873400,14566,4855,9711,4855,0,1,4857,2057026,2.057026
5255,4305,1865,8028825,2,42046,10513,1,323617400,323617400,15766,5255,10511,5255,0,1,5257,3090482,3.090482
5655,4305,1865,8028825,2,45246,11313,1,343361400,343361400,16966,5655,11311,5655,0,1,5657,238444,0.238444
6055,4305,1865,8028825,2,48446,12113,1,363105400,363105400,18166,6055,12111,6055,0,1,6057,385676,0.385676
6455,4305,1865,8028825,2,51646,12913,1,382849400,382849400,19366,6455,12911,6455,0,1,6457,827430,0.82743
6855,4305,1865,8028825,2,54846,13713,1,402593400,402593400,20566,6855,13711,6855,0,1,6857,1078098,1.078098
35,1140,7045,8031300,2,286,73,1,66542200,66542200,106,35,71,35,0,1,37,156273,0.156273
535,1140,7045,8031300,2,4286,1073,1,99282200,99282200,1606,535,1071,535,0,1,537,867233,0.867233
1035,1140,7045,8031300,2,8286,2073,1,132022200,132022200,3106,1035,2071,1035,0,1,1037,1599085,1.599085
1535,1140,7045,8031300,2,12286,3073,1,164762200,164762200,4606,1535,3071,1535,0,1,1537,2376519,2.376519
2035,1140,7045,8031300,2,16286,4073,1,197502200,197502200,6106,2035,4071,2035,0,1,2037,3128452,3.128452
2535,1140,7045,8031300,2,20286,5073,1,230242200,230242200,7606,2535,5071,2535,0,1,2537,3879825,3.879825
3035,1140,7045,8031300,2,24286,6073,1,262982200,262982200,9106,3035,6071,3035,0,1,3037,4637787,4.637787
3535,1140,7045,8031300,2,28286,7073,1,295722200,295722200,10606,3535,7071,3535,0,1,3537,5401389,5.401389
4035,1140,7045,8031300,2,32286,8073,1,328462200,328462200,12106,4035,8071,4035,0,1,4037,6163936,6.163936
55,1555,5165,8031575,2,446,113,1,67209400,67209400,166,55,111,55,0,1,57,164763,0.164763
455,1555,5165,8031575,2,3646,913,1,88713400,88713400,1366,455,911,455,0,1,457,713334,0.713334
855,1555,5165,8031575,2,6846,1713,1,110217400,110217400,2566,855,1711,855,0,1,857,522142,0.522142
1255,1555,5165,8031575,2,10046,2513,1,131721400,131721400,3766,1255,2511,1255,0,1,1257,294613,0.294613
1655,1555,5165,8031575,2,13246,3313,1,153225400,153225400,4966,1655,3311,1655,0,1,1657,290453,0.290453
2055,1555,5165,8031575,2,16446,4113,1,174729400,174729400,6166,2055,4111,2055,0,1,2057,3244421,3.244421
2455,1555,5165,8031575,2,19646,4913,1,196233400,196233400,7366,2455,4911,2455,0,1,2457,330206,0.330206
2855,1555,5165,8031575,2,22846,5713,1,217737400,217737400,8566,2855,5711,2855,0,1,2857,2162566,2.162566
3255,1555,5165,8031575,2,26046,6513,1,239241400,239241400,9766,3255,6511,3255,0,1,3257,3768785,3.768785
3655,1555,5165,8031575,2,29246,7313,1,260745400,260745400,10966,3655,7311,3655,0,1,3657,2560643,2.560643
4055,1555,5165,8031575,2,32446,8113,1,282249400,282249400,12166,4055,8111,4055,0,1,4057,6358849,6.358849
4455,1555,5165,8031575,2,35646,8913,1,303753400,303753400,13366,4455,8911,4455,0,1,4457,2890155,2.890155
4855,1555,5165,8031575,2,38846,9713,1,325257400,325257400,14566,4855,9711,4855,0,1,4857,504686,0.504686
5255,1555,5165,8031575,2,42046,10513,1,346761400,346761400,15766,5255,10511,5255,0,1,5257,1134580,1.13458
5655,1555,5165,8031575,2,45246,11313,1,368265400,368265400,16966,5655,11311,5655,0,1,5657,546128,0.546128
6055,1555,5165,8031575,2,48446,12113,1,389769400,389769400,18166,6055,12111,6055,0,1,6057,927691,0.927691
6455,1555,5165,8031575,2,51646,12913,1,411273400,411273400,19366,6455,12911,6455,0,1,6457,410417,0.410417
6855,1555,5165,8031575,2,54846,13713,1,432777400,432777400,20566,6855,13711,6855,0,1,6857,1609811,1.609811
39,1143,7041,8047863,2,318,81,1,66936312,66936312,118,39,79,39,0,1,41,21768,0.021768
539,1143,7041,8047863,2,4318,1081,1,99672312,99672312,1618,539,1079,539,0,1,541,32237,0.032237
1039,1143,7041,8047863,2,8318,2081,1,132408312,132408312,3118,1039,2079,1039,0,1,1041,258538,0.258538
1539,1143,7041,8047863,2,12318,3081,1,165144312,165144312,4618,1539,3079,1539,0,1,1541,185976,0.185976
2039,1143,7041,8047863,2,16318,4081,1,197880312,197880312,6118,2039,4079,2039,0,1,2041,874717,0.874717
2539,1143,7041,8047863,2,20318,5081,1,230616312,230616312,7618,2539,5079,2539,0,1,2541,289485,0.289485
3039,1143,7041,8047863,2,24318,6081,1,263352312,263352312,9118,3039,6079,3039,0,1,3041,673109,0.673109
3539,1143,7041,8047863,2,28318,7081,1,296088312,296088312,10618,3539,7079,3539,0,1,3541,909566,0.909566
4039,1143,7041,8047863,2,32318,8081,1,328824312,328824312,12118,4039,8079,4039,0,1,4041,515746,0.515746
4539,1143,7041,8047863,2,36318,9081,1,361560312,361560312,13618,4539,9079,4539,0,1,4541,316061,0.316061
5039,1143,7041,8047863,2,40318,10081,1,394296312,394296312,15118,5039,10079,5039,0,1,5041,844129,0.844129
5539,1143,7041,8047863,2,44318,11081,1,427032312,427032312,16618,5539,11079,5539,0,1,5541,5079081,5.079081
6039,1143,7041,8047863,2,48318,12081,1,459768312,459768312,18118,6039,12079,6039,0,1,6041,2230888,2.230888
6539,1143,7041,8047863,2,52318,13081,1,492504312,492504312,19618,6539,13079,6539,0,1,6541,267831,0.267831
7039,1143,7041,8047863,2,56318,14081,1,525240312,525240312,21118,7039,14079,7039,0,1,7041,1105285,1.105285
40,3300,2440,8052000,2,326,83,1,66252800,66252800,121,40,81,40,0,1,42,140148,0.140148
440,3300,2440,8052000,2,3526,883,1,84620800,84620800,1321,440,881,440,0,1,442,742600,0.7426
840,3300,2440,8052000,2,6726,1683,1,102988800,102988800,2521,840,1681,840,0,1,842,127603,0.127603
1240,3300,2440,8052000,2,9926,2483,1,121356800,121356800,3721,1240,2481,1240,0,1,1242,1944761,1.944761
1640,3300,2440,8052000,2,13126,3283,1,139724800,139724800,4921,1640,3281,1640,0,1,1642,917170,0.91717
2040,3300,2440,8052000,2,16326,4083,1,158092800,158092800,6121,2040,4081,2040,0,1,2042,2844210,2.84421
2440,3300,2440,8052000,2,19526,4883,1,176460800,176460800,7321,2440,4881,2440,0,1,2442,1285011,1.285011
2840,3300,2440,8052000,2,22726,5683,1,194828800,194828800,8521,2840,5681,2840,0,1,2842,4367245,4.367245
3240,3300,2440,8052000,2,25926,6483,1,213196800,213196800,9721,3240,6481,3240,0,1,3242,418156,0.418156
3640,3300,2440,8052000,2,29126,7283,1,231564800,231564800,10921,3640,7281,3640,0,1,3642,586348,0.586348
4040,3300,2440,8052000,2,32326,8083,1,249932800,249932800,12121,4040,8081,4040,0,1,4042,2163271,2.163271
4440,3300,2440,8052000,2,35526,8883,1,268300800,268300800,13321,4440,8881,4440,0,1,4442,11794,0.011794
4840,3300,2440,8052000,2,38726,9683,1,286668800,286668800,14521,4840,9681,4840,0,1,4842,493214,0.493214
5240,3300,2440,8052000,2,41926,10483,1,305036800,305036800,15721,5240,10481,5240,0,1,5242,1779485,1.779485
5640,3300,2440,8052000,2,45126,11283,1,323404800,323404800,16921,5640,11281,5640,0,1,5642,1028123,1.028123
6040,3300,2440,8052000,2,48326,12083,1,341772800,341772800,18121,6040,12081,6040,0,1,6042,1956453,1.956453
6440,3300,2440,8052000,2,51526,12883,1,360140800,360140800,19321,6440,12881,6440,0,1,6442,203109,0.203109
6840,3300,2440,8052000,2,54726,13683,1,378508800,378508800,20521,6840,13681,6840,0,1,6842,1107499,1.107499
40,2050,3940,8077000,2,326,83,1,66532800,66532800,121,40,81,40,0,1,42,12140,0.01214
440,2050,3940,8077000,2,3526,883,1,85700800,85700800,1321,440,881,440,0,1,442,83839,0.083839
840,2050,3940,8077000,2,6726,1683,1,104868800,104868800,2521,840,1681,840,0,1,842,8046,0.008046
1240,2050,3940,8077000,2,9926,2483,1,124036800,124036800,3721,1240,2481,1240,0,1,1242,275369,0.275369
1640,2050,3940,8077000,2,13126,3283,1,143204800,143204800,4921,1640,3281,1640,0,1,1642,652014,0.652014
2040,2050,3940,8077000,2,16326,4083,1,162372800,162372800,6121,2040,4081,2040,0,1,2042,49460,0.04946
2440,2050,3940,8077000,2,19526,4883,1,181540800,181540800,7321,2440,4881,2440,0,1,2442,1355215,1.355215
2840,2050,3940,8077000,2,22726,5683,1,200708800,200708800,8521,2840,5681,2840,0,1,2842,49781,0.049781
3240,2050,3940,8077000,2,25926,6483,1,219876800,219876800,9721,3240,6481,3240,0,1,3242,51855,0.051855
3640,2050,3940,8077000,2,29126,7283,1,239044800,239044800,10921,3640,7281,3640,0,1,3642,1139767,1.139767
4040,2050,3940,8077000,2,32326,8083,1,258212800,258212800,12121,4040,8081,4040,0,1,4042,518650,0.51865
4440,2050,3940,8077000,2,35526,8883,1,277380800,277380800,13321,4440,8881,4440,0,1,4442,604005,0.604005
4840,2050,3940,8077000,2,38726,9683,1,296548800,296548800,14521,4840,9681,4840,0,1,4842,88207,0.088207
5240,2050,3940,8077000,2,41926,10483,1,315716800,315716800,15721,5240,10481,5240,0,1,5242,356121,0.356121
5640,2050,3940,8077000,2,45126,11283,1,334884800,334884800,16921,5640,11281,5640,0,1,5642,779124,0.779124
6040,2050,3940,8077000,2,48326,12083,1,354052800,354052800,18121,6040,12081,6040,0,1,6042,260806,0.260806
6440,2050,3940,8077000,2,51526,12883,1,373220800,373220800,19321,6440,12881,6440,0,1,6442,1065690,1.06569
6840,2050,3940,8077000,2,54726,13683,1,392388800,392388800,20521,6840,13681,6840,0,1,6842,1895070,1.89507
40,6550,1240,8122000,2,326,83,1,67468800,67468800,121,40,81,40,0,1,42,7654,0.007654
440,6550,1240,8122000,2,3526,883,1,92396800,92396800,1321,440,881,440,0,1,442,18266,0.018266
840,6550,1240,8122000,2,6726,1683,1,117324800,117324800,2521,840,1681,840,0,1,842,213477,0.213477
1240,6550,1240,8122000,2,9926,2483,1,142252800,142252800,3721,1240,2481,1240,0,1,1242,17695,0.017695
1640,6550,1240,8122000,2,13126,3283,1,167180800,167180800,4921,1640,3281,1640,0,1,1642,478652,0.478652
2040,6550,1240,8122000,2,16326,4083,1,192108800,192108800,6121,2040,4081,2040,0,1,2042,223579,0.223579
2440,6550,1240,8122000,2,19526,4883,1,217036800,217036800,7321,2440,4881,2440,0,1,2442,476651,0.476651
2840,6550,1240,8122000,2,22726,5683,1,241964800,241964800,8521,2840,5681,2840,0,1,2842,332633,0.332633
3240,6550,1240,8122000,2,25926,6483,1,266892800,266892800,9721,3240,6481,3240,0,1,3242,289752,0.289752
3640,6550,1240,8122000,2,29126,7283,1,291820800,291820800,10921,3640,7281,3640,0,1,3642,1672356,1.672356
4040,6550,1240,8122000,2,32326,8083,1,316748800,316748800,12121,4040,8081,4040,0,1,4042,4273726,4.273726
4440,6550,1240,8122000,2,35526,8883,1,341676800,341676800,13321,4440,8881,4440,0,1,4442,1123393,1.123393
4840,6550,1240,8122000,2,38726,9683,1,366604800,366604800,14521,4840,9681,4840,0,1,4842,4161103,4.161103
5240,6550,1240,8122000,2,41926,10483,1,391532800,391532800,15721,5240,10481,5240,0,1,5242,383260,0.38326
5640,6550,1240,8122000,2,45126,11283,1,416460800,416460800,16921,5640,11281,5640,0,1,5642,19410,0.01941
6040,6550,1240,8122000,2,48326,12083,1,441388800,441388800,18121,6040,12081,6040,0,1,6042,4931092,4.931092
6440,6550,1240,8122000,2,51526,12883,1,466316800,466316800,19321,6440,12881,6440,0,1,6442,2193868,2.193868
6840,6550,1240,8122000,2,54726,13683,1,491244800,491244800,20521,6840,13681,6840,0,1,6842,512871,0.512871
40,3800,2140,8132000,2,326,83,1,66956800,66956800,121,40,81,40,0,1,42,148310,0.14831
440,3800,2140,8132000,2,3526,883,1,85964800,85964800,1321,440,881,440,0,1,442,755660,0.75566
840,3800,2140,8132000,2,6726,1683,1,104972800,104972800,2521,840,1681,840,0,1,842,442565,0.442565
1240,3800,2140,8132000,2,9926,2483,1,123980800,123980800,3721,1240,2481,1240,0,1,1242,2004911,2.004911
1640,3800,2140,8132000,2,13126,3283,1,142988800,142988800,4921,1640,3281,1640,0,1,1642,2627375,2.627375
2040,3800,2140,8132000,2,16326,4083,1,161996800,161996800,6121,2040,4081,2040,0,1,2042,640402,0.640402
2440,3800,2140,8132000,2,19526,4883,1,181004800,181004800,7321,2440,4881,2440,0,1,2442,3324274,3.324274
2840,3800,2140,8132000,2,22726,5683,1,200012800,200012800,8521,2840,5681,2840,0,1,2842,1621782,1.621782
3240,3800,2140,8132000,2,25926,6483,1,219020800,219020800,9721,3240,6481,3240,0,1,3242,5156373,5.156373
3640,3800,2140,8132000,2,29126,7283,1,238028800,238028800,10921,3640,7281,3640,0,1,3642,1550131,1.550131
4040,3800,2140,8132000,2,32326,8083,1,257036800,257036800,12121,4040,8081,4040,0,1,4042,2945247,2.945247
4440,3800,2140,8132000,2,35526,8883,1,276044800,276044800,13321,4440,8881,4440,0,1,4442,2614467,2.614467
4840,3800,2140,8132000,2,38726,9683,1,295052800,295052800,14521,4840,9681,4840,0,1,4842,5327209,5.327209
5240,3800,2140,8132000,2,41926,10483,1,314060800,314060800,15721,5240,10481,5240,0,1,5242,95842,0.095842
5640,3800,2140,8132000,2,45126,11283,1,333068800,333068800,16921,5640,11281,5640,0,1,5642,4332078,4.332078
6040,3800,2140,8132000,2,48326,12083,1,352076800,352076800,18121,6040,12081,6040,0,1,6042,2293287,2.293287
6440,3800,2140,8132000,2,51526,12883,1,371084800,371084800,19321,6440,12881,6440,0,1,6442,231454,0.231454
6840,3800,2140,8132000,2,54726,13683,1,390092800,390092800,20521,6840,13681,6840,0,1,6842,1193866,1.193866
44,1153,7055,8134415,2,358,91,1,67964536,67964536,133,44,89,44,0,1,46,6790,0.00679
544,1153,7055,8134415,2,4358,1091,1,100796536,100796536,1633,544,1089,544,0,1,546,110896,0.110896
1044,1153,7055,8134415,2,8358,2091,1,133628536,133628536,3133,1044,2089,1044,0,1,1046,35213,0.035213
1544,1153,7055,8134415,2,12358,3091,1,166460536,166460536,4633,1544,3089,1544,0,1,1546,64482,0.064482
2044,1153,7055,8134415,2,16358,4091,1,199292536,199292536,6133,2044,4089,2044,0,1,2046,607881,0.607881
2544,1153,7055,8134415,2,20358,5091,1,232124536,232124536,7633,2544,5089,2544,0,1,2546,370216,0.370216
3044,1153,7055,8134415,2,24358,6091,1,264956536,264956536,9133,3044,6089,3044,0,1,3046,547254,0.547254
3544,1153,7055,8134415,2,28358,7091,1,297788536,297788536,10633,3544,7089,3544,0,1,3546,663715,0.663715
4044,1153,7055,8134415,2,32358,8091,1,330620536,330620536,12133,4044,8089,4044,0,1,4046,1419914,1.419914
4544,1153,7055,8134415,2,36358,9091,1,363452536,363452536,13633,4544,9089,4544,0,1,4546,706002,0.706002
5044,1153,7055,8134415,2,40358,10091,1,396284536,396284536,15133,5044,10089,5044,0,1,5046,51764,0.051764
5544,1153,7055,8134415,2,44358,11091,1,429116536,429116536,16633,5544,11089,5544,0,1,5546,4260462,4.260462
6044,1153,7055,8134415,2,48358,12091,1,461948536,461948536,18133,6044,12089,6044,0,1,6046,2690318,2.690318
6544,1153,7055,8134415,2,52358,13091,1,494780536,494780536,19633,6544,13089,6544,0,1,6546,3330653,3.330653
7044,1153,7055,8134415,2,56358,14091,1,527612536,527612536,21133,7044,14089,7044,0,1,7046,273806,0.273806
55,3305,2465,8146825,2,446,113,1,67713400,67713400,166,55,111,55,0,1,57,167562,0.167562
455,3305,2465,8146825,2,3646,913,1,86177400,86177400,1366,455,911,455,0,1,457,787614,0.787614
855,3305,2465,8146825,2,6846,1713,1,104641400,104641400,2566,855,1711,855,0,1,857,881928,0.881928
1255,3305,2465,8146825,2,10046,2513,1,123105400,123105400,3766,1255,2511,1255,0,1,1257,1718267,1.718267
1655,3305,2465,8146825,2,13246,3313,1,141569400,141569400,4966,1655,3311,1655,0,1,1657,1675075,1.675075
2055,3305,2465,8146825,2,16446,4113,1,160033400,160033400,6166,2055,4111,2055,0,1,2057,3291366,3.291366
2455,3305,2465,8146825,2,19646,4913,1,178497400,178497400,7366,2455,4911,2455,0,1,2457,3863994,3.863994
2855,3305,2465,8146825,2,22846,5713,1,196961400,196961400,8566,2855,5711,2855,0,1,2857,1611161,1.611161
3255,3305,2465,8146825,2,26046,6513,1,215425400,215425400,9766,3255,6511,3255,0,1,3257,1546779,1.546779
3655,3305,2465,8146825,2,29246,7313,1,233889400,233889400,10966,3655,7311,3655,0,1,3657,5804615,5.804615
4055,3305,2465,8146825,2,32446,8113,1,252353400,252353400,12166,4055,8111,4055,0,1,4057,993259,0.993259
4455,3305,2465,8146825,2,35646,8913,1,270817400,270817400,13366,4455,8911,4455,0,1,4457,809384,0.809384
4855,3305,2465,8146825,2,38846,9713,1,289281400,289281400,14566,4855,9711,4855,0,1,4857,340875,0.340875
5255,3305,2465,8146825,2,42046,10513,1,307745400,307745400,15766,5255,10511,5255,0,1,5257,3095146,3.095146
5655,3305,2465,8146825,2,45246,11313,1,326209400,326209400,16966,5655,11311,5655,0,1,5657,2367006,2.367006
6055,3305,2465,8146825,2,48446,12113,1,344673400,344673400,18166,6055,12111,6055,0,1,6057,234605,0.234605
6455,3305,2465,8146825,2,51646,12913,1,363137400,363137400,19366,6455,12911,6455,0,1,6457,1424169,1.424169
6855,3305,2465,8146825,2,54846,13713,1,381601400,381601400,20566,6855,13711,6855,0,1,6857,1192349,1.192349
55,2055,3965,8148075,2,446,113,1,67833400,67833400,166,55,111,55,0,1,57,16620,0.01662
455,2055,3965,8148075,2,3646,913,1,87097400,87097400,1366,455,911,455,0,1,457,43792,0.043792
855,2055,3965,8148075,2,6846,1713,1,106361400,106361400,2566,855,1711,855,0,1,857,277799,0.277799
1255,2055,3965,8148075,2,10046,2513,1,125625400,125625400,3766,1255,2511,1255,0,1,1257,280386,0.280386
1655,2055,3965,8148075,2,13246,3313,1,144889400,144889400,4966,1655,3311,1655,0,1,1657,470457,0.470457
2055,2055,3965,8148075,2,16446,4113,1,164153400,164153400,6166,2055,4111,2055,0,1,2057,107359,0.107359
2455,2055,3965,8148075,2,19646,4913,1,183417400,183417400,7366,2455,4911,2455,0,1,2457,159936,0.159936
2855,2055,3965,8148075,2,22846,5713,1,202681400,202681400,8566,2855,5711,2855,0,1,2857,476464,0.476464
3255,2055,3965,8148075,2,26046,6513,1,221945400,221945400,9766,3255,6511,3255,0,1,3257,14662,0.014662
3655,2055,3965,8148075,2,29246,7313,1,241209400,241209400,10966,3655,7311,3655,0,1,3657,661415,0.661415
4055,2055,3965,8148075,2,32446,8113,1,260473400,260473400,12166,4055,8111,4055,0,1,4057,343028,0.343028
4455,2055,3965,8148075,2,35646,8913,1,279737400,279737400,13366,4455,8911,4455,0,1,4457,132484,0.132484
4855,2055,3965,8148075,2,38846,9713,1,299001400,299001400,14566,4855,9711,4855,0,1,4857,866524,0.866524
5255,2055,3965,8148075,2,42046,10513,1,318265400,318265400,15766,5255,10511,5255,0,1,5257,435926,0.435926
5655,2055,3965,8148075,2,45246,11313,1,337529400,337529400,16966,5655,11311,5655,0,1,5657,1764107,1.764107
6055,2055,3965,8148075,2,48446,12113,1,356793400,356793400,18166,6055,12111,6055,0,1,6057,268914,0.268914
6455,2055,3965,8148075,2,51646,12913,1,376057400,376057400,19366,6455,12911,6455,0,1,6457,689554,0.689554
6855,2055,3965,8148075,2,54846,13713,1,395321400,395321400,20566,6855,13711,6855,0,1,6857,1877948,1.877948
40,5300,1540,8162000,2,326,83,1,67484800,67484800,121,40,81,40,0,1,42,144885,0.144885
440,5300,1540,8162000,2,3526,883,1,89372800,89372800,1321,440,881,440,0,1,442,129143,0.129143
840,5300,1540,8162000,2,6726,1683,1,111260800,111260800,2521,840,1681,840,0,1,842,858053,0.858053
1240,5300,1540,8162000,2,9926,2483,1,133148800,133148800,3721,1240,2481,1240,0,1,1242,2017285,2.017285
1640,5300,1540,8162000,2,13126,3283,1,155036800,155036800,4921,1640,3281,1640,0,1,1642,330974,0.330974
2040,5300,1540,8162000,2,16326,4083,1,176924800,176924800,6121,2040,4081,2040,0,1,2042,1990078,1.990078
2440,5300,1540,8162000,2,19526,4883,1,198812800,198812800,7321,2440,4881,2440,0,1,2442,441468,0.441468
2840,5300,1540,8162000,2,22726,5683,1,220700800,220700800,8521,2840,5681,2840,0,1,2842,3541595,3.541595
3240,5300,1540,8162000,2,25926,6483,1,242588800,242588800,9721,3240,6481,3240,0,1,3242,2825529,2.825529
3640,5300,1540,8162000,2,29126,7283,1,264476800,264476800,10921,3640,7281,3640,0,1,3642,761766,0.761766
4040,5300,1540,8162000,2,32326,8083,1,286364800,286364800,12121,4040,8081,4040,0,1,4042,318009,0.318009
4440,5300,1540,8162000,2,35526,8883,1,308252800,308252800,13321,4440,8881,4440,0,1,4442,2073496,2.073496
4840,5300,1540,8162000,2,38726,9683,1,330140800,330140800,14521,4840,9681,4840,0,1,4842,640052,0.640052
5240,5300,1540,8162000,2,41926,10483,1,352028800,352028800,15721,5240,10481,5240,0,1,5242,4573850,4.57385
5640,5300,1540,8162000,2,45126,11283,1,373916800,373916800,16921,5640,11281,5640,0,1,5642,4270231,4.270231
6040,5300,1540,8162000,2,48326,12083,1,395804800,395804800,18121,6040,12081,6040,0,1,6042,951492,0.951492
6440,5300,1540,8162000,2,51526,12883,1,417692800,417692800,19321,6440,12881,6440,0,1,6442,4343114,4.343114
6840,5300,1540,8162000,2,54726,13683,1,439580800,439580800,20521,6840,13681,6840,0,1,6842,3823291,3.823291
40,1800,4540,8172000,2,326,83,1,67404800,67404800,121,40,81,40,0,1,42,152999,0.152999
440,1800,4540,8172000,2,3526,883,1,87692800,87692800,1321,440,881,440,0,1,442,765093,0.765093
840,1800,4540,8172000,2,6726,1683,1,107980800,107980800,2521,840,1681,840,0,1,842,1381926,1.381926
1240,1800,4540,8172000,2,9926,2483,1,128268800,128268800,3721,1240,2481,1240,0,1,1242,40001,0.040001
1640,1800,4540,8172000,2,13126,3283,1,148556800,148556800,4921,1640,3281,1640,0,1,1642,62228,0.062228
2040,1800,4540,8172000,2,16326,4083,1,168844800,168844800,6121,2040,4081,2040,0,1,2042,822335,0.822335
2440,1800,4540,8172000,2,19526,4883,1,189132800,189132800,7321,2440,4881,2440,0,1,2442,3891307,3.891307
2840,1800,4540,8172000,2,22726,5683,1,209420800,209420800,8521,2840,5681,2840,0,1,2842,2365949,2.365949
3240,1800,4540,8172000,2,25926,6483,1,229708800,229708800,9721,3240,6481,3240,0,1,3242,481366,0.481366
3640,1800,4540,8172000,2,29126,7283,1,249996800,249996800,10921,3640,7281,3640,0,1,3642,548284,0.548284
4040,1800,4540,8172000,2,32326,8083,1,270284800,270284800,12121,4040,8081,4040,0,1,4042,303441,0.303441
4440,1800,4540,8172000,2,35526,8883,1,290572800,290572800,13321,4440,8881,4440,0,1,4442,962203,0.962203
4840,1800,4540,8172000,2,38726,9683,1,310860800,310860800,14521,4840,9681,4840,0,1,4842,368371,0.368371
5240,1800,4540,8172000,2,41926,10483,1,331148800,331148800,15721,5240,10481,5240,0,1,5242,1581852,1.581852
5640,1800,4540,8172000,2,45126,11283,1,351436800,351436800,16921,5640,11281,5640,0,1,5642,1665645,1.665645
6040,1800,4540,8172000,2,48326,12083,1,371724800,371724800,18121,6040,12081,6040,0,1,6042,701593,0.701593
6440,1800,4540,8172000,2,51526,12883,1,392012800,392012800,19321,6440,12881,6440,0,1,6442,2282838,2.282838
6840,1800,4540,8172000,2,54726,13683,1,412300800,412300800,20521,6840,13681,6840,0,1,6842,1662752,1.662752
55,3805,2165,8237825,2,446,113,1,68529400,68529400,166,55,111,55,0,1,57,172665,0.172665
455,3805,2165,8237825,2,3646,913,1,87633400,87633400,1366,455,911,455,0,1,457,795551,0.795551
855,3805,2165,8237825,2,6846,1713,1,106737400,106737400,2566,855,1711,855,0,1,857,1436816,1.436816
1255,3805,2165,8237825,2,10046,2513,1,125841400,125841400,3766,1255,2511,1255,0,1,1257,416268,0.416268
1655,3805,2165,8237825,2,13246,3313,1,144945400,144945400,4966,1655,3311,1655,0,1,1657,111620,0.11162
2055,3805,2165,8237825,2,16446,4113,1,164049400,164049400,6166,2055,4111,2055,0,1,2057,2698088,2.698088
2455,3805,2165,8237825,2,19646,4913,1,183153400,183153400,7366,2455,4911,2455,0,1,2457,2818816,2.818816
2855,3805,2165,8237825,2,22846,5713,1,202257400,202257400,8566,2855,5711,2855,0,1,2857,1853147,1.853147
3255,3805,2165,8237825,2,26046,6513,1,221361400,221361400,9766,3255,6511,3255,0,1,3257,4070237,4.070237
3655,3805,2165,8237825,2,29246,7313,1,240465400,240465400,10966,3655,7311,3655,0,1,3657,655837,0.655837
4055,3805,2165,8237825,2,32446,8113,1,259569400,259569400,12166,4055,8111,4055,0,1,4057,6536444,6.536444
4455,3805,2165,8237825,2,35646,8913,1,278673400,278673400,13366,4455,8911,4455,0,1,4457,7175837,7.175837
4855,3805,2165,8237825,2,38846,9713,1,297777400,297777400,14566,4855,9711,4855,0,1,4857,163312,0.163312
5255,3805,2165,8237825,2,42046,10513,1,316881400,316881400,15766,5255,10511,5255,0,1,5257,388964,0.388964
5655,3805,2165,8237825,2,45246,11313,1,335985400,335985400,16966,5655,11311,5655,0,1,5657,1549465,1.549465
6055,3805,2165,8237825,2,48446,12113,1,355089400,355089400,18166,6055,12111,6055,0,1,6057,2599335,2.599335
6455,3805,2165,8237825,2,51646,12913,1,374193400,374193400,19366,6455,12911,6455,0,1,6457,1599579,1.599579
6855,3805,2165,8237825,2,54846,13713,1,393297400,393297400,20566,6855,13711,6855,0,1,6857,11001467,11.001467
55,1805,4565,8239825,2,446,113,1,68721400,68721400,166,55,111,55,0,1,57,173884,0.173884
455,1805,4565,8239825,2,3646,913,1,89105400,89105400,1366,455,911,455,0,1,457,714574,0.714574
855,1805,4565,8239825,2,6846,1713,1,109489400,109489400,2566,855,1711,855,0,1,857,242889,0.242889
1255,1805,4565,8239825,2,10046,2513,1,129873400,129873400,3766,1255,2511,1255,0,1,1257,2069526,2.069526
1655,1805,4565,8239825,2,13246,3313,1,150257400,150257400,4966,1655,3311,1655,0,1,1657,2068447,2.068447
2055,1805,4565,8239825,2,16446,4113,1,170641400,170641400,6166,2055,4111,2055,0,1,2057,464633,0.464633
2455,1805,4565,8239825,2,19646,4913,1,191025400,191025400,7366,2455,4911,2455,0,1,2457,1175291,1.175291
2855,1805,4565,8239825,2,22846,5713,1,211409400,211409400,8566,2855,5711,2855,0,1,2857,952359,0.952359
3255,1805,4565,8239825,2,26046,6513,1,231793400,231793400,9766,3255,6511,3255,0,1,3257,58925,0.058925
3655,1805,4565,8239825,2,29246,7313,1,252177400,252177400,10966,3655,7311,3655,0,1,3657,3581778,3.581778
4055,1805,4565,8239825,2,32446,8113,1,272561400,272561400,12166,4055,8111,4055,0,1,4057,252789,0.252789
4455,1805,4565,8239825,2,35646,8913,1,292945400,292945400,13366,4455,8911,4455,0,1,4457,3992482,3.992482
4855,1805,4565,8239825,2,38846,9713,1,313329400,313329400,14566,4855,9711,4855,0,1,4857,2607075,2.607075
5255,1805,4565,8239825,2,42046,10513,1,333713400,333713400,15766,5255,10511,5255,0,1,5257,2843435,2.843435
5655,1805,4565,8239825,2,45246,11313,1,354097400,354097400,16966,5655,11311,5655,0,1,5657,459516,0.459516
6055,1805,4565,8239825,2,48446,12113,1,374481400,374481400,18166,6055,12111,6055,0,1,6057,702365,0.702365
6455,1805,4565,8239825,2,51646,12913,1,394865400,394865400,19366,6455,12911,6455,0,1,6457,111640,0.11164
6855,1805,4565,8239825,2,54846,13713,1,415249400,415249400,20566,6855,13711,6855,0,1,6857,6644372,6.644372
40,1300,6340,8242000,2,326,83,1,68380800,68380800,121,40,81,40,0,1,42,153904,0.153904
440,1300,6340,8242000,2,3526,883,1,92828800,92828800,1321,440,881,440,0,1,442,251304,0.251304
840,1300,6340,8242000,2,6726,1683,1,117276800,117276800,2521,840,1681,840,0,1,842,1303932,1.303932
1240,1300,6340,8242000,2,9926,2483,1,141724800,141724800,3721,1240,2481,1240,0,1,1242,999989,0.999989
1640,1300,6340,8242000,2,13126,3283,1,166172800,166172800,4921,1640,3281,1640,0,1,1642,766295,0.766295
2040,1300,6340,8242000,2,16326,4083,1,190620800,190620800,6121,2040,4081,2040,0,1,2042,3058414,3.058414
2440,1300,6340,8242000,2,19526,4883,1,215068800,215068800,7321,2440,4881,2440,0,1,2442,12495,0.012495
2840,1300,6340,8242000,2,22726,5683,1,239516800,239516800,8521,2840,5681,2840,0,1,2842,2408850,2.40885
3240,1300,6340,8242000,2,25926,6483,1,263964800,263964800,9721,3240,6481,3240,0,1,3242,899913,0.899913
3640,1300,6340,8242000,2,29126,7283,1,288412800,288412800,10921,3640,7281,3640,0,1,3642,1718912,1.718912
4040,1300,6340,8242000,2,32326,8083,1,312860800,312860800,12121,4040,8081,4040,0,1,4042,417997,0.417997
4440,1300,6340,8242000,2,35526,8883,1,337308800,337308800,13321,4440,8881,4440,0,1,4442,364471,0.364471
4840,1300,6340,8242000,2,38726,9683,1,361756800,361756800,14521,4840,9681,4840,0,1,4842,1449086,1.449086
5240,1300,6340,8242000,2,41926,10483,1,386204800,386204800,15721,5240,10481,5240,0,1,5242,1706602,1.706602
5640,1300,6340,8242000,2,45126,11283,1,410652800,410652800,16921,5640,11281,5640,0,1,5642,5845864,5.845864
6040,1300,6340,8242000,2,48326,12083,1,435100800,435100800,18121,6040,12081,6040,0,1,6042,166090,0.16609
6440,1300,6340,8242000,2,51526,12883,1,459548800,459548800,19321,6440,12881,6440,0,1,6442,4326841,4.326841
6840,1300,6340,8242000,2,54726,13683,1,483996800,483996800,20521,6840,13681,6840,0,1,6842,568578,0.568578
55,6555,1265,8292075,2,446,113,1,69777400,69777400,166,55,111,55,0,1,57,18082,0.018082
455,6555,1265,8292075,2,3646,913,1,94801400,94801400,1366,455,911,455,0,1,457,84758,0.084758
855,6555,1265,8292075,2,6846,1713,1,119825400,119825400,2566,855,1711,855,0,1,857,12979,0.012979
1255,6555,1265,8292075,2,10046,2513,1,144849400,144849400,3766,1255,2511,1255,0,1,1257,64607,0.064607
1655,6555,1265,8292075,2,13246,3313,1,169873400,169873400,4966,1655,3311,1655,0,1,1657,324861,0.324861
2055,6555,1265,8292075,2,16446,4113,1,194897400,194897400,6166,2055,4111,2055,0,1,2057,75403,0.075403
2455,6555,1265,8292075,2,19646,4913,1,219921400,219921400,7366,2455,4911,2455,0,1,2457,1759807,1.759807
2855,6555,1265,8292075,2,22846,5713,1,244945400,244945400,8566,2855,5711,2855,0,1,2857,18968,0.018968
3255,6555,1265,8292075,2,26046,6513,1,269969400,269969400,9766,3255,6511,3255,0,1,3257,475945,0.475945
3655,6555,1265,8292075,2,29246,7313,1,294993400,294993400,10966,3655,7311,3655,0,1,3657,74894,0.074894
4055,6555,1265,8292075,2,32446,8113,1,320017400,320017400,12166,4055,8111,4055,0,1,4057,366769,0.366769
4455,6555,1265,8292075,2,35646,8913,1,345041400,345041400,13366,4455,8911,4455,0,1,4457,265294,0.265294
4855,6555,1265,8292075,2,38846,9713,1,370065400,370065400,14566,4855,9711,4855,0,1,4857,1617303,1.617303
5255,6555,1265,8292075,2,42046,10513,1,395089400,395089400,15766,5255,10511,5255,0,1,5257,3762051,3.762051
5655,6555,1265,8292075,2,45246,11313,1,420113400,420113400,16966,5655,11311,5655,0,1,5657,258955,0.258955
6055,6555,1265,8292075,2,48446,12113,1,445137400,445137400,18166,6055,12111,6055,0,1,6057,1719537,1.719537
6455,6555,1265,8292075,2,51646,12913,1,470161400,470161400,19366,6455,12911,6455,0,1,6457,963414,0.963414
6855,6555,1265,8292075,2,54846,13713,1,495185400,495185400,20566,6855,13711,6855,0,1,6857,705212,0.705212
55,5305,1565,8302325,2,446,113,1,69441400,69441400,166,55,111,55,0,1,57,162841,0.162841
455,5305,1565,8302325,2,3646,913,1,91425400,91425400,1366,455,911,455,0,1,457,793945,0.793945
855,5305,1565,8302325,2,6846,1713,1,113409400,113409400,2566,855,1711,855,0,1,857,670302,0.670302
1255,5305,1565,8302325,2,10046,2513,1,135393400,135393400,3766,1255,2511,1255,0,1,1257,2060802,2.060802
1655,5305,1565,8302325,2,13246,3313,1,157377400,157377400,4966,1655,3311,1655,0,1,1657,176920,0.17692
2055,5305,1565,8302325,2,16446,4113,1,179361400,179361400,6166,2055,4111,2055,0,1,2057,2987234,2.987234
2455,5305,1565,8302325,2,19646,4913,1,201345400,201345400,7366,2455,4911,2455,0,1,2457,3958746,3.958746
2855,5305,1565,8302325,2,22846,5713,1,223329400,223329400,8566,2855,5711,2855,0,1,2857,1249707,1.249707
3255,5305,1565,8302325,2,26046,6513,1,245313400,245313400,9766,3255,6511,3255,0,1,3257,700641,0.700641
3655,5305,1565,8302325,2,29246,7313,1,267297400,267297400,10966,3655,7311,3655,0,1,3657,1191246,1.191246
4055,5305,1565,8302325,2,32446,8113,1,289281400,289281400,12166,4055,8111,4055,0,1,4057,787868,0.787868
4455,5305,1565,8302325,2,35646,8913,1,311265400,311265400,13366,4455,8911,4455,0,1,4457,100093,0.100093
4855,5305,1565,8302325,2,38846,9713,1,333249400,333249400,14566,4855,9711,4855,0,1,4857,1531959,1.531959
5255,5305,1565,8302325,2,42046,10513,1,355233400,355233400,15766,5255,10511,5255,0,1,5257,456897,0.456897
5655,5305,1565,8302325,2,45246,11313,1,377217400,377217400,16966,5655,11311,5655,0,1,5657,2562870,2.56287
6055,5305,1565,8302325,2,48446,12113,1,399201400,399201400,18166,6055,12111,6055,0,1,6057,715891,0.715891
6455,5305,1565,8302325,2,51646,12913,1,421185400,421185400,19366,6455,12911,6455,0,1,6457,6132043,6.132043
6855,5305,1565,8302325,2,54846,13713,1,443169400,443169400,20566,6855,13711,6855,0,1,6857,2106888,2.106888
55,1305,6365,8306325,2,446,113,1,69825400,69825400,166,55,111,55,0,1,57,169048,0.169048
455,1305,6365,8306325,2,3646,913,1,94369400,94369400,1366,455,911,455,0,1,457,65934,0.065934
855,1305,6365,8306325,2,6846,1713,1,118913400,118913400,2566,855,1711,855,0,1,857,442822,0.442822
1255,1305,6365,8306325,2,10046,2513,1,143457400,143457400,3766,1255,2511,1255,0,1,1257,570031,0.570031
1655,1305,6365,8306325,2,13246,3313,1,168001400,168001400,4966,1655,3311,1655,0,1,1657,823020,0.82302
2055,1305,6365,8306325,2,16446,4113,1,192545400,192545400,6166,2055,4111,2055,0,1,2057,2203801,2.203801
2455,1305,6365,8306325,2,19646,4913,1,217089400,217089400,7366,2455,4911,2455,0,1,2457,589322,0.589322
2855,1305,6365,8306325,2,22846,5713,1,241633400,241633400,8566,2855,5711,2855,0,1,2857,1805954,1.805954
3255,1305,6365,8306325,2,26046,6513,1,266177400,266177400,9766,3255,6511,3255,0,1,3257,1610738,1.610738
3655,1305,6365,8306325,2,29246,7313,1,290721400,290721400,10966,3655,7311,3655,0,1,3657,1086207,1.086207
4055,1305,6365,8306325,2,32446,8113,1,315265400,315265400,12166,4055,8111,4055,0,1,4057,2528866,2.528866
4455,1305,6365,8306325,2,35646,8913,1,339809400,339809400,13366,4455,8911,4455,0,1,4457,3751116,3.751116
4855,1305,6365,8306325,2,38846,9713,1,364353400,364353400,14566,4855,9711,4855,0,1,4857,1661966,1.661966
5255,1305,6365,8306325,2,42046,10513,1,388897400,388897400,15766,5255,10511,5255,0,1,5257,522230,0.52223
5655,1305,6365,8306325,2,45246,11313,1,413441400,413441400,16966,5655,11311,5655,0,1,5657,2892725,2.892725
6055,1305,6365,8306325,2,48446,12113,1,437985400,437985400,18166,6055,12111,6055,0,1,6057,276814,0.276814
6455,1305,6365,8306325,2,51646,12913,1,462529400,462529400,19366,6455,12911,6455,0,1,6457,773246,0.773246
6855,1305,6365,8306325,2,54846,13713,1,487073400,487073400,20566,6855,13711,6855,0,1,6857,1764982,1.764982
40,3050,2740,8357000,2,326,83,1,68708800,68708800,121,40,81,40,0,1,42,18512,0.018512
440,3050,2740,8357000,2,3526,883,1,87236800,87236800,1321,440,881,440,0,1,442,22317,0.022317
840,3050,2740,8357000,2,6726,1683,1,105764800,105764800,2521,840,1681,840,0,1,842,141117,0.141117
1240,3050,2740,8357000,2,9926,2483,1,124292800,124292800,3721,1240,2481,1240,0,1,1242,201166,0.201166
1640,3050,2740,8357000,2,13126,3283,1,142820800,142820800,4921,1640,3281,1640,0,1,1642,412079,0.412079
2040,3050,2740,8357000,2,16326,4083,1,161348800,161348800,6121,2040,4081,2040,0,1,2042,317550,0.31755
2440,3050,2740,8357000,2,19526,4883,1,179876800,179876800,7321,2440,4881,2440,0,1,2442,105931,0.105931
2840,3050,2740,8357000,2,22726,5683,1,198404800,198404800,8521,2840,5681,2840,0,1,2842,215916,0.215916
3240,3050,2740,8357000,2,25926,6483,1,216932800,216932800,9721,3240,6481,3240,0,1,3242,44199,0.044199
3640,3050,2740,8357000,2,29126,7283,1,235460800,235460800,10921,3640,7281,3640,0,1,3642,493184,0.493184
4040,3050,2740,8357000,2,32326,8083,1,253988800,253988800,12121,4040,8081,4040,0,1,4042,298644,0.298644
4440,3050,2740,8357000,2,35526,8883,1,272516800,272516800,13321,4440,8881,4440,0,1,4442,323504,0.323504
4840,3050,2740,8357000,2,38726,9683,1,291044800,291044800,14521,4840,9681,4840,0,1,4842,118047,0.118047
5240,3050,2740,8357000,2,41926,10483,1,309572800,309572800,15721,5240,10481,5240,0,1,5242,1674668,1.674668
5640,3050,2740,8357000,2,45126,11283,1,328100800,328100800,16921,5640,11281,5640,0,1,5642,1916050,1.91605
6040,3050,2740,8357000,2,48326,12083,1,346628800,346628800,18121,6040,12081,6040,0,1,6042,1669033,1.669033
6440,3050,2740,8357000,2,51526,12883,1,365156800,365156800,19321,6440,12881,6440,0,1,6442,491009,0.491009
6840,3050,2740,8357000,2,54726,13683,1,383684800,383684800,20521,6840,13681,6840,0,1,6842,1779838,1.779838
40,2300,3640,8372000,2,326,83,1,68876800,68876800,121,40,81,40,0,1,42,156577,0.156577
440,2300,3640,8372000,2,3526,883,1,87884800,87884800,1321,440,881,440,0,1,442,204693,0.204693
840,2300,3640,8372000,2,6726,1683,1,106892800,106892800,2521,840,1681,840,0,1,842,1372045,1.372045
1240,2300,3640,8372000,2,9926,2483,1,125900800,125900800,3721,1240,2481,1240,0,1,1242,1981251,1.981251
1640,2300,3640,8372000,2,13126,3283,1,144908800,144908800,4921,1640,3281,1640,0,1,1642,182565,0.182565
2040,2300,3640,8372000,2,16326,4083,1,163916800,163916800,6121,2040,4081,2040,0,1,2042,2979672,2.979672
2440,2300,3640,8372000,2,19526,4883,1,182924800,182924800,7321,2440,4881,2440,0,1,2442,1295339,1.295339
2840,2300,3640,8372000,2,22726,5683,1,201932800,201932800,8521,2840,5681,2840,0,1,2842,3895108,3.895108
3240,2300,3640,8372000,2,25926,6483,1,220940800,220940800,9721,3240,6481,3240,0,1,3242,1587407,1.587407
3640,2300,3640,8372000,2,29126,7283,1,239948800,239948800,10921,3640,7281,3640,0,1,3642,1103604,1.103604
4040,2300,3640,8372000,2,32326,8083,1,258956800,258956800,12121,4040,8081,4040,0,1,4042,67833,0.067833
4440,2300,3640,8372000,2,35526,8883,1,277964800,277964800,13321,4440,8881,4440,0,1,4442,3159006,3.159006
4840,2300,3640,8372000,2,38726,9683,1,296972800,296972800,14521,4840,9681,4840,0,1,4842,1753611,1.753611
5240,2300,3640,8372000,2,41926,10483,1,315980800,315980800,15721,5240,10481,5240,0,1,5242,836843,0.836843
5640,2300,3640,8372000,2,45126,11283,1,334988800,334988800,16921,5640,11281,5640,0,1,5642,808310,0.80831
6040,2300,3640,8372000,2,48326,12083,1,353996800,353996800,18121,6040,12081,6040,0,1,6042,1044949,1.044949
6440,2300,3640,8372000,2,51526,12883,1,373004800,373004800,19321,6440,12881,6440,0,1,6442,1545153,1.545153
6840,2300,3640,8372000,2,54726,13683,1,392012800,392012800,20521,6840,13681,6840,0,1,6842,139127,0.139127
40,4550,1840,8372000,2,326,83,1,69020800,69020800,121,40,81,40,0,1,42,149027,0.149027
440,4550,1840,8372000,2,3526,883,1,89468800,89468800,1321,440,881,440,0,1,442,204667,0.204667
840,4550,1840,8372000,2,6726,1683,1,109916800,109916800,2521,840,1681,840,0,1,842,1338286,1.338286
1240,4550,1840,8372000,2,9926,2483,1,130364800,130364800,3721,1240,2481,1240,0,1,1242,1626585,1.626585
1640,4550,1840,8372000,2,13126,3283,1,150812800,150812800,4921,1640,3281,1640,0,1,1642,1986620,1.98662
2040,4550,1840,8372000,2,16326,4083,1,171260800,171260800,6121,2040,4081,2040,0,1,2042,353814,0.353814
2440,4550,1840,8372000,2,19526,4883,1,191708800,191708800,7321,2440,4881,2440,0,1,2442,1213514,1.213514
2840,4550,1840,8372000,2,22726,5683,1,212156800,212156800,8521,2840,5681,2840,0,1,2842,2697103,2.697103
3240,4550,1840,8372000,2,25926,6483,1,232604800,232604800,9721,3240,6481,3240,0,1,3242,1136798,1.136798
3640,4550,1840,8372000,2,29126,7283,1,253052800,253052800,10921,3640,7281,3640,0,1,3642,2642222,2.642222
4040,4550,1840,8372000,2,32326,8083,1,273500800,273500800,12121,4040,8081,4040,0,1,4042,4706389,4.706389
4440,4550,1840,8372000,2,35526,8883,1,293948800,293948800,13321,4440,8881,4440,0,1,4442,3818604,3.818604
4840,4550,1840,8372000,2,38726,9683,1,314396800,314396800,14521,4840,9681,4840,0,1,4842,1685371,1.685371
5240,4550,1840,8372000,2,41926,10483,1,334844800,334844800,15721,5240,10481,5240,0,1,5242,3883824,3.883824
5640,4550,1840,8372000,2,45126,11283,1,355292800,355292800,16921,5640,11281,5640,0,1,5642,3238383,3.238383
6040,4550,1840,8372000,2,48326,12083,1,375740800,375740800,18121,6040,12081,6040,0,1,6042,3198925,3.198925
6440,4550,1840,8372000,2,51526,12883,1,396188800,396188800,19321,6440,12881,6440,0,1,6442,1739518,1.739518
6840,4550,1840,8372000,2,54726,13683,1,416636800,416636800,20521,6840,13681,6840,0,1,6842,792795,0.792795
40,1550,5440,8432000,2,326,83,1,69692800,69692800,121,40,81,40,0,1,42,155811,0.155811
440,1550,5440,8432000,2,3526,883,1,92060800,92060800,1321,440,881,440,0,1,442,616777,0.616777
840,1550,5440,8432000,2,6726,1683,1,114428800,114428800,2521,840,1681,840,0,1,842,1384526,1.384526
1240,1550,5440,8432000,2,9926,2483,1,136796800,136796800,3721,1240,2481,1240,0,1,1242,284749,0.284749
1640,1550,5440,8432000,2,13126,3283,1,159164800,159164800,4921,1640,3281,1640,0,1,1642,422608,0.422608
2040,1550,5440,8432000,2,16326,4083,1,181532800,181532800,6121,2040,4081,2040,0,1,2042,528324,0.528324
2440,1550,5440,8432000,2,19526,4883,1,203900800,203900800,7321,2440,4881,2440,0,1,2442,1223787,1.223787
2840,1550,5440,8432000,2,22726,5683,1,226268800,226268800,8521,2840,5681,2840,0,1,2842,2598144,2.598144
3240,1550,5440,8432000,2,25926,6483,1,248636800,248636800,9721,3240,6481,3240,0,1,3242,711879,0.711879
3640,1550,5440,8432000,2,29126,7283,1,271004800,271004800,10921,3640,7281,3640,0,1,3642,5743554,5.743554
4040,1550,5440,8432000,2,32326,8083,1,293372800,293372800,12121,4040,8081,4040,0,1,4042,1560363,1.560363
4440,1550,5440,8432000,2,35526,8883,1,315740800,315740800,13321,4440,8881,4440,0,1,4442,987572,0.987572
4840,1550,5440,8432000,2,38726,9683,1,338108800,338108800,14521,4840,9681,4840,0,1,4842,720462,0.720462
5240,1550,5440,8432000,2,41926,10483,1,360476800,360476800,15721,5240,10481,5240,0,1,5242,1243740,1.24374
5640,1550,5440,8432000,2,45126,11283,1,382844800,382844800,16921,5640,11281,5640,0,1,5642,2477938,2.477938
6040,1550,5440,8432000,2,48326,12083,1,405212800,405212800,18121,6040,12081,6040,0,1,6042,2592234,2.592234
6440,1550,5440,8432000,2,51526,12883,1,427580800,427580800,19321,6440,12881,6440,0,1,6442,71565,0.071565
6840,1550,5440,8432000,2,54726,13683,1,449948800,449948800,20521,6840,13681,6840,0,1,6842,135594,0.135594
40,6800,1240,8432000,2,326,83,1,70028800,70028800,121,40,81,40,0,1,42,146867,0.146867
440,6800,1240,8432000,2,3526,883,1,95756800,95756800,1321,440,881,440,0,1,442,400210,0.40021
840,6800,1240,8432000,2,6726,1683,1,121484800,121484800,2521,840,1681,840,0,1,842,266595,0.266595
1240,6800,1240,8432000,2,9926,2483,1,147212800,147212800,3721,1240,2481,1240,0,1,1242,1277259,1.277259
1640,6800,1240,8432000,2,13126,3283,1,172940800,172940800,4921,1640,3281,1640,0,1,1642,2304120,2.30412
2040,6800,1240,8432000,2,16326,4083,1,198668800,198668800,6121,2040,4081,2040,0,1,2042,1908532,1.908532
2440,6800,1240,8432000,2,19526,4883,1,224396800,224396800,7321,2440,4881,2440,0,1,2442,1348972,1.348972
2840,6800,1240,8432000,2,22726,5683,1,250124800,250124800,8521,2840,5681,2840,0,1,2842,978734,0.978734
3240,6800,1240,8432000,2,25926,6483,1,275852800,275852800,9721,3240,6481,3240,0,1,3242,2022528,2.022528
3640,6800,1240,8432000,2,29126,7283,1,301580800,301580800,10921,3640,7281,3640,0,1,3642,34102,0.034102
4040,6800,1240,8432000,2,32326,8083,1,327308800,327308800,12121,4040,8081,4040,0,1,4042,14065,0.014065
4440,6800,1240,8432000,2,35526,8883,1,353036800,353036800,13321,4440,8881,4440,0,1,4442,6354053,6.354053
4840,6800,1240,8432000,2,38726,9683,1,378764800,378764800,14521,4840,9681,4840,0,1,4842,875563,0.875563
5240,6800,1240,8432000,2,41926,10483,1,404492800,404492800,15721,5240,10481,5240,0,1,5242,1543732,1.543732
5640,6800,1240,8432000,2,45126,11283,1,430220800,430220800,16921,5640,11281,5640,0,1,5642,1669354,1.669354
6040,6800,1240,8432000,2,48326,12083,1,455948800,455948800,18121,6040,12081,6040,0,1,6042,1297867,1.297867
6440,6800,1240,8432000,2,51526,12883,1,481676800,481676800,19321,6440,12881,6440,0,1,6442,2031820,2.03182
6840,6800,1240,8432000,2,54726,13683,1,507404800,507404800,20521,6840,13681,6840,0,1,6842,449323,0.449323
55,3055,2765,8447075,2,446,113,1,70137400,70137400,166,55,111,55,0,1,57,7146,0.007146
455,3055,2765,8447075,2,3646,913,1,88761400,88761400,1366,455,911,455,0,1,457,33183,0.033183
855,3055,2765,8447075,2,6846,1713,1,107385400,107385400,2566,855,1711,855,0,1,857,961,0.000961
1255,3055,2765,8447075,2,10046,2513,1,126009400,126009400,3766,1255,2511,1255,0,1,1257,197896,0.197896
1655,3055,2765,8447075,2,13246,3313,1,144633400,144633400,4966,1655,3311,1655,0,1,1657,99870,0.09987
2055,3055,2765,8447075,2,16446,4113,1,163257400,163257400,6166,2055,4111,2055,0,1,2057,654208,0.654208
2455,3055,2765,8447075,2,19646,4913,1,181881400,181881400,7366,2455,4911,2455,0,1,2457,531985,0.531985
2855,3055,2765,8447075,2,22846,5713,1,200505400,200505400,8566,2855,5711,2855,0,1,2857,233421,0.233421
3255,3055,2765,8447075,2,26046,6513,1,219129400,219129400,9766,3255,6511,3255,0,1,3257,351142,0.351142
3655,3055,2765,8447075,2,29246,7313,1,237753400,237753400,10966,3655,7311,3655,0,1,3657,1420395,1.420395
4055,3055,2765,8447075,2,32446,8113,1,256377400,256377400,12166,4055,8111,4055,0,1,4057,430753,0.430753
4455,3055,2765,8447075,2,35646,8913,1,275001400,275001400,13366,4455,8911,4455,0,1,4457,301057,0.301057
4855,3055,2765,8447075,2,38846,9713,1,293625400,293625400,14566,4855,9711,4855,0,1,4857,105186,0.105186
5255,3055,2765,8447075,2,42046,10513,1,312249400,312249400,15766,5255,10511,5255,0,1,5257,1746459,1.746459
5655,3055,2765,8447075,2,45246,11313,1,330873400,330873400,16966,5655,11311,5655,0,1,5657,3379260,3.37926
6055,3055,2765,8447075,2,48446,12113,1,349497400,349497400,18166,6055,12111,6055,0,1,6057,552700,0.5527
6455,3055,2765,8447075,2,51646,12913,1,368121400,368121400,19366,6455,12911,6455,0,1,6457,1784360,1.78436
6855,3055,2765,8447075,2,54846,13713,1,386745400,386745400,20566,6855,13711,6855,0,1,6857,201910,0.20191
55,2305,3665,8447825,2,446,113,1,70209400,70209400,166,55,111,55,0,1,57,175840,0.17584
455,2305,3665,8447825,2,3646,913,1,89313400,89313400,1366,455,911,455,0,1,457,781463,0.781463
855,2305,3665,8447825,2,6846,1713,1,108417400,108417400,2566,855,1711,855,0,1,857,50324,0.050324
1255,2305,3665,8447825,2,10046,2513,1,127521400,127521400,3766,1255,2511,1255,0,1,1257,1371504,1.371504
1655,2305,3665,8447825,2,13246,3313,1,146625400,146625400,4966,1655,3311,1655,0,1,1657,324638,0.324638
2055,2305,3665,8447825,2,16446,4113,1,165729400,165729400,6166,2055,4111,2055,0,1,2057,1656761,1.656761
2455,2305,3665,8447825,2,19646,4913,1,184833400,184833400,7366,2455,4911,2455,0,1,2457,169403,0.169403
2855,2305,3665,8447825,2,22846,5713,1,203937400,203937400,8566,2855,5711,2855,0,1,2857,784852,0.784852
3255,2305,3665,8447825,2,26046,6513,1,223041400,223041400,9766,3255,6511,3255,0,1,3257,515397,0.515397
3655,2305,3665,8447825,2,29246,7313,1,242145400,242145400,10966,3655,7311,3655,0,1,3657,357709,0.357709
4055,2305,3665,8447825,2,32446,8113,1,261249400,261249400,12166,4055,8111,4055,0,1,4057,1181932,1.181932
4455,2305,3665,8447825,2,35646,8913,1,280353400,280353400,13366,4455,8911,4455,0,1,4457,1158949,1.158949
4855,2305,3665,8447825,2,38846,9713,1,299457400,299457400,14566,4855,9711,4855,0,1,4857,2339006,2.339006
5255,2305,3665,8447825,2,42046,10513,1,318561400,318561400,15766,5255,10511,5255,0,1,5257,1742805,1.742805
5655,2305,3665,8447825,2,45246,11313,1,337665400,337665400,16966,5655,11311,5655,0,1,5657,2593003,2.593003
6055,2305,3665,8447825,2,48446,12113,1,356769400,356769400,18166,6055,12111,6055,0,1,6057,315454,0.315454
6455,2305,3665,8447825,2,51646,12913,1,375873400,375873400,19366,6455,12911,6455,0,1,6457,141555,0.141555
6855,2305,3665,8447825,2,54846,13713,1,394977400,394977400,20566,6855,13711,6855,0,1,6857,878858,0.878858
39,2793,3041,8493513,2,318,81,1,69768312,69768312,118,39,79,39,0,1,41,158984,0.158984
539,2793,3041,8493513,2,4318,1081,1,93104312,93104312,1618,539,1079,539,0,1,541,703006,0.703006
1039,2793,3041,8493513,2,8318,2081,1,116440312,116440312,3118,1039,2079,1039,0,1,1041,1727073,1.727073
1539,2793,3041,8493513,2,12318,3081,1,139776312,139776312,4618,1539,3079,1539,0,1,1541,2525202,2.525202
2039,2793,3041,8493513,2,16318,4081,1,163112312,163112312,6118,2039,4079,2039,0,1,2041,3326095,3.326095
2539,2793,3041,8493513,2,20318,5081,1,186448312,186448312,7618,2539,5079,2539,0,1,2541,3288042,3.288042
3039,2793,3041,8493513,2,24318,6081,1,209784312,209784312,9118,3039,6079,3039,0,1,3041,1437261,1.437261
3539,2793,3041,8493513,2,28318,7081,1,233120312,233120312,10618,3539,7079,3539,0,1,3541,3724481,3.724481
4039,2793,3041,8493513,2,32318,8081,1,256456312,256456312,12118,4039,8079,4039,0,1,4041,4363285,4.363285
4539,2793,3041,8493513,2,36318,9081,1,279792312,279792312,13618,4539,9079,4539,0,1,4541,4863206,4.863206
5039,2793,3041,8493513,2,40318,10081,1,303128312,303128312,15118,5039,10079,5039,0,1,5041,209932,0.209932
5539,2793,3041,8493513,2,44318,11081,1,326464312,326464312,16618,5539,11079,5539,0,1,5541,3815018,3.815018
6039,2793,3041,8493513,2,48318,12081,1,349800312,349800312,18118,6039,12079,6039,0,1,6041,583974,0.583974
6539,2793,3041,8493513,2,52318,13081,1,373136312,373136312,19618,6539,13079,6539,0,1,6541,5059942,5.059942
7039,2793,3041,8493513,2,56318,14081,1,396472312,396472312,21118,7039,14079,7039,0,1,7041,2155059,2.155059
39,3343,2541,8494563,2,318,81,1,69792312,69792312,118,39,79,39,0,1,41,47351,0.047351
539,3343,2541,8494563,2,4318,1081,1,93328312,93328312,1618,539,1079,539,0,1,541,129730,0.12973
1039,3343,2541,8494563,2,8318,2081,1,116864312,116864312,3118,1039,2079,1039,0,1,1041,26889,0.026889
1539,3343,2541,8494563,2,12318,3081,1,140400312,140400312,4618,1539,3079,1539,0,1,1541,9469,0.009469
2039,3343,2541,8494563,2,16318,4081,1,163936312,163936312,6118,2039,4079,2039,0,1,2041,118073,0.118073
2539,3343,2541,8494563,2,20318,5081,1,187472312,187472312,7618,2539,5079,2539,0,1,2541,997569,0.997569
3039,3343,2541,8494563,2,24318,6081,1,211008312,211008312,9118,3039,6079,3039,0,1,3041,2395906,2.395906
3539,3343,2541,8494563,2,28318,7081,1,234544312,234544312,10618,3539,7079,3539,0,1,3541,139902,0.139902
4039,3343,2541,8494563,2,32318,8081,1,258080312,258080312,12118,4039,8079,4039,0,1,4041,259192,0.259192
4539,3343,2541,8494563,2,36318,9081,1,281616312,281616312,13618,4539,9079,4539,0,1,4541,1948595,1.948595
5039,3343,2541,8494563,2,40318,10081,1,305152312,305152312,15118,5039,10079,5039,0,1,5041,286056,0.286056
5539,3343,2541,8494563,2,44318,11081,1,328688312,328688312,16618,5539,11079,5539,0,1,5541,4530996,4.530996
6039,3343,2541,8494563,2,48318,12081,1,352224312,352224312,18118,6039,12079,6039,0,1,6041,3746633,3.746633
6539,3343,2541,8494563,2,52318,13081,1,375760312,375760312,19618,6539,13079,6539,0,1,6541,1054444,1.054444
7039,3343,2541,8494563,2,56318,14081,1,399296312,399296312,21118,7039,14079,7039,0,1,7041,84116,0.084116
55,4555,1865,8495075,2,446,113,1,70785400,70785400,166,55,111,55,0,1,57,173917,0.173917
455,4555,1865,8495075,2,3646,913,1,91329400,91329400,1366,455,911,455,0,1,457,796498,0.796498
855,4555,1865,8495075,2,6846,1713,1,111873400,111873400,2566,855,1711,855,0,1,857,1430207,1.430207
1255,4555,1865,8495075,2,10046,2513,1,132417400,132417400,3766,1255,2511,1255,0,1,1257,2069926,2.069926
1655,4555,1865,8495075,2,13246,3313,1,152961400,152961400,4966,1655,3311,1655,0,1,1657,477331,0.477331
2055,4555,1865,8495075,2,16446,4113,1,173505400,173505400,6166,2055,4111,2055,0,1,2057,3321387,3.321387
2455,4555,1865,8495075,2,19646,4913,1,194049400,194049400,7366,2455,4911,2455,0,1,2457,677452,0.677452
2855,4555,1865,8495075,2,22846,5713,1,214593400,214593400,8566,2855,5711,2855,0,1,2857,2867744,2.867744
3255,4555,1865,8495075,2,26046,6513,1,235137400,235137400,9766,3255,6511,3255,0,1,3257,2055233,2.055233
3655,4555,1865,8495075,2,29246,7313,1,255681400,255681400,10966,3655,7311,3655,0,1,3657,5056903,5.056903
4055,4555,1865,8495075,2,32446,8113,1,276225400,276225400,12166,4055,8111,4055,0,1,4057,6525833,6.525833
4455,4555,1865,8495075,2,35646,8913,1,296769400,296769400,13366,4455,8911,4455,0,1,4457,5653798,5.653798
4855,4555,1865,8495075,2,38846,9713,1,317313400,317313400,14566,4855,9711,4855,0,1,4857,2926942,2.926942
5255,4555,1865,8495075,2,42046,10513,1,337857400,337857400,15766,5255,10511,5255,0,1,5257,1043303,1.043303
5655,4555,1865,8495075,2,45246,11313,1,358401400,358401400,16966,5655,11311,5655,0,1,5657,646927,0.646927
6055,4555,1865,8495075,2,48446,12113,1,378945400,378945400,18166,6055,12111,6055,0,1,6057,3302228,3.302228
6455,4555,1865,8495075,2,51646,12913,1,399489400,399489400,19366,6455,12911,6455,0,1,6457,818137,0.818137
6855,4555,1865,8495075,2,54846,13713,1,420033400,420033400,20566,6855,13711,6855,0,1,6857,10989184,10.989184
35,5500,1545,8497500,2,286,73,1,69952600,69952600,106,35,71,35,0,1,37,55522,0.055522
535,5500,1545,8497500,2,4286,1073,1,98132600,98132600,1606,535,1071,535,0,1,537,203198,0.203198
1035,5500,1545,8497500,2,8286,2073,1,126312600,126312600,3106,1035,2071,1035,0,1,1037,572559,0.572559
1535,5500,1545,8497500,2,12286,3073,1,154492600,154492600,4606,1535,3071,1535,0,1,1537,873282,0.873282
2035,5500,1545,8497500,2,16286,4073,1,182672600,182672600,6106,2035,4071,2035,0,1,2037,1079615,1.079615
2535,5500,1545,8497500,2,20286,5073,1,210852600,210852600,7606,2535,5071,2535,0,1,2537,111082,0.111082
3035,5500,1545,8497500,2,24286,6073,1,239032600,239032600,9106,3035,6071,3035,0,1,3037,1759724,1.759724
3535,5500,1545,8497500,2,28286,7073,1,267212600,267212600,10606,3535,7071,3535,0,1,3537,1937534,1.937534
4035,5500,1545,8497500,2,32286,8073,1,295392600,295392600,12106,4035,8071,4035,0,1,4037,3609823,3.609823
4535,5500,1545,8497500,2,36286,9073,1,323572600,323572600,13606,4535,9071,4535,0,1,4537,589180,0.58918
5035,5500,1545,8497500,2,40286,10073,1,351752600,351752600,15106,5035,10071,5035,0,1,5037,2228902,2.228902
5535,5500,1545,8497500,2,44286,11073,1,379932600,379932600,16606,5535,11071,5535,0,1,5537,1766108,1.766108
6035,5500,1545,8497500,2,48286,12073,1,408112600,408112600,18106,6035,12071,6035,0,1,6037,3212914,3.212914
6535,5500,1545,8497500,2,52286,13073,1,436292600,436292600,19606,6535,13071,6535,0,1,6537,10505712,10.505712
7035,5500,1545,8497500,2,56286,14073,1,464472600,464472600,21106,7035,14071,7035,0,1,7037,11274428,11.274428
55,1555,5465,8498075,2,446,113,1,71073400,71073400,166,55,111,55,0,1,57,174290,0.17429
455,1555,5465,8498075,2,3646,913,1,93537400,93537400,1366,455,911,455,0,1,457,586314,0.586314
855,1555,5465,8498075,2,6846,1713,1,116001400,116001400,2566,855,1711,855,0,1,857,691211,0.691211
1255,1555,5465,8498075,2,10046,2513,1,138465400,138465400,3766,1255,2511,1255,0,1,1257,2122307,2.122307
1655,1555,5465,8498075,2,13246,3313,1,160929400,160929400,4966,1655,3311,1655,0,1,1657,2700922,2.700922
2055,1555,5465,8498075,2,16446,4113,1,183393400,183393400,6166,2055,4111,2055,0,1,2057,293631,0.293631
2455,1555,5465,8498075,2,19646,4913,1,205857400,205857400,7366,2455,4911,2455,0,1,2457,1630956,1.630956
2855,1555,5465,8498075,2,22846,5713,1,228321400,228321400,8566,2855,5711,2855,0,1,2857,4749681,4.749681
3255,1555,5465,8498075,2,26046,6513,1,250785400,250785400,9766,3255,6511,3255,0,1,3257,1034327,1.034327
3655,1555,5465,8498075,2,29246,7313,1,273249400,273249400,10966,3655,7311,3655,0,1,3657,813518,0.813518
4055,1555,5465,8498075,2,32446,8113,1,295713400,295713400,12166,4055,8111,4055,0,1,4057,824064,0.824064
4455,1555,5465,8498075,2,35646,8913,1,318177400,318177400,13366,4455,8911,4455,0,1,4457,1623965,1.623965
4855,1555,5465,8498075,2,38846,9713,1,340641400,340641400,14566,4855,9711,4855,0,1,4857,222351,0.222351
5255,1555,5465,8498075,2,42046,10513,1,363105400,363105400,15766,5255,10511,5255,0,1,5257,3967658,3.967658
5655,1555,5465,8498075,2,45246,11313,1,385569400,385569400,16966,5655,11311,5655,0,1,5657,1346027,1.346027
6055,1555,5465,8498075,2,48446,12113,1,408033400,408033400,18166,6055,12111,6055,0,1,6057,3617720,3.61772
6455,1555,5465,8498075,2,51646,12913,1,430497400,430497400,19366,6455,12911,6455,0,1,6457,343467,0.343467
6855,1555,5465,8498075,2,54846,13713,1,452961400,452961400,20566,6855,13711,6855,0,1,6857,874405,0.874405
35,3340,2545,8500300,2,286,73,1,69650200,69650200,106,35,71,35,0,1,37,169741,0.169741
535,3340,2545,8500300,2,4286,1073,1,93190200,93190200,1606,535,1071,535,0,1,537,909968,0.909968
1035,3340,2545,8500300,2,8286,2073,1,116730200,116730200,3106,1035,2071,1035,0,1,1037,1709854,1.709854
1535,3340,2545,8500300,2,12286,3073,1,140270200,140270200,4606,1535,3071,1535,0,1,1537,2503427,2.503427
2035,3340,2545,8500300,2,16286,4073,1,163810200,163810200,6106,2035,4071,2035,0,1,2037,3300399,3.300399
40,2800,3040,8512000,2,326,83,1,69964800,69964800,121,40,81,40,0,1,42,151059,0.151059
440,2800,3040,8512000,2,3526,883,1,88652800,88652800,1321,440,881,440,0,1,442,750279,0.750279
840,2800,3040,8512000,2,6726,1683,1,107340800,107340800,2521,840,1681,840,0,1,842,1362159,1.362159
1240,2800,3040,8512000,2,9926,2483,1,126028800,126028800,3721,1240,2481,1240,0,1,1242,1980720,1.98072
1640,2800,3040,8512000,2,13126,3283,1,144716800,144716800,4921,1640,3281,1640,0,1,1642,2606722,2.606722
2040,2800,3040,8512000,2,16326,4083,1,163404800,163404800,6121,2040,4081,2040,0,1,2042,2210159,2.210159
2440,2800,3040,8512000,2,19526,4883,1,182092800,182092800,7321,2440,4881,2440,0,1,2442,1390620,1.39062
2840,2800,3040,8512000,2,22726,5683,1,200780800,200780800,8521,2840,5681,2840,0,1,2842,1037573,1.037573
3240,2800,3040,8512000,2,25926,6483,1,219468800,219468800,9721,3240,6481,3240,0,1,3242,3458637,3.458637
3640,2800,3040,8512000,2,29126,7283,1,238156800,238156800,10921,3640,7281,3640,0,1,3642,3075357,3.075357
4040,2800,3040,8512000,2,32326,8083,1,256844800,256844800,12121,4040,8081,4040,0,1,4042,282633,0.282633
4440,2800,3040,8512000,2,35526,8883,1,275532800,275532800,13321,4440,8881,4440,0,1,4442,3130260,3.13026
4840,2800,3040,8512000,2,38726,9683,1,294220800,294220800,14521,4840,9681,4840,0,1,4842,4126669,4.126669
5240,2800,3040,8512000,2,41926,10483,1,312908800,312908800,15721,5240,10481,5240,0,1,5242,3375841,3.375841
5640,2800,3040,8512000,2,45126,11283,1,331596800,331596800,16921,5640,11281,5640,0,1,5642,3797764,3.797764
6040,2800,3040,8512000,2,48326,12083,1,350284800,350284800,18121,6040,12081,6040,0,1,6042,866664,0.866664
6440,2800,3040,8512000,2,51526,12883,1,368972800,368972800,19321,6440,12881,6440,0,1,6442,7540544,7.540544
6840,2800,3040,8512000,2,54726,13683,1,387660800,387660800,20521,6840,13681,6840,0,1,6842,8354161,8.354161
40,2550,3340,8517000,2,326,83,1,70020800,70020800,121,40,81,40,0,1,42,153935,0.153935
440,2550,3340,8517000,2,3526,883,1,88868800,88868800,1321,440,881,440,0,1,442,768165,0.768165
840,2550,3340,8517000,2,6726,1683,1,107716800,107716800,2521,840,1681,840,0,1,842,568799,0.568799
1240,2550,3340,8517000,2,9926,2483,1,126564800,126564800,3721,1240,2481,1240,0,1,1242,2031026,2.031026
1640,2550,3340,8517000,2,13126,3283,1,145412800,145412800,4921,1640,3281,1640,0,1,1642,330535,0.330535
2040,2550,3340,8517000,2,16326,4083,1,164260800,164260800,6121,2040,4081,2040,0,1,2042,934598,0.934598
2440,2550,3340,8517000,2,19526,4883,1,183108800,183108800,7321,2440,4881,2440,0,1,2442,533060,0.53306
2840,2550,3340,8517000,2,22726,5683,1,201956800,201956800,8521,2840,5681,2840,0,1,2842,1632830,1.63283
3240,2550,3340,8517000,2,25926,6483,1,220804800,220804800,9721,3240,6481,3240,0,1,3242,837071,0.837071
3640,2550,3340,8517000,2,29126,7283,1,239652800,239652800,10921,3640,7281,3640,0,1,3642,1084398,1.084398
4040,2550,3340,8517000,2,32326,8083,1,258500800,258500800,12121,4040,8081,4040,0,1,4042,1549211,1.549211
4440,2550,3340,8517000,2,35526,8883,1,277348800,277348800,13321,4440,8881,4440,0,1,4442,1818585,1.818585
4840,2550,3340,8517000,2,38726,9683,1,296196800,296196800,14521,4840,9681,4840,0,1,4842,1030704,1.030704
5240,2550,3340,8517000,2,41926,10483,1,315044800,315044800,15721,5240,10481,5240,0,1,5242,3116880,3.11688
5640,2550,3340,8517000,2,45126,11283,1,333892800,333892800,16921,5640,11281,5640,0,1,5642,237121,0.237121
6040,2550,3340,8517000,2,48326,12083,1,352740800,352740800,18121,6040,12081,6040,0,1,6042,329164,0.329164
6440,2550,3340,8517000,2,51526,12883,1,371588800,371588800,19321,6440,12881,6440,0,1,6442,5561312,5.561312
6840,2550,3340,8517000,2,54726,13683,1,390436800,390436800,20521,6840,13681,6840,0,1,6842,145593,0.145593
39,1693,5041,8534413,2,318,81,1,70376312,70376312,118,39,79,39,0,1,41,27814,0.027814
539,1693,5041,8534413,2,4318,1081,1,97312312,97312312,1618,539,1079,539,0,1,541,564414,0.564414
1039,1693,5041,8534413,2,8318,2081,1,124248312,124248312,3118,1039,2079,1039,0,1,1041,767508,0.767508
1539,1693,5041,8534413,2,12318,3081,1,151184312,151184312,4618,1539,3079,1539,0,1,1541,53843,0.053843
2039,1693,5041,8534413,2,16318,4081,1,178120312,178120312,6118,2039,4079,2039,0,1,2041,3431289,3.431289
2539,1693,5041,8534413,2,20318,5081,1,205056312,205056312,7618,2539,5079,2539,0,1,2541,4257303,4.257303
3039,1693,5041,8534413,2,24318,6081,1,231992312,231992312,9118,3039,6079,3039,0,1,3041,626553,0.626553
3539,1693,5041,8534413,2,28318,7081,1,258928312,258928312,10618,3539,7079,3539,0,1,3541,2733464,2.733464
4039,1693,5041,8534413,2,32318,8081,1,285864312,285864312,12118,4039,8079,4039,0,1,4041,107696,0.107696
4539,1693,5041,8534413,2,36318,9081,1,312800312,312800312,13618,4539,9079,4539,0,1,4541,1305729,1.305729
5039,1693,5041,8534413,2,40318,10081,1,339736312,339736312,15118,5039,10079,5039,0,1,5041,1361212,1.361212
5539,1693,5041,8534413,2,44318,11081,1,366672312,366672312,16618,5539,11079,5539,0,1,5541,2449798,2.449798
6039,1693,5041,8534413,2,48318,12081,1,393608312,393608312,18118,6039,12079,6039,0,1,6041,728113,0.728113
6539,1693,5041,8534413,2,52318,13081,1,420544312,420544312,19618,6539,13079,6539,0,1,6541,338390,0.33839
7039,1693,5041,8534413,2,56318,14081,1,447480312,447480312,21118,7039,14079,7039,0,1,7041,521410,0.52141
39,5543,1541,8541763,2,318,81,1,70544312,70544312,118,39,79,39,0,1,41,15965,0.015965
539,5543,1541,8541763,2,4318,1081,1,98880312,98880312,1618,539,1079,539,0,1,541,16986,0.016986
1039,5543,1541,8541763,2,8318,2081,1,127216312,127216312,3118,1039,2079,1039,0,1,1041,349256,0.349256
1539,5543,1541,8541763,2,12318,3081,1,155552312,155552312,4618,1539,3079,1539,0,1,1541,205283,0.205283
2039,5543,1541,8541763,2,16318,4081,1,183888312,183888312,6118,2039,4079,2039,0,1,2041,833369,0.833369
2539,5543,1541,8541763,2,20318,5081,1,212224312,212224312,7618,2539,5079,2539,0,1,2541,12161,0.012161
3039,5543,1541,8541763,2,24318,6081,1,240560312,240560312,9118,3039,6079,3039,0,1,3041,217431,0.217431
3539,5543,1541,8541763,2,28318,7081,1,268896312,268896312,10618,3539,7079,3539,0,1,3541,192470,0.19247
4039,5543,1541,8541763,2,32318,8081,1,297232312,297232312,12118,4039,8079,4039,0,1,4041,1522269,1.522269
4539,5543,1541,8541763,2,36318,9081,1,325568312,325568312,13618,4539,9079,4539,0,1,4541,3286144,3.286144
5039,5543,1541,8541763,2,40318,10081,1,353904312,353904312,15118,5039,10079,5039,0,1,5041,1976880,1.97688
5539,5543,1541,8541763,2,44318,11081,1,382240312,382240312,16618,5539,11079,5539,0,1,5541,36774,0.036774
6039,5543,1541,8541763,2,48318,12081,1,410576312,410576312,18118,6039,12079,6039,0,1,6041,1496930,1.49693
6539,5543,1541,8541763,2,52318,13081,1,438912312,438912312,19618,6539,13079,6539,0,1,6541,1847868,1.847868
7039,5543,1541,8541763,2,56318,14081,1,467248312,467248312,21118,7039,14079,7039,0,1,7041,4506596,4.506596
40,5550,1540,8547000,2,326,83,1,70644800,70644800,121,40,81,40,0,1,42,156013,0.156013
440,5550,1540,8547000,2,3526,883,1,93332800,93332800,1321,440,881,440,0,1,442,246768,0.246768
840,5550,1540,8547000,2,6726,1683,1,116020800,116020800,2521,840,1681,840,0,1,842,1442685,1.442685
1240,5550,1540,8547000,2,9926,2483,1,138708800,138708800,3721,1240,2481,1240,0,1,1242,2099137,2.099137
1640,5550,1540,8547000,2,13126,3283,1,161396800,161396800,4921,1640,3281,1640,0,1,1642,2762270,2.76227
2040,5550,1540,8547000,2,16326,4083,1,184084800,184084800,6121,2040,4081,2040,0,1,2042,203097,0.203097
2440,5550,1540,8547000,2,19526,4883,1,206772800,206772800,7321,2440,4881,2440,0,1,2442,4074624,4.074624
2840,5550,1540,8547000,2,22726,5683,1,229460800,229460800,8521,2840,5681,2840,0,1,2842,2963903,2.963903
3240,5550,1540,8547000,2,25926,6483,1,252148800,252148800,9721,3240,6481,3240,0,1,3242,539550,0.53955
3640,5550,1540,8547000,2,29126,7283,1,274836800,274836800,10921,3640,7281,3640,0,1,3642,889696,0.889696
4040,5550,1540,8547000,2,32326,8083,1,297524800,297524800,12121,4040,8081,4040,0,1,4042,1762506,1.762506
4440,5550,1540,8547000,2,35526,8883,1,320212800,320212800,13321,4440,8881,4440,0,1,4442,429164,0.429164
4840,5550,1540,8547000,2,38726,9683,1,342900800,342900800,14521,4840,9681,4840,0,1,4842,2476808,2.476808
5240,5550,1540,8547000,2,41926,10483,1,365588800,365588800,15721,5240,10481,5240,0,1,5242,31066,0.031066
5640,5550,1540,8547000,2,45126,11283,1,388276800,388276800,16921,5640,11281,5640,0,1,5642,428665,0.428665
6040,5550,1540,8547000,2,48326,12083,1,410964800,410964800,18121,6040,12081,6040,0,1,6042,1291094,1.291094
6440,5550,1540,8547000,2,51526,12883,1,433652800,433652800,19321,6440,12881,6440,0,1,6442,10777449,10.777449
6840,5550,1540,8547000,2,54726,13683,1,456340800,456340800,20521,6840,13681,6840,0,1,6842,3332969,3.332969
35,5540,1545,8559300,2,286,73,1,70458200,70458200,106,35,71,35,0,1,37,175171,0.175171
535,5540,1545,8559300,2,4286,1073,1,98798200,98798200,1606,535,1071,535,0,1,537,256795,0.256795
1035,5540,1545,8559300,2,8286,2073,1,127138200,127138200,3106,1035,2071,1035,0,1,1037,1748442,1.748442
1535,5540,1545,8559300,2,12286,3073,1,155478200,155478200,4606,1535,3071,1535,0,1,1537,591141,0.591141
44,2803,3055,8563165,2,358,91,1,70567336,70567336,133,44,89,44,0,1,46,164412,0.164412
544,2803,3055,8563165,2,4358,1091,1,93999336,93999336,1633,544,1089,544,0,1,546,934233,0.934233
1044,2803,3055,8563165,2,8358,2091,1,117431336,117431336,3133,1044,2089,1044,0,1,1046,788543,0.788543
1544,2803,3055,8563165,2,12358,3091,1,140863336,140863336,4633,1544,3089,1544,0,1,1546,984288,0.984288
2044,2803,3055,8563165,2,16358,4091,1,164295336,164295336,6133,2044,4089,2044,0,1,2046,1991458,1.991458
2544,2803,3055,8563165,2,20358,5091,1,187727336,187727336,7633,2544,5089,2544,0,1,2546,416073,0.416073
3044,2803,3055,8563165,2,24358,6091,1,211159336,211159336,9133,3044,6089,3044,0,1,3046,2106537,2.106537
3544,2803,3055,8563165,2,28358,7091,1,234591336,234591336,10633,3544,7089,3544,0,1,3546,1311734,1.311734
4044,2803,3055,8563165,2,32358,8091,1,258023336,258023336,12133,4044,8089,4044,0,1,4046,1624305,1.624305
4544,2803,3055,8563165,2,36358,9091,1,281455336,281455336,13633,4544,9089,4544,0,1,4546,1556266,1.556266
5044,2803,3055,8563165,2,40358,10091,1,304887336,304887336,15133,5044,10089,5044,0,1,5046,1501618,1.501618
5544,2803,3055,8563165,2,44358,11091,1,328319336,328319336,16633,5544,11089,5544,0,1,5546,3714147,3.714147
6044,2803,3055,8563165,2,48358,12091,1,351751336,351751336,18133,6044,12089,6044,0,1,6046,29128,0.029128
6544,2803,3055,8563165,2,52358,13091,1,375183336,375183336,19633,6544,13089,6544,0,1,6546,2700671,2.700671
7044,2803,3055,8563165,2,56358,14091,1,398615336,398615336,21133,7044,14089,7044,0,1,7046,612130,0.61213
44,3353,2555,8566915,2,358,91,1,70614936,70614936,133,44,89,44,0,1,46,17690,0.01769
544,3353,2555,8566915,2,4358,1091,1,94246936,94246936,1633,544,1089,544,0,1,546,57714,0.057714
1044,3353,2555,8566915,2,8358,2091,1,117878936,117878936,3133,1044,2089,1044,0,1,1046,174163,0.174163
1544,3353,2555,8566915,2,12358,3091,1,141510936,141510936,4633,1544,3089,1544,0,1,1546,1016207,1.016207
2044,3353,2555,8566915,2,16358,4091,1,165142936,165142936,6133,2044,4089,2044,0,1,2046,727287,0.727287
2544,3353,2555,8566915,2,20358,5091,1,188774936,188774936,7633,2544,5089,2544,0,1,2546,39316,0.039316
3044,3353,2555,8566915,2,24358,6091,1,212406936,212406936,9133,3044,6089,3044,0,1,3046,160219,0.160219
3544,3353,2555,8566915,2,28358,7091,1,236038936,236038936,10633,3544,7089,3544,0,1,3546,2334645,2.334645
4044,3353,2555,8566915,2,32358,8091,1,259670936,259670936,12133,4044,8089,4044,0,1,4046,518844,0.518844
4544,3353,2555,8566915,2,36358,9091,1,283302936,283302936,13633,4544,9089,4544,0,1,4546,762457,0.762457
5044,3353,2555,8566915,2,40358,10091,1,306934936,306934936,15133,5044,10089,5044,0,1,5046,378033,0.378033
5544,3353,2555,8566915,2,44358,11091,1,330566936,330566936,16633,5544,11089,5544,0,1,5546,1556736,1.556736
6044,3353,2555,8566915,2,48358,12091,1,354198936,354198936,18133,6044,12089,6044,0,1,6046,160668,0.160668
6544,3353,2555,8566915,2,52358,13091,1,377830936,377830936,19633,6544,13089,6544,0,1,6546,440009,0.440009
7044,3353,2555,8566915,2,56358,14091,1,401462936,401462936,21133,7044,14089,7044,0,1,7046,6456919,6.456919
55,2805,3065,8597325,2,446,113,1,71361400,71361400,166,55,111,55,0,1,57,177054,0.177054
455,2805,3065,8597325,2,3646,913,1,90145400,90145400,1366,455,911,455,0,1,457,793892,0.793892
855,2805,3065,8597325,2,6846,1713,1,108929400,108929400,2566,855,1711,855,0,1,857,1426837,1.426837
1255,2805,3065,8597325,2,10046,2513,1,127713400,127713400,3766,1255,2511,1255,0,1,1257,11609,0.011609
1655,2805,3065,8597325,2,13246,3313,1,146497400,146497400,4966,1655,3311,1655,0,1,1657,1163341,1.163341
2055,2805,3065,8597325,2,16446,4113,1,165281400,165281400,6166,2055,4111,2055,0,1,2057,261884,0.261884
2455,2805,3065,8597325,2,19646,4913,1,184065400,184065400,7366,2455,4911,2455,0,1,2457,2283819,2.283819
2855,2805,3065,8597325,2,22846,5713,1,202849400,202849400,8566,2855,5711,2855,0,1,2857,4610515,4.610515
3255,2805,3065,8597325,2,26046,6513,1,221633400,221633400,9766,3255,6511,3255,0,1,3257,2402998,2.402998
3655,2805,3065,8597325,2,29246,7313,1,240417400,240417400,10966,3655,7311,3655,0,1,3657,1694329,1.694329
4055,2805,3065,8597325,2,32446,8113,1,259201400,259201400,12166,4055,8111,4055,0,1,4057,6543089,6.543089
4455,2805,3065,8597325,2,35646,8913,1,277985400,277985400,13366,4455,8911,4455,0,1,4457,426456,0.426456
4855,2805,3065,8597325,2,38846,9713,1,296769400,296769400,14566,4855,9711,4855,0,1,4857,2169739,2.169739
5255,2805,3065,8597325,2,42046,10513,1,315553400,315553400,15766,5255,10511,5255,0,1,5257,709842,0.709842
5655,2805,3065,8597325,2,45246,11313,1,334337400,334337400,16966,5655,11311,5655,0,1,5657,3840736,3.840736
6055,2805,3065,8597325,2,48446,12113,1,353121400,353121400,18166,6055,12111,6055,0,1,6057,684199,0.684199
6455,2805,3065,8597325,2,51646,12913,1,371905400,371905400,19366,6455,12911,6455,0,1,6457,522286,0.522286
6855,2805,3065,8597325,2,54846,13713,1,390689400,390689400,20566,6855,13711,6855,0,1,6857,3554024,3.554024
55,2555,3365,8597575,2,446,113,1,71385400,71385400,166,55,111,55,0,1,57,177280,0.17728
455,2555,3365,8597575,2,3646,913,1,90329400,90329400,1366,455,911,455,0,1,457,799305,0.799305
855,2555,3365,8597575,2,6846,1713,1,109273400,109273400,2566,855,1711,855,0,1,857,494632,0.494632
1255,2555,3365,8597575,2,10046,2513,1,128217400,128217400,3766,1255,2511,1255,0,1,1257,1307107,1.307107
1655,2555,3365,8597575,2,13246,3313,1,147161400,147161400,4966,1655,3311,1655,0,1,1657,133657,0.133657
2055,2555,3365,8597575,2,16446,4113,1,166105400,166105400,6166,2055,4111,2055,0,1,2057,179673,0.179673
2455,2555,3365,8597575,2,19646,4913,1,185049400,185049400,7366,2455,4911,2455,0,1,2457,349558,0.349558
2855,2555,3365,8597575,2,22846,5713,1,203993400,203993400,8566,2855,5711,2855,0,1,2857,954869,0.954869
3255,2555,3365,8597575,2,26046,6513,1,222937400,222937400,9766,3255,6511,3255,0,1,3257,3594109,3.594109
3655,2555,3365,8597575,2,29246,7313,1,241881400,241881400,10966,3655,7311,3655,0,1,3657,2372971,2.372971
4055,2555,3365,8597575,2,32446,8113,1,260825400,260825400,12166,4055,8111,4055,0,1,4057,4757932,4.757932
4455,2555,3365,8597575,2,35646,8913,1,279769400,279769400,13366,4455,8911,4455,0,1,4457,1739562,1.739562
4855,2555,3365,8597575,2,38846,9713,1,298713400,298713400,14566,4855,9711,4855,0,1,4857,1411222,1.411222
5255,2555,3365,8597575,2,42046,10513,1,317657400,317657400,15766,5255,10511,5255,0,1,5257,2355701,2.355701
5655,2555,3365,8597575,2,45246,11313,1,336601400,336601400,16966,5655,11311,5655,0,1,5657,874627,0.874627
6055,2555,3365,8597575,2,48446,12113,1,355545400,355545400,18166,6055,12111,6055,0,1,6057,1268928,1.268928
6455,2555,3365,8597575,2,51646,12913,1,374489400,374489400,19366,6455,12911,6455,0,1,6457,1944877,1.944877
6855,2555,3365,8597575,2,54846,13713,1,393433400,393433400,20566,6855,13711,6855,0,1,6857,2191147,2.191147
55,6805,1265,8608325,2,446,113,1,72417400,72417400,166,55,111,55,0,1,57,167612,0.167612
455,6805,1265,8608325,2,3646,913,1,98241400,98241400,1366,455,911,455,0,1,457,515488,0.515488
855,6805,1265,8608325,2,6846,1713,1,124065400,124065400,2566,855,1711,855,0,1,857,16273,0.016273
1255,6805,1265,8608325,2,10046,2513,1,149889400,149889400,3766,1255,2511,1255,0,1,1257,1226097,1.226097
1655,6805,1265,8608325,2,13246,3313,1,175713400,175713400,4966,1655,3311,1655,0,1,1657,1281436,1.281436
2055,6805,1265,8608325,2,16446,4113,1,201537400,201537400,6166,2055,4111,2055,0,1,2057,1496956,1.496956
2455,6805,1265,8608325,2,19646,4913,1,227361400,227361400,7366,2455,4911,2455,0,1,2457,354997,0.354997
2855,6805,1265,8608325,2,22846,5713,1,253185400,253185400,8566,2855,5711,2855,0,1,2857,3775765,3.775765
3255,6805,1265,8608325,2,26046,6513,1,279009400,279009400,9766,3255,6511,3255,0,1,3257,289870,0.28987
3655,6805,1265,8608325,2,29246,7313,1,304833400,304833400,10966,3655,7311,3655,0,1,3657,517762,0.517762
4055,6805,1265,8608325,2,32446,8113,1,330657400,330657400,12166,4055,8111,4055,0,1,4057,4699490,4.69949
4455,6805,1265,8608325,2,35646,8913,1,356481400,356481400,13366,4455,8911,4455,0,1,4457,7519843,7.519843
4855,6805,1265,8608325,2,38846,9713,1,382305400,382305400,14566,4855,9711,4855,0,1,4857,6027770,6.02777
5255,6805,1265,8608325,2,42046,10513,1,408129400,408129400,15766,5255,10511,5255,0,1,5257,2428129,2.428129
5655,6805,1265,8608325,2,45246,11313,1,433953400,433953400,16966,5655,11311,5655,0,1,5657,1167858,1.167858
6055,6805,1265,8608325,2,48446,12113,1,459777400,459777400,18166,6055,12111,6055,0,1,6057,3377070,3.37707
6455,6805,1265,8608325,2,51646,12913,1,485601400,485601400,19366,6455,12911,6455,0,1,6457,759968,0.759968
6855,6805,1265,8608325,2,54846,13713,1,511425400,511425400,20566,6855,13711,6855,0,1,6857,1400301,1.400301
44,1703,5055,8608665,2,358,91,1,71248136,71248136,133,44,89,44,0,1,46,159976,0.159976
544,1703,5055,8608665,2,4358,1091,1,98280136,98280136,1633,544,1089,544,0,1,546,20941,0.020941
1044,1703,5055,8608665,2,8358,2091,1,125312136,125312136,3133,1044,2089,1044,0,1,1046,1792770,1.79277
1544,1703,5055,8608665,2,12358,3091,1,152344136,152344136,4633,1544,3089,1544,0,1,1546,52165,0.052165
2044,1703,5055,8608665,2,16358,4091,1,179376136,179376136,6133,2044,4089,2044,0,1,2046,971581,0.971581
2544,1703,5055,8608665,2,20358,5091,1,206408136,206408136,7633,2544,5089,2544,0,1,2546,386026,0.386026
3044,1703,5055,8608665,2,24358,6091,1,233440136,233440136,9133,3044,6089,3044,0,1,3046,1618207,1.618207
3544,1703,5055,8608665,2,28358,7091,1,260472136,260472136,10633,3544,7089,3544,0,1,3546,4806923,4.806923
4044,1703,5055,8608665,2,32358,8091,1,287504136,287504136,12133,4044,8089,4044,0,1,4046,241083,0.241083
4544,1703,5055,8608665,2,36358,9091,1,314536136,314536136,13633,4544,9089,4544,0,1,4546,2291145,2.291145
5044,1703,5055,8608665,2,40358,10091,1,341568136,341568136,15133,5044,10089,5044,0,1,5046,508208,0.508208
5544,1703,5055,8608665,2,44358,11091,1,368600136,368600136,16633,5544,11089,5544,0,1,5546,813690,0.81369
6044,1703,5055,8608665,2,48358,12091,1,395632136,395632136,18133,6044,12089,6044,0,1,6046,277722,0.277722
6544,1703,5055,8608665,2,52358,13091,1,422664136,422664136,19633,6544,13089,6544,0,1,6546,1679545,1.679545
7044,1703,5055,8608665,2,56358,14091,1,449696136,449696136,21133,7044,14089,7044,0,1,7046,577112,0.577112
40,1300,6640,8632000,2,326,83,1,71596800,71596800,121,40,81,40,0,1,42,155138,0.155138
440,1300,6640,8632000,2,3526,883,1,97004800,97004800,1321,440,881,440,0,1,442,796201,0.796201
840,1300,6640,8632000,2,6726,1683,1,122412800,122412800,2521,840,1681,840,0,1,842,196367,0.196367
1240,1300,6640,8632000,2,9926,2483,1,147820800,147820800,3721,1240,2481,1240,0,1,1242,206076,0.206076
1640,1300,6640,8632000,2,13126,3283,1,173228800,173228800,4921,1640,3281,1640,0,1,1642,2726699,2.726699
2040,1300,6640,8632000,2,16326,4083,1,198636800,198636800,6121,2040,4081,2040,0,1,2042,384659,0.384659
2440,1300,6640,8632000,2,19526,4883,1,224044800,224044800,7321,2440,4881,2440,0,1,2442,823845,0.823845
2840,1300,6640,8632000,2,22726,5683,1,249452800,249452800,8521,2840,5681,2840,0,1,2842,3176985,3.176985
3240,1300,6640,8632000,2,25926,6483,1,274860800,274860800,9721,3240,6481,3240,0,1,3242,1655381,1.655381
3640,1300,6640,8632000,2,29126,7283,1,300268800,300268800,10921,3640,7281,3640,0,1,3642,1148427,1.148427
4040,1300,6640,8632000,2,32326,8083,1,325676800,325676800,12121,4040,8081,4040,0,1,4042,1682927,1.682927
4440,1300,6640,8632000,2,35526,8883,1,351084800,351084800,13321,4440,8881,4440,0,1,4442,843841,0.843841
4840,1300,6640,8632000,2,38726,9683,1,376492800,376492800,14521,4840,9681,4840,0,1,4842,74036,0.074036
5240,1300,6640,8632000,2,41926,10483,1,401900800,401900800,15721,5240,10481,5240,0,1,5242,818830,0.81883
5640,1300,6640,8632000,2,45126,11283,1,427308800,427308800,16921,5640,11281,5640,0,1,5642,3872488,3.872488
6040,1300,6640,8632000,2,48326,12083,1,452716800,452716800,18121,6040,12081,6040,0,1,6042,1358114,1.358114
6440,1300,6640,8632000,2,51526,12883,1,478124800,478124800,19321,6440,12881,6440,0,1,6442,77507,0.077507
6840,1300,6640,8632000,2,54726,13683,1,503532800,503532800,20521,6840,13681,6840,0,1,6842,207152,0.207152
44,5553,1555,8634915,2,358,91,1,71581336,71581336,133,44,89,44,0,1,46,9077,0.009077
544,5553,1555,8634915,2,4358,1091,1,100013336,100013336,1633,544,1089,544,0,1,546,122439,0.122439
1044,5553,1555,8634915,2,8358,2091,1,128445336,128445336,3133,1044,2089,1044,0,1,1046,112004,0.112004
1544,5553,1555,8634915,2,12358,3091,1,156877336,156877336,4633,1544,3089,1544,0,1,1546,529871,0.529871
2044,5553,1555,8634915,2,16358,4091,1,185309336,185309336,6133,2044,4089,2044,0,1,2046,277707,0.277707
2544,5553,1555,8634915,2,20358,5091,1,213741336,213741336,7633,2544,5089,2544,0,1,2546,1036143,1.036143
3044,5553,1555,8634915,2,24358,6091,1,242173336,242173336,9133,3044,6089,3044,0,1,3046,821524,0.821524
3544,5553,1555,8634915,2,28358,7091,1,270605336,270605336,10633,3544,7089,3544,0,1,3546,243511,0.243511
4044,5553,1555,8634915,2,32358,8091,1,299037336,299037336,12133,4044,8089,4044,0,1,4046,1058412,1.058412
4544,5553,1555,8634915,2,36358,9091,1,327469336,327469336,13633,4544,9089,4544,0,1,4546,1571425,1.571425
5044,5553,1555,8634915,2,40358,10091,1,355901336,355901336,15133,5044,10089,5044,0,1,5046,335352,0.335352
5544,5553,1555,8634915,2,44358,11091,1,384333336,384333336,16633,5544,11089,5544,0,1,5546,298324,0.298324
6044,5553,1555,8634915,2,48358,12091,1,412765336,412765336,18133,6044,12089,6044,0,1,6046,2289826,2.289826
6544,5553,1555,8634915,2,52358,13091,1,441197336,441197336,19633,6544,13089,6544,0,1,6546,6945076,6.945076
7044,5553,1555,8634915,2,56358,14091,1,469629336,469629336,21133,7044,14089,7044,0,1,7046,631377,0.631377
40,3550,2440,8662000,2,326,83,1,71212800,71212800,121,40,81,40,0,1,42,159617,0.159617
440,3550,2440,8662000,2,3526,883,1,90380800,90380800,1321,440,881,440,0,1,442,249852,0.249852
840,3550,2440,8662000,2,6726,1683,1,109548800,109548800,2521,840,1681,840,0,1,842,1440889,1.440889
1240,3550,2440,8662000,2,9926,2483,1,128716800,128716800,3721,1240,2481,1240,0,1,1242,254399,0.254399
1640,3550,2440,8662000,2,13126,3283,1,147884800,147884800,4921,1640,3281,1640,0,1,1642,2128947,2.128947
2040,3550,2440,8662000,2,16326,4083,1,167052800,167052800,6121,2040,4081,2040,0,1,2042,1695386,1.695386
2440,3550,2440,8662000,2,19526,4883,1,186220800,186220800,7321,2440,4881,2440,0,1,2442,31195,0.031195
2840,3550,2440,8662000,2,22726,5683,1,205388800,205388800,8521,2840,5681,2840,0,1,2842,2914698,2.914698
3240,3550,2440,8662000,2,25926,6483,1,224556800,224556800,9721,3240,6481,3240,0,1,3242,701171,0.701171
3640,3550,2440,8662000,2,29126,7283,1,243724800,243724800,10921,3640,7281,3640,0,1,3642,1552829,1.552829
4040,3550,2440,8662000,2,32326,8083,1,262892800,262892800,12121,4040,8081,4040,0,1,4042,918564,0.918564
4440,3550,2440,8662000,2,35526,8883,1,282060800,282060800,13321,4440,8881,4440,0,1,4442,4933477,4.933477
4840,3550,2440,8662000,2,38726,9683,1,301228800,301228800,14521,4840,9681,4840,0,1,4842,3873476,3.873476
5240,3550,2440,8662000,2,41926,10483,1,320396800,320396800,15721,5240,10481,5240,0,1,5242,2524892,2.524892
5640,3550,2440,8662000,2,45126,11283,1,339564800,339564800,16921,5640,11281,5640,0,1,5642,4322822,4.322822
6040,3550,2440,8662000,2,48326,12083,1,358732800,358732800,18121,6040,12081,6040,0,1,6042,5914723,5.914723
6440,3550,2440,8662000,2,51526,12883,1,377900800,377900800,19321,6440,12881,6440,0,1,6442,591707,0.591707
6840,3550,2440,8662000,2,54726,13683,1,397068800,397068800,20521,6840,13681,6840,0,1,6842,5813064,5.813064
40,4050,2140,8667000,2,326,83,1,71316800,71316800,121,40,81,40,0,1,42,26853,0.026853
440,4050,2140,8667000,2,3526,883,1,91124800,91124800,1321,440,881,440,0,1,442,113637,0.113637
840,4050,2140,8667000,2,6726,1683,1,110932800,110932800,2521,840,1681,840,0,1,842,104752,0.104752
1240,4050,2140,8667000,2,9926,2483,1,130740800,130740800,3721,1240,2481,1240,0,1,1242,54024,0.054024
1640,4050,2140,8667000,2,13126,3283,1,150548800,150548800,4921,1640,3281,1640,0,1,1642,592102,0.592102
2040,4050,2140,8667000,2,16326,4083,1,170356800,170356800,6121,2040,4081,2040,0,1,2042,232477,0.232477
2440,4050,2140,8667000,2,19526,4883,1,190164800,190164800,7321,2440,4881,2440,0,1,2442,475726,0.475726
2840,4050,2140,8667000,2,22726,5683,1,209972800,209972800,8521,2840,5681,2840,0,1,2842,785089,0.785089
3240,4050,2140,8667000,2,25926,6483,1,229780800,229780800,9721,3240,6481,3240,0,1,3242,635053,0.635053
3640,4050,2140,8667000,2,29126,7283,1,249588800,249588800,10921,3640,7281,3640,0,1,3642,166866,0.166866
4040,4050,2140,8667000,2,32326,8083,1,269396800,269396800,12121,4040,8081,4040,0,1,4042,3012270,3.01227
4440,4050,2140,8667000,2,35526,8883,1,289204800,289204800,13321,4440,8881,4440,0,1,4442,2522789,2.522789
4840,4050,2140,8667000,2,38726,9683,1,309012800,309012800,14521,4840,9681,4840,0,1,4842,2254386,2.254386
5240,4050,2140,8667000,2,41926,10483,1,328820800,328820800,15721,5240,10481,5240,0,1,5242,98598,0.098598
5640,4050,2140,8667000,2,45126,11283,1,348628800,348628800,16921,5640,11281,5640,0,1,5642,31858,0.031858
6040,4050,2140,8667000,2,48326,12083,1,368436800,368436800,18121,6040,12081,6040,0,1,6042,599536,0.599536
6440,4050,2140,8667000,2,51526,12883,1,388244800,388244800,19321,6440,12881,6440,0,1,6442,1123721,1.123721
6840,4050,2140,8667000,2,54726,13683,1,408052800,408052800,20521,6840,13681,6840,0,1,6842,861514,0.861514
40,2050,4240,8692000,2,326,83,1,71548800,71548800,121,40,81,40,0,1,42,13527,0.013527
440,2050,4240,8692000,2,3526,883,1,91676800,91676800,1321,440,881,440,0,1,442,18315,0.018315
840,2050,4240,8692000,2,6726,1683,1,111804800,111804800,2521,840,1681,840,0,1,842,1935,0.001935
1240,2050,4240,8692000,2,9926,2483,1,131932800,131932800,3721,1240,2481,1240,0,1,1242,26652,0.026652
1640,2050,4240,8692000,2,13126,3283,1,152060800,152060800,4921,1640,3281,1640,0,1,1642,581523,0.581523
2040,2050,4240,8692000,2,16326,4083,1,172188800,172188800,6121,2040,4081,2040,0,1,2042,199383,0.199383
2440,2050,4240,8692000,2,19526,4883,1,192316800,192316800,7321,2440,4881,2440,0,1,2442,828650,0.82865
2840,2050,4240,8692000,2,22726,5683,1,212444800,212444800,8521,2840,5681,2840,0,1,2842,232116,0.232116
3240,2050,4240,8692000,2,25926,6483,1,232572800,232572800,9721,3240,6481,3240,0,1,3242,808482,0.808482
3640,2050,4240,8692000,2,29126,7283,1,252700800,252700800,10921,3640,7281,3640,0,1,3642,422646,0.422646
4040,2050,4240,8692000,2,32326,8083,1,272828800,272828800,12121,4040,8081,4040,0,1,4042,518007,0.518007
4440,2050,4240,8692000,2,35526,8883,1,292956800,292956800,13321,4440,8881,4440,0,1,4442,205071,0.205071
4840,2050,4240,8692000,2,38726,9683,1,313084800,313084800,14521,4840,9681,4840,0,1,4842,226419,0.226419
5240,2050,4240,8692000,2,41926,10483,1,333212800,333212800,15721,5240,10481,5240,0,1,5242,560375,0.560375
5640,2050,4240,8692000,2,45126,11283,1,353340800,353340800,16921,5640,11281,5640,0,1,5642,177687,0.177687
6040,2050,4240,8692000,2,48326,12083,1,373468800,373468800,18121,6040,12081,6040,0,1,6042,37280,0.03728
6440,2050,4240,8692000,2,51526,12883,1,393596800,393596800,19321,6440,12881,6440,0,1,6442,2525344,2.525344
6840,2050,4240,8692000,2,54726,13683,1,413724800,413724800,20521,6840,13681,6840,0,1,6842,313065,0.313065
55,5555,1565,8693575,2,446,113,1,72681400,72681400,166,55,111,55,0,1,57,172947,0.172947
455,5555,1565,8693575,2,3646,913,1,95465400,95465400,1366,455,911,455,0,1,457,834692,0.834692
855,5555,1565,8693575,2,6846,1713,1,118249400,118249400,2566,855,1711,855,0,1,857,1491427,1.491427
1255,5555,1565,8693575,2,10046,2513,1,141033400,141033400,3766,1255,2511,1255,0,1,1257,2151307,2.151307
1655,5555,1565,8693575,2,13246,3313,1,163817400,163817400,4966,1655,3311,1655,0,1,1657,2815185,2.815185
2055,5555,1565,8693575,2,16446,4113,1,186601400,186601400,6166,2055,4111,2055,0,1,2057,2670045,2.670045
2455,5555,1565,8693575,2,19646,4913,1,209385400,209385400,7366,2455,4911,2455,0,1,2457,2200345,2.200345
2855,5555,1565,8693575,2,22846,5713,1,232169400,232169400,8566,2855,5711,2855,0,1,2857,3671710,3.67171
3255,5555,1565,8693575,2,26046,6513,1,254953400,254953400,9766,3255,6511,3255,0,1,3257,3085225,3.085225
3655,5555,1565,8693575,2,29246,7313,1,277737400,277737400,10966,3655,7311,3655,0,1,3657,2429803,2.429803
4055,5555,1565,8693575,2,32446,8113,1,300521400,300521400,12166,4055,8111,4055,0,1,4057,723384,0.723384
4455,5555,1565,8693575,2,35646,8913,1,323305400,323305400,13366,4455,8911,4455,0,1,4457,722096,0.722096
4855,5555,1565,8693575,2,38846,9713,1,346089400,346089400,14566,4855,9711,4855,0,1,4857,384195,0.384195
5255,5555,1565,8693575,2,42046,10513,1,368873400,368873400,15766,5255,10511,5255,0,1,5257,1579117,1.579117
5655,5555,1565,8693575,2,45246,11313,1,391657400,391657400,16966,5655,11311,5655,0,1,5657,970090,0.97009
6055,5555,1565,8693575,2,48446,12113,1,414441400,414441400,18166,6055,12111,6055,0,1,6057,1878730,1.87873
6455,5555,1565,8693575,2,51646,12913,1,437225400,437225400,19366,6455,12911,6455,0,1,6457,20354,0.020354
6855,5555,1565,8693575,2,54846,13713,1,460009400,460009400,20566,6855,13711,6855,0,1,6857,9865951,9.865951
55,1305,6665,8697825,2,446,113,1,73089400,73089400,166,55,111,55,0,1,57,176288,0.176288
455,1305,6665,8697825,2,3646,913,1,98593400,98593400,1366,455,911,455,0,1,457,590914,0.590914
855,1305,6665,8697825,2,6846,1713,1,124097400,124097400,2566,855,1711,855,0,1,857,52955,0.052955
1255,1305,6665,8697825,2,10046,2513,1,149601400,149601400,3766,1255,2511,1255,0,1,1257,782655,0.782655
1655,1305,6665,8697825,2,13246,3313,1,175105400,175105400,4966,1655,3311,1655,0,1,1657,741960,0.74196
2055,1305,6665,8697825,2,16446,4113,1,200609400,200609400,6166,2055,4111,2055,0,1,2057,168403,0.168403
2455,1305,6665,8697825,2,19646,4913,1,226113400,226113400,7366,2455,4911,2455,0,1,2457,389673,0.389673
2855,1305,6665,8697825,2,22846,5713,1,251617400,251617400,8566,2855,5711,2855,0,1,2857,1131400,1.1314
3255,1305,6665,8697825,2,26046,6513,1,277121400,277121400,9766,3255,6511,3255,0,1,3257,603942,0.603942
3655,1305,6665,8697825,2,29246,7313,1,302625400,302625400,10966,3655,7311,3655,0,1,3657,1323385,1.323385
4055,1305,6665,8697825,2,32446,8113,1,328129400,328129400,12166,4055,8111,4055,0,1,4057,1652622,1.652622
4455,1305,6665,8697825,2,35646,8913,1,353633400,353633400,13366,4455,8911,4455,0,1,4457,1917775,1.917775
4855,1305,6665,8697825,2,38846,9713,1,379137400,379137400,14566,4855,9711,4855,0,1,4857,796135,0.796135
5255,1305,6665,8697825,2,42046,10513,1,404641400,404641400,15766,5255,10511,5255,0,1,5257,2962050,2.96205
5655,1305,6665,8697825,2,45246,11313,1,430145400,430145400,16966,5655,11311,5655,0,1,5657,6411752,6.411752
6055,1305,6665,8697825,2,48446,12113,1,455649400,455649400,18166,6055,12111,6055,0,1,6057,221755,0.221755
6455,1305,6665,8697825,2,51646,12913,1,481153400,481153400,19366,6455,12911,6455,0,1,6457,900488,0.900488
6855,1305,6665,8697825,2,54846,13713,1,506657400,506657400,20566,6855,13711,6855,0,1,6857,294086,0.294086
40,1800,4840,8712000,2,326,83,1,71820800,71820800,121,40,81,40,0,1,42,162326,0.162326
440,1800,4840,8712000,2,3526,883,1,93068800,93068800,1321,440,881,440,0,1,442,60010,0.06001
840,1800,4840,8712000,2,6726,1683,1,114316800,114316800,2521,840,1681,840,0,1,842,515394,0.515394
1240,1800,4840,8712000,2,9926,2483,1,135564800,135564800,3721,1240,2481,1240,0,1,1242,2116810,2.11681
1640,1800,4840,8712000,2,13126,3283,1,156812800,156812800,4921,1640,3281,1640,0,1,1642,22925,0.022925
2040,1800,4840,8712000,2,16326,4083,1,178060800,178060800,6121,2040,4081,2040,0,1,2042,307084,0.307084
2440,1800,4840,8712000,2,19526,4883,1,199308800,199308800,7321,2440,4881,2440,0,1,2442,243145,0.243145
2840,1800,4840,8712000,2,22726,5683,1,220556800,220556800,8521,2840,5681,2840,0,1,2842,3199597,3.199597
3240,1800,4840,8712000,2,25926,6483,1,241804800,241804800,9721,3240,6481,3240,0,1,3242,2081309,2.081309
3640,1800,4840,8712000,2,29126,7283,1,263052800,263052800,10921,3640,7281,3640,0,1,3642,1261223,1.261223
4040,1800,4840,8712000,2,32326,8083,1,284300800,284300800,12121,4040,8081,4040,0,1,4042,238862,0.238862
4440,1800,4840,8712000,2,35526,8883,1,305548800,305548800,13321,4440,8881,4440,0,1,4442,2183435,2.183435
4840,1800,4840,8712000,2,38726,9683,1,326796800,326796800,14521,4840,9681,4840,0,1,4842,430656,0.430656
5240,1800,4840,8712000,2,41926,10483,1,348044800,348044800,15721,5240,10481,5240,0,1,5242,442301,0.442301
5640,1800,4840,8712000,2,45126,11283,1,369292800,369292800,16921,5640,11281,5640,0,1,5642,1213673,1.213673
6040,1800,4840,8712000,2,48326,12083,1,390540800,390540800,18121,6040,12081,6040,0,1,6042,1353679,1.353679
6440,1800,4840,8712000,2,51526,12883,1,411788800,411788800,19321,6440,12881,6440,0,1,6442,517184,0.517184
6840,1800,4840,8712000,2,54726,13683,1,433036800,433036800,20521,6840,13681,6840,0,1,6842,287686,0.287686
40,7050,1240,8742000,2,326,83,1,72588800,72588800,121,40,81,40,0,1,42,21671,0.021671
440,7050,1240,8742000,2,3526,883,1,99116800,99116800,1321,440,881,440,0,1,442,807080,0.80708
840,7050,1240,8742000,2,6726,1683,1,125644800,125644800,2521,840,1681,840,0,1,842,981808,0.981808
1240,7050,1240,8742000,2,9926,2483,1,152172800,152172800,3721,1240,2481,1240,0,1,1242,1292020,1.29202
1640,7050,1240,8742000,2,13126,3283,1,178700800,178700800,4921,1640,3281,1640,0,1,1642,121628,0.121628
2040,7050,1240,8742000,2,16326,4083,1,205228800,205228800,6121,2040,4081,2040,0,1,2042,3505506,3.505506
2440,7050,1240,8742000,2,19526,4883,1,231756800,231756800,7321,2440,4881,2440,0,1,2442,4196685,4.196685
2840,7050,1240,8742000,2,22726,5683,1,258284800,258284800,8521,2840,5681,2840,0,1,2842,3382032,3.382032
3240,7050,1240,8742000,2,25926,6483,1,284812800,284812800,9721,3240,6481,3240,0,1,3242,3691445,3.691445
3640,7050,1240,8742000,2,29126,7283,1,311340800,311340800,10921,3640,7281,3640,0,1,3642,6204317,6.204317
4040,7050,1240,8742000,2,32326,8083,1,337868800,337868800,12121,4040,8081,4040,0,1,4042,1767686,1.767686
4440,7050,1240,8742000,2,35526,8883,1,364396800,364396800,13321,4440,8881,4440,0,1,4442,165788,0.165788
4840,7050,1240,8742000,2,38726,9683,1,390924800,390924800,14521,4840,9681,4840,0,1,4842,4633151,4.633151
5240,7050,1240,8742000,2,41926,10483,1,417452800,417452800,15721,5240,10481,5240,0,1,5242,8923797,8.923797
5640,7050,1240,8742000,2,45126,11283,1,443980800,443980800,16921,5640,11281,5640,0,1,5642,9616056,9.616056
6040,7050,1240,8742000,2,48326,12083,1,470508800,470508800,18121,6040,12081,6040,0,1,6042,10294172,10.294172
6440,7050,1240,8742000,2,51526,12883,1,497036800,497036800,19321,6440,12881,6440,0,1,6442,11000784,11.000784
6840,7050,1240,8742000,2,54726,13683,1,523564800,523564800,20521,6840,13681,6840,0,1,6842,11702897,11.702897
55,3555,2465,8763075,2,446,113,1,72753400,72753400,166,55,111,55,0,1,57,184531,0.184531
455,3555,2465,8763075,2,3646,913,1,92017400,92017400,1366,455,911,455,0,1,457,842326,0.842326
855,3555,2465,8763075,2,6846,1713,1,111281400,111281400,2566,855,1711,855,0,1,857,1510371,1.510371
1255,3555,2465,8763075,2,10046,2513,1,130545400,130545400,3766,1255,2511,1255,0,1,1257,2182566,2.182566
1655,3555,2465,8763075,2,13246,3313,1,149809400,149809400,4966,1655,3311,1655,0,1,1657,408023,0.408023
2055,3555,2465,8763075,2,16446,4113,1,169073400,169073400,6166,2055,4111,2055,0,1,2057,1594358,1.594358
2455,3555,2465,8763075,2,19646,4913,1,188337400,188337400,7366,2455,4911,2455,0,1,2457,970667,0.970667
2855,3555,2465,8763075,2,22846,5713,1,207601400,207601400,8566,2855,5711,2855,0,1,2857,568659,0.568659
3255,3555,2465,8763075,2,26046,6513,1,226865400,226865400,9766,3255,6511,3255,0,1,3257,344008,0.344008
3655,3555,2465,8763075,2,29246,7313,1,246129400,246129400,10966,3655,7311,3655,0,1,3657,75368,0.075368
4055,3555,2465,8763075,2,32446,8113,1,265393400,265393400,12166,4055,8111,4055,0,1,4057,2618841,2.618841
4455,3555,2465,8763075,2,35646,8913,1,284657400,284657400,13366,4455,8911,4455,0,1,4457,1565373,1.565373
4855,3555,2465,8763075,2,38846,9713,1,303921400,303921400,14566,4855,9711,4855,0,1,4857,514098,0.514098
5255,3555,2465,8763075,2,42046,10513,1,323185400,323185400,15766,5255,10511,5255,0,1,5257,535874,0.535874
5655,3555,2465,8763075,2,45246,11313,1,342449400,342449400,16966,5655,11311,5655,0,1,5657,654668,0.654668
6055,3555,2465,8763075,2,48446,12113,1,361713400,361713400,18166,6055,12111,6055,0,1,6057,1645586,1.645586
6455,3555,2465,8763075,2,51646,12913,1,380977400,380977400,19366,6455,12911,6455,0,1,6457,4589956,4.589956
6855,3555,2465,8763075,2,54846,13713,1,400241400,400241400,20566,6855,13711,6855,0,1,6857,2984447,2.984447
55,2055,4265,8764575,2,446,113,1,72897400,72897400,166,55,111,55,0,1,57,33727,0.033727
455,2055,4265,8764575,2,3646,913,1,93121400,93121400,1366,455,911,455,0,1,457,24952,0.024952
855,2055,4265,8764575,2,6846,1713,1,113345400,113345400,2566,855,1711,855,0,1,857,86364,0.086364
1255,2055,4265,8764575,2,10046,2513,1,133569400,133569400,3766,1255,2511,1255,0,1,1257,11329,0.011329
1655,2055,4265,8764575,2,13246,3313,1,153793400,153793400,4966,1655,3311,1655,0,1,1657,508908,0.508908
2055,2055,4265,8764575,2,16446,4113,1,174017400,174017400,6166,2055,4111,2055,0,1,2057,275323,0.275323
2455,2055,4265,8764575,2,19646,4913,1,194241400,194241400,7366,2455,4911,2455,0,1,2457,136889,0.136889
2855,2055,4265,8764575,2,22846,5713,1,214465400,214465400,8566,2855,5711,2855,0,1,2857,56252,0.056252
3255,2055,4265,8764575,2,26046,6513,1,234689400,234689400,9766,3255,6511,3255,0,1,3257,898743,0.898743
3655,2055,4265,8764575,2,29246,7313,1,254913400,254913400,10966,3655,7311,3655,0,1,3657,609687,0.609687
4055,2055,4265,8764575,2,32446,8113,1,275137400,275137400,12166,4055,8111,4055,0,1,4057,319274,0.319274
4455,2055,4265,8764575,2,35646,8913,1,295361400,295361400,13366,4455,8911,4455,0,1,4457,631521,0.631521
4855,2055,4265,8764575,2,38846,9713,1,315585400,315585400,14566,4855,9711,4855,0,1,4857,571147,0.571147
5255,2055,4265,8764575,2,42046,10513,1,335809400,335809400,15766,5255,10511,5255,0,1,5257,217440,0.21744
5655,2055,4265,8764575,2,45246,11313,1,356033400,356033400,16966,5655,11311,5655,0,1,5657,976933,0.976933
6055,2055,4265,8764575,2,48446,12113,1,376257400,376257400,18166,6055,12111,6055,0,1,6057,161840,0.16184
6455,2055,4265,8764575,2,51646,12913,1,396481400,396481400,19366,6455,12911,6455,0,1,6457,54175,0.054175
6855,2055,4265,8764575,2,54846,13713,1,416705400,416705400,20566,6855,13711,6855,0,1,6857,245390,0.24539
55,4055,2165,8779075,2,446,113,1,72969400,72969400,166,55,111,55,0,1,57,9492,0.009492
455,4055,2165,8779075,2,3646,913,1,92873400,92873400,1366,455,911,455,0,1,457,172500,0.1725
855,4055,2165,8779075,2,6846,1713,1,112777400,112777400,2566,855,1711,855,0,1,857,14660,0.01466
1255,4055,2165,8779075,2,10046,2513,1,132681400,132681400,3766,1255,2511,1255,0,1,1257,22057,0.022057
1655,4055,2165,8779075,2,13246,3313,1,152585400,152585400,4966,1655,3311,1655,0,1,1657,472412,0.472412
2055,4055,2165,8779075,2,16446,4113,1,172489400,172489400,6166,2055,4111,2055,0,1,2057,23150,0.02315
2455,4055,2165,8779075,2,19646,4913,1,192393400,192393400,7366,2455,4911,2455,0,1,2457,312287,0.312287
2855,4055,2165,8779075,2,22846,5713,1,212297400,212297400,8566,2855,5711,2855,0,1,2857,50549,0.050549
3255,4055,2165,8779075,2,26046,6513,1,232201400,232201400,9766,3255,6511,3255,0,1,3257,468694,0.468694
3655,4055,2165,8779075,2,29246,7313,1,252105400,252105400,10966,3655,7311,3655,0,1,3657,333485,0.333485
4055,4055,2165,8779075,2,32446,8113,1,272009400,272009400,12166,4055,8111,4055,0,1,4057,123764,0.123764
4455,4055,2165,8779075,2,35646,8913,1,291913400,291913400,13366,4455,8911,4455,0,1,4457,147624,0.147624
4855,4055,2165,8779075,2,38846,9713,1,311817400,311817400,14566,4855,9711,4855,0,1,4857,407318,0.407318
5255,4055,2165,8779075,2,42046,10513,1,331721400,331721400,15766,5255,10511,5255,0,1,5257,263182,0.263182
5655,4055,2165,8779075,2,45246,11313,1,351625400,351625400,16966,5655,11311,5655,0,1,5657,640241,0.640241
6055,4055,2165,8779075,2,48446,12113,1,371529400,371529400,18166,6055,12111,6055,0,1,6057,4612118,4.612118
6455,4055,2165,8779075,2,51646,12913,1,391433400,391433400,19366,6455,12911,6455,0,1,6457,917465,0.917465
6855,4055,2165,8779075,2,54846,13713,1,411337400,411337400,20566,6855,13711,6855,0,1,6857,222573,0.222573
55,1805,4865,8781325,2,446,113,1,73185400,73185400,166,55,111,55,0,1,57,23309,0.023309
455,1805,4865,8781325,2,3646,913,1,94529400,94529400,1366,455,911,455,0,1,457,848761,0.848761
855,1805,4865,8781325,2,6846,1713,1,115873400,115873400,2566,855,1711,855,0,1,857,861906,0.861906
1255,1805,4865,8781325,2,10046,2513,1,137217400,137217400,3766,1255,2511,1255,0,1,1257,1793660,1.79366
1655,1805,4865,8781325,2,13246,3313,1,158561400,158561400,4966,1655,3311,1655,0,1,1657,1456373,1.456373
2055,1805,4865,8781325,2,16446,4113,1,179905400,179905400,6166,2055,4111,2055,0,1,2057,1655423,1.655423
2455,1805,4865,8781325,2,19646,4913,1,201249400,201249400,7366,2455,4911,2455,0,1,2457,1219584,1.219584
2855,1805,4865,8781325,2,22846,5713,1,222593400,222593400,8566,2855,5711,2855,0,1,2857,1172364,1.172364
3255,1805,4865,8781325,2,26046,6513,1,243937400,243937400,9766,3255,6511,3255,0,1,3257,2571088,2.571088
3655,1805,4865,8781325,2,29246,7313,1,265281400,265281400,10966,3655,7311,3655,0,1,3657,748635,0.748635
4055,1805,4865,8781325,2,32446,8113,1,286625400,286625400,12166,4055,8111,4055,0,1,4057,168126,0.168126
4455,1805,4865,8781325,2,35646,8913,1,307969400,307969400,13366,4455,8911,4455,0,1,4457,3080537,3.080537
4855,1805,4865,8781325,2,38846,9713,1,329313400,329313400,14566,4855,9711,4855,0,1,4857,63026,0.063026
5255,1805,4865,8781325,2,42046,10513,1,350657400,350657400,15766,5255,10511,5255,0,1,5257,30996,0.030996
5655,1805,4865,8781325,2,45246,11313,1,372001400,372001400,16966,5655,11311,5655,0,1,5657,154694,0.154694
6055,1805,4865,8781325,2,48446,12113,1,393345400,393345400,18166,6055,12111,6055,0,1,6057,734460,0.73446
6455,1805,4865,8781325,2,51646,12913,1,414689400,414689400,19366,6455,12911,6455,0,1,6457,372035,0.372035
6855,1805,4865,8781325,2,54846,13713,1,436033400,436033400,20566,6855,13711,6855,0,1,6857,281391,0.281391
40,4800,1840,8832000,2,326,83,1,72780800,72780800,121,40,81,40,0,1,42,155885,0.155885
440,4800,1840,8832000,2,3526,883,1,94028800,94028800,1321,440,881,440,0,1,442,774135,0.774135
840,4800,1840,8832000,2,6726,1683,1,115276800,115276800,2521,840,1681,840,0,1,842,597082,0.597082
1240,4800,1840,8832000,2,9926,2483,1,136524800,136524800,3721,1240,2481,1240,0,1,1242,209698,0.209698
1640,4800,1840,8832000,2,13126,3283,1,157772800,157772800,4921,1640,3281,1640,0,1,1642,2674679,2.674679
2040,4800,1840,8832000,2,16326,4083,1,179020800,179020800,6121,2040,4081,2040,0,1,2042,2157304,2.157304
2440,4800,1840,8832000,2,19526,4883,1,200268800,200268800,7321,2440,4881,2440,0,1,2442,449505,0.449505
2840,4800,1840,8832000,2,22726,5683,1,221516800,221516800,8521,2840,5681,2840,0,1,2842,3641484,3.641484
3240,4800,1840,8832000,2,25926,6483,1,242764800,242764800,9721,3240,6481,3240,0,1,3242,51943,0.051943
3640,4800,1840,8832000,2,29126,7283,1,264012800,264012800,10921,3640,7281,3640,0,1,3642,405433,0.405433
4040,4800,1840,8832000,2,32326,8083,1,285260800,285260800,12121,4040,8081,4040,0,1,4042,3021761,3.021761
4440,4800,1840,8832000,2,35526,8883,1,306508800,306508800,13321,4440,8881,4440,0,1,4442,3995301,3.995301
4840,4800,1840,8832000,2,38726,9683,1,327756800,327756800,14521,4840,9681,4840,0,1,4842,7817125,7.817125
5240,4800,1840,8832000,2,41926,10483,1,349004800,349004800,15721,5240,10481,5240,0,1,5242,1135758,1.135758
5640,4800,1840,8832000,2,45126,11283,1,370252800,370252800,16921,5640,11281,5640,0,1,5642,784226,0.784226
6040,4800,1840,8832000,2,48326,12083,1,391500800,391500800,18121,6040,12081,6040,0,1,6042,2641384,2.641384
6440,4800,1840,8832000,2,51526,12883,1,412748800,412748800,19321,6440,12881,6440,0,1,6442,10341353,10.341353
6840,4800,1840,8832000,2,54726,13683,1,433996800,433996800,20521,6840,13681,6840,0,1,6842,4709242,4.709242
40,1550,5740,8897000,2,326,83,1,73508800,73508800,121,40,81,40,0,1,42,168438,0.168438
440,1550,5740,8897000,2,3526,883,1,96836800,96836800,1321,440,881,440,0,1,442,217938,0.217938
840,1550,5740,8897000,2,6726,1683,1,120164800,120164800,2521,840,1681,840,0,1,842,445093,0.445093
1240,1550,5740,8897000,2,9926,2483,1,143492800,143492800,3721,1240,2481,1240,0,1,1242,1129517,1.129517
1640,1550,5740,8897000,2,13126,3283,1,166820800,166820800,4921,1640,3281,1640,0,1,1642,2863011,2.863011
2040,1550,5740,8897000,2,16326,4083,1,190148800,190148800,6121,2040,4081,2040,0,1,2042,1726943,1.726943
2440,1550,5740,8897000,2,19526,4883,1,213476800,213476800,7321,2440,4881,2440,0,1,2442,181093,0.181093
2840,1550,5740,8897000,2,22726,5683,1,236804800,236804800,8521,2840,5681,2840,0,1,2842,242061,0.242061
3240,1550,5740,8897000,2,25926,6483,1,260132800,260132800,9721,3240,6481,3240,0,1,3242,56879,0.056879
3640,1550,5740,8897000,2,29126,7283,1,283460800,283460800,10921,3640,7281,3640,0,1,3642,473885,0.473885
4040,1550,5740,8897000,2,32326,8083,1,306788800,306788800,12121,4040,8081,4040,0,1,4042,2349917,2.349917
4440,1550,5740,8897000,2,35526,8883,1,330116800,330116800,13321,4440,8881,4440,0,1,4442,674716,0.674716
4840,1550,5740,8897000,2,38726,9683,1,353444800,353444800,14521,4840,9681,4840,0,1,4842,225210,0.22521
5240,1550,5740,8897000,2,41926,10483,1,376772800,376772800,15721,5240,10481,5240,0,1,5242,2435565,2.435565
5640,1550,5740,8897000,2,45126,11283,1,400100800,400100800,16921,5640,11281,5640,0,1,5642,251853,0.251853
6040,1550,5740,8897000,2,48326,12083,1,423428800,423428800,18121,6040,12081,6040,0,1,6042,705360,0.70536
6440,1550,5740,8897000,2,51526,12883,1,446756800,446756800,19321,6440,12881,6440,0,1,6442,3762763,3.762763
6840,1550,5740,8897000,2,54726,13683,1,470084800,470084800,20521,6840,13681,6840,0,1,6842,3117388,3.117388
55,7055,1265,8924575,2,446,113,1,75057400,75057400,166,55,111,55,0,1,57,177593,0.177593
455,7055,1265,8924575,2,3646,913,1,101681400,101681400,1366,455,911,455,0,1,457,859296,0.859296
855,7055,1265,8924575,2,6846,1713,1,128305400,128305400,2566,855,1711,855,0,1,857,1548234,1.548234
1255,7055,1265,8924575,2,10046,2513,1,154929400,154929400,3766,1255,2511,1255,0,1,1257,385976,0.385976
1655,7055,1265,8924575,2,13246,3313,1,181553400,181553400,4966,1655,3311,1655,0,1,1657,115440,0.11544
2055,7055,1265,8924575,2,16446,4113,1,208177400,208177400,6166,2055,4111,2055,0,1,2057,1683722,1.683722
2455,7055,1265,8924575,2,19646,4913,1,234801400,234801400,7366,2455,4911,2455,0,1,2457,4314377,4.314377
2855,7055,1265,8924575,2,22846,5713,1,261425400,261425400,8566,2855,5711,2855,0,1,2857,5017485,5.017485
3255,7055,1265,8924575,2,26046,6513,1,288049400,288049400,9766,3255,6511,3255,0,1,3257,2056051,2.056051
3655,7055,1265,8924575,2,29246,7313,1,314673400,314673400,10966,3655,7311,3655,0,1,3657,5508250,5.50825
4055,7055,1265,8924575,2,32446,8113,1,341297400,341297400,12166,4055,8111,4055,0,1,4057,3734533,3.734533
4455,7055,1265,8924575,2,35646,8913,1,367921400,367921400,13366,4455,8911,4455,0,1,4457,7794405,7.794405
4855,7055,1265,8924575,2,38846,9713,1,394545400,394545400,14566,4855,9711,4855,0,1,4857,8538940,8.53894
5255,7055,1265,8924575,2,42046,10513,1,421169400,421169400,15766,5255,10511,5255,0,1,5257,9156321,9.156321
5655,7055,1265,8924575,2,45246,11313,1,447793400,447793400,16966,5655,11311,5655,0,1,5657,9927807,9.927807
6055,7055,1265,8924575,2,48446,12113,1,474417400,474417400,18166,6055,12111,6055,0,1,6057,10652758,10.652758
6455,7055,1265,8924575,2,51646,12913,1,501041400,501041400,19366,6455,12911,6455,0,1,6457,11359047,11.359047
6855,7055,1265,8924575,2,54846,13713,1,527665400,527665400,20566,6855,13711,6855,0,1,6857,12088196,12.088196
40,5800,1540,8932000,2,326,83,1,73804800,73804800,121,40,81,40,0,1,42,7895,0.007895
440,5800,1540,8932000,2,3526,883,1,97292800,97292800,1321,440,881,440,0,1,442,97179,0.097179
840,5800,1540,8932000,2,6726,1683,1,120780800,120780800,2521,840,1681,840,0,1,842,22040,0.02204
1240,5800,1540,8932000,2,9926,2483,1,144268800,144268800,3721,1240,2481,1240,0,1,1242,686263,0.686263
1640,5800,1540,8932000,2,13126,3283,1,167756800,167756800,4921,1640,3281,1640,0,1,1642,204890,0.20489
2040,5800,1540,8932000,2,16326,4083,1,191244800,191244800,6121,2040,4081,2040,0,1,2042,890605,0.890605
2440,5800,1540,8932000,2,19526,4883,1,214732800,214732800,7321,2440,4881,2440,0,1,2442,307287,0.307287
2840,5800,1540,8932000,2,22726,5683,1,238220800,238220800,8521,2840,5681,2840,0,1,2842,396063,0.396063
3240,5800,1540,8932000,2,25926,6483,1,261708800,261708800,9721,3240,6481,3240,0,1,3242,279656,0.279656
3640,5800,1540,8932000,2,29126,7283,1,285196800,285196800,10921,3640,7281,3640,0,1,3642,2474422,2.474422
4040,5800,1540,8932000,2,32326,8083,1,308684800,308684800,12121,4040,8081,4040,0,1,4042,2797455,2.797455
4440,5800,1540,8932000,2,35526,8883,1,332172800,332172800,13321,4440,8881,4440,0,1,4442,895303,0.895303
4840,5800,1540,8932000,2,38726,9683,1,355660800,355660800,14521,4840,9681,4840,0,1,4842,66798,0.066798
5240,5800,1540,8932000,2,41926,10483,1,379148800,379148800,15721,5240,10481,5240,0,1,5242,471307,0.471307
5640,5800,1540,8932000,2,45126,11283,1,402636800,402636800,16921,5640,11281,5640,0,1,5642,747059,0.747059
6040,5800,1540,8932000,2,48326,12083,1,426124800,426124800,18121,6040,12081,6040,0,1,6042,985160,0.98516
6440,5800,1540,8932000,2,51526,12883,1,449612800,449612800,19321,6440,12881,6440,0,1,6442,75794,0.075794
6840,5800,1540,8932000,2,54726,13683,1,473100800,473100800,20521,6840,13681,6840,0,1,6842,30876,0.030876
55,4805,1865,8961325,2,446,113,1,74625400,74625400,166,55,111,55,0,1,57,177673,0.177673
455,4805,1865,8961325,2,3646,913,1,95969400,95969400,1366,455,911,455,0,1,457,64469,0.064469
855,4805,1865,8961325,2,6846,1713,1,117313400,117313400,2566,855,1711,855,0,1,857,197680,0.19768
1255,4805,1865,8961325,2,10046,2513,1,138657400,138657400,3766,1255,2511,1255,0,1,1257,2180356,2.180356
1655,4805,1865,8961325,2,13246,3313,1,160001400,160001400,4966,1655,3311,1655,0,1,1657,2832254,2.832254
2055,4805,1865,8961325,2,16446,4113,1,181345400,181345400,6166,2055,4111,2055,0,1,2057,332654,0.332654
2455,4805,1865,8961325,2,19646,4913,1,202689400,202689400,7366,2455,4911,2455,0,1,2457,4174604,4.174604
2855,4805,1865,8961325,2,22846,5713,1,224033400,224033400,8566,2855,5711,2855,0,1,2857,4843939,4.843939
3255,4805,1865,8961325,2,26046,6513,1,245377400,245377400,9766,3255,6511,3255,0,1,3257,2055165,2.055165
3655,4805,1865,8961325,2,29246,7313,1,266721400,266721400,10966,3655,7311,3655,0,1,3657,3311884,3.311884
4055,4805,1865,8961325,2,32446,8113,1,288065400,288065400,12166,4055,8111,4055,0,1,4057,3232645,3.232645
4455,4805,1865,8961325,2,35646,8913,1,309409400,309409400,13366,4455,8911,4455,0,1,4457,769597,0.769597
4855,4805,1865,8961325,2,38846,9713,1,330753400,330753400,14566,4855,9711,4855,0,1,4857,133896,0.133896
5255,4805,1865,8961325,2,42046,10513,1,352097400,352097400,15766,5255,10511,5255,0,1,5257,8891883,8.891883
5655,4805,1865,8961325,2,45246,11313,1,373441400,373441400,16966,5655,11311,5655,0,1,5657,9295677,9.295677
6055,4805,1865,8961325,2,48446,12113,1,394785400,394785400,18166,6055,12111,6055,0,1,6057,10231598,10.231598
6455,4805,1865,8961325,2,51646,12913,1,416129400,416129400,19366,6455,12911,6455,0,1,6457,10841885,10.841885
6855,4805,1865,8961325,2,54846,13713,1,437473400,437473400,20566,6855,13711,6855,0,1,6857,5949086,5.949086
55,1555,5765,8964575,2,446,113,1,74937400,74937400,166,55,111,55,0,1,57,38608,0.038608
455,1555,5765,8964575,2,3646,913,1,98361400,98361400,1366,455,911,455,0,1,457,218549,0.218549
855,1555,5765,8964575,2,6846,1713,1,121785400,121785400,2566,855,1711,855,0,1,857,776360,0.77636
1255,1555,5765,8964575,2,10046,2513,1,145209400,145209400,3766,1255,2511,1255,0,1,1257,145563,0.145563
1655,1555,5765,8964575,2,13246,3313,1,168633400,168633400,4966,1655,3311,1655,0,1,1657,2929378,2.929378
2055,1555,5765,8964575,2,16446,4113,1,192057400,192057400,6166,2055,4111,2055,0,1,2057,1288731,1.288731
2455,1555,5765,8964575,2,19646,4913,1,215481400,215481400,7366,2455,4911,2455,0,1,2457,1021654,1.021654
2855,1555,5765,8964575,2,22846,5713,1,238905400,238905400,8566,2855,5711,2855,0,1,2857,709029,0.709029
3255,1555,5765,8964575,2,26046,6513,1,262329400,262329400,9766,3255,6511,3255,0,1,3257,564565,0.564565
3655,1555,5765,8964575,2,29246,7313,1,285753400,285753400,10966,3655,7311,3655,0,1,3657,83267,0.083267
4055,1555,5765,8964575,2,32446,8113,1,309177400,309177400,12166,4055,8111,4055,0,1,4057,1348621,1.348621
4455,1555,5765,8964575,2,35646,8913,1,332601400,332601400,13366,4455,8911,4455,0,1,4457,415688,0.415688
4855,1555,5765,8964575,2,38846,9713,1,356025400,356025400,14566,4855,9711,4855,0,1,4857,319110,0.31911
5255,1555,5765,8964575,2,42046,10513,1,379449400,379449400,15766,5255,10511,5255,0,1,5257,455996,0.455996
5655,1555,5765,8964575,2,45246,11313,1,402873400,402873400,16966,5655,11311,5655,0,1,5657,265770,0.26577
6055,1555,5765,8964575,2,48446,12113,1,426297400,426297400,18166,6055,12111,6055,0,1,6057,64411,0.064411
6455,1555,5765,8964575,2,51646,12913,1,449721400,449721400,19366,6455,12911,6455,0,1,6457,3957238,3.957238
6855,1555,5765,8964575,2,54846,13713,1,473145400,473145400,20566,6855,13711,6855,0,1,6857,48781,0.048781
35,4400,2045,8998000,2,286,73,1,73788600,73788600,106,35,71,35,0,1,37,47373,0.047373
535,4400,2045,8998000,2,4286,1073,1,99568600,99568600,1606,535,1071,535,0,1,537,61108,0.061108
1035,4400,2045,8998000,2,8286,2073,1,125348600,125348600,3106,1035,2071,1035,0,1,1037,5762,0.005762
1535,4400,2045,8998000,2,12286,3073,1,151128600,151128600,4606,1535,3071,1535,0,1,1537,305574,0.305574
2035,4400,2045,8998000,2,16286,4073,1,176908600,176908600,6106,2035,4071,2035,0,1,2037,3536992,3.536992
2535,4400,2045,8998000,2,20286,5073,1,202688600,202688600,7606,2535,5071,2535,0,1,2537,2870647,2.870647
3035,4400,2045,8998000,2,24286,6073,1,228468600,228468600,9106,3035,6071,3035,0,1,3037,2824966,2.824966
3535,4400,2045,8998000,2,28286,7073,1,254248600,254248600,10606,3535,7071,3535,0,1,3537,1053658,1.053658
4035,4400,2045,8998000,2,32286,8073,1,280028600,280028600,12106,4035,8071,4035,0,1,4037,4484278,4.484278
4535,4400,2045,8998000,2,36286,9073,1,305808600,305808600,13606,4535,9071,4535,0,1,4537,882508,0.882508
5035,4400,2045,8998000,2,40286,10073,1,331588600,331588600,15106,5035,10071,5035,0,1,5037,1942771,1.942771
5535,4400,2045,8998000,2,44286,11073,1,357368600,357368600,16606,5535,11071,5535,0,1,5537,5824827,5.824827
6035,4400,2045,8998000,2,48286,12073,1,383148600,383148600,18106,6035,12071,6035,0,1,6037,1256370,1.25637
6535,4400,2045,8998000,2,52286,13073,1,408928600,408928600,19606,6535,13071,6535,0,1,6537,6380580,6.38058
7035,4400,2045,8998000,2,56286,14073,1,434708600,434708600,21106,7035,14071,7035,0,1,7037,4164472,4.164472
40,1300,6940,9022000,2,326,83,1,74812800,74812800,121,40,81,40,0,1,42,161727,0.161727
440,1300,6940,9022000,2,3526,883,1,101180800,101180800,1321,440,881,440,0,1,442,794097,0.794097
840,1300,6940,9022000,2,6726,1683,1,127548800,127548800,2521,840,1681,840,0,1,842,1532024,1.532024
1240,1300,6940,9022000,2,9926,2483,1,153916800,153916800,3721,1240,2481,1240,0,1,1242,312031,0.312031
1640,1300,6940,9022000,2,13126,3283,1,180284800,180284800,4921,1640,3281,1640,0,1,1642,2484517,2.484517
2040,1300,6940,9022000,2,16326,4083,1,206652800,206652800,6121,2040,4081,2040,0,1,2042,135146,0.135146
2440,1300,6940,9022000,2,19526,4883,1,233020800,233020800,7321,2440,4881,2440,0,1,2442,3770406,3.770406
2840,1300,6940,9022000,2,22726,5683,1,259388800,259388800,8521,2840,5681,2840,0,1,2842,258375,0.258375
3240,1300,6940,9022000,2,25926,6483,1,285756800,285756800,9721,3240,6481,3240,0,1,3242,428105,0.428105
3640,1300,6940,9022000,2,29126,7283,1,312124800,312124800,10921,3640,7281,3640,0,1,3642,977509,0.977509
4040,1300,6940,9022000,2,32326,8083,1,338492800,338492800,12121,4040,8081,4040,0,1,4042,191840,0.19184
4440,1300,6940,9022000,2,35526,8883,1,364860800,364860800,13321,4440,8881,4440,0,1,4442,384739,0.384739
4840,1300,6940,9022000,2,38726,9683,1,391228800,391228800,14521,4840,9681,4840,0,1,4842,697829,0.697829
5240,1300,6940,9022000,2,41926,10483,1,417596800,417596800,15721,5240,10481,5240,0,1,5242,1091188,1.091188
5640,1300,6940,9022000,2,45126,11283,1,443964800,443964800,16921,5640,11281,5640,0,1,5642,7616942,7.616942
6040,1300,6940,9022000,2,48326,12083,1,470332800,470332800,18121,6040,12081,6040,0,1,6042,2615137,2.615137
6440,1300,6940,9022000,2,51526,12883,1,496700800,496700800,19321,6440,12881,6440,0,1,6442,4149363,4.149363
6840,1300,6940,9022000,2,54726,13683,1,523068800,523068800,20521,6840,13681,6840,0,1,6842,3767274,3.767274
40,3300,2740,9042000,2,326,83,1,74268800,74268800,121,40,81,40,0,1,42,158934,0.158934
440,3300,2740,9042000,2,3526,883,1,93596800,93596800,1321,440,881,440,0,1,442,835492,0.835492
840,3300,2740,9042000,2,6726,1683,1,112924800,112924800,2521,840,1681,840,0,1,842,1526064,1.526064
1240,3300,2740,9042000,2,9926,2483,1,132252800,132252800,3721,1240,2481,1240,0,1,1242,1786681,1.786681
1640,3300,2740,9042000,2,13126,3283,1,151580800,151580800,4921,1640,3281,1640,0,1,1642,340187,0.340187
2040,3300,2740,9042000,2,16326,4083,1,170908800,170908800,6121,2040,4081,2040,0,1,2042,496811,0.496811
2440,3300,2740,9042000,2,19526,4883,1,190236800,190236800,7321,2440,4881,2440,0,1,2442,3387487,3.387487
2840,3300,2740,9042000,2,22726,5683,1,209564800,209564800,8521,2840,5681,2840,0,1,2842,403245,0.403245
3240,3300,2740,9042000,2,25926,6483,1,228892800,228892800,9721,3240,6481,3240,0,1,3242,24904,0.024904
3640,3300,2740,9042000,2,29126,7283,1,248220800,248220800,10921,3640,7281,3640,0,1,3642,506628,0.506628
4040,3300,2740,9042000,2,32326,8083,1,267548800,267548800,12121,4040,8081,4040,0,1,4042,1727625,1.727625
4440,3300,2740,9042000,2,35526,8883,1,286876800,286876800,13321,4440,8881,4440,0,1,4442,309373,0.309373
4840,3300,2740,9042000,2,38726,9683,1,306204800,306204800,14521,4840,9681,4840,0,1,4842,685745,0.685745
5240,3300,2740,9042000,2,41926,10483,1,325532800,325532800,15721,5240,10481,5240,0,1,5242,2683210,2.68321
5640,3300,2740,9042000,2,45126,11283,1,344860800,344860800,16921,5640,11281,5640,0,1,5642,4746204,4.746204
6040,3300,2740,9042000,2,48326,12083,1,364188800,364188800,18121,6040,12081,6040,0,1,6042,1745073,1.745073
6440,3300,2740,9042000,2,51526,12883,1,383516800,383516800,19321,6440,12881,6440,0,1,6442,3268364,3.268364
6840,3300,2740,9042000,2,54726,13683,1,402844800,402844800,20521,6840,13681,6840,0,1,6842,2411091,2.411091
35,2240,4045,9060800,2,286,73,1,74246200,74246200,106,35,71,35,0,1,37,160099,0.160099
535,2240,4045,9060800,2,4286,1073,1,99386200,99386200,1606,535,1071,535,0,1,537,968593,0.968593
1035,2240,4045,9060800,2,8286,2073,1,124526200,124526200,3106,1035,2071,1035,0,1,1037,1816444,1.816444
1535,2240,4045,9060800,2,12286,3073,1,149666200,149666200,4606,1535,3071,1535,0,1,1537,2663203,2.663203
2035,2240,4045,9060800,2,16286,4073,1,174806200,174806200,6106,2035,4071,2035,0,1,2037,3511116,3.511116
2535,2240,4045,9060800,2,20286,5073,1,199946200,199946200,7606,2535,5071,2535,0,1,2537,4358189,4.358189
40,2300,3940,9062000,2,326,83,1,74492800,74492800,121,40,81,40,0,1,42,167919,0.167919
440,2300,3940,9062000,2,3526,883,1,94460800,94460800,1321,440,881,440,0,1,442,828944,0.828944
840,2300,3940,9062000,2,6726,1683,1,114428800,114428800,2521,840,1681,840,0,1,842,1318427,1.318427
1240,2300,3940,9062000,2,9926,2483,1,134396800,134396800,3721,1240,2481,1240,0,1,1242,2165375,2.165375
1640,2300,3940,9062000,2,13126,3283,1,154364800,154364800,4921,1640,3281,1640,0,1,1642,697071,0.697071
2040,2300,3940,9062000,2,16326,4083,1,174332800,174332800,6121,2040,4081,2040,0,1,2042,3513070,3.51307
2440,2300,3940,9062000,2,19526,4883,1,194300800,194300800,7321,2440,4881,2440,0,1,2442,23580,0.02358
2840,2300,3940,9062000,2,22726,5683,1,214268800,214268800,8521,2840,5681,2840,0,1,2842,2147900,2.1479
3240,2300,3940,9062000,2,25926,6483,1,234236800,234236800,9721,3240,6481,3240,0,1,3242,44051,0.044051
3640,2300,3940,9062000,2,29126,7283,1,254204800,254204800,10921,3640,7281,3640,0,1,3642,1803435,1.803435
4040,2300,3940,9062000,2,32326,8083,1,274172800,274172800,12121,4040,8081,4040,0,1,4042,1351421,1.351421
4440,2300,3940,9062000,2,35526,8883,1,294140800,294140800,13321,4440,8881,4440,0,1,4442,1567176,1.567176
4840,2300,3940,9062000,2,38726,9683,1,314108800,314108800,14521,4840,9681,4840,0,1,4842,65259,0.065259
5240,2300,3940,9062000,2,41926,10483,1,334076800,334076800,15721,5240,10481,5240,0,1,5242,667651,0.667651
5640,2300,3940,9062000,2,45126,11283,1,354044800,354044800,16921,5640,11281,5640,0,1,5642,670509,0.670509
6040,2300,3940,9062000,2,48326,12083,1,374012800,374012800,18121,6040,12081,6040,0,1,6042,1128827,1.128827
6440,2300,3940,9062000,2,51526,12883,1,393980800,393980800,19321,6440,12881,6440,0,1,6442,752525,0.752525
6840,2300,3940,9062000,2,54726,13683,1,413948800,413948800,20521,6840,13681,6840,0,1,6842,121146,0.121146
39,2243,4041,9063963,2,318,81,1,74472312,74472312,118,39,79,39,0,1,41,12827,0.012827
539,2243,4041,9063963,2,4318,1081,1,99608312,99608312,1618,539,1079,539,0,1,541,32241,0.032241
1039,2243,4041,9063963,2,8318,2081,1,124744312,124744312,3118,1039,2079,1039,0,1,1041,18402,0.018402
1539,2243,4041,9063963,2,12318,3081,1,149880312,149880312,4618,1539,3079,1539,0,1,1541,352896,0.352896
2039,2243,4041,9063963,2,16318,4081,1,175016312,175016312,6118,2039,4079,2039,0,1,2041,623740,0.62374
2539,2243,4041,9063963,2,20318,5081,1,200152312,200152312,7618,2539,5079,2539,0,1,2541,798822,0.798822
3039,2243,4041,9063963,2,24318,6081,1,225288312,225288312,9118,3039,6079,3039,0,1,3041,1077420,1.07742
3539,2243,4041,9063963,2,28318,7081,1,250424312,250424312,10618,3539,7079,3539,0,1,3541,26583,0.026583
4039,2243,4041,9063963,2,32318,8081,1,275560312,275560312,12118,4039,8079,4039,0,1,4041,365491,0.365491
4539,2243,4041,9063963,2,36318,9081,1,300696312,300696312,13618,4539,9079,4539,0,1,4541,371590,0.37159
5039,2243,4041,9063963,2,40318,10081,1,325832312,325832312,15118,5039,10079,5039,0,1,5041,2014016,2.014016
5539,2243,4041,9063963,2,44318,11081,1,350968312,350968312,16618,5539,11079,5539,0,1,5541,895123,0.895123
6039,2243,4041,9063963,2,48318,12081,1,376104312,376104312,18118,6039,12079,6039,0,1,6041,885505,0.885505
6539,2243,4041,9063963,2,52318,13081,1,401240312,401240312,19618,6539,13079,6539,0,1,6541,1196051,1.196051
7039,2243,4041,9063963,2,56318,14081,1,426376312,426376312,21118,7039,14079,7039,0,1,7041,1634385,1.634385
39,4443,2041,9068163,2,318,81,1,74568312,74568312,118,39,79,39,0,1,41,19056,0.019056
539,4443,2041,9068163,2,4318,1081,1,100504312,100504312,1618,539,1079,539,0,1,541,23650,0.02365
1039,4443,2041,9068163,2,8318,2081,1,126440312,126440312,3118,1039,2079,1039,0,1,1041,72482,0.072482
1539,4443,2041,9068163,2,12318,3081,1,152376312,152376312,4618,1539,3079,1539,0,1,1541,109509,0.109509
2039,4443,2041,9068163,2,16318,4081,1,178312312,178312312,6118,2039,4079,2039,0,1,2041,960771,0.960771
2539,4443,2041,9068163,2,20318,5081,1,204248312,204248312,7618,2539,5079,2539,0,1,2541,83492,0.083492
3039,4443,2041,9068163,2,24318,6081,1,230184312,230184312,9118,3039,6079,3039,0,1,3041,2830586,2.830586
3539,4443,2041,9068163,2,28318,7081,1,256120312,256120312,10618,3539,7079,3539,0,1,3541,1082133,1.082133
4039,4443,2041,9068163,2,32318,8081,1,282056312,282056312,12118,4039,8079,4039,0,1,4041,986060,0.98606
4539,4443,2041,9068163,2,36318,9081,1,307992312,307992312,13618,4539,9079,4539,0,1,4541,2722960,2.72296
5039,4443,2041,9068163,2,40318,10081,1,333928312,333928312,15118,5039,10079,5039,0,1,5041,618587,0.618587
5539,4443,2041,9068163,2,44318,11081,1,359864312,359864312,16618,5539,11079,5539,0,1,5541,3262884,3.262884
6039,4443,2041,9068163,2,48318,12081,1,385800312,385800312,18118,6039,12079,6039,0,1,6041,345403,0.345403
6539,4443,2041,9068163,2,52318,13081,1,411736312,411736312,19618,6539,13079,6539,0,1,6541,5158361,5.158361
7039,4443,2041,9068163,2,56318,14081,1,437672312,437672312,21118,7039,14079,7039,0,1,7041,567044,0.567044
35,4440,2045,9079800,2,286,73,1,74454200,74454200,106,35,71,35,0,1,37,181690,0.18169
535,4440,2045,9079800,2,4286,1073,1,100394200,100394200,1606,535,1071,535,0,1,537,973515,0.973515
1035,4440,2045,9079800,2,8286,2073,1,126334200,126334200,3106,1035,2071,1035,0,1,1037,1805087,1.805087
1535,4440,2045,9079800,2,12286,3073,1,152274200,152274200,4606,1535,3071,1535,0,1,1537,2686142,2.686142
2035,4440,2045,9079800,2,16286,4073,1,178214200,178214200,6106,2035,4071,2035,0,1,2037,3541834,3.541834
55,5805,1565,9084825,2,446,113,1,75921400,75921400,166,55,111,55,0,1,57,881,0.000881
455,5805,1565,9084825,2,3646,913,1,99505400,99505400,1366,455,911,455,0,1,457,85788,0.085788
855,5805,1565,9084825,2,6846,1713,1,123089400,123089400,2566,855,1711,855,0,1,857,385815,0.385815
1255,5805,1565,9084825,2,10046,2513,1,146673400,146673400,3766,1255,2511,1255,0,1,1257,75120,0.07512
1655,5805,1565,9084825,2,13246,3313,1,170257400,170257400,4966,1655,3311,1655,0,1,1657,373139,0.373139
2055,5805,1565,9084825,2,16446,4113,1,193841400,193841400,6166,2055,4111,2055,0,1,2057,961311,0.961311
2455,5805,1565,9084825,2,19646,4913,1,217425400,217425400,7366,2455,4911,2455,0,1,2457,1237471,1.237471
2855,5805,1565,9084825,2,22846,5713,1,241009400,241009400,8566,2855,5711,2855,0,1,2857,848430,0.84843
3255,5805,1565,9084825,2,26046,6513,1,264593400,264593400,9766,3255,6511,3255,0,1,3257,727149,0.727149
3655,5805,1565,9084825,2,29246,7313,1,288177400,288177400,10966,3655,7311,3655,0,1,3657,398285,0.398285
4055,5805,1565,9084825,2,32446,8113,1,311761400,311761400,12166,4055,8111,4055,0,1,4057,1832093,1.832093
4455,5805,1565,9084825,2,35646,8913,1,335345400,335345400,13366,4455,8911,4455,0,1,4457,1267192,1.267192
4855,5805,1565,9084825,2,38846,9713,1,358929400,358929400,14566,4855,9711,4855,0,1,4857,1608051,1.608051
5255,5805,1565,9084825,2,42046,10513,1,382513400,382513400,15766,5255,10511,5255,0,1,5257,100158,0.100158
5655,5805,1565,9084825,2,45246,11313,1,406097400,406097400,16966,5655,11311,5655,0,1,5657,2327836,2.327836
6055,5805,1565,9084825,2,48446,12113,1,429681400,429681400,18166,6055,12111,6055,0,1,6057,681869,0.681869
6455,5805,1565,9084825,2,51646,12913,1,453265400,453265400,19366,6455,12911,6455,0,1,6457,574184,0.574184
6855,5805,1565,9084825,2,54846,13713,1,476849400,476849400,20566,6855,13711,6855,0,1,6857,3091135,3.091135
55,1305,6965,9089325,2,446,113,1,76353400,76353400,166,55,111,55,0,1,57,184354,0.184354
455,1305,6965,9089325,2,3646,913,1,102817400,102817400,1366,455,911,455,0,1,457,11365,0.011365
855,1305,6965,9089325,2,6846,1713,1,129281400,129281400,2566,855,1711,855,0,1,857,577507,0.577507
1255,1305,6965,9089325,2,10046,2513,1,155745400,155745400,3766,1255,2511,1255,0,1,1257,1213631,1.213631
1655,1305,6965,9089325,2,13246,3313,1,182209400,182209400,4966,1655,3311,1655,0,1,1657,621745,0.621745
2055,1305,6965,9089325,2,16446,4113,1,208673400,208673400,6166,2055,4111,2055,0,1,2057,784773,0.784773
2455,1305,6965,9089325,2,19646,4913,1,235137400,235137400,7366,2455,4911,2455,0,1,2457,300681,0.300681
2855,1305,6965,9089325,2,22846,5713,1,261601400,261601400,8566,2855,5711,2855,0,1,2857,2046669,2.046669
3255,1305,6965,9089325,2,26046,6513,1,288065400,288065400,9766,3255,6511,3255,0,1,3257,3248382,3.248382
3655,1305,6965,9089325,2,29246,7313,1,314529400,314529400,10966,3655,7311,3655,0,1,3657,712194,0.712194
4055,1305,6965,9089325,2,32446,8113,1,340993400,340993400,12166,4055,8111,4055,0,1,4057,158042,0.158042
4455,1305,6965,9089325,2,35646,8913,1,367457400,367457400,13366,4455,8911,4455,0,1,4457,59350,0.05935
4855,1305,6965,9089325,2,38846,9713,1,393921400,393921400,14566,4855,9711,4855,0,1,4857,973199,0.973199
5255,1305,6965,9089325,2,42046,10513,1,420385400,420385400,15766,5255,10511,5255,0,1,5257,1239908,1.239908
5655,1305,6965,9089325,2,45246,11313,1,446849400,446849400,16966,5655,11311,5655,0,1,5657,100769,0.100769
6055,1305,6965,9089325,2,48446,12113,1,473313400,473313400,18166,6055,12111,6055,0,1,6057,696518,0.696518
6455,1305,6965,9089325,2,51646,12913,1,499777400,499777400,19366,6455,12911,6455,0,1,6457,1170440,1.17044
6855,1305,6965,9089325,2,54846,13713,1,526241400,526241400,20566,6855,13711,6855,0,1,6857,3953813,3.953813
44,2253,4055,9135915,2,358,91,1,75307736,75307736,133,44,89,44,0,1,46,12011,0.012011
544,2253,4055,9135915,2,4358,1091,1,100539736,100539736,1633,544,1089,544,0,1,546,87362,0.087362
1044,2253,4055,9135915,2,8358,2091,1,125771736,125771736,3133,1044,2089,1044,0,1,1046,27126,0.027126
1544,2253,4055,9135915,2,12358,3091,1,151003736,151003736,4633,1544,3089,1544,0,1,1546,70414,0.070414
2044,2253,4055,9135915,2,16358,4091,1,176235736,176235736,6133,2044,4089,2044,0,1,2046,296603,0.296603
2544,2253,4055,9135915,2,20358,5091,1,201467736,201467736,7633,2544,5089,2544,0,1,2546,43144,0.043144
3044,2253,4055,9135915,2,24358,6091,1,226699736,226699736,9133,3044,6089,3044,0,1,3046,1440799,1.440799
3544,2253,4055,9135915,2,28358,7091,1,251931736,251931736,10633,3544,7089,3544,0,1,3546,4079859,4.079859
4044,2253,4055,9135915,2,32358,8091,1,277163736,277163736,12133,4044,8089,4044,0,1,4046,437488,0.437488
4544,2253,4055,9135915,2,36358,9091,1,302395736,302395736,13633,4544,9089,4544,0,1,4546,1606836,1.606836
5044,2253,4055,9135915,2,40358,10091,1,327627736,327627736,15133,5044,10089,5044,0,1,5046,86501,0.086501
5544,2253,4055,9135915,2,44358,11091,1,352859736,352859736,16633,5544,11089,5544,0,1,5546,503471,0.503471
6044,2253,4055,9135915,2,48358,12091,1,378091736,378091736,18133,6044,12089,6044,0,1,6046,454125,0.454125
6544,2253,4055,9135915,2,52358,13091,1,403323736,403323736,19633,6544,13089,6544,0,1,6546,2113626,2.113626
7044,2253,4055,9135915,2,56358,14091,1,428555736,428555736,21133,7044,14089,7044,0,1,7046,3828663,3.828663
55,3305,2765,9138325,2,446,113,1,75777400,75777400,166,55,111,55,0,1,57,187420,0.18742
455,3305,2765,9138325,2,3646,913,1,95201400,95201400,1366,455,911,455,0,1,457,694167,0.694167
855,3305,2765,9138325,2,6846,1713,1,114625400,114625400,2566,855,1711,855,0,1,857,831964,0.831964
1255,3305,2765,9138325,2,10046,2513,1,134049400,134049400,3766,1255,2511,1255,0,1,1257,1511275,1.511275
1655,3305,2765,9138325,2,13246,3313,1,153473400,153473400,4966,1655,3311,1655,0,1,1657,2981238,2.981238
2055,3305,2765,9138325,2,16446,4113,1,172897400,172897400,6166,2055,4111,2055,0,1,2057,3690016,3.690016
2455,3305,2765,9138325,2,19646,4913,1,192321400,192321400,7366,2455,4911,2455,0,1,2457,281499,0.281499
2855,3305,2765,9138325,2,22846,5713,1,211745400,211745400,8566,2855,5711,2855,0,1,2857,5099384,5.099384
3255,3305,2765,9138325,2,26046,6513,1,231169400,231169400,9766,3255,6511,3255,0,1,3257,1036886,1.036886
3655,3305,2765,9138325,2,29246,7313,1,250593400,250593400,10966,3655,7311,3655,0,1,3657,282836,0.282836
4055,3305,2765,9138325,2,32446,8113,1,270017400,270017400,12166,4055,8111,4055,0,1,4057,854419,0.854419
4455,3305,2765,9138325,2,35646,8913,1,289441400,289441400,13366,4455,8911,4455,0,1,4457,2530696,2.530696
4855,3305,2765,9138325,2,38846,9713,1,308865400,308865400,14566,4855,9711,4855,0,1,4857,919593,0.919593
5255,3305,2765,9138325,2,42046,10513,1,328289400,328289400,15766,5255,10511,5255,0,1,5257,442500,0.4425
5655,3305,2765,9138325,2,45246,11313,1,347713400,347713400,16966,5655,11311,5655,0,1,5657,2791391,2.791391
6055,3305,2765,9138325,2,48446,12113,1,367137400,367137400,18166,6055,12111,6055,0,1,6057,493885,0.493885
6455,3305,2765,9138325,2,51646,12913,1,386561400,386561400,19366,6455,12911,6455,0,1,6457,2449647,2.449647
6855,3305,2765,9138325,2,54846,13713,1,405985400,405985400,20566,6855,13711,6855,0,1,6857,3994294,3.994294
55,2305,3965,9139325,2,446,113,1,75873400,75873400,166,55,111,55,0,1,57,65451,0.065451
455,2305,3965,9139325,2,3646,913,1,95937400,95937400,1366,455,911,455,0,1,457,612372,0.612372
855,2305,3965,9139325,2,6846,1713,1,116001400,116001400,2566,855,1711,855,0,1,857,1516498,1.516498
1255,2305,3965,9139325,2,10046,2513,1,136065400,136065400,3766,1255,2511,1255,0,1,1257,1057023,1.057023
1655,2305,3965,9139325,2,13246,3313,1,156129400,156129400,4966,1655,3311,1655,0,1,1657,198694,0.198694
2055,2305,3965,9139325,2,16446,4113,1,176193400,176193400,6166,2055,4111,2055,0,1,2057,77844,0.077844
2455,2305,3965,9139325,2,19646,4913,1,196257400,196257400,7366,2455,4911,2455,0,1,2457,1798471,1.798471
2855,2305,3965,9139325,2,22846,5713,1,216321400,216321400,8566,2855,5711,2855,0,1,2857,900067,0.900067
3255,2305,3965,9139325,2,26046,6513,1,236385400,236385400,9766,3255,6511,3255,0,1,3257,1264702,1.264702
3655,2305,3965,9139325,2,29246,7313,1,256449400,256449400,10966,3655,7311,3655,0,1,3657,989275,0.989275
4055,2305,3965,9139325,2,32446,8113,1,276513400,276513400,12166,4055,8111,4055,0,1,4057,1371842,1.371842
4455,2305,3965,9139325,2,35646,8913,1,296577400,296577400,13366,4455,8911,4455,0,1,4457,508836,0.508836
4855,2305,3965,9139325,2,38846,9713,1,316641400,316641400,14566,4855,9711,4855,0,1,4857,727163,0.727163
5255,2305,3965,9139325,2,42046,10513,1,336705400,336705400,15766,5255,10511,5255,0,1,5257,609611,0.609611
5655,2305,3965,9139325,2,45246,11313,1,356769400,356769400,16966,5655,11311,5655,0,1,5657,491434,0.491434
6055,2305,3965,9139325,2,48446,12113,1,376833400,376833400,18166,6055,12111,6055,0,1,6057,3404419,3.404419
6455,2305,3965,9139325,2,51646,12913,1,396897400,396897400,19366,6455,12911,6455,0,1,6457,3811912,3.811912
6855,2305,3965,9139325,2,54846,13713,1,416961400,416961400,20566,6855,13711,6855,0,1,6857,933317,0.933317
44,4453,2055,9150915,2,358,91,1,75498136,75498136,133,44,89,44,0,1,46,11360,0.01136
544,4453,2055,9150915,2,4358,1091,1,101530136,101530136,1633,544,1089,544,0,1,546,168098,0.168098
1044,4453,2055,9150915,2,8358,2091,1,127562136,127562136,3133,1044,2089,1044,0,1,1046,97483,0.097483
1544,4453,2055,9150915,2,12358,3091,1,153594136,153594136,4633,1544,3089,1544,0,1,1546,491586,0.491586
2044,4453,2055,9150915,2,16358,4091,1,179626136,179626136,6133,2044,4089,2044,0,1,2046,1317559,1.317559
2544,4453,2055,9150915,2,20358,5091,1,205658136,205658136,7633,2544,5089,2544,0,1,2546,239275,0.239275
3044,4453,2055,9150915,2,24358,6091,1,231690136,231690136,9133,3044,6089,3044,0,1,3046,26391,0.026391
3544,4453,2055,9150915,2,28358,7091,1,257722136,257722136,10633,3544,7089,3544,0,1,3546,360823,0.360823
4044,4453,2055,9150915,2,32358,8091,1,283754136,283754136,12133,4044,8089,4044,0,1,4046,1005592,1.005592
4544,4453,2055,9150915,2,36358,9091,1,309786136,309786136,13633,4544,9089,4544,0,1,4546,752256,0.752256
5044,4453,2055,9150915,2,40358,10091,1,335818136,335818136,15133,5044,10089,5044,0,1,5046,1061071,1.061071
5544,4453,2055,9150915,2,44358,11091,1,361850136,361850136,16633,5544,11089,5544,0,1,5546,680673,0.680673
6044,4453,2055,9150915,2,48358,12091,1,387882136,387882136,18133,6044,12089,6044,0,1,6046,3876463,3.876463
6544,4453,2055,9150915,2,52358,13091,1,413914136,413914136,19633,6544,13089,6544,0,1,6546,3487897,3.487897
7044,4453,2055,9150915,2,56358,14091,1,439946136,439946136,21133,7044,14089,7044,0,1,7046,2674695,2.674695
40,4300,2140,9202000,2,326,83,1,75676800,75676800,121,40,81,40,0,1,42,164617,0.164617
440,4300,2140,9202000,2,3526,883,1,96284800,96284800,1321,440,881,440,0,1,442,829750,0.82975
840,4300,2140,9202000,2,6726,1683,1,116892800,116892800,2521,840,1681,840,0,1,842,957566,0.957566
1240,4300,2140,9202000,2,9926,2483,1,137500800,137500800,3721,1240,2481,1240,0,1,1242,609984,0.609984
1640,4300,2140,9202000,2,13126,3283,1,158108800,158108800,4921,1640,3281,1640,0,1,1642,168049,0.168049
2040,4300,2140,9202000,2,16326,4083,1,178716800,178716800,6121,2040,4081,2040,0,1,2042,1469789,1.469789
2440,4300,2140,9202000,2,19526,4883,1,199324800,199324800,7321,2440,4881,2440,0,1,2442,1417349,1.417349
2840,4300,2140,9202000,2,22726,5683,1,219932800,219932800,8521,2840,5681,2840,0,1,2842,621143,0.621143
3240,4300,2140,9202000,2,25926,6483,1,240540800,240540800,9721,3240,6481,3240,0,1,3242,1033294,1.033294
3640,4300,2140,9202000,2,29126,7283,1,261148800,261148800,10921,3640,7281,3640,0,1,3642,18609,0.018609
4040,4300,2140,9202000,2,32326,8083,1,281756800,281756800,12121,4040,8081,4040,0,1,4042,110334,0.110334
4440,4300,2140,9202000,2,35526,8883,1,302364800,302364800,13321,4440,8881,4440,0,1,4442,768354,0.768354
4840,4300,2140,9202000,2,38726,9683,1,322972800,322972800,14521,4840,9681,4840,0,1,4842,2826762,2.826762
5240,4300,2140,9202000,2,41926,10483,1,343580800,343580800,15721,5240,10481,5240,0,1,5242,500398,0.500398
5640,4300,2140,9202000,2,45126,11283,1,364188800,364188800,16921,5640,11281,5640,0,1,5642,529320,0.52932
6040,4300,2140,9202000,2,48326,12083,1,384796800,384796800,18121,6040,12081,6040,0,1,6042,183100,0.1831
6440,4300,2140,9202000,2,51526,12883,1,405404800,405404800,19321,6440,12881,6440,0,1,6442,464348,0.464348
6840,4300,2140,9202000,2,54726,13683,1,426012800,426012800,20521,6840,13681,6840,0,1,6842,1065435,1.065435
40,1800,5140,9252000,2,326,83,1,76236800,76236800,121,40,81,40,0,1,42,173393,0.173393
440,1800,5140,9252000,2,3526,883,1,98444800,98444800,1321,440,881,440,0,1,442,480634,0.480634
840,1800,5140,9252000,2,6726,1683,1,120652800,120652800,2521,840,1681,840,0,1,842,1113545,1.113545
1240,1800,5140,9252000,2,9926,2483,1,142860800,142860800,3721,1240,2481,1240,0,1,1242,2264167,2.264167
1640,1800,5140,9252000,2,13126,3283,1,165068800,165068800,4921,1640,3281,1640,0,1,1642,469952,0.469952
2040,1800,5140,9252000,2,16326,4083,1,187276800,187276800,6121,2040,4081,2040,0,1,2042,112209,0.112209
2440,1800,5140,9252000,2,19526,4883,1,209484800,209484800,7321,2440,4881,2440,0,1,2442,1655029,1.655029
2840,1800,5140,9252000,2,22726,5683,1,231692800,231692800,8521,2840,5681,2840,0,1,2842,761191,0.761191
3240,1800,5140,9252000,2,25926,6483,1,253900800,253900800,9721,3240,6481,3240,0,1,3242,797657,0.797657
3640,1800,5140,9252000,2,29126,7283,1,276108800,276108800,10921,3640,7281,3640,0,1,3642,843475,0.843475
4040,1800,5140,9252000,2,32326,8083,1,298316800,298316800,12121,4040,8081,4040,0,1,4042,560673,0.560673
4440,1800,5140,9252000,2,35526,8883,1,320524800,320524800,13321,4440,8881,4440,0,1,4442,3570047,3.570047
4840,1800,5140,9252000,2,38726,9683,1,342732800,342732800,14521,4840,9681,4840,0,1,4842,851912,0.851912
5240,1800,5140,9252000,2,41926,10483,1,364940800,364940800,15721,5240,10481,5240,0,1,5242,3045945,3.045945
5640,1800,5140,9252000,2,45126,11283,1,387148800,387148800,16921,5640,11281,5640,0,1,5642,135012,0.135012
6040,1800,5140,9252000,2,48326,12083,1,409356800,409356800,18121,6040,12081,6040,0,1,6042,1261284,1.261284
6440,1800,5140,9252000,2,51526,12883,1,431564800,431564800,19321,6440,12881,6440,0,1,6442,786182,0.786182
6840,1800,5140,9252000,2,54726,13683,1,453772800,453772800,20521,6840,13681,6840,0,1,6842,273641,0.273641
40,3050,3040,9272000,2,326,83,1,76124800,76124800,121,40,81,40,0,1,42,22687,0.022687
440,3050,3040,9272000,2,3526,883,1,95612800,95612800,1321,440,881,440,0,1,442,118955,0.118955
840,3050,3040,9272000,2,6726,1683,1,115100800,115100800,2521,840,1681,840,0,1,842,228729,0.228729
1240,3050,3040,9272000,2,9926,2483,1,134588800,134588800,3721,1240,2481,1240,0,1,1242,199220,0.19922
1640,3050,3040,9272000,2,13126,3283,1,154076800,154076800,4921,1640,3281,1640,0,1,1642,514886,0.514886
2040,3050,3040,9272000,2,16326,4083,1,173564800,173564800,6121,2040,4081,2040,0,1,2042,1242260,1.24226
2440,3050,3040,9272000,2,19526,4883,1,193052800,193052800,7321,2440,4881,2440,0,1,2442,31981,0.031981
2840,3050,3040,9272000,2,22726,5683,1,212540800,212540800,8521,2840,5681,2840,0,1,2842,150676,0.150676
3240,3050,3040,9272000,2,25926,6483,1,232028800,232028800,9721,3240,6481,3240,0,1,3242,873816,0.873816
3640,3050,3040,9272000,2,29126,7283,1,251516800,251516800,10921,3640,7281,3640,0,1,3642,1666273,1.666273
4040,3050,3040,9272000,2,32326,8083,1,271004800,271004800,12121,4040,8081,4040,0,1,4042,674550,0.67455
4440,3050,3040,9272000,2,35526,8883,1,290492800,290492800,13321,4440,8881,4440,0,1,4442,21210,0.02121
4840,3050,3040,9272000,2,38726,9683,1,309980800,309980800,14521,4840,9681,4840,0,1,4842,71838,0.071838
5240,3050,3040,9272000,2,41926,10483,1,329468800,329468800,15721,5240,10481,5240,0,1,5242,1212507,1.212507
5640,3050,3040,9272000,2,45126,11283,1,348956800,348956800,16921,5640,11281,5640,0,1,5642,257430,0.25743
6040,3050,3040,9272000,2,48326,12083,1,368444800,368444800,18121,6040,12081,6040,0,1,6042,2221002,2.221002
6440,3050,3040,9272000,2,51526,12883,1,387932800,387932800,19321,6440,12881,6440,0,1,6442,741776,0.741776
6840,3050,3040,9272000,2,54726,13683,1,407420800,407420800,20521,6840,13681,6840,0,1,6842,1008316,1.008316
40,3800,2440,9272000,2,326,83,1,76172800,76172800,121,40,81,40,0,1,42,165532,0.165532
440,3800,2440,9272000,2,3526,883,1,96140800,96140800,1321,440,881,440,0,1,442,850724,0.850724
840,3800,2440,9272000,2,6726,1683,1,116108800,116108800,2521,840,1681,840,0,1,842,1553456,1.553456
1240,3800,2440,9272000,2,9926,2483,1,136076800,136076800,3721,1240,2481,1240,0,1,1242,2248906,2.248906
1640,3800,2440,9272000,2,13126,3283,1,156044800,156044800,4921,1640,3281,1640,0,1,1642,2965697,2.965697
2040,3800,2440,9272000,2,16326,4083,1,176012800,176012800,6121,2040,4081,2040,0,1,2042,3681297,3.681297
2440,3800,2440,9272000,2,19526,4883,1,195980800,195980800,7321,2440,4881,2440,0,1,2442,4340711,4.340711
2840,3800,2440,9272000,2,22726,5683,1,215948800,215948800,8521,2840,5681,2840,0,1,2842,1565083,1.565083
3240,3800,2440,9272000,2,25926,6483,1,235916800,235916800,9721,3240,6481,3240,0,1,3242,3698624,3.698624
3640,3800,2440,9272000,2,29126,7283,1,255884800,255884800,10921,3640,7281,3640,0,1,3642,3291638,3.291638
4040,3800,2440,9272000,2,32326,8083,1,275852800,275852800,12121,4040,8081,4040,0,1,4042,1980282,1.980282
4440,3800,2440,9272000,2,35526,8883,1,295820800,295820800,13321,4440,8881,4440,0,1,4442,7603992,7.603992
4840,3800,2440,9272000,2,38726,9683,1,315788800,315788800,14521,4840,9681,4840,0,1,4842,1210107,1.210107
5240,3800,2440,9272000,2,41926,10483,1,335756800,335756800,15721,5240,10481,5240,0,1,5242,139108,0.139108
5640,3800,2440,9272000,2,45126,11283,1,355724800,355724800,16921,5640,11281,5640,0,1,5642,2425430,2.42543
6040,3800,2440,9272000,2,48326,12083,1,375692800,375692800,18121,6040,12081,6040,0,1,6042,107037,0.107037
6440,3800,2440,9272000,2,51526,12883,1,395660800,395660800,19321,6440,12881,6440,0,1,6442,4062677,4.062677
6840,3800,2440,9272000,2,54726,13683,1,415628800,415628800,20521,6840,13681,6840,0,1,6842,1285139,1.285139
40,2550,3640,9282000,2,326,83,1,76236800,76236800,121,40,81,40,0,1,42,166171,0.166171
440,2550,3640,9282000,2,3526,883,1,96044800,96044800,1321,440,881,440,0,1,442,837119,0.837119
840,2550,3640,9282000,2,6726,1683,1,115852800,115852800,2521,840,1681,840,0,1,842,37412,0.037412
1240,2550,3640,9282000,2,9926,2483,1,135660800,135660800,3721,1240,2481,1240,0,1,1242,111848,0.111848
1640,2550,3640,9282000,2,13126,3283,1,155468800,155468800,4921,1640,3281,1640,0,1,1642,1592027,1.592027
2040,2550,3640,9282000,2,16326,4083,1,175276800,175276800,6121,2040,4081,2040,0,1,2042,1094193,1.094193
2440,2550,3640,9282000,2,19526,4883,1,195084800,195084800,7321,2440,4881,2440,0,1,2442,1101604,1.101604
2840,2550,3640,9282000,2,22726,5683,1,214892800,214892800,8521,2840,5681,2840,0,1,2842,1433059,1.433059
3240,2550,3640,9282000,2,25926,6483,1,234700800,234700800,9721,3240,6481,3240,0,1,3242,45938,0.045938
3640,2550,3640,9282000,2,29126,7283,1,254508800,254508800,10921,3640,7281,3640,0,1,3642,2378812,2.378812
4040,2550,3640,9282000,2,32326,8083,1,274316800,274316800,12121,4040,8081,4040,0,1,4042,253219,0.253219
4440,2550,3640,9282000,2,35526,8883,1,294124800,294124800,13321,4440,8881,4440,0,1,4442,454579,0.454579
4840,2550,3640,9282000,2,38726,9683,1,313932800,313932800,14521,4840,9681,4840,0,1,4842,3251150,3.25115
5240,2550,3640,9282000,2,41926,10483,1,333740800,333740800,15721,5240,10481,5240,0,1,5242,478949,0.478949
5640,2550,3640,9282000,2,45126,11283,1,353548800,353548800,16921,5640,11281,5640,0,1,5642,1859487,1.859487
6040,2550,3640,9282000,2,48326,12083,1,373356800,373356800,18121,6040,12081,6040,0,1,6042,536855,0.536855
6440,2550,3640,9282000,2,51526,12883,1,393164800,393164800,19321,6440,12881,6440,0,1,6442,2247459,2.247459
6840,2550,3640,9282000,2,54726,13683,1,412972800,412972800,20521,6840,13681,6840,0,1,6842,1627894,1.627894
40,5050,1840,9292000,2,326,83,1,76540800,76540800,121,40,81,40,0,1,42,7500,0.0075
440,5050,1840,9292000,2,3526,883,1,98588800,98588800,1321,440,881,440,0,1,442,6066,0.006066
840,5050,1840,9292000,2,6726,1683,1,120636800,120636800,2521,840,1681,840,0,1,842,40395,0.040395
1240,5050,1840,9292000,2,9926,2483,1,142684800,142684800,3721,1240,2481,1240,0,1,1242,136408,0.136408
1640,5050,1840,9292000,2,13126,3283,1,164732800,164732800,4921,1640,3281,1640,0,1,1642,363929,0.363929
2040,5050,1840,9292000,2,16326,4083,1,186780800,186780800,6121,2040,4081,2040,0,1,2042,1519479,1.519479
2440,5050,1840,9292000,2,19526,4883,1,208828800,208828800,7321,2440,4881,2440,0,1,2442,16996,0.016996
2840,5050,1840,9292000,2,22726,5683,1,230876800,230876800,8521,2840,5681,2840,0,1,2842,407933,0.407933
3240,5050,1840,9292000,2,25926,6483,1,252924800,252924800,9721,3240,6481,3240,0,1,3242,378103,0.378103
3640,5050,1840,9292000,2,29126,7283,1,274972800,274972800,10921,3640,7281,3640,0,1,3642,734445,0.734445
4040,5050,1840,9292000,2,32326,8083,1,297020800,297020800,12121,4040,8081,4040,0,1,4042,85502,0.085502
4440,5050,1840,9292000,2,35526,8883,1,319068800,319068800,13321,4440,8881,4440,0,1,4442,224566,0.224566
4840,5050,1840,9292000,2,38726,9683,1,341116800,341116800,14521,4840,9681,4840,0,1,4842,103180,0.10318
5240,5050,1840,9292000,2,41926,10483,1,363164800,363164800,15721,5240,10481,5240,0,1,5242,1940313,1.940313
5640,5050,1840,9292000,2,45126,11283,1,385212800,385212800,16921,5640,11281,5640,0,1,5642,818932,0.818932
6040,5050,1840,9292000,2,48326,12083,1,407260800,407260800,18121,6040,12081,6040,0,1,6042,1681580,1.68158
6440,5050,1840,9292000,2,51526,12883,1,429308800,429308800,19321,6440,12881,6440,0,1,6442,71917,0.071917
6840,5050,1840,9292000,2,54726,13683,1,451356800,451356800,20521,6840,13681,6840,0,1,6842,296515,0.296515
40,2050,4540,9307000,2,326,83,1,76564800,76564800,121,40,81,40,0,1,42,23529,0.023529
440,2050,4540,9307000,2,3526,883,1,97652800,97652800,1321,440,881,440,0,1,442,20316,0.020316
840,2050,4540,9307000,2,6726,1683,1,118740800,118740800,2521,840,1681,840,0,1,842,28589,0.028589
1240,2050,4540,9307000,2,9926,2483,1,139828800,139828800,3721,1240,2481,1240,0,1,1242,10639,0.010639
1640,2050,4540,9307000,2,13126,3283,1,160916800,160916800,4921,1640,3281,1640,0,1,1642,48255,0.048255
2040,2050,4540,9307000,2,16326,4083,1,182004800,182004800,6121,2040,4081,2040,0,1,2042,590240,0.59024
2440,2050,4540,9307000,2,19526,4883,1,203092800,203092800,7321,2440,4881,2440,0,1,2442,1755155,1.755155
2840,2050,4540,9307000,2,22726,5683,1,224180800,224180800,8521,2840,5681,2840,0,1,2842,668936,0.668936
3240,2050,4540,9307000,2,25926,6483,1,245268800,245268800,9721,3240,6481,3240,0,1,3242,200372,0.200372
3640,2050,4540,9307000,2,29126,7283,1,266356800,266356800,10921,3640,7281,3640,0,1,3642,1495138,1.495138
4040,2050,4540,9307000,2,32326,8083,1,287444800,287444800,12121,4040,8081,4040,0,1,4042,25154,0.025154
4440,2050,4540,9307000,2,35526,8883,1,308532800,308532800,13321,4440,8881,4440,0,1,4442,594915,0.594915
4840,2050,4540,9307000,2,38726,9683,1,329620800,329620800,14521,4840,9681,4840,0,1,4842,669190,0.66919
5240,2050,4540,9307000,2,41926,10483,1,350708800,350708800,15721,5240,10481,5240,0,1,5242,40969,0.040969
5640,2050,4540,9307000,2,45126,11283,1,371796800,371796800,16921,5640,11281,5640,0,1,5642,199415,0.199415
6040,2050,4540,9307000,2,48326,12083,1,392884800,392884800,18121,6040,12081,6040,0,1,6042,185401,0.185401
6440,2050,4540,9307000,2,51526,12883,1,413972800,413972800,19321,6440,12881,6440,0,1,6442,701786,0.701786
6840,2050,4540,9307000,2,54726,13683,1,435060800,435060800,20521,6840,13681,6840,0,1,6842,2813806,2.813806
40,6050,1540,9317000,2,326,83,1,76964800,76964800,121,40,81,40,0,1,42,162066,0.162066
440,6050,1540,9317000,2,3526,883,1,101252800,101252800,1321,440,881,440,0,1,442,831239,0.831239
840,6050,1540,9317000,2,6726,1683,1,125540800,125540800,2521,840,1681,840,0,1,842,1515526,1.515526
1240,6050,1540,9317000,2,9926,2483,1,149828800,149828800,3721,1240,2481,1240,0,1,1242,68342,0.068342
1640,6050,1540,9317000,2,13126,3283,1,174116800,174116800,4921,1640,3281,1640,0,1,1642,676140,0.67614
2040,6050,1540,9317000,2,16326,4083,1,198404800,198404800,6121,2040,4081,2040,0,1,2042,206809,0.206809
2440,6050,1540,9317000,2,19526,4883,1,222692800,222692800,7321,2440,4881,2440,0,1,2442,1441699,1.441699
2840,6050,1540,9317000,2,22726,5683,1,246980800,246980800,8521,2840,5681,2840,0,1,2842,2388208,2.388208
3240,6050,1540,9317000,2,25926,6483,1,271268800,271268800,9721,3240,6481,3240,0,1,3242,1049942,1.049942
3640,6050,1540,9317000,2,29126,7283,1,295556800,295556800,10921,3640,7281,3640,0,1,3642,1859888,1.859888
4040,6050,1540,9317000,2,32326,8083,1,319844800,319844800,12121,4040,8081,4040,0,1,4042,97850,0.09785
4440,6050,1540,9317000,2,35526,8883,1,344132800,344132800,13321,4440,8881,4440,0,1,4442,998564,0.998564
4840,6050,1540,9317000,2,38726,9683,1,368420800,368420800,14521,4840,9681,4840,0,1,4842,523135,0.523135
5240,6050,1540,9317000,2,41926,10483,1,392708800,392708800,15721,5240,10481,5240,0,1,5242,374112,0.374112
5640,6050,1540,9317000,2,45126,11283,1,416996800,416996800,16921,5640,11281,5640,0,1,5642,1393415,1.393415
6040,6050,1540,9317000,2,48326,12083,1,441284800,441284800,18121,6040,12081,6040,0,1,6042,7111337,7.111337
6440,6050,1540,9317000,2,51526,12883,1,465572800,465572800,19321,6440,12881,6440,0,1,6442,4733374,4.733374
6840,6050,1540,9317000,2,54726,13683,1,489860800,489860800,20521,6840,13681,6840,0,1,6842,2810811,2.810811
55,4305,2165,9320325,2,446,113,1,77409400,77409400,166,55,111,55,0,1,57,187858,0.187858
455,4305,2165,9320325,2,3646,913,1,98113400,98113400,1366,455,911,455,0,1,457,156444,0.156444
855,4305,2165,9320325,2,6846,1713,1,118817400,118817400,2566,855,1711,855,0,1,857,664286,0.664286
1255,4305,2165,9320325,2,10046,2513,1,139521400,139521400,3766,1255,2511,1255,0,1,1257,161977,0.161977
1655,4305,2165,9320325,2,13246,3313,1,160225400,160225400,4966,1655,3311,1655,0,1,1657,331216,0.331216
2055,4305,2165,9320325,2,16446,4113,1,180929400,180929400,6166,2055,4111,2055,0,1,2057,681361,0.681361
2455,4305,2165,9320325,2,19646,4913,1,201633400,201633400,7366,2455,4911,2455,0,1,2457,174054,0.174054
2855,4305,2165,9320325,2,22846,5713,1,222337400,222337400,8566,2855,5711,2855,0,1,2857,2399176,2.399176
3255,4305,2165,9320325,2,26046,6513,1,243041400,243041400,9766,3255,6511,3255,0,1,3257,1640280,1.64028
3655,4305,2165,9320325,2,29246,7313,1,263745400,263745400,10966,3655,7311,3655,0,1,3657,1151867,1.151867
4055,4305,2165,9320325,2,32446,8113,1,284449400,284449400,12166,4055,8111,4055,0,1,4057,564018,0.564018
4455,4305,2165,9320325,2,35646,8913,1,305153400,305153400,13366,4455,8911,4455,0,1,4457,1019665,1.019665
4855,4305,2165,9320325,2,38846,9713,1,325857400,325857400,14566,4855,9711,4855,0,1,4857,3707649,3.707649
5255,4305,2165,9320325,2,42046,10513,1,346561400,346561400,15766,5255,10511,5255,0,1,5257,236606,0.236606
5655,4305,2165,9320325,2,45246,11313,1,367265400,367265400,16966,5655,11311,5655,0,1,5657,1926665,1.926665
6055,4305,2165,9320325,2,48446,12113,1,387969400,387969400,18166,6055,12111,6055,0,1,6057,298432,0.298432
6455,4305,2165,9320325,2,51646,12913,1,408673400,408673400,19366,6455,12911,6455,0,1,6457,2226837,2.226837
6855,4305,2165,9320325,2,54846,13713,1,429377400,429377400,20566,6855,13711,6855,0,1,6857,514399,0.514399
55,1805,5165,9322825,2,446,113,1,77649400,77649400,166,55,111,55,0,1,57,197191,0.197191
455,1805,5165,9322825,2,3646,913,1,99953400,99953400,1366,455,911,455,0,1,457,283989,0.283989
855,1805,5165,9322825,2,6846,1713,1,122257400,122257400,2566,855,1711,855,0,1,857,712157,0.712157
1255,1805,5165,9322825,2,10046,2513,1,144561400,144561400,3766,1255,2511,1255,0,1,1257,8244,0.008244
1655,1805,5165,9322825,2,13246,3313,1,166865400,166865400,4966,1655,3311,1655,0,1,1657,708097,0.708097
2055,1805,5165,9322825,2,16446,4113,1,189169400,189169400,6166,2055,4111,2055,0,1,2057,1110408,1.110408
2455,1805,5165,9322825,2,19646,4913,1,211473400,211473400,7366,2455,4911,2455,0,1,2457,3432658,3.432658
2855,1805,5165,9322825,2,22846,5713,1,233777400,233777400,8566,2855,5711,2855,0,1,2857,543419,0.543419
3255,1805,5165,9322825,2,26046,6513,1,256081400,256081400,9766,3255,6511,3255,0,1,3257,905802,0.905802
3655,1805,5165,9322825,2,29246,7313,1,278385400,278385400,10966,3655,7311,3655,0,1,3657,258375,0.258375
4055,1805,5165,9322825,2,32446,8113,1,300689400,300689400,12166,4055,8111,4055,0,1,4057,83230,0.08323
4455,1805,5165,9322825,2,35646,8913,1,322993400,322993400,13366,4455,8911,4455,0,1,4457,919495,0.919495
4855,1805,5165,9322825,2,38846,9713,1,345297400,345297400,14566,4855,9711,4855,0,1,4857,107469,0.107469
5255,1805,5165,9322825,2,42046,10513,1,367601400,367601400,15766,5255,10511,5255,0,1,5257,944246,0.944246
5655,1805,5165,9322825,2,45246,11313,1,389905400,389905400,16966,5655,11311,5655,0,1,5657,33446,0.033446
6055,1805,5165,9322825,2,48446,12113,1,412209400,412209400,18166,6055,12111,6055,0,1,6057,729791,0.729791
6455,1805,5165,9322825,2,51646,12913,1,434513400,434513400,19366,6455,12911,6455,0,1,6457,6643221,6.643221
6855,1805,5165,9322825,2,54846,13713,1,456817400,456817400,20566,6855,13711,6855,0,1,6857,1255075,1.255075
35,6050,1545,9347250,2,286,73,1,76904600,76904600,106,35,71,35,0,1,37,8102,0.008102
535,6050,1545,9347250,2,4286,1073,1,107284600,107284600,1606,535,1071,535,0,1,537,148238,0.148238
1035,6050,1545,9347250,2,8286,2073,1,137664600,137664600,3106,1035,2071,1035,0,1,1037,354071,0.354071
1535,6050,1545,9347250,2,12286,3073,1,168044600,168044600,4606,1535,3071,1535,0,1,1537,103812,0.103812
2035,6050,1545,9347250,2,16286,4073,1,198424600,198424600,6106,2035,4071,2035,0,1,2037,2572025,2.572025
2535,6050,1545,9347250,2,20286,5073,1,228804600,228804600,7606,2535,5071,2535,0,1,2537,1357127,1.357127
3035,6050,1545,9347250,2,24286,6073,1,259184600,259184600,9106,3035,6071,3035,0,1,3037,547887,0.547887
3535,6050,1545,9347250,2,28286,7073,1,289564600,289564600,10606,3535,7071,3535,0,1,3537,2539364,2.539364
4035,6050,1545,9347250,2,32286,8073,1,319944600,319944600,12106,4035,8071,4035,0,1,4037,307845,0.307845
4535,6050,1545,9347250,2,36286,9073,1,350324600,350324600,13606,4535,9071,4535,0,1,4537,4389842,4.389842
5035,6050,1545,9347250,2,40286,10073,1,380704600,380704600,15106,5035,10071,5035,0,1,5037,5862541,5.862541
5535,6050,1545,9347250,2,44286,11073,1,411084600,411084600,16606,5535,11071,5535,0,1,5537,19680,0.01968
6035,6050,1545,9347250,2,48286,12073,1,441464600,441464600,18106,6035,12071,6035,0,1,6037,1419039,1.419039
6535,6050,1545,9347250,2,52286,13073,1,471844600,471844600,19606,6535,13071,6535,0,1,6537,11938217,11.938217
7035,6050,1545,9347250,2,56286,14073,1,502224600,502224600,21106,7035,14071,7035,0,1,7037,12857733,12.857733
40,2800,3340,9352000,2,326,83,1,76780800,76780800,121,40,81,40,0,1,42,167963,0.167963
440,2800,3340,9352000,2,3526,883,1,96428800,96428800,1321,440,881,440,0,1,442,843282,0.843282
840,2800,3340,9352000,2,6726,1683,1,116076800,116076800,2521,840,1681,840,0,1,842,371904,0.371904
1240,2800,3340,9352000,2,9926,2483,1,135724800,135724800,3721,1240,2481,1240,0,1,1242,643218,0.643218
1640,2800,3340,9352000,2,13126,3283,1,155372800,155372800,4921,1640,3281,1640,0,1,1642,2558781,2.558781
2040,2800,3340,9352000,2,16326,4083,1,175020800,175020800,6121,2040,4081,2040,0,1,2042,894209,0.894209
2440,2800,3340,9352000,2,19526,4883,1,194668800,194668800,7321,2440,4881,2440,0,1,2442,2642572,2.642572
2840,2800,3340,9352000,2,22726,5683,1,214316800,214316800,8521,2840,5681,2840,0,1,2842,2168590,2.16859
3240,2800,3340,9352000,2,25926,6483,1,233964800,233964800,9721,3240,6481,3240,0,1,3242,939015,0.939015
3640,2800,3340,9352000,2,29126,7283,1,253612800,253612800,10921,3640,7281,3640,0,1,3642,292437,0.292437
4040,2800,3340,9352000,2,32326,8083,1,273260800,273260800,12121,4040,8081,4040,0,1,4042,1807730,1.80773
4440,2800,3340,9352000,2,35526,8883,1,292908800,292908800,13321,4440,8881,4440,0,1,4442,1277183,1.277183
4840,2800,3340,9352000,2,38726,9683,1,312556800,312556800,14521,4840,9681,4840,0,1,4842,812734,0.812734
5240,2800,3340,9352000,2,41926,10483,1,332204800,332204800,15721,5240,10481,5240,0,1,5242,643294,0.643294
5640,2800,3340,9352000,2,45126,11283,1,351852800,351852800,16921,5640,11281,5640,0,1,5642,7683947,7.683947
6040,2800,3340,9352000,2,48326,12083,1,371500800,371500800,18121,6040,12081,6040,0,1,6042,425561,0.425561
6440,2800,3340,9352000,2,51526,12883,1,391148800,391148800,19321,6440,12881,6440,0,1,6442,8929512,8.929512
6840,2800,3340,9352000,2,54726,13683,1,410796800,410796800,20521,6840,13681,6840,0,1,6842,5642542,5.642542
40,1550,6040,9362000,2,326,83,1,77324800,77324800,121,40,81,40,0,1,42,175862,0.175862
440,1550,6040,9362000,2,3526,883,1,101612800,101612800,1321,440,881,440,0,1,442,858864,0.858864
840,1550,6040,9362000,2,6726,1683,1,125900800,125900800,2521,840,1681,840,0,1,842,1361776,1.361776
1240,1550,6040,9362000,2,9926,2483,1,150188800,150188800,3721,1240,2481,1240,0,1,1242,289567,0.289567
1640,1550,6040,9362000,2,13126,3283,1,174476800,174476800,4921,1640,3281,1640,0,1,1642,514940,0.51494
2040,1550,6040,9362000,2,16326,4083,1,198764800,198764800,6121,2040,4081,2040,0,1,2042,3703663,3.703663
2440,1550,6040,9362000,2,19526,4883,1,223052800,223052800,7321,2440,4881,2440,0,1,2442,671941,0.671941
2840,1550,6040,9362000,2,22726,5683,1,247340800,247340800,8521,2840,5681,2840,0,1,2842,844054,0.844054
3240,1550,6040,9362000,2,25926,6483,1,271628800,271628800,9721,3240,6481,3240,0,1,3242,3216982,3.216982
3640,1550,6040,9362000,2,29126,7283,1,295916800,295916800,10921,3640,7281,3640,0,1,3642,1845479,1.845479
4040,1550,6040,9362000,2,32326,8083,1,320204800,320204800,12121,4040,8081,4040,0,1,4042,52634,0.052634
4440,1550,6040,9362000,2,35526,8883,1,344492800,344492800,13321,4440,8881,4440,0,1,4442,1639677,1.639677
4840,1550,6040,9362000,2,38726,9683,1,368780800,368780800,14521,4840,9681,4840,0,1,4842,2015897,2.015897
5240,1550,6040,9362000,2,41926,10483,1,393068800,393068800,15721,5240,10481,5240,0,1,5242,1377908,1.377908
5640,1550,6040,9362000,2,45126,11283,1,417356800,417356800,16921,5640,11281,5640,0,1,5642,3504646,3.504646
6040,1550,6040,9362000,2,48326,12083,1,441644800,441644800,18121,6040,12081,6040,0,1,6042,114503,0.114503
6440,1550,6040,9362000,2,51526,12883,1,465932800,465932800,19321,6440,12881,6440,0,1,6442,5306165,5.306165
6840,1550,6040,9362000,2,54726,13683,1,490220800,490220800,20521,6840,13681,6840,0,1,6842,6119551,6.119551
55,3055,3065,9363575,2,446,113,1,77601400,77601400,166,55,111,55,0,1,57,7903,0.007903
455,3055,3065,9363575,2,3646,913,1,97185400,97185400,1366,455,911,455,0,1,457,11009,0.011009
855,3055,3065,9363575,2,6846,1713,1,116769400,116769400,2566,855,1711,855,0,1,857,68975,0.068975
1255,3055,3065,9363575,2,10046,2513,1,136353400,136353400,3766,1255,2511,1255,0,1,1257,96637,0.096637
1655,3055,3065,9363575,2,13246,3313,1,155937400,155937400,4966,1655,3311,1655,0,1,1657,550055,0.550055
2055,3055,3065,9363575,2,16446,4113,1,175521400,175521400,6166,2055,4111,2055,0,1,2057,1080867,1.080867
2455,3055,3065,9363575,2,19646,4913,1,195105400,195105400,7366,2455,4911,2455,0,1,2457,326023,0.326023
2855,3055,3065,9363575,2,22846,5713,1,214689400,214689400,8566,2855,5711,2855,0,1,2857,22820,0.02282
3255,3055,3065,9363575,2,26046,6513,1,234273400,234273400,9766,3255,6511,3255,0,1,3257,1995339,1.995339
3655,3055,3065,9363575,2,29246,7313,1,253857400,253857400,10966,3655,7311,3655,0,1,3657,459995,0.459995
4055,3055,3065,9363575,2,32446,8113,1,273441400,273441400,12166,4055,8111,4055,0,1,4057,283524,0.283524
4455,3055,3065,9363575,2,35646,8913,1,293025400,293025400,13366,4455,8911,4455,0,1,4457,223597,0.223597
4855,3055,3065,9363575,2,38846,9713,1,312609400,312609400,14566,4855,9711,4855,0,1,4857,21301,0.021301
5255,3055,3065,9363575,2,42046,10513,1,332193400,332193400,15766,5255,10511,5255,0,1,5257,1780358,1.780358
5655,3055,3065,9363575,2,45246,11313,1,351777400,351777400,16966,5655,11311,5655,0,1,5657,2697741,2.697741
6055,3055,3065,9363575,2,48446,12113,1,371361400,371361400,18166,6055,12111,6055,0,1,6057,907403,0.907403
6455,3055,3065,9363575,2,51646,12913,1,390945400,390945400,19366,6455,12911,6455,0,1,6457,79676,0.079676
6855,3055,3065,9363575,2,54846,13713,1,410529400,410529400,20566,6855,13711,6855,0,1,6857,2321537,2.321537
55,2555,3665,9364075,2,446,113,1,77649400,77649400,166,55,111,55,0,1,57,193124,0.193124
455,2555,3665,9364075,2,3646,913,1,97553400,97553400,1366,455,911,455,0,1,457,22787,0.022787
855,2555,3665,9364075,2,6846,1713,1,117457400,117457400,2566,855,1711,855,0,1,857,662933,0.662933
1255,2555,3665,9364075,2,10046,2513,1,137361400,137361400,3766,1255,2511,1255,0,1,1257,1916569,1.916569
1655,2555,3665,9364075,2,13246,3313,1,157265400,157265400,4966,1655,3311,1655,0,1,1657,2945250,2.94525
2055,2555,3665,9364075,2,16446,4113,1,177169400,177169400,6166,2055,4111,2055,0,1,2057,88445,0.088445
2455,2555,3665,9364075,2,19646,4913,1,197073400,197073400,7366,2455,4911,2455,0,1,2457,1446974,1.446974
2855,2555,3665,9364075,2,22846,5713,1,216977400,216977400,8566,2855,5711,2855,0,1,2857,470324,0.470324
3255,2555,3665,9364075,2,26046,6513,1,236881400,236881400,9766,3255,6511,3255,0,1,3257,1820137,1.820137
3655,2555,3665,9364075,2,29246,7313,1,256785400,256785400,10966,3655,7311,3655,0,1,3657,2006824,2.006824
4055,2555,3665,9364075,2,32446,8113,1,276689400,276689400,12166,4055,8111,4055,0,1,4057,59518,0.059518
4455,2555,3665,9364075,2,35646,8913,1,296593400,296593400,13366,4455,8911,4455,0,1,4457,2098506,2.098506
4855,2555,3665,9364075,2,38846,9713,1,316497400,316497400,14566,4855,9711,4855,0,1,4857,252448,0.252448
5255,2555,3665,9364075,2,42046,10513,1,336401400,336401400,15766,5255,10511,5255,0,1,5257,2045572,2.045572
5655,2555,3665,9364075,2,45246,11313,1,356305400,356305400,16966,5655,11311,5655,0,1,5657,542215,0.542215
6055,2555,3665,9364075,2,48446,12113,1,376209400,376209400,18166,6055,12111,6055,0,1,6057,1846457,1.846457
6455,2555,3665,9364075,2,51646,12913,1,396113400,396113400,19366,6455,12911,6455,0,1,6457,956437,0.956437
6855,2555,3665,9364075,2,54846,13713,1,416017400,416017400,20566,6855,13711,6855,0,1,6857,728084,0.728084
55,3805,2465,9379325,2,446,113,1,77793400,77793400,166,55,111,55,0,1,57,196540,0.19654
455,3805,2465,9379325,2,3646,913,1,97857400,97857400,1366,455,911,455,0,1,457,907226,0.907226
855,3805,2465,9379325,2,6846,1713,1,117921400,117921400,2566,855,1711,855,0,1,857,1631866,1.631866
1255,3805,2465,9379325,2,10046,2513,1,137985400,137985400,3766,1255,2511,1255,0,1,1257,608798,0.608798
1655,3805,2465,9379325,2,13246,3313,1,158049400,158049400,4966,1655,3311,1655,0,1,1657,3077256,3.077256
2055,3805,2465,9379325,2,16446,4113,1,178113400,178113400,6166,2055,4111,2055,0,1,2057,1206133,1.206133
2455,3805,2465,9379325,2,19646,4913,1,198177400,198177400,7366,2455,4911,2455,0,1,2457,1891988,1.891988
2855,3805,2465,9379325,2,22846,5713,1,218241400,218241400,8566,2855,5711,2855,0,1,2857,3204743,3.204743
3255,3805,2465,9379325,2,26046,6513,1,238305400,238305400,9766,3255,6511,3255,0,1,3257,5002867,5.002867
3655,3805,2465,9379325,2,29246,7313,1,258369400,258369400,10966,3655,7311,3655,0,1,3657,6696343,6.696343
4055,3805,2465,9379325,2,32446,8113,1,278433400,278433400,12166,4055,8111,4055,0,1,4057,2463174,2.463174
4455,3805,2465,9379325,2,35646,8913,1,298497400,298497400,13366,4455,8911,4455,0,1,4457,7913361,7.913361
4855,3805,2465,9379325,2,38846,9713,1,318561400,318561400,14566,4855,9711,4855,0,1,4857,225802,0.225802
5255,3805,2465,9379325,2,42046,10513,1,338625400,338625400,15766,5255,10511,5255,0,1,5257,2547727,2.547727
5655,3805,2465,9379325,2,45246,11313,1,358689400,358689400,16966,5655,11311,5655,0,1,5657,2166046,2.166046
6055,3805,2465,9379325,2,48446,12113,1,378753400,378753400,18166,6055,12111,6055,0,1,6057,46606,0.046606
6455,3805,2465,9379325,2,51646,12913,1,398817400,398817400,19366,6455,12911,6455,0,1,6457,994165,0.994165
6855,3805,2465,9379325,2,54846,13713,1,418881400,418881400,20566,6855,13711,6855,0,1,6857,79247,0.079247
39,1693,5541,9380913,2,318,81,1,77304312,77304312,118,39,79,39,0,1,41,166424,0.166424
539,1693,5541,9380913,2,4318,1081,1,106240312,106240312,1618,539,1079,539,0,1,541,1039701,1.039701
1039,1693,5541,9380913,2,8318,2081,1,135176312,135176312,3118,1039,2079,1039,0,1,1041,986131,0.986131
1539,1693,5541,9380913,2,12318,3081,1,164112312,164112312,4618,1539,3079,1539,0,1,1541,679112,0.679112
2039,1693,5541,9380913,2,16318,4081,1,193048312,193048312,6118,2039,4079,2039,0,1,2041,2661924,2.661924
2539,1693,5541,9380913,2,20318,5081,1,221984312,221984312,7618,2539,5079,2539,0,1,2541,606474,0.606474
3039,1693,5541,9380913,2,24318,6081,1,250920312,250920312,9118,3039,6079,3039,0,1,3041,156166,0.156166
3539,1693,5541,9380913,2,28318,7081,1,279856312,279856312,10618,3539,7079,3539,0,1,3541,4237760,4.23776
4039,1693,5541,9380913,2,32318,8081,1,308792312,308792312,12118,4039,8079,4039,0,1,4041,5930886,5.930886
4539,1693,5541,9380913,2,36318,9081,1,337728312,337728312,13618,4539,9079,4539,0,1,4541,406957,0.406957
5039,1693,5541,9380913,2,40318,10081,1,366664312,366664312,15118,5039,10079,5039,0,1,5041,3910757,3.910757
5539,1693,5541,9380913,2,44318,11081,1,395600312,395600312,16618,5539,11079,5539,0,1,5541,3366925,3.366925
6039,1693,5541,9380913,2,48318,12081,1,424536312,424536312,18118,6039,12079,6039,0,1,6041,1938980,1.93898
6539,1693,5541,9380913,2,52318,13081,1,453472312,453472312,19618,6539,13079,6539,0,1,6541,4885282,4.885282
7039,1693,5541,9380913,2,56318,14081,1,482408312,482408312,21118,7039,14079,7039,0,1,7041,3683416,3.683416
55,2055,4565,9381075,2,446,113,1,77961400,77961400,166,55,111,55,0,1,57,13515,0.013515
455,2055,4565,9381075,2,3646,913,1,99145400,99145400,1366,455,911,455,0,1,457,12405,0.012405
855,2055,4565,9381075,2,6846,1713,1,120329400,120329400,2566,855,1711,855,0,1,857,39270,0.03927
1255,2055,4565,9381075,2,10046,2513,1,141513400,141513400,3766,1255,2511,1255,0,1,1257,15509,0.015509
1655,2055,4565,9381075,2,13246,3313,1,162697400,162697400,4966,1655,3311,1655,0,1,1657,206451,0.206451
2055,2055,4565,9381075,2,16446,4113,1,183881400,183881400,6166,2055,4111,2055,0,1,2057,411886,0.411886
2455,2055,4565,9381075,2,19646,4913,1,205065400,205065400,7366,2455,4911,2455,0,1,2457,62653,0.062653
2855,2055,4565,9381075,2,22846,5713,1,226249400,226249400,8566,2855,5711,2855,0,1,2857,464469,0.464469
3255,2055,4565,9381075,2,26046,6513,1,247433400,247433400,9766,3255,6511,3255,0,1,3257,272336,0.272336
3655,2055,4565,9381075,2,29246,7313,1,268617400,268617400,10966,3655,7311,3655,0,1,3657,87929,0.087929
4055,2055,4565,9381075,2,32446,8113,1,289801400,289801400,12166,4055,8111,4055,0,1,4057,2015114,2.015114
4455,2055,4565,9381075,2,35646,8913,1,310985400,310985400,13366,4455,8911,4455,0,1,4457,359568,0.359568
4855,2055,4565,9381075,2,38846,9713,1,332169400,332169400,14566,4855,9711,4855,0,1,4857,2086808,2.086808
5255,2055,4565,9381075,2,42046,10513,1,353353400,353353400,15766,5255,10511,5255,0,1,5257,496911,0.496911
5655,2055,4565,9381075,2,45246,11313,1,374537400,374537400,16966,5655,11311,5655,0,1,5657,372042,0.372042
6055,2055,4565,9381075,2,48446,12113,1,395721400,395721400,18166,6055,12111,6055,0,1,6057,623343,0.623343
6455,2055,4565,9381075,2,51646,12913,1,416905400,416905400,19366,6455,12911,6455,0,1,6457,128503,0.128503
6855,2055,4565,9381075,2,54846,13713,1,438089400,438089400,20566,6855,13711,6855,0,1,6857,2304154,2.304154
39,6093,1541,9389313,2,318,81,1,77496312,77496312,118,39,79,39,0,1,41,12591,0.012591
539,6093,1541,9389313,2,4318,1081,1,108032312,108032312,1618,539,1079,539,0,1,541,21345,0.021345
1039,6093,1541,9389313,2,8318,2081,1,138568312,138568312,3118,1039,2079,1039,0,1,1041,198493,0.198493
1539,6093,1541,9389313,2,12318,3081,1,169104312,169104312,4618,1539,3079,1539,0,1,1541,826946,0.826946
2039,6093,1541,9389313,2,16318,4081,1,199640312,199640312,6118,2039,4079,2039,0,1,2041,523234,0.523234
2539,6093,1541,9389313,2,20318,5081,1,230176312,230176312,7618,2539,5079,2539,0,1,2541,503759,0.503759
3039,6093,1541,9389313,2,24318,6081,1,260712312,260712312,9118,3039,6079,3039,0,1,3041,3258998,3.258998
3539,6093,1541,9389313,2,28318,7081,1,291248312,291248312,10618,3539,7079,3539,0,1,3541,1265992,1.265992
4039,6093,1541,9389313,2,32318,8081,1,321784312,321784312,12118,4039,8079,4039,0,1,4041,509105,0.509105
4539,6093,1541,9389313,2,36318,9081,1,352320312,352320312,13618,4539,9079,4539,0,1,4541,37166,0.037166
5039,6093,1541,9389313,2,40318,10081,1,382856312,382856312,15118,5039,10079,5039,0,1,5041,1494851,1.494851
5539,6093,1541,9389313,2,44318,11081,1,413392312,413392312,16618,5539,11079,5539,0,1,5541,3456511,3.456511
6039,6093,1541,9389313,2,48318,12081,1,443928312,443928312,18118,6039,12079,6039,0,1,6041,3354445,3.354445
6539,6093,1541,9389313,2,52318,13081,1,474464312,474464312,19618,6539,13079,6539,0,1,6541,2473587,2.473587
7039,6093,1541,9389313,2,56318,14081,1,505000312,505000312,21118,7039,14079,7039,0,1,7041,11552871,11.552871
35,6090,1545,9409050,2,286,73,1,77410200,77410200,106,35,71,35,0,1,37,11211,0.011211
535,6090,1545,9409050,2,4286,1073,1,107950200,107950200,1606,535,1071,535,0,1,537,791374,0.791374
1035,6090,1545,9409050,2,8286,2073,1,138490200,138490200,3106,1035,2071,1035,0,1,1037,331382,0.331382
1535,6090,1545,9409050,2,12286,3073,1,169030200,169030200,4606,1535,3071,1535,0,1,1537,1877603,1.877603
55,5055,1865,9427575,2,446,113,1,78465400,78465400,166,55,111,55,0,1,57,12325,0.012325
455,5055,1865,9427575,2,3646,913,1,100609400,100609400,1366,455,911,455,0,1,457,64663,0.064663
855,5055,1865,9427575,2,6846,1713,1,122753400,122753400,2566,855,1711,855,0,1,857,154001,0.154001
1255,5055,1865,9427575,2,10046,2513,1,144897400,144897400,3766,1255,2511,1255,0,1,1257,5176,0.005176
1655,5055,1865,9427575,2,13246,3313,1,167041400,167041400,4966,1655,3311,1655,0,1,1657,13135,0.013135
2055,5055,1865,9427575,2,16446,4113,1,189185400,189185400,6166,2055,4111,2055,0,1,2057,330723,0.330723
2455,5055,1865,9427575,2,19646,4913,1,211329400,211329400,7366,2455,4911,2455,0,1,2457,1408210,1.40821
2855,5055,1865,9427575,2,22846,5713,1,233473400,233473400,8566,2855,5711,2855,0,1,2857,66926,0.066926
3255,5055,1865,9427575,2,26046,6513,1,255617400,255617400,9766,3255,6511,3255,0,1,3257,99327,0.099327
3655,5055,1865,9427575,2,29246,7313,1,277761400,277761400,10966,3655,7311,3655,0,1,3657,263614,0.263614
4055,5055,1865,9427575,2,32446,8113,1,299905400,299905400,12166,4055,8111,4055,0,1,4057,2278149,2.278149
4455,5055,1865,9427575,2,35646,8913,1,322049400,322049400,13366,4455,8911,4455,0,1,4457,1007732,1.007732
4855,5055,1865,9427575,2,38846,9713,1,344193400,344193400,14566,4855,9711,4855,0,1,4857,1082186,1.082186
5255,5055,1865,9427575,2,42046,10513,1,366337400,366337400,15766,5255,10511,5255,0,1,5257,20802,0.020802
5655,5055,1865,9427575,2,45246,11313,1,388481400,388481400,16966,5655,11311,5655,0,1,5657,871133,0.871133
6055,5055,1865,9427575,2,48446,12113,1,410625400,410625400,18166,6055,12111,6055,0,1,6057,1332032,1.332032
6455,5055,1865,9427575,2,51646,12913,1,432769400,432769400,19366,6455,12911,6455,0,1,6457,647412,0.647412
6855,5055,1865,9427575,2,54846,13713,1,454913400,454913400,20566,6855,13711,6855,0,1,6857,488632,0.488632
55,1555,6065,9431075,2,446,113,1,78801400,78801400,166,55,111,55,0,1,57,196328,0.196328
455,1555,6065,9431075,2,3646,913,1,103185400,103185400,1366,455,911,455,0,1,457,906470,0.90647
855,1555,6065,9431075,2,6846,1713,1,127569400,127569400,2566,855,1711,855,0,1,857,989926,0.989926
1255,1555,6065,9431075,2,10046,2513,1,151953400,151953400,3766,1255,2511,1255,0,1,1257,1439913,1.439913
1655,1555,6065,9431075,2,13246,3313,1,176337400,176337400,4966,1655,3311,1655,0,1,1657,914316,0.914316
2055,1555,6065,9431075,2,16446,4113,1,200721400,200721400,6166,2055,4111,2055,0,1,2057,572691,0.572691
2455,1555,6065,9431075,2,19646,4913,1,225105400,225105400,7366,2455,4911,2455,0,1,2457,1695275,1.695275
2855,1555,6065,9431075,2,22846,5713,1,249489400,249489400,8566,2855,5711,2855,0,1,2857,832827,0.832827
3255,1555,6065,9431075,2,26046,6513,1,273873400,273873400,9766,3255,6511,3255,0,1,3257,790020,0.79002
3655,1555,6065,9431075,2,29246,7313,1,298257400,298257400,10966,3655,7311,3655,0,1,3657,3835624,3.835624
4055,1555,6065,9431075,2,32446,8113,1,322641400,322641400,12166,4055,8111,4055,0,1,4057,2653079,2.653079
4455,1555,6065,9431075,2,35646,8913,1,347025400,347025400,13366,4455,8911,4455,0,1,4457,3538909,3.538909
4855,1555,6065,9431075,2,38846,9713,1,371409400,371409400,14566,4855,9711,4855,0,1,4857,302727,0.302727
5255,1555,6065,9431075,2,42046,10513,1,395793400,395793400,15766,5255,10511,5255,0,1,5257,3296718,3.296718
5655,1555,6065,9431075,2,45246,11313,1,420177400,420177400,16966,5655,11311,5655,0,1,5657,706868,0.706868
6055,1555,6065,9431075,2,48446,12113,1,444561400,444561400,18166,6055,12111,6055,0,1,6057,2385488,2.385488
6455,1555,6065,9431075,2,51646,12913,1,468945400,468945400,19366,6455,12911,6455,0,1,6457,2362391,2.362391
6855,1555,6065,9431075,2,54846,13713,1,493329400,493329400,20566,6855,13711,6855,0,1,6857,2001776,2.001776
55,2805,3365,9438825,2,446,113,1,78225400,78225400,166,55,111,55,0,1,57,189855,0.189855
455,2805,3365,9438825,2,3646,913,1,97969400,97969400,1366,455,911,455,0,1,457,870787,0.870787
855,2805,3365,9438825,2,6846,1713,1,117713400,117713400,2566,855,1711,855,0,1,857,1565564,1.565564
1255,2805,3365,9438825,2,10046,2513,1,137457400,137457400,3766,1255,2511,1255,0,1,1257,601938,0.601938
1655,2805,3365,9438825,2,13246,3313,1,157201400,157201400,4966,1655,3311,1655,0,1,1657,2764724,2.764724
2055,2805,3365,9438825,2,16446,4113,1,176945400,176945400,6166,2055,4111,2055,0,1,2057,1292081,1.292081
2455,2805,3365,9438825,2,19646,4913,1,196689400,196689400,7366,2455,4911,2455,0,1,2457,725910,0.72591
2855,2805,3365,9438825,2,22846,5713,1,216433400,216433400,8566,2855,5711,2855,0,1,2857,4834972,4.834972
3255,2805,3365,9438825,2,26046,6513,1,236177400,236177400,9766,3255,6511,3255,0,1,3257,3554725,3.554725
3655,2805,3365,9438825,2,29246,7313,1,255921400,255921400,10966,3655,7311,3655,0,1,3657,171069,0.171069
4055,2805,3365,9438825,2,32446,8113,1,275665400,275665400,12166,4055,8111,4055,0,1,4057,2894323,2.894323
4455,2805,3365,9438825,2,35646,8913,1,295409400,295409400,13366,4455,8911,4455,0,1,4457,3765024,3.765024
4855,2805,3365,9438825,2,38846,9713,1,315153400,315153400,14566,4855,9711,4855,0,1,4857,75398,0.075398
5255,2805,3365,9438825,2,42046,10513,1,334897400,334897400,15766,5255,10511,5255,0,1,5257,298143,0.298143
5655,2805,3365,9438825,2,45246,11313,1,354641400,354641400,16966,5655,11311,5655,0,1,5657,280025,0.280025
6055,2805,3365,9438825,2,48446,12113,1,374385400,374385400,18166,6055,12111,6055,0,1,6057,1650838,1.650838
6455,2805,3365,9438825,2,51646,12913,1,394129400,394129400,19366,6455,12911,6455,0,1,6457,1595498,1.595498
6855,2805,3365,9438825,2,54846,13713,1,413873400,413873400,20566,6855,13711,6855,0,1,6857,1513733,1.513733
44,1703,5555,9460165,2,358,91,1,78236136,78236136,133,44,89,44,0,1,46,175562,0.175562
544,1703,5555,9460165,2,4358,1091,1,107268136,107268136,1633,544,1089,544,0,1,546,806088,0.806088
1044,1703,5555,9460165,2,8358,2091,1,136300136,136300136,3133,1044,2089,1044,0,1,1046,1023532,1.023532
1544,1703,5555,9460165,2,12358,3091,1,165332136,165332136,4633,1544,3089,1544,0,1,1546,1957097,1.957097
2044,1703,5555,9460165,2,16358,4091,1,194364136,194364136,6133,2044,4089,2044,0,1,2046,3789743,3.789743
2544,1703,5555,9460165,2,20358,5091,1,223396136,223396136,7633,2544,5089,2544,0,1,2546,547010,0.54701
3044,1703,5555,9460165,2,24358,6091,1,252428136,252428136,9133,3044,6089,3044,0,1,3046,2093689,2.093689
3544,1703,5555,9460165,2,28358,7091,1,281460136,281460136,10633,3544,7089,3544,0,1,3546,3443488,3.443488
4044,1703,5555,9460165,2,32358,8091,1,310492136,310492136,12133,4044,8089,4044,0,1,4046,1066433,1.066433
4544,1703,5555,9460165,2,36358,9091,1,339524136,339524136,13633,4544,9089,4544,0,1,4546,2473207,2.473207
5044,1703,5555,9460165,2,40358,10091,1,368556136,368556136,15133,5044,10089,5044,0,1,5046,7131253,7.131253
5544,1703,5555,9460165,2,44358,11091,1,397588136,397588136,16633,5544,11089,5544,0,1,5546,57996,0.057996
6044,1703,5555,9460165,2,48358,12091,1,426620136,426620136,18133,6044,12089,6044,0,1,6046,209479,0.209479
6544,1703,5555,9460165,2,52358,13091,1,455652136,455652136,19633,6544,13089,6544,0,1,6546,2218116,2.218116
7044,1703,5555,9460165,2,56358,14091,1,484684136,484684136,21133,7044,14089,7044,0,1,7046,4882874,4.882874
55,6055,1565,9476075,2,446,113,1,79161400,79161400,166,55,111,55,0,1,57,183890,0.18389
455,6055,1565,9476075,2,3646,913,1,103545400,103545400,1366,455,911,455,0,1,457,681764,0.681764
855,6055,1565,9476075,2,6846,1713,1,127929400,127929400,2566,855,1711,855,0,1,857,410756,0.410756
1255,6055,1565,9476075,2,10046,2513,1,152313400,152313400,3766,1255,2511,1255,0,1,1257,2316614,2.316614
1655,6055,1565,9476075,2,13246,3313,1,176697400,176697400,4966,1655,3311,1655,0,1,1657,3035434,3.035434
2055,6055,1565,9476075,2,16446,4113,1,201081400,201081400,6166,2055,4111,2055,0,1,2057,2336764,2.336764
2455,6055,1565,9476075,2,19646,4913,1,225465400,225465400,7366,2455,4911,2455,0,1,2457,4475005,4.475005
2855,6055,1565,9476075,2,22846,5713,1,249849400,249849400,8566,2855,5711,2855,0,1,2857,724381,0.724381
3255,6055,1565,9476075,2,26046,6513,1,274233400,274233400,9766,3255,6511,3255,0,1,3257,388257,0.388257
3655,6055,1565,9476075,2,29246,7313,1,298617400,298617400,10966,3655,7311,3655,0,1,3657,3101558,3.101558
4055,6055,1565,9476075,2,32446,8113,1,323001400,323001400,12166,4055,8111,4055,0,1,4057,574473,0.574473
4455,6055,1565,9476075,2,35646,8913,1,347385400,347385400,13366,4455,8911,4455,0,1,4457,964273,0.964273
4855,6055,1565,9476075,2,38846,9713,1,371769400,371769400,14566,4855,9711,4855,0,1,4857,1115554,1.115554
5255,6055,1565,9476075,2,42046,10513,1,396153400,396153400,15766,5255,10511,5255,0,1,5257,4060113,4.060113
5655,6055,1565,9476075,2,45246,11313,1,420537400,420537400,16966,5655,11311,5655,0,1,5657,3385567,3.385567
6055,6055,1565,9476075,2,48446,12113,1,444921400,444921400,18166,6055,12111,6055,0,1,6057,8530712,8.530712
6455,6055,1565,9476075,2,51646,12913,1,469305400,469305400,19366,6455,12911,6455,0,1,6457,1206004,1.206004
6855,6055,1565,9476075,2,54846,13713,1,493689400,493689400,20566,6855,13711,6855,0,1,6857,3356306,3.356306
44,6103,1555,9490165,2,358,91,1,78616936,78616936,133,44,89,44,0,1,46,36148,0.036148
544,6103,1555,9490165,2,4358,1091,1,109248936,109248936,1633,544,1089,544,0,1,546,99912,0.099912
1044,6103,1555,9490165,2,8358,2091,1,139880936,139880936,3133,1044,2089,1044,0,1,1046,268351,0.268351
1544,6103,1555,9490165,2,12358,3091,1,170512936,170512936,4633,1544,3089,1544,0,1,1546,363032,0.363032
2044,6103,1555,9490165,2,16358,4091,1,201144936,201144936,6133,2044,4089,2044,0,1,2046,2160056,2.160056
2544,6103,1555,9490165,2,20358,5091,1,231776936,231776936,7633,2544,5089,2544,0,1,2546,59666,0.059666
3044,6103,1555,9490165,2,24358,6091,1,262408936,262408936,9133,3044,6089,3044,0,1,3046,742669,0.742669
3544,6103,1555,9490165,2,28358,7091,1,293040936,293040936,10633,3544,7089,3544,0,1,3546,1458630,1.45863
4044,6103,1555,9490165,2,32358,8091,1,323672936,323672936,12133,4044,8089,4044,0,1,4046,1244653,1.244653
4544,6103,1555,9490165,2,36358,9091,1,354304936,354304936,13633,4544,9089,4544,0,1,4546,2898487,2.898487
5044,6103,1555,9490165,2,40358,10091,1,384936936,384936936,15133,5044,10089,5044,0,1,5046,1219002,1.219002
5544,6103,1555,9490165,2,44358,11091,1,415568936,415568936,16633,5544,11089,5544,0,1,5546,3825262,3.825262
6044,6103,1555,9490165,2,48358,12091,1,446200936,446200936,18133,6044,12089,6044,0,1,6046,529481,0.529481
6544,6103,1555,9490165,2,52358,13091,1,476832936,476832936,19633,6544,13089,6544,0,1,6546,1076963,1.076963
7044,6103,1555,9490165,2,56358,14091,1,507464936,507464936,21133,7044,14089,7044,0,1,7046,6171734,6.171734
40,6300,1540,9702000,2,326,83,1,80124800,80124800,121,40,81,40,0,1,42,175002,0.175002
440,6300,1540,9702000,2,3526,883,1,105212800,105212800,1321,440,881,440,0,1,442,876598,0.876598
840,6300,1540,9702000,2,6726,1683,1,130300800,130300800,2521,840,1681,840,0,1,842,1597938,1.597938
1240,6300,1540,9702000,2,9926,2483,1,155388800,155388800,3721,1240,2481,1240,0,1,1242,39794,0.039794
1640,6300,1540,9702000,2,13126,3283,1,180476800,180476800,4921,1640,3281,1640,0,1,1642,27204,0.027204
2040,6300,1540,9702000,2,16326,4083,1,205564800,205564800,6121,2040,4081,2040,0,1,2042,1734150,1.73415
2440,6300,1540,9702000,2,19526,4883,1,230652800,230652800,7321,2440,4881,2440,0,1,2442,2414872,2.414872
2840,6300,1540,9702000,2,22726,5683,1,255740800,255740800,8521,2840,5681,2840,0,1,2842,4833811,4.833811
3240,6300,1540,9702000,2,25926,6483,1,280828800,280828800,9721,3240,6481,3240,0,1,3242,622610,0.62261
3640,6300,1540,9702000,2,29126,7283,1,305916800,305916800,10921,3640,7281,3640,0,1,3642,2525634,2.525634
4040,6300,1540,9702000,2,32326,8083,1,331004800,331004800,12121,4040,8081,4040,0,1,4042,6890023,6.890023
4440,6300,1540,9702000,2,35526,8883,1,356092800,356092800,13321,4440,8881,4440,0,1,4442,4348715,4.348715
4840,6300,1540,9702000,2,38726,9683,1,381180800,381180800,14521,4840,9681,4840,0,1,4842,3344033,3.344033
5240,6300,1540,9702000,2,41926,10483,1,406268800,406268800,15721,5240,10481,5240,0,1,5242,2491124,2.491124
5640,6300,1540,9702000,2,45126,11283,1,431356800,431356800,16921,5640,11281,5640,0,1,5642,6706116,6.706116
6040,6300,1540,9702000,2,48326,12083,1,456444800,456444800,18121,6040,12081,6040,0,1,6042,1251796,1.251796
6440,6300,1540,9702000,2,51526,12883,1,481532800,481532800,19321,6440,12881,6440,0,1,6442,5939438,5.939438
6840,6300,1540,9702000,2,54726,13683,1,506620800,506620800,20521,6840,13681,6840,0,1,6842,9569267,9.569267
40,3550,2740,9727000,2,326,83,1,79828800,79828800,121,40,81,40,0,1,42,180246,0.180246
440,3550,2740,9727000,2,3526,883,1,99956800,99956800,1321,440,881,440,0,1,442,896749,0.896749
840,3550,2740,9727000,2,6726,1683,1,120084800,120084800,2521,840,1681,840,0,1,842,473400,0.4734
1240,3550,2740,9727000,2,9926,2483,1,140212800,140212800,3721,1240,2481,1240,0,1,1242,2385907,2.385907
1640,3550,2740,9727000,2,13126,3283,1,160340800,160340800,4921,1640,3281,1640,0,1,1642,234920,0.23492
2040,3550,2740,9727000,2,16326,4083,1,180468800,180468800,6121,2040,4081,2040,0,1,2042,2316569,2.316569
2440,3550,2740,9727000,2,19526,4883,1,200596800,200596800,7321,2440,4881,2440,0,1,2442,1442848,1.442848
2840,3550,2740,9727000,2,22726,5683,1,220724800,220724800,8521,2840,5681,2840,0,1,2842,541162,0.541162
3240,3550,2740,9727000,2,25926,6483,1,240852800,240852800,9721,3240,6481,3240,0,1,3242,576393,0.576393
3640,3550,2740,9727000,2,29126,7283,1,260980800,260980800,10921,3640,7281,3640,0,1,3642,414698,0.414698
4040,3550,2740,9727000,2,32326,8083,1,281108800,281108800,12121,4040,8081,4040,0,1,4042,689887,0.689887
4440,3550,2740,9727000,2,35526,8883,1,301236800,301236800,13321,4440,8881,4440,0,1,4442,4079494,4.079494
4840,3550,2740,9727000,2,38726,9683,1,321364800,321364800,14521,4840,9681,4840,0,1,4842,4463000,4.463
5240,3550,2740,9727000,2,41926,10483,1,341492800,341492800,15721,5240,10481,5240,0,1,5242,621336,0.621336
5640,3550,2740,9727000,2,45126,11283,1,361620800,361620800,16921,5640,11281,5640,0,1,5642,3815966,3.815966
6040,3550,2740,9727000,2,48326,12083,1,381748800,381748800,18121,6040,12081,6040,0,1,6042,3793973,3.793973
6440,3550,2740,9727000,2,51526,12883,1,401876800,401876800,19321,6440,12881,6440,0,1,6442,2630966,2.630966
6840,3550,2740,9727000,2,54726,13683,1,422004800,422004800,20521,6840,13681,6840,0,1,6842,1424574,1.424574
40,4550,2140,9737000,2,326,83,1,80036800,80036800,121,40,81,40,0,1,42,176199,0.176199
440,4550,2140,9737000,2,3526,883,1,101444800,101444800,1321,440,881,440,0,1,442,877406,0.877406
840,4550,2140,9737000,2,6726,1683,1,122852800,122852800,2521,840,1681,840,0,1,842,938279,0.938279
1240,4550,2140,9737000,2,9926,2483,1,144260800,144260800,3721,1240,2481,1240,0,1,1242,1779063,1.779063
1640,4550,2140,9737000,2,13126,3283,1,165668800,165668800,4921,1640,3281,1640,0,1,1642,279269,0.279269
2040,4550,2140,9737000,2,16326,4083,1,187076800,187076800,6121,2040,4081,2040,0,1,2042,1154426,1.154426
2440,4550,2140,9737000,2,19526,4883,1,208484800,208484800,7321,2440,4881,2440,0,1,2442,4458968,4.458968
2840,4550,2140,9737000,2,22726,5683,1,229892800,229892800,8521,2840,5681,2840,0,1,2842,3727826,3.727826
3240,4550,2140,9737000,2,25926,6483,1,251300800,251300800,9721,3240,6481,3240,0,1,3242,570410,0.57041
3640,4550,2140,9737000,2,29126,7283,1,272708800,272708800,10921,3640,7281,3640,0,1,3642,1271918,1.271918
4040,4550,2140,9737000,2,32326,8083,1,294116800,294116800,12121,4040,8081,4040,0,1,4042,7388980,7.38898
4440,4550,2140,9737000,2,35526,8883,1,315524800,315524800,13321,4440,8881,4440,0,1,4442,2338233,2.338233
4840,4550,2140,9737000,2,38726,9683,1,336932800,336932800,14521,4840,9681,4840,0,1,4842,3245944,3.245944
5240,4550,2140,9737000,2,41926,10483,1,358340800,358340800,15721,5240,10481,5240,0,1,5242,3936849,3.936849
5640,4550,2140,9737000,2,45126,11283,1,379748800,379748800,16921,5640,11281,5640,0,1,5642,4310516,4.310516
6040,4550,2140,9737000,2,48326,12083,1,401156800,401156800,18121,6040,12081,6040,0,1,6042,2581396,2.581396
6440,4550,2140,9737000,2,51526,12883,1,422564800,422564800,19321,6440,12881,6440,0,1,6442,161714,0.161714
6840,4550,2140,9737000,2,54726,13683,1,443972800,443972800,20521,6840,13681,6840,0,1,6842,904462,0.904462
40,2300,4240,9752000,2,326,83,1,80108800,80108800,121,40,81,40,0,1,42,181707,0.181707
440,2300,4240,9752000,2,3526,883,1,101036800,101036800,1321,440,881,440,0,1,442,751974,0.751974
840,2300,4240,9752000,2,6726,1683,1,121964800,121964800,2521,840,1681,840,0,1,842,1573254,1.573254
1240,2300,4240,9752000,2,9926,2483,1,142892800,142892800,3721,1240,2481,1240,0,1,1242,611005,0.611005
1640,2300,4240,9752000,2,13126,3283,1,163820800,163820800,4921,1640,3281,1640,0,1,1642,676790,0.67679
2040,2300,4240,9752000,2,16326,4083,1,184748800,184748800,6121,2040,4081,2040,0,1,2042,2831436,2.831436
2440,2300,4240,9752000,2,19526,4883,1,205676800,205676800,7321,2440,4881,2440,0,1,2442,4405770,4.40577
2840,2300,4240,9752000,2,22726,5683,1,226604800,226604800,8521,2840,5681,2840,0,1,2842,2642363,2.642363
3240,2300,4240,9752000,2,25926,6483,1,247532800,247532800,9721,3240,6481,3240,0,1,3242,429798,0.429798
3640,2300,4240,9752000,2,29126,7283,1,268460800,268460800,10921,3640,7281,3640,0,1,3642,4377864,4.377864
4040,2300,4240,9752000,2,32326,8083,1,289388800,289388800,12121,4040,8081,4040,0,1,4042,1455278,1.455278
4440,2300,4240,9752000,2,35526,8883,1,310316800,310316800,13321,4440,8881,4440,0,1,4442,1250003,1.250003
4840,2300,4240,9752000,2,38726,9683,1,331244800,331244800,14521,4840,9681,4840,0,1,4842,649417,0.649417
5240,2300,4240,9752000,2,41926,10483,1,352172800,352172800,15721,5240,10481,5240,0,1,5242,4910293,4.910293
5640,2300,4240,9752000,2,45126,11283,1,373100800,373100800,16921,5640,11281,5640,0,1,5642,30771,0.030771
6040,2300,4240,9752000,2,48326,12083,1,394028800,394028800,18121,6040,12081,6040,0,1,6042,556458,0.556458
6440,2300,4240,9752000,2,51526,12883,1,414956800,414956800,19321,6440,12881,6440,0,1,6442,1205764,1.205764
6840,2300,4240,9752000,2,54726,13683,1,435884800,435884800,20521,6840,13681,6840,0,1,6842,2691104,2.691104
40,5300,1840,9752000,2,326,83,1,80300800,80300800,121,40,81,40,0,1,42,170700,0.1707
440,5300,1840,9752000,2,3526,883,1,103148800,103148800,1321,440,881,440,0,1,442,884702,0.884702
840,5300,1840,9752000,2,6726,1683,1,125996800,125996800,2521,840,1681,840,0,1,842,1609165,1.609165
1240,5300,1840,9752000,2,9926,2483,1,148844800,148844800,3721,1240,2481,1240,0,1,1242,136174,0.136174
1640,5300,1840,9752000,2,13126,3283,1,171692800,171692800,4921,1640,3281,1640,0,1,1642,364877,0.364877
2040,5300,1840,9752000,2,16326,4083,1,194540800,194540800,6121,2040,4081,2040,0,1,2042,3824273,3.824273
2440,5300,1840,9752000,2,19526,4883,1,217388800,217388800,7321,2440,4881,2440,0,1,2442,140134,0.140134
2840,5300,1840,9752000,2,22726,5683,1,240236800,240236800,8521,2840,5681,2840,0,1,2842,5271449,5.271449
3240,5300,1840,9752000,2,25926,6483,1,263084800,263084800,9721,3240,6481,3240,0,1,3242,5988491,5.988491
3640,5300,1840,9752000,2,29126,7283,1,285932800,285932800,10921,3640,7281,3640,0,1,3642,1356750,1.35675
4040,5300,1840,9752000,2,32326,8083,1,308780800,308780800,12121,4040,8081,4040,0,1,4042,128668,0.128668
4440,5300,1840,9752000,2,35526,8883,1,331628800,331628800,13321,4440,8881,4440,0,1,4442,1177306,1.177306
4840,5300,1840,9752000,2,38726,9683,1,354476800,354476800,14521,4840,9681,4840,0,1,4842,1764591,1.764591
5240,5300,1840,9752000,2,41926,10483,1,377324800,377324800,15721,5240,10481,5240,0,1,5242,5611305,5.611305
5640,5300,1840,9752000,2,45126,11283,1,400172800,400172800,16921,5640,11281,5640,0,1,5642,2365526,2.365526
6040,5300,1840,9752000,2,48326,12083,1,423020800,423020800,18121,6040,12081,6040,0,1,6042,669081,0.669081
6440,5300,1840,9752000,2,51526,12883,1,445868800,445868800,19321,6440,12881,6440,0,1,6442,7108881,7.108881
6840,5300,1840,9752000,2,54726,13683,1,468716800,468716800,20521,6840,13681,6840,0,1,6842,2340103,2.340103
40,1800,5440,9792000,2,326,83,1,80652800,80652800,121,40,81,40,0,1,42,180989,0.180989
440,1800,5440,9792000,2,3526,883,1,103820800,103820800,1321,440,881,440,0,1,442,695525,0.695525
840,1800,5440,9792000,2,6726,1683,1,126988800,126988800,2521,840,1681,840,0,1,842,187159,0.187159
1240,1800,5440,9792000,2,9926,2483,1,150156800,150156800,3721,1240,2481,1240,0,1,1242,1085323,1.085323
1640,1800,5440,9792000,2,13126,3283,1,173324800,173324800,4921,1640,3281,1640,0,1,1642,2723884,2.723884
2040,1800,5440,9792000,2,16326,4083,1,196492800,196492800,6121,2040,4081,2040,0,1,2042,686753,0.686753
2440,1800,5440,9792000,2,19526,4883,1,219660800,219660800,7321,2440,4881,2440,0,1,2442,1707098,1.707098
2840,1800,5440,9792000,2,22726,5683,1,242828800,242828800,8521,2840,5681,2840,0,1,2842,1157736,1.157736
3240,1800,5440,9792000,2,25926,6483,1,265996800,265996800,9721,3240,6481,3240,0,1,3242,1138172,1.138172
3640,1800,5440,9792000,2,29126,7283,1,289164800,289164800,10921,3640,7281,3640,0,1,3642,2036970,2.03697
4040,1800,5440,9792000,2,32326,8083,1,312332800,312332800,12121,4040,8081,4040,0,1,4042,3941531,3.941531
4440,1800,5440,9792000,2,35526,8883,1,335500800,335500800,13321,4440,8881,4440,0,1,4442,1392740,1.39274
4840,1800,5440,9792000,2,38726,9683,1,358668800,358668800,14521,4840,9681,4840,0,1,4842,864105,0.864105
5240,1800,5440,9792000,2,41926,10483,1,381836800,381836800,15721,5240,10481,5240,0,1,5242,4125695,4.125695
5640,1800,5440,9792000,2,45126,11283,1,405004800,405004800,16921,5640,11281,5640,0,1,5642,616464,0.616464
6040,1800,5440,9792000,2,48326,12083,1,428172800,428172800,18121,6040,12081,6040,0,1,6042,7734997,7.734997
6440,1800,5440,9792000,2,51526,12883,1,451340800,451340800,19321,6440,12881,6440,0,1,6442,2205736,2.205736
6840,1800,5440,9792000,2,54726,13683,1,474508800,474508800,20521,6840,13681,6840,0,1,6842,1456904,1.456904
40,1550,6340,9827000,2,326,83,1,81140800,81140800,121,40,81,40,0,1,42,178254,0.178254
440,1550,6340,9827000,2,3526,883,1,106388800,106388800,1321,440,881,440,0,1,442,908460,0.90846
840,1550,6340,9827000,2,6726,1683,1,131636800,131636800,2521,840,1681,840,0,1,842,676907,0.676907
1240,1550,6340,9827000,2,9926,2483,1,156884800,156884800,3721,1240,2481,1240,0,1,1242,1882492,1.882492
1640,1550,6340,9827000,2,13126,3283,1,182132800,182132800,4921,1640,3281,1640,0,1,1642,49996,0.049996
2040,1550,6340,9827000,2,16326,4083,1,207380800,207380800,6121,2040,4081,2040,0,1,2042,413348,0.413348
2440,1550,6340,9827000,2,19526,4883,1,232628800,232628800,7321,2440,4881,2440,0,1,2442,441286,0.441286
2840,1550,6340,9827000,2,22726,5683,1,257876800,257876800,8521,2840,5681,2840,0,1,2842,798674,0.798674
3240,1550,6340,9827000,2,25926,6483,1,283124800,283124800,9721,3240,6481,3240,0,1,3242,3416841,3.416841
3640,1550,6340,9827000,2,29126,7283,1,308372800,308372800,10921,3640,7281,3640,0,1,3642,1384921,1.384921
4040,1550,6340,9827000,2,32326,8083,1,333620800,333620800,12121,4040,8081,4040,0,1,4042,3464141,3.464141
4440,1550,6340,9827000,2,35526,8883,1,358868800,358868800,13321,4440,8881,4440,0,1,4442,1333115,1.333115
4840,1550,6340,9827000,2,38726,9683,1,384116800,384116800,14521,4840,9681,4840,0,1,4842,3246669,3.246669
5240,1550,6340,9827000,2,41926,10483,1,409364800,409364800,15721,5240,10481,5240,0,1,5242,1043955,1.043955
5640,1550,6340,9827000,2,45126,11283,1,434612800,434612800,16921,5640,11281,5640,0,1,5642,3613451,3.613451
6040,1550,6340,9827000,2,48326,12083,1,459860800,459860800,18121,6040,12081,6040,0,1,6042,1286758,1.286758
6440,1550,6340,9827000,2,51526,12883,1,485108800,485108800,19321,6440,12881,6440,0,1,6442,85994,0.085994
6840,1550,6340,9827000,2,54726,13683,1,510356800,510356800,20521,6840,13681,6840,0,1,6842,151605,0.151605
55,3555,2765,9829575,2,446,113,1,81417400,81417400,166,55,111,55,0,1,57,203871,0.203871
455,3555,2765,9829575,2,3646,913,1,101641400,101641400,1366,455,911,455,0,1,457,944724,0.944724
855,3555,2765,9829575,2,6846,1713,1,121865400,121865400,2566,855,1711,855,0,1,857,515479,0.515479
1255,3555,2765,9829575,2,10046,2513,1,142089400,142089400,3766,1255,2511,1255,0,1,1257,522363,0.522363
1655,3555,2765,9829575,2,13246,3313,1,162313400,162313400,4966,1655,3311,1655,0,1,1657,3207489,3.207489
2055,3555,2765,9829575,2,16446,4113,1,182537400,182537400,6166,2055,4111,2055,0,1,2057,1524029,1.524029
2455,3555,2765,9829575,2,19646,4913,1,202761400,202761400,7366,2455,4911,2455,0,1,2457,217856,0.217856
2855,3555,2765,9829575,2,22846,5713,1,222985400,222985400,8566,2855,5711,2855,0,1,2857,1465169,1.465169
3255,3555,2765,9829575,2,26046,6513,1,243209400,243209400,9766,3255,6511,3255,0,1,3257,1393250,1.39325
3655,3555,2765,9829575,2,29246,7313,1,263433400,263433400,10966,3655,7311,3655,0,1,3657,5525117,5.525117
4055,3555,2765,9829575,2,32446,8113,1,283657400,283657400,12166,4055,8111,4055,0,1,4057,239563,0.239563
4455,3555,2765,9829575,2,35646,8913,1,303881400,303881400,13366,4455,8911,4455,0,1,4457,2212513,2.212513
4855,3555,2765,9829575,2,38846,9713,1,324105400,324105400,14566,4855,9711,4855,0,1,4857,8056561,8.056561
5255,3555,2765,9829575,2,42046,10513,1,344329400,344329400,15766,5255,10511,5255,0,1,5257,1366268,1.366268
5655,3555,2765,9829575,2,45246,11313,1,364553400,364553400,16966,5655,11311,5655,0,1,5657,4267951,4.267951
6055,3555,2765,9829575,2,48446,12113,1,384777400,384777400,18166,6055,12111,6055,0,1,6057,7054663,7.054663
6455,3555,2765,9829575,2,51646,12913,1,405001400,405001400,19366,6455,12911,6455,0,1,6457,9370622,9.370622
6855,3555,2765,9829575,2,54846,13713,1,425225400,425225400,20566,6855,13711,6855,0,1,6857,2271298,2.271298
55,2305,4265,9830825,2,446,113,1,81537400,81537400,166,55,111,55,0,1,57,198376,0.198376
455,2305,4265,9830825,2,3646,913,1,102561400,102561400,1366,455,911,455,0,1,457,906264,0.906264
855,2305,4265,9830825,2,6846,1713,1,123585400,123585400,2566,855,1711,855,0,1,857,1629824,1.629824
1255,2305,4265,9830825,2,10046,2513,1,144609400,144609400,3766,1255,2511,1255,0,1,1257,2355276,2.355276
1655,2305,4265,9830825,2,13246,3313,1,165633400,165633400,4966,1655,3311,1655,0,1,1657,816266,0.816266
2055,2305,4265,9830825,2,16446,4113,1,186657400,186657400,6166,2055,4111,2055,0,1,2057,3477880,3.47788
2455,2305,4265,9830825,2,19646,4913,1,207681400,207681400,7366,2455,4911,2455,0,1,2457,1582068,1.582068
2855,2305,4265,9830825,2,22846,5713,1,228705400,228705400,8566,2855,5711,2855,0,1,2857,5279680,5.27968
3255,2305,4265,9830825,2,26046,6513,1,249729400,249729400,9766,3255,6511,3255,0,1,3257,242397,0.242397
3655,2305,4265,9830825,2,29246,7313,1,270753400,270753400,10966,3655,7311,3655,0,1,3657,1005225,1.005225
4055,2305,4265,9830825,2,32446,8113,1,291777400,291777400,12166,4055,8111,4055,0,1,4057,699337,0.699337
4455,2305,4265,9830825,2,35646,8913,1,312801400,312801400,13366,4455,8911,4455,0,1,4457,845505,0.845505
4855,2305,4265,9830825,2,38846,9713,1,333825400,333825400,14566,4855,9711,4855,0,1,4857,2289520,2.28952
5255,2305,4265,9830825,2,42046,10513,1,354849400,354849400,15766,5255,10511,5255,0,1,5257,3218557,3.218557
5655,2305,4265,9830825,2,45246,11313,1,375873400,375873400,16966,5655,11311,5655,0,1,5657,6342446,6.342446
6055,2305,4265,9830825,2,48446,12113,1,396897400,396897400,18166,6055,12111,6055,0,1,6057,491192,0.491192
6455,2305,4265,9830825,2,51646,12913,1,417921400,417921400,19366,6455,12911,6455,0,1,6457,2218040,2.21804
6855,2305,4265,9830825,2,54846,13713,1,438945400,438945400,20566,6855,13711,6855,0,1,6857,566014,0.566014
55,4555,2165,9861575,2,446,113,1,81849400,81849400,166,55,111,55,0,1,57,202107,0.202107
455,4555,2165,9861575,2,3646,913,1,103353400,103353400,1366,455,911,455,0,1,457,923717,0.923717
855,4555,2165,9861575,2,6846,1713,1,124857400,124857400,2566,855,1711,855,0,1,857,1656698,1.656698
1255,4555,2165,9861575,2,10046,2513,1,146361400,146361400,3766,1255,2511,1255,0,1,1257,1815018,1.815018
1655,4555,2165,9861575,2,13246,3313,1,167865400,167865400,4966,1655,3311,1655,0,1,1657,3126671,3.126671
2055,4555,2165,9861575,2,16446,4113,1,189369400,189369400,6166,2055,4111,2055,0,1,2057,256307,0.256307
2455,4555,2165,9861575,2,19646,4913,1,210873400,210873400,7366,2455,4911,2455,0,1,2457,3005938,3.005938
2855,4555,2165,9861575,2,22846,5713,1,232377400,232377400,8566,2855,5711,2855,0,1,2857,4051249,4.051249
3255,4555,2165,9861575,2,26046,6513,1,253881400,253881400,9766,3255,6511,3255,0,1,3257,2160904,2.160904
3655,4555,2165,9861575,2,29246,7313,1,275385400,275385400,10966,3655,7311,3655,0,1,3657,4832987,4.832987
4055,4555,2165,9861575,2,32446,8113,1,296889400,296889400,12166,4055,8111,4055,0,1,4057,3037495,3.037495
4455,4555,2165,9861575,2,35646,8913,1,318393400,318393400,13366,4455,8911,4455,0,1,4457,2767852,2.767852
4855,4555,2165,9861575,2,38846,9713,1,339897400,339897400,14566,4855,9711,4855,0,1,4857,615874,0.615874
5255,4555,2165,9861575,2,42046,10513,1,361401400,361401400,15766,5255,10511,5255,0,1,5257,422724,0.422724
5655,4555,2165,9861575,2,45246,11313,1,382905400,382905400,16966,5655,11311,5655,0,1,5657,966856,0.966856
6055,4555,2165,9861575,2,48446,12113,1,404409400,404409400,18166,6055,12111,6055,0,1,6057,848911,0.848911
6455,4555,2165,9861575,2,51646,12913,1,425913400,425913400,19366,6455,12911,6455,0,1,6457,3176521,3.176521
6855,4555,2165,9861575,2,54846,13713,1,447417400,447417400,20566,6855,13711,6855,0,1,6857,3249115,3.249115
55,1805,5465,9864325,2,446,113,1,82113400,82113400,166,55,111,55,0,1,57,10267,0.010267
455,1805,5465,9864325,2,3646,913,1,105377400,105377400,1366,455,911,455,0,1,457,277542,0.277542
855,1805,5465,9864325,2,6846,1713,1,128641400,128641400,2566,855,1711,855,0,1,857,440549,0.440549
1255,1805,5465,9864325,2,10046,2513,1,151905400,151905400,3766,1255,2511,1255,0,1,1257,1361686,1.361686
1655,1805,5465,9864325,2,13246,3313,1,175169400,175169400,4966,1655,3311,1655,0,1,1657,3227746,3.227746
2055,1805,5465,9864325,2,16446,4113,1,198433400,198433400,6166,2055,4111,2055,0,1,2057,2140379,2.140379
2455,1805,5465,9864325,2,19646,4913,1,221697400,221697400,7366,2455,4911,2455,0,1,2457,2805730,2.80573
2855,1805,5465,9864325,2,22846,5713,1,244961400,244961400,8566,2855,5711,2855,0,1,2857,1526172,1.526172
3255,1805,5465,9864325,2,26046,6513,1,268225400,268225400,9766,3255,6511,3255,0,1,3257,1562087,1.562087
3655,1805,5465,9864325,2,29246,7313,1,291489400,291489400,10966,3655,7311,3655,0,1,3657,684789,0.684789
4055,1805,5465,9864325,2,32446,8113,1,314753400,314753400,12166,4055,8111,4055,0,1,4057,1971765,1.971765
4455,1805,5465,9864325,2,35646,8913,1,338017400,338017400,13366,4455,8911,4455,0,1,4457,199848,0.199848
4855,1805,5465,9864325,2,38846,9713,1,361281400,361281400,14566,4855,9711,4855,0,1,4857,2334944,2.334944
5255,1805,5465,9864325,2,42046,10513,1,384545400,384545400,15766,5255,10511,5255,0,1,5257,2563947,2.563947
5655,1805,5465,9864325,2,45246,11313,1,407809400,407809400,16966,5655,11311,5655,0,1,5657,688685,0.688685
6055,1805,5465,9864325,2,48446,12113,1,431073400,431073400,18166,6055,12111,6055,0,1,6057,1364455,1.364455
6455,1805,5465,9864325,2,51646,12913,1,454337400,454337400,19366,6455,12911,6455,0,1,6457,3052135,3.052135
6855,1805,5465,9864325,2,54846,13713,1,477601400,477601400,20566,6855,13711,6855,0,1,6857,4063637,4.063637
55,6305,1565,9867325,2,446,113,1,82401400,82401400,166,55,111,55,0,1,57,199407,0.199407
455,6305,1565,9867325,2,3646,913,1,107585400,107585400,1366,455,911,455,0,1,457,929852,0.929852
855,6305,1565,9867325,2,6846,1713,1,132769400,132769400,2566,855,1711,855,0,1,857,1673702,1.673702
1255,6305,1565,9867325,2,10046,2513,1,157953400,157953400,3766,1255,2511,1255,0,1,1257,2420066,2.420066
1655,6305,1565,9867325,2,13246,3313,1,183137400,183137400,4966,1655,3311,1655,0,1,1657,2334756,2.334756
2055,6305,1565,9867325,2,16446,4113,1,208321400,208321400,6166,2055,4111,2055,0,1,2057,664561,0.664561
2455,6305,1565,9867325,2,19646,4913,1,233505400,233505400,7366,2455,4911,2455,0,1,2457,3759750,3.75975
2855,6305,1565,9867325,2,22846,5713,1,258689400,258689400,8566,2855,5711,2855,0,1,2857,416427,0.416427
3255,6305,1565,9867325,2,26046,6513,1,283873400,283873400,9766,3255,6511,3255,0,1,3257,2074472,2.074472
3655,6305,1565,9867325,2,29246,7313,1,309057400,309057400,10966,3655,7311,3655,0,1,3657,6917361,6.917361
4055,6305,1565,9867325,2,32446,8113,1,334241400,334241400,12166,4055,8111,4055,0,1,4057,5434633,5.434633
4455,6305,1565,9867325,2,35646,8913,1,359425400,359425400,13366,4455,8911,4455,0,1,4457,105141,0.105141
4855,6305,1565,9867325,2,38846,9713,1,384609400,384609400,14566,4855,9711,4855,0,1,4857,506643,0.506643
5255,6305,1565,9867325,2,42046,10513,1,409793400,409793400,15766,5255,10511,5255,0,1,5257,9969930,9.96993
5655,6305,1565,9867325,2,45246,11313,1,434977400,434977400,16966,5655,11311,5655,0,1,5657,10427614,10.427614
6055,6305,1565,9867325,2,48446,12113,1,460161400,460161400,18166,6055,12111,6055,0,1,6057,1678279,1.678279
6455,6305,1565,9867325,2,51646,12913,1,485345400,485345400,19366,6455,12911,6455,0,1,6457,2915878,2.915878
6855,6305,1565,9867325,2,54846,13713,1,510529400,510529400,20566,6855,13711,6855,0,1,6857,8139848,8.139848
40,4050,2440,9882000,2,326,83,1,81132800,81132800,121,40,81,40,0,1,42,7198,0.007198
440,4050,2440,9882000,2,3526,883,1,101900800,101900800,1321,440,881,440,0,1,442,12553,0.012553
840,4050,2440,9882000,2,6726,1683,1,122668800,122668800,2521,840,1681,840,0,1,842,156806,0.156806
1240,4050,2440,9882000,2,9926,2483,1,143436800,143436800,3721,1240,2481,1240,0,1,1242,34805,0.034805
1640,4050,2440,9882000,2,13126,3283,1,164204800,164204800,4921,1640,3281,1640,0,1,1642,810149,0.810149
2040,4050,2440,9882000,2,16326,4083,1,184972800,184972800,6121,2040,4081,2040,0,1,2042,439494,0.439494
2440,4050,2440,9882000,2,19526,4883,1,205740800,205740800,7321,2440,4881,2440,0,1,2442,250930,0.25093
2840,4050,2440,9882000,2,22726,5683,1,226508800,226508800,8521,2840,5681,2840,0,1,2842,500334,0.500334
3240,4050,2440,9882000,2,25926,6483,1,247276800,247276800,9721,3240,6481,3240,0,1,3242,173965,0.173965
3640,4050,2440,9882000,2,29126,7283,1,268044800,268044800,10921,3640,7281,3640,0,1,3642,612799,0.612799
4040,4050,2440,9882000,2,32326,8083,1,288812800,288812800,12121,4040,8081,4040,0,1,4042,314284,0.314284
4440,4050,2440,9882000,2,35526,8883,1,309580800,309580800,13321,4440,8881,4440,0,1,4442,357509,0.357509
4840,4050,2440,9882000,2,38726,9683,1,330348800,330348800,14521,4840,9681,4840,0,1,4842,1815605,1.815605
5240,4050,2440,9882000,2,41926,10483,1,351116800,351116800,15721,5240,10481,5240,0,1,5242,646705,0.646705
5640,4050,2440,9882000,2,45126,11283,1,371884800,371884800,16921,5640,11281,5640,0,1,5642,603377,0.603377
6040,4050,2440,9882000,2,48326,12083,1,392652800,392652800,18121,6040,12081,6040,0,1,6042,940780,0.94078
6440,4050,2440,9882000,2,51526,12883,1,413420800,413420800,19321,6440,12881,6440,0,1,6442,110275,0.110275
6840,4050,2440,9882000,2,54726,13683,1,434188800,434188800,20521,6840,13681,6840,0,1,6842,1736806,1.736806
39,2793,3541,9890013,2,318,81,1,81096312,81096312,118,39,79,39,0,1,41,184365,0.184365
539,2793,3541,9890013,2,4318,1081,1,106432312,106432312,1618,539,1079,539,0,1,541,1083672,1.083672
1039,2793,3541,9890013,2,8318,2081,1,131768312,131768312,3118,1039,2079,1039,0,1,1041,1063846,1.063846
1539,2793,3541,9890013,2,12318,3081,1,157104312,157104312,4618,1539,3079,1539,0,1,1541,2081765,2.081765
2039,2793,3541,9890013,2,16318,4081,1,182440312,182440312,6118,2039,4079,2039,0,1,2041,505549,0.505549
2539,2793,3541,9890013,2,20318,5081,1,207776312,207776312,7618,2539,5079,2539,0,1,2541,920672,0.920672
3039,2793,3541,9890013,2,24318,6081,1,233112312,233112312,9118,3039,6079,3039,0,1,3041,872499,0.872499
3539,2793,3541,9890013,2,28318,7081,1,258448312,258448312,10618,3539,7079,3539,0,1,3541,3617115,3.617115
4039,2793,3541,9890013,2,32318,8081,1,283784312,283784312,12118,4039,8079,4039,0,1,4041,427895,0.427895
4539,2793,3541,9890013,2,36318,9081,1,309120312,309120312,13618,4539,9079,4539,0,1,4541,2392732,2.392732
5039,2793,3541,9890013,2,40318,10081,1,334456312,334456312,15118,5039,10079,5039,0,1,5041,2725512,2.725512
5539,2793,3541,9890013,2,44318,11081,1,359792312,359792312,16618,5539,11079,5539,0,1,5541,8927368,8.927368
6039,2793,3541,9890013,2,48318,12081,1,385128312,385128312,18118,6039,12079,6039,0,1,6041,2201416,2.201416
6539,2793,3541,9890013,2,52318,13081,1,410464312,410464312,19618,6539,13079,6539,0,1,6541,1157506,1.157506
7039,2793,3541,9890013,2,56318,14081,1,435800312,435800312,21118,7039,14079,7039,0,1,7041,802293,0.802293
39,3893,2541,9892113,2,318,81,1,81144312,81144312,118,39,79,39,0,1,41,178744,0.178744
539,3893,2541,9892113,2,4318,1081,1,106880312,106880312,1618,539,1079,539,0,1,541,1107106,1.107106
1039,3893,2541,9892113,2,8318,2081,1,132616312,132616312,3118,1039,2079,1039,0,1,1041,2073008,2.073008
1539,3893,2541,9892113,2,12318,3081,1,158352312,158352312,4618,1539,3079,1539,0,1,1541,3030498,3.030498
2039,3893,2541,9892113,2,16318,4081,1,184088312,184088312,6118,2039,4079,2039,0,1,2041,3989958,3.989958
2539,3893,2541,9892113,2,20318,5081,1,209824312,209824312,7618,2539,5079,2539,0,1,2541,1613153,1.613153
3039,3893,2541,9892113,2,24318,6081,1,235560312,235560312,9118,3039,6079,3039,0,1,3041,3671297,3.671297
3539,3893,2541,9892113,2,28318,7081,1,261296312,261296312,10618,3539,7079,3539,0,1,3541,6692164,6.692164
4039,3893,2541,9892113,2,32318,8081,1,287032312,287032312,12118,4039,8079,4039,0,1,4041,740861,0.740861
4539,3893,2541,9892113,2,36318,9081,1,312768312,312768312,13618,4539,9079,4539,0,1,4541,5114497,5.114497
5039,3893,2541,9892113,2,40318,10081,1,338504312,338504312,15118,5039,10079,5039,0,1,5041,9787836,9.787836
5539,3893,2541,9892113,2,44318,11081,1,364240312,364240312,16618,5539,11079,5539,0,1,5541,9708020,9.70802
6039,3893,2541,9892113,2,48318,12081,1,389976312,389976312,18118,6039,12079,6039,0,1,6041,6070898,6.070898
6539,3893,2541,9892113,2,52318,13081,1,415712312,415712312,19618,6539,13079,6539,0,1,6541,9531516,9.531516
7039,3893,2541,9892113,2,56318,14081,1,441448312,441448312,21118,7039,14079,7039,0,1,7041,13673902,13.673902
55,5305,1865,9893825,2,446,113,1,82305400,82305400,166,55,111,55,0,1,57,196106,0.196106
455,5305,1865,9893825,2,3646,913,1,105249400,105249400,1366,455,911,455,0,1,457,939881,0.939881
855,5305,1865,9893825,2,6846,1713,1,128193400,128193400,2566,855,1711,855,0,1,857,1013465,1.013465
1255,5305,1865,9893825,2,10046,2513,1,151137400,151137400,3766,1255,2511,1255,0,1,1257,248399,0.248399
1655,5305,1865,9893825,2,13246,3313,1,174081400,174081400,4966,1655,3311,1655,0,1,1657,1704817,1.704817
2055,5305,1865,9893825,2,16446,4113,1,197025400,197025400,6166,2055,4111,2055,0,1,2057,1977362,1.977362
2455,5305,1865,9893825,2,19646,4913,1,219969400,219969400,7366,2455,4911,2455,0,1,2457,721415,0.721415
2855,5305,1865,9893825,2,22846,5713,1,242913400,242913400,8566,2855,5711,2855,0,1,2857,3282290,3.28229
3255,5305,1865,9893825,2,26046,6513,1,265857400,265857400,9766,3255,6511,3255,0,1,3257,6995,0.006995
3655,5305,1865,9893825,2,29246,7313,1,288801400,288801400,10966,3655,7311,3655,0,1,3657,6974129,6.974129
4055,5305,1865,9893825,2,32446,8113,1,311745400,311745400,12166,4055,8111,4055,0,1,4057,1461490,1.46149
4455,5305,1865,9893825,2,35646,8913,1,334689400,334689400,13366,4455,8911,4455,0,1,4457,168610,0.16861
4855,5305,1865,9893825,2,38846,9713,1,357633400,357633400,14566,4855,9711,4855,0,1,4857,1179361,1.179361
5255,5305,1865,9893825,2,42046,10513,1,380577400,380577400,15766,5255,10511,5255,0,1,5257,3686478,3.686478
5655,5305,1865,9893825,2,45246,11313,1,403521400,403521400,16966,5655,11311,5655,0,1,5657,2930202,2.930202
6055,5305,1865,9893825,2,48446,12113,1,426465400,426465400,18166,6055,12111,6055,0,1,6057,3284356,3.284356
6455,5305,1865,9893825,2,51646,12913,1,449409400,449409400,19366,6455,12911,6455,0,1,6457,776251,0.776251
6855,5305,1865,9893825,2,54846,13713,1,472353400,472353400,20566,6855,13711,6855,0,1,6857,1927844,1.927844
55,1555,6365,9897575,2,446,113,1,82665400,82665400,166,55,111,55,0,1,57,149421,0.149421
455,1555,6365,9897575,2,3646,913,1,108009400,108009400,1366,455,911,455,0,1,457,955557,0.955557
855,1555,6365,9897575,2,6846,1713,1,133353400,133353400,2566,855,1711,855,0,1,857,473572,0.473572
1255,1555,6365,9897575,2,10046,2513,1,158697400,158697400,3766,1255,2511,1255,0,1,1257,2458323,2.458323
1655,1555,6365,9897575,2,13246,3313,1,184041400,184041400,4966,1655,3311,1655,0,1,1657,3233905,3.233905
2055,1555,6365,9897575,2,16446,4113,1,209385400,209385400,6166,2055,4111,2055,0,1,2057,1599574,1.599574
2455,1555,6365,9897575,2,19646,4913,1,234729400,234729400,7366,2455,4911,2455,0,1,2457,1271170,1.27117
2855,1555,6365,9897575,2,22846,5713,1,260073400,260073400,8566,2855,5711,2855,0,1,2857,305640,0.30564
3255,1555,6365,9897575,2,26046,6513,1,285417400,285417400,9766,3255,6511,3255,0,1,3257,645353,0.645353
3655,1555,6365,9897575,2,29246,7313,1,310761400,310761400,10966,3655,7311,3655,0,1,3657,996329,0.996329
4055,1555,6365,9897575,2,32446,8113,1,336105400,336105400,12166,4055,8111,4055,0,1,4057,858366,0.858366
4455,1555,6365,9897575,2,35646,8913,1,361449400,361449400,13366,4455,8911,4455,0,1,4457,2533856,2.533856
4855,1555,6365,9897575,2,38846,9713,1,386793400,386793400,14566,4855,9711,4855,0,1,4857,2715432,2.715432
5255,1555,6365,9897575,2,42046,10513,1,412137400,412137400,15766,5255,10511,5255,0,1,5257,1438958,1.438958
5655,1555,6365,9897575,2,45246,11313,1,437481400,437481400,16966,5655,11311,5655,0,1,5657,2378283,2.378283
6055,1555,6365,9897575,2,48446,12113,1,462825400,462825400,18166,6055,12111,6055,0,1,6057,1031680,1.03168
6455,1555,6365,9897575,2,51646,12913,1,488169400,488169400,19366,6455,12911,6455,0,1,6457,1594047,1.594047
6855,1555,6365,9897575,2,54846,13713,1,513513400,513513400,20566,6855,13711,6855,0,1,6857,5852228,5.852228
40,2050,4840,9922000,2,326,83,1,81580800,81580800,121,40,81,40,0,1,42,33454,0.033454
440,2050,4840,9922000,2,3526,883,1,103628800,103628800,1321,440,881,440,0,1,442,33268,0.033268
840,2050,4840,9922000,2,6726,1683,1,125676800,125676800,2521,840,1681,840,0,1,842,189968,0.189968
1240,2050,4840,9922000,2,9926,2483,1,147724800,147724800,3721,1240,2481,1240,0,1,1242,46343,0.046343
1640,2050,4840,9922000,2,13126,3283,1,169772800,169772800,4921,1640,3281,1640,0,1,1642,127864,0.127864
2040,2050,4840,9922000,2,16326,4083,1,191820800,191820800,6121,2040,4081,2040,0,1,2042,108248,0.108248
2440,2050,4840,9922000,2,19526,4883,1,213868800,213868800,7321,2440,4881,2440,0,1,2442,282398,0.282398
2840,2050,4840,9922000,2,22726,5683,1,235916800,235916800,8521,2840,5681,2840,0,1,2842,98889,0.098889
3240,2050,4840,9922000,2,25926,6483,1,257964800,257964800,9721,3240,6481,3240,0,1,3242,24753,0.024753
3640,2050,4840,9922000,2,29126,7283,1,280012800,280012800,10921,3640,7281,3640,0,1,3642,1155954,1.155954
4040,2050,4840,9922000,2,32326,8083,1,302060800,302060800,12121,4040,8081,4040,0,1,4042,941530,0.94153
4440,2050,4840,9922000,2,35526,8883,1,324108800,324108800,13321,4440,8881,4440,0,1,4442,102711,0.102711
4840,2050,4840,9922000,2,38726,9683,1,346156800,346156800,14521,4840,9681,4840,0,1,4842,32603,0.032603
5240,2050,4840,9922000,2,41926,10483,1,368204800,368204800,15721,5240,10481,5240,0,1,5242,431433,0.431433
5640,2050,4840,9922000,2,45126,11283,1,390252800,390252800,16921,5640,11281,5640,0,1,5642,1926491,1.926491
6040,2050,4840,9922000,2,48326,12083,1,412300800,412300800,18121,6040,12081,6040,0,1,6042,898593,0.898593
6440,2050,4840,9922000,2,51526,12883,1,434348800,434348800,19321,6440,12881,6440,0,1,6442,1279364,1.279364
6840,2050,4840,9922000,2,54726,13683,1,456396800,456396800,20521,6840,13681,6840,0,1,6842,4732296,4.732296
44,2803,3555,9964665,2,358,91,1,81955336,81955336,133,44,89,44,0,1,46,184581,0.184581
544,2803,3555,9964665,2,4358,1091,1,107387336,107387336,1633,544,1089,544,0,1,546,1085581,1.085581
1044,2803,3555,9964665,2,8358,2091,1,132819336,132819336,3133,1044,2089,1044,0,1,1046,68191,0.068191
1544,2803,3555,9964665,2,12358,3091,1,158251336,158251336,4633,1544,3089,1544,0,1,1546,598107,0.598107
2044,2803,3555,9964665,2,16358,4091,1,183683336,183683336,6133,2044,4089,2044,0,1,2046,907491,0.907491
2544,2803,3555,9964665,2,20358,5091,1,209115336,209115336,7633,2544,5089,2544,0,1,2546,1914886,1.914886
3044,2803,3555,9964665,2,24358,6091,1,234547336,234547336,9133,3044,6089,3044,0,1,3046,125120,0.12512
3544,2803,3555,9964665,2,28358,7091,1,259979336,259979336,10633,3544,7089,3544,0,1,3546,2744877,2.744877
4044,2803,3555,9964665,2,32358,8091,1,285411336,285411336,12133,4044,8089,4044,0,1,4046,5303268,5.303268
4544,2803,3555,9964665,2,36358,9091,1,310843336,310843336,13633,4544,9089,4544,0,1,4546,4650261,4.650261
5044,2803,3555,9964665,2,40358,10091,1,336275336,336275336,15133,5044,10089,5044,0,1,5046,569297,0.569297
5544,2803,3555,9964665,2,44358,11091,1,361707336,361707336,16633,5544,11089,5544,0,1,5546,1870057,1.870057
6044,2803,3555,9964665,2,48358,12091,1,387139336,387139336,18133,6044,12089,6044,0,1,6046,2883440,2.88344
6544,2803,3555,9964665,2,52358,13091,1,412571336,412571336,19633,6544,13089,6544,0,1,6546,2669993,2.669993
7044,2803,3555,9964665,2,56358,14091,1,438003336,438003336,21133,7044,14089,7044,0,1,7046,286451,0.286451
44,3903,2555,9972165,2,358,91,1,82050536,82050536,133,44,89,44,0,1,46,192689,0.192689
544,3903,2555,9972165,2,4358,1091,1,107882536,107882536,1633,544,1089,544,0,1,546,1131859,1.131859
1044,3903,2555,9972165,2,8358,2091,1,133714536,133714536,3133,1044,2089,1044,0,1,1046,1521242,1.521242
1544,3903,2555,9972165,2,12358,3091,1,159546536,159546536,4633,1544,3089,1544,0,1,1546,3047074,3.047074
2044,3903,2555,9972165,2,16358,4091,1,185378536,185378536,6133,2044,4089,2044,0,1,2046,990030,0.99003
2544,3903,2555,9972165,2,20358,5091,1,211210536,211210536,7633,2544,5089,2544,0,1,2546,4455014,4.455014
3044,3903,2555,9972165,2,24358,6091,1,237042536,237042536,9133,3044,6089,3044,0,1,3046,3046535,3.046535
3544,3903,2555,9972165,2,28358,7091,1,262874536,262874536,10633,3544,7089,3544,0,1,3546,400019,0.400019
4044,3903,2555,9972165,2,32358,8091,1,288706536,288706536,12133,4044,8089,4044,0,1,4046,2011264,2.011264
4544,3903,2555,9972165,2,36358,9091,1,314538536,314538536,13633,4544,9089,4544,0,1,4546,734138,0.734138
5044,3903,2555,9972165,2,40358,10091,1,340370536,340370536,15133,5044,10089,5044,0,1,5046,6514750,6.51475
5544,3903,2555,9972165,2,44358,11091,1,366202536,366202536,16633,5544,11089,5544,0,1,5546,10844879,10.844879
6044,3903,2555,9972165,2,48358,12091,1,392034536,392034536,18133,6044,12089,6044,0,1,6046,11742718,11.742718
6544,3903,2555,9972165,2,52358,13091,1,417866536,417866536,19633,6544,13089,6544,0,1,6546,3105176,3.105176
7044,3903,2555,9972165,2,56358,14091,1,443698536,443698536,21133,7044,14089,7044,0,1,7046,11735119,11.735119
55,4055,2465,9995575,2,446,113,1,82833400,82833400,166,55,111,55,0,1,57,12766,0.012766
455,4055,2465,9995575,2,3646,913,1,103697400,103697400,1366,455,911,455,0,1,457,27297,0.027297
855,4055,2465,9995575,2,6846,1713,1,124561400,124561400,2566,855,1711,855,0,1,857,37263,0.037263
1255,4055,2465,9995575,2,10046,2513,1,145425400,145425400,3766,1255,2511,1255,0,1,1257,155998,0.155998
1655,4055,2465,9995575,2,13246,3313,1,166289400,166289400,4966,1655,3311,1655,0,1,1657,278045,0.278045
2055,4055,2465,9995575,2,16446,4113,1,187153400,187153400,6166,2055,4111,2055,0,1,2057,10898,0.010898
2455,4055,2465,9995575,2,19646,4913,1,208017400,208017400,7366,2455,4911,2455,0,1,2457,486746,0.486746
2855,4055,2465,9995575,2,22846,5713,1,228881400,228881400,8566,2855,5711,2855,0,1,2857,1151529,1.151529
3255,4055,2465,9995575,2,26046,6513,1,249745400,249745400,9766,3255,6511,3255,0,1,3257,1730093,1.730093
3655,4055,2465,9995575,2,29246,7313,1,270609400,270609400,10966,3655,7311,3655,0,1,3657,563610,0.56361
4055,4055,2465,9995575,2,32446,8113,1,291473400,291473400,12166,4055,8111,4055,0,1,4057,56647,0.056647
4455,4055,2465,9995575,2,35646,8913,1,312337400,312337400,13366,4455,8911,4455,0,1,4457,1757513,1.757513
4855,4055,2465,9995575,2,38846,9713,1,333201400,333201400,14566,4855,9711,4855,0,1,4857,794269,0.794269
5255,4055,2465,9995575,2,42046,10513,1,354065400,354065400,15766,5255,10511,5255,0,1,5257,885613,0.885613
5655,4055,2465,9995575,2,45246,11313,1,374929400,374929400,16966,5655,11311,5655,0,1,5657,21371,0.021371
6055,4055,2465,9995575,2,48446,12113,1,395793400,395793400,18166,6055,12111,6055,0,1,6057,170781,0.170781
6455,4055,2465,9995575,2,51646,12913,1,416657400,416657400,19366,6455,12911,6455,0,1,6457,73066,0.073066
6855,4055,2465,9995575,2,54846,13713,1,437521400,437521400,20566,6855,13711,6855,0,1,6857,1518982,1.518982
55,2055,4865,9997575,2,446,113,1,83025400,83025400,166,55,111,55,0,1,57,6859,0.006859
455,2055,4865,9997575,2,3646,913,1,105169400,105169400,1366,455,911,455,0,1,457,62423,0.062423
855,2055,4865,9997575,2,6846,1713,1,127313400,127313400,2566,855,1711,855,0,1,857,66504,0.066504
1255,2055,4865,9997575,2,10046,2513,1,149457400,149457400,3766,1255,2511,1255,0,1,1257,11173,0.011173
1655,2055,4865,9997575,2,13246,3313,1,171601400,171601400,4966,1655,3311,1655,0,1,1657,122624,0.122624
2055,2055,4865,9997575,2,16446,4113,1,193745400,193745400,6166,2055,4111,2055,0,1,2057,139532,0.139532
2455,2055,4865,9997575,2,19646,4913,1,215889400,215889400,7366,2455,4911,2455,0,1,2457,134357,0.134357
2855,2055,4865,9997575,2,22846,5713,1,238033400,238033400,8566,2855,5711,2855,0,1,2857,503659,0.503659
3255,2055,4865,9997575,2,26046,6513,1,260177400,260177400,9766,3255,6511,3255,0,1,3257,215369,0.215369
3655,2055,4865,9997575,2,29246,7313,1,282321400,282321400,10966,3655,7311,3655,0,1,3657,488516,0.488516
4055,2055,4865,9997575,2,32446,8113,1,304465400,304465400,12166,4055,8111,4055,0,1,4057,736681,0.736681
4455,2055,4865,9997575,2,35646,8913,1,326609400,326609400,13366,4455,8911,4455,0,1,4457,448620,0.44862
4855,2055,4865,9997575,2,38846,9713,1,348753400,348753400,14566,4855,9711,4855,0,1,4857,88542,0.088542
5255,2055,4865,9997575,2,42046,10513,1,370897400,370897400,15766,5255,10511,5255,0,1,5257,246852,0.246852
5655,2055,4865,9997575,2,45246,11313,1,393041400,393041400,16966,5655,11311,5655,0,1,5657,159864,0.159864
6055,2055,4865,9997575,2,48446,12113,1,415185400,415185400,18166,6055,12111,6055,0,1,6057,1321348,1.321348
6455,2055,4865,9997575,2,51646,12913,1,437329400,437329400,19366,6455,12911,6455,0,1,6457,476421,0.476421
6855,2055,4865,9997575,2,54846,13713,1,459473400,459473400,20566,6855,13711,6855,0,1,6857,1759189,1.759189
40,3300,3040,10032000,2,326,83,1,82284800,82284800,121,40,81,40,0,1,42,173068,0.173068
440,3300,3040,10032000,2,3526,883,1,102572800,102572800,1321,440,881,440,0,1,442,910672,0.910672
840,3300,3040,10032000,2,6726,1683,1,122860800,122860800,2521,840,1681,840,0,1,842,1644613,1.644613
1240,3300,3040,10032000,2,9926,2483,1,143148800,143148800,3721,1240,2481,1240,0,1,1242,2373588,2.373588
1640,3300,3040,10032000,2,13126,3283,1,163436800,163436800,4921,1640,3281,1640,0,1,1642,2614231,2.614231
2040,3300,3040,10032000,2,16326,4083,1,183724800,183724800,6121,2040,4081,2040,0,1,2042,3253978,3.253978
2440,3300,3040,10032000,2,19526,4883,1,204012800,204012800,7321,2440,4881,2440,0,1,2442,337400,0.3374
2840,3300,3040,10032000,2,22726,5683,1,224300800,224300800,8521,2840,5681,2840,0,1,2842,4443630,4.44363
3240,3300,3040,10032000,2,25926,6483,1,244588800,244588800,9721,3240,6481,3240,0,1,3242,3327274,3.327274
3640,3300,3040,10032000,2,29126,7283,1,264876800,264876800,10921,3640,7281,3640,0,1,3642,994140,0.99414
4040,3300,3040,10032000,2,32326,8083,1,285164800,285164800,12121,4040,8081,4040,0,1,4042,524545,0.524545
4440,3300,3040,10032000,2,35526,8883,1,305452800,305452800,13321,4440,8881,4440,0,1,4442,1637014,1.637014
4840,3300,3040,10032000,2,38726,9683,1,325740800,325740800,14521,4840,9681,4840,0,1,4842,1371003,1.371003
5240,3300,3040,10032000,2,41926,10483,1,346028800,346028800,15721,5240,10481,5240,0,1,5242,641408,0.641408
5640,3300,3040,10032000,2,45126,11283,1,366316800,366316800,16921,5640,11281,5640,0,1,5642,1828102,1.828102
6040,3300,3040,10032000,2,48326,12083,1,386604800,386604800,18121,6040,12081,6040,0,1,6042,3022160,3.02216
6440,3300,3040,10032000,2,51526,12883,1,406892800,406892800,19321,6440,12881,6440,0,1,6442,275101,0.275101
6840,3300,3040,10032000,2,54726,13683,1,427180800,427180800,20521,6840,13681,6840,0,1,6842,1420964,1.420964
40,2550,3940,10047000,2,326,83,1,82452800,82452800,121,40,81,40,0,1,42,179473,0.179473
440,2550,3940,10047000,2,3526,883,1,103220800,103220800,1321,440,881,440,0,1,442,905697,0.905697
840,2550,3940,10047000,2,6726,1683,1,123988800,123988800,2521,840,1681,840,0,1,842,12298,0.012298
1240,2550,3940,10047000,2,9926,2483,1,144756800,144756800,3721,1240,2481,1240,0,1,1242,1828462,1.828462
1640,2550,3940,10047000,2,13126,3283,1,165524800,165524800,4921,1640,3281,1640,0,1,1642,2441072,2.441072
2040,2550,3940,10047000,2,16326,4083,1,186292800,186292800,6121,2040,4081,2040,0,1,2042,463300,0.4633
2440,2550,3940,10047000,2,19526,4883,1,207060800,207060800,7321,2440,4881,2440,0,1,2442,1103424,1.103424
2840,2550,3940,10047000,2,22726,5683,1,227828800,227828800,8521,2840,5681,2840,0,1,2842,282622,0.282622
3240,2550,3940,10047000,2,25926,6483,1,248596800,248596800,9721,3240,6481,3240,0,1,3242,2347399,2.347399
3640,2550,3940,10047000,2,29126,7283,1,269364800,269364800,10921,3640,7281,3640,0,1,3642,3848253,3.848253
4040,2550,3940,10047000,2,32326,8083,1,290132800,290132800,12121,4040,8081,4040,0,1,4042,221392,0.221392
4440,2550,3940,10047000,2,35526,8883,1,310900800,310900800,13321,4440,8881,4440,0,1,4442,175851,0.175851
4840,2550,3940,10047000,2,38726,9683,1,331668800,331668800,14521,4840,9681,4840,0,1,4842,3040468,3.040468
5240,2550,3940,10047000,2,41926,10483,1,352436800,352436800,15721,5240,10481,5240,0,1,5242,392173,0.392173
5640,2550,3940,10047000,2,45126,11283,1,373204800,373204800,16921,5640,11281,5640,0,1,5642,4326245,4.326245
6040,2550,3940,10047000,2,48326,12083,1,393972800,393972800,18121,6040,12081,6040,0,1,6042,467674,0.467674
6440,2550,3940,10047000,2,51526,12883,1,414740800,414740800,19321,6440,12881,6440,0,1,6442,1413327,1.413327
6840,2550,3940,10047000,2,54726,13683,1,435508800,435508800,20521,6840,13681,6840,0,1,6842,649895,0.649895
40,6550,1540,10087000,2,326,83,1,83284800,83284800,121,40,81,40,0,1,42,22809,0.022809
440,6550,1540,10087000,2,3526,883,1,109172800,109172800,1321,440,881,440,0,1,442,56061,0.056061
840,6550,1540,10087000,2,6726,1683,1,135060800,135060800,2521,840,1681,840,0,1,842,1922,0.001922
1240,6550,1540,10087000,2,9926,2483,1,160948800,160948800,3721,1240,2481,1240,0,1,1242,554167,0.554167
1640,6550,1540,10087000,2,13126,3283,1,186836800,186836800,4921,1640,3281,1640,0,1,1642,262989,0.262989
2040,6550,1540,10087000,2,16326,4083,1,212724800,212724800,6121,2040,4081,2040,0,1,2042,141865,0.141865
2440,6550,1540,10087000,2,19526,4883,1,238612800,238612800,7321,2440,4881,2440,0,1,2442,290799,0.290799
2840,6550,1540,10087000,2,22726,5683,1,264500800,264500800,8521,2840,5681,2840,0,1,2842,660260,0.66026
3240,6550,1540,10087000,2,25926,6483,1,290388800,290388800,9721,3240,6481,3240,0,1,3242,563800,0.5638
3640,6550,1540,10087000,2,29126,7283,1,316276800,316276800,10921,3640,7281,3640,0,1,3642,1473118,1.473118
4040,6550,1540,10087000,2,32326,8083,1,342164800,342164800,12121,4040,8081,4040,0,1,4042,230709,0.230709
4440,6550,1540,10087000,2,35526,8883,1,368052800,368052800,13321,4440,8881,4440,0,1,4442,13903,0.013903
4840,6550,1540,10087000,2,38726,9683,1,393940800,393940800,14521,4840,9681,4840,0,1,4842,3540928,3.540928
5240,6550,1540,10087000,2,41926,10483,1,419828800,419828800,15721,5240,10481,5240,0,1,5242,924935,0.924935
5640,6550,1540,10087000,2,45126,11283,1,445716800,445716800,16921,5640,11281,5640,0,1,5642,1009486,1.009486
6040,6550,1540,10087000,2,48326,12083,1,471604800,471604800,18121,6040,12081,6040,0,1,6042,32217,0.032217
6440,6550,1540,10087000,2,51526,12883,1,497492800,497492800,19321,6440,12881,6440,0,1,6442,579696,0.579696
6840,6550,1540,10087000,2,54726,13683,1,523380800,523380800,20521,6840,13681,6840,0,1,6842,777673,0.777673
35,4950,2045,10122750,2,286,73,1,82940600,82940600,106,35,71,35,0,1,37,29751,0.029751
535,4950,2045,10122750,2,4286,1073,1,110920600,110920600,1606,535,1071,535,0,1,537,293023,0.293023
1035,4950,2045,10122750,2,8286,2073,1,138900600,138900600,3106,1035,2071,1035,0,1,1037,235454,0.235454
1535,4950,2045,10122750,2,12286,3073,1,166880600,166880600,4606,1535,3071,1535,0,1,1537,403633,0.403633
2035,4950,2045,10122750,2,16286,4073,1,194860600,194860600,6106,2035,4071,2035,0,1,2037,498441,0.498441
2535,4950,2045,10122750,2,20286,5073,1,222840600,222840600,7606,2535,5071,2535,0,1,2537,5043720,5.04372
3035,4950,2045,10122750,2,24286,6073,1,250820600,250820600,9106,3035,6071,3035,0,1,3037,1289754,1.289754
3535,4950,2045,10122750,2,28286,7073,1,278800600,278800600,10606,3535,7071,3535,0,1,3537,782496,0.782496
4035,4950,2045,10122750,2,32286,8073,1,306780600,306780600,12106,4035,8071,4035,0,1,4037,691298,0.691298
4535,4950,2045,10122750,2,36286,9073,1,334760600,334760600,13606,4535,9071,4535,0,1,4537,7444964,7.444964
5035,4950,2045,10122750,2,40286,10073,1,362740600,362740600,15106,5035,10071,5035,0,1,5037,5778714,5.778714
5535,4950,2045,10122750,2,44286,11073,1,390720600,390720600,16606,5535,11071,5535,0,1,5537,5062030,5.06203
6035,4950,2045,10122750,2,48286,12073,1,418700600,418700600,18106,6035,12071,6035,0,1,6037,11898289,11.898289
6535,4950,2045,10122750,2,52286,13073,1,446680600,446680600,19606,6535,13071,6535,0,1,6537,2526406,2.526406
7035,4950,2045,10122750,2,56286,14073,1,474660600,474660600,21106,7035,14071,7035,0,1,7037,2516808,2.516808
55,3305,3065,10129825,2,446,113,1,83841400,83841400,166,55,111,55,0,1,57,207932,0.207932
455,3305,3065,10129825,2,3646,913,1,104225400,104225400,1366,455,911,455,0,1,457,976929,0.976929
855,3305,3065,10129825,2,6846,1713,1,124609400,124609400,2566,855,1711,855,0,1,857,709540,0.70954
1255,3305,3065,10129825,2,10046,2513,1,144993400,144993400,3766,1255,2511,1255,0,1,1257,2524700,2.5247
1655,3305,3065,10129825,2,13246,3313,1,165377400,165377400,4966,1655,3311,1655,0,1,1657,21596,0.021596
2055,3305,3065,10129825,2,16446,4113,1,185761400,185761400,6166,2055,4111,2055,0,1,2057,551105,0.551105
2455,3305,3065,10129825,2,19646,4913,1,206145400,206145400,7366,2455,4911,2455,0,1,2457,2602659,2.602659
2855,3305,3065,10129825,2,22846,5713,1,226529400,226529400,8566,2855,5711,2855,0,1,2857,1324587,1.324587
3255,3305,3065,10129825,2,26046,6513,1,246913400,246913400,9766,3255,6511,3255,0,1,3257,2480824,2.480824
3655,3305,3065,10129825,2,29246,7313,1,267297400,267297400,10966,3655,7311,3655,0,1,3657,7205278,7.205278
4055,3305,3065,10129825,2,32446,8113,1,287681400,287681400,12166,4055,8111,4055,0,1,4057,1034465,1.034465
4455,3305,3065,10129825,2,35646,8913,1,308065400,308065400,13366,4455,8911,4455,0,1,4457,3252095,3.252095
4855,3305,3065,10129825,2,38846,9713,1,328449400,328449400,14566,4855,9711,4855,0,1,4857,2632554,2.632554
5255,3305,3065,10129825,2,42046,10513,1,348833400,348833400,15766,5255,10511,5255,0,1,5257,2470976,2.470976
5655,3305,3065,10129825,2,45246,11313,1,369217400,369217400,16966,5655,11311,5655,0,1,5657,1593008,1.593008
6055,3305,3065,10129825,2,48446,12113,1,389601400,389601400,18166,6055,12111,6055,0,1,6057,599162,0.599162
6455,3305,3065,10129825,2,51646,12913,1,409985400,409985400,19366,6455,12911,6455,0,1,6457,569423,0.569423
6855,3305,3065,10129825,2,54846,13713,1,430369400,430369400,20566,6855,13711,6855,0,1,6857,1924891,1.924891
55,2555,3965,10130575,2,446,113,1,83913400,83913400,166,55,111,55,0,1,57,209339,0.209339
455,2555,3965,10130575,2,3646,913,1,104777400,104777400,1366,455,911,455,0,1,457,946149,0.946149
855,2555,3965,10130575,2,6846,1713,1,125641400,125641400,2566,855,1711,855,0,1,857,1688362,1.688362
1255,2555,3965,10130575,2,10046,2513,1,146505400,146505400,3766,1255,2511,1255,0,1,1257,455228,0.455228
1655,2555,3965,10130575,2,13246,3313,1,167369400,167369400,4966,1655,3311,1655,0,1,1657,342131,0.342131
2055,2555,3965,10130575,2,16446,4113,1,188233400,188233400,6166,2055,4111,2055,0,1,2057,2828912,2.828912
2455,2555,3965,10130575,2,19646,4913,1,209097400,209097400,7366,2455,4911,2455,0,1,2457,268865,0.268865
2855,2555,3965,10130575,2,22846,5713,1,229961400,229961400,8566,2855,5711,2855,0,1,2857,1564582,1.564582
3255,2555,3965,10130575,2,26046,6513,1,250825400,250825400,9766,3255,6511,3255,0,1,3257,1546945,1.546945
3655,2555,3965,10130575,2,29246,7313,1,271689400,271689400,10966,3655,7311,3655,0,1,3657,437441,0.437441
4055,2555,3965,10130575,2,32446,8113,1,292553400,292553400,12166,4055,8111,4055,0,1,4057,399962,0.399962
4455,2555,3965,10130575,2,35646,8913,1,313417400,313417400,13366,4455,8911,4455,0,1,4457,1287880,1.28788
4855,2555,3965,10130575,2,38846,9713,1,334281400,334281400,14566,4855,9711,4855,0,1,4857,1543479,1.543479
5255,2555,3965,10130575,2,42046,10513,1,355145400,355145400,15766,5255,10511,5255,0,1,5257,1453665,1.453665
5655,2555,3965,10130575,2,45246,11313,1,376009400,376009400,16966,5655,11311,5655,0,1,5657,204513,0.204513
6055,2555,3965,10130575,2,48446,12113,1,396873400,396873400,18166,6055,12111,6055,0,1,6057,4957971,4.957971
6455,2555,3965,10130575,2,51646,12913,1,417737400,417737400,19366,6455,12911,6455,0,1,6457,175767,0.175767
6855,2555,3965,10130575,2,54846,13713,1,438601400,438601400,20566,6855,13711,6855,0,1,6857,848559,0.848559
39,3343,3041,10166063,2,318,81,1,83320312,83320312,118,39,79,39,0,1,41,23268,0.023268
539,3343,3041,10166063,2,4318,1081,1,108856312,108856312,1618,539,1079,539,0,1,541,58952,0.058952
1039,3343,3041,10166063,2,8318,2081,1,134392312,134392312,3118,1039,2079,1039,0,1,1041,182744,0.182744
1539,3343,3041,10166063,2,12318,3081,1,159928312,159928312,4618,1539,3079,1539,0,1,1541,279189,0.279189
2039,3343,3041,10166063,2,16318,4081,1,185464312,185464312,6118,2039,4079,2039,0,1,2041,74553,0.074553
2539,3343,3041,10166063,2,20318,5081,1,211000312,211000312,7618,2539,5079,2539,0,1,2541,181648,0.181648
3039,3343,3041,10166063,2,24318,6081,1,236536312,236536312,9118,3039,6079,3039,0,1,3041,8767,0.008767
3539,3343,3041,10166063,2,28318,7081,1,262072312,262072312,10618,3539,7079,3539,0,1,3541,318382,0.318382
4039,3343,3041,10166063,2,32318,8081,1,287608312,287608312,12118,4039,8079,4039,0,1,4041,1453816,1.453816
4539,3343,3041,10166063,2,36318,9081,1,313144312,313144312,13618,4539,9079,4539,0,1,4541,546774,0.546774
5039,3343,3041,10166063,2,40318,10081,1,338680312,338680312,15118,5039,10079,5039,0,1,5041,1048936,1.048936
5539,3343,3041,10166063,2,44318,11081,1,364216312,364216312,16618,5539,11079,5539,0,1,5541,731692,0.731692
6039,3343,3041,10166063,2,48318,12081,1,389752312,389752312,18118,6039,12079,6039,0,1,6041,234828,0.234828
6539,3343,3041,10166063,2,52318,13081,1,415288312,415288312,19618,6539,13079,6539,0,1,6541,932880,0.93288
7039,3343,3041,10166063,2,56318,14081,1,440824312,440824312,21118,7039,14079,7039,0,1,7041,2205716,2.205716
35,3340,3045,10170300,2,286,73,1,83150200,83150200,106,35,71,35,0,1,37,189190,0.18919
535,3340,3045,10170300,2,4286,1073,1,108690200,108690200,1606,535,1071,535,0,1,537,1087211,1.087211
1035,3340,3045,10170300,2,8286,2073,1,134230200,134230200,3106,1035,2071,1035,0,1,1037,2045320,2.04532
1535,3340,3045,10170300,2,12286,3073,1,159770200,159770200,4606,1535,3071,1535,0,1,1537,2994232,2.994232
2035,3340,3045,10170300,2,16286,4073,1,185310200,185310200,6106,2035,4071,2035,0,1,2037,3947216,3.947216
35,2240,4545,10180800,2,286,73,1,83346200,83346200,106,35,71,35,0,1,37,185378,0.185378
535,2240,4545,10180800,2,4286,1073,1,110486200,110486200,1606,535,1071,535,0,1,537,1088826,1.088826
1035,2240,4545,10180800,2,8286,2073,1,137626200,137626200,3106,1035,2071,1035,0,1,1037,2043040,2.04304
1535,2240,4545,10180800,2,12286,3073,1,164766200,164766200,4606,1535,3071,1535,0,1,1537,2992928,2.992928
2035,2240,4545,10180800,2,16286,4073,1,191906200,191906200,6106,2035,4071,2035,0,1,2037,3946141,3.946141
2535,2240,4545,10180800,2,20286,5073,1,219046200,219046200,7606,2535,5071,2535,0,1,2537,4892075,4.892075
39,2243,4541,10185463,2,318,81,1,83600312,83600312,118,39,79,39,0,1,41,25644,0.025644
539,2243,4541,10185463,2,4318,1081,1,110736312,110736312,1618,539,1079,539,0,1,541,35942,0.035942
1039,2243,4541,10185463,2,8318,2081,1,137872312,137872312,3118,1039,2079,1039,0,1,1041,129207,0.129207
1539,2243,4541,10185463,2,12318,3081,1,165008312,165008312,4618,1539,3079,1539,0,1,1541,293027,0.293027
2039,2243,4541,10185463,2,16318,4081,1,192144312,192144312,6118,2039,4079,2039,0,1,2041,460156,0.460156
2539,2243,4541,10185463,2,20318,5081,1,219280312,219280312,7618,2539,5079,2539,0,1,2541,356352,0.356352
3039,2243,4541,10185463,2,24318,6081,1,246416312,246416312,9118,3039,6079,3039,0,1,3041,707784,0.707784
3539,2243,4541,10185463,2,28318,7081,1,273552312,273552312,10618,3539,7079,3539,0,1,3541,1169947,1.169947
4039,2243,4541,10185463,2,32318,8081,1,300688312,300688312,12118,4039,8079,4039,0,1,4041,960794,0.960794
4539,2243,4541,10185463,2,36318,9081,1,327824312,327824312,13618,4539,9079,4539,0,1,4541,344025,0.344025
5039,2243,4541,10185463,2,40318,10081,1,354960312,354960312,15118,5039,10079,5039,0,1,5041,809143,0.809143
5539,2243,4541,10185463,2,44318,11081,1,382096312,382096312,16618,5539,11079,5539,0,1,5541,2146748,2.146748
6039,2243,4541,10185463,2,48318,12081,1,409232312,409232312,18118,6039,12079,6039,0,1,6041,4363197,4.363197
6539,2243,4541,10185463,2,52318,13081,1,436368312,436368312,19618,6539,13079,6539,0,1,6541,7655014,7.655014
7039,2243,4541,10185463,2,56318,14081,1,463504312,463504312,21118,7039,14079,7039,0,1,7041,310054,0.310054
40,3050,3340,10187000,2,326,83,1,83540800,83540800,121,40,81,40,0,1,42,34815,0.034815
440,3050,3340,10187000,2,3526,883,1,103988800,103988800,1321,440,881,440,0,1,442,14156,0.014156
840,3050,3340,10187000,2,6726,1683,1,124436800,124436800,2521,840,1681,840,0,1,842,71250,0.07125
1240,3050,3340,10187000,2,9926,2483,1,144884800,144884800,3721,1240,2481,1240,0,1,1242,410967,0.410967
1640,3050,3340,10187000,2,13126,3283,1,165332800,165332800,4921,1640,3281,1640,0,1,1642,53351,0.053351
2040,3050,3340,10187000,2,16326,4083,1,185780800,185780800,6121,2040,4081,2040,0,1,2042,613428,0.613428
2440,3050,3340,10187000,2,19526,4883,1,206228800,206228800,7321,2440,4881,2440,0,1,2442,626843,0.626843
2840,3050,3340,10187000,2,22726,5683,1,226676800,226676800,8521,2840,5681,2840,0,1,2842,1130018,1.130018
3240,3050,3340,10187000,2,25926,6483,1,247124800,247124800,9721,3240,6481,3240,0,1,3242,623538,0.623538
3640,3050,3340,10187000,2,29126,7283,1,267572800,267572800,10921,3640,7281,3640,0,1,3642,407370,0.40737
4040,3050,3340,10187000,2,32326,8083,1,288020800,288020800,12121,4040,8081,4040,0,1,4042,146390,0.14639
4440,3050,3340,10187000,2,35526,8883,1,308468800,308468800,13321,4440,8881,4440,0,1,4442,137418,0.137418
4840,3050,3340,10187000,2,38726,9683,1,328916800,328916800,14521,4840,9681,4840,0,1,4842,83522,0.083522
5240,3050,3340,10187000,2,41926,10483,1,349364800,349364800,15721,5240,10481,5240,0,1,5242,92541,0.092541
5640,3050,3340,10187000,2,45126,11283,1,369812800,369812800,16921,5640,11281,5640,0,1,5642,506894,0.506894
6040,3050,3340,10187000,2,48326,12083,1,390260800,390260800,18121,6040,12081,6040,0,1,6042,1266460,1.26646
6440,3050,3340,10187000,2,51526,12883,1,410708800,410708800,19321,6440,12881,6440,0,1,6442,1830187,1.830187
6840,3050,3340,10187000,2,54726,13683,1,431156800,431156800,20521,6840,13681,6840,0,1,6842,1584607,1.584607
39,4993,2041,10190713,2,318,81,1,83720312,83720312,118,39,79,39,0,1,41,178247,0.178247
539,4993,2041,10190713,2,4318,1081,1,111856312,111856312,1618,539,1079,539,0,1,541,1106776,1.106776
1039,4993,2041,10190713,2,8318,2081,1,139992312,139992312,3118,1039,2079,1039,0,1,1041,2056220,2.05622
1539,4993,2041,10190713,2,12318,3081,1,168128312,168128312,4618,1539,3079,1539,0,1,1541,2269111,2.269111
2039,4993,2041,10190713,2,16318,4081,1,196264312,196264312,6118,2039,4079,2039,0,1,2041,3394013,3.394013
2539,4993,2041,10190713,2,20318,5081,1,224400312,224400312,7618,2539,5079,2539,0,1,2541,4910159,4.910159
3039,4993,2041,10190713,2,24318,6081,1,252536312,252536312,9118,3039,6079,3039,0,1,3041,5497971,5.497971
3539,4993,2041,10190713,2,28318,7081,1,280672312,280672312,10618,3539,7079,3539,0,1,3541,6824240,6.82424
4039,4993,2041,10190713,2,32318,8081,1,308808312,308808312,12118,4039,8079,4039,0,1,4041,4831464,4.831464
4539,4993,2041,10190713,2,36318,9081,1,336944312,336944312,13618,4539,9079,4539,0,1,4541,1073823,1.073823
5039,4993,2041,10190713,2,40318,10081,1,365080312,365080312,15118,5039,10079,5039,0,1,5041,9656769,9.656769
5539,4993,2041,10190713,2,44318,11081,1,393216312,393216312,16618,5539,11079,5539,0,1,5541,10586326,10.586326
6039,4993,2041,10190713,2,48318,12081,1,421352312,421352312,18118,6039,12079,6039,0,1,6041,11580009,11.580009
6539,4993,2041,10190713,2,52318,13081,1,449488312,449488312,19618,6539,13079,6539,0,1,6541,12506047,12.506047
7039,4993,2041,10190713,2,56318,14081,1,477624312,477624312,21118,7039,14079,7039,0,1,7041,13483950,13.48395
40,2800,3640,10192000,2,326,83,1,83596800,83596800,121,40,81,40,0,1,42,184556,0.184556
440,2800,3640,10192000,2,3526,883,1,104204800,104204800,1321,440,881,440,0,1,442,355822,0.355822
840,2800,3640,10192000,2,6726,1683,1,124812800,124812800,2521,840,1681,840,0,1,842,601515,0.601515
1240,2800,3640,10192000,2,9926,2483,1,145420800,145420800,3721,1240,2481,1240,0,1,1242,763052,0.763052
1640,2800,3640,10192000,2,13126,3283,1,166028800,166028800,4921,1640,3281,1640,0,1,1642,1845944,1.845944
2040,2800,3640,10192000,2,16326,4083,1,186636800,186636800,6121,2040,4081,2040,0,1,2042,3701811,3.701811
2440,2800,3640,10192000,2,19526,4883,1,207244800,207244800,7321,2440,4881,2440,0,1,2442,2187635,2.187635
2840,2800,3640,10192000,2,22726,5683,1,227852800,227852800,8521,2840,5681,2840,0,1,2842,3419462,3.419462
3240,2800,3640,10192000,2,25926,6483,1,248460800,248460800,9721,3240,6481,3240,0,1,3242,5291414,5.291414
3640,2800,3640,10192000,2,29126,7283,1,269068800,269068800,10921,3640,7281,3640,0,1,3642,4640235,4.640235
4040,2800,3640,10192000,2,32326,8083,1,289676800,289676800,12121,4040,8081,4040,0,1,4042,769031,0.769031
4440,2800,3640,10192000,2,35526,8883,1,310284800,310284800,13321,4440,8881,4440,0,1,4442,810367,0.810367
4840,2800,3640,10192000,2,38726,9683,1,330892800,330892800,14521,4840,9681,4840,0,1,4842,9070577,9.070577
5240,2800,3640,10192000,2,41926,10483,1,351500800,351500800,15721,5240,10481,5240,0,1,5242,37022,0.037022
5640,2800,3640,10192000,2,45126,11283,1,372108800,372108800,16921,5640,11281,5640,0,1,5642,1111650,1.11165
6040,2800,3640,10192000,2,48326,12083,1,392716800,392716800,18121,6040,12081,6040,0,1,6042,1466736,1.466736
6440,2800,3640,10192000,2,51526,12883,1,413324800,413324800,19321,6440,12881,6440,0,1,6442,689685,0.689685
6840,2800,3640,10192000,2,54726,13683,1,433932800,433932800,20521,6840,13681,6840,0,1,6842,2761106,2.761106
35,6600,1545,10197000,2,286,73,1,83856600,83856600,106,35,71,35,0,1,37,49994,0.049994
535,6600,1545,10197000,2,4286,1073,1,116436600,116436600,1606,535,1071,535,0,1,537,278633,0.278633
1035,6600,1545,10197000,2,8286,2073,1,149016600,149016600,3106,1035,2071,1035,0,1,1037,2034323,2.034323
1535,6600,1545,10197000,2,12286,3073,1,181596600,181596600,4606,1535,3071,1535,0,1,1537,2017745,2.017745
2035,6600,1545,10197000,2,16286,4073,1,214176600,214176600,6106,2035,4071,2035,0,1,2037,367434,0.367434
2535,6600,1545,10197000,2,20286,5073,1,246756600,246756600,7606,2535,5071,2535,0,1,2537,2418713,2.418713
3035,6600,1545,10197000,2,24286,6073,1,279336600,279336600,9106,3035,6071,3035,0,1,3037,1881897,1.881897
3535,6600,1545,10197000,2,28286,7073,1,311916600,311916600,10606,3535,7071,3535,0,1,3537,6127031,6.127031
4035,6600,1545,10197000,2,32286,8073,1,344496600,344496600,12106,4035,8071,4035,0,1,4037,366336,0.366336
4535,6600,1545,10197000,2,36286,9073,1,377076600,377076600,13606,4535,9071,4535,0,1,4537,4904191,4.904191
5035,6600,1545,10197000,2,40286,10073,1,409656600,409656600,15106,5035,10071,5035,0,1,5037,2185397,2.185397
5535,6600,1545,10197000,2,44286,11073,1,442236600,442236600,16606,5535,11071,5535,0,1,5537,2034513,2.034513
6035,6600,1545,10197000,2,48286,12073,1,474816600,474816600,18106,6035,12071,6035,0,1,6037,2372210,2.37221
6535,6600,1545,10197000,2,52286,13073,1,507396600,507396600,19606,6535,13071,6535,0,1,6537,9947873,9.947873
7035,6600,1545,10197000,2,56286,14073,1,539976600,539976600,21106,7035,14071,7035,0,1,7037,13589548,13.589548
40,5550,1840,10212000,2,326,83,1,84060800,84060800,121,40,81,40,0,1,42,183146,0.183146
440,5550,1840,10212000,2,3526,883,1,107708800,107708800,1321,440,881,440,0,1,442,450946,0.450946
840,5550,1840,10212000,2,6726,1683,1,131356800,131356800,2521,840,1681,840,0,1,842,1419382,1.419382
1240,5550,1840,10212000,2,9926,2483,1,155004800,155004800,3721,1240,2481,1240,0,1,1242,1750858,1.750858
1640,5550,1840,10212000,2,13126,3283,1,178652800,178652800,4921,1640,3281,1640,0,1,1642,2861664,2.861664
2040,5550,1840,10212000,2,16326,4083,1,202300800,202300800,6121,2040,4081,2040,0,1,2042,35196,0.035196
2440,5550,1840,10212000,2,19526,4883,1,225948800,225948800,7321,2440,4881,2440,0,1,2442,1902700,1.9027
2840,5550,1840,10212000,2,22726,5683,1,249596800,249596800,8521,2840,5681,2840,0,1,2842,487259,0.487259
3240,5550,1840,10212000,2,25926,6483,1,273244800,273244800,9721,3240,6481,3240,0,1,3242,1201275,1.201275
3640,5550,1840,10212000,2,29126,7283,1,296892800,296892800,10921,3640,7281,3640,0,1,3642,2946159,2.946159
4040,5550,1840,10212000,2,32326,8083,1,320540800,320540800,12121,4040,8081,4040,0,1,4042,3415417,3.415417
4440,5550,1840,10212000,2,35526,8883,1,344188800,344188800,13321,4440,8881,4440,0,1,4442,161889,0.161889
4840,5550,1840,10212000,2,38726,9683,1,367836800,367836800,14521,4840,9681,4840,0,1,4842,947119,0.947119
5240,5550,1840,10212000,2,41926,10483,1,391484800,391484800,15721,5240,10481,5240,0,1,5242,376977,0.376977
5640,5550,1840,10212000,2,45126,11283,1,415132800,415132800,16921,5640,11281,5640,0,1,5642,2398503,2.398503
6040,5550,1840,10212000,2,48326,12083,1,438780800,438780800,18121,6040,12081,6040,0,1,6042,662084,0.662084
6440,5550,1840,10212000,2,51526,12883,1,462428800,462428800,19321,6440,12881,6440,0,1,6442,6155336,6.155336
6840,5550,1840,10212000,2,54726,13683,1,486076800,486076800,20521,6840,13681,6840,0,1,6842,899429,0.899429
39,1693,6041,10227413,2,318,81,1,84232312,84232312,118,39,79,39,0,1,41,181415,0.181415
539,1693,6041,10227413,2,4318,1081,1,115168312,115168312,1618,539,1079,539,0,1,541,772051,0.772051
1039,1693,6041,10227413,2,8318,2081,1,146104312,146104312,3118,1039,2079,1039,0,1,1041,1320845,1.320845
1539,1693,6041,10227413,2,12318,3081,1,177040312,177040312,4618,1539,3079,1539,0,1,1541,3118150,3.11815
2039,1693,6041,10227413,2,16318,4081,1,207976312,207976312,6118,2039,4079,2039,0,1,2041,2493711,2.493711
2539,1693,6041,10227413,2,20318,5081,1,238912312,238912312,7618,2539,5079,2539,0,1,2541,278083,0.278083
3039,1693,6041,10227413,2,24318,6081,1,269848312,269848312,9118,3039,6079,3039,0,1,3041,6104716,6.104716
3539,1693,6041,10227413,2,28318,7081,1,300784312,300784312,10618,3539,7079,3539,0,1,3541,1329125,1.329125
4039,1693,6041,10227413,2,32318,8081,1,331720312,331720312,12118,4039,8079,4039,0,1,4041,4015790,4.01579
4539,1693,6041,10227413,2,36318,9081,1,362656312,362656312,13618,4539,9079,4539,0,1,4541,2044217,2.044217
5039,1693,6041,10227413,2,40318,10081,1,393592312,393592312,15118,5039,10079,5039,0,1,5041,5812887,5.812887
5539,1693,6041,10227413,2,44318,11081,1,424528312,424528312,16618,5539,11079,5539,0,1,5541,4152701,4.152701
6039,1693,6041,10227413,2,48318,12081,1,455464312,455464312,18118,6039,12079,6039,0,1,6041,2471848,2.471848
6539,1693,6041,10227413,2,52318,13081,1,486400312,486400312,19618,6539,13079,6539,0,1,6541,978094,0.978094
7039,1693,6041,10227413,2,56318,14081,1,517336312,517336312,21118,7039,14079,7039,0,1,7041,641846,0.641846
39,6643,1541,10236863,2,318,81,1,84448312,84448312,118,39,79,39,0,1,41,22076,0.022076
539,6643,1541,10236863,2,4318,1081,1,117184312,117184312,1618,539,1079,539,0,1,541,6029,0.006029
1039,6643,1541,10236863,2,8318,2081,1,149920312,149920312,3118,1039,2079,1039,0,1,1041,12884,0.012884
1539,6643,1541,10236863,2,12318,3081,1,182656312,182656312,4618,1539,3079,1539,0,1,1541,2651,0.002651
2039,6643,1541,10236863,2,16318,4081,1,215392312,215392312,6118,2039,4079,2039,0,1,2041,279756,0.279756
2539,6643,1541,10236863,2,20318,5081,1,248128312,248128312,7618,2539,5079,2539,0,1,2541,394843,0.394843
3039,6643,1541,10236863,2,24318,6081,1,280864312,280864312,9118,3039,6079,3039,0,1,3041,1105000,1.105
3539,6643,1541,10236863,2,28318,7081,1,313600312,313600312,10618,3539,7079,3539,0,1,3541,2730033,2.730033
4039,6643,1541,10236863,2,32318,8081,1,346336312,346336312,12118,4039,8079,4039,0,1,4041,1918563,1.918563
4539,6643,1541,10236863,2,36318,9081,1,379072312,379072312,13618,4539,9079,4539,0,1,4541,1236523,1.236523
5039,6643,1541,10236863,2,40318,10081,1,411808312,411808312,15118,5039,10079,5039,0,1,5041,1306743,1.306743
5539,6643,1541,10236863,2,44318,11081,1,444544312,444544312,16618,5539,11079,5539,0,1,5541,87487,0.087487
6039,6643,1541,10236863,2,48318,12081,1,477280312,477280312,18118,6039,12079,6039,0,1,6041,3529554,3.529554
6539,6643,1541,10236863,2,52318,13081,1,510016312,510016312,19618,6539,13079,6539,0,1,6541,512852,0.512852
7039,6643,1541,10236863,2,56318,14081,1,542752312,542752312,21118,7039,14079,7039,0,1,7041,1990787,1.990787
44,3353,3055,10243415,2,358,91,1,84202936,84202936,133,44,89,44,0,1,46,21477,0.021477
544,3353,3055,10243415,2,4358,1091,1,109834936,109834936,1633,544,1089,544,0,1,546,174245,0.174245
1044,3353,3055,10243415,2,8358,2091,1,135466936,135466936,3133,1044,2089,1044,0,1,1046,39256,0.039256
1544,3353,3055,10243415,2,12358,3091,1,161098936,161098936,4633,1544,3089,1544,0,1,1546,430797,0.430797
2044,3353,3055,10243415,2,16358,4091,1,186730936,186730936,6133,2044,4089,2044,0,1,2046,23350,0.02335
2544,3353,3055,10243415,2,20358,5091,1,212362936,212362936,7633,2544,5089,2544,0,1,2546,133792,0.133792
3044,3353,3055,10243415,2,24358,6091,1,237994936,237994936,9133,3044,6089,3044,0,1,3046,1209578,1.209578
3544,3353,3055,10243415,2,28358,7091,1,263626936,263626936,10633,3544,7089,3544,0,1,3546,397147,0.397147
4044,3353,3055,10243415,2,32358,8091,1,289258936,289258936,12133,4044,8089,4044,0,1,4046,344390,0.34439
4544,3353,3055,10243415,2,36358,9091,1,314890936,314890936,13633,4544,9089,4544,0,1,4546,396501,0.396501
5044,3353,3055,10243415,2,40358,10091,1,340522936,340522936,15133,5044,10089,5044,0,1,5046,246113,0.246113
5544,3353,3055,10243415,2,44358,11091,1,366154936,366154936,16633,5544,11089,5544,0,1,5546,5104485,5.104485
6044,3353,3055,10243415,2,48358,12091,1,391786936,391786936,18133,6044,12089,6044,0,1,6046,94580,0.09458
6544,3353,3055,10243415,2,52358,13091,1,417418936,417418936,19633,6544,13089,6544,0,1,6546,2047239,2.047239
7044,3353,3055,10243415,2,56358,14091,1,443050936,443050936,21133,7044,14089,7044,0,1,7046,2224819,2.224819
55,6555,1565,10258575,2,446,113,1,85641400,85641400,166,55,111,55,0,1,57,16499,0.016499
455,6555,1565,10258575,2,3646,913,1,111625400,111625400,1366,455,911,455,0,1,457,14722,0.014722
855,6555,1565,10258575,2,6846,1713,1,137609400,137609400,2566,855,1711,855,0,1,857,239279,0.239279
1255,6555,1565,10258575,2,10046,2513,1,163593400,163593400,3766,1255,2511,1255,0,1,1257,26873,0.026873
1655,6555,1565,10258575,2,13246,3313,1,189577400,189577400,4966,1655,3311,1655,0,1,1657,1215650,1.21565
2055,6555,1565,10258575,2,16446,4113,1,215561400,215561400,6166,2055,4111,2055,0,1,2057,784426,0.784426
2455,6555,1565,10258575,2,19646,4913,1,241545400,241545400,7366,2455,4911,2455,0,1,2457,360538,0.360538
2855,6555,1565,10258575,2,22846,5713,1,267529400,267529400,8566,2855,5711,2855,0,1,2857,59642,0.059642
3255,6555,1565,10258575,2,26046,6513,1,293513400,293513400,9766,3255,6511,3255,0,1,3257,755753,0.755753
3655,6555,1565,10258575,2,29246,7313,1,319497400,319497400,10966,3655,7311,3655,0,1,3657,871065,0.871065
4055,6555,1565,10258575,2,32446,8113,1,345481400,345481400,12166,4055,8111,4055,0,1,4057,531069,0.531069
4455,6555,1565,10258575,2,35646,8913,1,371465400,371465400,13366,4455,8911,4455,0,1,4457,869277,0.869277
4855,6555,1565,10258575,2,38846,9713,1,397449400,397449400,14566,4855,9711,4855,0,1,4857,1880298,1.880298
5255,6555,1565,10258575,2,42046,10513,1,423433400,423433400,15766,5255,10511,5255,0,1,5257,2481824,2.481824
5655,6555,1565,10258575,2,45246,11313,1,449417400,449417400,16966,5655,11311,5655,0,1,5657,226058,0.226058
6055,6555,1565,10258575,2,48446,12113,1,475401400,475401400,18166,6055,12111,6055,0,1,6057,346512,0.346512
6455,6555,1565,10258575,2,51646,12913,1,501385400,501385400,19366,6455,12911,6455,0,1,6457,2036221,2.036221
6855,6555,1565,10258575,2,54846,13713,1,527369400,527369400,20566,6855,13711,6855,0,1,6857,2255464,2.255464
44,2253,4555,10262415,2,358,91,1,84495736,84495736,133,44,89,44,0,1,46,43062,0.043062
544,2253,4555,10262415,2,4358,1091,1,111727736,111727736,1633,544,1089,544,0,1,546,14829,0.014829
1044,2253,4555,10262415,2,8358,2091,1,138959736,138959736,3133,1044,2089,1044,0,1,1046,33082,0.033082
1544,2253,4555,10262415,2,12358,3091,1,166191736,166191736,4633,1544,3089,1544,0,1,1546,239324,0.239324
2044,2253,4555,10262415,2,16358,4091,1,193423736,193423736,6133,2044,4089,2044,0,1,2046,1545160,1.54516
2544,2253,4555,10262415,2,20358,5091,1,220655736,220655736,7633,2544,5089,2544,0,1,2546,8373,0.008373
3044,2253,4555,10262415,2,24358,6091,1,247887736,247887736,9133,3044,6089,3044,0,1,3046,1443996,1.443996
3544,2253,4555,10262415,2,28358,7091,1,275119736,275119736,10633,3544,7089,3544,0,1,3546,1720093,1.720093
4044,2253,4555,10262415,2,32358,8091,1,302351736,302351736,12133,4044,8089,4044,0,1,4046,2917614,2.917614
4544,2253,4555,10262415,2,36358,9091,1,329583736,329583736,13633,4544,9089,4544,0,1,4546,1784315,1.784315
5044,2253,4555,10262415,2,40358,10091,1,356815736,356815736,15133,5044,10089,5044,0,1,5046,1873600,1.8736
5544,2253,4555,10262415,2,44358,11091,1,384047736,384047736,16633,5544,11089,5544,0,1,5546,627068,0.627068
6044,2253,4555,10262415,2,48358,12091,1,411279736,411279736,18133,6044,12089,6044,0,1,6046,1465198,1.465198
6544,2253,4555,10262415,2,52358,13091,1,438511736,438511736,19633,6544,13089,6544,0,1,6546,1289183,1.289183
7044,2253,4555,10262415,2,56358,14091,1,465743736,465743736,21133,7044,14089,7044,0,1,7046,228423,0.228423
40,4800,2140,10272000,2,326,83,1,84396800,84396800,121,40,81,40,0,1,42,190942,0.190942
440,4800,2140,10272000,2,3526,883,1,106604800,106604800,1321,440,881,440,0,1,442,923420,0.92342
840,4800,2140,10272000,2,6726,1683,1,128812800,128812800,2521,840,1681,840,0,1,842,960231,0.960231
1240,4800,2140,10272000,2,9926,2483,1,151020800,151020800,3721,1240,2481,1240,0,1,1242,140819,0.140819
1640,4800,2140,10272000,2,13126,3283,1,173228800,173228800,4921,1640,3281,1640,0,1,1642,1280903,1.280903
2040,4800,2140,10272000,2,16326,4083,1,195436800,195436800,6121,2040,4081,2040,0,1,2042,3940231,3.940231
2440,4800,2140,10272000,2,19526,4883,1,217644800,217644800,7321,2440,4881,2440,0,1,2442,4712583,4.712583
2840,4800,2140,10272000,2,22726,5683,1,239852800,239852800,8521,2840,5681,2840,0,1,2842,4405206,4.405206
3240,4800,2140,10272000,2,25926,6483,1,262060800,262060800,9721,3240,6481,3240,0,1,3242,3394308,3.394308
3640,4800,2140,10272000,2,29126,7283,1,284268800,284268800,10921,3640,7281,3640,0,1,3642,497238,0.497238
4040,4800,2140,10272000,2,32326,8083,1,306476800,306476800,12121,4040,8081,4040,0,1,4042,6099284,6.099284
4440,4800,2140,10272000,2,35526,8883,1,328684800,328684800,13321,4440,8881,4440,0,1,4442,4558373,4.558373
4840,4800,2140,10272000,2,38726,9683,1,350892800,350892800,14521,4840,9681,4840,0,1,4842,5155099,5.155099
5240,4800,2140,10272000,2,41926,10483,1,373100800,373100800,15721,5240,10481,5240,0,1,5242,10078418,10.078418
5640,4800,2140,10272000,2,45126,11283,1,395308800,395308800,16921,5640,11281,5640,0,1,5642,620280,0.62028
6040,4800,2140,10272000,2,48326,12083,1,417516800,417516800,18121,6040,12081,6040,0,1,6042,1936657,1.936657
6440,4800,2140,10272000,2,51526,12883,1,439724800,439724800,19321,6440,12881,6440,0,1,6442,3306966,3.306966
6840,4800,2140,10272000,2,54726,13683,1,461932800,461932800,20521,6840,13681,6840,0,1,6842,1830834,1.830834
55,3055,3365,10280075,2,446,113,1,85065400,85065400,166,55,111,55,0,1,57,19622,0.019622
455,3055,3365,10280075,2,3646,913,1,105609400,105609400,1366,455,911,455,0,1,457,35877,0.035877
855,3055,3365,10280075,2,6846,1713,1,126153400,126153400,2566,855,1711,855,0,1,857,129631,0.129631
1255,3055,3365,10280075,2,10046,2513,1,146697400,146697400,3766,1255,2511,1255,0,1,1257,386244,0.386244
1655,3055,3365,10280075,2,13246,3313,1,167241400,167241400,4966,1655,3311,1655,0,1,1657,122419,0.122419
2055,3055,3365,10280075,2,16446,4113,1,187785400,187785400,6166,2055,4111,2055,0,1,2057,885022,0.885022
2455,3055,3365,10280075,2,19646,4913,1,208329400,208329400,7366,2455,4911,2455,0,1,2457,60243,0.060243
2855,3055,3365,10280075,2,22846,5713,1,228873400,228873400,8566,2855,5711,2855,0,1,2857,93192,0.093192
3255,3055,3365,10280075,2,26046,6513,1,249417400,249417400,9766,3255,6511,3255,0,1,3257,360596,0.360596
3655,3055,3365,10280075,2,29246,7313,1,269961400,269961400,10966,3655,7311,3655,0,1,3657,28134,0.028134
4055,3055,3365,10280075,2,32446,8113,1,290505400,290505400,12166,4055,8111,4055,0,1,4057,237923,0.237923
4455,3055,3365,10280075,2,35646,8913,1,311049400,311049400,13366,4455,8911,4455,0,1,4457,918740,0.91874
4855,3055,3365,10280075,2,38846,9713,1,331593400,331593400,14566,4855,9711,4855,0,1,4857,1100830,1.10083
5255,3055,3365,10280075,2,42046,10513,1,352137400,352137400,15766,5255,10511,5255,0,1,5257,5957835,5.957835
5655,3055,3365,10280075,2,45246,11313,1,372681400,372681400,16966,5655,11311,5655,0,1,5657,1917307,1.917307
6055,3055,3365,10280075,2,48446,12113,1,393225400,393225400,18166,6055,12111,6055,0,1,6057,220479,0.220479
6455,3055,3365,10280075,2,51646,12913,1,413769400,413769400,19366,6455,12911,6455,0,1,6457,306742,0.306742
6855,3055,3365,10280075,2,54846,13713,1,434313400,434313400,20566,6855,13711,6855,0,1,6857,45565,0.045565
55,2805,3665,10280325,2,446,113,1,85089400,85089400,166,55,111,55,0,1,57,206938,0.206938
455,2805,3665,10280325,2,3646,913,1,105793400,105793400,1366,455,911,455,0,1,457,947602,0.947602
855,2805,3665,10280325,2,6846,1713,1,126497400,126497400,2566,855,1711,855,0,1,857,276206,0.276206
1255,2805,3665,10280325,2,10046,2513,1,147201400,147201400,3766,1255,2511,1255,0,1,1257,586652,0.586652
1655,2805,3665,10280325,2,13246,3313,1,167905400,167905400,4966,1655,3311,1655,0,1,1657,369375,0.369375
2055,2805,3665,10280325,2,16446,4113,1,188609400,188609400,6166,2055,4111,2055,0,1,2057,2046379,2.046379
2455,2805,3665,10280325,2,19646,4913,1,209313400,209313400,7366,2455,4911,2455,0,1,2457,4746555,4.746555
2855,2805,3665,10280325,2,22846,5713,1,230017400,230017400,8566,2855,5711,2855,0,1,2857,1937493,1.937493
3255,2805,3665,10280325,2,26046,6513,1,250721400,250721400,9766,3255,6511,3255,0,1,3257,1237407,1.237407
3655,2805,3665,10280325,2,29246,7313,1,271425400,271425400,10966,3655,7311,3655,0,1,3657,612151,0.612151
4055,2805,3665,10280325,2,32446,8113,1,292129400,292129400,12166,4055,8111,4055,0,1,4057,61432,0.061432
4455,2805,3665,10280325,2,35646,8913,1,312833400,312833400,13366,4455,8911,4455,0,1,4457,1476219,1.476219
4855,2805,3665,10280325,2,38846,9713,1,333537400,333537400,14566,4855,9711,4855,0,1,4857,505389,0.505389
5255,2805,3665,10280325,2,42046,10513,1,354241400,354241400,15766,5255,10511,5255,0,1,5257,1337240,1.33724
5655,2805,3665,10280325,2,45246,11313,1,374945400,374945400,16966,5655,11311,5655,0,1,5657,3742256,3.742256
6055,2805,3665,10280325,2,48446,12113,1,395649400,395649400,18166,6055,12111,6055,0,1,6057,249402,0.249402
6455,2805,3665,10280325,2,51646,12913,1,416353400,416353400,19366,6455,12911,6455,0,1,6457,2412686,2.412686
6855,2805,3665,10280325,2,54846,13713,1,437057400,437057400,20566,6855,13711,6855,0,1,6857,154462,0.154462
44,5003,2055,10281165,2,358,91,1,84733736,84733736,133,44,89,44,0,1,46,188752,0.188752
544,5003,2055,10281165,2,4358,1091,1,112965736,112965736,1633,544,1089,544,0,1,546,1127848,1.127848
1044,5003,2055,10281165,2,8358,2091,1,141197736,141197736,3133,1044,2089,1044,0,1,1046,2102635,2.102635
1544,5003,2055,10281165,2,12358,3091,1,169429736,169429736,4633,1544,3089,1544,0,1,1546,3053011,3.053011
2044,5003,2055,10281165,2,16358,4091,1,197661736,197661736,6133,2044,4089,2044,0,1,2046,4008096,4.008096
2544,5003,2055,10281165,2,20358,5091,1,225893736,225893736,7633,2544,5089,2544,0,1,2546,4971663,4.971663
3044,5003,2055,10281165,2,24358,6091,1,254125736,254125736,9133,3044,6089,3044,0,1,3046,1024241,1.024241
3544,5003,2055,10281165,2,28358,7091,1,282357736,282357736,10633,3544,7089,3544,0,1,3546,6898608,6.898608
4044,5003,2055,10281165,2,32358,8091,1,310589736,310589736,12133,4044,8089,4044,0,1,4046,7805634,7.805634
4544,5003,2055,10281165,2,36358,9091,1,338821736,338821736,13633,4544,9089,4544,0,1,4546,8826401,8.826401
5044,5003,2055,10281165,2,40358,10091,1,367053736,367053736,15133,5044,10089,5044,0,1,5046,9842060,9.84206
5544,5003,2055,10281165,2,44358,11091,1,395285736,395285736,16633,5544,11089,5544,0,1,5546,10739997,10.739997
6044,5003,2055,10281165,2,48358,12091,1,423517736,423517736,18133,6044,12089,6044,0,1,6046,11737563,11.737563
6544,5003,2055,10281165,2,52358,13091,1,451749736,451749736,19633,6544,13089,6544,0,1,6546,12611601,12.611601
7044,5003,2055,10281165,2,56358,14091,1,479981736,479981736,21133,7044,14089,7044,0,1,7046,13553818,13.553818
40,1550,6640,10292000,2,326,83,1,84956800,84956800,121,40,81,40,0,1,42,56415,0.056415
440,1550,6640,10292000,2,3526,883,1,111164800,111164800,1321,440,881,440,0,1,442,929551,0.929551
840,1550,6640,10292000,2,6726,1683,1,137372800,137372800,2521,840,1681,840,0,1,842,1694674,1.694674
1240,1550,6640,10292000,2,9926,2483,1,163580800,163580800,3721,1240,2481,1240,0,1,1242,848204,0.848204
1640,1550,6640,10292000,2,13126,3283,1,189788800,189788800,4921,1640,3281,1640,0,1,1642,546782,0.546782
2040,1550,6640,10292000,2,16326,4083,1,215996800,215996800,6121,2040,4081,2040,0,1,2042,175651,0.175651
2440,1550,6640,10292000,2,19526,4883,1,242204800,242204800,7321,2440,4881,2440,0,1,2442,2143517,2.143517
2840,1550,6640,10292000,2,22726,5683,1,268412800,268412800,8521,2840,5681,2840,0,1,2842,168871,0.168871
3240,1550,6640,10292000,2,25926,6483,1,294620800,294620800,9721,3240,6481,3240,0,1,3242,188156,0.188156
3640,1550,6640,10292000,2,29126,7283,1,320828800,320828800,10921,3640,7281,3640,0,1,3642,318054,0.318054
4040,1550,6640,10292000,2,32326,8083,1,347036800,347036800,12121,4040,8081,4040,0,1,4042,349366,0.349366
4440,1550,6640,10292000,2,35526,8883,1,373244800,373244800,13321,4440,8881,4440,0,1,4442,81918,0.081918
4840,1550,6640,10292000,2,38726,9683,1,399452800,399452800,14521,4840,9681,4840,0,1,4842,2282139,2.282139
5240,1550,6640,10292000,2,41926,10483,1,425660800,425660800,15721,5240,10481,5240,0,1,5242,366242,0.366242
5640,1550,6640,10292000,2,45126,11283,1,451868800,451868800,16921,5640,11281,5640,0,1,5642,223928,0.223928
6040,1550,6640,10292000,2,48326,12083,1,478076800,478076800,18121,6040,12081,6040,0,1,6042,4430173,4.430173
6440,1550,6640,10292000,2,51526,12883,1,504284800,504284800,19321,6440,12881,6440,0,1,6442,4375294,4.375294
6840,1550,6640,10292000,2,54726,13683,1,530492800,530492800,20521,6840,13681,6840,0,1,6842,524454,0.524454
44,1703,6055,10311665,2,358,91,1,85224136,85224136,133,44,89,44,0,1,46,190577,0.190577
544,1703,6055,10311665,2,4358,1091,1,116256136,116256136,1633,544,1089,544,0,1,546,336493,0.336493
1044,1703,6055,10311665,2,8358,2091,1,147288136,147288136,3133,1044,2089,1044,0,1,1046,54412,0.054412
1544,1703,6055,10311665,2,12358,3091,1,178320136,178320136,4633,1544,3089,1544,0,1,1546,3137984,3.137984
2044,1703,6055,10311665,2,16358,4091,1,209352136,209352136,6133,2044,4089,2044,0,1,2046,484959,0.484959
2544,1703,6055,10311665,2,20358,5091,1,240384136,240384136,7633,2544,5089,2544,0,1,2546,2163405,2.163405
3044,1703,6055,10311665,2,24358,6091,1,271416136,271416136,9133,3044,6089,3044,0,1,3046,1414763,1.414763
3544,1703,6055,10311665,2,28358,7091,1,302448136,302448136,10633,3544,7089,3544,0,1,3546,3501021,3.501021
4044,1703,6055,10311665,2,32358,8091,1,333480136,333480136,12133,4044,8089,4044,0,1,4046,5766906,5.766906
4544,1703,6055,10311665,2,36358,9091,1,364512136,364512136,13633,4544,9089,4544,0,1,4546,815405,0.815405
5044,1703,6055,10311665,2,40358,10091,1,395544136,395544136,15133,5044,10089,5044,0,1,5046,6419410,6.41941
5544,1703,6055,10311665,2,44358,11091,1,426576136,426576136,16633,5544,11089,5544,0,1,5546,1017152,1.017152
6044,1703,6055,10311665,2,48358,12091,1,457608136,457608136,18133,6044,12089,6044,0,1,6046,1277965,1.277965
6544,1703,6055,10311665,2,52358,13091,1,488640136,488640136,19633,6544,13089,6544,0,1,6546,181162,0.181162
7044,1703,6055,10311665,2,56358,14091,1,519672136,519672136,21133,7044,14089,7044,0,1,7046,513965,0.513965
40,1800,5740,10332000,2,326,83,1,85068800,85068800,121,40,81,40,0,1,42,163486,0.163486
440,1800,5740,10332000,2,3526,883,1,109196800,109196800,1321,440,881,440,0,1,442,24909,0.024909
840,1800,5740,10332000,2,6726,1683,1,133324800,133324800,2521,840,1681,840,0,1,842,1754509,1.754509
1240,1800,5740,10332000,2,9926,2483,1,157452800,157452800,3721,1240,2481,1240,0,1,1242,2539699,2.539699
1640,1800,5740,10332000,2,13126,3283,1,181580800,181580800,4921,1640,3281,1640,0,1,1642,553861,0.553861
2040,1800,5740,10332000,2,16326,4083,1,205708800,205708800,6121,2040,4081,2040,0,1,2042,1569889,1.569889
2440,1800,5740,10332000,2,19526,4883,1,229836800,229836800,7321,2440,4881,2440,0,1,2442,4906029,4.906029
2840,1800,5740,10332000,2,22726,5683,1,253964800,253964800,8521,2840,5681,2840,0,1,2842,60388,0.060388
3240,1800,5740,10332000,2,25926,6483,1,278092800,278092800,9721,3240,6481,3240,0,1,3242,742261,0.742261
3640,1800,5740,10332000,2,29126,7283,1,302220800,302220800,10921,3640,7281,3640,0,1,3642,1422012,1.422012
4040,1800,5740,10332000,2,32326,8083,1,326348800,326348800,12121,4040,8081,4040,0,1,4042,1249153,1.249153
4440,1800,5740,10332000,2,35526,8883,1,350476800,350476800,13321,4440,8881,4440,0,1,4442,6392871,6.392871
4840,1800,5740,10332000,2,38726,9683,1,374604800,374604800,14521,4840,9681,4840,0,1,4842,122494,0.122494
5240,1800,5740,10332000,2,41926,10483,1,398732800,398732800,15721,5240,10481,5240,0,1,5242,4742556,4.742556
5640,1800,5740,10332000,2,45126,11283,1,422860800,422860800,16921,5640,11281,5640,0,1,5642,1257746,1.257746
6040,1800,5740,10332000,2,48326,12083,1,446988800,446988800,18121,6040,12081,6040,0,1,6042,1261246,1.261246
6440,1800,5740,10332000,2,51526,12883,1,471116800,471116800,19321,6440,12881,6440,0,1,6442,1776204,1.776204
6840,1800,5740,10332000,2,54726,13683,1,495244800,495244800,20521,6840,13681,6840,0,1,6842,663254,0.663254
44,6653,1555,10345415,2,358,91,1,85652536,85652536,133,44,89,44,0,1,46,11292,0.011292
544,6653,1555,10345415,2,4358,1091,1,118484536,118484536,1633,544,1089,544,0,1,546,131740,0.13174
1044,6653,1555,10345415,2,8358,2091,1,151316536,151316536,3133,1044,2089,1044,0,1,1046,146762,0.146762
1544,6653,1555,10345415,2,12358,3091,1,184148536,184148536,4633,1544,3089,1544,0,1,1546,401226,0.401226
2044,6653,1555,10345415,2,16358,4091,1,216980536,216980536,6133,2044,4089,2044,0,1,2046,2064099,2.064099
2544,6653,1555,10345415,2,20358,5091,1,249812536,249812536,7633,2544,5089,2544,0,1,2546,44434,0.044434
3044,6653,1555,10345415,2,24358,6091,1,282644536,282644536,9133,3044,6089,3044,0,1,3046,596908,0.596908
3544,6653,1555,10345415,2,28358,7091,1,315476536,315476536,10633,3544,7089,3544,0,1,3546,1512133,1.512133
4044,6653,1555,10345415,2,32358,8091,1,348308536,348308536,12133,4044,8089,4044,0,1,4046,788396,0.788396
4544,6653,1555,10345415,2,36358,9091,1,381140536,381140536,13633,4544,9089,4544,0,1,4546,62811,0.062811
5044,6653,1555,10345415,2,40358,10091,1,413972536,413972536,15133,5044,10089,5044,0,1,5046,184649,0.184649
5544,6653,1555,10345415,2,44358,11091,1,446804536,446804536,16633,5544,11089,5544,0,1,5546,191402,0.191402
6044,6653,1555,10345415,2,48358,12091,1,479636536,479636536,18133,6044,12089,6044,0,1,6046,170972,0.170972
6544,6653,1555,10345415,2,52358,13091,1,512468536,512468536,19633,6544,13089,6544,0,1,6546,5480987,5.480987
7044,6653,1555,10345415,2,56358,14091,1,545300536,545300536,21133,7044,14089,7044,0,1,7046,1709175,1.709175
55,5555,1865,10360075,2,446,113,1,86145400,86145400,166,55,111,55,0,1,57,207165,0.207165
455,5555,1865,10360075,2,3646,913,1,109889400,109889400,1366,455,911,455,0,1,457,983103,0.983103
855,5555,1865,10360075,2,6846,1713,1,133633400,133633400,2566,855,1711,855,0,1,857,956218,0.956218
1255,5555,1865,10360075,2,10046,2513,1,157377400,157377400,3766,1255,2511,1255,0,1,1257,1334472,1.334472
1655,5555,1865,10360075,2,13246,3313,1,181121400,181121400,4966,1655,3311,1655,0,1,1657,1447869,1.447869
2055,5555,1865,10360075,2,16446,4113,1,204865400,204865400,6166,2055,4111,2055,0,1,2057,4139483,4.139483
2455,5555,1865,10360075,2,19646,4913,1,228609400,228609400,7366,2455,4911,2455,0,1,2457,4324416,4.324416
2855,5555,1865,10360075,2,22846,5713,1,252353400,252353400,8566,2855,5711,2855,0,1,2857,5331742,5.331742
3255,5555,1865,10360075,2,26046,6513,1,276097400,276097400,9766,3255,6511,3255,0,1,3257,688284,0.688284
3655,5555,1865,10360075,2,29246,7313,1,299841400,299841400,10966,3655,7311,3655,0,1,3657,115440,0.11544
4055,5555,1865,10360075,2,32446,8113,1,323585400,323585400,12166,4055,8111,4055,0,1,4057,1973305,1.973305
4455,5555,1865,10360075,2,35646,8913,1,347329400,347329400,13366,4455,8911,4455,0,1,4457,916934,0.916934
4855,5555,1865,10360075,2,38846,9713,1,371073400,371073400,14566,4855,9711,4855,0,1,4857,2211717,2.211717
5255,5555,1865,10360075,2,42046,10513,1,394817400,394817400,15766,5255,10511,5255,0,1,5257,3806785,3.806785
5655,5555,1865,10360075,2,45246,11313,1,418561400,418561400,16966,5655,11311,5655,0,1,5657,1183158,1.183158
6055,5555,1865,10360075,2,48446,12113,1,442305400,442305400,18166,6055,12111,6055,0,1,6057,12116223,12.116223
6455,5555,1865,10360075,2,51646,12913,1,466049400,466049400,19366,6455,12911,6455,0,1,6457,6870616,6.870616
6855,5555,1865,10360075,2,54846,13713,1,489793400,489793400,20566,6855,13711,6855,0,1,6857,7705022,7.705022
55,1555,6665,10364075,2,446,113,1,86529400,86529400,166,55,111,55,0,1,57,212710,0.21271
455,1555,6665,10364075,2,3646,913,1,112833400,112833400,1366,455,911,455,0,1,457,999776,0.999776
855,1555,6665,10364075,2,6846,1713,1,139137400,139137400,2566,855,1711,855,0,1,857,1791393,1.791393
1255,1555,6665,10364075,2,10046,2513,1,165441400,165441400,3766,1255,2511,1255,0,1,1257,1322134,1.322134
1655,1555,6665,10364075,2,13246,3313,1,191745400,191745400,4966,1655,3311,1655,0,1,1657,249374,0.249374
2055,1555,6665,10364075,2,16446,4113,1,218049400,218049400,6166,2055,4111,2055,0,1,2057,2321475,2.321475
2455,1555,6665,10364075,2,19646,4913,1,244353400,244353400,7366,2455,4911,2455,0,1,2457,522341,0.522341
2855,1555,6665,10364075,2,22846,5713,1,270657400,270657400,8566,2855,5711,2855,0,1,2857,2274676,2.274676
3255,1555,6665,10364075,2,26046,6513,1,296961400,296961400,9766,3255,6511,3255,0,1,3257,1987813,1.987813
3655,1555,6665,10364075,2,29246,7313,1,323265400,323265400,10966,3655,7311,3655,0,1,3657,5112507,5.112507
4055,1555,6665,10364075,2,32446,8113,1,349569400,349569400,12166,4055,8111,4055,0,1,4057,3340740,3.34074
4455,1555,6665,10364075,2,35646,8913,1,375873400,375873400,13366,4455,8911,4455,0,1,4457,746783,0.746783
4855,1555,6665,10364075,2,38846,9713,1,402177400,402177400,14566,4855,9711,4855,0,1,4857,1275482,1.275482
5255,1555,6665,10364075,2,42046,10513,1,428481400,428481400,15766,5255,10511,5255,0,1,5257,334102,0.334102
5655,1555,6665,10364075,2,45246,11313,1,454785400,454785400,16966,5655,11311,5655,0,1,5657,266306,0.266306
6055,1555,6665,10364075,2,48446,12113,1,481089400,481089400,18166,6055,12111,6055,0,1,6057,1919316,1.919316
6455,1555,6665,10364075,2,51646,12913,1,507393400,507393400,19366,6455,12911,6455,0,1,6457,3032215,3.032215
6855,1555,6665,10364075,2,54846,13713,1,533697400,533697400,20566,6855,13711,6855,0,1,6857,46286,0.046286
55,4805,2165,10402825,2,446,113,1,86289400,86289400,166,55,111,55,0,1,57,210514,0.210514
455,4805,2165,10402825,2,3646,913,1,108593400,108593400,1366,455,911,455,0,1,457,964281,0.964281
855,4805,2165,10402825,2,6846,1713,1,130897400,130897400,2566,855,1711,855,0,1,857,1600006,1.600006
1255,4805,2165,10402825,2,10046,2513,1,153201400,153201400,3766,1255,2511,1255,0,1,1257,111160,0.11116
1655,4805,2165,10402825,2,13246,3313,1,175505400,175505400,4966,1655,3311,1655,0,1,1657,138570,0.13857
2055,4805,2165,10402825,2,16446,4113,1,197809400,197809400,6166,2055,4111,2055,0,1,2057,2987911,2.987911
2455,4805,2165,10402825,2,19646,4913,1,220113400,220113400,7366,2455,4911,2455,0,1,2457,4177427,4.177427
2855,4805,2165,10402825,2,22846,5713,1,242417400,242417400,8566,2855,5711,2855,0,1,2857,5449145,5.449145
3255,4805,2165,10402825,2,26046,6513,1,264721400,264721400,9766,3255,6511,3255,0,1,3257,2699105,2.699105
3655,4805,2165,10402825,2,29246,7313,1,287025400,287025400,10966,3655,7311,3655,0,1,3657,3338343,3.338343
4055,4805,2165,10402825,2,32446,8113,1,309329400,309329400,12166,4055,8111,4055,0,1,4057,1622308,1.622308
4455,4805,2165,10402825,2,35646,8913,1,331633400,331633400,13366,4455,8911,4455,0,1,4457,7466156,7.466156
4855,4805,2165,10402825,2,38846,9713,1,353937400,353937400,14566,4855,9711,4855,0,1,4857,2885840,2.88584
5255,4805,2165,10402825,2,42046,10513,1,376241400,376241400,15766,5255,10511,5255,0,1,5257,8831921,8.831921
5655,4805,2165,10402825,2,45246,11313,1,398545400,398545400,16966,5655,11311,5655,0,1,5657,3041933,3.041933
6055,4805,2165,10402825,2,48446,12113,1,420849400,420849400,18166,6055,12111,6055,0,1,6057,5985732,5.985732
6455,4805,2165,10402825,2,51646,12913,1,443153400,443153400,19366,6455,12911,6455,0,1,6457,3529467,3.529467
6855,4805,2165,10402825,2,54846,13713,1,465457400,465457400,20566,6855,13711,6855,0,1,6857,13356271,13.356271
55,1805,5765,10405825,2,446,113,1,86577400,86577400,166,55,111,55,0,1,57,221915,0.221915
455,1805,5765,10405825,2,3646,913,1,110801400,110801400,1366,455,911,455,0,1,457,1011180,1.01118
855,1805,5765,10405825,2,6846,1713,1,135025400,135025400,2566,855,1711,855,0,1,857,36005,0.036005
1255,1805,5765,10405825,2,10046,2513,1,159249400,159249400,3766,1255,2511,1255,0,1,1257,694272,0.694272
1655,1805,5765,10405825,2,13246,3313,1,183473400,183473400,4966,1655,3311,1655,0,1,1657,262235,0.262235
2055,1805,5765,10405825,2,16446,4113,1,207697400,207697400,6166,2055,4111,2055,0,1,2057,20886,0.020886
2455,1805,5765,10405825,2,19646,4913,1,231921400,231921400,7366,2455,4911,2455,0,1,2457,1017061,1.017061
2855,1805,5765,10405825,2,22846,5713,1,256145400,256145400,8566,2855,5711,2855,0,1,2857,2304081,2.304081
3255,1805,5765,10405825,2,26046,6513,1,280369400,280369400,9766,3255,6511,3255,0,1,3257,1543379,1.543379
3655,1805,5765,10405825,2,29246,7313,1,304593400,304593400,10966,3655,7311,3655,0,1,3657,1028701,1.028701
4055,1805,5765,10405825,2,32446,8113,1,328817400,328817400,12166,4055,8111,4055,0,1,4057,1305754,1.305754
4455,1805,5765,10405825,2,35646,8913,1,353041400,353041400,13366,4455,8911,4455,0,1,4457,1260557,1.260557
4855,1805,5765,10405825,2,38846,9713,1,377265400,377265400,14566,4855,9711,4855,0,1,4857,2166929,2.166929
5255,1805,5765,10405825,2,42046,10513,1,401489400,401489400,15766,5255,10511,5255,0,1,5257,4790966,4.790966
5655,1805,5765,10405825,2,45246,11313,1,425713400,425713400,16966,5655,11311,5655,0,1,5657,697711,0.697711
6055,1805,5765,10405825,2,48446,12113,1,449937400,449937400,18166,6055,12111,6055,0,1,6057,1130720,1.13072
6455,1805,5765,10405825,2,51646,12913,1,474161400,474161400,19366,6455,12911,6455,0,1,6457,2598689,2.598689
6855,1805,5765,10405825,2,54846,13713,1,498385400,498385400,20566,6855,13711,6855,0,1,6857,43989,0.043989
40,3800,2740,10412000,2,326,83,1,85388800,85388800,121,40,81,40,0,1,42,186644,0.186644
440,3800,2740,10412000,2,3526,883,1,106316800,106316800,1321,440,881,440,0,1,442,328916,0.328916
840,3800,2740,10412000,2,6726,1683,1,127244800,127244800,2521,840,1681,840,0,1,842,1764595,1.764595
1240,3800,2740,10412000,2,9926,2483,1,148172800,148172800,3721,1240,2481,1240,0,1,1242,2558689,2.558689
1640,3800,2740,10412000,2,13126,3283,1,169100800,169100800,4921,1640,3281,1640,0,1,1642,1184810,1.18481
2040,3800,2740,10412000,2,16326,4083,1,190028800,190028800,6121,2040,4081,2040,0,1,2042,4159966,4.159966
2440,3800,2740,10412000,2,19526,4883,1,210956800,210956800,7321,2440,4881,2440,0,1,2442,4960893,4.960893
2840,3800,2740,10412000,2,22726,5683,1,231884800,231884800,8521,2840,5681,2840,0,1,2842,1672749,1.672749
3240,3800,2740,10412000,2,25926,6483,1,252812800,252812800,9721,3240,6481,3240,0,1,3242,183212,0.183212
3640,3800,2740,10412000,2,29126,7283,1,273740800,273740800,10921,3640,7281,3640,0,1,3642,499401,0.499401
4040,3800,2740,10412000,2,32326,8083,1,294668800,294668800,12121,4040,8081,4040,0,1,4042,8004515,8.004515
4440,3800,2740,10412000,2,35526,8883,1,315596800,315596800,13321,4440,8881,4440,0,1,4442,4242515,4.242515
4840,3800,2740,10412000,2,38726,9683,1,336524800,336524800,14521,4840,9681,4840,0,1,4842,2784523,2.784523
5240,3800,2740,10412000,2,41926,10483,1,357452800,357452800,15721,5240,10481,5240,0,1,5242,1983943,1.983943
5640,3800,2740,10412000,2,45126,11283,1,378380800,378380800,16921,5640,11281,5640,0,1,5642,1341247,1.341247
6040,3800,2740,10412000,2,48326,12083,1,399308800,399308800,18121,6040,12081,6040,0,1,6042,2085230,2.08523
6440,3800,2740,10412000,2,51526,12883,1,420236800,420236800,19321,6440,12881,6440,0,1,6442,110336,0.110336
6840,3800,2740,10412000,2,54726,13683,1,441164800,441164800,20521,6840,13681,6840,0,1,6842,1427762,1.427762
40,2300,4540,10442000,2,326,83,1,85724800,85724800,121,40,81,40,0,1,42,194815,0.194815
440,2300,4540,10442000,2,3526,883,1,107612800,107612800,1321,440,881,440,0,1,442,991526,0.991526
840,2300,4540,10442000,2,6726,1683,1,129500800,129500800,2521,840,1681,840,0,1,842,1070150,1.07015
1240,2300,4540,10442000,2,9926,2483,1,151388800,151388800,3721,1240,2481,1240,0,1,1242,1227176,1.227176
1640,2300,4540,10442000,2,13126,3283,1,173276800,173276800,4921,1640,3281,1640,0,1,1642,1493878,1.493878
2040,2300,4540,10442000,2,16326,4083,1,195164800,195164800,6121,2040,4081,2040,0,1,2042,215371,0.215371
2440,2300,4540,10442000,2,19526,4883,1,217052800,217052800,7321,2440,4881,2440,0,1,2442,4199005,4.199005
2840,2300,4540,10442000,2,22726,5683,1,238940800,238940800,8521,2840,5681,2840,0,1,2842,4063667,4.063667
3240,2300,4540,10442000,2,25926,6483,1,260828800,260828800,9721,3240,6481,3240,0,1,3242,318343,0.318343
3640,2300,4540,10442000,2,29126,7283,1,282716800,282716800,10921,3640,7281,3640,0,1,3642,781441,0.781441
4040,2300,4540,10442000,2,32326,8083,1,304604800,304604800,12121,4040,8081,4040,0,1,4042,811861,0.811861
4440,2300,4540,10442000,2,35526,8883,1,326492800,326492800,13321,4440,8881,4440,0,1,4442,1912350,1.91235
4840,2300,4540,10442000,2,38726,9683,1,348380800,348380800,14521,4840,9681,4840,0,1,4842,578210,0.57821
5240,2300,4540,10442000,2,41926,10483,1,370268800,370268800,15721,5240,10481,5240,0,1,5242,510338,0.510338
5640,2300,4540,10442000,2,45126,11283,1,392156800,392156800,16921,5640,11281,5640,0,1,5642,132475,0.132475
6040,2300,4540,10442000,2,48326,12083,1,414044800,414044800,18121,6040,12081,6040,0,1,6042,739625,0.739625
6440,2300,4540,10442000,2,51526,12883,1,435932800,435932800,19321,6440,12881,6440,0,1,6442,2415960,2.41596
6840,2300,4540,10442000,2,54726,13683,1,457820800,457820800,20521,6840,13681,6840,0,1,6842,1802523,1.802523
40,6800,1540,10472000,2,326,83,1,86444800,86444800,121,40,81,40,0,1,42,182841,0.182841
440,6800,1540,10472000,2,3526,883,1,113132800,113132800,1321,440,881,440,0,1,442,235851,0.235851
840,6800,1540,10472000,2,6726,1683,1,139820800,139820800,2521,840,1681,840,0,1,842,594767,0.594767
1240,6800,1540,10472000,2,9926,2483,1,166508800,166508800,3721,1240,2481,1240,0,1,1242,2586607,2.586607
1640,6800,1540,10472000,2,13126,3283,1,193196800,193196800,4921,1640,3281,1640,0,1,1642,909768,0.909768
2040,6800,1540,10472000,2,16326,4083,1,219884800,219884800,6121,2040,4081,2040,0,1,2042,2710355,2.710355
2440,6800,1540,10472000,2,19526,4883,1,246572800,246572800,7321,2440,4881,2440,0,1,2442,3220200,3.2202
2840,6800,1540,10472000,2,22726,5683,1,273260800,273260800,8521,2840,5681,2840,0,1,2842,696405,0.696405
3240,6800,1540,10472000,2,25926,6483,1,299948800,299948800,9721,3240,6481,3240,0,1,3242,1307661,1.307661
3640,6800,1540,10472000,2,29126,7283,1,326636800,326636800,10921,3640,7281,3640,0,1,3642,809945,0.809945
4040,6800,1540,10472000,2,32326,8083,1,353324800,353324800,12121,4040,8081,4040,0,1,4042,1038258,1.038258
4440,6800,1540,10472000,2,35526,8883,1,380012800,380012800,13321,4440,8881,4440,0,1,4442,3807228,3.807228
4840,6800,1540,10472000,2,38726,9683,1,406700800,406700800,14521,4840,9681,4840,0,1,4842,1053517,1.053517
5240,6800,1540,10472000,2,41926,10483,1,433388800,433388800,15721,5240,10481,5240,0,1,5242,2937494,2.937494
5640,6800,1540,10472000,2,45126,11283,1,460076800,460076800,16921,5640,11281,5640,0,1,5642,66860,0.06686
6040,6800,1540,10472000,2,48326,12083,1,486764800,486764800,18121,6040,12081,6040,0,1,6042,10980233,10.980233
6440,6800,1540,10472000,2,51526,12883,1,513452800,513452800,19321,6440,12881,6440,0,1,6442,3915192,3.915192
6840,6800,1540,10472000,2,54726,13683,1,540140800,540140800,20521,6840,13681,6840,0,1,6842,4292855,4.292855
40,4300,2440,10492000,2,326,83,1,86092800,86092800,121,40,81,40,0,1,42,186591,0.186591
440,4300,2440,10492000,2,3526,883,1,107660800,107660800,1321,440,881,440,0,1,442,327735,0.327735
840,4300,2440,10492000,2,6726,1683,1,129228800,129228800,2521,840,1681,840,0,1,842,86644,0.086644
1240,4300,2440,10492000,2,9926,2483,1,150796800,150796800,3721,1240,2481,1240,0,1,1242,9515,0.009515
1640,4300,2440,10492000,2,13126,3283,1,172364800,172364800,4921,1640,3281,1640,0,1,1642,2539980,2.53998
2040,4300,2440,10492000,2,16326,4083,1,193932800,193932800,6121,2040,4081,2040,0,1,2042,1443202,1.443202
2440,4300,2440,10492000,2,19526,4883,1,215500800,215500800,7321,2440,4881,2440,0,1,2442,1895343,1.895343
2840,4300,2440,10492000,2,22726,5683,1,237068800,237068800,8521,2840,5681,2840,0,1,2842,75272,0.075272
3240,4300,2440,10492000,2,25926,6483,1,258636800,258636800,9721,3240,6481,3240,0,1,3242,5350693,5.350693
3640,4300,2440,10492000,2,29126,7283,1,280204800,280204800,10921,3640,7281,3640,0,1,3642,3399136,3.399136
4040,4300,2440,10492000,2,32326,8083,1,301772800,301772800,12121,4040,8081,4040,0,1,4042,99302,0.099302
4440,4300,2440,10492000,2,35526,8883,1,323340800,323340800,13321,4440,8881,4440,0,1,4442,1596853,1.596853
4840,4300,2440,10492000,2,38726,9683,1,344908800,344908800,14521,4840,9681,4840,0,1,4842,4678553,4.678553
5240,4300,2440,10492000,2,41926,10483,1,366476800,366476800,15721,5240,10481,5240,0,1,5242,1266627,1.266627
5640,4300,2440,10492000,2,45126,11283,1,388044800,388044800,16921,5640,11281,5640,0,1,5642,186334,0.186334
6040,4300,2440,10492000,2,48326,12083,1,409612800,409612800,18121,6040,12081,6040,0,1,6042,1071195,1.071195
6440,4300,2440,10492000,2,51526,12883,1,431180800,431180800,19321,6440,12881,6440,0,1,6442,1405675,1.405675
6840,4300,2440,10492000,2,54726,13683,1,452748800,452748800,20521,6840,13681,6840,0,1,6842,1411984,1.411984
55,3805,2765,10520825,2,446,113,1,87057400,87057400,166,55,111,55,0,1,57,221013,0.221013
455,3805,2765,10520825,2,3646,913,1,108081400,108081400,1366,455,911,455,0,1,457,1021525,1.021525
855,3805,2765,10520825,2,6846,1713,1,129105400,129105400,2566,855,1711,855,0,1,857,1840768,1.840768
1255,3805,2765,10520825,2,10046,2513,1,150129400,150129400,3766,1255,2511,1255,0,1,1257,2671618,2.671618
1655,3805,2765,10520825,2,13246,3313,1,171153400,171153400,4966,1655,3311,1655,0,1,1657,3451854,3.451854
2055,3805,2765,10520825,2,16446,4113,1,192177400,192177400,6166,2055,4111,2055,0,1,2057,1712314,1.712314
2455,3805,2765,10520825,2,19646,4913,1,213201400,213201400,7366,2455,4911,2455,0,1,2457,1202821,1.202821
2855,3805,2765,10520825,2,22846,5713,1,234225400,234225400,8566,2855,5711,2855,0,1,2857,85876,0.085876
3255,3805,2765,10520825,2,26046,6513,1,255249400,255249400,9766,3255,6511,3255,0,1,3257,3601736,3.601736
3655,3805,2765,10520825,2,29246,7313,1,276273400,276273400,10966,3655,7311,3655,0,1,3657,4433091,4.433091
4055,3805,2765,10520825,2,32446,8113,1,297297400,297297400,12166,4055,8111,4055,0,1,4057,736358,0.736358
4455,3805,2765,10520825,2,35646,8913,1,318321400,318321400,13366,4455,8911,4455,0,1,4457,4369612,4.369612
4855,3805,2765,10520825,2,38846,9713,1,339345400,339345400,14566,4855,9711,4855,0,1,4857,737916,0.737916
5255,3805,2765,10520825,2,42046,10513,1,360369400,360369400,15766,5255,10511,5255,0,1,5257,524364,0.524364
5655,3805,2765,10520825,2,45246,11313,1,381393400,381393400,16966,5655,11311,5655,0,1,5657,187523,0.187523
6055,3805,2765,10520825,2,48446,12113,1,402417400,402417400,18166,6055,12111,6055,0,1,6057,164609,0.164609
6455,3805,2765,10520825,2,51646,12913,1,423441400,423441400,19366,6455,12911,6455,0,1,6457,225836,0.225836
6855,3805,2765,10520825,2,54846,13713,1,444465400,444465400,20566,6855,13711,6855,0,1,6857,387618,0.387618
55,2305,4565,10522325,2,446,113,1,87201400,87201400,166,55,111,55,0,1,57,219067,0.219067
455,2305,4565,10522325,2,3646,913,1,109185400,109185400,1366,455,911,455,0,1,457,969212,0.969212
855,2305,4565,10522325,2,6846,1713,1,131169400,131169400,2566,855,1711,855,0,1,857,424554,0.424554
1255,2305,4565,10522325,2,10046,2513,1,153153400,153153400,3766,1255,2511,1255,0,1,1257,2520286,2.520286
1655,2305,4565,10522325,2,13246,3313,1,175137400,175137400,4966,1655,3311,1655,0,1,1657,1524978,1.524978
2055,2305,4565,10522325,2,16446,4113,1,197121400,197121400,6166,2055,4111,2055,0,1,2057,3184018,3.184018
2455,2305,4565,10522325,2,19646,4913,1,219105400,219105400,7366,2455,4911,2455,0,1,2457,4114679,4.114679
2855,2305,4565,10522325,2,22846,5713,1,241089400,241089400,8566,2855,5711,2855,0,1,2857,3357471,3.357471
3255,2305,4565,10522325,2,26046,6513,1,263073400,263073400,9766,3255,6511,3255,0,1,3257,1140496,1.140496
3655,2305,4565,10522325,2,29246,7313,1,285057400,285057400,10966,3655,7311,3655,0,1,3657,2462766,2.462766
4055,2305,4565,10522325,2,32446,8113,1,307041400,307041400,12166,4055,8111,4055,0,1,4057,2569727,2.569727
4455,2305,4565,10522325,2,35646,8913,1,329025400,329025400,13366,4455,8911,4455,0,1,4457,462800,0.4628
4855,2305,4565,10522325,2,38846,9713,1,351009400,351009400,14566,4855,9711,4855,0,1,4857,3206157,3.206157
5255,2305,4565,10522325,2,42046,10513,1,372993400,372993400,15766,5255,10511,5255,0,1,5257,316041,0.316041
5655,2305,4565,10522325,2,45246,11313,1,394977400,394977400,16966,5655,11311,5655,0,1,5657,991597,0.991597
6055,2305,4565,10522325,2,48446,12113,1,416961400,416961400,18166,6055,12111,6055,0,1,6057,1310501,1.310501
6455,2305,4565,10522325,2,51646,12913,1,438945400,438945400,19366,6455,12911,6455,0,1,6457,2413586,2.413586
6855,2305,4565,10522325,2,54846,13713,1,460929400,460929400,20566,6855,13711,6855,0,1,6857,3328321,3.328321
40,2050,5140,10537000,2,326,83,1,86596800,86596800,121,40,81,40,0,1,42,7426,0.007426
440,2050,5140,10537000,2,3526,883,1,109604800,109604800,1321,440,881,440,0,1,442,87354,0.087354
840,2050,5140,10537000,2,6726,1683,1,132612800,132612800,2521,840,1681,840,0,1,842,187668,0.187668
1240,2050,5140,10537000,2,9926,2483,1,155620800,155620800,3721,1240,2481,1240,0,1,1242,87276,0.087276
1640,2050,5140,10537000,2,13126,3283,1,178628800,178628800,4921,1640,3281,1640,0,1,1642,343418,0.343418
2040,2050,5140,10537000,2,16326,4083,1,201636800,201636800,6121,2040,4081,2040,0,1,2042,147665,0.147665
2440,2050,5140,10537000,2,19526,4883,1,224644800,224644800,7321,2440,4881,2440,0,1,2442,67589,0.067589
2840,2050,5140,10537000,2,22726,5683,1,247652800,247652800,8521,2840,5681,2840,0,1,2842,187042,0.187042
3240,2050,5140,10537000,2,25926,6483,1,270660800,270660800,9721,3240,6481,3240,0,1,3242,94402,0.094402
3640,2050,5140,10537000,2,29126,7283,1,293668800,293668800,10921,3640,7281,3640,0,1,3642,44683,0.044683
4040,2050,5140,10537000,2,32326,8083,1,316676800,316676800,12121,4040,8081,4040,0,1,4042,187685,0.187685
4440,2050,5140,10537000,2,35526,8883,1,339684800,339684800,13321,4440,8881,4440,0,1,4442,1008954,1.008954
4840,2050,5140,10537000,2,38726,9683,1,362692800,362692800,14521,4840,9681,4840,0,1,4842,29298,0.029298
5240,2050,5140,10537000,2,41926,10483,1,385700800,385700800,15721,5240,10481,5240,0,1,5242,155025,0.155025
5640,2050,5140,10537000,2,45126,11283,1,408708800,408708800,16921,5640,11281,5640,0,1,5642,125318,0.125318
6040,2050,5140,10537000,2,48326,12083,1,431716800,431716800,18121,6040,12081,6040,0,1,6042,80330,0.08033
6440,2050,5140,10537000,2,51526,12883,1,454724800,454724800,19321,6440,12881,6440,0,1,6442,128164,0.128164
6840,2050,5140,10537000,2,54726,13683,1,477732800,477732800,20521,6840,13681,6840,0,1,6842,167111,0.167111
55,4305,2465,10611825,2,446,113,1,87873400,87873400,166,55,111,55,0,1,57,212473,0.212473
455,4305,2465,10611825,2,3646,913,1,109537400,109537400,1366,455,911,455,0,1,457,983480,0.98348
855,4305,2465,10611825,2,6846,1713,1,131201400,131201400,2566,855,1711,855,0,1,857,604445,0.604445
1255,4305,2465,10611825,2,10046,2513,1,152865400,152865400,3766,1255,2511,1255,0,1,1257,1453573,1.453573
1655,4305,2465,10611825,2,13246,3313,1,174529400,174529400,4966,1655,3311,1655,0,1,1657,3097,0.003097
2055,4305,2465,10611825,2,16446,4113,1,196193400,196193400,6166,2055,4111,2055,0,1,2057,893169,0.893169
2455,4305,2465,10611825,2,19646,4913,1,217857400,217857400,7366,2455,4911,2455,0,1,2457,644791,0.644791
2855,4305,2465,10611825,2,22846,5713,1,239521400,239521400,8566,2855,5711,2855,0,1,2857,3553810,3.55381
3255,4305,2465,10611825,2,26046,6513,1,261185400,261185400,9766,3255,6511,3255,0,1,3257,74551,0.074551
3655,4305,2465,10611825,2,29246,7313,1,282849400,282849400,10966,3655,7311,3655,0,1,3657,595072,0.595072
4055,4305,2465,10611825,2,32446,8113,1,304513400,304513400,12166,4055,8111,4055,0,1,4057,4060115,4.060115
4455,4305,2465,10611825,2,35646,8913,1,326177400,326177400,13366,4455,8911,4455,0,1,4457,310062,0.310062
4855,4305,2465,10611825,2,38846,9713,1,347841400,347841400,14566,4855,9711,4855,0,1,4857,653863,0.653863
5255,4305,2465,10611825,2,42046,10513,1,369505400,369505400,15766,5255,10511,5255,0,1,5257,1416968,1.416968
5655,4305,2465,10611825,2,45246,11313,1,391169400,391169400,16966,5655,11311,5655,0,1,5657,1868481,1.868481
6055,4305,2465,10611825,2,48446,12113,1,412833400,412833400,18166,6055,12111,6055,0,1,6057,270419,0.270419
6455,4305,2465,10611825,2,51646,12913,1,434497400,434497400,19366,6455,12911,6455,0,1,6457,156664,0.156664
6855,4305,2465,10611825,2,54846,13713,1,456161400,456161400,20566,6855,13711,6855,0,1,6857,207148,0.207148
55,2055,5165,10614075,2,446,113,1,88089400,88089400,166,55,111,55,0,1,57,7303,0.007303
455,2055,5165,10614075,2,3646,913,1,111193400,111193400,1366,455,911,455,0,1,457,38843,0.038843
855,2055,5165,10614075,2,6846,1713,1,134297400,134297400,2566,855,1711,855,0,1,857,92219,0.092219
1255,2055,5165,10614075,2,10046,2513,1,157401400,157401400,3766,1255,2511,1255,0,1,1257,35248,0.035248
1655,2055,5165,10614075,2,13246,3313,1,180505400,180505400,4966,1655,3311,1655,0,1,1657,100513,0.100513
2055,2055,5165,10614075,2,16446,4113,1,203609400,203609400,6166,2055,4111,2055,0,1,2057,51956,0.051956
2455,2055,5165,10614075,2,19646,4913,1,226713400,226713400,7366,2455,4911,2455,0,1,2457,1286793,1.286793
2855,2055,5165,10614075,2,22846,5713,1,249817400,249817400,8566,2855,5711,2855,0,1,2857,37438,0.037438
3255,2055,5165,10614075,2,26046,6513,1,272921400,272921400,9766,3255,6511,3255,0,1,3257,124333,0.124333
3655,2055,5165,10614075,2,29246,7313,1,296025400,296025400,10966,3655,7311,3655,0,1,3657,248526,0.248526
4055,2055,5165,10614075,2,32446,8113,1,319129400,319129400,12166,4055,8111,4055,0,1,4057,63804,0.063804
4455,2055,5165,10614075,2,35646,8913,1,342233400,342233400,13366,4455,8911,4455,0,1,4457,555824,0.555824
4855,2055,5165,10614075,2,38846,9713,1,365337400,365337400,14566,4855,9711,4855,0,1,4857,151409,0.151409
5255,2055,5165,10614075,2,42046,10513,1,388441400,388441400,15766,5255,10511,5255,0,1,5257,1379006,1.379006
5655,2055,5165,10614075,2,45246,11313,1,411545400,411545400,16966,5655,11311,5655,0,1,5657,494941,0.494941
6055,2055,5165,10614075,2,48446,12113,1,434649400,434649400,18166,6055,12111,6055,0,1,6057,713020,0.71302
6455,2055,5165,10614075,2,51646,12913,1,457753400,457753400,19366,6455,12911,6455,0,1,6457,56034,0.056034
6855,2055,5165,10614075,2,54846,13713,1,480857400,480857400,20566,6855,13711,6855,0,1,6857,739240,0.73924
55,6805,1565,10649825,2,446,113,1,88881400,88881400,166,55,111,55,0,1,57,210356,0.210356
455,6805,1565,10649825,2,3646,913,1,115665400,115665400,1366,455,911,455,0,1,457,23107,0.023107
855,6805,1565,10649825,2,6846,1713,1,142449400,142449400,2566,855,1711,855,0,1,857,245282,0.245282
1255,6805,1565,10649825,2,10046,2513,1,169233400,169233400,3766,1255,2511,1255,0,1,1257,800051,0.800051
1655,6805,1565,10649825,2,13246,3313,1,196017400,196017400,4966,1655,3311,1655,0,1,1657,462316,0.462316
2055,6805,1565,10649825,2,16446,4113,1,222801400,222801400,6166,2055,4111,2055,0,1,2057,114661,0.114661
2455,6805,1565,10649825,2,19646,4913,1,249585400,249585400,7366,2455,4911,2455,0,1,2457,3228261,3.228261
2855,6805,1565,10649825,2,22846,5713,1,276369400,276369400,8566,2855,5711,2855,0,1,2857,40253,0.040253
3255,6805,1565,10649825,2,26046,6513,1,303153400,303153400,9766,3255,6511,3255,0,1,3257,1541575,1.541575
3655,6805,1565,10649825,2,29246,7313,1,329937400,329937400,10966,3655,7311,3655,0,1,3657,3811942,3.811942
4055,6805,1565,10649825,2,32446,8113,1,356721400,356721400,12166,4055,8111,4055,0,1,4057,4381568,4.381568
4455,6805,1565,10649825,2,35646,8913,1,383505400,383505400,13366,4455,8911,4455,0,1,4457,38463,0.038463
4855,6805,1565,10649825,2,38846,9713,1,410289400,410289400,14566,4855,9711,4855,0,1,4857,7107569,7.107569
5255,6805,1565,10649825,2,42046,10513,1,437073400,437073400,15766,5255,10511,5255,0,1,5257,544228,0.544228
5655,6805,1565,10649825,2,45246,11313,1,463857400,463857400,16966,5655,11311,5655,0,1,5657,1464225,1.464225
6055,6805,1565,10649825,2,48446,12113,1,490641400,490641400,18166,6055,12111,6055,0,1,6057,2655789,2.655789
6455,6805,1565,10649825,2,51646,12913,1,517425400,517425400,19366,6455,12911,6455,0,1,6457,926055,0.926055
6855,6805,1565,10649825,2,54846,13713,1,544209400,544209400,20566,6855,13711,6855,0,1,6857,15961,0.015961
40,5800,1840,10672000,2,326,83,1,87820800,87820800,121,40,81,40,0,1,42,208,0.000208
440,5800,1840,10672000,2,3526,883,1,112268800,112268800,1321,440,881,440,0,1,442,78968,0.078968
840,5800,1840,10672000,2,6726,1683,1,136716800,136716800,2521,840,1681,840,0,1,842,303519,0.303519
1240,5800,1840,10672000,2,9926,2483,1,161164800,161164800,3721,1240,2481,1240,0,1,1242,124117,0.124117
1640,5800,1840,10672000,2,13126,3283,1,185612800,185612800,4921,1640,3281,1640,0,1,1642,179531,0.179531
2040,5800,1840,10672000,2,16326,4083,1,210060800,210060800,6121,2040,4081,2040,0,1,2042,57066,0.057066
2440,5800,1840,10672000,2,19526,4883,1,234508800,234508800,7321,2440,4881,2440,0,1,2442,2383138,2.383138
2840,5800,1840,10672000,2,22726,5683,1,258956800,258956800,8521,2840,5681,2840,0,1,2842,447169,0.447169
3240,5800,1840,10672000,2,25926,6483,1,283404800,283404800,9721,3240,6481,3240,0,1,3242,575627,0.575627
3640,5800,1840,10672000,2,29126,7283,1,307852800,307852800,10921,3640,7281,3640,0,1,3642,2066070,2.06607
4040,5800,1840,10672000,2,32326,8083,1,332300800,332300800,12121,4040,8081,4040,0,1,4042,778454,0.778454
4440,5800,1840,10672000,2,35526,8883,1,356748800,356748800,13321,4440,8881,4440,0,1,4442,558067,0.558067
4840,5800,1840,10672000,2,38726,9683,1,381196800,381196800,14521,4840,9681,4840,0,1,4842,3110794,3.110794
5240,5800,1840,10672000,2,41926,10483,1,405644800,405644800,15721,5240,10481,5240,0,1,5242,2324109,2.324109
5640,5800,1840,10672000,2,45126,11283,1,430092800,430092800,16921,5640,11281,5640,0,1,5642,23282,0.023282
6040,5800,1840,10672000,2,48326,12083,1,454540800,454540800,18121,6040,12081,6040,0,1,6042,3552833,3.552833
6440,5800,1840,10672000,2,51526,12883,1,478988800,478988800,19321,6440,12881,6440,0,1,6442,942178,0.942178
6840,5800,1840,10672000,2,54726,13683,1,503436800,503436800,20521,6840,13681,6840,0,1,6842,269650,0.26965
40,1550,6940,10757000,2,326,83,1,88772800,88772800,121,40,81,40,0,1,42,191076,0.191076
440,1550,6940,10757000,2,3526,883,1,115940800,115940800,1321,440,881,440,0,1,442,993913,0.993913
840,1550,6940,10757000,2,6726,1683,1,143108800,143108800,2521,840,1681,840,0,1,842,1163697,1.163697
1240,1550,6940,10757000,2,9926,2483,1,170276800,170276800,3721,1240,2481,1240,0,1,1242,1425311,1.425311
1640,1550,6940,10757000,2,13126,3283,1,197444800,197444800,4921,1640,3281,1640,0,1,1642,967801,0.967801
2040,1550,6940,10757000,2,16326,4083,1,224612800,224612800,6121,2040,4081,2040,0,1,2042,748156,0.748156
2440,1550,6940,10757000,2,19526,4883,1,251780800,251780800,7321,2440,4881,2440,0,1,2442,731578,0.731578
2840,1550,6940,10757000,2,22726,5683,1,278948800,278948800,8521,2840,5681,2840,0,1,2842,2093510,2.09351
3240,1550,6940,10757000,2,25926,6483,1,306116800,306116800,9721,3240,6481,3240,0,1,3242,184110,0.18411
3640,1550,6940,10757000,2,29126,7283,1,333284800,333284800,10921,3640,7281,3640,0,1,3642,211546,0.211546
4040,1550,6940,10757000,2,32326,8083,1,360452800,360452800,12121,4040,8081,4040,0,1,4042,1860177,1.860177
4440,1550,6940,10757000,2,35526,8883,1,387620800,387620800,13321,4440,8881,4440,0,1,4442,631118,0.631118
4840,1550,6940,10757000,2,38726,9683,1,414788800,414788800,14521,4840,9681,4840,0,1,4842,2264682,2.264682
5240,1550,6940,10757000,2,41926,10483,1,441956800,441956800,15721,5240,10481,5240,0,1,5242,532016,0.532016
5640,1550,6940,10757000,2,45126,11283,1,469124800,469124800,16921,5640,11281,5640,0,1,5642,5509692,5.509692
6040,1550,6940,10757000,2,48326,12083,1,496292800,496292800,18121,6040,12081,6040,0,1,6042,97104,0.097104
6440,1550,6940,10757000,2,51526,12883,1,523460800,523460800,19321,6440,12881,6440,0,1,6442,7266155,7.266155
6840,1550,6940,10757000,2,54726,13683,1,550628800,550628800,20521,6840,13681,6840,0,1,6842,511262,0.511262
40,3550,3040,10792000,2,326,83,1,88444800,88444800,121,40,81,40,0,1,42,185406,0.185406
440,3550,3040,10792000,2,3526,883,1,109532800,109532800,1321,440,881,440,0,1,442,966012,0.966012
840,3550,3040,10792000,2,6726,1683,1,130620800,130620800,2521,840,1681,840,0,1,842,1760809,1.760809
1240,3550,3040,10792000,2,9926,2483,1,151708800,151708800,3721,1240,2481,1240,0,1,1242,1876879,1.876879
1640,3550,3040,10792000,2,13126,3283,1,172796800,172796800,4921,1640,3281,1640,0,1,1642,741196,0.741196
2040,3550,3040,10792000,2,16326,4083,1,193884800,193884800,6121,2040,4081,2040,0,1,2042,1435062,1.435062
2440,3550,3040,10792000,2,19526,4883,1,214972800,214972800,7321,2440,4881,2440,0,1,2442,45164,0.045164
2840,3550,3040,10792000,2,22726,5683,1,236060800,236060800,8521,2840,5681,2840,0,1,2842,762099,0.762099
3240,3550,3040,10792000,2,25926,6483,1,257148800,257148800,9721,3240,6481,3240,0,1,3242,332063,0.332063
3640,3550,3040,10792000,2,29126,7283,1,278236800,278236800,10921,3640,7281,3640,0,1,3642,2829476,2.829476
4040,3550,3040,10792000,2,32326,8083,1,299324800,299324800,12121,4040,8081,4040,0,1,4042,1736534,1.736534
4440,3550,3040,10792000,2,35526,8883,1,320412800,320412800,13321,4440,8881,4440,0,1,4442,1634444,1.634444
4840,3550,3040,10792000,2,38726,9683,1,341500800,341500800,14521,4840,9681,4840,0,1,4842,3393697,3.393697
5240,3550,3040,10792000,2,41926,10483,1,362588800,362588800,15721,5240,10481,5240,0,1,5242,1550685,1.550685
5640,3550,3040,10792000,2,45126,11283,1,383676800,383676800,16921,5640,11281,5640,0,1,5642,2936631,2.936631
6040,3550,3040,10792000,2,48326,12083,1,404764800,404764800,18121,6040,12081,6040,0,1,6042,24408,0.024408
6440,3550,3040,10792000,2,51526,12883,1,425852800,425852800,19321,6440,12881,6440,0,1,6442,884285,0.884285
6840,3550,3040,10792000,2,54726,13683,1,446940800,446940800,20521,6840,13681,6840,0,1,6842,13321350,13.32135
40,5050,2140,10807000,2,326,83,1,88756800,88756800,121,40,81,40,0,1,42,460,0.00046
440,5050,2140,10807000,2,3526,883,1,111764800,111764800,1321,440,881,440,0,1,442,55298,0.055298
840,5050,2140,10807000,2,6726,1683,1,134772800,134772800,2521,840,1681,840,0,1,842,180446,0.180446
1240,5050,2140,10807000,2,9926,2483,1,157780800,157780800,3721,1240,2481,1240,0,1,1242,147183,0.147183
1640,5050,2140,10807000,2,13126,3283,1,180788800,180788800,4921,1640,3281,1640,0,1,1642,21792,0.021792
2040,5050,2140,10807000,2,16326,4083,1,203796800,203796800,6121,2040,4081,2040,0,1,2042,203668,0.203668
2440,5050,2140,10807000,2,19526,4883,1,226804800,226804800,7321,2440,4881,2440,0,1,2442,1292053,1.292053
2840,5050,2140,10807000,2,22726,5683,1,249812800,249812800,8521,2840,5681,2840,0,1,2842,47183,0.047183
3240,5050,2140,10807000,2,25926,6483,1,272820800,272820800,9721,3240,6481,3240,0,1,3242,1205710,1.20571
3640,5050,2140,10807000,2,29126,7283,1,295828800,295828800,10921,3640,7281,3640,0,1,3642,15019,0.015019
4040,5050,2140,10807000,2,32326,8083,1,318836800,318836800,12121,4040,8081,4040,0,1,4042,1444237,1.444237
4440,5050,2140,10807000,2,35526,8883,1,341844800,341844800,13321,4440,8881,4440,0,1,4442,3396104,3.396104
4840,5050,2140,10807000,2,38726,9683,1,364852800,364852800,14521,4840,9681,4840,0,1,4842,566935,0.566935
5240,5050,2140,10807000,2,41926,10483,1,387860800,387860800,15721,5240,10481,5240,0,1,5242,3498631,3.498631
5640,5050,2140,10807000,2,45126,11283,1,410868800,410868800,16921,5640,11281,5640,0,1,5642,996424,0.996424
6040,5050,2140,10807000,2,48326,12083,1,433876800,433876800,18121,6040,12081,6040,0,1,6042,21871,0.021871
6440,5050,2140,10807000,2,51526,12883,1,456884800,456884800,19321,6440,12881,6440,0,1,6442,773729,0.773729
6840,5050,2140,10807000,2,54726,13683,1,479892800,479892800,20521,6840,13681,6840,0,1,6842,264632,0.264632
40,2550,4240,10812000,2,326,83,1,88668800,88668800,121,40,81,40,0,1,42,188135,0.188135
440,2550,4240,10812000,2,3526,883,1,110396800,110396800,1321,440,881,440,0,1,442,25863,0.025863
840,2550,4240,10812000,2,6726,1683,1,132124800,132124800,2521,840,1681,840,0,1,842,989281,0.989281
1240,2550,4240,10812000,2,9926,2483,1,153852800,153852800,3721,1240,2481,1240,0,1,1242,195664,0.195664
1640,2550,4240,10812000,2,13126,3283,1,175580800,175580800,4921,1640,3281,1640,0,1,1642,1218996,1.218996
2040,2550,4240,10812000,2,16326,4083,1,197308800,197308800,6121,2040,4081,2040,0,1,2042,4083694,4.083694
2440,2550,4240,10812000,2,19526,4883,1,219036800,219036800,7321,2440,4881,2440,0,1,2442,445910,0.44591
2840,2550,4240,10812000,2,22726,5683,1,240764800,240764800,8521,2840,5681,2840,0,1,2842,637923,0.637923
3240,2550,4240,10812000,2,25926,6483,1,262492800,262492800,9721,3240,6481,3240,0,1,3242,4596821,4.596821
3640,2550,4240,10812000,2,29126,7283,1,284220800,284220800,10921,3640,7281,3640,0,1,3642,680673,0.680673
4040,2550,4240,10812000,2,32326,8083,1,305948800,305948800,12121,4040,8081,4040,0,1,4042,1665046,1.665046
4440,2550,4240,10812000,2,35526,8883,1,327676800,327676800,13321,4440,8881,4440,0,1,4442,453085,0.453085
4840,2550,4240,10812000,2,38726,9683,1,349404800,349404800,14521,4840,9681,4840,0,1,4842,1274624,1.274624
5240,2550,4240,10812000,2,41926,10483,1,371132800,371132800,15721,5240,10481,5240,0,1,5242,1170535,1.170535
5640,2550,4240,10812000,2,45126,11283,1,392860800,392860800,16921,5640,11281,5640,0,1,5642,4300118,4.300118
6040,2550,4240,10812000,2,48326,12083,1,414588800,414588800,18121,6040,12081,6040,0,1,6042,749140,0.74914
6440,2550,4240,10812000,2,51526,12883,1,436316800,436316800,19321,6440,12881,6440,0,1,6442,604243,0.604243
6840,2550,4240,10812000,2,54726,13683,1,458044800,458044800,20521,6840,13681,6840,0,1,6842,4271330,4.27133
55,5805,1865,10826325,2,446,113,1,89985400,89985400,166,55,111,55,0,1,57,30460,0.03046
455,5805,1865,10826325,2,3646,913,1,114529400,114529400,1366,455,911,455,0,1,457,287,0.000287
855,5805,1865,10826325,2,6846,1713,1,139073400,139073400,2566,855,1711,855,0,1,857,318818,0.318818
1255,5805,1865,10826325,2,10046,2513,1,163617400,163617400,3766,1255,2511,1255,0,1,1257,82023,0.082023
1655,5805,1865,10826325,2,13246,3313,1,188161400,188161400,4966,1655,3311,1655,0,1,1657,680097,0.680097
2055,5805,1865,10826325,2,16446,4113,1,212705400,212705400,6166,2055,4111,2055,0,1,2057,75907,0.075907
2455,5805,1865,10826325,2,19646,4913,1,237249400,237249400,7366,2455,4911,2455,0,1,2457,84302,0.084302
2855,5805,1865,10826325,2,22846,5713,1,261793400,261793400,8566,2855,5711,2855,0,1,2857,125344,0.125344
3255,5805,1865,10826325,2,26046,6513,1,286337400,286337400,9766,3255,6511,3255,0,1,3257,247247,0.247247
3655,5805,1865,10826325,2,29246,7313,1,310881400,310881400,10966,3655,7311,3655,0,1,3657,61383,0.061383
4055,5805,1865,10826325,2,32446,8113,1,335425400,335425400,12166,4055,8111,4055,0,1,4057,803265,0.803265
4455,5805,1865,10826325,2,35646,8913,1,359969400,359969400,13366,4455,8911,4455,0,1,4457,359621,0.359621
4855,5805,1865,10826325,2,38846,9713,1,384513400,384513400,14566,4855,9711,4855,0,1,4857,847790,0.84779
5255,5805,1865,10826325,2,42046,10513,1,409057400,409057400,15766,5255,10511,5255,0,1,5257,14748,0.014748
5655,5805,1865,10826325,2,45246,11313,1,433601400,433601400,16966,5655,11311,5655,0,1,5657,608244,0.608244
6055,5805,1865,10826325,2,48446,12113,1,458145400,458145400,18166,6055,12111,6055,0,1,6057,48977,0.048977
6455,5805,1865,10826325,2,51646,12913,1,482689400,482689400,19366,6455,12911,6455,0,1,6457,581957,0.581957
6855,5805,1865,10826325,2,54846,13713,1,507233400,507233400,20566,6855,13711,6855,0,1,6857,107359,0.107359
55,1555,6965,10830575,2,446,113,1,90393400,90393400,166,55,111,55,0,1,57,223129,0.223129
455,1555,6965,10830575,2,3646,913,1,117657400,117657400,1366,455,911,455,0,1,457,1037627,1.037627
855,1555,6965,10830575,2,6846,1713,1,144921400,144921400,2566,855,1711,855,0,1,857,1419616,1.419616
1255,1555,6965,10830575,2,10046,2513,1,172185400,172185400,3766,1255,2511,1255,0,1,1257,2701805,2.701805
1655,1555,6965,10830575,2,13246,3313,1,199449400,199449400,4966,1655,3311,1655,0,1,1657,123308,0.123308
2055,1555,6965,10830575,2,16446,4113,1,226713400,226713400,6166,2055,4111,2055,0,1,2057,2779304,2.779304
2455,1555,6965,10830575,2,19646,4913,1,253977400,253977400,7366,2455,4911,2455,0,1,2457,967626,0.967626
2855,1555,6965,10830575,2,22846,5713,1,281241400,281241400,8566,2855,5711,2855,0,1,2857,1682907,1.682907
3255,1555,6965,10830575,2,26046,6513,1,308505400,308505400,9766,3255,6511,3255,0,1,3257,1383109,1.383109
3655,1555,6965,10830575,2,29246,7313,1,335769400,335769400,10966,3655,7311,3655,0,1,3657,6568016,6.568016
4055,1555,6965,10830575,2,32446,8113,1,363033400,363033400,12166,4055,8111,4055,0,1,4057,4477162,4.477162
4455,1555,6965,10830575,2,35646,8913,1,390297400,390297400,13366,4455,8911,4455,0,1,4457,249402,0.249402
4855,1555,6965,10830575,2,38846,9713,1,417561400,417561400,14566,4855,9711,4855,0,1,4857,1076063,1.076063
5255,1555,6965,10830575,2,42046,10513,1,444825400,444825400,15766,5255,10511,5255,0,1,5257,1578116,1.578116
5655,1555,6965,10830575,2,45246,11313,1,472089400,472089400,16966,5655,11311,5655,0,1,5657,177357,0.177357
6055,1555,6965,10830575,2,48446,12113,1,499353400,499353400,18166,6055,12111,6055,0,1,6057,1433664,1.433664
6455,1555,6965,10830575,2,51646,12913,1,526617400,526617400,19366,6455,12911,6455,0,1,6457,5764884,5.764884
6855,1555,6965,10830575,2,54846,13713,1,553881400,553881400,20566,6855,13711,6855,0,1,6857,74042,0.074042
40,7050,1540,10857000,2,326,83,1,89604800,89604800,121,40,81,40,0,1,42,19750,0.01975
440,7050,1540,10857000,2,3526,883,1,117092800,117092800,1321,440,881,440,0,1,442,1010705,1.010705
840,7050,1540,10857000,2,6726,1683,1,144580800,144580800,2521,840,1681,840,0,1,842,1851431,1.851431
1240,7050,1540,10857000,2,9926,2483,1,172068800,172068800,3721,1240,2481,1240,0,1,1242,2687825,2.687825
1640,7050,1540,10857000,2,13126,3283,1,199556800,199556800,4921,1640,3281,1640,0,1,1642,2787710,2.78771
2040,7050,1540,10857000,2,16326,4083,1,227044800,227044800,6121,2040,4081,2040,0,1,2042,4380693,4.380693
2440,7050,1540,10857000,2,19526,4883,1,254532800,254532800,7321,2440,4881,2440,0,1,2442,5242141,5.242141
2840,7050,1540,10857000,2,22726,5683,1,282020800,282020800,8521,2840,5681,2840,0,1,2842,1765569,1.765569
3240,7050,1540,10857000,2,25926,6483,1,309508800,309508800,9721,3240,6481,3240,0,1,3242,605266,0.605266
3640,7050,1540,10857000,2,29126,7283,1,336996800,336996800,10921,3640,7281,3640,0,1,3642,4146124,4.146124
4040,7050,1540,10857000,2,32326,8083,1,364484800,364484800,12121,4040,8081,4040,0,1,4042,6696341,6.696341
4440,7050,1540,10857000,2,35526,8883,1,391972800,391972800,13321,4440,8881,4440,0,1,4442,9487142,9.487142
4840,7050,1540,10857000,2,38726,9683,1,419460800,419460800,14521,4840,9681,4840,0,1,4842,7260044,7.260044
5240,7050,1540,10857000,2,41926,10483,1,446948800,446948800,15721,5240,10481,5240,0,1,5242,11156091,11.156091
5640,7050,1540,10857000,2,45126,11283,1,474436800,474436800,16921,5640,11281,5640,0,1,5642,12025675,12.025675
6040,7050,1540,10857000,2,48326,12083,1,501924800,501924800,18121,6040,12081,6040,0,1,6042,12914145,12.914145
6440,7050,1540,10857000,2,51526,12883,1,529412800,529412800,19321,6440,12881,6440,0,1,6442,13746374,13.746374
6840,7050,1540,10857000,2,54726,13683,1,556900800,556900800,20521,6840,13681,6840,0,1,6842,14608143,14.608143
40,1800,6040,10872000,2,326,83,1,89484800,89484800,121,40,81,40,0,1,42,202102,0.202102
440,1800,6040,10872000,2,3526,883,1,114572800,114572800,1321,440,881,440,0,1,442,738055,0.738055
840,1800,6040,10872000,2,6726,1683,1,139660800,139660800,2521,840,1681,840,0,1,842,1192400,1.1924
1240,1800,6040,10872000,2,9926,2483,1,164748800,164748800,3721,1240,2481,1240,0,1,1242,81766,0.081766
1640,1800,6040,10872000,2,13126,3283,1,189836800,189836800,4921,1640,3281,1640,0,1,1642,1008829,1.008829
2040,1800,6040,10872000,2,16326,4083,1,214924800,214924800,6121,2040,4081,2040,0,1,2042,1768698,1.768698
2440,1800,6040,10872000,2,19526,4883,1,240012800,240012800,7321,2440,4881,2440,0,1,2442,2225379,2.225379
2840,1800,6040,10872000,2,22726,5683,1,265100800,265100800,8521,2840,5681,2840,0,1,2842,277773,0.277773
3240,1800,6040,10872000,2,25926,6483,1,290188800,290188800,9721,3240,6481,3240,0,1,3242,964141,0.964141
3640,1800,6040,10872000,2,29126,7283,1,315276800,315276800,10921,3640,7281,3640,0,1,3642,2170180,2.17018
4040,1800,6040,10872000,2,32326,8083,1,340364800,340364800,12121,4040,8081,4040,0,1,4042,1224282,1.224282
4440,1800,6040,10872000,2,35526,8883,1,365452800,365452800,13321,4440,8881,4440,0,1,4442,1046885,1.046885
4840,1800,6040,10872000,2,38726,9683,1,390540800,390540800,14521,4840,9681,4840,0,1,4842,1430626,1.430626
5240,1800,6040,10872000,2,41926,10483,1,415628800,415628800,15721,5240,10481,5240,0,1,5242,2251970,2.25197
5640,1800,6040,10872000,2,45126,11283,1,440716800,440716800,16921,5640,11281,5640,0,1,5642,645614,0.645614
6040,1800,6040,10872000,2,48326,12083,1,465804800,465804800,18121,6040,12081,6040,0,1,6042,47330,0.04733
6440,1800,6040,10872000,2,51526,12883,1,490892800,490892800,19321,6440,12881,6440,0,1,6442,1342794,1.342794
6840,1800,6040,10872000,2,54726,13683,1,515980800,515980800,20521,6840,13681,6840,0,1,6842,4044548,4.044548
55,3555,3065,10896075,2,446,113,1,90081400,90081400,166,55,111,55,0,1,57,226625,0.226625
455,3555,3065,10896075,2,3646,913,1,111265400,111265400,1366,455,911,455,0,1,457,1043646,1.043646
855,3555,3065,10896075,2,6846,1713,1,132449400,132449400,2566,855,1711,855,0,1,857,1594976,1.594976
1255,3555,3065,10896075,2,10046,2513,1,153633400,153633400,3766,1255,2511,1255,0,1,1257,2713935,2.713935
1655,3555,3065,10896075,2,13246,3313,1,174817400,174817400,4966,1655,3311,1655,0,1,1657,1415216,1.415216
2055,3555,3065,10896075,2,16446,4113,1,196001400,196001400,6166,2055,4111,2055,0,1,2057,475114,0.475114
2455,3555,3065,10896075,2,19646,4913,1,217185400,217185400,7366,2455,4911,2455,0,1,2457,1778860,1.77886
2855,3555,3065,10896075,2,22846,5713,1,238369400,238369400,8566,2855,5711,2855,0,1,2857,293247,0.293247
3255,3555,3065,10896075,2,26046,6513,1,259553400,259553400,9766,3255,6511,3255,0,1,3257,1344433,1.344433
3655,3555,3065,10896075,2,29246,7313,1,280737400,280737400,10966,3655,7311,3655,0,1,3657,5829523,5.829523
4055,3555,3065,10896075,2,32446,8113,1,301921400,301921400,12166,4055,8111,4055,0,1,4057,3114757,3.114757
4455,3555,3065,10896075,2,35646,8913,1,323105400,323105400,13366,4455,8911,4455,0,1,4457,145626,0.145626
4855,3555,3065,10896075,2,38846,9713,1,344289400,344289400,14566,4855,9711,4855,0,1,4857,1845393,1.845393
5255,3555,3065,10896075,2,42046,10513,1,365473400,365473400,15766,5255,10511,5255,0,1,5257,845443,0.845443
5655,3555,3065,10896075,2,45246,11313,1,386657400,386657400,16966,5655,11311,5655,0,1,5657,2006725,2.006725
6055,3555,3065,10896075,2,48446,12113,1,407841400,407841400,18166,6055,12111,6055,0,1,6057,2507681,2.507681
6455,3555,3065,10896075,2,51646,12913,1,429025400,429025400,19366,6455,12911,6455,0,1,6457,2159236,2.159236
6855,3555,3065,10896075,2,54846,13713,1,450209400,450209400,20566,6855,13711,6855,0,1,6857,1074067,1.074067
55,2555,4265,10897075,2,446,113,1,90177400,90177400,166,55,111,55,0,1,57,225089,0.225089
455,2555,4265,10897075,2,3646,913,1,112001400,112001400,1366,455,911,455,0,1,457,1012045,1.012045
855,2555,4265,10897075,2,6846,1713,1,133825400,133825400,2566,855,1711,855,0,1,857,642050,0.64205
1255,2555,4265,10897075,2,10046,2513,1,155649400,155649400,3766,1255,2511,1255,0,1,1257,2621849,2.621849
1655,2555,4265,10897075,2,13246,3313,1,177473400,177473400,4966,1655,3311,1655,0,1,1657,3422030,3.42203
2055,2555,4265,10897075,2,16446,4113,1,199297400,199297400,6166,2055,4111,2055,0,1,2057,3532212,3.532212
2455,2555,4265,10897075,2,19646,4913,1,221121400,221121400,7366,2455,4911,2455,0,1,2457,3120455,3.120455
2855,2555,4265,10897075,2,22846,5713,1,242945400,242945400,8566,2855,5711,2855,0,1,2857,604600,0.6046
3255,2555,4265,10897075,2,26046,6513,1,264769400,264769400,9766,3255,6511,3255,0,1,3257,407894,0.407894
3655,2555,4265,10897075,2,29246,7313,1,286593400,286593400,10966,3655,7311,3655,0,1,3657,5581472,5.581472
4055,2555,4265,10897075,2,32446,8113,1,308417400,308417400,12166,4055,8111,4055,0,1,4057,92914,0.092914
4455,2555,4265,10897075,2,35646,8913,1,330241400,330241400,13366,4455,8911,4455,0,1,4457,3352354,3.352354
4855,2555,4265,10897075,2,38846,9713,1,352065400,352065400,14566,4855,9711,4855,0,1,4857,364167,0.364167
5255,2555,4265,10897075,2,42046,10513,1,373889400,373889400,15766,5255,10511,5255,0,1,5257,163562,0.163562
5655,2555,4265,10897075,2,45246,11313,1,395713400,395713400,16966,5655,11311,5655,0,1,5657,1470970,1.47097
6055,2555,4265,10897075,2,48446,12113,1,417537400,417537400,18166,6055,12111,6055,0,1,6057,3556016,3.556016
6455,2555,4265,10897075,2,51646,12913,1,439361400,439361400,19366,6455,12911,6455,0,1,6457,4348693,4.348693
6855,2555,4265,10897075,2,54846,13713,1,461185400,461185400,20566,6855,13711,6855,0,1,6857,1086354,1.086354
55,5055,2165,10944075,2,446,113,1,90729400,90729400,166,55,111,55,0,1,57,10000,0.01
455,5055,2165,10944075,2,3646,913,1,113833400,113833400,1366,455,911,455,0,1,457,8802,0.008802
855,5055,2165,10944075,2,6846,1713,1,136937400,136937400,2566,855,1711,855,0,1,857,78611,0.078611
1255,5055,2165,10944075,2,10046,2513,1,160041400,160041400,3766,1255,2511,1255,0,1,1257,10435,0.010435
1655,5055,2165,10944075,2,13246,3313,1,183145400,183145400,4966,1655,3311,1655,0,1,1657,194714,0.194714
2055,5055,2165,10944075,2,16446,4113,1,206249400,206249400,6166,2055,4111,2055,0,1,2057,51690,0.05169
2455,5055,2165,10944075,2,19646,4913,1,229353400,229353400,7366,2455,4911,2455,0,1,2457,296342,0.296342
2855,5055,2165,10944075,2,22846,5713,1,252457400,252457400,8566,2855,5711,2855,0,1,2857,1482355,1.482355
3255,5055,2165,10944075,2,26046,6513,1,275561400,275561400,9766,3255,6511,3255,0,1,3257,9562,0.009562
3655,5055,2165,10944075,2,29246,7313,1,298665400,298665400,10966,3655,7311,3655,0,1,3657,7977,0.007977
4055,5055,2165,10944075,2,32446,8113,1,321769400,321769400,12166,4055,8111,4055,0,1,4057,1686034,1.686034
4455,5055,2165,10944075,2,35646,8913,1,344873400,344873400,13366,4455,8911,4455,0,1,4457,1314465,1.314465
4855,5055,2165,10944075,2,38846,9713,1,367977400,367977400,14566,4855,9711,4855,0,1,4857,318753,0.318753
5255,5055,2165,10944075,2,42046,10513,1,391081400,391081400,15766,5255,10511,5255,0,1,5257,2101785,2.101785
5655,5055,2165,10944075,2,45246,11313,1,414185400,414185400,16966,5655,11311,5655,0,1,5657,4608354,4.608354
6055,5055,2165,10944075,2,48446,12113,1,437289400,437289400,18166,6055,12111,6055,0,1,6057,1038022,1.038022
6455,5055,2165,10944075,2,51646,12913,1,460393400,460393400,19366,6455,12911,6455,0,1,6457,732781,0.732781
6855,5055,2165,10944075,2,54846,13713,1,483497400,483497400,20566,6855,13711,6855,0,1,6857,129475,0.129475
55,1805,6065,10947325,2,446,113,1,91041400,91041400,166,55,111,55,0,1,57,230629,0.230629
455,1805,6065,10947325,2,3646,913,1,116225400,116225400,1366,455,911,455,0,1,457,35642,0.035642
855,1805,6065,10947325,2,6846,1713,1,141409400,141409400,2566,855,1711,855,0,1,857,1897886,1.897886
1255,1805,6065,10947325,2,10046,2513,1,166593400,166593400,3766,1255,2511,1255,0,1,1257,757284,0.757284
1655,1805,6065,10947325,2,13246,3313,1,191777400,191777400,4966,1655,3311,1655,0,1,1657,1289687,1.289687
2055,1805,6065,10947325,2,16446,4113,1,216961400,216961400,6166,2055,4111,2055,0,1,2057,533317,0.533317
2455,1805,6065,10947325,2,19646,4913,1,242145400,242145400,7366,2455,4911,2455,0,1,2457,178407,0.178407
2855,1805,6065,10947325,2,22846,5713,1,267329400,267329400,8566,2855,5711,2855,0,1,2857,826787,0.826787
3255,1805,6065,10947325,2,26046,6513,1,292513400,292513400,9766,3255,6511,3255,0,1,3257,4362063,4.362063
3655,1805,6065,10947325,2,29246,7313,1,317697400,317697400,10966,3655,7311,3655,0,1,3657,2298903,2.298903
4055,1805,6065,10947325,2,32446,8113,1,342881400,342881400,12166,4055,8111,4055,0,1,4057,2468453,2.468453
4455,1805,6065,10947325,2,35646,8913,1,368065400,368065400,13366,4455,8911,4455,0,1,4457,1665993,1.665993
4855,1805,6065,10947325,2,38846,9713,1,393249400,393249400,14566,4855,9711,4855,0,1,4857,170007,0.170007
5255,1805,6065,10947325,2,42046,10513,1,418433400,418433400,15766,5255,10511,5255,0,1,5257,3518239,3.518239
5655,1805,6065,10947325,2,45246,11313,1,443617400,443617400,16966,5655,11311,5655,0,1,5657,950932,0.950932
6055,1805,6065,10947325,2,48446,12113,1,468801400,468801400,18166,6055,12111,6055,0,1,6057,1720823,1.720823
6455,1805,6065,10947325,2,51646,12913,1,493985400,493985400,19366,6455,12911,6455,0,1,6457,1336481,1.336481
6855,1805,6065,10947325,2,54846,13713,1,519169400,519169400,20566,6855,13711,6855,0,1,6857,89856,0.089856
40,3300,3340,11022000,2,326,83,1,90300800,90300800,121,40,81,40,0,1,42,194155,0.194155
440,3300,3340,11022000,2,3526,883,1,111548800,111548800,1321,440,881,440,0,1,442,571306,0.571306
840,3300,3340,11022000,2,6726,1683,1,132796800,132796800,2521,840,1681,840,0,1,842,519857,0.519857
1240,3300,3340,11022000,2,9926,2483,1,154044800,154044800,3721,1240,2481,1240,0,1,1242,1490444,1.490444
1640,3300,3340,11022000,2,13126,3283,1,175292800,175292800,4921,1640,3281,1640,0,1,1642,993904,0.993904
2040,3300,3340,11022000,2,16326,4083,1,196540800,196540800,6121,2040,4081,2040,0,1,2042,536480,0.53648
2440,3300,3340,11022000,2,19526,4883,1,217788800,217788800,7321,2440,4881,2440,0,1,2442,1221609,1.221609
2840,3300,3340,11022000,2,22726,5683,1,239036800,239036800,8521,2840,5681,2840,0,1,2842,1920361,1.920361
3240,3300,3340,11022000,2,25926,6483,1,260284800,260284800,9721,3240,6481,3240,0,1,3242,1918313,1.918313
3640,3300,3340,11022000,2,29126,7283,1,281532800,281532800,10921,3640,7281,3640,0,1,3642,745561,0.745561
4040,3300,3340,11022000,2,32326,8083,1,302780800,302780800,12121,4040,8081,4040,0,1,4042,1575862,1.575862
4440,3300,3340,11022000,2,35526,8883,1,324028800,324028800,13321,4440,8881,4440,0,1,4442,1643888,1.643888
4840,3300,3340,11022000,2,38726,9683,1,345276800,345276800,14521,4840,9681,4840,0,1,4842,2905395,2.905395
5240,3300,3340,11022000,2,41926,10483,1,366524800,366524800,15721,5240,10481,5240,0,1,5242,2414195,2.414195
5640,3300,3340,11022000,2,45126,11283,1,387772800,387772800,16921,5640,11281,5640,0,1,5642,636059,0.636059
6040,3300,3340,11022000,2,48326,12083,1,409020800,409020800,18121,6040,12081,6040,0,1,6042,1254444,1.254444
6440,3300,3340,11022000,2,51526,12883,1,430268800,430268800,19321,6440,12881,6440,0,1,6442,631914,0.631914
6840,3300,3340,11022000,2,54726,13683,1,451516800,451516800,20521,6840,13681,6840,0,1,6842,2547782,2.547782
40,2800,3940,11032000,2,326,83,1,90412800,90412800,121,40,81,40,0,1,42,196208,0.196208
440,2800,3940,11032000,2,3526,883,1,111980800,111980800,1321,440,881,440,0,1,442,999151,0.999151
840,2800,3940,11032000,2,6726,1683,1,133548800,133548800,2521,840,1681,840,0,1,842,1809211,1.809211
1240,2800,3940,11032000,2,9926,2483,1,155116800,155116800,3721,1240,2481,1240,0,1,1242,2627979,2.627979
1640,2800,3940,11032000,2,13126,3283,1,176684800,176684800,4921,1640,3281,1640,0,1,1642,1535997,1.535997
2040,2800,3940,11032000,2,16326,4083,1,198252800,198252800,6121,2040,4081,2040,0,1,2042,1402656,1.402656
2440,2800,3940,11032000,2,19526,4883,1,219820800,219820800,7321,2440,4881,2440,0,1,2442,1184490,1.18449
2840,2800,3940,11032000,2,22726,5683,1,241388800,241388800,8521,2840,5681,2840,0,1,2842,2175562,2.175562
3240,2800,3940,11032000,2,25926,6483,1,262956800,262956800,9721,3240,6481,3240,0,1,3242,723754,0.723754
3640,2800,3940,11032000,2,29126,7283,1,284524800,284524800,10921,3640,7281,3640,0,1,3642,1063933,1.063933
4040,2800,3940,11032000,2,32326,8083,1,306092800,306092800,12121,4040,8081,4040,0,1,4042,1081384,1.081384
4440,2800,3940,11032000,2,35526,8883,1,327660800,327660800,13321,4440,8881,4440,0,1,4442,3720175,3.720175
4840,2800,3940,11032000,2,38726,9683,1,349228800,349228800,14521,4840,9681,4840,0,1,4842,2987566,2.987566
5240,2800,3940,11032000,2,41926,10483,1,370796800,370796800,15721,5240,10481,5240,0,1,5242,2305697,2.305697
5640,2800,3940,11032000,2,45126,11283,1,392364800,392364800,16921,5640,11281,5640,0,1,5642,3405540,3.40554
6040,2800,3940,11032000,2,48326,12083,1,413932800,413932800,18121,6040,12081,6040,0,1,6042,2986940,2.98694
6440,2800,3940,11032000,2,51526,12883,1,435500800,435500800,19321,6440,12881,6440,0,1,6442,12338072,12.338072
6840,2800,3940,11032000,2,54726,13683,1,457068800,457068800,20521,6840,13681,6840,0,1,6842,827727,0.827727
55,7055,1565,11041075,2,446,113,1,92121400,92121400,166,55,111,55,0,1,57,216382,0.216382
455,7055,1565,11041075,2,3646,913,1,119705400,119705400,1366,455,911,455,0,1,457,847385,0.847385
855,7055,1565,11041075,2,6846,1713,1,147289400,147289400,2566,855,1711,855,0,1,857,744513,0.744513
1255,7055,1565,11041075,2,10046,2513,1,174873400,174873400,3766,1255,2511,1255,0,1,1257,2761569,2.761569
1655,7055,1565,11041075,2,13246,3313,1,202457400,202457400,4966,1655,3311,1655,0,1,1657,698302,0.698302
2055,7055,1565,11041075,2,16446,4113,1,230041400,230041400,6166,2055,4111,2055,0,1,2057,2506415,2.506415
2455,7055,1565,11041075,2,19646,4913,1,257625400,257625400,7366,2455,4911,2455,0,1,2457,5326727,5.326727
2855,7055,1565,11041075,2,22846,5713,1,285209400,285209400,8566,2855,5711,2855,0,1,2857,4028017,4.028017
3255,7055,1565,11041075,2,26046,6513,1,312793400,312793400,9766,3255,6511,3255,0,1,3257,7065665,7.065665
3655,7055,1565,11041075,2,29246,7313,1,340377400,340377400,10966,3655,7311,3655,0,1,3657,7937550,7.93755
4055,7055,1565,11041075,2,32446,8113,1,367961400,367961400,12166,4055,8111,4055,0,1,4057,8766202,8.766202
4455,7055,1565,11041075,2,35646,8913,1,395545400,395545400,13366,4455,8911,4455,0,1,4457,9620132,9.620132
4855,7055,1565,11041075,2,38846,9713,1,423129400,423129400,14566,4855,9711,4855,0,1,4857,3365068,3.365068
5255,7055,1565,11041075,2,42046,10513,1,450713400,450713400,15766,5255,10511,5255,0,1,5257,11375765,11.375765
5655,7055,1565,11041075,2,45246,11313,1,478297400,478297400,16966,5655,11311,5655,0,1,5657,1126115,1.126115
6055,7055,1565,11041075,2,48446,12113,1,505881400,505881400,18166,6055,12111,6055,0,1,6057,13158992,13.158992
6455,7055,1565,11041075,2,51646,12913,1,533465400,533465400,19366,6455,12911,6455,0,1,6457,14047154,14.047154
6855,7055,1565,11041075,2,54846,13713,1,561049400,561049400,20566,6855,13711,6855,0,1,6857,14945326,14.945326
39,1693,6541,11073913,2,318,81,1,91160312,91160312,118,39,79,39,0,1,41,196143,0.196143
539,1693,6541,11073913,2,4318,1081,1,124096312,124096312,1618,539,1079,539,0,1,541,421651,0.421651
1039,1693,6541,11073913,2,8318,2081,1,157032312,157032312,3118,1039,2079,1039,0,1,1041,359968,0.359968
1539,1693,6541,11073913,2,12318,3081,1,189968312,189968312,4618,1539,3079,1539,0,1,1541,909354,0.909354
2039,1693,6541,11073913,2,16318,4081,1,222904312,222904312,6118,2039,4079,2039,0,1,2041,1808349,1.808349
2539,1693,6541,11073913,2,20318,5081,1,255840312,255840312,7618,2539,5079,2539,0,1,2541,294761,0.294761
3039,1693,6541,11073913,2,24318,6081,1,288776312,288776312,9118,3039,6079,3039,0,1,3041,896978,0.896978
3539,1693,6541,11073913,2,28318,7081,1,321712312,321712312,10618,3539,7079,3539,0,1,3541,3253704,3.253704
4039,1693,6541,11073913,2,32318,8081,1,354648312,354648312,12118,4039,8079,4039,0,1,4041,694899,0.694899
4539,1693,6541,11073913,2,36318,9081,1,387584312,387584312,13618,4539,9079,4539,0,1,4541,493718,0.493718
5039,1693,6541,11073913,2,40318,10081,1,420520312,420520312,15118,5039,10079,5039,0,1,5041,3021629,3.021629
5539,1693,6541,11073913,2,44318,11081,1,453456312,453456312,16618,5539,11079,5539,0,1,5541,779539,0.779539
6039,1693,6541,11073913,2,48318,12081,1,486392312,486392312,18118,6039,12079,6039,0,1,6041,1192803,1.192803
6539,1693,6541,11073913,2,52318,13081,1,519328312,519328312,19618,6539,13079,6539,0,1,6541,465893,0.465893
7039,1693,6541,11073913,2,56318,14081,1,552264312,552264312,21118,7039,14079,7039,0,1,7041,1134014,1.134014
40,4050,2740,11097000,2,326,83,1,90948800,90948800,121,40,81,40,0,1,42,7535,0.007535
440,4050,2740,11097000,2,3526,883,1,112676800,112676800,1321,440,881,440,0,1,442,31499,0.031499
840,4050,2740,11097000,2,6726,1683,1,134404800,134404800,2521,840,1681,840,0,1,842,37011,0.037011
1240,4050,2740,11097000,2,9926,2483,1,156132800,156132800,3721,1240,2481,1240,0,1,1242,708001,0.708001
1640,4050,2740,11097000,2,13126,3283,1,177860800,177860800,4921,1640,3281,1640,0,1,1642,737143,0.737143
2040,4050,2740,11097000,2,16326,4083,1,199588800,199588800,6121,2040,4081,2040,0,1,2042,676155,0.676155
2440,4050,2740,11097000,2,19526,4883,1,221316800,221316800,7321,2440,4881,2440,0,1,2442,474583,0.474583
2840,4050,2740,11097000,2,22726,5683,1,243044800,243044800,8521,2840,5681,2840,0,1,2842,1108471,1.108471
3240,4050,2740,11097000,2,25926,6483,1,264772800,264772800,9721,3240,6481,3240,0,1,3242,17507,0.017507
3640,4050,2740,11097000,2,29126,7283,1,286500800,286500800,10921,3640,7281,3640,0,1,3642,27262,0.027262
4040,4050,2740,11097000,2,32326,8083,1,308228800,308228800,12121,4040,8081,4040,0,1,4042,258701,0.258701
4440,4050,2740,11097000,2,35526,8883,1,329956800,329956800,13321,4440,8881,4440,0,1,4442,203409,0.203409
4840,4050,2740,11097000,2,38726,9683,1,351684800,351684800,14521,4840,9681,4840,0,1,4842,1273055,1.273055
5240,4050,2740,11097000,2,41926,10483,1,373412800,373412800,15721,5240,10481,5240,0,1,5242,478855,0.478855
5640,4050,2740,11097000,2,45126,11283,1,395140800,395140800,16921,5640,11281,5640,0,1,5642,532290,0.53229
6040,4050,2740,11097000,2,48326,12083,1,416868800,416868800,18121,6040,12081,6040,0,1,6042,1319567,1.319567
6440,4050,2740,11097000,2,51526,12883,1,438596800,438596800,19321,6440,12881,6440,0,1,6442,63825,0.063825
6840,4050,2740,11097000,2,54726,13683,1,460324800,460324800,20521,6840,13681,6840,0,1,6842,1255100,1.2551
40,3050,3640,11102000,2,326,83,1,90956800,90956800,121,40,81,40,0,1,42,16556,0.016556
440,3050,3640,11102000,2,3526,883,1,112364800,112364800,1321,440,881,440,0,1,442,124707,0.124707
840,3050,3640,11102000,2,6726,1683,1,133772800,133772800,2521,840,1681,840,0,1,842,380,0.00038
1240,3050,3640,11102000,2,9926,2483,1,155180800,155180800,3721,1240,2481,1240,0,1,1242,59685,0.059685
1640,3050,3640,11102000,2,13126,3283,1,176588800,176588800,4921,1640,3281,1640,0,1,1642,313205,0.313205
2040,3050,3640,11102000,2,16326,4083,1,197996800,197996800,6121,2040,4081,2040,0,1,2042,137520,0.13752
2440,3050,3640,11102000,2,19526,4883,1,219404800,219404800,7321,2440,4881,2440,0,1,2442,162472,0.162472
2840,3050,3640,11102000,2,22726,5683,1,240812800,240812800,8521,2840,5681,2840,0,1,2842,223747,0.223747
3240,3050,3640,11102000,2,25926,6483,1,262220800,262220800,9721,3240,6481,3240,0,1,3242,496626,0.496626
3640,3050,3640,11102000,2,29126,7283,1,283628800,283628800,10921,3640,7281,3640,0,1,3642,270166,0.270166
4040,3050,3640,11102000,2,32326,8083,1,305036800,305036800,12121,4040,8081,4040,0,1,4042,234382,0.234382
4440,3050,3640,11102000,2,35526,8883,1,326444800,326444800,13321,4440,8881,4440,0,1,4442,95236,0.095236
4840,3050,3640,11102000,2,38726,9683,1,347852800,347852800,14521,4840,9681,4840,0,1,4842,1300972,1.300972
5240,3050,3640,11102000,2,41926,10483,1,369260800,369260800,15721,5240,10481,5240,0,1,5242,560071,0.560071
5640,3050,3640,11102000,2,45126,11283,1,390668800,390668800,16921,5640,11281,5640,0,1,5642,2803475,2.803475
6040,3050,3640,11102000,2,48326,12083,1,412076800,412076800,18121,6040,12081,6040,0,1,6042,237488,0.237488
6440,3050,3640,11102000,2,51526,12883,1,433484800,433484800,19321,6440,12881,6440,0,1,6442,784839,0.784839
6840,3050,3640,11102000,2,54726,13683,1,454892800,454892800,20521,6840,13681,6840,0,1,6842,91703,0.091703
40,4550,2440,11102000,2,326,83,1,91052800,91052800,121,40,81,40,0,1,42,200363,0.200363
440,4550,2440,11102000,2,3526,883,1,113420800,113420800,1321,440,881,440,0,1,442,991243,0.991243
840,4550,2440,11102000,2,6726,1683,1,135788800,135788800,2521,840,1681,840,0,1,842,1808645,1.808645
1240,4550,2440,11102000,2,9926,2483,1,158156800,158156800,3721,1240,2481,1240,0,1,1242,602942,0.602942
1640,4550,2440,11102000,2,13126,3283,1,180524800,180524800,4921,1640,3281,1640,0,1,1642,3406092,3.406092
2040,4550,2440,11102000,2,16326,4083,1,202892800,202892800,6121,2040,4081,2040,0,1,2042,2514702,2.514702
2440,4550,2440,11102000,2,19526,4883,1,225260800,225260800,7321,2440,4881,2440,0,1,2442,3120111,3.120111
2840,4550,2440,11102000,2,22726,5683,1,247628800,247628800,8521,2840,5681,2840,0,1,2842,4316426,4.316426
3240,4550,2440,11102000,2,25926,6483,1,269996800,269996800,9721,3240,6481,3240,0,1,3242,2385394,2.385394
3640,4550,2440,11102000,2,29126,7283,1,292364800,292364800,10921,3640,7281,3640,0,1,3642,4653894,4.653894
4040,4550,2440,11102000,2,32326,8083,1,314732800,314732800,12121,4040,8081,4040,0,1,4042,1651107,1.651107
4440,4550,2440,11102000,2,35526,8883,1,337100800,337100800,13321,4440,8881,4440,0,1,4442,4590795,4.590795
4840,4550,2440,11102000,2,38726,9683,1,359468800,359468800,14521,4840,9681,4840,0,1,4842,3557722,3.557722
5240,4550,2440,11102000,2,41926,10483,1,381836800,381836800,15721,5240,10481,5240,0,1,5242,3948315,3.948315
5640,4550,2440,11102000,2,45126,11283,1,404204800,404204800,16921,5640,11281,5640,0,1,5642,4700468,4.700468
6040,4550,2440,11102000,2,48326,12083,1,426572800,426572800,18121,6040,12081,6040,0,1,6042,12259428,12.259428
6440,4550,2440,11102000,2,51526,12883,1,448940800,448940800,19321,6440,12881,6440,0,1,6442,4747288,4.747288
6840,4550,2440,11102000,2,54726,13683,1,471308800,471308800,20521,6840,13681,6840,0,1,6842,7022419,7.022419
55,3305,3365,11121325,2,446,113,1,91905400,91905400,166,55,111,55,0,1,57,228030,0.22803
455,3305,3365,11121325,2,3646,913,1,113249400,113249400,1366,455,911,455,0,1,457,1077898,1.077898
855,3305,3365,11121325,2,6846,1713,1,134593400,134593400,2566,855,1711,855,0,1,857,290258,0.290258
1255,3305,3365,11121325,2,10046,2513,1,155937400,155937400,3766,1255,2511,1255,0,1,1257,364636,0.364636
1655,3305,3365,11121325,2,13246,3313,1,177281400,177281400,4966,1655,3311,1655,0,1,1657,439811,0.439811
2055,3305,3365,11121325,2,16446,4113,1,198625400,198625400,6166,2055,4111,2055,0,1,2057,1170036,1.170036
2455,3305,3365,11121325,2,19646,4913,1,219969400,219969400,7366,2455,4911,2455,0,1,2457,635391,0.635391
2855,3305,3365,11121325,2,22846,5713,1,241313400,241313400,8566,2855,5711,2855,0,1,2857,134702,0.134702
3255,3305,3365,11121325,2,26046,6513,1,262657400,262657400,9766,3255,6511,3255,0,1,3257,2384555,2.384555
3655,3305,3365,11121325,2,29246,7313,1,284001400,284001400,10966,3655,7311,3655,0,1,3657,5917177,5.917177
4055,3305,3365,11121325,2,32446,8113,1,305345400,305345400,12166,4055,8111,4055,0,1,4057,1005850,1.00585
4455,3305,3365,11121325,2,35646,8913,1,326689400,326689400,13366,4455,8911,4455,0,1,4457,1877945,1.877945
4855,3305,3365,11121325,2,38846,9713,1,348033400,348033400,14566,4855,9711,4855,0,1,4857,223648,0.223648
5255,3305,3365,11121325,2,42046,10513,1,369377400,369377400,15766,5255,10511,5255,0,1,5257,794839,0.794839
5655,3305,3365,11121325,2,45246,11313,1,390721400,390721400,16966,5655,11311,5655,0,1,5657,126914,0.126914
6055,3305,3365,11121325,2,48446,12113,1,412065400,412065400,18166,6055,12111,6055,0,1,6057,909024,0.909024
6455,3305,3365,11121325,2,51646,12913,1,433409400,433409400,19366,6455,12911,6455,0,1,6457,3749795,3.749795
6855,3305,3365,11121325,2,54846,13713,1,454753400,454753400,20566,6855,13711,6855,0,1,6857,436902,0.436902
55,2805,3965,11121825,2,446,113,1,91953400,91953400,166,55,111,55,0,1,57,223842,0.223842
455,2805,3965,11121825,2,3646,913,1,113617400,113617400,1366,455,911,455,0,1,457,430069,0.430069
855,2805,3965,11121825,2,6846,1713,1,135281400,135281400,2566,855,1711,855,0,1,857,315785,0.315785
1255,2805,3965,11121825,2,10046,2513,1,156945400,156945400,3766,1255,2511,1255,0,1,1257,508409,0.508409
1655,2805,3965,11121825,2,13246,3313,1,178609400,178609400,4966,1655,3311,1655,0,1,1657,661341,0.661341
2055,2805,3965,11121825,2,16446,4113,1,200273400,200273400,6166,2055,4111,2055,0,1,2057,3646738,3.646738
2455,2805,3965,11121825,2,19646,4913,1,221937400,221937400,7366,2455,4911,2455,0,1,2457,2622899,2.622899
2855,2805,3965,11121825,2,22846,5713,1,243601400,243601400,8566,2855,5711,2855,0,1,2857,5807474,5.807474
3255,2805,3965,11121825,2,26046,6513,1,265265400,265265400,9766,3255,6511,3255,0,1,3257,219239,0.219239
3655,2805,3965,11121825,2,29246,7313,1,286929400,286929400,10966,3655,7311,3655,0,1,3657,918042,0.918042
4055,2805,3965,11121825,2,32446,8113,1,308593400,308593400,12166,4055,8111,4055,0,1,4057,4398984,4.398984
4455,2805,3965,11121825,2,35646,8913,1,330257400,330257400,13366,4455,8911,4455,0,1,4457,6191055,6.191055
4855,2805,3965,11121825,2,38846,9713,1,351921400,351921400,14566,4855,9711,4855,0,1,4857,657640,0.65764
5255,2805,3965,11121825,2,42046,10513,1,373585400,373585400,15766,5255,10511,5255,0,1,5257,489328,0.489328
5655,2805,3965,11121825,2,45246,11313,1,395249400,395249400,16966,5655,11311,5655,0,1,5657,3172290,3.17229
6055,2805,3965,11121825,2,48446,12113,1,416913400,416913400,18166,6055,12111,6055,0,1,6057,846554,0.846554
6455,2805,3965,11121825,2,51646,12913,1,438577400,438577400,19366,6455,12911,6455,0,1,6457,3002210,3.00221
6855,2805,3965,11121825,2,54846,13713,1,460241400,460241400,20566,6855,13711,6855,0,1,6857,165831,0.165831
40,2300,4840,11132000,2,326,83,1,91340800,91340800,121,40,81,40,0,1,42,205645,0.205645
440,2300,4840,11132000,2,3526,883,1,114188800,114188800,1321,440,881,440,0,1,442,122914,0.122914
840,2300,4840,11132000,2,6726,1683,1,137036800,137036800,2521,840,1681,840,0,1,842,1824090,1.82409
1240,2300,4840,11132000,2,9926,2483,1,159884800,159884800,3721,1240,2481,1240,0,1,1242,2629485,2.629485
1640,2300,4840,11132000,2,13126,3283,1,182732800,182732800,4921,1640,3281,1640,0,1,1642,2917888,2.917888
2040,2300,4840,11132000,2,16326,4083,1,205580800,205580800,6121,2040,4081,2040,0,1,2042,225475,0.225475
2440,2300,4840,11132000,2,19526,4883,1,228428800,228428800,7321,2440,4881,2440,0,1,2442,1192140,1.19214
2840,2300,4840,11132000,2,22726,5683,1,251276800,251276800,8521,2840,5681,2840,0,1,2842,122823,0.122823
3240,2300,4840,11132000,2,25926,6483,1,274124800,274124800,9721,3240,6481,3240,0,1,3242,731684,0.731684
3640,2300,4840,11132000,2,29126,7283,1,296972800,296972800,10921,3640,7281,3640,0,1,3642,761260,0.76126
4040,2300,4840,11132000,2,32326,8083,1,319820800,319820800,12121,4040,8081,4040,0,1,4042,2146158,2.146158
4440,2300,4840,11132000,2,35526,8883,1,342668800,342668800,13321,4440,8881,4440,0,1,4442,117186,0.117186
4840,2300,4840,11132000,2,38726,9683,1,365516800,365516800,14521,4840,9681,4840,0,1,4842,56387,0.056387
5240,2300,4840,11132000,2,41926,10483,1,388364800,388364800,15721,5240,10481,5240,0,1,5242,2842780,2.84278
5640,2300,4840,11132000,2,45126,11283,1,411212800,411212800,16921,5640,11281,5640,0,1,5642,24096,0.024096
6040,2300,4840,11132000,2,48326,12083,1,434060800,434060800,18121,6040,12081,6040,0,1,6042,86970,0.08697
6440,2300,4840,11132000,2,51526,12883,1,456908800,456908800,19321,6440,12881,6440,0,1,6442,4969707,4.969707
6840,2300,4840,11132000,2,54726,13683,1,479756800,479756800,20521,6840,13681,6840,0,1,6842,79935,0.079935
40,6050,1840,11132000,2,326,83,1,91580800,91580800,121,40,81,40,0,1,42,191473,0.191473
440,6050,1840,11132000,2,3526,883,1,116828800,116828800,1321,440,881,440,0,1,442,968477,0.968477
840,6050,1840,11132000,2,6726,1683,1,142076800,142076800,2521,840,1681,840,0,1,842,36231,0.036231
1240,6050,1840,11132000,2,9926,2483,1,167324800,167324800,3721,1240,2481,1240,0,1,1242,2564783,2.564783
1640,6050,1840,11132000,2,13126,3283,1,192572800,192572800,4921,1640,3281,1640,0,1,1642,3363214,3.363214
2040,6050,1840,11132000,2,16326,4083,1,217820800,217820800,6121,2040,4081,2040,0,1,2042,3129270,3.12927
2440,6050,1840,11132000,2,19526,4883,1,243068800,243068800,7321,2440,4881,2440,0,1,2442,1525072,1.525072
2840,6050,1840,11132000,2,22726,5683,1,268316800,268316800,8521,2840,5681,2840,0,1,2842,3741228,3.741228
3240,6050,1840,11132000,2,25926,6483,1,293564800,293564800,9721,3240,6481,3240,0,1,3242,344423,0.344423
3640,6050,1840,11132000,2,29126,7283,1,318812800,318812800,10921,3640,7281,3640,0,1,3642,254041,0.254041
4040,6050,1840,11132000,2,32326,8083,1,344060800,344060800,12121,4040,8081,4040,0,1,4042,321023,0.321023
4440,6050,1840,11132000,2,35526,8883,1,369308800,369308800,13321,4440,8881,4440,0,1,4442,3027339,3.027339
4840,6050,1840,11132000,2,38726,9683,1,394556800,394556800,14521,4840,9681,4840,0,1,4842,2494755,2.494755
5240,6050,1840,11132000,2,41926,10483,1,419804800,419804800,15721,5240,10481,5240,0,1,5242,3335876,3.335876
5640,6050,1840,11132000,2,45126,11283,1,445052800,445052800,16921,5640,11281,5640,0,1,5642,455642,0.455642
6040,6050,1840,11132000,2,48326,12083,1,470300800,470300800,18121,6040,12081,6040,0,1,6042,1372872,1.372872
6440,6050,1840,11132000,2,51526,12883,1,495548800,495548800,19321,6440,12881,6440,0,1,6442,2010098,2.010098
6840,6050,1840,11132000,2,54726,13683,1,520796800,520796800,20521,6840,13681,6840,0,1,6842,1810534,1.810534
40,2050,5440,11152000,2,326,83,1,91612800,91612800,121,40,81,40,0,1,42,16288,0.016288
440,2050,5440,11152000,2,3526,883,1,115580800,115580800,1321,440,881,440,0,1,442,86065,0.086065
840,2050,5440,11152000,2,6726,1683,1,139548800,139548800,2521,840,1681,840,0,1,842,53659,0.053659
1240,2050,5440,11152000,2,9926,2483,1,163516800,163516800,3721,1240,2481,1240,0,1,1242,143265,0.143265
1640,2050,5440,11152000,2,13126,3283,1,187484800,187484800,4921,1640,3281,1640,0,1,1642,164844,0.164844
2040,2050,5440,11152000,2,16326,4083,1,211452800,211452800,6121,2040,4081,2040,0,1,2042,158929,0.158929
2440,2050,5440,11152000,2,19526,4883,1,235420800,235420800,7321,2440,4881,2440,0,1,2442,16986,0.016986
2840,2050,5440,11152000,2,22726,5683,1,259388800,259388800,8521,2840,5681,2840,0,1,2842,551237,0.551237
3240,2050,5440,11152000,2,25926,6483,1,283356800,283356800,9721,3240,6481,3240,0,1,3242,436438,0.436438
3640,2050,5440,11152000,2,29126,7283,1,307324800,307324800,10921,3640,7281,3640,0,1,3642,245633,0.245633
4040,2050,5440,11152000,2,32326,8083,1,331292800,331292800,12121,4040,8081,4040,0,1,4042,64566,0.064566
4440,2050,5440,11152000,2,35526,8883,1,355260800,355260800,13321,4440,8881,4440,0,1,4442,1219184,1.219184
4840,2050,5440,11152000,2,38726,9683,1,379228800,379228800,14521,4840,9681,4840,0,1,4842,39314,0.039314
5240,2050,5440,11152000,2,41926,10483,1,403196800,403196800,15721,5240,10481,5240,0,1,5242,224902,0.224902
5640,2050,5440,11152000,2,45126,11283,1,427164800,427164800,16921,5640,11281,5640,0,1,5642,365135,0.365135
6040,2050,5440,11152000,2,48326,12083,1,451132800,451132800,18121,6040,12081,6040,0,1,6042,29591,0.029591
6440,2050,5440,11152000,2,51526,12883,1,475100800,475100800,19321,6440,12881,6440,0,1,6442,335625,0.335625
6840,2050,5440,11152000,2,54726,13683,1,499068800,499068800,20521,6840,13681,6840,0,1,6842,6251125,6.251125
44,1703,6555,11163165,2,358,91,1,92212136,92212136,133,44,89,44,0,1,46,206170,0.20617
544,1703,6555,11163165,2,4358,1091,1,125244136,125244136,1633,544,1089,544,0,1,546,62236,0.062236
1044,1703,6555,11163165,2,8358,2091,1,158276136,158276136,3133,1044,2089,1044,0,1,1046,1562009,1.562009
1544,1703,6555,11163165,2,12358,3091,1,191308136,191308136,4633,1544,3089,1544,0,1,1546,1018433,1.018433
2044,1703,6555,11163165,2,16358,4091,1,224340136,224340136,6133,2044,4089,2044,0,1,2046,2278787,2.278787
2544,1703,6555,11163165,2,20358,5091,1,257372136,257372136,7633,2544,5089,2544,0,1,2546,2439233,2.439233
3044,1703,6555,11163165,2,24358,6091,1,290404136,290404136,9133,3044,6089,3044,0,1,3046,1212500,1.2125
3544,1703,6555,11163165,2,28358,7091,1,323436136,323436136,10633,3544,7089,3544,0,1,3546,2941201,2.941201
4044,1703,6555,11163165,2,32358,8091,1,356468136,356468136,12133,4044,8089,4044,0,1,4046,1439121,1.439121
4544,1703,6555,11163165,2,36358,9091,1,389500136,389500136,13633,4544,9089,4544,0,1,4546,815219,0.815219
5044,1703,6555,11163165,2,40358,10091,1,422532136,422532136,15133,5044,10089,5044,0,1,5046,2349351,2.349351
5544,1703,6555,11163165,2,44358,11091,1,455564136,455564136,16633,5544,11089,5544,0,1,5546,935005,0.935005
6044,1703,6555,11163165,2,48358,12091,1,488596136,488596136,18133,6044,12089,6044,0,1,6046,543651,0.543651
6544,1703,6555,11163165,2,52358,13091,1,521628136,521628136,19633,6544,13089,6544,0,1,6546,3067963,3.067963
7044,1703,6555,11163165,2,56358,14091,1,554660136,554660136,21133,7044,14089,7044,0,1,7046,7867968,7.867968
55,3055,3665,11196575,2,446,113,1,92529400,92529400,166,55,111,55,0,1,57,48741,0.048741
455,3055,3665,11196575,2,3646,913,1,114033400,114033400,1366,455,911,455,0,1,457,145750,0.14575
855,3055,3665,11196575,2,6846,1713,1,135537400,135537400,2566,855,1711,855,0,1,857,294270,0.29427
1255,3055,3665,11196575,2,10046,2513,1,157041400,157041400,3766,1255,2511,1255,0,1,1257,398305,0.398305
1655,3055,3665,11196575,2,13246,3313,1,178545400,178545400,4966,1655,3311,1655,0,1,1657,346138,0.346138
2055,3055,3665,11196575,2,16446,4113,1,200049400,200049400,6166,2055,4111,2055,0,1,2057,324898,0.324898
2455,3055,3665,11196575,2,19646,4913,1,221553400,221553400,7366,2455,4911,2455,0,1,2457,321355,0.321355
2855,3055,3665,11196575,2,22846,5713,1,243057400,243057400,8566,2855,5711,2855,0,1,2857,221995,0.221995
3255,3055,3665,11196575,2,26046,6513,1,264561400,264561400,9766,3255,6511,3255,0,1,3257,534874,0.534874
3655,3055,3665,11196575,2,29246,7313,1,286065400,286065400,10966,3655,7311,3655,0,1,3657,1860808,1.860808
4055,3055,3665,11196575,2,32446,8113,1,307569400,307569400,12166,4055,8111,4055,0,1,4057,32576,0.032576
4455,3055,3665,11196575,2,35646,8913,1,329073400,329073400,13366,4455,8911,4455,0,1,4457,508258,0.508258
4855,3055,3665,11196575,2,38846,9713,1,350577400,350577400,14566,4855,9711,4855,0,1,4857,740583,0.740583
5255,3055,3665,11196575,2,42046,10513,1,372081400,372081400,15766,5255,10511,5255,0,1,5257,144842,0.144842
5655,3055,3665,11196575,2,45246,11313,1,393585400,393585400,16966,5655,11311,5655,0,1,5657,1388895,1.388895
6055,3055,3665,11196575,2,48446,12113,1,415089400,415089400,18166,6055,12111,6055,0,1,6057,630220,0.63022
6455,3055,3665,11196575,2,51646,12913,1,436593400,436593400,19366,6455,12911,6455,0,1,6457,912189,0.912189
6855,3055,3665,11196575,2,54846,13713,1,458097400,458097400,20566,6855,13711,6855,0,1,6857,2360284,2.360284
35,4400,2545,11198000,2,286,73,1,91528600,91528600,106,35,71,35,0,1,37,219,0.000219
535,4400,2545,11198000,2,4286,1073,1,119308600,119308600,1606,535,1071,535,0,1,537,84220,0.08422
1035,4400,2545,11198000,2,8286,2073,1,147088600,147088600,3106,1035,2071,1035,0,1,1037,7426,0.007426
1535,4400,2545,11198000,2,12286,3073,1,174868600,174868600,4606,1535,3071,1535,0,1,1537,3320690,3.32069
2035,4400,2545,11198000,2,16286,4073,1,202648600,202648600,6106,2035,4071,2035,0,1,2037,366543,0.366543
2535,4400,2545,11198000,2,20286,5073,1,230428600,230428600,7606,2535,5071,2535,0,1,2537,1477278,1.477278
3035,4400,2545,11198000,2,24286,6073,1,258208600,258208600,9106,3035,6071,3035,0,1,3037,1027404,1.027404
3535,4400,2545,11198000,2,28286,7073,1,285988600,285988600,10606,3535,7071,3535,0,1,3537,5862852,5.862852
4035,4400,2545,11198000,2,32286,8073,1,313768600,313768600,12106,4035,8071,4035,0,1,4037,1965221,1.965221
4535,4400,2545,11198000,2,36286,9073,1,341548600,341548600,13606,4535,9071,4535,0,1,4537,2556154,2.556154
5035,4400,2545,11198000,2,40286,10073,1,369328600,369328600,15106,5035,10071,5035,0,1,5037,10361570,10.36157
5535,4400,2545,11198000,2,44286,11073,1,397108600,397108600,16606,5535,11071,5535,0,1,5537,5971636,5.971636
6035,4400,2545,11198000,2,48286,12073,1,424888600,424888600,18106,6035,12071,6035,0,1,6037,875747,0.875747
6535,4400,2545,11198000,2,52286,13073,1,452668600,452668600,19606,6535,13071,6535,0,1,6537,1820090,1.82009
7035,4400,2545,11198000,2,56286,14073,1,480448600,480448600,21106,7035,14071,7035,0,1,7037,3065469,3.065469
55,4055,2765,11212075,2,446,113,1,92697400,92697400,166,55,111,55,0,1,57,11305,0.011305
455,4055,2765,11212075,2,3646,913,1,114521400,114521400,1366,455,911,455,0,1,457,89149,0.089149
855,4055,2765,11212075,2,6846,1713,1,136345400,136345400,2566,855,1711,855,0,1,857,113696,0.113696
1255,4055,2765,11212075,2,10046,2513,1,158169400,158169400,3766,1255,2511,1255,0,1,1257,131579,0.131579
1655,4055,2765,11212075,2,13246,3313,1,179993400,179993400,4966,1655,3311,1655,0,1,1657,54105,0.054105
2055,4055,2765,11212075,2,16446,4113,1,201817400,201817400,6166,2055,4111,2055,0,1,2057,639,0.000639
2455,4055,2765,11212075,2,19646,4913,1,223641400,223641400,7366,2455,4911,2455,0,1,2457,120620,0.12062
2855,4055,2765,11212075,2,22846,5713,1,245465400,245465400,8566,2855,5711,2855,0,1,2857,1532836,1.532836
3255,4055,2765,11212075,2,26046,6513,1,267289400,267289400,9766,3255,6511,3255,0,1,3257,227384,0.227384
3655,4055,2765,11212075,2,29246,7313,1,289113400,289113400,10966,3655,7311,3655,0,1,3657,1230814,1.230814
4055,4055,2765,11212075,2,32446,8113,1,310937400,310937400,12166,4055,8111,4055,0,1,4057,158280,0.15828
4455,4055,2765,11212075,2,35646,8913,1,332761400,332761400,13366,4455,8911,4455,0,1,4457,1561289,1.561289
4855,4055,2765,11212075,2,38846,9713,1,354585400,354585400,14566,4855,9711,4855,0,1,4857,781612,0.781612
5255,4055,2765,11212075,2,42046,10513,1,376409400,376409400,15766,5255,10511,5255,0,1,5257,2687528,2.687528
5655,4055,2765,11212075,2,45246,11313,1,398233400,398233400,16966,5655,11311,5655,0,1,5657,180721,0.180721
6055,4055,2765,11212075,2,48446,12113,1,420057400,420057400,18166,6055,12111,6055,0,1,6057,2555242,2.555242
6455,4055,2765,11212075,2,51646,12913,1,441881400,441881400,19366,6455,12911,6455,0,1,6457,1914336,1.914336
6855,4055,2765,11212075,2,54846,13713,1,463705400,463705400,20566,6855,13711,6855,0,1,6857,672349,0.672349
55,2305,4865,11213825,2,446,113,1,92865400,92865400,166,55,111,55,0,1,57,228269,0.228269
455,2305,4865,11213825,2,3646,913,1,115809400,115809400,1366,455,911,455,0,1,457,1033674,1.033674
855,2305,4865,11213825,2,6846,1713,1,138753400,138753400,2566,855,1711,855,0,1,857,197059,0.197059
1255,2305,4865,11213825,2,10046,2513,1,161697400,161697400,3766,1255,2511,1255,0,1,1257,2422137,2.422137
1655,2305,4865,11213825,2,13246,3313,1,184641400,184641400,4966,1655,3311,1655,0,1,1657,864775,0.864775
2055,2305,4865,11213825,2,16446,4113,1,207585400,207585400,6166,2055,4111,2055,0,1,2057,947770,0.94777
2455,2305,4865,11213825,2,19646,4913,1,230529400,230529400,7366,2455,4911,2455,0,1,2457,117932,0.117932
2855,2305,4865,11213825,2,22846,5713,1,253473400,253473400,8566,2855,5711,2855,0,1,2857,165191,0.165191
3255,2305,4865,11213825,2,26046,6513,1,276417400,276417400,9766,3255,6511,3255,0,1,3257,840924,0.840924
3655,2305,4865,11213825,2,29246,7313,1,299361400,299361400,10966,3655,7311,3655,0,1,3657,1744867,1.744867
4055,2305,4865,11213825,2,32446,8113,1,322305400,322305400,12166,4055,8111,4055,0,1,4057,265228,0.265228
4455,2305,4865,11213825,2,35646,8913,1,345249400,345249400,13366,4455,8911,4455,0,1,4457,149672,0.149672
4855,2305,4865,11213825,2,38846,9713,1,368193400,368193400,14566,4855,9711,4855,0,1,4857,992296,0.992296
5255,2305,4865,11213825,2,42046,10513,1,391137400,391137400,15766,5255,10511,5255,0,1,5257,128849,0.128849
5655,2305,4865,11213825,2,45246,11313,1,414081400,414081400,16966,5655,11311,5655,0,1,5657,631938,0.631938
6055,2305,4865,11213825,2,48446,12113,1,437025400,437025400,18166,6055,12111,6055,0,1,6057,1602958,1.602958
6455,2305,4865,11213825,2,51646,12913,1,459969400,459969400,19366,6455,12911,6455,0,1,6457,1803276,1.803276
6855,2305,4865,11213825,2,54846,13713,1,482913400,482913400,20566,6855,13711,6855,0,1,6857,992639,0.992639
55,4555,2465,11228075,2,446,113,1,92913400,92913400,166,55,111,55,0,1,57,229796,0.229796
455,4555,2465,11228075,2,3646,913,1,115377400,115377400,1366,455,911,455,0,1,457,1049601,1.049601
855,4555,2465,11228075,2,6846,1713,1,137841400,137841400,2566,855,1711,855,0,1,857,1016557,1.016557
1255,4555,2465,11228075,2,10046,2513,1,160305400,160305400,3766,1255,2511,1255,0,1,1257,1411324,1.411324
1655,4555,2465,11228075,2,13246,3313,1,182769400,182769400,4966,1655,3311,1655,0,1,1657,1365036,1.365036
2055,4555,2465,11228075,2,16446,4113,1,205233400,205233400,6166,2055,4111,2055,0,1,2057,411302,0.411302
2455,4555,2465,11228075,2,19646,4913,1,227697400,227697400,7366,2455,4911,2455,0,1,2457,1805678,1.805678
2855,4555,2465,11228075,2,22846,5713,1,250161400,250161400,8566,2855,5711,2855,0,1,2857,1530992,1.530992
3255,4555,2465,11228075,2,26046,6513,1,272625400,272625400,9766,3255,6511,3255,0,1,3257,2183006,2.183006
3655,4555,2465,11228075,2,29246,7313,1,295089400,295089400,10966,3655,7311,3655,0,1,3657,3927970,3.92797
4055,4555,2465,11228075,2,32446,8113,1,317553400,317553400,12166,4055,8111,4055,0,1,4057,4382913,4.382913
4455,4555,2465,11228075,2,35646,8913,1,340017400,340017400,13366,4455,8911,4455,0,1,4457,7056032,7.056032
4855,4555,2465,11228075,2,38846,9713,1,362481400,362481400,14566,4855,9711,4855,0,1,4857,40711,0.040711
5255,4555,2465,11228075,2,42046,10513,1,384945400,384945400,15766,5255,10511,5255,0,1,5257,5739435,5.739435
5655,4555,2465,11228075,2,45246,11313,1,407409400,407409400,16966,5655,11311,5655,0,1,5657,4104047,4.104047
6055,4555,2465,11228075,2,48446,12113,1,429873400,429873400,18166,6055,12111,6055,0,1,6057,7837348,7.837348
6455,4555,2465,11228075,2,51646,12913,1,452337400,452337400,19366,6455,12911,6455,0,1,6457,153259,0.153259
6855,4555,2465,11228075,2,54846,13713,1,474801400,474801400,20566,6855,13711,6855,0,1,6857,3759499,3.759499
55,2055,5465,11230575,2,446,113,1,93153400,93153400,166,55,111,55,0,1,57,9094,0.009094
455,2055,5465,11230575,2,3646,913,1,117217400,117217400,1366,455,911,455,0,1,457,56100,0.0561
855,2055,5465,11230575,2,6846,1713,1,141281400,141281400,2566,855,1711,855,0,1,857,152606,0.152606
1255,2055,5465,11230575,2,10046,2513,1,165345400,165345400,3766,1255,2511,1255,0,1,1257,85016,0.085016
1655,2055,5465,11230575,2,13246,3313,1,189409400,189409400,4966,1655,3311,1655,0,1,1657,192320,0.19232
2055,2055,5465,11230575,2,16446,4113,1,213473400,213473400,6166,2055,4111,2055,0,1,2057,749270,0.74927
2455,2055,5465,11230575,2,19646,4913,1,237537400,237537400,7366,2455,4911,2455,0,1,2457,103449,0.103449
2855,2055,5465,11230575,2,22846,5713,1,261601400,261601400,8566,2855,5711,2855,0,1,2857,988086,0.988086
3255,2055,5465,11230575,2,26046,6513,1,285665400,285665400,9766,3255,6511,3255,0,1,3257,129578,0.129578
3655,2055,5465,11230575,2,29246,7313,1,309729400,309729400,10966,3655,7311,3655,0,1,3657,119088,0.119088
4055,2055,5465,11230575,2,32446,8113,1,333793400,333793400,12166,4055,8111,4055,0,1,4057,702760,0.70276
4455,2055,5465,11230575,2,35646,8913,1,357857400,357857400,13366,4455,8911,4455,0,1,4457,61012,0.061012
4855,2055,5465,11230575,2,38846,9713,1,381921400,381921400,14566,4855,9711,4855,0,1,4857,45864,0.045864
5255,2055,5465,11230575,2,42046,10513,1,405985400,405985400,15766,5255,10511,5255,0,1,5257,589086,0.589086
5655,2055,5465,11230575,2,45246,11313,1,430049400,430049400,16966,5655,11311,5655,0,1,5657,20929,0.020929
6055,2055,5465,11230575,2,48446,12113,1,454113400,454113400,18166,6055,12111,6055,0,1,6057,674054,0.674054
6455,2055,5465,11230575,2,51646,12913,1,478177400,478177400,19366,6455,12911,6455,0,1,6457,3588766,3.588766
6855,2055,5465,11230575,2,54846,13713,1,502241400,502241400,20566,6855,13711,6855,0,1,6857,437722,0.437722
35,5500,2045,11247500,2,286,73,1,92092600,92092600,106,35,71,35,0,1,37,81136,0.081136
535,5500,2045,11247500,2,4286,1073,1,122272600,122272600,1606,535,1071,535,0,1,537,299967,0.299967
1035,5500,2045,11247500,2,8286,2073,1,152452600,152452600,3106,1035,2071,1035,0,1,1037,202934,0.202934
1535,5500,2045,11247500,2,12286,3073,1,182632600,182632600,4606,1535,3071,1535,0,1,1537,2389258,2.389258
2035,5500,2045,11247500,2,16286,4073,1,212812600,212812600,6106,2035,4071,2035,0,1,2037,1002799,1.002799
2535,5500,2045,11247500,2,20286,5073,1,242992600,242992600,7606,2535,5071,2535,0,1,2537,4510566,4.510566
3035,5500,2045,11247500,2,24286,6073,1,273172600,273172600,9106,3035,6071,3035,0,1,3037,2759069,2.759069
3535,5500,2045,11247500,2,28286,7073,1,303352600,303352600,10606,3535,7071,3535,0,1,3537,4553515,4.553515
4035,5500,2045,11247500,2,32286,8073,1,333532600,333532600,12106,4035,8071,4035,0,1,4037,1663167,1.663167
4535,5500,2045,11247500,2,36286,9073,1,363712600,363712600,13606,4535,9071,4535,0,1,4537,54721,0.054721
5035,5500,2045,11247500,2,40286,10073,1,393892600,393892600,15106,5035,10071,5035,0,1,5037,1016380,1.01638
5535,5500,2045,11247500,2,44286,11073,1,424072600,424072600,16606,5535,11071,5535,0,1,5537,7682418,7.682418
6035,5500,2045,11247500,2,48286,12073,1,454252600,454252600,18106,6035,12071,6035,0,1,6037,3967188,3.967188
6535,5500,2045,11247500,2,52286,13073,1,484432600,484432600,19606,6535,13071,6535,0,1,6537,1071058,1.071058
7035,5500,2045,11247500,2,56286,14073,1,514612600,514612600,21106,7035,14071,7035,0,1,7037,2732547,2.732547
39,2793,4041,11286513,2,318,81,1,92424312,92424312,118,39,79,39,0,1,41,209045,0.209045
539,2793,4041,11286513,2,4318,1081,1,119760312,119760312,1618,539,1079,539,0,1,541,1236734,1.236734
1039,2793,4041,11286513,2,8318,2081,1,147096312,147096312,3118,1039,2079,1039,0,1,1041,925415,0.925415
1539,2793,4041,11286513,2,12318,3081,1,174432312,174432312,4618,1539,3079,1539,0,1,1541,82182,0.082182
2039,2793,4041,11286513,2,16318,4081,1,201768312,201768312,6118,2039,4079,2039,0,1,2041,4412819,4.412819
2539,2793,4041,11286513,2,20318,5081,1,229104312,229104312,7618,2539,5079,2539,0,1,2541,227105,0.227105
3039,2793,4041,11286513,2,24318,6081,1,256440312,256440312,9118,3039,6079,3039,0,1,3041,1293196,1.293196
3539,2793,4041,11286513,2,28318,7081,1,283776312,283776312,10618,3539,7079,3539,0,1,3541,1129322,1.129322
4039,2793,4041,11286513,2,32318,8081,1,311112312,311112312,12118,4039,8079,4039,0,1,4041,2174943,2.174943
4539,2793,4041,11286513,2,36318,9081,1,338448312,338448312,13618,4539,9079,4539,0,1,4541,3303048,3.303048
5039,2793,4041,11286513,2,40318,10081,1,365784312,365784312,15118,5039,10079,5039,0,1,5041,61928,0.061928
5539,2793,4041,11286513,2,44318,11081,1,393120312,393120312,16618,5539,11079,5539,0,1,5541,515421,0.515421
6039,2793,4041,11286513,2,48318,12081,1,420456312,420456312,18118,6039,12079,6039,0,1,6041,5794607,5.794607
6539,2793,4041,11286513,2,52318,13081,1,447792312,447792312,19618,6539,13079,6539,0,1,6541,2866624,2.866624
7039,2793,4041,11286513,2,56318,14081,1,475128312,475128312,21118,7039,14079,7039,0,1,7041,3743433,3.743433
39,4443,2541,11289663,2,318,81,1,92496312,92496312,118,39,79,39,0,1,41,29684,0.029684
539,4443,2541,11289663,2,4318,1081,1,120432312,120432312,1618,539,1079,539,0,1,541,102873,0.102873
1039,4443,2541,11289663,2,8318,2081,1,148368312,148368312,3118,1039,2079,1039,0,1,1041,150344,0.150344
1539,4443,2541,11289663,2,12318,3081,1,176304312,176304312,4618,1539,3079,1539,0,1,1541,87238,0.087238
2039,4443,2541,11289663,2,16318,4081,1,204240312,204240312,6118,2039,4079,2039,0,1,2041,368587,0.368587
2539,4443,2541,11289663,2,20318,5081,1,232176312,232176312,7618,2539,5079,2539,0,1,2541,1576324,1.576324
3039,4443,2541,11289663,2,24318,6081,1,260112312,260112312,9118,3039,6079,3039,0,1,3041,436561,0.436561
3539,4443,2541,11289663,2,28318,7081,1,288048312,288048312,10618,3539,7079,3539,0,1,3541,2156851,2.156851
4039,4443,2541,11289663,2,32318,8081,1,315984312,315984312,12118,4039,8079,4039,0,1,4041,375637,0.375637
4539,4443,2541,11289663,2,36318,9081,1,343920312,343920312,13618,4539,9079,4539,0,1,4541,3137541,3.137541
5039,4443,2541,11289663,2,40318,10081,1,371856312,371856312,15118,5039,10079,5039,0,1,5041,100139,0.100139
5539,4443,2541,11289663,2,44318,11081,1,399792312,399792312,16618,5539,11079,5539,0,1,5541,3759448,3.759448
6039,4443,2541,11289663,2,48318,12081,1,427728312,427728312,18118,6039,12079,6039,0,1,6041,2022818,2.022818
6539,4443,2541,11289663,2,52318,13081,1,455664312,455664312,19618,6539,13079,6539,0,1,6541,7344946,7.344946
7039,4443,2541,11289663,2,56318,14081,1,483600312,483600312,21118,7039,14079,7039,0,1,7041,6593265,6.593265
55,6055,1865,11292575,2,446,113,1,93825400,93825400,166,55,111,55,0,1,57,221360,0.22136
455,6055,1865,11292575,2,3646,913,1,119169400,119169400,1366,455,911,455,0,1,457,1057244,1.057244
855,6055,1865,11292575,2,6846,1713,1,144513400,144513400,2566,855,1711,855,0,1,857,1116807,1.116807
1255,6055,1865,11292575,2,10046,2513,1,169857400,169857400,3766,1255,2511,1255,0,1,1257,2757822,2.757822
1655,6055,1865,11292575,2,13246,3313,1,195201400,195201400,4966,1655,3311,1655,0,1,1657,3610672,3.610672
2055,6055,1865,11292575,2,16446,4113,1,220545400,220545400,6166,2055,4111,2055,0,1,2057,568078,0.568078
2455,6055,1865,11292575,2,19646,4913,1,245889400,245889400,7366,2455,4911,2455,0,1,2457,2063533,2.063533
2855,6055,1865,11292575,2,22846,5713,1,271233400,271233400,8566,2855,5711,2855,0,1,2857,1970570,1.97057
3255,6055,1865,11292575,2,26046,6513,1,296577400,296577400,9766,3255,6511,3255,0,1,3257,233282,0.233282
3655,6055,1865,11292575,2,29246,7313,1,321921400,321921400,10966,3655,7311,3655,0,1,3657,2780485,2.780485
4055,6055,1865,11292575,2,32446,8113,1,347265400,347265400,12166,4055,8111,4055,0,1,4057,1195460,1.19546
4455,6055,1865,11292575,2,35646,8913,1,372609400,372609400,13366,4455,8911,4455,0,1,4457,1372956,1.372956
4855,6055,1865,11292575,2,38846,9713,1,397953400,397953400,14566,4855,9711,4855,0,1,4857,755767,0.755767
5255,6055,1865,11292575,2,42046,10513,1,423297400,423297400,15766,5255,10511,5255,0,1,5257,2040586,2.040586
5655,6055,1865,11292575,2,45246,11313,1,448641400,448641400,16966,5655,11311,5655,0,1,5657,1385048,1.385048
6055,6055,1865,11292575,2,48446,12113,1,473985400,473985400,18166,6055,12111,6055,0,1,6057,12184599,12.184599
6455,6055,1865,11292575,2,51646,12913,1,499329400,499329400,19366,6455,12911,6455,0,1,6457,4178137,4.178137
6855,6055,1865,11292575,2,54846,13713,1,524673400,524673400,20566,6855,13711,6855,0,1,6857,1799582,1.799582
35,4440,2545,11299800,2,286,73,1,92354200,92354200,106,35,71,35,0,1,37,213497,0.213497
535,4440,2545,11299800,2,4286,1073,1,120294200,120294200,1606,535,1071,535,0,1,537,1208528,1.208528
1035,4440,2545,11299800,2,8286,2073,1,148234200,148234200,3106,1035,2071,1035,0,1,1037,2241681,2.241681
1535,4440,2545,11299800,2,12286,3073,1,176174200,176174200,4606,1535,3071,1535,0,1,1537,3335130,3.33513
2035,4440,2545,11299800,2,16286,4073,1,204114200,204114200,6106,2035,4071,2035,0,1,2037,4394947,4.394947
35,2240,5045,11300800,2,286,73,1,92446200,92446200,106,35,71,35,0,1,37,207720,0.20772
535,2240,5045,11300800,2,4286,1073,1,121586200,121586200,1606,535,1071,535,0,1,537,1215719,1.215719
1035,2240,5045,11300800,2,8286,2073,1,150726200,150726200,3106,1035,2071,1035,0,1,1037,2264082,2.264082
1535,2240,5045,11300800,2,12286,3073,1,179866200,179866200,4606,1535,3071,1535,0,1,1537,3321254,3.321254
2035,2240,5045,11300800,2,16286,4073,1,209006200,209006200,6106,2035,4071,2035,0,1,2037,4378927,4.378927
2535,2240,5045,11300800,2,20286,5073,1,238146200,238146200,7606,2535,5071,2535,0,1,2537,5433948,5.433948
39,2243,5041,11306963,2,318,81,1,92728312,92728312,118,39,79,39,0,1,41,9527,0.009527
539,2243,5041,11306963,2,4318,1081,1,121864312,121864312,1618,539,1079,539,0,1,541,238,0.000238
1039,2243,5041,11306963,2,8318,2081,1,151000312,151000312,3118,1039,2079,1039,0,1,1041,145140,0.14514
1539,2243,5041,11306963,2,12318,3081,1,180136312,180136312,4618,1539,3079,1539,0,1,1541,89628,0.089628
2039,2243,5041,11306963,2,16318,4081,1,209272312,209272312,6118,2039,4079,2039,0,1,2041,16472,0.016472
2539,2243,5041,11306963,2,20318,5081,1,238408312,238408312,7618,2539,5079,2539,0,1,2541,1057350,1.05735
3039,2243,5041,11306963,2,24318,6081,1,267544312,267544312,9118,3039,6079,3039,0,1,3041,529817,0.529817
3539,2243,5041,11306963,2,28318,7081,1,296680312,296680312,10618,3539,7079,3539,0,1,3541,274239,0.274239
4039,2243,5041,11306963,2,32318,8081,1,325816312,325816312,12118,4039,8079,4039,0,1,4041,274943,0.274943
4539,2243,5041,11306963,2,36318,9081,1,354952312,354952312,13618,4539,9079,4539,0,1,4541,2961960,2.96196
5039,2243,5041,11306963,2,40318,10081,1,384088312,384088312,15118,5039,10079,5039,0,1,5041,134650,0.13465
5539,2243,5041,11306963,2,44318,11081,1,413224312,413224312,16618,5539,11079,5539,0,1,5541,1766197,1.766197
6039,2243,5041,11306963,2,48318,12081,1,442360312,442360312,18118,6039,12079,6039,0,1,6041,107588,0.107588
6539,2243,5041,11306963,2,52318,13081,1,471496312,471496312,19618,6539,13079,6539,0,1,6541,698908,0.698908
7039,2243,5041,11306963,2,56318,14081,1,500632312,500632312,21118,7039,14079,7039,0,1,7041,6576760,6.57676
39,5543,2041,11313263,2,318,81,1,92872312,92872312,118,39,79,39,0,1,41,336,0.000336
539,5543,2041,11313263,2,4318,1081,1,123208312,123208312,1618,539,1079,539,0,1,541,139410,0.13941
1039,5543,2041,11313263,2,8318,2081,1,153544312,153544312,3118,1039,2079,1039,0,1,1041,398663,0.398663
1539,5543,2041,11313263,2,12318,3081,1,183880312,183880312,4618,1539,3079,1539,0,1,1541,194348,0.194348
2039,5543,2041,11313263,2,16318,4081,1,214216312,214216312,6118,2039,4079,2039,0,1,2041,769000,0.769
2539,5543,2041,11313263,2,20318,5081,1,244552312,244552312,7618,2539,5079,2539,0,1,2541,1671039,1.671039
3039,5543,2041,11313263,2,24318,6081,1,274888312,274888312,9118,3039,6079,3039,0,1,3041,2371439,2.371439
3539,5543,2041,11313263,2,28318,7081,1,305224312,305224312,10618,3539,7079,3539,0,1,3541,470422,0.470422
4039,5543,2041,11313263,2,32318,8081,1,335560312,335560312,12118,4039,8079,4039,0,1,4041,2406567,2.406567
4539,5543,2041,11313263,2,36318,9081,1,365896312,365896312,13618,4539,9079,4539,0,1,4541,4574244,4.574244
5039,5543,2041,11313263,2,40318,10081,1,396232312,396232312,15118,5039,10079,5039,0,1,5041,1929088,1.929088
5539,5543,2041,11313263,2,44318,11081,1,426568312,426568312,16618,5539,11079,5539,0,1,5541,5713714,5.713714
6039,5543,2041,11313263,2,48318,12081,1,456904312,456904312,18118,6039,12079,6039,0,1,6041,1148297,1.148297
6539,5543,2041,11313263,2,52318,13081,1,487240312,487240312,19618,6539,13079,6539,0,1,6541,5624118,5.624118
7039,5543,2041,11313263,2,56318,14081,1,517576312,517576312,21118,7039,14079,7039,0,1,7041,2892335,2.892335
35,5540,2045,11329300,2,286,73,1,92758200,92758200,106,35,71,35,0,1,37,201277,0.201277
535,5540,2045,11329300,2,4286,1073,1,123098200,123098200,1606,535,1071,535,0,1,537,424817,0.424817
1035,5540,2045,11329300,2,8286,2073,1,153438200,153438200,3106,1035,2071,1035,0,1,1037,130885,0.130885
1535,5540,2045,11329300,2,12286,3073,1,183778200,183778200,4606,1535,3071,1535,0,1,1537,3363833,3.363833
40,5300,2140,11342000,2,326,83,1,93116800,93116800,121,40,81,40,0,1,42,205452,0.205452
440,5300,2140,11342000,2,3526,883,1,116924800,116924800,1321,440,881,440,0,1,442,1050689,1.050689
840,5300,2140,11342000,2,6726,1683,1,140732800,140732800,2521,840,1681,840,0,1,842,1923775,1.923775
1240,5300,2140,11342000,2,9926,2483,1,164540800,164540800,3721,1240,2481,1240,0,1,1242,980457,0.980457
1640,5300,2140,11342000,2,13126,3283,1,188348800,188348800,4921,1640,3281,1640,0,1,1642,3668335,3.668335
2040,5300,2140,11342000,2,16326,4083,1,212156800,212156800,6121,2040,4081,2040,0,1,2042,2241914,2.241914
2440,5300,2140,11342000,2,19526,4883,1,235964800,235964800,7321,2440,4881,2440,0,1,2442,585306,0.585306
2840,5300,2140,11342000,2,22726,5683,1,259772800,259772800,8521,2840,5681,2840,0,1,2842,160983,0.160983
3240,5300,2140,11342000,2,25926,6483,1,283580800,283580800,9721,3240,6481,3240,0,1,3242,1136576,1.136576
3640,5300,2140,11342000,2,29126,7283,1,307388800,307388800,10921,3640,7281,3640,0,1,3642,788261,0.788261
4040,5300,2140,11342000,2,32326,8083,1,331196800,331196800,12121,4040,8081,4040,0,1,4042,200695,0.200695
4440,5300,2140,11342000,2,35526,8883,1,355004800,355004800,13321,4440,8881,4440,0,1,4442,122284,0.122284
4840,5300,2140,11342000,2,38726,9683,1,378812800,378812800,14521,4840,9681,4840,0,1,4842,1443546,1.443546
5240,5300,2140,11342000,2,41926,10483,1,402620800,402620800,15721,5240,10481,5240,0,1,5242,3164583,3.164583
5640,5300,2140,11342000,2,45126,11283,1,426428800,426428800,16921,5640,11281,5640,0,1,5642,4354764,4.354764
6040,5300,2140,11342000,2,48326,12083,1,450236800,450236800,18121,6040,12081,6040,0,1,6042,1668867,1.668867
6440,5300,2140,11342000,2,51526,12883,1,474044800,474044800,19321,6440,12881,6440,0,1,6442,2868090,2.86809
6840,5300,2140,11342000,2,54726,13683,1,497852800,497852800,20521,6840,13681,6840,0,1,6842,633096,0.633096
44,2803,4055,11366165,2,358,91,1,93343336,93343336,133,44,89,44,0,1,46,214561,0.214561
544,2803,4055,11366165,2,4358,1091,1,120775336,120775336,1633,544,1089,544,0,1,546,1242344,1.242344
1044,2803,4055,11366165,2,8358,2091,1,148207336,148207336,3133,1044,2089,1044,0,1,1046,2290424,2.290424
1544,2803,4055,11366165,2,12358,3091,1,175639336,175639336,4633,1544,3089,1544,0,1,1546,3278813,3.278813
2044,2803,4055,11366165,2,16358,4091,1,203071336,203071336,6133,2044,4089,2044,0,1,2046,518823,0.518823
2544,2803,4055,11366165,2,20358,5091,1,230503336,230503336,7633,2544,5089,2544,0,1,2546,4496285,4.496285
3044,2803,4055,11366165,2,24358,6091,1,257935336,257935336,9133,3044,6089,3044,0,1,3046,2256876,2.256876
3544,2803,4055,11366165,2,28358,7091,1,285367336,285367336,10633,3544,7089,3544,0,1,3546,2664640,2.66464
4044,2803,4055,11366165,2,32358,8091,1,312799336,312799336,12133,4044,8089,4044,0,1,4046,428294,0.428294
4544,2803,4055,11366165,2,36358,9091,1,340231336,340231336,13633,4544,9089,4544,0,1,4546,1128208,1.128208
5044,2803,4055,11366165,2,40358,10091,1,367663336,367663336,15133,5044,10089,5044,0,1,5046,176071,0.176071
5544,2803,4055,11366165,2,44358,11091,1,395095336,395095336,16633,5544,11089,5544,0,1,5546,2179689,2.179689
6044,2803,4055,11366165,2,48358,12091,1,422527336,422527336,18133,6044,12089,6044,0,1,6046,2738731,2.738731
6544,2803,4055,11366165,2,52358,13091,1,449959336,449959336,19633,6544,13089,6544,0,1,6546,3023867,3.023867
7044,2803,4055,11366165,2,56358,14091,1,477391336,477391336,21133,7044,14089,7044,0,1,7046,84856,0.084856
44,4453,2555,11377415,2,358,91,1,93486136,93486136,133,44,89,44,0,1,46,9789,0.009789
544,4453,2555,11377415,2,4358,1091,1,121518136,121518136,1633,544,1089,544,0,1,546,22451,0.022451
1044,4453,2555,11377415,2,8358,2091,1,149550136,149550136,3133,1044,2089,1044,0,1,1046,79298,0.079298
1544,4453,2555,11377415,2,12358,3091,1,177582136,177582136,4633,1544,3089,1544,0,1,1546,578578,0.578578
2044,4453,2555,11377415,2,16358,4091,1,205614136,205614136,6133,2044,4089,2044,0,1,2046,856749,0.856749
2544,4453,2555,11377415,2,20358,5091,1,233646136,233646136,7633,2544,5089,2544,0,1,2546,1373669,1.373669
3044,4453,2555,11377415,2,24358,6091,1,261678136,261678136,9133,3044,6089,3044,0,1,3046,1689284,1.689284
3544,4453,2555,11377415,2,28358,7091,1,289710136,289710136,10633,3544,7089,3544,0,1,3546,217857,0.217857
4044,4453,2555,11377415,2,32358,8091,1,317742136,317742136,12133,4044,8089,4044,0,1,4046,1021172,1.021172
4544,4453,2555,11377415,2,36358,9091,1,345774136,345774136,13633,4544,9089,4544,0,1,4546,339933,0.339933
5044,4453,2555,11377415,2,40358,10091,1,373806136,373806136,15133,5044,10089,5044,0,1,5046,1596859,1.596859
5544,4453,2555,11377415,2,44358,11091,1,401838136,401838136,16633,5544,11089,5544,0,1,5546,544044,0.544044
6044,4453,2555,11377415,2,48358,12091,1,429870136,429870136,18133,6044,12089,6044,0,1,6046,2677937,2.677937
6544,4453,2555,11377415,2,52358,13091,1,457902136,457902136,19633,6544,13089,6544,0,1,6546,3100253,3.100253
7044,4453,2555,11377415,2,56358,14091,1,485934136,485934136,21133,7044,14089,7044,0,1,7046,5944165,5.944165
44,2253,5055,11388915,2,358,91,1,93683736,93683736,133,44,89,44,0,1,46,42638,0.042638
544,2253,5055,11388915,2,4358,1091,1,122915736,122915736,1633,544,1089,544,0,1,546,49274,0.049274
1044,2253,5055,11388915,2,8358,2091,1,152147736,152147736,3133,1044,2089,1044,0,1,1046,9534,0.009534
1544,2253,5055,11388915,2,12358,3091,1,181379736,181379736,4633,1544,3089,1544,0,1,1546,95207,0.095207
2044,2253,5055,11388915,2,16358,4091,1,210611736,210611736,6133,2044,4089,2044,0,1,2046,56343,0.056343
2544,2253,5055,11388915,2,20358,5091,1,239843736,239843736,7633,2544,5089,2544,0,1,2546,622231,0.622231
3044,2253,5055,11388915,2,24358,6091,1,269075736,269075736,9133,3044,6089,3044,0,1,3046,115610,0.11561
3544,2253,5055,11388915,2,28358,7091,1,298307736,298307736,10633,3544,7089,3544,0,1,3546,204949,0.204949
4044,2253,5055,11388915,2,32358,8091,1,327539736,327539736,12133,4044,8089,4044,0,1,4046,960530,0.96053
4544,2253,5055,11388915,2,36358,9091,1,356771736,356771736,13633,4544,9089,4544,0,1,4546,3369427,3.369427
5044,2253,5055,11388915,2,40358,10091,1,386003736,386003736,15133,5044,10089,5044,0,1,5046,182347,0.182347
5544,2253,5055,11388915,2,44358,11091,1,415235736,415235736,16633,5544,11089,5544,0,1,5546,1880977,1.880977
6044,2253,5055,11388915,2,48358,12091,1,444467736,444467736,18133,6044,12089,6044,0,1,6046,848861,0.848861
6544,2253,5055,11388915,2,52358,13091,1,473699736,473699736,19633,6544,13089,6544,0,1,6546,1300306,1.300306
7044,2253,5055,11388915,2,56358,14091,1,502931736,502931736,21133,7044,14089,7044,0,1,7046,948306,0.948306
44,5553,2055,11411415,2,358,91,1,93969336,93969336,133,44,89,44,0,1,46,19377,0.019377
544,5553,2055,11411415,2,4358,1091,1,124401336,124401336,1633,544,1089,544,0,1,546,49167,0.049167
1044,5553,2055,11411415,2,8358,2091,1,154833336,154833336,3133,1044,2089,1044,0,1,1046,367176,0.367176
1544,5553,2055,11411415,2,12358,3091,1,185265336,185265336,4633,1544,3089,1544,0,1,1546,105755,0.105755
2044,5553,2055,11411415,2,16358,4091,1,215697336,215697336,6133,2044,4089,2044,0,1,2046,1828927,1.828927
2544,5553,2055,11411415,2,20358,5091,1,246129336,246129336,7633,2544,5089,2544,0,1,2546,1482277,1.482277
3044,5553,2055,11411415,2,24358,6091,1,276561336,276561336,9133,3044,6089,3044,0,1,3046,1639793,1.639793
3544,5553,2055,11411415,2,28358,7091,1,306993336,306993336,10633,3544,7089,3544,0,1,3546,129773,0.129773
4044,5553,2055,11411415,2,32358,8091,1,337425336,337425336,12133,4044,8089,4044,0,1,4046,2697765,2.697765
4544,5553,2055,11411415,2,36358,9091,1,367857336,367857336,13633,4544,9089,4544,0,1,4546,622948,0.622948
5044,5553,2055,11411415,2,40358,10091,1,398289336,398289336,15133,5044,10089,5044,0,1,5046,4871620,4.87162
5544,5553,2055,11411415,2,44358,11091,1,428721336,428721336,16633,5544,11089,5544,0,1,5546,575878,0.575878
6044,5553,2055,11411415,2,48358,12091,1,459153336,459153336,18133,6044,12089,6044,0,1,6046,2254556,2.254556
6544,5553,2055,11411415,2,52358,13091,1,489585336,489585336,19633,6544,13089,6544,0,1,6546,5440939,5.440939
7044,5553,2055,11411415,2,56358,14091,1,520017336,520017336,21133,7044,14089,7044,0,1,7046,2186314,2.186314
40,1800,6340,11412000,2,326,83,1,93900800,93900800,121,40,81,40,0,1,42,213025,0.213025
440,1800,6340,11412000,2,3526,883,1,119948800,119948800,1321,440,881,440,0,1,442,544485,0.544485
840,1800,6340,11412000,2,6726,1683,1,145996800,145996800,2521,840,1681,840,0,1,842,1137641,1.137641
1240,1800,6340,11412000,2,9926,2483,1,172044800,172044800,3721,1240,2481,1240,0,1,1242,535036,0.535036
1640,1800,6340,11412000,2,13126,3283,1,198092800,198092800,4921,1640,3281,1640,0,1,1642,510246,0.510246
2040,1800,6340,11412000,2,16326,4083,1,224140800,224140800,6121,2040,4081,2040,0,1,2042,392310,0.39231
2440,1800,6340,11412000,2,19526,4883,1,250188800,250188800,7321,2440,4881,2440,0,1,2442,1884310,1.88431
2840,1800,6340,11412000,2,22726,5683,1,276236800,276236800,8521,2840,5681,2840,0,1,2842,516515,0.516515
3240,1800,6340,11412000,2,25926,6483,1,302284800,302284800,9721,3240,6481,3240,0,1,3242,350670,0.35067
3640,1800,6340,11412000,2,29126,7283,1,328332800,328332800,10921,3640,7281,3640,0,1,3642,2238360,2.23836
4040,1800,6340,11412000,2,32326,8083,1,354380800,354380800,12121,4040,8081,4040,0,1,4042,2533334,2.533334
4440,1800,6340,11412000,2,35526,8883,1,380428800,380428800,13321,4440,8881,4440,0,1,4442,769797,0.769797
4840,1800,6340,11412000,2,38726,9683,1,406476800,406476800,14521,4840,9681,4840,0,1,4842,1193280,1.19328
5240,1800,6340,11412000,2,41926,10483,1,432524800,432524800,15721,5240,10481,5240,0,1,5242,5269586,5.269586
5640,1800,6340,11412000,2,45126,11283,1,458572800,458572800,16921,5640,11281,5640,0,1,5642,606032,0.606032
6040,1800,6340,11412000,2,48326,12083,1,484620800,484620800,18121,6040,12081,6040,0,1,6042,232230,0.23223
6440,1800,6340,11412000,2,51526,12883,1,510668800,510668800,19321,6440,12881,6440,0,1,6442,547467,0.547467
6840,1800,6340,11412000,2,54726,13683,1,536716800,536716800,20521,6840,13681,6840,0,1,6842,1470364,1.470364
55,5305,2165,11485325,2,446,113,1,95169400,95169400,166,55,111,55,0,1,57,229068,0.229068
455,5305,2165,11485325,2,3646,913,1,119073400,119073400,1366,455,911,455,0,1,457,1096264,1.096264
855,5305,2165,11485325,2,6846,1713,1,142977400,142977400,2566,855,1711,855,0,1,857,1053280,1.05328
1255,5305,2165,11485325,2,10046,2513,1,166881400,166881400,3766,1255,2511,1255,0,1,1257,822437,0.822437
1655,5305,2165,11485325,2,13246,3313,1,190785400,190785400,4966,1655,3311,1655,0,1,1657,3725211,3.725211
2055,5305,2165,11485325,2,16446,4113,1,214689400,214689400,6166,2055,4111,2055,0,1,2057,2232448,2.232448
2455,5305,2165,11485325,2,19646,4913,1,238593400,238593400,7366,2455,4911,2455,0,1,2457,721932,0.721932
2855,5305,2165,11485325,2,22846,5713,1,262497400,262497400,8566,2855,5711,2855,0,1,2857,1851258,1.851258
3255,5305,2165,11485325,2,26046,6513,1,286401400,286401400,9766,3255,6511,3255,0,1,3257,346205,0.346205
3655,5305,2165,11485325,2,29246,7313,1,310305400,310305400,10966,3655,7311,3655,0,1,3657,3484221,3.484221
4055,5305,2165,11485325,2,32446,8113,1,334209400,334209400,12166,4055,8111,4055,0,1,4057,927823,0.927823
4455,5305,2165,11485325,2,35646,8913,1,358113400,358113400,13366,4455,8911,4455,0,1,4457,997444,0.997444
4855,5305,2165,11485325,2,38846,9713,1,382017400,382017400,14566,4855,9711,4855,0,1,4857,200414,0.200414
5255,5305,2165,11485325,2,42046,10513,1,405921400,405921400,15766,5255,10511,5255,0,1,5257,1426086,1.426086
5655,5305,2165,11485325,2,45246,11313,1,429825400,429825400,16966,5655,11311,5655,0,1,5657,2269912,2.269912
6055,5305,2165,11485325,2,48446,12113,1,453729400,453729400,18166,6055,12111,6055,0,1,6057,5019990,5.01999
6455,5305,2165,11485325,2,51646,12913,1,477633400,477633400,19366,6455,12911,6455,0,1,6457,2678305,2.678305
6855,5305,2165,11485325,2,54846,13713,1,501537400,501537400,20566,6855,13711,6855,0,1,6857,1527351,1.527351
55,1805,6365,11488825,2,446,113,1,95505400,95505400,166,55,111,55,0,1,57,243382,0.243382
455,1805,6365,11488825,2,3646,913,1,121649400,121649400,1366,455,911,455,0,1,457,1113576,1.113576
855,1805,6365,11488825,2,6846,1713,1,147793400,147793400,2566,855,1711,855,0,1,857,831150,0.83115
1255,1805,6365,11488825,2,10046,2513,1,173937400,173937400,3766,1255,2511,1255,0,1,1257,696357,0.696357
1655,1805,6365,11488825,2,13246,3313,1,200081400,200081400,4966,1655,3311,1655,0,1,1657,1426974,1.426974
2055,1805,6365,11488825,2,16446,4113,1,226225400,226225400,6166,2055,4111,2055,0,1,2057,2620347,2.620347
2455,1805,6365,11488825,2,19646,4913,1,252369400,252369400,7366,2455,4911,2455,0,1,2457,3987245,3.987245
2855,1805,6365,11488825,2,22846,5713,1,278513400,278513400,8566,2855,5711,2855,0,1,2857,808808,0.808808
3255,1805,6365,11488825,2,26046,6513,1,304657400,304657400,9766,3255,6511,3255,0,1,3257,1013361,1.013361
3655,1805,6365,11488825,2,29246,7313,1,330801400,330801400,10966,3655,7311,3655,0,1,3657,893297,0.893297
4055,1805,6365,11488825,2,32446,8113,1,356945400,356945400,12166,4055,8111,4055,0,1,4057,164041,0.164041
4455,1805,6365,11488825,2,35646,8913,1,383089400,383089400,13366,4455,8911,4455,0,1,4457,660715,0.660715
4855,1805,6365,11488825,2,38846,9713,1,409233400,409233400,14566,4855,9711,4855,0,1,4857,914027,0.914027
5255,1805,6365,11488825,2,42046,10513,1,435377400,435377400,15766,5255,10511,5255,0,1,5257,141845,0.141845
5655,1805,6365,11488825,2,45246,11313,1,461521400,461521400,16966,5655,11311,5655,0,1,5657,388927,0.388927
6055,1805,6365,11488825,2,48446,12113,1,487665400,487665400,18166,6055,12111,6055,0,1,6057,2021266,2.021266
6455,1805,6365,11488825,2,51646,12913,1,513809400,513809400,19366,6455,12911,6455,0,1,6457,3678649,3.678649
6855,1805,6365,11488825,2,54846,13713,1,539953400,539953400,20566,6855,13711,6855,0,1,6857,444477,0.444477
40,3800,3040,11552000,2,326,83,1,94604800,94604800,121,40,81,40,0,1,42,211646,0.211646
440,3800,3040,11552000,2,3526,883,1,116492800,116492800,1321,440,881,440,0,1,442,1043494,1.043494
840,3800,3040,11552000,2,6726,1683,1,138380800,138380800,2521,840,1681,840,0,1,842,1893707,1.893707
1240,3800,3040,11552000,2,9926,2483,1,160268800,160268800,3721,1240,2481,1240,0,1,1242,2744533,2.744533
1640,3800,3040,11552000,2,13126,3283,1,182156800,182156800,4921,1640,3281,1640,0,1,1642,3598843,3.598843
2040,3800,3040,11552000,2,16326,4083,1,204044800,204044800,6121,2040,4081,2040,0,1,2042,4458474,4.458474
2440,3800,3040,11552000,2,19526,4883,1,225932800,225932800,7321,2440,4881,2440,0,1,2442,711103,0.711103
2840,3800,3040,11552000,2,22726,5683,1,247820800,247820800,8521,2840,5681,2840,0,1,2842,1530270,1.53027
3240,3800,3040,11552000,2,25926,6483,1,269708800,269708800,9721,3240,6481,3240,0,1,3242,1045890,1.04589
3640,3800,3040,11552000,2,29126,7283,1,291596800,291596800,10921,3640,7281,3640,0,1,3642,578621,0.578621
4040,3800,3040,11552000,2,32326,8083,1,313484800,313484800,12121,4040,8081,4040,0,1,4042,5390757,5.390757
4440,3800,3040,11552000,2,35526,8883,1,335372800,335372800,13321,4440,8881,4440,0,1,4442,2691752,2.691752
4840,3800,3040,11552000,2,38726,9683,1,357260800,357260800,14521,4840,9681,4840,0,1,4842,460654,0.460654
5240,3800,3040,11552000,2,41926,10483,1,379148800,379148800,15721,5240,10481,5240,0,1,5242,99768,0.099768
5640,3800,3040,11552000,2,45126,11283,1,401036800,401036800,16921,5640,11281,5640,0,1,5642,8084688,8.084688
6040,3800,3040,11552000,2,48326,12083,1,422924800,422924800,18121,6040,12081,6040,0,1,6042,2281544,2.281544
6440,3800,3040,11552000,2,51526,12883,1,444812800,444812800,19321,6440,12881,6440,0,1,6442,2291156,2.291156
6840,3800,3040,11552000,2,54726,13683,1,466700800,466700800,20521,6840,13681,6840,0,1,6842,695998,0.695998
40,2550,4540,11577000,2,326,83,1,94884800,94884800,121,40,81,40,0,1,42,205440,0.20544
440,2550,4540,11577000,2,3526,883,1,117572800,117572800,1321,440,881,440,0,1,442,112811,0.112811
840,2550,4540,11577000,2,6726,1683,1,140260800,140260800,2521,840,1681,840,0,1,842,144119,0.144119
1240,2550,4540,11577000,2,9926,2483,1,162948800,162948800,3721,1240,2481,1240,0,1,1242,1957202,1.957202
1640,2550,4540,11577000,2,13126,3283,1,185636800,185636800,4921,1640,3281,1640,0,1,1642,53019,0.053019
2040,2550,4540,11577000,2,16326,4083,1,208324800,208324800,6121,2040,4081,2040,0,1,2042,1774509,1.774509
2440,2550,4540,11577000,2,19526,4883,1,231012800,231012800,7321,2440,4881,2440,0,1,2442,1200423,1.200423
2840,2550,4540,11577000,2,22726,5683,1,253700800,253700800,8521,2840,5681,2840,0,1,2842,3487898,3.487898
3240,2550,4540,11577000,2,25926,6483,1,276388800,276388800,9721,3240,6481,3240,0,1,3242,2500601,2.500601
3640,2550,4540,11577000,2,29126,7283,1,299076800,299076800,10921,3640,7281,3640,0,1,3642,2931173,2.931173
4040,2550,4540,11577000,2,32326,8083,1,321764800,321764800,12121,4040,8081,4040,0,1,4042,1588296,1.588296
4440,2550,4540,11577000,2,35526,8883,1,344452800,344452800,13321,4440,8881,4440,0,1,4442,1254212,1.254212
4840,2550,4540,11577000,2,38726,9683,1,367140800,367140800,14521,4840,9681,4840,0,1,4842,1273667,1.273667
5240,2550,4540,11577000,2,41926,10483,1,389828800,389828800,15721,5240,10481,5240,0,1,5242,322205,0.322205
5640,2550,4540,11577000,2,45126,11283,1,412516800,412516800,16921,5640,11281,5640,0,1,5642,607335,0.607335
6040,2550,4540,11577000,2,48326,12083,1,435204800,435204800,18121,6040,12081,6040,0,1,6042,311283,0.311283
6440,2550,4540,11577000,2,51526,12883,1,457892800,457892800,19321,6440,12881,6440,0,1,6442,9203718,9.203718
6840,2550,4540,11577000,2,54726,13683,1,480580800,480580800,20521,6840,13681,6840,0,1,6842,1694337,1.694337
40,6300,1840,11592000,2,326,83,1,95340800,95340800,121,40,81,40,0,1,42,206360,0.20636
440,6300,1840,11592000,2,3526,883,1,121388800,121388800,1321,440,881,440,0,1,442,1026733,1.026733
840,6300,1840,11592000,2,6726,1683,1,147436800,147436800,2521,840,1681,840,0,1,842,972305,0.972305
1240,6300,1840,11592000,2,9926,2483,1,173484800,173484800,3721,1240,2481,1240,0,1,1242,2231814,2.231814
1640,6300,1840,11592000,2,13126,3283,1,199532800,199532800,4921,1640,3281,1640,0,1,1642,277751,0.277751
2040,6300,1840,11592000,2,16326,4083,1,225580800,225580800,6121,2040,4081,2040,0,1,2042,4328592,4.328592
2440,6300,1840,11592000,2,19526,4883,1,251628800,251628800,7321,2440,4881,2440,0,1,2442,4184266,4.184266
2840,6300,1840,11592000,2,22726,5683,1,277676800,277676800,8521,2840,5681,2840,0,1,2842,3442933,3.442933
3240,6300,1840,11592000,2,25926,6483,1,303724800,303724800,9721,3240,6481,3240,0,1,3242,1630073,1.630073
3640,6300,1840,11592000,2,29126,7283,1,329772800,329772800,10921,3640,7281,3640,0,1,3642,247031,0.247031
4040,6300,1840,11592000,2,32326,8083,1,355820800,355820800,12121,4040,8081,4040,0,1,4042,1230246,1.230246
4440,6300,1840,11592000,2,35526,8883,1,381868800,381868800,13321,4440,8881,4440,0,1,4442,4369764,4.369764
4840,6300,1840,11592000,2,38726,9683,1,407916800,407916800,14521,4840,9681,4840,0,1,4842,5971221,5.971221
5240,6300,1840,11592000,2,41926,10483,1,433964800,433964800,15721,5240,10481,5240,0,1,5242,2846187,2.846187
5640,6300,1840,11592000,2,45126,11283,1,460012800,460012800,16921,5640,11281,5640,0,1,5642,11991492,11.991492
6040,6300,1840,11592000,2,48326,12083,1,486060800,486060800,18121,6040,12081,6040,0,1,6042,5130810,5.13081
6440,6300,1840,11592000,2,51526,12883,1,512108800,512108800,19321,6440,12881,6440,0,1,6442,5135358,5.135358
6840,6300,1840,11592000,2,54726,13683,1,538156800,538156800,20521,6840,13681,6840,0,1,6842,14538526,14.538526
55,3805,3065,11662325,2,446,113,1,96321400,96321400,166,55,111,55,0,1,57,247214,0.247214
455,3805,3065,11662325,2,3646,913,1,118305400,118305400,1366,455,911,455,0,1,457,1129071,1.129071
855,3805,3065,11662325,2,6846,1713,1,140289400,140289400,2566,855,1711,855,0,1,857,1915223,1.915223
1255,3805,3065,11662325,2,10046,2513,1,162273400,162273400,3766,1255,2511,1255,0,1,1257,1472285,1.472285
1655,3805,3065,11662325,2,13246,3313,1,184257400,184257400,4966,1655,3311,1655,0,1,1657,1830554,1.830554
2055,3805,3065,11662325,2,16446,4113,1,206241400,206241400,6166,2055,4111,2055,0,1,2057,4700028,4.700028
2455,3805,3065,11662325,2,19646,4913,1,228225400,228225400,7366,2455,4911,2455,0,1,2457,748464,0.748464
2855,3805,3065,11662325,2,22846,5713,1,250209400,250209400,8566,2855,5711,2855,0,1,2857,721044,0.721044
3255,3805,3065,11662325,2,26046,6513,1,272193400,272193400,9766,3255,6511,3255,0,1,3257,2223573,2.223573
3655,3805,3065,11662325,2,29246,7313,1,294177400,294177400,10966,3655,7311,3655,0,1,3657,1485166,1.485166
4055,3805,3065,11662325,2,32446,8113,1,316161400,316161400,12166,4055,8111,4055,0,1,4057,9214931,9.214931
4455,3805,3065,11662325,2,35646,8913,1,338145400,338145400,13366,4455,8911,4455,0,1,4457,461493,0.461493
4855,3805,3065,11662325,2,38846,9713,1,360129400,360129400,14566,4855,9711,4855,0,1,4857,2702147,2.702147
5255,3805,3065,11662325,2,42046,10513,1,382113400,382113400,15766,5255,10511,5255,0,1,5257,4508308,4.508308
5655,3805,3065,11662325,2,45246,11313,1,404097400,404097400,16966,5655,11311,5655,0,1,5657,364814,0.364814
6055,3805,3065,11662325,2,48446,12113,1,426081400,426081400,18166,6055,12111,6055,0,1,6057,1494004,1.494004
6455,3805,3065,11662325,2,51646,12913,1,448065400,448065400,19366,6455,12911,6455,0,1,6457,658395,0.658395
6855,3805,3065,11662325,2,54846,13713,1,470049400,470049400,20566,6855,13711,6855,0,1,6857,203868,0.203868
55,2555,4565,11663575,2,446,113,1,96441400,96441400,166,55,111,55,0,1,57,241140,0.24114
455,2555,4565,11663575,2,3646,913,1,119225400,119225400,1366,455,911,455,0,1,457,434263,0.434263
855,2555,4565,11663575,2,6846,1713,1,142009400,142009400,2566,855,1711,855,0,1,857,1453676,1.453676
1255,2555,4565,11663575,2,10046,2513,1,164793400,164793400,3766,1255,2511,1255,0,1,1257,299276,0.299276
1655,2555,4565,11663575,2,13246,3313,1,187577400,187577400,4966,1655,3311,1655,0,1,1657,1159264,1.159264
2055,2555,4565,11663575,2,16446,4113,1,210361400,210361400,6166,2055,4111,2055,0,1,2057,2947184,2.947184
2455,2555,4565,11663575,2,19646,4913,1,233145400,233145400,7366,2455,4911,2455,0,1,2457,244496,0.244496
2855,2555,4565,11663575,2,22846,5713,1,255929400,255929400,8566,2855,5711,2855,0,1,2857,2244843,2.244843
3255,2555,4565,11663575,2,26046,6513,1,278713400,278713400,9766,3255,6511,3255,0,1,3257,3365531,3.365531
3655,2555,4565,11663575,2,29246,7313,1,301497400,301497400,10966,3655,7311,3655,0,1,3657,1641433,1.641433
4055,2555,4565,11663575,2,32446,8113,1,324281400,324281400,12166,4055,8111,4055,0,1,4057,1874530,1.87453
4455,2555,4565,11663575,2,35646,8913,1,347065400,347065400,13366,4455,8911,4455,0,1,4457,1759145,1.759145
4855,2555,4565,11663575,2,38846,9713,1,369849400,369849400,14566,4855,9711,4855,0,1,4857,230448,0.230448
5255,2555,4565,11663575,2,42046,10513,1,392633400,392633400,15766,5255,10511,5255,0,1,5257,719058,0.719058
5655,2555,4565,11663575,2,45246,11313,1,415417400,415417400,16966,5655,11311,5655,0,1,5657,725402,0.725402
6055,2555,4565,11663575,2,48446,12113,1,438201400,438201400,18166,6055,12111,6055,0,1,6057,712526,0.712526
6455,2555,4565,11663575,2,51646,12913,1,460985400,460985400,19366,6455,12911,6455,0,1,6457,4760452,4.760452
6855,2555,4565,11663575,2,54846,13713,1,483769400,483769400,20566,6855,13711,6855,0,1,6857,3045103,3.045103
40,4800,2440,11712000,2,326,83,1,96012800,96012800,121,40,81,40,0,1,42,212516,0.212516
440,4800,2440,11712000,2,3526,883,1,119180800,119180800,1321,440,881,440,0,1,442,1048987,1.048987
840,4800,2440,11712000,2,6726,1683,1,142348800,142348800,2521,840,1681,840,0,1,842,215109,0.215109
1240,4800,2440,11712000,2,9926,2483,1,165516800,165516800,3721,1240,2481,1240,0,1,1242,2735143,2.735143
1640,4800,2440,11712000,2,13126,3283,1,188684800,188684800,4921,1640,3281,1640,0,1,1642,3591806,3.591806
2040,4800,2440,11712000,2,16326,4083,1,211852800,211852800,6121,2040,4081,2040,0,1,2042,4438658,4.438658
2440,4800,2440,11712000,2,19526,4883,1,235020800,235020800,7321,2440,4881,2440,0,1,2442,1818286,1.818286
2840,4800,2440,11712000,2,22726,5683,1,258188800,258188800,8521,2840,5681,2840,0,1,2842,4122499,4.122499
3240,4800,2440,11712000,2,25926,6483,1,281356800,281356800,9721,3240,6481,3240,0,1,3242,660654,0.660654
3640,4800,2440,11712000,2,29126,7283,1,304524800,304524800,10921,3640,7281,3640,0,1,3642,281419,0.281419
4040,4800,2440,11712000,2,32326,8083,1,327692800,327692800,12121,4040,8081,4040,0,1,4042,1789311,1.789311
4440,4800,2440,11712000,2,35526,8883,1,350860800,350860800,13321,4440,8881,4440,0,1,4442,6992070,6.99207
4840,4800,2440,11712000,2,38726,9683,1,374028800,374028800,14521,4840,9681,4840,0,1,4842,8427352,8.427352
5240,4800,2440,11712000,2,41926,10483,1,397196800,397196800,15721,5240,10481,5240,0,1,5242,3219368,3.219368
5640,4800,2440,11712000,2,45126,11283,1,420364800,420364800,16921,5640,11281,5640,0,1,5642,5047832,5.047832
6040,4800,2440,11712000,2,48326,12083,1,443532800,443532800,18121,6040,12081,6040,0,1,6042,1479135,1.479135
6440,4800,2440,11712000,2,51526,12883,1,466700800,466700800,19321,6440,12881,6440,0,1,6442,7423056,7.423056
6840,4800,2440,11712000,2,54726,13683,1,489868800,489868800,20521,6840,13681,6840,0,1,6842,14742867,14.742867
55,6305,1865,11758825,2,446,113,1,97665400,97665400,166,55,111,55,0,1,57,234769,0.234769
455,6305,1865,11758825,2,3646,913,1,123809400,123809400,1366,455,911,455,0,1,457,1114824,1.114824
855,6305,1865,11758825,2,6846,1713,1,149953400,149953400,2566,855,1711,855,0,1,857,1991968,1.991968
1255,6305,1865,11758825,2,10046,2513,1,176097400,176097400,3766,1255,2511,1255,0,1,1257,1056252,1.056252
1655,6305,1865,11758825,2,13246,3313,1,202241400,202241400,4966,1655,3311,1655,0,1,1657,441390,0.44139
2055,6305,1865,11758825,2,16446,4113,1,228385400,228385400,6166,2055,4111,2055,0,1,2057,4664146,4.664146
2455,6305,1865,11758825,2,19646,4913,1,254529400,254529400,7366,2455,4911,2455,0,1,2457,5202731,5.202731
2855,6305,1865,11758825,2,22846,5713,1,280673400,280673400,8566,2855,5711,2855,0,1,2857,1978093,1.978093
3255,6305,1865,11758825,2,26046,6513,1,306817400,306817400,9766,3255,6511,3255,0,1,3257,3992847,3.992847
3655,6305,1865,11758825,2,29246,7313,1,332961400,332961400,10966,3655,7311,3655,0,1,3657,1156430,1.15643
4055,6305,1865,11758825,2,32446,8113,1,359105400,359105400,12166,4055,8111,4055,0,1,4057,974287,0.974287
4455,6305,1865,11758825,2,35646,8913,1,385249400,385249400,13366,4455,8911,4455,0,1,4457,1765901,1.765901
4855,6305,1865,11758825,2,38846,9713,1,411393400,411393400,14566,4855,9711,4855,0,1,4857,4490998,4.490998
5255,6305,1865,11758825,2,42046,10513,1,437537400,437537400,15766,5255,10511,5255,0,1,5257,4955115,4.955115
5655,6305,1865,11758825,2,45246,11313,1,463681400,463681400,16966,5655,11311,5655,0,1,5657,9007307,9.007307
6055,6305,1865,11758825,2,48446,12113,1,489825400,489825400,18166,6055,12111,6055,0,1,6057,13680050,13.68005
6455,6305,1865,11758825,2,51646,12913,1,515969400,515969400,19366,6455,12911,6455,0,1,6457,981736,0.981736
6855,6305,1865,11758825,2,54846,13713,1,542113400,542113400,20566,6855,13711,6855,0,1,6857,15394290,15.39429
40,2050,5740,11767000,2,326,83,1,96628800,96628800,121,40,81,40,0,1,42,10634,0.010634
440,2050,5740,11767000,2,3526,883,1,121556800,121556800,1321,440,881,440,0,1,442,51018,0.051018
840,2050,5740,11767000,2,6726,1683,1,146484800,146484800,2521,840,1681,840,0,1,842,196358,0.196358
1240,2050,5740,11767000,2,9926,2483,1,171412800,171412800,3721,1240,2481,1240,0,1,1242,35197,0.035197
1640,2050,5740,11767000,2,13126,3283,1,196340800,196340800,4921,1640,3281,1640,0,1,1642,45543,0.045543
2040,2050,5740,11767000,2,16326,4083,1,221268800,221268800,6121,2040,4081,2040,0,1,2042,248900,0.2489
2440,2050,5740,11767000,2,19526,4883,1,246196800,246196800,7321,2440,4881,2440,0,1,2442,518304,0.518304
2840,2050,5740,11767000,2,22726,5683,1,271124800,271124800,8521,2840,5681,2840,0,1,2842,187361,0.187361
3240,2050,5740,11767000,2,25926,6483,1,296052800,296052800,9721,3240,6481,3240,0,1,3242,165907,0.165907
3640,2050,5740,11767000,2,29126,7283,1,320980800,320980800,10921,3640,7281,3640,0,1,3642,293622,0.293622
4040,2050,5740,11767000,2,32326,8083,1,345908800,345908800,12121,4040,8081,4040,0,1,4042,891311,0.891311
4440,2050,5740,11767000,2,35526,8883,1,370836800,370836800,13321,4440,8881,4440,0,1,4442,1873613,1.873613
4840,2050,5740,11767000,2,38726,9683,1,395764800,395764800,14521,4840,9681,4840,0,1,4842,1003188,1.003188
5240,2050,5740,11767000,2,41926,10483,1,420692800,420692800,15721,5240,10481,5240,0,1,5242,504614,0.504614
5640,2050,5740,11767000,2,45126,11283,1,445620800,445620800,16921,5640,11281,5640,0,1,5642,630971,0.630971
6040,2050,5740,11767000,2,48326,12083,1,470548800,470548800,18121,6040,12081,6040,0,1,6042,457405,0.457405
6440,2050,5740,11767000,2,51526,12883,1,495476800,495476800,19321,6440,12881,6440,0,1,6442,660841,0.660841
6840,2050,5740,11767000,2,54726,13683,1,520404800,520404800,20521,6840,13681,6840,0,1,6842,4272769,4.272769
40,4300,2740,11782000,2,326,83,1,96508800,96508800,121,40,81,40,0,1,42,210982,0.210982
440,4300,2740,11782000,2,3526,883,1,119036800,119036800,1321,440,881,440,0,1,442,1057636,1.057636
840,4300,2740,11782000,2,6726,1683,1,141564800,141564800,2521,840,1681,840,0,1,842,322393,0.322393
1240,4300,2740,11782000,2,9926,2483,1,164092800,164092800,3721,1240,2481,1240,0,1,1242,28809,0.028809
1640,4300,2740,11782000,2,13126,3283,1,186620800,186620800,4921,1640,3281,1640,0,1,1642,2086703,2.086703
2040,4300,2740,11782000,2,16326,4083,1,209148800,209148800,6121,2040,4081,2040,0,1,2042,959521,0.959521
2440,4300,2740,11782000,2,19526,4883,1,231676800,231676800,7321,2440,4881,2440,0,1,2442,865071,0.865071
2840,4300,2740,11782000,2,22726,5683,1,254204800,254204800,8521,2840,5681,2840,0,1,2842,2553756,2.553756
3240,4300,2740,11782000,2,25926,6483,1,276732800,276732800,9721,3240,6481,3240,0,1,3242,20538,0.020538
3640,4300,2740,11782000,2,29126,7283,1,299260800,299260800,10921,3640,7281,3640,0,1,3642,5204983,5.204983
4040,4300,2740,11782000,2,32326,8083,1,321788800,321788800,12121,4040,8081,4040,0,1,4042,207701,0.207701
4440,4300,2740,11782000,2,35526,8883,1,344316800,344316800,13321,4440,8881,4440,0,1,4442,2407622,2.407622
4840,4300,2740,11782000,2,38726,9683,1,366844800,366844800,14521,4840,9681,4840,0,1,4842,4649354,4.649354
5240,4300,2740,11782000,2,41926,10483,1,389372800,389372800,15721,5240,10481,5240,0,1,5242,1556031,1.556031
5640,4300,2740,11782000,2,45126,11283,1,411900800,411900800,16921,5640,11281,5640,0,1,5642,39803,0.039803
6040,4300,2740,11782000,2,48326,12083,1,434428800,434428800,18121,6040,12081,6040,0,1,6042,181424,0.181424
6440,4300,2740,11782000,2,51526,12883,1,456956800,456956800,19321,6440,12881,6440,0,1,6442,3652178,3.652178
6840,4300,2740,11782000,2,54726,13683,1,479484800,479484800,20521,6840,13681,6840,0,1,6842,2025885,2.025885
40,2300,5140,11822000,2,326,83,1,96956800,96956800,121,40,81,40,0,1,42,219096,0.219096
440,2300,5140,11822000,2,3526,883,1,120764800,120764800,1321,440,881,440,0,1,442,1075928,1.075928
840,2300,5140,11822000,2,6726,1683,1,144572800,144572800,2521,840,1681,840,0,1,842,1944263,1.944263
1240,2300,5140,11822000,2,9926,2483,1,168380800,168380800,3721,1240,2481,1240,0,1,1242,2820655,2.820655
1640,2300,5140,11822000,2,13126,3283,1,192188800,192188800,4921,1640,3281,1640,0,1,1642,178185,0.178185
2040,2300,5140,11822000,2,16326,4083,1,215996800,215996800,6121,2040,4081,2040,0,1,2042,4582078,4.582078
2440,2300,5140,11822000,2,19526,4883,1,239804800,239804800,7321,2440,4881,2440,0,1,2442,798913,0.798913
2840,2300,5140,11822000,2,22726,5683,1,263612800,263612800,8521,2840,5681,2840,0,1,2842,173608,0.173608
3240,2300,5140,11822000,2,25926,6483,1,287420800,287420800,9721,3240,6481,3240,0,1,3242,1343963,1.343963
3640,2300,5140,11822000,2,29126,7283,1,311228800,311228800,10921,3640,7281,3640,0,1,3642,1675808,1.675808
4040,2300,5140,11822000,2,32326,8083,1,335036800,335036800,12121,4040,8081,4040,0,1,4042,1587995,1.587995
4440,2300,5140,11822000,2,35526,8883,1,358844800,358844800,13321,4440,8881,4440,0,1,4442,1336561,1.336561
4840,2300,5140,11822000,2,38726,9683,1,382652800,382652800,14521,4840,9681,4840,0,1,4842,606395,0.606395
5240,2300,5140,11822000,2,41926,10483,1,406460800,406460800,15721,5240,10481,5240,0,1,5242,1005872,1.005872
5640,2300,5140,11822000,2,45126,11283,1,430268800,430268800,16921,5640,11281,5640,0,1,5642,656452,0.656452
6040,2300,5140,11822000,2,48326,12083,1,454076800,454076800,18121,6040,12081,6040,0,1,6042,889563,0.889563
6440,2300,5140,11822000,2,51526,12883,1,477884800,477884800,19321,6440,12881,6440,0,1,6442,1409953,1.409953
6840,2300,5140,11822000,2,54726,13683,1,501692800,501692800,20521,6840,13681,6840,0,1,6842,2082320,2.08232
39,3343,3541,11837563,2,318,81,1,96848312,96848312,118,39,79,39,0,1,41,25788,0.025788
539,3343,3541,11837563,2,4318,1081,1,124384312,124384312,1618,539,1079,539,0,1,541,120560,0.12056
1039,3343,3541,11837563,2,8318,2081,1,151920312,151920312,3118,1039,2079,1039,0,1,1041,11806,0.011806
1539,3343,3541,11837563,2,12318,3081,1,179456312,179456312,4618,1539,3079,1539,0,1,1541,90954,0.090954
2039,3343,3541,11837563,2,16318,4081,1,206992312,206992312,6118,2039,4079,2039,0,1,2041,280632,0.280632
2539,3343,3541,11837563,2,20318,5081,1,234528312,234528312,7618,2539,5079,2539,0,1,2541,279028,0.279028
3039,3343,3541,11837563,2,24318,6081,1,262064312,262064312,9118,3039,6079,3039,0,1,3041,3966205,3.966205
3539,3343,3541,11837563,2,28318,7081,1,289600312,289600312,10618,3539,7079,3539,0,1,3541,1437157,1.437157
4039,3343,3541,11837563,2,32318,8081,1,317136312,317136312,12118,4039,8079,4039,0,1,4041,885987,0.885987
4539,3343,3541,11837563,2,36318,9081,1,344672312,344672312,13618,4539,9079,4539,0,1,4541,919076,0.919076
5039,3343,3541,11837563,2,40318,10081,1,372208312,372208312,15118,5039,10079,5039,0,1,5041,1780220,1.78022
5539,3343,3541,11837563,2,44318,11081,1,399744312,399744312,16618,5539,11079,5539,0,1,5541,90731,0.090731
6039,3343,3541,11837563,2,48318,12081,1,427280312,427280312,18118,6039,12079,6039,0,1,6041,1161084,1.161084
6539,3343,3541,11837563,2,52318,13081,1,454816312,454816312,19618,6539,13079,6539,0,1,6541,1846431,1.846431
7039,3343,3541,11837563,2,56318,14081,1,482352312,482352312,21118,7039,14079,7039,0,1,7041,4394034,4.394034
39,3893,3041,11838613,2,318,81,1,96872312,96872312,118,39,79,39,0,1,41,209239,0.209239
539,3893,3041,11838613,2,4318,1081,1,124608312,124608312,1618,539,1079,539,0,1,541,1320163,1.320163
1039,3893,3041,11838613,2,8318,2081,1,152344312,152344312,3118,1039,2079,1039,0,1,1041,2485265,2.485265
1539,3893,3041,11838613,2,12318,3081,1,180080312,180080312,4618,1539,3079,1539,0,1,1541,3620128,3.620128
2039,3893,3041,11838613,2,16318,4081,1,207816312,207816312,6118,2039,4079,2039,0,1,2041,4781366,4.781366
2539,3893,3041,11838613,2,20318,5081,1,235552312,235552312,7618,2539,5079,2539,0,1,2541,1536417,1.536417
3039,3893,3041,11838613,2,24318,6081,1,263288312,263288312,9118,3039,6079,3039,0,1,3041,969995,0.969995
3539,3893,3041,11838613,2,28318,7081,1,291024312,291024312,10618,3539,7079,3539,0,1,3541,2577597,2.577597
4039,3893,3041,11838613,2,32318,8081,1,318760312,318760312,12118,4039,8079,4039,0,1,4041,1764866,1.764866
4539,3893,3041,11838613,2,36318,9081,1,346496312,346496312,13618,4539,9079,4539,0,1,4541,635808,0.635808
5039,3893,3041,11838613,2,40318,10081,1,374232312,374232312,15118,5039,10079,5039,0,1,5041,549975,0.549975
5539,3893,3041,11838613,2,44318,11081,1,401968312,401968312,16618,5539,11079,5539,0,1,5541,3024255,3.024255
6039,3893,3041,11838613,2,48318,12081,1,429704312,429704312,18118,6039,12079,6039,0,1,6041,1182616,1.182616
6539,3893,3041,11838613,2,52318,13081,1,457440312,457440312,19618,6539,13079,6539,0,1,6541,15194106,15.194106
7039,3893,3041,11838613,2,56318,14081,1,485176312,485176312,21118,7039,14079,7039,0,1,7041,5961807,5.961807
35,3340,3545,11840300,2,286,73,1,96650200,96650200,106,35,71,35,0,1,37,216478,0.216478
535,3340,3545,11840300,2,4286,1073,1,124190200,124190200,1606,535,1071,535,0,1,537,1264120,1.26412
1035,3340,3545,11840300,2,8286,2073,1,151730200,151730200,3106,1035,2071,1035,0,1,1037,2376275,2.376275
1535,3340,3545,11840300,2,12286,3073,1,179270200,179270200,4606,1535,3071,1535,0,1,1537,3481213,3.481213
2035,3340,3545,11840300,2,16286,4073,1,206810200,206810200,6106,2035,4071,2035,0,1,2037,4585423,4.585423
55,4805,2465,11844325,2,446,113,1,97953400,97953400,166,55,111,55,0,1,57,245318,0.245318
455,4805,2465,11844325,2,3646,913,1,121217400,121217400,1366,455,911,455,0,1,457,593245,0.593245
855,4805,2465,11844325,2,6846,1713,1,144481400,144481400,2566,855,1711,855,0,1,857,790791,0.790791
1255,4805,2465,11844325,2,10046,2513,1,167745400,167745400,3766,1255,2511,1255,0,1,1257,2872896,2.872896
1655,4805,2465,11844325,2,13246,3313,1,191009400,191009400,4966,1655,3311,1655,0,1,1657,1280215,1.280215
2055,4805,2465,11844325,2,16446,4113,1,214273400,214273400,6166,2055,4111,2055,0,1,2057,4616368,4.616368
2455,4805,2465,11844325,2,19646,4913,1,237537400,237537400,7366,2455,4911,2455,0,1,2457,5501075,5.501075
2855,4805,2465,11844325,2,22846,5713,1,260801400,260801400,8566,2855,5711,2855,0,1,2857,5012166,5.012166
3255,4805,2465,11844325,2,26046,6513,1,284065400,284065400,9766,3255,6511,3255,0,1,3257,2775142,2.775142
3655,4805,2465,11844325,2,29246,7313,1,307329400,307329400,10966,3655,7311,3655,0,1,3657,4141642,4.141642
4055,4805,2465,11844325,2,32446,8113,1,330593400,330593400,12166,4055,8111,4055,0,1,4057,257608,0.257608
4455,4805,2465,11844325,2,35646,8913,1,353857400,353857400,13366,4455,8911,4455,0,1,4457,987941,0.987941
4855,4805,2465,11844325,2,38846,9713,1,377121400,377121400,14566,4855,9711,4855,0,1,4857,4860497,4.860497
5255,4805,2465,11844325,2,42046,10513,1,400385400,400385400,15766,5255,10511,5255,0,1,5257,7792326,7.792326
5655,4805,2465,11844325,2,45246,11313,1,423649400,423649400,16966,5655,11311,5655,0,1,5657,329814,0.329814
6055,4805,2465,11844325,2,48446,12113,1,446913400,446913400,18166,6055,12111,6055,0,1,6057,13480853,13.480853
6455,4805,2465,11844325,2,51646,12913,1,470177400,470177400,19366,6455,12911,6455,0,1,6457,4867884,4.867884
6855,4805,2465,11844325,2,54846,13713,1,493441400,493441400,20566,6855,13711,6855,0,1,6857,4122128,4.122128
55,2055,5765,11847075,2,446,113,1,98217400,98217400,166,55,111,55,0,1,57,13986,0.013986
455,2055,5765,11847075,2,3646,913,1,123241400,123241400,1366,455,911,455,0,1,457,28792,0.028792
855,2055,5765,11847075,2,6846,1713,1,148265400,148265400,2566,855,1711,855,0,1,857,143357,0.143357
1255,2055,5765,11847075,2,10046,2513,1,173289400,173289400,3766,1255,2511,1255,0,1,1257,294745,0.294745
1655,2055,5765,11847075,2,13246,3313,1,198313400,198313400,4966,1655,3311,1655,0,1,1657,365454,0.365454
2055,2055,5765,11847075,2,16446,4113,1,223337400,223337400,6166,2055,4111,2055,0,1,2057,141521,0.141521
2455,2055,5765,11847075,2,19646,4913,1,248361400,248361400,7366,2455,4911,2455,0,1,2457,681206,0.681206
2855,2055,5765,11847075,2,22846,5713,1,273385400,273385400,8566,2855,5711,2855,0,1,2857,558926,0.558926
3255,2055,5765,11847075,2,26046,6513,1,298409400,298409400,9766,3255,6511,3255,0,1,3257,638944,0.638944
3655,2055,5765,11847075,2,29246,7313,1,323433400,323433400,10966,3655,7311,3655,0,1,3657,22386,0.022386
4055,2055,5765,11847075,2,32446,8113,1,348457400,348457400,12166,4055,8111,4055,0,1,4057,253168,0.253168
4455,2055,5765,11847075,2,35646,8913,1,373481400,373481400,13366,4455,8911,4455,0,1,4457,1170108,1.170108
4855,2055,5765,11847075,2,38846,9713,1,398505400,398505400,14566,4855,9711,4855,0,1,4857,162315,0.162315
5255,2055,5765,11847075,2,42046,10513,1,423529400,423529400,15766,5255,10511,5255,0,1,5257,1507368,1.507368
5655,2055,5765,11847075,2,45246,11313,1,448553400,448553400,16966,5655,11311,5655,0,1,5657,734131,0.734131
6055,2055,5765,11847075,2,48446,12113,1,473577400,473577400,18166,6055,12111,6055,0,1,6057,1792240,1.79224
6455,2055,5765,11847075,2,51646,12913,1,498601400,498601400,19366,6455,12911,6455,0,1,6457,1456399,1.456399
6855,2055,5765,11847075,2,54846,13713,1,523625400,523625400,20566,6855,13711,6855,0,1,6857,1491598,1.491598
40,3550,3340,11857000,2,326,83,1,97060800,97060800,121,40,81,40,0,1,42,208768,0.208768
440,3550,3340,11857000,2,3526,883,1,119108800,119108800,1321,440,881,440,0,1,442,1088313,1.088313
840,3550,3340,11857000,2,6726,1683,1,141156800,141156800,2521,840,1681,840,0,1,842,1990389,1.990389
1240,3550,3340,11857000,2,9926,2483,1,163204800,163204800,3721,1240,2481,1240,0,1,1242,2902031,2.902031
1640,3550,3340,11857000,2,13126,3283,1,185252800,185252800,4921,1640,3281,1640,0,1,1642,3793408,3.793408
2040,3550,3340,11857000,2,16326,4083,1,207300800,207300800,6121,2040,4081,2040,0,1,2042,2344397,2.344397
2440,3550,3340,11857000,2,19526,4883,1,229348800,229348800,7321,2440,4881,2440,0,1,2442,1524839,1.524839
2840,3550,3340,11857000,2,22726,5683,1,251396800,251396800,8521,2840,5681,2840,0,1,2842,506986,0.506986
3240,3550,3340,11857000,2,25926,6483,1,273444800,273444800,9721,3240,6481,3240,0,1,3242,614231,0.614231
3640,3550,3340,11857000,2,29126,7283,1,295492800,295492800,10921,3640,7281,3640,0,1,3642,3484901,3.484901
4040,3550,3340,11857000,2,32326,8083,1,317540800,317540800,12121,4040,8081,4040,0,1,4042,2010256,2.010256
4440,3550,3340,11857000,2,35526,8883,1,339588800,339588800,13321,4440,8881,4440,0,1,4442,1566571,1.566571
4840,3550,3340,11857000,2,38726,9683,1,361636800,361636800,14521,4840,9681,4840,0,1,4842,1279365,1.279365
5240,3550,3340,11857000,2,41926,10483,1,383684800,383684800,15721,5240,10481,5240,0,1,5242,3185457,3.185457
5640,3550,3340,11857000,2,45126,11283,1,405732800,405732800,16921,5640,11281,5640,0,1,5642,529231,0.529231
6040,3550,3340,11857000,2,48326,12083,1,427780800,427780800,18121,6040,12081,6040,0,1,6042,1494972,1.494972
6440,3550,3340,11857000,2,51526,12883,1,449828800,449828800,19321,6440,12881,6440,0,1,6442,521721,0.521721
6840,3550,3340,11857000,2,54726,13683,1,471876800,471876800,20521,6840,13681,6840,0,1,6842,10650097,10.650097
40,2800,4240,11872000,2,326,83,1,97228800,97228800,121,40,81,40,0,1,42,207730,0.20773
440,2800,4240,11872000,2,3526,883,1,119756800,119756800,1321,440,881,440,0,1,442,1039852,1.039852
840,2800,4240,11872000,2,6726,1683,1,142284800,142284800,2521,840,1681,840,0,1,842,1137265,1.137265
1240,2800,4240,11872000,2,9926,2483,1,164812800,164812800,3721,1240,2481,1240,0,1,1242,1161039,1.161039
1640,2800,4240,11872000,2,13126,3283,1,187340800,187340800,4921,1640,3281,1640,0,1,1642,2208635,2.208635
2040,2800,4240,11872000,2,16326,4083,1,209868800,209868800,6121,2040,4081,2040,0,1,2042,2263097,2.263097
2440,2800,4240,11872000,2,19526,4883,1,232396800,232396800,7321,2440,4881,2440,0,1,2442,126471,0.126471
2840,2800,4240,11872000,2,22726,5683,1,254924800,254924800,8521,2840,5681,2840,0,1,2842,178378,0.178378
3240,2800,4240,11872000,2,25926,6483,1,277452800,277452800,9721,3240,6481,3240,0,1,3242,7081358,7.081358
3640,2800,4240,11872000,2,29126,7283,1,299980800,299980800,10921,3640,7281,3640,0,1,3642,1713318,1.713318
4040,2800,4240,11872000,2,32326,8083,1,322508800,322508800,12121,4040,8081,4040,0,1,4042,1447988,1.447988
4440,2800,4240,11872000,2,35526,8883,1,345036800,345036800,13321,4440,8881,4440,0,1,4442,2423685,2.423685
4840,2800,4240,11872000,2,38726,9683,1,367564800,367564800,14521,4840,9681,4840,0,1,4842,3328646,3.328646
5240,2800,4240,11872000,2,41926,10483,1,390092800,390092800,15721,5240,10481,5240,0,1,5242,521894,0.521894
5640,2800,4240,11872000,2,45126,11283,1,412620800,412620800,16921,5640,11281,5640,0,1,5642,526969,0.526969
6040,2800,4240,11872000,2,48326,12083,1,435148800,435148800,18121,6040,12081,6040,0,1,6042,2394607,2.394607
6440,2800,4240,11872000,2,51526,12883,1,457676800,457676800,19321,6440,12881,6440,0,1,6442,580002,0.580002
6840,2800,4240,11872000,2,54726,13683,1,480204800,480204800,20521,6840,13681,6840,0,1,6842,2870291,2.870291
40,5550,2140,11877000,2,326,83,1,97476800,97476800,121,40,81,40,0,1,42,217270,0.21727
440,5550,2140,11877000,2,3526,883,1,122084800,122084800,1321,440,881,440,0,1,442,234117,0.234117
840,5550,2140,11877000,2,6726,1683,1,146692800,146692800,2521,840,1681,840,0,1,842,2001763,2.001763
1240,5550,2140,11877000,2,9926,2483,1,171300800,171300800,3721,1240,2481,1240,0,1,1242,2908163,2.908163
1640,5550,2140,11877000,2,13126,3283,1,195908800,195908800,4921,1640,3281,1640,0,1,1642,1097830,1.09783
2040,5550,2140,11877000,2,16326,4083,1,220516800,220516800,6121,2040,4081,2040,0,1,2042,106876,0.106876
2440,5550,2140,11877000,2,19526,4883,1,245124800,245124800,7321,2440,4881,2440,0,1,2442,2283856,2.283856
2840,5550,2140,11877000,2,22726,5683,1,269732800,269732800,8521,2840,5681,2840,0,1,2842,6568546,6.568546
3240,5550,2140,11877000,2,25926,6483,1,294340800,294340800,9721,3240,6481,3240,0,1,3242,2427428,2.427428
3640,5550,2140,11877000,2,29126,7283,1,318948800,318948800,10921,3640,7281,3640,0,1,3642,8281305,8.281305
4040,5550,2140,11877000,2,32326,8083,1,343556800,343556800,12121,4040,8081,4040,0,1,4042,2254120,2.25412
4440,5550,2140,11877000,2,35526,8883,1,368164800,368164800,13321,4440,8881,4440,0,1,4442,1314484,1.314484
4840,5550,2140,11877000,2,38726,9683,1,392772800,392772800,14521,4840,9681,4840,0,1,4842,2879595,2.879595
5240,5550,2140,11877000,2,41926,10483,1,417380800,417380800,15721,5240,10481,5240,0,1,5242,1040986,1.040986
5640,5550,2140,11877000,2,45126,11283,1,441988800,441988800,16921,5640,11281,5640,0,1,5642,6171963,6.171963
6040,5550,2140,11877000,2,48326,12083,1,466596800,466596800,18121,6040,12081,6040,0,1,6042,1110076,1.110076
6440,5550,2140,11877000,2,51526,12883,1,491204800,491204800,19321,6440,12881,6440,0,1,6442,3600966,3.600966
6840,5550,2140,11877000,2,54726,13683,1,515812800,515812800,20521,6840,13681,6840,0,1,6842,15791833,15.791833
55,4305,2765,11903325,2,446,113,1,98337400,98337400,166,55,111,55,0,1,57,237194,0.237194
455,4305,2765,11903325,2,3646,913,1,120961400,120961400,1366,455,911,455,0,1,457,1103082,1.103082
855,4305,2765,11903325,2,6846,1713,1,143585400,143585400,2566,855,1711,855,0,1,857,1270698,1.270698
1255,4305,2765,11903325,2,10046,2513,1,166209400,166209400,3766,1255,2511,1255,0,1,1257,1803140,1.80314
1655,4305,2765,11903325,2,13246,3313,1,188833400,188833400,4966,1655,3311,1655,0,1,1657,836481,0.836481
2055,4305,2765,11903325,2,16446,4113,1,211457400,211457400,6166,2055,4111,2055,0,1,2057,494569,0.494569
2455,4305,2765,11903325,2,19646,4913,1,234081400,234081400,7366,2455,4911,2455,0,1,2457,167191,0.167191
2855,4305,2765,11903325,2,22846,5713,1,256705400,256705400,8566,2855,5711,2855,0,1,2857,412193,0.412193
3255,4305,2765,11903325,2,26046,6513,1,279329400,279329400,9766,3255,6511,3255,0,1,3257,200058,0.200058
3655,4305,2765,11903325,2,29246,7313,1,301953400,301953400,10966,3655,7311,3655,0,1,3657,859480,0.85948
4055,4305,2765,11903325,2,32446,8113,1,324577400,324577400,12166,4055,8111,4055,0,1,4057,1935184,1.935184
4455,4305,2765,11903325,2,35646,8913,1,347201400,347201400,13366,4455,8911,4455,0,1,4457,135752,0.135752
4855,4305,2765,11903325,2,38846,9713,1,369825400,369825400,14566,4855,9711,4855,0,1,4857,2604712,2.604712
5255,4305,2765,11903325,2,42046,10513,1,392449400,392449400,15766,5255,10511,5255,0,1,5257,3263532,3.263532
5655,4305,2765,11903325,2,45246,11313,1,415073400,415073400,16966,5655,11311,5655,0,1,5657,1122023,1.122023
6055,4305,2765,11903325,2,48446,12113,1,437697400,437697400,18166,6055,12111,6055,0,1,6057,473234,0.473234
6455,4305,2765,11903325,2,51646,12913,1,460321400,460321400,19366,6455,12911,6455,0,1,6457,118076,0.118076
6855,4305,2765,11903325,2,54846,13713,1,482945400,482945400,20566,6855,13711,6855,0,1,6857,4021936,4.021936
55,2305,5165,11905325,2,446,113,1,98529400,98529400,166,55,111,55,0,1,57,240143,0.240143
455,2305,5165,11905325,2,3646,913,1,122433400,122433400,1366,455,911,455,0,1,457,955028,0.955028
855,2305,5165,11905325,2,6846,1713,1,146337400,146337400,2566,855,1711,855,0,1,857,812289,0.812289
1255,2305,5165,11905325,2,10046,2513,1,170241400,170241400,3766,1255,2511,1255,0,1,1257,716055,0.716055
1655,2305,5165,11905325,2,13246,3313,1,194145400,194145400,4966,1655,3311,1655,0,1,1657,1127146,1.127146
2055,2305,5165,11905325,2,16446,4113,1,218049400,218049400,6166,2055,4111,2055,0,1,2057,65355,0.065355
2455,2305,5165,11905325,2,19646,4913,1,241953400,241953400,7366,2455,4911,2455,0,1,2457,233564,0.233564
2855,2305,5165,11905325,2,22846,5713,1,265857400,265857400,8566,2855,5711,2855,0,1,2857,1313399,1.313399
3255,2305,5165,11905325,2,26046,6513,1,289761400,289761400,9766,3255,6511,3255,0,1,3257,1157239,1.157239
3655,2305,5165,11905325,2,29246,7313,1,313665400,313665400,10966,3655,7311,3655,0,1,3657,596271,0.596271
4055,2305,5165,11905325,2,32446,8113,1,337569400,337569400,12166,4055,8111,4055,0,1,4057,689307,0.689307
4455,2305,5165,11905325,2,35646,8913,1,361473400,361473400,13366,4455,8911,4455,0,1,4457,2411259,2.411259
4855,2305,5165,11905325,2,38846,9713,1,385377400,385377400,14566,4855,9711,4855,0,1,4857,8034618,8.034618
5255,2305,5165,11905325,2,42046,10513,1,409281400,409281400,15766,5255,10511,5255,0,1,5257,1133808,1.133808
5655,2305,5165,11905325,2,45246,11313,1,433185400,433185400,16966,5655,11311,5655,0,1,5657,1497589,1.497589
6055,2305,5165,11905325,2,48446,12113,1,457089400,457089400,18166,6055,12111,6055,0,1,6057,2243304,2.243304
6455,2305,5165,11905325,2,51646,12913,1,480993400,480993400,19366,6455,12911,6455,0,1,6457,793211,0.793211
6855,2305,5165,11905325,2,54846,13713,1,504897400,504897400,20566,6855,13711,6855,0,1,6857,1890462,1.890462
44,3353,3555,11919915,2,358,91,1,97790936,97790936,133,44,89,44,0,1,46,13522,0.013522
544,3353,3555,11919915,2,4358,1091,1,125422936,125422936,1633,544,1089,544,0,1,546,98238,0.098238
1044,3353,3555,11919915,2,8358,2091,1,153054936,153054936,3133,1044,2089,1044,0,1,1046,61301,0.061301
1544,3353,3555,11919915,2,12358,3091,1,180686936,180686936,4633,1544,3089,1544,0,1,1546,51186,0.051186
2044,3353,3555,11919915,2,16358,4091,1,208318936,208318936,6133,2044,4089,2044,0,1,2046,1066595,1.066595
2544,3353,3555,11919915,2,20358,5091,1,235950936,235950936,7633,2544,5089,2544,0,1,2546,54248,0.054248
3044,3353,3555,11919915,2,24358,6091,1,263582936,263582936,9133,3044,6089,3044,0,1,3046,1173802,1.173802
3544,3353,3555,11919915,2,28358,7091,1,291214936,291214936,10633,3544,7089,3544,0,1,3546,2087351,2.087351
4044,3353,3555,11919915,2,32358,8091,1,318846936,318846936,12133,4044,8089,4044,0,1,4046,1519336,1.519336
4544,3353,3555,11919915,2,36358,9091,1,346478936,346478936,13633,4544,9089,4544,0,1,4546,289540,0.28954
5044,3353,3555,11919915,2,40358,10091,1,374110936,374110936,15133,5044,10089,5044,0,1,5046,1346599,1.346599
5544,3353,3555,11919915,2,44358,11091,1,401742936,401742936,16633,5544,11089,5544,0,1,5546,473266,0.473266
6044,3353,3555,11919915,2,48358,12091,1,429374936,429374936,18133,6044,12089,6044,0,1,6046,206631,0.206631
6544,3353,3555,11919915,2,52358,13091,1,457006936,457006936,19633,6544,13089,6544,0,1,6546,554728,0.554728
7044,3353,3555,11919915,2,56358,14091,1,484638936,484638936,21133,7044,14089,7044,0,1,7046,7841541,7.841541
39,1693,7041,11920413,2,318,81,1,98088312,98088312,118,39,79,39,0,1,41,211344,0.211344
539,1693,7041,11920413,2,4318,1081,1,133024312,133024312,1618,539,1079,539,0,1,541,506604,0.506604
1039,1693,7041,11920413,2,8318,2081,1,167960312,167960312,3118,1039,2079,1039,0,1,1041,2485384,2.485384
1539,1693,7041,11920413,2,12318,3081,1,202896312,202896312,4618,1539,3079,1539,0,1,1541,3308350,3.30835
2039,1693,7041,11920413,2,16318,4081,1,237832312,237832312,6118,2039,4079,2039,0,1,2041,1183384,1.183384
2539,1693,7041,11920413,2,20318,5081,1,272768312,272768312,7618,2539,5079,2539,0,1,2541,468157,0.468157
3039,1693,7041,11920413,2,24318,6081,1,307704312,307704312,9118,3039,6079,3039,0,1,3041,1831673,1.831673
3539,1693,7041,11920413,2,28318,7081,1,342640312,342640312,10618,3539,7079,3539,0,1,3541,398579,0.398579
4039,1693,7041,11920413,2,32318,8081,1,377576312,377576312,12118,4039,8079,4039,0,1,4041,317068,0.317068
4539,1693,7041,11920413,2,36318,9081,1,412512312,412512312,13618,4539,9079,4539,0,1,4541,2506211,2.506211
5039,1693,7041,11920413,2,40318,10081,1,447448312,447448312,15118,5039,10079,5039,0,1,5041,309046,0.309046
5539,1693,7041,11920413,2,44318,11081,1,482384312,482384312,16618,5539,11079,5539,0,1,5541,112520,0.11252
6039,1693,7041,11920413,2,48318,12081,1,517320312,517320312,18118,6039,12079,6039,0,1,6041,2893877,2.893877
6539,1693,7041,11920413,2,52318,13081,1,552256312,552256312,19618,6539,13079,6539,0,1,6541,636484,0.636484
7039,1693,7041,11920413,2,56318,14081,1,587192312,587192312,21118,7039,14079,7039,0,1,7041,330962,0.330962
44,3903,3055,11923665,2,358,91,1,97838536,97838536,133,44,89,44,0,1,46,229896,0.229896
544,3903,3055,11923665,2,4358,1091,1,125670536,125670536,1633,544,1089,544,0,1,546,632268,0.632268
1044,3903,3055,11923665,2,8358,2091,1,153502536,153502536,3133,1044,2089,1044,0,1,1046,2495571,2.495571
1544,3903,3055,11923665,2,12358,3091,1,181334536,181334536,4633,1544,3089,1544,0,1,1546,752759,0.752759
2044,3903,3055,11923665,2,16358,4091,1,209166536,209166536,6133,2044,4089,2044,0,1,2046,755044,0.755044
2544,3903,3055,11923665,2,20358,5091,1,236998536,236998536,7633,2544,5089,2544,0,1,2546,5418364,5.418364
3044,3903,3055,11923665,2,24358,6091,1,264830536,264830536,9133,3044,6089,3044,0,1,3046,502699,0.502699
3544,3903,3055,11923665,2,28358,7091,1,292662536,292662536,10633,3544,7089,3544,0,1,3546,1718508,1.718508
4044,3903,3055,11923665,2,32358,8091,1,320494536,320494536,12133,4044,8089,4044,0,1,4046,1770880,1.77088
4544,3903,3055,11923665,2,36358,9091,1,348326536,348326536,13633,4544,9089,4544,0,1,4546,3584105,3.584105
5044,3903,3055,11923665,2,40358,10091,1,376158536,376158536,15133,5044,10089,5044,0,1,5046,8021263,8.021263
5544,3903,3055,11923665,2,44358,11091,1,403990536,403990536,16633,5544,11089,5544,0,1,5546,8042028,8.042028
6044,3903,3055,11923665,2,48358,12091,1,431822536,431822536,18133,6044,12089,6044,0,1,6046,3500182,3.500182
6544,3903,3055,11923665,2,52358,13091,1,459654536,459654536,19633,6544,13089,6544,0,1,6546,7668076,7.668076
7044,3903,3055,11923665,2,56358,14091,1,487486536,487486536,21133,7044,14089,7044,0,1,7046,16546519,16.546519
40,1800,6640,11952000,2,326,83,1,98316800,98316800,121,40,81,40,0,1,42,218160,0.21816
440,1800,6640,11952000,2,3526,883,1,125324800,125324800,1321,440,881,440,0,1,442,133189,0.133189
840,1800,6640,11952000,2,6726,1683,1,152332800,152332800,2521,840,1681,840,0,1,842,1735509,1.735509
1240,1800,6640,11952000,2,9926,2483,1,179340800,179340800,3721,1240,2481,1240,0,1,1242,1011412,1.011412
1640,1800,6640,11952000,2,13126,3283,1,206348800,206348800,4921,1640,3281,1640,0,1,1642,2548103,2.548103
2040,1800,6640,11952000,2,16326,4083,1,233356800,233356800,6121,2040,4081,2040,0,1,2042,3044250,3.04425
2440,1800,6640,11952000,2,19526,4883,1,260364800,260364800,7321,2440,4881,2440,0,1,2442,543478,0.543478
2840,1800,6640,11952000,2,22726,5683,1,287372800,287372800,8521,2840,5681,2840,0,1,2842,134493,0.134493
3240,1800,6640,11952000,2,25926,6483,1,314380800,314380800,9721,3240,6481,3240,0,1,3242,46917,0.046917
3640,1800,6640,11952000,2,29126,7283,1,341388800,341388800,10921,3640,7281,3640,0,1,3642,68427,0.068427
4040,1800,6640,11952000,2,32326,8083,1,368396800,368396800,12121,4040,8081,4040,0,1,4042,131474,0.131474
4440,1800,6640,11952000,2,35526,8883,1,395404800,395404800,13321,4440,8881,4440,0,1,4442,919728,0.919728
4840,1800,6640,11952000,2,38726,9683,1,422412800,422412800,14521,4840,9681,4840,0,1,4842,368639,0.368639
5240,1800,6640,11952000,2,41926,10483,1,449420800,449420800,15721,5240,10481,5240,0,1,5242,1528452,1.528452
5640,1800,6640,11952000,2,45126,11283,1,476428800,476428800,16921,5640,11281,5640,0,1,5642,2103093,2.103093
6040,1800,6640,11952000,2,48326,12083,1,503436800,503436800,18121,6040,12081,6040,0,1,6042,1630970,1.63097
6440,1800,6640,11952000,2,51526,12883,1,530444800,530444800,19321,6440,12881,6440,0,1,6442,6095058,6.095058
6840,1800,6640,11952000,2,54726,13683,1,557452800,557452800,20521,6840,13681,6840,0,1,6842,598801,0.598801
55,3555,3365,11962575,2,446,113,1,98745400,98745400,166,55,111,55,0,1,57,248008,0.248008
455,3555,3365,11962575,2,3646,913,1,120889400,120889400,1366,455,911,455,0,1,457,1144728,1.144728
855,3555,3365,11962575,2,6846,1713,1,143033400,143033400,2566,855,1711,855,0,1,857,261294,0.261294
1255,3555,3365,11962575,2,10046,2513,1,165177400,165177400,3766,1255,2511,1255,0,1,1257,545446,0.545446
1655,3555,3365,11962575,2,13246,3313,1,187321400,187321400,4966,1655,3311,1655,0,1,1657,2018302,2.018302
2055,3555,3365,11962575,2,16446,4113,1,209465400,209465400,6166,2055,4111,2055,0,1,2057,2049802,2.049802
2455,3555,3365,11962575,2,19646,4913,1,231609400,231609400,7366,2455,4911,2455,0,1,2457,376370,0.37637
2855,3555,3365,11962575,2,22846,5713,1,253753400,253753400,8566,2855,5711,2855,0,1,2857,846690,0.84669
3255,3555,3365,11962575,2,26046,6513,1,275897400,275897400,9766,3255,6511,3255,0,1,3257,155793,0.155793
3655,3555,3365,11962575,2,29246,7313,1,298041400,298041400,10966,3655,7311,3655,0,1,3657,16172,0.016172
4055,3555,3365,11962575,2,32446,8113,1,320185400,320185400,12166,4055,8111,4055,0,1,4057,570844,0.570844
4455,3555,3365,11962575,2,35646,8913,1,342329400,342329400,13366,4455,8911,4455,0,1,4457,470041,0.470041
4855,3555,3365,11962575,2,38846,9713,1,364473400,364473400,14566,4855,9711,4855,0,1,4857,1152810,1.15281
5255,3555,3365,11962575,2,42046,10513,1,386617400,386617400,15766,5255,10511,5255,0,1,5257,91242,0.091242
5655,3555,3365,11962575,2,45246,11313,1,408761400,408761400,16966,5655,11311,5655,0,1,5657,588107,0.588107
6055,3555,3365,11962575,2,48446,12113,1,430905400,430905400,18166,6055,12111,6055,0,1,6057,3557492,3.557492
6455,3555,3365,11962575,2,51646,12913,1,453049400,453049400,19366,6455,12911,6455,0,1,6457,3381887,3.381887
6855,3555,3365,11962575,2,54846,13713,1,475193400,475193400,20566,6855,13711,6855,0,1,6857,9201351,9.201351
55,2805,4265,11963325,2,446,113,1,98817400,98817400,166,55,111,55,0,1,57,240567,0.240567
455,2805,4265,11963325,2,3646,913,1,121441400,121441400,1366,455,911,455,0,1,457,312452,0.312452
855,2805,4265,11963325,2,6846,1713,1,144065400,144065400,2566,855,1711,855,0,1,857,1984246,1.984246
1255,2805,4265,11963325,2,10046,2513,1,166689400,166689400,3766,1255,2511,1255,0,1,1257,1891691,1.891691
1655,2805,4265,11963325,2,13246,3313,1,189313400,189313400,4966,1655,3311,1655,0,1,1657,3519292,3.519292
2055,2805,4265,11963325,2,16446,4113,1,211937400,211937400,6166,2055,4111,2055,0,1,2057,2606093,2.606093
2455,2805,4265,11963325,2,19646,4913,1,234561400,234561400,7366,2455,4911,2455,0,1,2457,3370475,3.370475
2855,2805,4265,11963325,2,22846,5713,1,257185400,257185400,8566,2855,5711,2855,0,1,2857,5068497,5.068497
3255,2805,4265,11963325,2,26046,6513,1,279809400,279809400,9766,3255,6511,3255,0,1,3257,273790,0.27379
3655,2805,4265,11963325,2,29246,7313,1,302433400,302433400,10966,3655,7311,3655,0,1,3657,1055650,1.05565
4055,2805,4265,11963325,2,32446,8113,1,325057400,325057400,12166,4055,8111,4055,0,1,4057,1065657,1.065657
4455,2805,4265,11963325,2,35646,8913,1,347681400,347681400,13366,4455,8911,4455,0,1,4457,3655115,3.655115
4855,2805,4265,11963325,2,38846,9713,1,370305400,370305400,14566,4855,9711,4855,0,1,4857,2642716,2.642716
5255,2805,4265,11963325,2,42046,10513,1,392929400,392929400,15766,5255,10511,5255,0,1,5257,2258710,2.25871
5655,2805,4265,11963325,2,45246,11313,1,415553400,415553400,16966,5655,11311,5655,0,1,5657,1830907,1.830907
6055,2805,4265,11963325,2,48446,12113,1,438177400,438177400,18166,6055,12111,6055,0,1,6057,385663,0.385663
6455,2805,4265,11963325,2,51646,12913,1,460801400,460801400,19366,6455,12911,6455,0,1,6457,3370529,3.370529
6855,2805,4265,11963325,2,54846,13713,1,483425400,483425400,20566,6855,13711,6855,0,1,6857,1473194,1.473194
40,3300,3640,12012000,2,326,83,1,98316800,98316800,121,40,81,40,0,1,42,209899,0.209899
440,3300,3640,12012000,2,3526,883,1,120524800,120524800,1321,440,881,440,0,1,442,453918,0.453918
840,3300,3640,12012000,2,6726,1683,1,142732800,142732800,2521,840,1681,840,0,1,842,1379444,1.379444
1240,3300,3640,12012000,2,9926,2483,1,164940800,164940800,3721,1240,2481,1240,0,1,1242,2896933,2.896933
1640,3300,3640,12012000,2,13126,3283,1,187148800,187148800,4921,1640,3281,1640,0,1,1642,349,0.000349
2040,3300,3640,12012000,2,16326,4083,1,209356800,209356800,6121,2040,4081,2040,0,1,2042,4698523,4.698523
2440,3300,3640,12012000,2,19526,4883,1,231564800,231564800,7321,2440,4881,2440,0,1,2442,354846,0.354846
2840,3300,3640,12012000,2,22726,5683,1,253772800,253772800,8521,2840,5681,2840,0,1,2842,40324,0.040324
3240,3300,3640,12012000,2,25926,6483,1,275980800,275980800,9721,3240,6481,3240,0,1,3242,835831,0.835831
3640,3300,3640,12012000,2,29126,7283,1,298188800,298188800,10921,3640,7281,3640,0,1,3642,240550,0.24055
4040,3300,3640,12012000,2,32326,8083,1,320396800,320396800,12121,4040,8081,4040,0,1,4042,145287,0.145287
4440,3300,3640,12012000,2,35526,8883,1,342604800,342604800,13321,4440,8881,4440,0,1,4442,1758540,1.75854
4840,3300,3640,12012000,2,38726,9683,1,364812800,364812800,14521,4840,9681,4840,0,1,4842,195981,0.195981
5240,3300,3640,12012000,2,41926,10483,1,387020800,387020800,15721,5240,10481,5240,0,1,5242,5703502,5.703502
5640,3300,3640,12012000,2,45126,11283,1,409228800,409228800,16921,5640,11281,5640,0,1,5642,1433465,1.433465
6040,3300,3640,12012000,2,48326,12083,1,431436800,431436800,18121,6040,12081,6040,0,1,6042,2286903,2.286903
6440,3300,3640,12012000,2,51526,12883,1,453644800,453644800,19321,6440,12881,6440,0,1,6442,479800,0.4798
6840,3300,3640,12012000,2,54726,13683,1,475852800,475852800,20521,6840,13681,6840,0,1,6842,5475359,5.475359
44,1703,7055,12014665,2,358,91,1,99200136,99200136,133,44,89,44,0,1,46,90513,0.090513
544,1703,7055,12014665,2,4358,1091,1,134232136,134232136,1633,544,1089,544,0,1,546,640022,0.640022
1044,1703,7055,12014665,2,8358,2091,1,169264136,169264136,3133,1044,2089,1044,0,1,1046,2510831,2.510831
1544,1703,7055,12014665,2,12358,3091,1,204296136,204296136,4633,1544,3089,1544,0,1,1546,131015,0.131015
2044,1703,7055,12014665,2,16358,4091,1,239328136,239328136,6133,2044,4089,2044,0,1,2046,3661247,3.661247
2544,1703,7055,12014665,2,20358,5091,1,274360136,274360136,7633,2544,5089,2544,0,1,2546,494499,0.494499
3044,1703,7055,12014665,2,24358,6091,1,309392136,309392136,9133,3044,6089,3044,0,1,3046,131611,0.131611
3544,1703,7055,12014665,2,28358,7091,1,344424136,344424136,10633,3544,7089,3544,0,1,3546,2104814,2.104814
4044,1703,7055,12014665,2,32358,8091,1,379456136,379456136,12133,4044,8089,4044,0,1,4046,165111,0.165111
4544,1703,7055,12014665,2,36358,9091,1,414488136,414488136,13633,4544,9089,4544,0,1,4546,2004829,2.004829
5044,1703,7055,12014665,2,40358,10091,1,449520136,449520136,15133,5044,10089,5044,0,1,5046,10191636,10.191636
5544,1703,7055,12014665,2,44358,11091,1,484552136,484552136,16633,5544,11089,5544,0,1,5546,786347,0.786347
6044,1703,7055,12014665,2,48358,12091,1,519584136,519584136,18133,6044,12089,6044,0,1,6046,404858,0.404858
6544,1703,7055,12014665,2,52358,13091,1,554616136,554616136,19633,6544,13089,6544,0,1,6546,1126736,1.126736
7044,1703,7055,12014665,2,56358,14091,1,589648136,589648136,21133,7044,14089,7044,0,1,7046,2958131,2.958131
40,3050,3940,12017000,2,326,83,1,98372800,98372800,121,40,81,40,0,1,42,9968,0.009968
440,3050,3940,12017000,2,3526,883,1,120740800,120740800,1321,440,881,440,0,1,442,145571,0.145571
840,3050,3940,12017000,2,6726,1683,1,143108800,143108800,2521,840,1681,840,0,1,842,239886,0.239886
1240,3050,3940,12017000,2,9926,2483,1,165476800,165476800,3721,1240,2481,1240,0,1,1242,54281,0.054281
1640,3050,3940,12017000,2,13126,3283,1,187844800,187844800,4921,1640,3281,1640,0,1,1642,304183,0.304183
2040,3050,3940,12017000,2,16326,4083,1,210212800,210212800,6121,2040,4081,2040,0,1,2042,74630,0.07463
2440,3050,3940,12017000,2,19526,4883,1,232580800,232580800,7321,2440,4881,2440,0,1,2442,1744799,1.744799
2840,3050,3940,12017000,2,22726,5683,1,254948800,254948800,8521,2840,5681,2840,0,1,2842,603233,0.603233
3240,3050,3940,12017000,2,25926,6483,1,277316800,277316800,9721,3240,6481,3240,0,1,3242,132689,0.132689
3640,3050,3940,12017000,2,29126,7283,1,299684800,299684800,10921,3640,7281,3640,0,1,3642,267656,0.267656
4040,3050,3940,12017000,2,32326,8083,1,322052800,322052800,12121,4040,8081,4040,0,1,4042,869824,0.869824
4440,3050,3940,12017000,2,35526,8883,1,344420800,344420800,13321,4440,8881,4440,0,1,4442,1638720,1.63872
4840,3050,3940,12017000,2,38726,9683,1,366788800,366788800,14521,4840,9681,4840,0,1,4842,193499,0.193499
5240,3050,3940,12017000,2,41926,10483,1,389156800,389156800,15721,5240,10481,5240,0,1,5242,1554783,1.554783
5640,3050,3940,12017000,2,45126,11283,1,411524800,411524800,16921,5640,11281,5640,0,1,5642,3876802,3.876802
6040,3050,3940,12017000,2,48326,12083,1,433892800,433892800,18121,6040,12081,6040,0,1,6042,3047653,3.047653
6440,3050,3940,12017000,2,51526,12883,1,456260800,456260800,19321,6440,12881,6440,0,1,6442,1027012,1.027012
6840,3050,3940,12017000,2,54726,13683,1,478628800,478628800,20521,6840,13681,6840,0,1,6842,293729,0.293729
55,5555,2165,12026575,2,446,113,1,99609400,99609400,166,55,111,55,0,1,57,242267,0.242267
455,5555,2165,12026575,2,3646,913,1,124313400,124313400,1366,455,911,455,0,1,457,1140108,1.140108
855,5555,2165,12026575,2,6846,1713,1,149017400,149017400,2566,855,1711,855,0,1,857,2050762,2.050762
1255,5555,2165,12026575,2,10046,2513,1,173721400,173721400,3766,1255,2511,1255,0,1,1257,495568,0.495568
1655,5555,2165,12026575,2,13246,3313,1,198425400,198425400,4966,1655,3311,1655,0,1,1657,2027224,2.027224
2055,5555,2165,12026575,2,16446,4113,1,223129400,223129400,6166,2055,4111,2055,0,1,2057,1165859,1.165859
2455,5555,2165,12026575,2,19646,4913,1,247833400,247833400,7366,2455,4911,2455,0,1,2457,227192,0.227192
2855,5555,2165,12026575,2,22846,5713,1,272537400,272537400,8566,2855,5711,2855,0,1,2857,6646883,6.646883
3255,5555,2165,12026575,2,26046,6513,1,297241400,297241400,9766,3255,6511,3255,0,1,3257,7558415,7.558415
3655,5555,2165,12026575,2,29246,7313,1,321945400,321945400,10966,3655,7311,3655,0,1,3657,1028354,1.028354
4055,5555,2165,12026575,2,32446,8113,1,346649400,346649400,12166,4055,8111,4055,0,1,4057,1599929,1.599929
4455,5555,2165,12026575,2,35646,8913,1,371353400,371353400,13366,4455,8911,4455,0,1,4457,1014870,1.01487
4855,5555,2165,12026575,2,38846,9713,1,396057400,396057400,14566,4855,9711,4855,0,1,4857,515166,0.515166
5255,5555,2165,12026575,2,42046,10513,1,420761400,420761400,15766,5255,10511,5255,0,1,5257,9385795,9.385795
5655,5555,2165,12026575,2,45246,11313,1,445465400,445465400,16966,5655,11311,5655,0,1,5657,145665,0.145665
6055,5555,2165,12026575,2,48446,12113,1,470169400,470169400,18166,6055,12111,6055,0,1,6057,6441027,6.441027
6455,5555,2165,12026575,2,51646,12913,1,494873400,494873400,19366,6455,12911,6455,0,1,6457,5873426,5.873426
6855,5555,2165,12026575,2,54846,13713,1,519577400,519577400,20566,6855,13711,6855,0,1,6857,7180361,7.180361
55,1805,6665,12030325,2,446,113,1,99969400,99969400,166,55,111,55,0,1,57,164592,0.164592
455,1805,6665,12030325,2,3646,913,1,127073400,127073400,1366,455,911,455,0,1,457,876792,0.876792
855,1805,6665,12030325,2,6846,1713,1,154177400,154177400,2566,855,1711,855,0,1,857,532385,0.532385
1255,1805,6665,12030325,2,10046,2513,1,181281400,181281400,3766,1255,2511,1255,0,1,1257,2998901,2.998901
1655,1805,6665,12030325,2,13246,3313,1,208385400,208385400,4966,1655,3311,1655,0,1,1657,287748,0.287748
2055,1805,6665,12030325,2,16446,4113,1,235489400,235489400,6166,2055,4111,2055,0,1,2057,1146679,1.146679
2455,1805,6665,12030325,2,19646,4913,1,262593400,262593400,7366,2455,4911,2455,0,1,2457,914707,0.914707
2855,1805,6665,12030325,2,22846,5713,1,289697400,289697400,8566,2855,5711,2855,0,1,2857,340478,0.340478
3255,1805,6665,12030325,2,26046,6513,1,316801400,316801400,9766,3255,6511,3255,0,1,3257,353161,0.353161
3655,1805,6665,12030325,2,29246,7313,1,343905400,343905400,10966,3655,7311,3655,0,1,3657,146441,0.146441
4055,1805,6665,12030325,2,32446,8113,1,371009400,371009400,12166,4055,8111,4055,0,1,4057,26808,0.026808
4455,1805,6665,12030325,2,35646,8913,1,398113400,398113400,13366,4455,8911,4455,0,1,4457,2039372,2.039372
4855,1805,6665,12030325,2,38846,9713,1,425217400,425217400,14566,4855,9711,4855,0,1,4857,3502375,3.502375
5255,1805,6665,12030325,2,42046,10513,1,452321400,452321400,15766,5255,10511,5255,0,1,5257,928408,0.928408
5655,1805,6665,12030325,2,45246,11313,1,479425400,479425400,16966,5655,11311,5655,0,1,5657,340806,0.340806
6055,1805,6665,12030325,2,48446,12113,1,506529400,506529400,18166,6055,12111,6055,0,1,6057,874013,0.874013
6455,1805,6665,12030325,2,51646,12913,1,533633400,533633400,19366,6455,12911,6455,0,1,6457,73786,0.073786
6855,1805,6665,12030325,2,54846,13713,1,560737400,560737400,20566,6855,13711,6855,0,1,6857,878782,0.878782
40,6550,1840,12052000,2,326,83,1,99100800,99100800,121,40,81,40,0,1,42,22182,0.022182
440,6550,1840,12052000,2,3526,883,1,125948800,125948800,1321,440,881,440,0,1,442,27030,0.02703
840,6550,1840,12052000,2,6726,1683,1,152796800,152796800,2521,840,1681,840,0,1,842,36465,0.036465
1240,6550,1840,12052000,2,9926,2483,1,179644800,179644800,3721,1240,2481,1240,0,1,1242,259547,0.259547
1640,6550,1840,12052000,2,13126,3283,1,206492800,206492800,4921,1640,3281,1640,0,1,1642,940024,0.940024
2040,6550,1840,12052000,2,16326,4083,1,233340800,233340800,6121,2040,4081,2040,0,1,2042,271909,0.271909
2440,6550,1840,12052000,2,19526,4883,1,260188800,260188800,7321,2440,4881,2440,0,1,2442,481399,0.481399
2840,6550,1840,12052000,2,22726,5683,1,287036800,287036800,8521,2840,5681,2840,0,1,2842,28672,0.028672
3240,6550,1840,12052000,2,25926,6483,1,313884800,313884800,9721,3240,6481,3240,0,1,3242,1763835,1.763835
3640,6550,1840,12052000,2,29126,7283,1,340732800,340732800,10921,3640,7281,3640,0,1,3642,351524,0.351524
4040,6550,1840,12052000,2,32326,8083,1,367580800,367580800,12121,4040,8081,4040,0,1,4042,1041519,1.041519
4440,6550,1840,12052000,2,35526,8883,1,394428800,394428800,13321,4440,8881,4440,0,1,4442,420317,0.420317
4840,6550,1840,12052000,2,38726,9683,1,421276800,421276800,14521,4840,9681,4840,0,1,4842,2573628,2.573628
5240,6550,1840,12052000,2,41926,10483,1,448124800,448124800,15721,5240,10481,5240,0,1,5242,52564,0.052564
5640,6550,1840,12052000,2,45126,11283,1,474972800,474972800,16921,5640,11281,5640,0,1,5642,471929,0.471929
6040,6550,1840,12052000,2,48326,12083,1,501820800,501820800,18121,6040,12081,6040,0,1,6042,306905,0.306905
6440,6550,1840,12052000,2,51526,12883,1,528668800,528668800,19321,6440,12881,6440,0,1,6442,4034904,4.034904
6840,6550,1840,12052000,2,54726,13683,1,555516800,555516800,20521,6840,13681,6840,0,1,6842,2507275,2.507275
55,3305,3665,12112825,2,446,113,1,99969400,99969400,166,55,111,55,0,1,57,249488,0.249488
455,3305,3665,12112825,2,3646,913,1,122273400,122273400,1366,455,911,455,0,1,457,1135529,1.135529
855,3305,3665,12112825,2,6846,1713,1,144577400,144577400,2566,855,1711,855,0,1,857,313142,0.313142
1255,3305,3665,12112825,2,10046,2513,1,166881400,166881400,3766,1255,2511,1255,0,1,1257,1112853,1.112853
1655,3305,3665,12112825,2,13246,3313,1,189185400,189185400,4966,1655,3311,1655,0,1,1657,3948050,3.94805
2055,3305,3665,12112825,2,16446,4113,1,211489400,211489400,6166,2055,4111,2055,0,1,2057,127251,0.127251
2455,3305,3665,12112825,2,19646,4913,1,233793400,233793400,7366,2455,4911,2455,0,1,2457,1168476,1.168476
2855,3305,3665,12112825,2,22846,5713,1,256097400,256097400,8566,2855,5711,2855,0,1,2857,473282,0.473282
3255,3305,3665,12112825,2,26046,6513,1,278401400,278401400,9766,3255,6511,3255,0,1,3257,735853,0.735853
3655,3305,3665,12112825,2,29246,7313,1,300705400,300705400,10966,3655,7311,3655,0,1,3657,1249684,1.249684
4055,3305,3665,12112825,2,32446,8113,1,323009400,323009400,12166,4055,8111,4055,0,1,4057,642298,0.642298
4455,3305,3665,12112825,2,35646,8913,1,345313400,345313400,13366,4455,8911,4455,0,1,4457,36301,0.036301
4855,3305,3665,12112825,2,38846,9713,1,367617400,367617400,14566,4855,9711,4855,0,1,4857,549580,0.54958
5255,3305,3665,12112825,2,42046,10513,1,389921400,389921400,15766,5255,10511,5255,0,1,5257,755079,0.755079
5655,3305,3665,12112825,2,45246,11313,1,412225400,412225400,16966,5655,11311,5655,0,1,5657,824182,0.824182
6055,3305,3665,12112825,2,48446,12113,1,434529400,434529400,18166,6055,12111,6055,0,1,6057,1103745,1.103745
6455,3305,3665,12112825,2,51646,12913,1,456833400,456833400,19366,6455,12911,6455,0,1,6457,280904,0.280904
6855,3305,3665,12112825,2,54846,13713,1,479137400,479137400,20566,6855,13711,6855,0,1,6857,8582878,8.582878
55,3055,3965,12113075,2,446,113,1,99993400,99993400,166,55,111,55,0,1,57,8550,0.00855
455,3055,3965,12113075,2,3646,913,1,122457400,122457400,1366,455,911,455,0,1,457,87914,0.087914
855,3055,3965,12113075,2,6846,1713,1,144921400,144921400,2566,855,1711,855,0,1,857,189276,0.189276
1255,3055,3965,12113075,2,10046,2513,1,167385400,167385400,3766,1255,2511,1255,0,1,1257,10039,0.010039
1655,3055,3965,12113075,2,13246,3313,1,189849400,189849400,4966,1655,3311,1655,0,1,1657,45443,0.045443
2055,3055,3965,12113075,2,16446,4113,1,212313400,212313400,6166,2055,4111,2055,0,1,2057,25834,0.025834
2455,3055,3965,12113075,2,19646,4913,1,234777400,234777400,7366,2455,4911,2455,0,1,2457,433985,0.433985
2855,3055,3965,12113075,2,22846,5713,1,257241400,257241400,8566,2855,5711,2855,0,1,2857,60914,0.060914
3255,3055,3965,12113075,2,26046,6513,1,279705400,279705400,9766,3255,6511,3255,0,1,3257,19980,0.01998
3655,3055,3965,12113075,2,29246,7313,1,302169400,302169400,10966,3655,7311,3655,0,1,3657,1716336,1.716336
4055,3055,3965,12113075,2,32446,8113,1,324633400,324633400,12166,4055,8111,4055,0,1,4057,792070,0.79207
4455,3055,3965,12113075,2,35646,8913,1,347097400,347097400,13366,4455,8911,4455,0,1,4457,554116,0.554116
4855,3055,3965,12113075,2,38846,9713,1,369561400,369561400,14566,4855,9711,4855,0,1,4857,265027,0.265027
5255,3055,3965,12113075,2,42046,10513,1,392025400,392025400,15766,5255,10511,5255,0,1,5257,962585,0.962585
5655,3055,3965,12113075,2,45246,11313,1,414489400,414489400,16966,5655,11311,5655,0,1,5657,7578584,7.578584
6055,3055,3965,12113075,2,48446,12113,1,436953400,436953400,18166,6055,12111,6055,0,1,6057,291573,0.291573
6455,3055,3965,12113075,2,51646,12913,1,459417400,459417400,19366,6455,12911,6455,0,1,6457,1075830,1.07583
6855,3055,3965,12113075,2,54846,13713,1,481881400,481881400,20566,6855,13711,6855,0,1,6857,657310,0.65731
55,6555,1865,12225075,2,446,113,1,101505400,101505400,166,55,111,55,0,1,57,15873,0.015873
455,6555,1865,12225075,2,3646,913,1,128449400,128449400,1366,455,911,455,0,1,457,161909,0.161909
855,6555,1865,12225075,2,6846,1713,1,155393400,155393400,2566,855,1711,855,0,1,857,47957,0.047957
1255,6555,1865,12225075,2,10046,2513,1,182337400,182337400,3766,1255,2511,1255,0,1,1257,639549,0.639549
1655,6555,1865,12225075,2,13246,3313,1,209281400,209281400,4966,1655,3311,1655,0,1,1657,37935,0.037935
2055,6555,1865,12225075,2,16446,4113,1,236225400,236225400,6166,2055,4111,2055,0,1,2057,743188,0.743188
2455,6555,1865,12225075,2,19646,4913,1,263169400,263169400,7366,2455,4911,2455,0,1,2457,166426,0.166426
2855,6555,1865,12225075,2,22846,5713,1,290113400,290113400,8566,2855,5711,2855,0,1,2857,66280,0.06628
3255,6555,1865,12225075,2,26046,6513,1,317057400,317057400,9766,3255,6511,3255,0,1,3257,1196115,1.196115
3655,6555,1865,12225075,2,29246,7313,1,344001400,344001400,10966,3655,7311,3655,0,1,3657,540623,0.540623
4055,6555,1865,12225075,2,32446,8113,1,370945400,370945400,12166,4055,8111,4055,0,1,4057,23370,0.02337
4455,6555,1865,12225075,2,35646,8913,1,397889400,397889400,13366,4455,8911,4455,0,1,4457,2091236,2.091236
4855,6555,1865,12225075,2,38846,9713,1,424833400,424833400,14566,4855,9711,4855,0,1,4857,4244061,4.244061
5255,6555,1865,12225075,2,42046,10513,1,451777400,451777400,15766,5255,10511,5255,0,1,5257,1492500,1.4925
5655,6555,1865,12225075,2,45246,11313,1,478721400,478721400,16966,5655,11311,5655,0,1,5657,56237,0.056237
6055,6555,1865,12225075,2,48446,12113,1,505665400,505665400,18166,6055,12111,6055,0,1,6057,419776,0.419776
6455,6555,1865,12225075,2,51646,12913,1,532609400,532609400,19366,6455,12911,6455,0,1,6457,854141,0.854141
6855,6555,1865,12225075,2,54846,13713,1,559553400,559553400,20566,6855,13711,6855,0,1,6857,2722059,2.722059
40,4050,3040,12312000,2,326,83,1,100764800,100764800,121,40,81,40,0,1,42,9074,0.009074
440,4050,3040,12312000,2,3526,883,1,123452800,123452800,1321,440,881,440,0,1,442,77095,0.077095
840,4050,3040,12312000,2,6726,1683,1,146140800,146140800,2521,840,1681,840,0,1,842,129867,0.129867
1240,4050,3040,12312000,2,9926,2483,1,168828800,168828800,3721,1240,2481,1240,0,1,1242,147633,0.147633
1640,4050,3040,12312000,2,13126,3283,1,191516800,191516800,4921,1640,3281,1640,0,1,1642,199369,0.199369
2040,4050,3040,12312000,2,16326,4083,1,214204800,214204800,6121,2040,4081,2040,0,1,2042,121923,0.121923
2440,4050,3040,12312000,2,19526,4883,1,236892800,236892800,7321,2440,4881,2440,0,1,2442,25145,0.025145
2840,4050,3040,12312000,2,22726,5683,1,259580800,259580800,8521,2840,5681,2840,0,1,2842,235030,0.23503
3240,4050,3040,12312000,2,25926,6483,1,282268800,282268800,9721,3240,6481,3240,0,1,3242,1143151,1.143151
3640,4050,3040,12312000,2,29126,7283,1,304956800,304956800,10921,3640,7281,3640,0,1,3642,300733,0.300733
4040,4050,3040,12312000,2,32326,8083,1,327644800,327644800,12121,4040,8081,4040,0,1,4042,59506,0.059506
4440,4050,3040,12312000,2,35526,8883,1,350332800,350332800,13321,4440,8881,4440,0,1,4442,1744857,1.744857
4840,4050,3040,12312000,2,38726,9683,1,373020800,373020800,14521,4840,9681,4840,0,1,4842,18992,0.018992
5240,4050,3040,12312000,2,41926,10483,1,395708800,395708800,15721,5240,10481,5240,0,1,5242,702856,0.702856
5640,4050,3040,12312000,2,45126,11283,1,418396800,418396800,16921,5640,11281,5640,0,1,5642,397483,0.397483
6040,4050,3040,12312000,2,48326,12083,1,441084800,441084800,18121,6040,12081,6040,0,1,6042,181219,0.181219
6440,4050,3040,12312000,2,51526,12883,1,463772800,463772800,19321,6440,12881,6440,0,1,6442,3502256,3.502256
6840,4050,3040,12312000,2,54726,13683,1,486460800,486460800,20521,6840,13681,6840,0,1,6842,1421052,1.421052
40,5050,2440,12322000,2,326,83,1,100972800,100972800,121,40,81,40,0,1,42,21113,0.021113
440,5050,2440,12322000,2,3526,883,1,124940800,124940800,1321,440,881,440,0,1,442,21972,0.021972
840,5050,2440,12322000,2,6726,1683,1,148908800,148908800,2521,840,1681,840,0,1,842,58297,0.058297
1240,5050,2440,12322000,2,9926,2483,1,172876800,172876800,3721,1240,2481,1240,0,1,1242,455534,0.455534
1640,5050,2440,12322000,2,13126,3283,1,196844800,196844800,4921,1640,3281,1640,0,1,1642,132352,0.132352
2040,5050,2440,12322000,2,16326,4083,1,220812800,220812800,6121,2040,4081,2040,0,1,2042,236443,0.236443
2440,5050,2440,12322000,2,19526,4883,1,244780800,244780800,7321,2440,4881,2440,0,1,2442,190095,0.190095
2840,5050,2440,12322000,2,22726,5683,1,268748800,268748800,8521,2840,5681,2840,0,1,2842,574099,0.574099
3240,5050,2440,12322000,2,25926,6483,1,292716800,292716800,9721,3240,6481,3240,0,1,3242,1406869,1.406869
3640,5050,2440,12322000,2,29126,7283,1,316684800,316684800,10921,3640,7281,3640,0,1,3642,288760,0.28876
4040,5050,2440,12322000,2,32326,8083,1,340652800,340652800,12121,4040,8081,4040,0,1,4042,2136185,2.136185
4440,5050,2440,12322000,2,35526,8883,1,364620800,364620800,13321,4440,8881,4440,0,1,4442,3679970,3.67997
4840,5050,2440,12322000,2,38726,9683,1,388588800,388588800,14521,4840,9681,4840,0,1,4842,1514593,1.514593
5240,5050,2440,12322000,2,41926,10483,1,412556800,412556800,15721,5240,10481,5240,0,1,5242,623748,0.623748
5640,5050,2440,12322000,2,45126,11283,1,436524800,436524800,16921,5640,11281,5640,0,1,5642,1025131,1.025131
6040,5050,2440,12322000,2,48326,12083,1,460492800,460492800,18121,6040,12081,6040,0,1,6042,679635,0.679635
6440,5050,2440,12322000,2,51526,12883,1,484460800,484460800,19321,6440,12881,6440,0,1,6442,562835,0.562835
6840,5050,2440,12322000,2,54726,13683,1,508428800,508428800,20521,6840,13681,6840,0,1,6842,1548233,1.548233
40,2550,4840,12342000,2,326,83,1,101100800,101100800,121,40,81,40,0,1,42,216730,0.21673
440,2550,4840,12342000,2,3526,883,1,124748800,124748800,1321,440,881,440,0,1,442,1104003,1.104003
840,2550,4840,12342000,2,6726,1683,1,148396800,148396800,2521,840,1681,840,0,1,842,2004764,2.004764
1240,2550,4840,12342000,2,9926,2483,1,172044800,172044800,3721,1240,2481,1240,0,1,1242,2910466,2.910466
1640,2550,4840,12342000,2,13126,3283,1,195692800,195692800,4921,1640,3281,1640,0,1,1642,100149,0.100149
2040,2550,4840,12342000,2,16326,4083,1,219340800,219340800,6121,2040,4081,2040,0,1,2042,675699,0.675699
2440,2550,4840,12342000,2,19526,4883,1,242988800,242988800,7321,2440,4881,2440,0,1,2442,2859292,2.859292
2840,2550,4840,12342000,2,22726,5683,1,266636800,266636800,8521,2840,5681,2840,0,1,2842,4267539,4.267539
3240,2550,4840,12342000,2,25926,6483,1,290284800,290284800,9721,3240,6481,3240,0,1,3242,168697,0.168697
3640,2550,4840,12342000,2,29126,7283,1,313932800,313932800,10921,3640,7281,3640,0,1,3642,3107686,3.107686
4040,2550,4840,12342000,2,32326,8083,1,337580800,337580800,12121,4040,8081,4040,0,1,4042,287970,0.28797
4440,2550,4840,12342000,2,35526,8883,1,361228800,361228800,13321,4440,8881,4440,0,1,4442,1539183,1.539183
4840,2550,4840,12342000,2,38726,9683,1,384876800,384876800,14521,4840,9681,4840,0,1,4842,2211897,2.211897
5240,2550,4840,12342000,2,41926,10483,1,408524800,408524800,15721,5240,10481,5240,0,1,5242,1145530,1.14553
5640,2550,4840,12342000,2,45126,11283,1,432172800,432172800,16921,5640,11281,5640,0,1,5642,346977,0.346977
6040,2550,4840,12342000,2,48326,12083,1,455820800,455820800,18121,6040,12081,6040,0,1,6042,1079391,1.079391
6440,2550,4840,12342000,2,51526,12883,1,479468800,479468800,19321,6440,12881,6440,0,1,6442,1082921,1.082921
6840,2550,4840,12342000,2,54726,13683,1,503116800,503116800,20521,6840,13681,6840,0,1,6842,1369162,1.369162
35,6050,2045,12372250,2,286,73,1,101244600,101244600,106,35,71,35,0,1,37,13399,0.013399
535,6050,2045,12372250,2,4286,1073,1,133624600,133624600,1606,535,1071,535,0,1,537,109849,0.109849
1035,6050,2045,12372250,2,8286,2073,1,166004600,166004600,3106,1035,2071,1035,0,1,1037,110848,0.110848
1535,6050,2045,12372250,2,12286,3073,1,198384600,198384600,4606,1535,3071,1535,0,1,1537,658679,0.658679
2035,6050,2045,12372250,2,16286,4073,1,230764600,230764600,6106,2035,4071,2035,0,1,2037,126928,0.126928
2535,6050,2045,12372250,2,20286,5073,1,263144600,263144600,7606,2535,5071,2535,0,1,2537,6163242,6.163242
3035,6050,2045,12372250,2,24286,6073,1,295524600,295524600,9106,3035,6071,3035,0,1,3037,1488244,1.488244
3535,6050,2045,12372250,2,28286,7073,1,327904600,327904600,10606,3535,7071,3535,0,1,3537,4782155,4.782155
4035,6050,2045,12372250,2,32286,8073,1,360284600,360284600,12106,4035,8071,4035,0,1,4037,6393146,6.393146
4535,6050,2045,12372250,2,36286,9073,1,392664600,392664600,13606,4535,9071,4535,0,1,4537,3206603,3.206603
5035,6050,2045,12372250,2,40286,10073,1,425044600,425044600,15106,5035,10071,5035,0,1,5037,5304080,5.30408
5535,6050,2045,12372250,2,44286,11073,1,457424600,457424600,16606,5535,11071,5535,0,1,5537,4858927,4.858927
6035,6050,2045,12372250,2,48286,12073,1,489804600,489804600,18106,6035,12071,6035,0,1,6037,12471142,12.471142
6535,6050,2045,12372250,2,52286,13073,1,522184600,522184600,19606,6535,13071,6535,0,1,6537,740880,0.74088
7035,6050,2045,12372250,2,56286,14073,1,554564600,554564600,21106,7035,14071,7035,0,1,7037,16949641,16.949641
40,2050,6040,12382000,2,326,83,1,101644800,101644800,121,40,81,40,0,1,42,8352,0.008352
440,2050,6040,12382000,2,3526,883,1,127532800,127532800,1321,440,881,440,0,1,442,28464,0.028464
840,2050,6040,12382000,2,6726,1683,1,153420800,153420800,2521,840,1681,840,0,1,842,33602,0.033602
1240,2050,6040,12382000,2,9926,2483,1,179308800,179308800,3721,1240,2481,1240,0,1,1242,164376,0.164376
1640,2050,6040,12382000,2,13126,3283,1,205196800,205196800,4921,1640,3281,1640,0,1,1642,336723,0.336723
2040,2050,6040,12382000,2,16326,4083,1,231084800,231084800,6121,2040,4081,2040,0,1,2042,1008090,1.00809
2440,2050,6040,12382000,2,19526,4883,1,256972800,256972800,7321,2440,4881,2440,0,1,2442,253529,0.253529
2840,2050,6040,12382000,2,22726,5683,1,282860800,282860800,8521,2840,5681,2840,0,1,2842,225463,0.225463
3240,2050,6040,12382000,2,25926,6483,1,308748800,308748800,9721,3240,6481,3240,0,1,3242,320566,0.320566
3640,2050,6040,12382000,2,29126,7283,1,334636800,334636800,10921,3640,7281,3640,0,1,3642,102478,0.102478
4040,2050,6040,12382000,2,32326,8083,1,360524800,360524800,12121,4040,8081,4040,0,1,4042,359851,0.359851
4440,2050,6040,12382000,2,35526,8883,1,386412800,386412800,13321,4440,8881,4440,0,1,4442,405035,0.405035
4840,2050,6040,12382000,2,38726,9683,1,412300800,412300800,14521,4840,9681,4840,0,1,4842,539240,0.53924
5240,2050,6040,12382000,2,41926,10483,1,438188800,438188800,15721,5240,10481,5240,0,1,5242,318582,0.318582
5640,2050,6040,12382000,2,45126,11283,1,464076800,464076800,16921,5640,11281,5640,0,1,5642,549375,0.549375
6040,2050,6040,12382000,2,48326,12083,1,489964800,489964800,18121,6040,12081,6040,0,1,6042,1026303,1.026303
6440,2050,6040,12382000,2,51526,12883,1,515852800,515852800,19321,6440,12881,6440,0,1,6442,4980347,4.980347
6840,2050,6040,12382000,2,54726,13683,1,541740800,541740800,20521,6840,13681,6840,0,1,6842,3940005,3.940005
40,5800,2140,12412000,2,326,83,1,101836800,101836800,121,40,81,40,0,1,42,14277,0.014277
440,5800,2140,12412000,2,3526,883,1,127244800,127244800,1321,440,881,440,0,1,442,43578,0.043578
840,5800,2140,12412000,2,6726,1683,1,152652800,152652800,2521,840,1681,840,0,1,842,11039,0.011039
1240,5800,2140,12412000,2,9926,2483,1,178060800,178060800,3721,1240,2481,1240,0,1,1242,141390,0.14139
1640,5800,2140,12412000,2,13126,3283,1,203468800,203468800,4921,1640,3281,1640,0,1,1642,994617,0.994617
2040,5800,2140,12412000,2,16326,4083,1,228876800,228876800,6121,2040,4081,2040,0,1,2042,378974,0.378974
2440,5800,2140,12412000,2,19526,4883,1,254284800,254284800,7321,2440,4881,2440,0,1,2442,529985,0.529985
2840,5800,2140,12412000,2,22726,5683,1,279692800,279692800,8521,2840,5681,2840,0,1,2842,697056,0.697056
3240,5800,2140,12412000,2,25926,6483,1,305100800,305100800,9721,3240,6481,3240,0,1,3242,756430,0.75643
3640,5800,2140,12412000,2,29126,7283,1,330508800,330508800,10921,3640,7281,3640,0,1,3642,368239,0.368239
4040,5800,2140,12412000,2,32326,8083,1,355916800,355916800,12121,4040,8081,4040,0,1,4042,2292406,2.292406
4440,5800,2140,12412000,2,35526,8883,1,381324800,381324800,13321,4440,8881,4440,0,1,4442,658914,0.658914
4840,5800,2140,12412000,2,38726,9683,1,406732800,406732800,14521,4840,9681,4840,0,1,4842,404581,0.404581
5240,5800,2140,12412000,2,41926,10483,1,432140800,432140800,15721,5240,10481,5240,0,1,5242,537021,0.537021
5640,5800,2140,12412000,2,45126,11283,1,457548800,457548800,16921,5640,11281,5640,0,1,5642,1442099,1.442099
6040,5800,2140,12412000,2,48326,12083,1,482956800,482956800,18121,6040,12081,6040,0,1,6042,178537,0.178537
6440,5800,2140,12412000,2,51526,12883,1,508364800,508364800,19321,6440,12881,6440,0,1,6442,223238,0.223238
6840,5800,2140,12412000,2,54726,13683,1,533772800,533772800,20521,6840,13681,6840,0,1,6842,1063765,1.063765
35,2240,5545,12420800,2,286,73,1,101546200,101546200,106,35,71,35,0,1,37,226216,0.226216
535,2240,5545,12420800,2,4286,1073,1,132686200,132686200,1606,535,1071,535,0,1,537,1336874,1.336874
1035,2240,5545,12420800,2,8286,2073,1,163826200,163826200,3106,1035,2071,1035,0,1,1037,2489769,2.489769
1535,2240,5545,12420800,2,12286,3073,1,194966200,194966200,4606,1535,3071,1535,0,1,1537,3669934,3.669934
2035,2240,5545,12420800,2,16286,4073,1,226106200,226106200,6106,2035,4071,2035,0,1,2037,4806477,4.806477
2535,2240,5545,12420800,2,20286,5073,1,257246200,257246200,7606,2535,5071,2535,0,1,2537,5964998,5.964998
39,2243,5541,12428463,2,318,81,1,101856312,101856312,118,39,79,39,0,1,41,12681,0.012681
539,2243,5541,12428463,2,4318,1081,1,132992312,132992312,1618,539,1079,539,0,1,541,117788,0.117788
1039,2243,5541,12428463,2,8318,2081,1,164128312,164128312,3118,1039,2079,1039,0,1,1041,321347,0.321347
1539,2243,5541,12428463,2,12318,3081,1,195264312,195264312,4618,1539,3079,1539,0,1,1541,168562,0.168562
2039,2243,5541,12428463,2,16318,4081,1,226400312,226400312,6118,2039,4079,2039,0,1,2041,701323,0.701323
2539,2243,5541,12428463,2,20318,5081,1,257536312,257536312,7618,2539,5079,2539,0,1,2541,784938,0.784938
3039,2243,5541,12428463,2,24318,6081,1,288672312,288672312,9118,3039,6079,3039,0,1,3041,1513911,1.513911
3539,2243,5541,12428463,2,28318,7081,1,319808312,319808312,10618,3539,7079,3539,0,1,3541,229281,0.229281
4039,2243,5541,12428463,2,32318,8081,1,350944312,350944312,12118,4039,8079,4039,0,1,4041,2036737,2.036737
4539,2243,5541,12428463,2,36318,9081,1,382080312,382080312,13618,4539,9079,4539,0,1,4541,429732,0.429732
5039,2243,5541,12428463,2,40318,10081,1,413216312,413216312,15118,5039,10079,5039,0,1,5041,3894975,3.894975
5539,2243,5541,12428463,2,44318,11081,1,444352312,444352312,16618,5539,11079,5539,0,1,5541,308606,0.308606
6039,2243,5541,12428463,2,48318,12081,1,475488312,475488312,18118,6039,12079,6039,0,1,6041,1539374,1.539374
6539,2243,5541,12428463,2,52318,13081,1,506624312,506624312,19618,6539,13079,6539,0,1,6541,1489576,1.489576
7039,2243,5541,12428463,2,56318,14081,1,537760312,537760312,21118,7039,14079,7039,0,1,7041,2028480,2.02848
55,4055,3065,12428575,2,446,113,1,102561400,102561400,166,55,111,55,0,1,57,15130,0.01513
455,4055,3065,12428575,2,3646,913,1,125345400,125345400,1366,455,911,455,0,1,457,73962,0.073962
855,4055,3065,12428575,2,6846,1713,1,148129400,148129400,2566,855,1711,855,0,1,857,36411,0.036411
1255,4055,3065,12428575,2,10046,2513,1,170913400,170913400,3766,1255,2511,1255,0,1,1257,135703,0.135703
1655,4055,3065,12428575,2,13246,3313,1,193697400,193697400,4966,1655,3311,1655,0,1,1657,1082567,1.082567
2055,4055,3065,12428575,2,16446,4113,1,216481400,216481400,6166,2055,4111,2055,0,1,2057,257890,0.25789
2455,4055,3065,12428575,2,19646,4913,1,239265400,239265400,7366,2455,4911,2455,0,1,2457,18356,0.018356
2855,4055,3065,12428575,2,22846,5713,1,262049400,262049400,8566,2855,5711,2855,0,1,2857,242498,0.242498
3255,4055,3065,12428575,2,26046,6513,1,284833400,284833400,9766,3255,6511,3255,0,1,3257,873543,0.873543
3655,4055,3065,12428575,2,29246,7313,1,307617400,307617400,10966,3655,7311,3655,0,1,3657,67685,0.067685
4055,4055,3065,12428575,2,32446,8113,1,330401400,330401400,12166,4055,8111,4055,0,1,4057,142025,0.142025
4455,4055,3065,12428575,2,35646,8913,1,353185400,353185400,13366,4455,8911,4455,0,1,4457,567706,0.567706
4855,4055,3065,12428575,2,38846,9713,1,375969400,375969400,14566,4855,9711,4855,0,1,4857,205446,0.205446
5255,4055,3065,12428575,2,42046,10513,1,398753400,398753400,15766,5255,10511,5255,0,1,5257,930069,0.930069
5655,4055,3065,12428575,2,45246,11313,1,421537400,421537400,16966,5655,11311,5655,0,1,5657,111581,0.111581
6055,4055,3065,12428575,2,48446,12113,1,444321400,444321400,18166,6055,12111,6055,0,1,6057,1456330,1.45633
6455,4055,3065,12428575,2,51646,12913,1,467105400,467105400,19366,6455,12911,6455,0,1,6457,3454552,3.454552
6855,4055,3065,12428575,2,54846,13713,1,489889400,489889400,20566,6855,13711,6855,0,1,6857,3464537,3.464537
55,2555,4865,12430075,2,446,113,1,102705400,102705400,166,55,111,55,0,1,57,257058,0.257058
455,2555,4865,12430075,2,3646,913,1,126449400,126449400,1366,455,911,455,0,1,457,1155112,1.155112
855,2555,4865,12430075,2,6846,1713,1,150193400,150193400,2566,855,1711,855,0,1,857,2066640,2.06664
1255,2555,4865,12430075,2,10046,2513,1,173937400,173937400,3766,1255,2511,1255,0,1,1257,692332,0.692332
1655,2555,4865,12430075,2,13246,3313,1,197681400,197681400,4966,1655,3311,1655,0,1,1657,1098806,1.098806
2055,2555,4865,12430075,2,16446,4113,1,221425400,221425400,6166,2055,4111,2055,0,1,2057,2286160,2.28616
2455,2555,4865,12430075,2,19646,4913,1,245169400,245169400,7366,2455,4911,2455,0,1,2457,2107399,2.107399
2855,2555,4865,12430075,2,22846,5713,1,268913400,268913400,8566,2855,5711,2855,0,1,2857,85203,0.085203
3255,2555,4865,12430075,2,26046,6513,1,292657400,292657400,9766,3255,6511,3255,0,1,3257,285019,0.285019
3655,2555,4865,12430075,2,29246,7313,1,316401400,316401400,10966,3655,7311,3655,0,1,3657,265564,0.265564
4055,2555,4865,12430075,2,32446,8113,1,340145400,340145400,12166,4055,8111,4055,0,1,4057,748343,0.748343
4455,2555,4865,12430075,2,35646,8913,1,363889400,363889400,13366,4455,8911,4455,0,1,4457,86365,0.086365
4855,2555,4865,12430075,2,38846,9713,1,387633400,387633400,14566,4855,9711,4855,0,1,4857,1388108,1.388108
5255,2555,4865,12430075,2,42046,10513,1,411377400,411377400,15766,5255,10511,5255,0,1,5257,342660,0.34266
5655,2555,4865,12430075,2,45246,11313,1,435121400,435121400,16966,5655,11311,5655,0,1,5657,2646570,2.64657
6055,2555,4865,12430075,2,48446,12113,1,458865400,458865400,18166,6055,12111,6055,0,1,6057,2247146,2.247146
6455,2555,4865,12430075,2,51646,12913,1,482609400,482609400,19366,6455,12911,6455,0,1,6457,2509414,2.509414
6855,2555,4865,12430075,2,54846,13713,1,506353400,506353400,20566,6855,13711,6855,0,1,6857,2447410,2.44741
39,6093,2041,12435813,2,318,81,1,102024312,102024312,118,39,79,39,0,1,41,12628,0.012628
539,6093,2041,12435813,2,4318,1081,1,134560312,134560312,1618,539,1079,539,0,1,541,28201,0.028201
1039,6093,2041,12435813,2,8318,2081,1,167096312,167096312,3118,1039,2079,1039,0,1,1041,39697,0.039697
1539,6093,2041,12435813,2,12318,3081,1,199632312,199632312,4618,1539,3079,1539,0,1,1541,305002,0.305002
2039,6093,2041,12435813,2,16318,4081,1,232168312,232168312,6118,2039,4079,2039,0,1,2041,7374,0.007374
2539,6093,2041,12435813,2,20318,5081,1,264704312,264704312,7618,2539,5079,2539,0,1,2541,974027,0.974027
3039,6093,2041,12435813,2,24318,6081,1,297240312,297240312,9118,3039,6079,3039,0,1,3041,30061,0.030061
3539,6093,2041,12435813,2,28318,7081,1,329776312,329776312,10618,3539,7079,3539,0,1,3541,321530,0.32153
4039,6093,2041,12435813,2,32318,8081,1,362312312,362312312,12118,4039,8079,4039,0,1,4041,1296951,1.296951
4539,6093,2041,12435813,2,36318,9081,1,394848312,394848312,13618,4539,9079,4539,0,1,4541,5833757,5.833757
5039,6093,2041,12435813,2,40318,10081,1,427384312,427384312,15118,5039,10079,5039,0,1,5041,3487991,3.487991
5539,6093,2041,12435813,2,44318,11081,1,459920312,459920312,16618,5539,11079,5539,0,1,5541,1384833,1.384833
6039,6093,2041,12435813,2,48318,12081,1,492456312,492456312,18118,6039,12079,6039,0,1,6041,2988457,2.988457
6539,6093,2041,12435813,2,52318,13081,1,524992312,524992312,19618,6539,13079,6539,0,1,6541,28677,0.028677
7039,6093,2041,12435813,2,56318,14081,1,557528312,557528312,21118,7039,14079,7039,0,1,7041,5671857,5.671857
35,6090,2045,12454050,2,286,73,1,101910200,101910200,106,35,71,35,0,1,37,29968,0.029968
535,6090,2045,12454050,2,4286,1073,1,134450200,134450200,1606,535,1071,535,0,1,537,956611,0.956611
1035,6090,2045,12454050,2,8286,2073,1,166990200,166990200,3106,1035,2071,1035,0,1,1037,2595695,2.595695
1535,6090,2045,12454050,2,12286,3073,1,199530200,199530200,4606,1535,3071,1535,0,1,1537,3836138,3.836138
55,5055,2465,12460575,2,446,113,1,102993400,102993400,166,55,111,55,0,1,57,11862,0.011862
455,5055,2465,12460575,2,3646,913,1,127057400,127057400,1366,455,911,455,0,1,457,236296,0.236296
855,5055,2465,12460575,2,6846,1713,1,151121400,151121400,2566,855,1711,855,0,1,857,58558,0.058558
1255,5055,2465,12460575,2,10046,2513,1,175185400,175185400,3766,1255,2511,1255,0,1,1257,460215,0.460215
1655,5055,2465,12460575,2,13246,3313,1,199249400,199249400,4966,1655,3311,1655,0,1,1657,717884,0.717884
2055,5055,2465,12460575,2,16446,4113,1,223313400,223313400,6166,2055,4111,2055,0,1,2057,464744,0.464744
2455,5055,2465,12460575,2,19646,4913,1,247377400,247377400,7366,2455,4911,2455,0,1,2457,25095,0.025095
2855,5055,2465,12460575,2,22846,5713,1,271441400,271441400,8566,2855,5711,2855,0,1,2857,274241,0.274241
3255,5055,2465,12460575,2,26046,6513,1,295505400,295505400,9766,3255,6511,3255,0,1,3257,61621,0.061621
3655,5055,2465,12460575,2,29246,7313,1,319569400,319569400,10966,3655,7311,3655,0,1,3657,146451,0.146451
4055,5055,2465,12460575,2,32446,8113,1,343633400,343633400,12166,4055,8111,4055,0,1,4057,321460,0.32146
4455,5055,2465,12460575,2,35646,8913,1,367697400,367697400,13366,4455,8911,4455,0,1,4457,441369,0.441369
4855,5055,2465,12460575,2,38846,9713,1,391761400,391761400,14566,4855,9711,4855,0,1,4857,304785,0.304785
5255,5055,2465,12460575,2,42046,10513,1,415825400,415825400,15766,5255,10511,5255,0,1,5257,79272,0.079272
5655,5055,2465,12460575,2,45246,11313,1,439889400,439889400,16966,5655,11311,5655,0,1,5657,543762,0.543762
6055,5055,2465,12460575,2,48446,12113,1,463953400,463953400,18166,6055,12111,6055,0,1,6057,2762583,2.762583
6455,5055,2465,12460575,2,51646,12913,1,488017400,488017400,19366,6455,12911,6455,0,1,6457,736605,0.736605
6855,5055,2465,12460575,2,54846,13713,1,512081400,512081400,20566,6855,13711,6855,0,1,6857,1211258,1.211258
55,2055,6065,12463575,2,446,113,1,103281400,103281400,166,55,111,55,0,1,57,8487,0.008487
455,2055,6065,12463575,2,3646,913,1,129265400,129265400,1366,455,911,455,0,1,457,133232,0.133232
855,2055,6065,12463575,2,6846,1713,1,155249400,155249400,2566,855,1711,855,0,1,857,152359,0.152359
1255,2055,6065,12463575,2,10046,2513,1,181233400,181233400,3766,1255,2511,1255,0,1,1257,235237,0.235237
1655,2055,6065,12463575,2,13246,3313,1,207217400,207217400,4966,1655,3311,1655,0,1,1657,11503,0.011503
2055,2055,6065,12463575,2,16446,4113,1,233201400,233201400,6166,2055,4111,2055,0,1,2057,801281,0.801281
2455,2055,6065,12463575,2,19646,4913,1,259185400,259185400,7366,2455,4911,2455,0,1,2457,179850,0.17985
2855,2055,6065,12463575,2,22846,5713,1,285169400,285169400,8566,2855,5711,2855,0,1,2857,20292,0.020292
3255,2055,6065,12463575,2,26046,6513,1,311153400,311153400,9766,3255,6511,3255,0,1,3257,243195,0.243195
3655,2055,6065,12463575,2,29246,7313,1,337137400,337137400,10966,3655,7311,3655,0,1,3657,221454,0.221454
4055,2055,6065,12463575,2,32446,8113,1,363121400,363121400,12166,4055,8111,4055,0,1,4057,504049,0.504049
4455,2055,6065,12463575,2,35646,8913,1,389105400,389105400,13366,4455,8911,4455,0,1,4457,870638,0.870638
4855,2055,6065,12463575,2,38846,9713,1,415089400,415089400,14566,4855,9711,4855,0,1,4857,149930,0.14993
5255,2055,6065,12463575,2,42046,10513,1,441073400,441073400,15766,5255,10511,5255,0,1,5257,930492,0.930492
5655,2055,6065,12463575,2,45246,11313,1,467057400,467057400,16966,5655,11311,5655,0,1,5657,1585796,1.585796
6055,2055,6065,12463575,2,48446,12113,1,493041400,493041400,18166,6055,12111,6055,0,1,6057,310325,0.310325
6455,2055,6065,12463575,2,51646,12913,1,519025400,519025400,19366,6455,12911,6455,0,1,6457,861775,0.861775
6855,2055,6065,12463575,2,54846,13713,1,545009400,545009400,20566,6855,13711,6855,0,1,6857,3191024,3.191024
40,4550,2740,12467000,2,326,83,1,102068800,102068800,121,40,81,40,0,1,42,226013,0.226013
440,4550,2740,12467000,2,3526,883,1,125396800,125396800,1321,440,881,440,0,1,442,1122512,1.122512
840,4550,2740,12467000,2,6726,1683,1,148724800,148724800,2521,840,1681,840,0,1,842,1936448,1.936448
1240,4550,2740,12467000,2,9926,2483,1,172052800,172052800,3721,1240,2481,1240,0,1,1242,1282675,1.282675
1640,4550,2740,12467000,2,13126,3283,1,195380800,195380800,4921,1640,3281,1640,0,1,1642,3037313,3.037313
2040,4550,2740,12467000,2,16326,4083,1,218708800,218708800,6121,2040,4081,2040,0,1,2042,246580,0.24658
2440,4550,2740,12467000,2,19526,4883,1,242036800,242036800,7321,2440,4881,2440,0,1,2442,3986278,3.986278
2840,4550,2740,12467000,2,22726,5683,1,265364800,265364800,8521,2840,5681,2840,0,1,2842,1995468,1.995468
3240,4550,2740,12467000,2,25926,6483,1,288692800,288692800,9721,3240,6481,3240,0,1,3242,2704270,2.70427
3640,4550,2740,12467000,2,29126,7283,1,312020800,312020800,10921,3640,7281,3640,0,1,3642,469487,0.469487
4040,4550,2740,12467000,2,32326,8083,1,335348800,335348800,12121,4040,8081,4040,0,1,4042,1723030,1.72303
4440,4550,2740,12467000,2,35526,8883,1,358676800,358676800,13321,4440,8881,4440,0,1,4442,6132634,6.132634
4840,4550,2740,12467000,2,38726,9683,1,382004800,382004800,14521,4840,9681,4840,0,1,4842,1102585,1.102585
5240,4550,2740,12467000,2,41926,10483,1,405332800,405332800,15721,5240,10481,5240,0,1,5242,5762656,5.762656
5640,4550,2740,12467000,2,45126,11283,1,428660800,428660800,16921,5640,11281,5640,0,1,5642,2607916,2.607916
6040,4550,2740,12467000,2,48326,12083,1,451988800,451988800,18121,6040,12081,6040,0,1,6042,4032968,4.032968
6440,4550,2740,12467000,2,51526,12883,1,475316800,475316800,19321,6440,12881,6440,0,1,6442,2279671,2.279671
6840,4550,2740,12467000,2,54726,13683,1,498644800,498644800,20521,6840,13681,6840,0,1,6842,814056,0.814056
40,1800,6940,12492000,2,326,83,1,102732800,102732800,121,40,81,40,0,1,42,234503,0.234503
440,1800,6940,12492000,2,3526,883,1,130700800,130700800,1321,440,881,440,0,1,442,373697,0.373697
840,1800,6940,12492000,2,6726,1683,1,158668800,158668800,2521,840,1681,840,0,1,842,239427,0.239427
1240,1800,6940,12492000,2,9926,2483,1,186636800,186636800,3721,1240,2481,1240,0,1,1242,408270,0.40827
1640,1800,6940,12492000,2,13126,3283,1,214604800,214604800,4921,1640,3281,1640,0,1,1642,1318015,1.318015
2040,1800,6940,12492000,2,16326,4083,1,242572800,242572800,6121,2040,4081,2040,0,1,2042,3217097,3.217097
2440,1800,6940,12492000,2,19526,4883,1,270540800,270540800,7321,2440,4881,2440,0,1,2442,1374048,1.374048
2840,1800,6940,12492000,2,22726,5683,1,298508800,298508800,8521,2840,5681,2840,0,1,2842,501084,0.501084
3240,1800,6940,12492000,2,25926,6483,1,326476800,326476800,9721,3240,6481,3240,0,1,3242,263933,0.263933
3640,1800,6940,12492000,2,29126,7283,1,354444800,354444800,10921,3640,7281,3640,0,1,3642,962223,0.962223
4040,1800,6940,12492000,2,32326,8083,1,382412800,382412800,12121,4040,8081,4040,0,1,4042,915369,0.915369
4440,1800,6940,12492000,2,35526,8883,1,410380800,410380800,13321,4440,8881,4440,0,1,4442,47703,0.047703
4840,1800,6940,12492000,2,38726,9683,1,438348800,438348800,14521,4840,9681,4840,0,1,4842,2356890,2.35689
5240,1800,6940,12492000,2,41926,10483,1,466316800,466316800,15721,5240,10481,5240,0,1,5242,3521272,3.521272
5640,1800,6940,12492000,2,45126,11283,1,494284800,494284800,16921,5640,11281,5640,0,1,5642,1976956,1.976956
6040,1800,6940,12492000,2,48326,12083,1,522252800,522252800,18121,6040,12081,6040,0,1,6042,549253,0.549253
6440,1800,6940,12492000,2,51526,12883,1,550220800,550220800,19321,6440,12881,6440,0,1,6442,2549117,2.549117
6840,1800,6940,12492000,2,54726,13683,1,578188800,578188800,20521,6840,13681,6840,0,1,6842,1303493,1.303493
40,2300,5440,12512000,2,326,83,1,102572800,102572800,121,40,81,40,0,1,42,227951,0.227951
440,2300,5440,12512000,2,3526,883,1,127340800,127340800,1321,440,881,440,0,1,442,1107114,1.107114
840,2300,5440,12512000,2,6726,1683,1,152108800,152108800,2521,840,1681,840,0,1,842,554727,0.554727
1240,2300,5440,12512000,2,9926,2483,1,176876800,176876800,3721,1240,2481,1240,0,1,1242,1546745,1.546745
1640,2300,5440,12512000,2,13126,3283,1,201644800,201644800,4921,1640,3281,1640,0,1,1642,126467,0.126467
2040,2300,5440,12512000,2,16326,4083,1,226412800,226412800,6121,2040,4081,2040,0,1,2042,397847,0.397847
2440,2300,5440,12512000,2,19526,4883,1,251180800,251180800,7321,2440,4881,2440,0,1,2442,213900,0.2139
2840,2300,5440,12512000,2,22726,5683,1,275948800,275948800,8521,2840,5681,2840,0,1,2842,196264,0.196264
3240,2300,5440,12512000,2,25926,6483,1,300716800,300716800,9721,3240,6481,3240,0,1,3242,214528,0.214528
3640,2300,5440,12512000,2,29126,7283,1,325484800,325484800,10921,3640,7281,3640,0,1,3642,3100208,3.100208
4040,2300,5440,12512000,2,32326,8083,1,350252800,350252800,12121,4040,8081,4040,0,1,4042,2817427,2.817427
4440,2300,5440,12512000,2,35526,8883,1,375020800,375020800,13321,4440,8881,4440,0,1,4442,4237444,4.237444
4840,2300,5440,12512000,2,38726,9683,1,399788800,399788800,14521,4840,9681,4840,0,1,4842,86891,0.086891
5240,2300,5440,12512000,2,41926,10483,1,424556800,424556800,15721,5240,10481,5240,0,1,5242,136440,0.13644
5640,2300,5440,12512000,2,45126,11283,1,449324800,449324800,16921,5640,11281,5640,0,1,5642,38075,0.038075
6040,2300,5440,12512000,2,48326,12083,1,474092800,474092800,18121,6040,12081,6040,0,1,6042,5371014,5.371014
6440,2300,5440,12512000,2,51526,12883,1,498860800,498860800,19321,6440,12881,6440,0,1,6442,325710,0.32571
6840,2300,5440,12512000,2,54726,13683,1,523628800,523628800,20521,6840,13681,6840,0,1,6842,315231,0.315231
40,6800,1840,12512000,2,326,83,1,102860800,102860800,121,40,81,40,0,1,42,215536,0.215536
440,6800,1840,12512000,2,3526,883,1,130508800,130508800,1321,440,881,440,0,1,442,1140937,1.140937
840,6800,1840,12512000,2,6726,1683,1,158156800,158156800,2521,840,1681,840,0,1,842,612042,0.612042
1240,6800,1840,12512000,2,9926,2483,1,185804800,185804800,3721,1240,2481,1240,0,1,1242,238520,0.23852
1640,6800,1840,12512000,2,13126,3283,1,213452800,213452800,4921,1640,3281,1640,0,1,1642,828464,0.828464
2040,6800,1840,12512000,2,16326,4083,1,241100800,241100800,6121,2040,4081,2040,0,1,2042,4136159,4.136159
2440,6800,1840,12512000,2,19526,4883,1,268748800,268748800,7321,2440,4881,2440,0,1,2442,352421,0.352421
2840,6800,1840,12512000,2,22726,5683,1,296396800,296396800,8521,2840,5681,2840,0,1,2842,269224,0.269224
3240,6800,1840,12512000,2,25926,6483,1,324044800,324044800,9721,3240,6481,3240,0,1,3242,2379137,2.379137
3640,6800,1840,12512000,2,29126,7283,1,351692800,351692800,10921,3640,7281,3640,0,1,3642,1281252,1.281252
4040,6800,1840,12512000,2,32326,8083,1,379340800,379340800,12121,4040,8081,4040,0,1,4042,15025,0.015025
4440,6800,1840,12512000,2,35526,8883,1,406988800,406988800,13321,4440,8881,4440,0,1,4442,1086413,1.086413
4840,6800,1840,12512000,2,38726,9683,1,434636800,434636800,14521,4840,9681,4840,0,1,4842,4461138,4.461138
5240,6800,1840,12512000,2,41926,10483,1,462284800,462284800,15721,5240,10481,5240,0,1,5242,473947,0.473947
5640,6800,1840,12512000,2,45126,11283,1,489932800,489932800,16921,5640,11281,5640,0,1,5642,2668023,2.668023
6040,6800,1840,12512000,2,48326,12083,1,517580800,517580800,18121,6040,12081,6040,0,1,6042,5668781,5.668781
6440,6800,1840,12512000,2,51526,12883,1,545228800,545228800,19321,6440,12881,6440,0,1,6442,161062,0.161062
6840,6800,1840,12512000,2,54726,13683,1,572876800,572876800,20521,6840,13681,6840,0,1,6842,684484,0.684484
44,2253,5555,12515415,2,358,91,1,102871736,102871736,133,44,89,44,0,1,46,98065,0.098065
544,2253,5555,12515415,2,4358,1091,1,134103736,134103736,1633,544,1089,544,0,1,546,138712,0.138712
1044,2253,5555,12515415,2,8358,2091,1,165335736,165335736,3133,1044,2089,1044,0,1,1046,61344,0.061344
1544,2253,5555,12515415,2,12358,3091,1,196567736,196567736,4633,1544,3089,1544,0,1,1546,238456,0.238456
2044,2253,5555,12515415,2,16358,4091,1,227799736,227799736,6133,2044,4089,2044,0,1,2046,903411,0.903411
2544,2253,5555,12515415,2,20358,5091,1,259031736,259031736,7633,2544,5089,2544,0,1,2546,307917,0.307917
3044,2253,5555,12515415,2,24358,6091,1,290263736,290263736,9133,3044,6089,3044,0,1,3046,384355,0.384355
3544,2253,5555,12515415,2,28358,7091,1,321495736,321495736,10633,3544,7089,3544,0,1,3546,490610,0.49061
4044,2253,5555,12515415,2,32358,8091,1,352727736,352727736,12133,4044,8089,4044,0,1,4046,485147,0.485147
4544,2253,5555,12515415,2,36358,9091,1,383959736,383959736,13633,4544,9089,4544,0,1,4546,883632,0.883632
5044,2253,5555,12515415,2,40358,10091,1,415191736,415191736,15133,5044,10089,5044,0,1,5046,1747494,1.747494
5544,2253,5555,12515415,2,44358,11091,1,446423736,446423736,16633,5544,11089,5544,0,1,5546,1105742,1.105742
6044,2253,5555,12515415,2,48358,12091,1,477655736,477655736,18133,6044,12089,6044,0,1,6046,2365826,2.365826
6544,2253,5555,12515415,2,52358,13091,1,508887736,508887736,19633,6544,13089,6544,0,1,6546,1074109,1.074109
7044,2253,5555,12515415,2,56358,14091,1,540119736,540119736,21133,7044,14089,7044,0,1,7046,1122903,1.122903
44,6103,2055,12541665,2,358,91,1,103204936,103204936,133,44,89,44,0,1,46,52657,0.052657
544,6103,2055,12541665,2,4358,1091,1,135836936,135836936,1633,544,1089,544,0,1,546,66209,0.066209
1044,6103,2055,12541665,2,8358,2091,1,168468936,168468936,3133,1044,2089,1044,0,1,1046,170105,0.170105
1544,6103,2055,12541665,2,12358,3091,1,201100936,201100936,4633,1544,3089,1544,0,1,1546,547215,0.547215
2044,6103,2055,12541665,2,16358,4091,1,233732936,233732936,6133,2044,4089,2044,0,1,2046,668851,0.668851
2544,6103,2055,12541665,2,20358,5091,1,266364936,266364936,7633,2544,5089,2544,0,1,2546,592321,0.592321
3044,6103,2055,12541665,2,24358,6091,1,298996936,298996936,9133,3044,6089,3044,0,1,3046,69909,0.069909
3544,6103,2055,12541665,2,28358,7091,1,331628936,331628936,10633,3544,7089,3544,0,1,3546,2263930,2.26393
4044,6103,2055,12541665,2,32358,8091,1,364260936,364260936,12133,4044,8089,4044,0,1,4046,86575,0.086575
4544,6103,2055,12541665,2,36358,9091,1,396892936,396892936,13633,4544,9089,4544,0,1,4546,1548757,1.548757
5044,6103,2055,12541665,2,40358,10091,1,429524936,429524936,15133,5044,10089,5044,0,1,5046,4235588,4.235588
5544,6103,2055,12541665,2,44358,11091,1,462156936,462156936,16633,5544,11089,5544,0,1,5546,434929,0.434929
6044,6103,2055,12541665,2,48358,12091,1,494788936,494788936,18133,6044,12089,6044,0,1,6046,194922,0.194922
6544,6103,2055,12541665,2,52358,13091,1,527420936,527420936,19633,6544,13089,6544,0,1,6546,3640574,3.640574
7044,6103,2055,12541665,2,56358,14091,1,560052936,560052936,21133,7044,14089,7044,0,1,7046,3381590,3.38159
55,5805,2165,12567825,2,446,113,1,104049400,104049400,166,55,111,55,0,1,57,8604,0.008604
455,5805,2165,12567825,2,3646,913,1,129553400,129553400,1366,455,911,455,0,1,457,9525,0.009525
855,5805,2165,12567825,2,6846,1713,1,155057400,155057400,2566,855,1711,855,0,1,857,37415,0.037415
1255,5805,2165,12567825,2,10046,2513,1,180561400,180561400,3766,1255,2511,1255,0,1,1257,289674,0.289674
1655,5805,2165,12567825,2,13246,3313,1,206065400,206065400,4966,1655,3311,1655,0,1,1657,466070,0.46607
2055,5805,2165,12567825,2,16446,4113,1,231569400,231569400,6166,2055,4111,2055,0,1,2057,315236,0.315236
2455,5805,2165,12567825,2,19646,4913,1,257073400,257073400,7366,2455,4911,2455,0,1,2457,2323833,2.323833
2855,5805,2165,12567825,2,22846,5713,1,282577400,282577400,8566,2855,5711,2855,0,1,2857,445614,0.445614
3255,5805,2165,12567825,2,26046,6513,1,308081400,308081400,9766,3255,6511,3255,0,1,3257,422162,0.422162
3655,5805,2165,12567825,2,29246,7313,1,333585400,333585400,10966,3655,7311,3655,0,1,3657,1724265,1.724265
4055,5805,2165,12567825,2,32446,8113,1,359089400,359089400,12166,4055,8111,4055,0,1,4057,1639312,1.639312
4455,5805,2165,12567825,2,35646,8913,1,384593400,384593400,13366,4455,8911,4455,0,1,4457,2188049,2.188049
4855,5805,2165,12567825,2,38846,9713,1,410097400,410097400,14566,4855,9711,4855,0,1,4857,1649740,1.64974
5255,5805,2165,12567825,2,42046,10513,1,435601400,435601400,15766,5255,10511,5255,0,1,5257,194937,0.194937
5655,5805,2165,12567825,2,45246,11313,1,461105400,461105400,16966,5655,11311,5655,0,1,5657,254458,0.254458
6055,5805,2165,12567825,2,48446,12113,1,486609400,486609400,18166,6055,12111,6055,0,1,6057,134849,0.134849
6455,5805,2165,12567825,2,51646,12913,1,512113400,512113400,19366,6455,12911,6455,0,1,6457,414079,0.414079
6855,5805,2165,12567825,2,54846,13713,1,537617400,537617400,20566,6855,13711,6855,0,1,6857,1335459,1.335459
55,1805,6965,12571825,2,446,113,1,104433400,104433400,166,55,111,55,0,1,57,66537,0.066537
455,1805,6965,12571825,2,3646,913,1,132497400,132497400,1366,455,911,455,0,1,457,348850,0.34885
855,1805,6965,12571825,2,6846,1713,1,160561400,160561400,2566,855,1711,855,0,1,857,267191,0.267191
1255,1805,6965,12571825,2,10046,2513,1,188625400,188625400,3766,1255,2511,1255,0,1,1257,773530,0.77353
1655,1805,6965,12571825,2,13246,3313,1,216689400,216689400,4966,1655,3311,1655,0,1,1657,740574,0.740574
2055,1805,6965,12571825,2,16446,4113,1,244753400,244753400,6166,2055,4111,2055,0,1,2057,2435579,2.435579
2455,1805,6965,12571825,2,19646,4913,1,272817400,272817400,7366,2455,4911,2455,0,1,2457,1171252,1.171252
2855,1805,6965,12571825,2,22846,5713,1,300881400,300881400,8566,2855,5711,2855,0,1,2857,40819,0.040819
3255,1805,6965,12571825,2,26046,6513,1,328945400,328945400,9766,3255,6511,3255,0,1,3257,2838890,2.83889
3655,1805,6965,12571825,2,29246,7313,1,357009400,357009400,10966,3655,7311,3655,0,1,3657,891436,0.891436
4055,1805,6965,12571825,2,32446,8113,1,385073400,385073400,12166,4055,8111,4055,0,1,4057,564603,0.564603
4455,1805,6965,12571825,2,35646,8913,1,413137400,413137400,13366,4455,8911,4455,0,1,4457,467607,0.467607
4855,1805,6965,12571825,2,38846,9713,1,441201400,441201400,14566,4855,9711,4855,0,1,4857,6601492,6.601492
5255,1805,6965,12571825,2,42046,10513,1,469265400,469265400,15766,5255,10511,5255,0,1,5257,927472,0.927472
5655,1805,6965,12571825,2,45246,11313,1,497329400,497329400,16966,5655,11311,5655,0,1,5657,260490,0.26049
6055,1805,6965,12571825,2,48446,12113,1,525393400,525393400,18166,6055,12111,6055,0,1,6057,2292084,2.292084
6455,1805,6965,12571825,2,51646,12913,1,553457400,553457400,19366,6455,12911,6455,0,1,6457,1238450,1.23845
6855,1805,6965,12571825,2,54846,13713,1,581521400,581521400,20566,6855,13711,6855,0,1,6857,315461,0.315461
55,4555,2765,12594575,2,446,113,1,103977400,103977400,166,55,111,55,0,1,57,257979,0.257979
455,4555,2765,12594575,2,3646,913,1,127401400,127401400,1366,455,911,455,0,1,457,1176907,1.176907
855,4555,2765,12594575,2,6846,1713,1,150825400,150825400,2566,855,1711,855,0,1,857,454688,0.454688
1255,4555,2765,12594575,2,10046,2513,1,174249400,174249400,3766,1255,2511,1255,0,1,1257,1889349,1.889349
1655,4555,2765,12594575,2,13246,3313,1,197673400,197673400,4966,1655,3311,1655,0,1,1657,900213,0.900213
2055,4555,2765,12594575,2,16446,4113,1,221097400,221097400,6166,2055,4111,2055,0,1,2057,90947,0.090947
2455,4555,2765,12594575,2,19646,4913,1,244521400,244521400,7366,2455,4911,2455,0,1,2457,5247808,5.247808
2855,4555,2765,12594575,2,22846,5713,1,267945400,267945400,8566,2855,5711,2855,0,1,2857,3166537,3.166537
3255,4555,2765,12594575,2,26046,6513,1,291369400,291369400,9766,3255,6511,3255,0,1,3257,754140,0.75414
3655,4555,2765,12594575,2,29246,7313,1,314793400,314793400,10966,3655,7311,3655,0,1,3657,3213974,3.213974
4055,4555,2765,12594575,2,32446,8113,1,338217400,338217400,12166,4055,8111,4055,0,1,4057,8577728,8.577728
4455,4555,2765,12594575,2,35646,8913,1,361641400,361641400,13366,4455,8911,4455,0,1,4457,3434599,3.434599
4855,4555,2765,12594575,2,38846,9713,1,385065400,385065400,14566,4855,9711,4855,0,1,4857,3367367,3.367367
5255,4555,2765,12594575,2,42046,10513,1,408489400,408489400,15766,5255,10511,5255,0,1,5257,2457239,2.457239
5655,4555,2765,12594575,2,45246,11313,1,431913400,431913400,16966,5655,11311,5655,0,1,5657,2867102,2.867102
6055,4555,2765,12594575,2,48446,12113,1,455337400,455337400,18166,6055,12111,6055,0,1,6057,46448,0.046448
6455,4555,2765,12594575,2,51646,12913,1,478761400,478761400,19366,6455,12911,6455,0,1,6457,1741557,1.741557
6855,4555,2765,12594575,2,54846,13713,1,502185400,502185400,20566,6855,13711,6855,0,1,6857,7006495,7.006495
55,2305,5465,12596825,2,446,113,1,104193400,104193400,166,55,111,55,0,1,57,252965,0.252965
455,2305,5465,12596825,2,3646,913,1,129057400,129057400,1366,455,911,455,0,1,457,1023646,1.023646
855,2305,5465,12596825,2,6846,1713,1,153921400,153921400,2566,855,1711,855,0,1,857,1363623,1.363623
1255,2305,5465,12596825,2,10046,2513,1,178785400,178785400,3766,1255,2511,1255,0,1,1257,3024384,3.024384
1655,2305,5465,12596825,2,13246,3313,1,203649400,203649400,4966,1655,3311,1655,0,1,1657,1524006,1.524006
2055,2305,5465,12596825,2,16446,4113,1,228513400,228513400,6166,2055,4111,2055,0,1,2057,128840,0.12884
2455,2305,5465,12596825,2,19646,4913,1,253377400,253377400,7366,2455,4911,2455,0,1,2457,150085,0.150085
2855,2305,5465,12596825,2,22846,5713,1,278241400,278241400,8566,2855,5711,2855,0,1,2857,583517,0.583517
3255,2305,5465,12596825,2,26046,6513,1,303105400,303105400,9766,3255,6511,3255,0,1,3257,525128,0.525128
3655,2305,5465,12596825,2,29246,7313,1,327969400,327969400,10966,3655,7311,3655,0,1,3657,4237785,4.237785
4055,2305,5465,12596825,2,32446,8113,1,352833400,352833400,12166,4055,8111,4055,0,1,4057,3378774,3.378774
4455,2305,5465,12596825,2,35646,8913,1,377697400,377697400,13366,4455,8911,4455,0,1,4457,2055009,2.055009
4855,2305,5465,12596825,2,38846,9713,1,402561400,402561400,14566,4855,9711,4855,0,1,4857,272308,0.272308
5255,2305,5465,12596825,2,42046,10513,1,427425400,427425400,15766,5255,10511,5255,0,1,5257,121728,0.121728
5655,2305,5465,12596825,2,45246,11313,1,452289400,452289400,16966,5655,11311,5655,0,1,5657,2466996,2.466996
6055,2305,5465,12596825,2,48446,12113,1,477153400,477153400,18166,6055,12111,6055,0,1,6057,514559,0.514559
6455,2305,5465,12596825,2,51646,12913,1,502017400,502017400,19366,6455,12911,6455,0,1,6457,1028027,1.028027
6855,2305,5465,12596825,2,54846,13713,1,526881400,526881400,20566,6855,13711,6855,0,1,6857,215559,0.215559
35,4950,2545,12597750,2,286,73,1,102880600,102880600,106,35,71,35,0,1,37,49572,0.049572
535,4950,2545,12597750,2,4286,1073,1,132860600,132860600,1606,535,1071,535,0,1,537,592644,0.592644
1035,4950,2545,12597750,2,8286,2073,1,162840600,162840600,3106,1035,2071,1035,0,1,1037,483719,0.483719
1535,4950,2545,12597750,2,12286,3073,1,192820600,192820600,4606,1535,3071,1535,0,1,1537,107986,0.107986
2035,4950,2545,12597750,2,16286,4073,1,222800600,222800600,6106,2035,4071,2035,0,1,2037,2193567,2.193567
2535,4950,2545,12597750,2,20286,5073,1,252780600,252780600,7606,2535,5071,2535,0,1,2537,4584424,4.584424
3035,4950,2545,12597750,2,24286,6073,1,282760600,282760600,9106,3035,6071,3035,0,1,3037,2041372,2.041372
3535,4950,2545,12597750,2,28286,7073,1,312740600,312740600,10606,3535,7071,3535,0,1,3537,8687691,8.687691
4035,4950,2545,12597750,2,32286,8073,1,342720600,342720600,12106,4035,8071,4035,0,1,4037,2461748,2.461748
4535,4950,2545,12597750,2,36286,9073,1,372700600,372700600,13606,4535,9071,4535,0,1,4537,462600,0.4626
5035,4950,2545,12597750,2,40286,10073,1,402680600,402680600,15106,5035,10071,5035,0,1,5037,1890125,1.890125
5535,4950,2545,12597750,2,44286,11073,1,432660600,432660600,16606,5535,11071,5535,0,1,5537,6512393,6.512393
6035,4950,2545,12597750,2,48286,12073,1,462640600,462640600,18106,6035,12071,6035,0,1,6037,2910203,2.910203
6535,4950,2545,12597750,2,52286,13073,1,492620600,492620600,19606,6535,13071,6535,0,1,6537,8950258,8.950258
7035,4950,2545,12597750,2,56286,14073,1,522600600,522600600,21106,7035,14071,7035,0,1,7037,17243482,17.243482
39,2793,4541,12683013,2,318,81,1,103752312,103752312,118,39,79,39,0,1,41,234008,0.234008
539,2793,4541,12683013,2,4318,1081,1,133088312,133088312,1618,539,1079,539,0,1,541,609085,0.609085
1039,2793,4541,12683013,2,8318,2081,1,162424312,162424312,3118,1039,2079,1039,0,1,1041,62241,0.062241
1539,2793,4541,12683013,2,12318,3081,1,191760312,191760312,4618,1539,3079,1539,0,1,1541,97561,0.097561
2039,2793,4541,12683013,2,16318,4081,1,221096312,221096312,6118,2039,4079,2039,0,1,2041,1320842,1.320842
2539,2793,4541,12683013,2,20318,5081,1,250432312,250432312,7618,2539,5079,2539,0,1,2541,3768889,3.768889
3039,2793,4541,12683013,2,24318,6081,1,279768312,279768312,9118,3039,6079,3039,0,1,3041,3827547,3.827547
3539,2793,4541,12683013,2,28318,7081,1,309104312,309104312,10618,3539,7079,3539,0,1,3541,208424,0.208424
4039,2793,4541,12683013,2,32318,8081,1,338440312,338440312,12118,4039,8079,4039,0,1,4041,2330007,2.330007
4539,2793,4541,12683013,2,36318,9081,1,367776312,367776312,13618,4539,9079,4539,0,1,4541,1163179,1.163179
5039,2793,4541,12683013,2,40318,10081,1,397112312,397112312,15118,5039,10079,5039,0,1,5041,485700,0.4857
5539,2793,4541,12683013,2,44318,11081,1,426448312,426448312,16618,5539,11079,5539,0,1,5541,328775,0.328775
6039,2793,4541,12683013,2,48318,12081,1,455784312,455784312,18118,6039,12079,6039,0,1,6041,3579473,3.579473
6539,2793,4541,12683013,2,52318,13081,1,485120312,485120312,19618,6539,13079,6539,0,1,6541,599023,0.599023
7039,2793,4541,12683013,2,56318,14081,1,514456312,514456312,21118,7039,14079,7039,0,1,7041,1225774,1.225774
39,4993,2541,12687213,2,318,81,1,103848312,103848312,118,39,79,39,0,1,41,222841,0.222841
539,4993,2541,12687213,2,4318,1081,1,133984312,133984312,1618,539,1079,539,0,1,541,1376179,1.376179
1039,4993,2541,12687213,2,8318,2081,1,164120312,164120312,3118,1039,2079,1039,0,1,1041,2555041,2.555041
1539,4993,2541,12687213,2,12318,3081,1,194256312,194256312,4618,1539,3079,1539,0,1,1541,1261850,1.26185
2039,4993,2541,12687213,2,16318,4081,1,224392312,224392312,6118,2039,4079,2039,0,1,2041,3358972,3.358972
2539,4993,2541,12687213,2,20318,5081,1,254528312,254528312,7618,2539,5079,2539,0,1,2541,803997,0.803997
3039,4993,2541,12687213,2,24318,6081,1,284664312,284664312,9118,3039,6079,3039,0,1,3041,1068115,1.068115
3539,4993,2541,12687213,2,28318,7081,1,314800312,314800312,10618,3539,7079,3539,0,1,3541,4788932,4.788932
4039,4993,2541,12687213,2,32318,8081,1,344936312,344936312,12118,4039,8079,4039,0,1,4041,3913218,3.913218
4539,4993,2541,12687213,2,36318,9081,1,375072312,375072312,13618,4539,9079,4539,0,1,4541,6473003,6.473003
5039,4993,2541,12687213,2,40318,10081,1,405208312,405208312,15118,5039,10079,5039,0,1,5041,4007981,4.007981
5539,4993,2541,12687213,2,44318,11081,1,435344312,435344312,16618,5539,11079,5539,0,1,5541,6792463,6.792463
6039,4993,2541,12687213,2,48318,12081,1,465480312,465480312,18118,6039,12079,6039,0,1,6041,14346635,14.346635
6539,4993,2541,12687213,2,52318,13081,1,495616312,495616312,19618,6539,13079,6539,0,1,6541,15534099,15.534099
7039,4993,2541,12687213,2,56318,14081,1,525752312,525752312,21118,7039,14079,7039,0,1,7041,16748245,16.748245
55,6805,1865,12691325,2,446,113,1,105345400,105345400,166,55,111,55,0,1,57,253779,0.253779
455,6805,1865,12691325,2,3646,913,1,133089400,133089400,1366,455,911,455,0,1,457,1218341,1.218341
855,6805,1865,12691325,2,6846,1713,1,160833400,160833400,2566,855,1711,855,0,1,857,2193681,2.193681
1255,6805,1865,12691325,2,10046,2513,1,188577400,188577400,3766,1255,2511,1255,0,1,1257,201070,0.20107
1655,6805,1865,12691325,2,13246,3313,1,216321400,216321400,4966,1655,3311,1655,0,1,1657,582628,0.582628
2055,6805,1865,12691325,2,16446,4113,1,244065400,244065400,6166,2055,4111,2055,0,1,2057,497682,0.497682
2455,6805,1865,12691325,2,19646,4913,1,271809400,271809400,7366,2455,4911,2455,0,1,2457,699377,0.699377
2855,6805,1865,12691325,2,22846,5713,1,299553400,299553400,8566,2855,5711,2855,0,1,2857,1603510,1.60351
3255,6805,1865,12691325,2,26046,6513,1,327297400,327297400,9766,3255,6511,3255,0,1,3257,3332095,3.332095
3655,6805,1865,12691325,2,29246,7313,1,355041400,355041400,10966,3655,7311,3655,0,1,3657,3179419,3.179419
4055,6805,1865,12691325,2,32446,8113,1,382785400,382785400,12166,4055,8111,4055,0,1,4057,4213874,4.213874
4455,6805,1865,12691325,2,35646,8913,1,410529400,410529400,13366,4455,8911,4455,0,1,4457,1505539,1.505539
4855,6805,1865,12691325,2,38846,9713,1,438273400,438273400,14566,4855,9711,4855,0,1,4857,1164084,1.164084
5255,6805,1865,12691325,2,42046,10513,1,466017400,466017400,15766,5255,10511,5255,0,1,5257,1999586,1.999586
5655,6805,1865,12691325,2,45246,11313,1,493761400,493761400,16966,5655,11311,5655,0,1,5657,1713015,1.713015
6055,6805,1865,12691325,2,48446,12113,1,521505400,521505400,18166,6055,12111,6055,0,1,6057,3569562,3.569562
6455,6805,1865,12691325,2,51646,12913,1,549249400,549249400,19366,6455,12911,6455,0,1,6457,360767,0.360767
6855,6805,1865,12691325,2,54846,13713,1,576993400,576993400,20566,6855,13711,6855,0,1,6857,3499612,3.499612
40,3800,3340,12692000,2,326,83,1,103820800,103820800,121,40,81,40,0,1,42,230456,0.230456
440,3800,3340,12692000,2,3526,883,1,126668800,126668800,1321,440,881,440,0,1,442,1172752,1.172752
840,3800,3340,12692000,2,6726,1683,1,149516800,149516800,2521,840,1681,840,0,1,842,1422066,1.422066
1240,3800,3340,12692000,2,9926,2483,1,172364800,172364800,3721,1240,2481,1240,0,1,1242,1006922,1.006922
1640,3800,3340,12692000,2,13126,3283,1,195212800,195212800,4921,1640,3281,1640,0,1,1642,4072655,4.072655
2040,3800,3340,12692000,2,16326,4083,1,218060800,218060800,6121,2040,4081,2040,0,1,2042,5075084,5.075084
2440,3800,3340,12692000,2,19526,4883,1,240908800,240908800,7321,2440,4881,2440,0,1,2442,3352440,3.35244
2840,3800,3340,12692000,2,22726,5683,1,263756800,263756800,8521,2840,5681,2840,0,1,2842,733614,0.733614
3240,3800,3340,12692000,2,25926,6483,1,286604800,286604800,9721,3240,6481,3240,0,1,3242,198759,0.198759
3640,3800,3340,12692000,2,29126,7283,1,309452800,309452800,10921,3640,7281,3640,0,1,3642,2122489,2.122489
4040,3800,3340,12692000,2,32326,8083,1,332300800,332300800,12121,4040,8081,4040,0,1,4042,1141561,1.141561
4440,3800,3340,12692000,2,35526,8883,1,355148800,355148800,13321,4440,8881,4440,0,1,4442,10914353,10.914353
4840,3800,3340,12692000,2,38726,9683,1,377996800,377996800,14521,4840,9681,4840,0,1,4842,2840696,2.840696
5240,3800,3340,12692000,2,41926,10483,1,400844800,400844800,15721,5240,10481,5240,0,1,5242,567555,0.567555
5640,3800,3340,12692000,2,45126,11283,1,423692800,423692800,16921,5640,11281,5640,0,1,5642,2270148,2.270148
6040,3800,3340,12692000,2,48326,12083,1,446540800,446540800,18121,6040,12081,6040,0,1,6042,1749444,1.749444
6440,3800,3340,12692000,2,51526,12883,1,469388800,469388800,19321,6440,12881,6440,0,1,6442,4778036,4.778036
6840,3800,3340,12692000,2,54726,13683,1,492236800,492236800,20521,6840,13681,6840,0,1,6842,910164,0.910164
40,2800,4540,12712000,2,326,83,1,104044800,104044800,121,40,81,40,0,1,42,226619,0.226619
440,2800,4540,12712000,2,3526,883,1,127532800,127532800,1321,440,881,440,0,1,442,1144217,1.144217
840,2800,4540,12712000,2,6726,1683,1,151020800,151020800,2521,840,1681,840,0,1,842,1807933,1.807933
1240,2800,4540,12712000,2,9926,2483,1,174508800,174508800,3721,1240,2481,1240,0,1,1242,3023167,3.023167
1640,2800,4540,12712000,2,13126,3283,1,197996800,197996800,4921,1640,3281,1640,0,1,1642,778048,0.778048
2040,2800,4540,12712000,2,16326,4083,1,221484800,221484800,6121,2040,4081,2040,0,1,2042,3413935,3.413935
2440,2800,4540,12712000,2,19526,4883,1,244972800,244972800,7321,2440,4881,2440,0,1,2442,261668,0.261668
2840,2800,4540,12712000,2,22726,5683,1,268460800,268460800,8521,2840,5681,2840,0,1,2842,570825,0.570825
3240,2800,4540,12712000,2,25926,6483,1,291948800,291948800,9721,3240,6481,3240,0,1,3242,1291564,1.291564
3640,2800,4540,12712000,2,29126,7283,1,315436800,315436800,10921,3640,7281,3640,0,1,3642,3827855,3.827855
4040,2800,4540,12712000,2,32326,8083,1,338924800,338924800,12121,4040,8081,4040,0,1,4042,2510829,2.510829
4440,2800,4540,12712000,2,35526,8883,1,362412800,362412800,13321,4440,8881,4440,0,1,4442,1233227,1.233227
4840,2800,4540,12712000,2,38726,9683,1,385900800,385900800,14521,4840,9681,4840,0,1,4842,8536427,8.536427
5240,2800,4540,12712000,2,41926,10483,1,409388800,409388800,15721,5240,10481,5240,0,1,5242,6167822,6.167822
5640,2800,4540,12712000,2,45126,11283,1,432876800,432876800,16921,5640,11281,5640,0,1,5642,496671,0.496671
6040,2800,4540,12712000,2,48326,12083,1,456364800,456364800,18121,6040,12081,6040,0,1,6042,116677,0.116677
6440,2800,4540,12712000,2,51526,12883,1,479852800,479852800,19321,6440,12881,6440,0,1,6442,1811693,1.811693
6840,2800,4540,12712000,2,54726,13683,1,503340800,503340800,20521,6840,13681,6840,0,1,6842,942725,0.942725
44,2803,4555,12767665,2,358,91,1,104731336,104731336,133,44,89,44,0,1,46,83628,0.083628
544,2803,4555,12767665,2,4358,1091,1,134163336,134163336,1633,544,1089,544,0,1,546,1333058,1.333058
1044,2803,4555,12767665,2,8358,2091,1,163595336,163595336,3133,1044,2089,1044,0,1,1046,2563971,2.563971
1544,2803,4555,12767665,2,12358,3091,1,193027336,193027336,4633,1544,3089,1544,0,1,1546,1603088,1.603088
2044,2803,4555,12767665,2,16358,4091,1,222459336,222459336,6133,2044,4089,2044,0,1,2046,795708,0.795708
2544,2803,4555,12767665,2,20358,5091,1,251891336,251891336,7633,2544,5089,2544,0,1,2546,1115737,1.115737
3044,2803,4555,12767665,2,24358,6091,1,281323336,281323336,9133,3044,6089,3044,0,1,3046,7289133,7.289133
3544,2803,4555,12767665,2,28358,7091,1,310755336,310755336,10633,3544,7089,3544,0,1,3546,768258,0.768258
4044,2803,4555,12767665,2,32358,8091,1,340187336,340187336,12133,4044,8089,4044,0,1,4046,5884224,5.884224
4544,2803,4555,12767665,2,36358,9091,1,369619336,369619336,13633,4544,9089,4544,0,1,4546,143368,0.143368
5044,2803,4555,12767665,2,40358,10091,1,399051336,399051336,15133,5044,10089,5044,0,1,5046,222668,0.222668
5544,2803,4555,12767665,2,44358,11091,1,428483336,428483336,16633,5544,11089,5544,0,1,5546,5944421,5.944421
6044,2803,4555,12767665,2,48358,12091,1,457915336,457915336,18133,6044,12089,6044,0,1,6046,3778047,3.778047
6544,2803,4555,12767665,2,52358,13091,1,487347336,487347336,19633,6544,13089,6544,0,1,6546,363512,0.363512
7044,2803,4555,12767665,2,56358,14091,1,516779336,516779336,21133,7044,14089,7044,0,1,7046,4090580,4.09058
44,5003,2555,12782665,2,358,91,1,104921736,104921736,133,44,89,44,0,1,46,234938,0.234938
544,5003,2555,12782665,2,4358,1091,1,135153736,135153736,1633,544,1089,544,0,1,546,1401547,1.401547
1044,5003,2555,12782665,2,8358,2091,1,165385736,165385736,3133,1044,2089,1044,0,1,1046,2392760,2.39276
1544,5003,2555,12782665,2,12358,3091,1,195617736,195617736,4633,1544,3089,1544,0,1,1546,138345,0.138345
2044,5003,2555,12782665,2,16358,4091,1,225849736,225849736,6133,2044,4089,2044,0,1,2046,1259092,1.259092
2544,5003,2555,12782665,2,20358,5091,1,256081736,256081736,7633,2544,5089,2544,0,1,2546,715176,0.715176
3044,5003,2555,12782665,2,24358,6091,1,286313736,286313736,9133,3044,6089,3044,0,1,3046,2399348,2.399348
3544,5003,2555,12782665,2,28358,7091,1,316545736,316545736,10633,3544,7089,3544,0,1,3546,8567111,8.567111
4044,5003,2555,12782665,2,32358,8091,1,346777736,346777736,12133,4044,8089,4044,0,1,4046,5709047,5.709047
4544,5003,2555,12782665,2,36358,9091,1,377009736,377009736,13633,4544,9089,4544,0,1,4546,10961474,10.961474
5044,5003,2555,12782665,2,40358,10091,1,407241736,407241736,15133,5044,10089,5044,0,1,5046,12184654,12.184654
5544,5003,2555,12782665,2,44358,11091,1,437473736,437473736,16633,5544,11089,5544,0,1,5546,5213509,5.213509
6044,5003,2555,12782665,2,48358,12091,1,467705736,467705736,18133,6044,12089,6044,0,1,6046,14568503,14.568503
6544,5003,2555,12782665,2,52358,13091,1,497937736,497937736,19633,6544,13089,6544,0,1,6546,15725464,15.725464
7044,5003,2555,12782665,2,56358,14091,1,528169736,528169736,21133,7044,14089,7044,0,1,7046,16919999,16.919999
55,3805,3365,12803825,2,446,113,1,105585400,105585400,166,55,111,55,0,1,57,274114,0.274114
455,3805,3365,12803825,2,3646,913,1,128529400,128529400,1366,455,911,455,0,1,457,1234958,1.234958
855,3805,3365,12803825,2,6846,1713,1,151473400,151473400,2566,855,1711,855,0,1,857,2226556,2.226556
1255,3805,3365,12803825,2,10046,2513,1,174417400,174417400,3766,1255,2511,1255,0,1,1257,56533,0.056533
1655,3805,3365,12803825,2,13246,3313,1,197361400,197361400,4966,1655,3311,1655,0,1,1657,4193959,4.193959
2055,3805,3365,12803825,2,16446,4113,1,220305400,220305400,6166,2055,4111,2055,0,1,2057,5179771,5.179771
2455,3805,3365,12803825,2,19646,4913,1,243249400,243249400,7366,2455,4911,2455,0,1,2457,652732,0.652732
2855,3805,3365,12803825,2,22846,5713,1,266193400,266193400,8566,2855,5711,2855,0,1,2857,1830642,1.830642
3255,3805,3365,12803825,2,26046,6513,1,289137400,289137400,9766,3255,6511,3255,0,1,3257,960453,0.960453
3655,3805,3365,12803825,2,29246,7313,1,312081400,312081400,10966,3655,7311,3655,0,1,3657,9137926,9.137926
4055,3805,3365,12803825,2,32446,8113,1,335025400,335025400,12166,4055,8111,4055,0,1,4057,5066689,5.066689
4455,3805,3365,12803825,2,35646,8913,1,357969400,357969400,13366,4455,8911,4455,0,1,4457,11116027,11.116027
4855,3805,3365,12803825,2,38846,9713,1,380913400,380913400,14566,4855,9711,4855,0,1,4857,3000759,3.000759
5255,3805,3365,12803825,2,42046,10513,1,403857400,403857400,15766,5255,10511,5255,0,1,5257,5740082,5.740082
5655,3805,3365,12803825,2,45246,11313,1,426801400,426801400,16966,5655,11311,5655,0,1,5657,2419781,2.419781
6055,3805,3365,12803825,2,48446,12113,1,449745400,449745400,18166,6055,12111,6055,0,1,6057,1538480,1.53848
6455,3805,3365,12803825,2,51646,12913,1,472689400,472689400,19366,6455,12911,6455,0,1,6457,234454,0.234454
6855,3805,3365,12803825,2,54846,13713,1,495633400,495633400,20566,6855,13711,6855,0,1,6857,822957,0.822957
55,2805,4565,12804825,2,446,113,1,105681400,105681400,166,55,111,55,0,1,57,268034,0.268034
455,2805,4565,12804825,2,3646,913,1,129265400,129265400,1366,455,911,455,0,1,457,1178782,1.178782
855,2805,4565,12804825,2,6846,1713,1,152849400,152849400,2566,855,1711,855,0,1,857,2120755,2.120755
1255,2805,4565,12804825,2,10046,2513,1,176433400,176433400,3766,1255,2511,1255,0,1,1257,211902,0.211902
1655,2805,4565,12804825,2,13246,3313,1,200017400,200017400,4966,1655,3311,1655,0,1,1657,1285949,1.285949
2055,2805,4565,12804825,2,16446,4113,1,223601400,223601400,6166,2055,4111,2055,0,1,2057,771059,0.771059
2455,2805,4565,12804825,2,19646,4913,1,247185400,247185400,7366,2455,4911,2455,0,1,2457,5912519,5.912519
2855,2805,4565,12804825,2,22846,5713,1,270769400,270769400,8566,2855,5711,2855,0,1,2857,1884607,1.884607
3255,2805,4565,12804825,2,26046,6513,1,294353400,294353400,9766,3255,6511,3255,0,1,3257,3341331,3.341331
3655,2805,4565,12804825,2,29246,7313,1,317937400,317937400,10966,3655,7311,3655,0,1,3657,648875,0.648875
4055,2805,4565,12804825,2,32446,8113,1,341521400,341521400,12166,4055,8111,4055,0,1,4057,5928375,5.928375
4455,2805,4565,12804825,2,35646,8913,1,365105400,365105400,13366,4455,8911,4455,0,1,4457,5196302,5.196302
4855,2805,4565,12804825,2,38846,9713,1,388689400,388689400,14566,4855,9711,4855,0,1,4857,2275726,2.275726
5255,2805,4565,12804825,2,42046,10513,1,412273400,412273400,15766,5255,10511,5255,0,1,5257,913143,0.913143
5655,2805,4565,12804825,2,45246,11313,1,435857400,435857400,16966,5655,11311,5655,0,1,5657,6348862,6.348862
6055,2805,4565,12804825,2,48446,12113,1,459441400,459441400,18166,6055,12111,6055,0,1,6057,1524122,1.524122
6455,2805,4565,12804825,2,51646,12913,1,483025400,483025400,19366,6455,12911,6455,0,1,6457,3512497,3.512497
6855,2805,4565,12804825,2,54846,13713,1,506609400,506609400,20566,6855,13711,6855,0,1,6857,2901761,2.901761
40,3550,3640,12922000,2,326,83,1,105676800,105676800,121,40,81,40,0,1,42,225534,0.225534
440,3550,3640,12922000,2,3526,883,1,128684800,128684800,1321,440,881,440,0,1,442,94606,0.094606
840,3550,3640,12922000,2,6726,1683,1,151692800,151692800,2521,840,1681,840,0,1,842,573765,0.573765
1240,3550,3640,12922000,2,9926,2483,1,174700800,174700800,3721,1240,2481,1240,0,1,1242,1382685,1.382685
1640,3550,3640,12922000,2,13126,3283,1,197708800,197708800,4921,1640,3281,1640,0,1,1642,1826670,1.82667
2040,3550,3640,12922000,2,16326,4083,1,220716800,220716800,6121,2040,4081,2040,0,1,2042,3679695,3.679695
2440,3550,3640,12922000,2,19526,4883,1,243724800,243724800,7321,2440,4881,2440,0,1,2442,1085903,1.085903
2840,3550,3640,12922000,2,22726,5683,1,266732800,266732800,8521,2840,5681,2840,0,1,2842,364861,0.364861
3240,3550,3640,12922000,2,25926,6483,1,289740800,289740800,9721,3240,6481,3240,0,1,3242,1906403,1.906403
3640,3550,3640,12922000,2,29126,7283,1,312748800,312748800,10921,3640,7281,3640,0,1,3642,7397244,7.397244
4040,3550,3640,12922000,2,32326,8083,1,335756800,335756800,12121,4040,8081,4040,0,1,4042,2539192,2.539192
4440,3550,3640,12922000,2,35526,8883,1,358764800,358764800,13321,4440,8881,4440,0,1,4442,1798759,1.798759
4840,3550,3640,12922000,2,38726,9683,1,381772800,381772800,14521,4840,9681,4840,0,1,4842,1805953,1.805953
5240,3550,3640,12922000,2,41926,10483,1,404780800,404780800,15721,5240,10481,5240,0,1,5242,1970498,1.970498
5640,3550,3640,12922000,2,45126,11283,1,427788800,427788800,16921,5640,11281,5640,0,1,5642,529692,0.529692
6040,3550,3640,12922000,2,48326,12083,1,450796800,450796800,18121,6040,12081,6040,0,1,6042,4107742,4.107742
6440,3550,3640,12922000,2,51526,12883,1,473804800,473804800,19321,6440,12881,6440,0,1,6442,2012399,2.012399
6840,3550,3640,12922000,2,54726,13683,1,496812800,496812800,20521,6840,13681,6840,0,1,6842,4843013,4.843013
40,3050,4240,12932000,2,326,83,1,105788800,105788800,121,40,81,40,0,1,42,9736,0.009736
440,3050,4240,12932000,2,3526,883,1,129116800,129116800,1321,440,881,440,0,1,442,107481,0.107481
840,3050,4240,12932000,2,6726,1683,1,152444800,152444800,2521,840,1681,840,0,1,842,101491,0.101491
1240,3050,4240,12932000,2,9926,2483,1,175772800,175772800,3721,1240,2481,1240,0,1,1242,13145,0.013145
1640,3050,4240,12932000,2,13126,3283,1,199100800,199100800,4921,1640,3281,1640,0,1,1642,212538,0.212538
2040,3050,4240,12932000,2,16326,4083,1,222428800,222428800,6121,2040,4081,2040,0,1,2042,434528,0.434528
2440,3050,4240,12932000,2,19526,4883,1,245756800,245756800,7321,2440,4881,2440,0,1,2442,16024,0.016024
2840,3050,4240,12932000,2,22726,5683,1,269084800,269084800,8521,2840,5681,2840,0,1,2842,202375,0.202375
3240,3050,4240,12932000,2,25926,6483,1,292412800,292412800,9721,3240,6481,3240,0,1,3242,83734,0.083734
3640,3050,4240,12932000,2,29126,7283,1,315740800,315740800,10921,3640,7281,3640,0,1,3642,423824,0.423824
4040,3050,4240,12932000,2,32326,8083,1,339068800,339068800,12121,4040,8081,4040,0,1,4042,897263,0.897263
4440,3050,4240,12932000,2,35526,8883,1,362396800,362396800,13321,4440,8881,4440,0,1,4442,2698572,2.698572
4840,3050,4240,12932000,2,38726,9683,1,385724800,385724800,14521,4840,9681,4840,0,1,4842,316016,0.316016
5240,3050,4240,12932000,2,41926,10483,1,409052800,409052800,15721,5240,10481,5240,0,1,5242,102747,0.102747
5640,3050,4240,12932000,2,45126,11283,1,432380800,432380800,16921,5640,11281,5640,0,1,5642,3936846,3.936846
6040,3050,4240,12932000,2,48326,12083,1,455708800,455708800,18121,6040,12081,6040,0,1,6042,782656,0.782656
6440,3050,4240,12932000,2,51526,12883,1,479036800,479036800,19321,6440,12881,6440,0,1,6442,474069,0.474069
6840,3050,4240,12932000,2,54726,13683,1,502364800,502364800,20521,6840,13681,6840,0,1,6842,956610,0.95661
40,5300,2440,12932000,2,326,83,1,105932800,105932800,121,40,81,40,0,1,42,229755,0.229755
440,5300,2440,12932000,2,3526,883,1,130700800,130700800,1321,440,881,440,0,1,442,230719,0.230719
840,5300,2440,12932000,2,6726,1683,1,155468800,155468800,2521,840,1681,840,0,1,842,2174081,2.174081
1240,5300,2440,12932000,2,9926,2483,1,180236800,180236800,3721,1240,2481,1240,0,1,1242,983190,0.98319
1640,5300,2440,12932000,2,13126,3283,1,205004800,205004800,4921,1640,3281,1640,0,1,1642,2379006,2.379006
2040,5300,2440,12932000,2,16326,4083,1,229772800,229772800,6121,2040,4081,2040,0,1,2042,3920646,3.920646
2440,5300,2440,12932000,2,19526,4883,1,254540800,254540800,7321,2440,4881,2440,0,1,2442,2321840,2.32184
2840,5300,2440,12932000,2,22726,5683,1,279308800,279308800,8521,2840,5681,2840,0,1,2842,982364,0.982364
3240,5300,2440,12932000,2,25926,6483,1,304076800,304076800,9721,3240,6481,3240,0,1,3242,1363197,1.363197
3640,5300,2440,12932000,2,29126,7283,1,328844800,328844800,10921,3640,7281,3640,0,1,3642,271656,0.271656
4040,5300,2440,12932000,2,32326,8083,1,353612800,353612800,12121,4040,8081,4040,0,1,4042,2213513,2.213513
4440,5300,2440,12932000,2,35526,8883,1,378380800,378380800,13321,4440,8881,4440,0,1,4442,1402710,1.40271
4840,5300,2440,12932000,2,38726,9683,1,403148800,403148800,14521,4840,9681,4840,0,1,4842,171686,0.171686
5240,5300,2440,12932000,2,41926,10483,1,427916800,427916800,15721,5240,10481,5240,0,1,5242,366005,0.366005
5640,5300,2440,12932000,2,45126,11283,1,452684800,452684800,16921,5640,11281,5640,0,1,5642,2105674,2.105674
6040,5300,2440,12932000,2,48326,12083,1,477452800,477452800,18121,6040,12081,6040,0,1,6042,2827279,2.827279
6440,5300,2440,12932000,2,51526,12883,1,502220800,502220800,19321,6440,12881,6440,0,1,6442,671630,0.67163
6840,5300,2440,12932000,2,54726,13683,1,526988800,526988800,20521,6840,13681,6840,0,1,6842,1342287,1.342287
40,6050,2140,12947000,2,326,83,1,106196800,106196800,121,40,81,40,0,1,42,228159,0.228159
440,6050,2140,12947000,2,3526,883,1,132404800,132404800,1321,440,881,440,0,1,442,1157527,1.157527
840,6050,2140,12947000,2,6726,1683,1,158612800,158612800,2521,840,1681,840,0,1,842,2101814,2.101814
1240,6050,2140,12947000,2,9926,2483,1,184820800,184820800,3721,1240,2481,1240,0,1,1242,249270,0.24927
1640,6050,2140,12947000,2,13126,3283,1,211028800,211028800,4921,1640,3281,1640,0,1,1642,3035434,3.035434
2040,6050,2140,12947000,2,16326,4083,1,237236800,237236800,6121,2040,4081,2040,0,1,2042,2546938,2.546938
2440,6050,2140,12947000,2,19526,4883,1,263444800,263444800,7321,2440,4881,2440,0,1,2442,3618886,3.618886
2840,6050,2140,12947000,2,22726,5683,1,289652800,289652800,8521,2840,5681,2840,0,1,2842,711906,0.711906
3240,6050,2140,12947000,2,25926,6483,1,315860800,315860800,9721,3240,6481,3240,0,1,3242,3399201,3.399201
3640,6050,2140,12947000,2,29126,7283,1,342068800,342068800,10921,3640,7281,3640,0,1,3642,1637129,1.637129
4040,6050,2140,12947000,2,32326,8083,1,368276800,368276800,12121,4040,8081,4040,0,1,4042,645290,0.64529
4440,6050,2140,12947000,2,35526,8883,1,394484800,394484800,13321,4440,8881,4440,0,1,4442,2565181,2.565181
4840,6050,2140,12947000,2,38726,9683,1,420692800,420692800,14521,4840,9681,4840,0,1,4842,3561632,3.561632
5240,6050,2140,12947000,2,41926,10483,1,446900800,446900800,15721,5240,10481,5240,0,1,5242,1337890,1.33789
5640,6050,2140,12947000,2,45126,11283,1,473108800,473108800,16921,5640,11281,5640,0,1,5642,318808,0.318808
6040,6050,2140,12947000,2,48326,12083,1,499316800,499316800,18121,6040,12081,6040,0,1,6042,1753794,1.753794
6440,6050,2140,12947000,2,51526,12883,1,525524800,525524800,19321,6440,12881,6440,0,1,6442,1495730,1.49573
6840,6050,2140,12947000,2,54726,13683,1,551732800,551732800,20521,6840,13681,6840,0,1,6842,239868,0.239868
40,7050,1840,12972000,2,326,83,1,106620800,106620800,121,40,81,40,0,1,42,225651,0.225651
440,7050,1840,12972000,2,3526,883,1,135068800,135068800,1321,440,881,440,0,1,442,1187810,1.18781
840,7050,1840,12972000,2,6726,1683,1,163516800,163516800,2521,840,1681,840,0,1,842,2182144,2.182144
1240,7050,1840,12972000,2,9926,2483,1,191964800,191964800,3721,1240,2481,1240,0,1,1242,2538291,2.538291
1640,7050,1840,12972000,2,13126,3283,1,220412800,220412800,4921,1640,3281,1640,0,1,1642,3291205,3.291205
2040,7050,1840,12972000,2,16326,4083,1,248860800,248860800,6121,2040,4081,2040,0,1,2042,1819389,1.819389
2440,7050,1840,12972000,2,19526,4883,1,277308800,277308800,7321,2440,4881,2440,0,1,2442,4090341,4.090341
2840,7050,1840,12972000,2,22726,5683,1,305756800,305756800,8521,2840,5681,2840,0,1,2842,955559,0.955559
3240,7050,1840,12972000,2,25926,6483,1,334204800,334204800,9721,3240,6481,3240,0,1,3242,4581459,4.581459
3640,7050,1840,12972000,2,29126,7283,1,362652800,362652800,10921,3640,7281,3640,0,1,3642,3999457,3.999457
4040,7050,1840,12972000,2,32326,8083,1,391100800,391100800,12121,4040,8081,4040,0,1,4042,822893,0.822893
4440,7050,1840,12972000,2,35526,8883,1,419548800,419548800,13321,4440,8881,4440,0,1,4442,5008740,5.00874
4840,7050,1840,12972000,2,38726,9683,1,447996800,447996800,14521,4840,9681,4840,0,1,4842,12049135,12.049135
5240,7050,1840,12972000,2,41926,10483,1,476444800,476444800,15721,5240,10481,5240,0,1,5242,11583493,11.583493
5640,7050,1840,12972000,2,45126,11283,1,504892800,504892800,16921,5640,11281,5640,0,1,5642,13997209,13.997209
6040,7050,1840,12972000,2,48326,12083,1,533340800,533340800,18121,6040,12081,6040,0,1,6042,15081078,15.081078
6440,7050,1840,12972000,2,51526,12883,1,561788800,561788800,19321,6440,12881,6440,0,1,6442,16003412,16.003412
6840,7050,1840,12972000,2,54726,13683,1,590236800,590236800,20521,6840,13681,6840,0,1,6842,16997619,16.997619
40,2050,6340,12997000,2,326,83,1,106660800,106660800,121,40,81,40,0,1,42,272,0.000272
440,2050,6340,12997000,2,3526,883,1,133508800,133508800,1321,440,881,440,0,1,442,67794,0.067794
840,2050,6340,12997000,2,6726,1683,1,160356800,160356800,2521,840,1681,840,0,1,842,12642,0.012642
1240,2050,6340,12997000,2,9926,2483,1,187204800,187204800,3721,1240,2481,1240,0,1,1242,305752,0.305752
1640,2050,6340,12997000,2,13126,3283,1,214052800,214052800,4921,1640,3281,1640,0,1,1642,235967,0.235967
2040,2050,6340,12997000,2,16326,4083,1,240900800,240900800,6121,2040,4081,2040,0,1,2042,51917,0.051917
2440,2050,6340,12997000,2,19526,4883,1,267748800,267748800,7321,2440,4881,2440,0,1,2442,19685,0.019685
2840,2050,6340,12997000,2,22726,5683,1,294596800,294596800,8521,2840,5681,2840,0,1,2842,398544,0.398544
3240,2050,6340,12997000,2,25926,6483,1,321444800,321444800,9721,3240,6481,3240,0,1,3242,114429,0.114429
3640,2050,6340,12997000,2,29126,7283,1,348292800,348292800,10921,3640,7281,3640,0,1,3642,828388,0.828388
4040,2050,6340,12997000,2,32326,8083,1,375140800,375140800,12121,4040,8081,4040,0,1,4042,26537,0.026537
4440,2050,6340,12997000,2,35526,8883,1,401988800,401988800,13321,4440,8881,4440,0,1,4442,806672,0.806672
4840,2050,6340,12997000,2,38726,9683,1,428836800,428836800,14521,4840,9681,4840,0,1,4842,122861,0.122861
5240,2050,6340,12997000,2,41926,10483,1,455684800,455684800,15721,5240,10481,5240,0,1,5242,417835,0.417835
5640,2050,6340,12997000,2,45126,11283,1,482532800,482532800,16921,5640,11281,5640,0,1,5642,140860,0.14086
6040,2050,6340,12997000,2,48326,12083,1,509380800,509380800,18121,6040,12081,6040,0,1,6042,159992,0.159992
6440,2050,6340,12997000,2,51526,12883,1,536228800,536228800,19321,6440,12881,6440,0,1,6442,1205121,1.205121
6840,2050,6340,12997000,2,54726,13683,1,563076800,563076800,20521,6840,13681,6840,0,1,6842,912306,0.912306
40,3300,3940,13002000,2,326,83,1,106332800,106332800,121,40,81,40,0,1,42,229250,0.22925
440,3300,3940,13002000,2,3526,883,1,129500800,129500800,1321,440,881,440,0,1,442,1200544,1.200544
840,3300,3940,13002000,2,6726,1683,1,152668800,152668800,2521,840,1681,840,0,1,842,656546,0.656546
1240,3300,3940,13002000,2,9926,2483,1,175836800,175836800,3721,1240,2481,1240,0,1,1242,3190100,3.1901
1640,3300,3940,13002000,2,13126,3283,1,199004800,199004800,4921,1640,3281,1640,0,1,1642,2455619,2.455619
2040,3300,3940,13002000,2,16326,4083,1,222172800,222172800,6121,2040,4081,2040,0,1,2042,3901321,3.901321
2440,3300,3940,13002000,2,19526,4883,1,245340800,245340800,7321,2440,4881,2440,0,1,2442,4273714,4.273714
2840,3300,3940,13002000,2,22726,5683,1,268508800,268508800,8521,2840,5681,2840,0,1,2842,1257733,1.257733
3240,3300,3940,13002000,2,25926,6483,1,291676800,291676800,9721,3240,6481,3240,0,1,3242,153339,0.153339
3640,3300,3940,13002000,2,29126,7283,1,314844800,314844800,10921,3640,7281,3640,0,1,3642,2013374,2.013374
4040,3300,3940,13002000,2,32326,8083,1,338012800,338012800,12121,4040,8081,4040,0,1,4042,1030352,1.030352
4440,3300,3940,13002000,2,35526,8883,1,361180800,361180800,13321,4440,8881,4440,0,1,4442,781856,0.781856
4840,3300,3940,13002000,2,38726,9683,1,384348800,384348800,14521,4840,9681,4840,0,1,4842,155641,0.155641
5240,3300,3940,13002000,2,41926,10483,1,407516800,407516800,15721,5240,10481,5240,0,1,5242,270067,0.270067
5640,3300,3940,13002000,2,45126,11283,1,430684800,430684800,16921,5640,11281,5640,0,1,5642,852578,0.852578
6040,3300,3940,13002000,2,48326,12083,1,453852800,453852800,18121,6040,12081,6040,0,1,6042,1154491,1.154491
6440,3300,3940,13002000,2,51526,12883,1,477020800,477020800,19321,6440,12881,6440,0,1,6442,1526500,1.5265
6840,3300,3940,13002000,2,54726,13683,1,500188800,500188800,20521,6840,13681,6840,0,1,6842,2698199,2.698199
55,3555,3665,13029075,2,446,113,1,107409400,107409400,166,55,111,55,0,1,57,270252,0.270252
455,3555,3665,13029075,2,3646,913,1,130513400,130513400,1366,455,911,455,0,1,457,1245764,1.245764
855,3555,3665,13029075,2,6846,1713,1,153617400,153617400,2566,855,1711,855,0,1,857,2240234,2.240234
1255,3555,3665,13029075,2,10046,2513,1,176721400,176721400,3766,1255,2511,1255,0,1,1257,3243178,3.243178
1655,3555,3665,13029075,2,13246,3313,1,199825400,199825400,4966,1655,3311,1655,0,1,1657,2167809,2.167809
2055,3555,3665,13029075,2,16446,4113,1,222929400,222929400,6166,2055,4111,2055,0,1,2057,3110042,3.110042
2455,3555,3665,13029075,2,19646,4913,1,246033400,246033400,7366,2455,4911,2455,0,1,2457,2761527,2.761527
2855,3555,3665,13029075,2,22846,5713,1,269137400,269137400,8566,2855,5711,2855,0,1,2857,4678192,4.678192
3255,3555,3665,13029075,2,26046,6513,1,292241400,292241400,9766,3255,6511,3255,0,1,3257,3366452,3.366452
3655,3555,3665,13029075,2,29246,7313,1,315345400,315345400,10966,3655,7311,3655,0,1,3657,1890978,1.890978
4055,3555,3665,13029075,2,32446,8113,1,338449400,338449400,12166,4055,8111,4055,0,1,4057,938956,0.938956
4455,3555,3665,13029075,2,35646,8913,1,361553400,361553400,13366,4455,8911,4455,0,1,4457,121708,0.121708
4855,3555,3665,13029075,2,38846,9713,1,384657400,384657400,14566,4855,9711,4855,0,1,4857,1973007,1.973007
5255,3555,3665,13029075,2,42046,10513,1,407761400,407761400,15766,5255,10511,5255,0,1,5257,1649450,1.64945
5655,3555,3665,13029075,2,45246,11313,1,430865400,430865400,16966,5655,11311,5655,0,1,5657,3834944,3.834944
6055,3555,3665,13029075,2,48446,12113,1,453969400,453969400,18166,6055,12111,6055,0,1,6057,1012155,1.012155
6455,3555,3665,13029075,2,51646,12913,1,477073400,477073400,19366,6455,12911,6455,0,1,6457,2430776,2.430776
6855,3555,3665,13029075,2,54846,13713,1,500177400,500177400,20566,6855,13711,6855,0,1,6857,5647384,5.647384
55,3055,4265,13029575,2,446,113,1,107457400,107457400,166,55,111,55,0,1,57,16324,0.016324
455,3055,4265,13029575,2,3646,913,1,130881400,130881400,1366,455,911,455,0,1,457,50366,0.050366
855,3055,4265,13029575,2,6846,1713,1,154305400,154305400,2566,855,1711,855,0,1,857,49302,0.049302
1255,3055,4265,13029575,2,10046,2513,1,177729400,177729400,3766,1255,2511,1255,0,1,1257,55750,0.05575
1655,3055,4265,13029575,2,13246,3313,1,201153400,201153400,4966,1655,3311,1655,0,1,1657,14850,0.01485
2055,3055,4265,13029575,2,16446,4113,1,224577400,224577400,6166,2055,4111,2055,0,1,2057,209244,0.209244
2455,3055,4265,13029575,2,19646,4913,1,248001400,248001400,7366,2455,4911,2455,0,1,2457,17124,0.017124
2855,3055,4265,13029575,2,22846,5713,1,271425400,271425400,8566,2855,5711,2855,0,1,2857,182998,0.182998
3255,3055,4265,13029575,2,26046,6513,1,294849400,294849400,9766,3255,6511,3255,0,1,3257,75748,0.075748
3655,3055,4265,13029575,2,29246,7313,1,318273400,318273400,10966,3655,7311,3655,0,1,3657,965698,0.965698
4055,3055,4265,13029575,2,32446,8113,1,341697400,341697400,12166,4055,8111,4055,0,1,4057,488546,0.488546
4455,3055,4265,13029575,2,35646,8913,1,365121400,365121400,13366,4455,8911,4455,0,1,4457,579613,0.579613
4855,3055,4265,13029575,2,38846,9713,1,388545400,388545400,14566,4855,9711,4855,0,1,4857,703842,0.703842
5255,3055,4265,13029575,2,42046,10513,1,411969400,411969400,15766,5255,10511,5255,0,1,5257,1179749,1.179749
5655,3055,4265,13029575,2,45246,11313,1,435393400,435393400,16966,5655,11311,5655,0,1,5657,1331550,1.33155
6055,3055,4265,13029575,2,48446,12113,1,458817400,458817400,18166,6055,12111,6055,0,1,6057,893722,0.893722
6455,3055,4265,13029575,2,51646,12913,1,482241400,482241400,19366,6455,12911,6455,0,1,6457,2257454,2.257454
6855,3055,4265,13029575,2,54846,13713,1,505665400,505665400,20566,6855,13711,6855,0,1,6857,366229,0.366229
40,4300,3040,13072000,2,326,83,1,106924800,106924800,121,40,81,40,0,1,42,229563,0.229563
440,4300,3040,13072000,2,3526,883,1,130412800,130412800,1321,440,881,440,0,1,442,834994,0.834994
840,4300,3040,13072000,2,6726,1683,1,153900800,153900800,2521,840,1681,840,0,1,842,169873,0.169873
1240,4300,3040,13072000,2,9926,2483,1,177388800,177388800,3721,1240,2481,1240,0,1,1242,741390,0.74139
1640,4300,3040,13072000,2,13126,3283,1,200876800,200876800,4921,1640,3281,1640,0,1,1642,1691178,1.691178
2040,4300,3040,13072000,2,16326,4083,1,224364800,224364800,6121,2040,4081,2040,0,1,2042,551746,0.551746
2440,4300,3040,13072000,2,19526,4883,1,247852800,247852800,7321,2440,4881,2440,0,1,2442,337561,0.337561
2840,4300,3040,13072000,2,22726,5683,1,271340800,271340800,8521,2840,5681,2840,0,1,2842,1416027,1.416027
3240,4300,3040,13072000,2,25926,6483,1,294828800,294828800,9721,3240,6481,3240,0,1,3242,1060304,1.060304
3640,4300,3040,13072000,2,29126,7283,1,318316800,318316800,10921,3640,7281,3640,0,1,3642,3767602,3.767602
4040,4300,3040,13072000,2,32326,8083,1,341804800,341804800,12121,4040,8081,4040,0,1,4042,969304,0.969304
4440,4300,3040,13072000,2,35526,8883,1,365292800,365292800,13321,4440,8881,4440,0,1,4442,807374,0.807374
4840,4300,3040,13072000,2,38726,9683,1,388780800,388780800,14521,4840,9681,4840,0,1,4842,1212690,1.21269
5240,4300,3040,13072000,2,41926,10483,1,412268800,412268800,15721,5240,10481,5240,0,1,5242,5458152,5.458152
5640,4300,3040,13072000,2,45126,11283,1,435756800,435756800,16921,5640,11281,5640,0,1,5642,442600,0.4426
6040,4300,3040,13072000,2,48326,12083,1,459244800,459244800,18121,6040,12081,6040,0,1,6042,413606,0.413606
6440,4300,3040,13072000,2,51526,12883,1,482732800,482732800,19321,6440,12881,6440,0,1,6442,1811876,1.811876
6840,4300,3040,13072000,2,54726,13683,1,506220800,506220800,20521,6840,13681,6840,0,1,6842,548007,0.548007
55,5305,2465,13076825,2,446,113,1,108033400,108033400,166,55,111,55,0,1,57,261486,0.261486
455,5305,2465,13076825,2,3646,913,1,132897400,132897400,1366,455,911,455,0,1,457,1239300,1.2393
855,5305,2465,13076825,2,6846,1713,1,157761400,157761400,2566,855,1711,855,0,1,857,98641,0.098641
1255,5305,2465,13076825,2,10046,2513,1,182625400,182625400,3766,1255,2511,1255,0,1,1257,1063464,1.063464
1655,5305,2465,13076825,2,13246,3313,1,207489400,207489400,4966,1655,3311,1655,0,1,1657,2015054,2.015054
2055,5305,2465,13076825,2,16446,4113,1,232353400,232353400,6166,2055,4111,2055,0,1,2057,31718,0.031718
2455,5305,2465,13076825,2,19646,4913,1,257217400,257217400,7366,2455,4911,2455,0,1,2457,2380796,2.380796
2855,5305,2465,13076825,2,22846,5713,1,282081400,282081400,8566,2855,5711,2855,0,1,2857,64938,0.064938
3255,5305,2465,13076825,2,26046,6513,1,306945400,306945400,9766,3255,6511,3255,0,1,3257,267512,0.267512
3655,5305,2465,13076825,2,29246,7313,1,331809400,331809400,10966,3655,7311,3655,0,1,3657,9195835,9.195835
4055,5305,2465,13076825,2,32446,8113,1,356673400,356673400,12166,4055,8111,4055,0,1,4057,3800073,3.800073
4455,5305,2465,13076825,2,35646,8913,1,381537400,381537400,13366,4455,8911,4455,0,1,4457,1176036,1.176036
4855,5305,2465,13076825,2,38846,9713,1,406401400,406401400,14566,4855,9711,4855,0,1,4857,1160032,1.160032
5255,5305,2465,13076825,2,42046,10513,1,431265400,431265400,15766,5255,10511,5255,0,1,5257,904081,0.904081
5655,5305,2465,13076825,2,45246,11313,1,456129400,456129400,16966,5655,11311,5655,0,1,5657,1322293,1.322293
6055,5305,2465,13076825,2,48446,12113,1,480993400,480993400,18166,6055,12111,6055,0,1,6057,1611493,1.611493
6455,5305,2465,13076825,2,51646,12913,1,505857400,505857400,19366,6455,12911,6455,0,1,6457,1361253,1.361253
6855,5305,2465,13076825,2,54846,13713,1,530721400,530721400,20566,6855,13711,6855,0,1,6857,4357942,4.357942
55,2055,6365,13080075,2,446,113,1,108345400,108345400,166,55,111,55,0,1,57,8881,0.008881
455,2055,6365,13080075,2,3646,913,1,135289400,135289400,1366,455,911,455,0,1,457,17360,0.01736
855,2055,6365,13080075,2,6846,1713,1,162233400,162233400,2566,855,1711,855,0,1,857,4384,0.004384
1255,2055,6365,13080075,2,10046,2513,1,189177400,189177400,3766,1255,2511,1255,0,1,1257,24178,0.024178
1655,2055,6365,13080075,2,13246,3313,1,216121400,216121400,4966,1655,3311,1655,0,1,1657,232086,0.232086
2055,2055,6365,13080075,2,16446,4113,1,243065400,243065400,6166,2055,4111,2055,0,1,2057,795121,0.795121
2455,2055,6365,13080075,2,19646,4913,1,270009400,270009400,7366,2455,4911,2455,0,1,2457,129860,0.12986
2855,2055,6365,13080075,2,22846,5713,1,296953400,296953400,8566,2855,5711,2855,0,1,2857,204281,0.204281
3255,2055,6365,13080075,2,26046,6513,1,323897400,323897400,9766,3255,6511,3255,0,1,3257,137759,0.137759
3655,2055,6365,13080075,2,29246,7313,1,350841400,350841400,10966,3655,7311,3655,0,1,3657,976537,0.976537
4055,2055,6365,13080075,2,32446,8113,1,377785400,377785400,12166,4055,8111,4055,0,1,4057,386849,0.386849
4455,2055,6365,13080075,2,35646,8913,1,404729400,404729400,13366,4455,8911,4455,0,1,4457,1401694,1.401694
4855,2055,6365,13080075,2,38846,9713,1,431673400,431673400,14566,4855,9711,4855,0,1,4857,137341,0.137341
5255,2055,6365,13080075,2,42046,10513,1,458617400,458617400,15766,5255,10511,5255,0,1,5257,65086,0.065086
5655,2055,6365,13080075,2,45246,11313,1,485561400,485561400,16966,5655,11311,5655,0,1,5657,183510,0.18351
6055,2055,6365,13080075,2,48446,12113,1,512505400,512505400,18166,6055,12111,6055,0,1,6057,1561632,1.561632
6455,2055,6365,13080075,2,51646,12913,1,539449400,539449400,19366,6455,12911,6455,0,1,6457,2522266,2.522266
6855,2055,6365,13080075,2,54846,13713,1,566393400,566393400,20566,6855,13711,6855,0,1,6857,2867872,2.867872
55,3305,3965,13104325,2,446,113,1,108033400,108033400,166,55,111,55,0,1,57,268751,0.268751
455,3305,3965,13104325,2,3646,913,1,131297400,131297400,1366,455,911,455,0,1,457,1266774,1.266774
855,3305,3965,13104325,2,6846,1713,1,154561400,154561400,2566,855,1711,855,0,1,857,2259817,2.259817
1255,3305,3965,13104325,2,10046,2513,1,177825400,177825400,3766,1255,2511,1255,0,1,1257,1200075,1.200075
1655,3305,3965,13104325,2,13246,3313,1,201089400,201089400,4966,1655,3311,1655,0,1,1657,1850941,1.850941
2055,3305,3965,13104325,2,16446,4113,1,224353400,224353400,6166,2055,4111,2055,0,1,2057,1671669,1.671669
2455,3305,3965,13104325,2,19646,4913,1,247617400,247617400,7366,2455,4911,2455,0,1,2457,1017537,1.017537
2855,3305,3965,13104325,2,22846,5713,1,270881400,270881400,8566,2855,5711,2855,0,1,2857,2254797,2.254797
3255,3305,3965,13104325,2,26046,6513,1,294145400,294145400,9766,3255,6511,3255,0,1,3257,1116854,1.116854
3655,3305,3965,13104325,2,29246,7313,1,317409400,317409400,10966,3655,7311,3655,0,1,3657,236539,0.236539
4055,3305,3965,13104325,2,32446,8113,1,340673400,340673400,12166,4055,8111,4055,0,1,4057,3366183,3.366183
4455,3305,3965,13104325,2,35646,8913,1,363937400,363937400,13366,4455,8911,4455,0,1,4457,1114640,1.11464
4855,3305,3965,13104325,2,38846,9713,1,387201400,387201400,14566,4855,9711,4855,0,1,4857,296965,0.296965
5255,3305,3965,13104325,2,42046,10513,1,410465400,410465400,15766,5255,10511,5255,0,1,5257,1883499,1.883499
5655,3305,3965,13104325,2,45246,11313,1,433729400,433729400,16966,5655,11311,5655,0,1,5657,1867150,1.86715
6055,3305,3965,13104325,2,48446,12113,1,456993400,456993400,18166,6055,12111,6055,0,1,6057,1785993,1.785993
6455,3305,3965,13104325,2,51646,12913,1,480257400,480257400,19366,6455,12911,6455,0,1,6457,761283,0.761283
6855,3305,3965,13104325,2,54846,13713,1,503521400,503521400,20566,6855,13711,6855,0,1,6857,3370634,3.370634
40,2550,5140,13107000,2,326,83,1,107316800,107316800,121,40,81,40,0,1,42,232007,0.232007
440,2550,5140,13107000,2,3526,883,1,131924800,131924800,1321,440,881,440,0,1,442,1177430,1.17743
840,2550,5140,13107000,2,6726,1683,1,156532800,156532800,2521,840,1681,840,0,1,842,517659,0.517659
1240,2550,5140,13107000,2,9926,2483,1,181140800,181140800,3721,1240,2481,1240,0,1,1242,859723,0.859723
1640,2550,5140,13107000,2,13126,3283,1,205748800,205748800,4921,1640,3281,1640,0,1,1642,4098866,4.098866
2040,2550,5140,13107000,2,16326,4083,1,230356800,230356800,6121,2040,4081,2040,0,1,2042,3825230,3.82523
2440,2550,5140,13107000,2,19526,4883,1,254964800,254964800,7321,2440,4881,2440,0,1,2442,164785,0.164785
2840,2550,5140,13107000,2,22726,5683,1,279572800,279572800,8521,2840,5681,2840,0,1,2842,541927,0.541927
3240,2550,5140,13107000,2,25926,6483,1,304180800,304180800,9721,3240,6481,3240,0,1,3242,6737422,6.737422
3640,2550,5140,13107000,2,29126,7283,1,328788800,328788800,10921,3640,7281,3640,0,1,3642,608354,0.608354
4040,2550,5140,13107000,2,32326,8083,1,353396800,353396800,12121,4040,8081,4040,0,1,4042,1365091,1.365091
4440,2550,5140,13107000,2,35526,8883,1,378004800,378004800,13321,4440,8881,4440,0,1,4442,2661751,2.661751
4840,2550,5140,13107000,2,38726,9683,1,402612800,402612800,14521,4840,9681,4840,0,1,4842,134488,0.134488
5240,2550,5140,13107000,2,41926,10483,1,427220800,427220800,15721,5240,10481,5240,0,1,5242,144326,0.144326
5640,2550,5140,13107000,2,45126,11283,1,451828800,451828800,16921,5640,11281,5640,0,1,5642,1661186,1.661186
6040,2550,5140,13107000,2,48326,12083,1,476436800,476436800,18121,6040,12081,6040,0,1,6042,824701,0.824701
6440,2550,5140,13107000,2,51526,12883,1,501044800,501044800,19321,6440,12881,6440,0,1,6442,518616,0.518616
6840,2550,5140,13107000,2,54726,13683,1,525652800,525652800,20521,6840,13681,6840,0,1,6842,1869194,1.869194
55,6055,2165,13109075,2,446,113,1,108489400,108489400,166,55,111,55,0,1,57,257731,0.257731
455,6055,2165,13109075,2,3646,913,1,134793400,134793400,1366,455,911,455,0,1,457,682524,0.682524
855,6055,2165,13109075,2,6846,1713,1,161097400,161097400,2566,855,1711,855,0,1,857,1445070,1.44507
1255,6055,2165,13109075,2,10046,2513,1,187401400,187401400,3766,1255,2511,1255,0,1,1257,1930892,1.930892
1655,6055,2165,13109075,2,13246,3313,1,213705400,213705400,4966,1655,3311,1655,0,1,1657,1121108,1.121108
2055,6055,2165,13109075,2,16446,4113,1,240009400,240009400,6166,2055,4111,2055,0,1,2057,201280,0.20128
2455,6055,2165,13109075,2,19646,4913,1,266313400,266313400,7366,2455,4911,2455,0,1,2457,4776212,4.776212
2855,6055,2165,13109075,2,22846,5713,1,292617400,292617400,8566,2855,5711,2855,0,1,2857,12939,0.012939
3255,6055,2165,13109075,2,26046,6513,1,318921400,318921400,9766,3255,6511,3255,0,1,3257,986890,0.98689
3655,6055,2165,13109075,2,29246,7313,1,345225400,345225400,10966,3655,7311,3655,0,1,3657,2806425,2.806425
4055,6055,2165,13109075,2,32446,8113,1,371529400,371529400,12166,4055,8111,4055,0,1,4057,2860134,2.860134
4455,6055,2165,13109075,2,35646,8913,1,397833400,397833400,13366,4455,8911,4455,0,1,4457,1258970,1.25897
4855,6055,2165,13109075,2,38846,9713,1,424137400,424137400,14566,4855,9711,4855,0,1,4857,1793020,1.79302
5255,6055,2165,13109075,2,42046,10513,1,450441400,450441400,15766,5255,10511,5255,0,1,5257,2673763,2.673763
5655,6055,2165,13109075,2,45246,11313,1,476745400,476745400,16966,5655,11311,5655,0,1,5657,3512154,3.512154
6055,6055,2165,13109075,2,48446,12113,1,503049400,503049400,18166,6055,12111,6055,0,1,6057,5046650,5.04665
6455,6055,2165,13109075,2,51646,12913,1,529353400,529353400,19366,6455,12911,6455,0,1,6457,1282855,1.282855
6855,6055,2165,13109075,2,54846,13713,1,555657400,555657400,20566,6855,13711,6855,0,1,6857,1155714,1.155714
40,4800,2740,13152000,2,326,83,1,107628800,107628800,121,40,81,40,0,1,42,234343,0.234343
440,4800,2740,13152000,2,3526,883,1,131756800,131756800,1321,440,881,440,0,1,442,1180053,1.180053
840,4800,2740,13152000,2,6726,1683,1,155884800,155884800,2521,840,1681,840,0,1,842,2135475,2.135475
1240,4800,2740,13152000,2,9926,2483,1,180012800,180012800,3721,1240,2481,1240,0,1,1242,3108762,3.108762
1640,4800,2740,13152000,2,13126,3283,1,204140800,204140800,4921,1640,3281,1640,0,1,1642,4075219,4.075219
2040,4800,2740,13152000,2,16326,4083,1,228268800,228268800,6121,2040,4081,2040,0,1,2042,4343116,4.343116
2440,4800,2740,13152000,2,19526,4883,1,252396800,252396800,7321,2440,4881,2440,0,1,2442,663697,0.663697
2840,4800,2740,13152000,2,22726,5683,1,276524800,276524800,8521,2840,5681,2840,0,1,2842,3534001,3.534001
3240,4800,2740,13152000,2,25926,6483,1,300652800,300652800,9721,3240,6481,3240,0,1,3242,3634769,3.634769
3640,4800,2740,13152000,2,29126,7283,1,324780800,324780800,10921,3640,7281,3640,0,1,3642,43920,0.04392
4040,4800,2740,13152000,2,32326,8083,1,348908800,348908800,12121,4040,8081,4040,0,1,4042,4044687,4.044687
4440,4800,2740,13152000,2,35526,8883,1,373036800,373036800,13321,4440,8881,4440,0,1,4442,1584605,1.584605
4840,4800,2740,13152000,2,38726,9683,1,397164800,397164800,14521,4840,9681,4840,0,1,4842,5195064,5.195064
5240,4800,2740,13152000,2,41926,10483,1,421292800,421292800,15721,5240,10481,5240,0,1,5242,6311045,6.311045
5640,4800,2740,13152000,2,45126,11283,1,445420800,445420800,16921,5640,11281,5640,0,1,5642,9807404,9.807404
6040,4800,2740,13152000,2,48326,12083,1,469548800,469548800,18121,6040,12081,6040,0,1,6042,10952540,10.95254
6440,4800,2740,13152000,2,51526,12883,1,493676800,493676800,19321,6440,12881,6440,0,1,6442,6034794,6.034794
6840,4800,2740,13152000,2,54726,13683,1,517804800,517804800,20521,6840,13681,6840,0,1,6842,4013055,4.013055
55,7055,1865,13157575,2,446,113,1,109185400,109185400,166,55,111,55,0,1,57,259929,0.259929
455,7055,1865,13157575,2,3646,913,1,137729400,137729400,1366,455,911,455,0,1,457,98934,0.098934
855,7055,1865,13157575,2,6846,1713,1,166273400,166273400,2566,855,1711,855,0,1,857,433784,0.433784
1255,7055,1865,13157575,2,10046,2513,1,194817400,194817400,3766,1255,2511,1255,0,1,1257,561209,0.561209
1655,7055,1865,13157575,2,13246,3313,1,223361400,223361400,4966,1655,3311,1655,0,1,1657,4302133,4.302133
2055,7055,1865,13157575,2,16446,4113,1,251905400,251905400,6166,2055,4111,2055,0,1,2057,2581046,2.581046
2455,7055,1865,13157575,2,19646,4913,1,280449400,280449400,7366,2455,4911,2455,0,1,2457,4536613,4.536613
2855,7055,1865,13157575,2,22846,5713,1,308993400,308993400,8566,2855,5711,2855,0,1,2857,3725696,3.725696
3255,7055,1865,13157575,2,26046,6513,1,337537400,337537400,9766,3255,6511,3255,0,1,3257,5007379,5.007379
3655,7055,1865,13157575,2,29246,7313,1,366081400,366081400,10966,3655,7311,3655,0,1,3657,52279,0.052279
4055,7055,1865,13157575,2,32446,8113,1,394625400,394625400,12166,4055,8111,4055,0,1,4057,9558965,9.558965
4455,7055,1865,13157575,2,35646,8913,1,423169400,423169400,13366,4455,8911,4455,0,1,4457,6106440,6.10644
4855,7055,1865,13157575,2,38846,9713,1,451713400,451713400,14566,4855,9711,4855,0,1,4857,4666842,4.666842
5255,7055,1865,13157575,2,42046,10513,1,480257400,480257400,15766,5255,10511,5255,0,1,5257,13565813,13.565813
5655,7055,1865,13157575,2,45246,11313,1,508801400,508801400,16966,5655,11311,5655,0,1,5657,14545222,14.545222
6055,7055,1865,13157575,2,48446,12113,1,537345400,537345400,18166,6055,12111,6055,0,1,6057,15647646,15.647646
6455,7055,1865,13157575,2,51646,12913,1,565889400,565889400,19366,6455,12911,6455,0,1,6457,16730994,16.730994
6855,7055,1865,13157575,2,54846,13713,1,594433400,594433400,20566,6855,13711,6855,0,1,6857,17770543,17.770543
55,4305,3065,13194825,2,446,113,1,108801400,108801400,166,55,111,55,0,1,57,263356,0.263356
455,4305,3065,13194825,2,3646,913,1,132385400,132385400,1366,455,911,455,0,1,457,1221215,1.221215
855,4305,3065,13194825,2,6846,1713,1,155969400,155969400,2566,855,1711,855,0,1,857,113794,0.113794
1255,4305,3065,13194825,2,10046,2513,1,179553400,179553400,3766,1255,2511,1255,0,1,1257,633905,0.633905
1655,4305,3065,13194825,2,13246,3313,1,203137400,203137400,4966,1655,3311,1655,0,1,1657,757882,0.757882
2055,4305,3065,13194825,2,16446,4113,1,226721400,226721400,6166,2055,4111,2055,0,1,2057,85986,0.085986
2455,4305,3065,13194825,2,19646,4913,1,250305400,250305400,7366,2455,4911,2455,0,1,2457,2184348,2.184348
2855,4305,3065,13194825,2,22846,5713,1,273889400,273889400,8566,2855,5711,2855,0,1,2857,351793,0.351793
3255,4305,3065,13194825,2,26046,6513,1,297473400,297473400,9766,3255,6511,3255,0,1,3257,2787007,2.787007
3655,4305,3065,13194825,2,29246,7313,1,321057400,321057400,10966,3655,7311,3655,0,1,3657,1785140,1.78514
4055,4305,3065,13194825,2,32446,8113,1,344641400,344641400,12166,4055,8111,4055,0,1,4057,817730,0.81773
4455,4305,3065,13194825,2,35646,8913,1,368225400,368225400,13366,4455,8911,4455,0,1,4457,4999487,4.999487
4855,4305,3065,13194825,2,38846,9713,1,391809400,391809400,14566,4855,9711,4855,0,1,4857,1553353,1.553353
5255,4305,3065,13194825,2,42046,10513,1,415393400,415393400,15766,5255,10511,5255,0,1,5257,359081,0.359081
5655,4305,3065,13194825,2,45246,11313,1,438977400,438977400,16966,5655,11311,5655,0,1,5657,2119785,2.119785
6055,4305,3065,13194825,2,48446,12113,1,462561400,462561400,18166,6055,12111,6055,0,1,6057,420345,0.420345
6455,4305,3065,13194825,2,51646,12913,1,486145400,486145400,19366,6455,12911,6455,0,1,6457,1109394,1.109394
6855,4305,3065,13194825,2,54846,13713,1,509729400,509729400,20566,6855,13711,6855,0,1,6857,2149542,2.149542
55,2555,5165,13196575,2,446,113,1,108969400,108969400,166,55,111,55,0,1,57,190250,0.19025
455,2555,5165,13196575,2,3646,913,1,133673400,133673400,1366,455,911,455,0,1,457,635041,0.635041
855,2555,5165,13196575,2,6846,1713,1,158377400,158377400,2566,855,1711,855,0,1,857,115455,0.115455
1255,2555,5165,13196575,2,10046,2513,1,183081400,183081400,3766,1255,2511,1255,0,1,1257,1012179,1.012179
1655,2555,5165,13196575,2,13246,3313,1,207785400,207785400,4966,1655,3311,1655,0,1,1657,2597438,2.597438
2055,2555,5165,13196575,2,16446,4113,1,232489400,232489400,6166,2055,4111,2055,0,1,2057,840505,0.840505
2455,2555,5165,13196575,2,19646,4913,1,257193400,257193400,7366,2455,4911,2455,0,1,2457,113308,0.113308
2855,2555,5165,13196575,2,22846,5713,1,281897400,281897400,8566,2855,5711,2855,0,1,2857,3276030,3.27603
3255,2555,5165,13196575,2,26046,6513,1,306601400,306601400,9766,3255,6511,3255,0,1,3257,1822089,1.822089
3655,2555,5165,13196575,2,29246,7313,1,331305400,331305400,10966,3655,7311,3655,0,1,3657,940047,0.940047
4055,2555,5165,13196575,2,32446,8113,1,356009400,356009400,12166,4055,8111,4055,0,1,4057,24787,0.024787
4455,2555,5165,13196575,2,35646,8913,1,380713400,380713400,13366,4455,8911,4455,0,1,4457,384148,0.384148
4855,2555,5165,13196575,2,38846,9713,1,405417400,405417400,14566,4855,9711,4855,0,1,4857,171772,0.171772
5255,2555,5165,13196575,2,42046,10513,1,430121400,430121400,15766,5255,10511,5255,0,1,5257,3491393,3.491393
5655,2555,5165,13196575,2,45246,11313,1,454825400,454825400,16966,5655,11311,5655,0,1,5657,109637,0.109637
6055,2555,5165,13196575,2,48446,12113,1,479529400,479529400,18166,6055,12111,6055,0,1,6057,1988254,1.988254
6455,2555,5165,13196575,2,51646,12913,1,504233400,504233400,19366,6455,12911,6455,0,1,6457,858693,0.858693
6855,2555,5165,13196575,2,54846,13713,1,528937400,528937400,20566,6855,13711,6855,0,1,6857,1518692,1.518692
40,2300,5740,13202000,2,326,83,1,108188800,108188800,121,40,81,40,0,1,42,243763,0.243763
440,2300,5740,13202000,2,3526,883,1,133916800,133916800,1321,440,881,440,0,1,442,156214,0.156214
840,2300,5740,13202000,2,6726,1683,1,159644800,159644800,2521,840,1681,840,0,1,842,939245,0.939245
1240,2300,5740,13202000,2,9926,2483,1,185372800,185372800,3721,1240,2481,1240,0,1,1242,95146,0.095146
1640,2300,5740,13202000,2,13126,3283,1,211100800,211100800,4921,1640,3281,1640,0,1,1642,3024168,3.024168
2040,2300,5740,13202000,2,16326,4083,1,236828800,236828800,6121,2040,4081,2040,0,1,2042,1162590,1.16259
2440,2300,5740,13202000,2,19526,4883,1,262556800,262556800,7321,2440,4881,2440,0,1,2442,4696998,4.696998
2840,2300,5740,13202000,2,22726,5683,1,288284800,288284800,8521,2840,5681,2840,0,1,2842,26373,0.026373
3240,2300,5740,13202000,2,25926,6483,1,314012800,314012800,9721,3240,6481,3240,0,1,3242,2864677,2.864677
3640,2300,5740,13202000,2,29126,7283,1,339740800,339740800,10921,3640,7281,3640,0,1,3642,2339848,2.339848
4040,2300,5740,13202000,2,32326,8083,1,365468800,365468800,12121,4040,8081,4040,0,1,4042,1453987,1.453987
4440,2300,5740,13202000,2,35526,8883,1,391196800,391196800,13321,4440,8881,4440,0,1,4442,3672814,3.672814
4840,2300,5740,13202000,2,38726,9683,1,416924800,416924800,14521,4840,9681,4840,0,1,4842,2048417,2.048417
5240,2300,5740,13202000,2,41926,10483,1,442652800,442652800,15721,5240,10481,5240,0,1,5242,611833,0.611833
5640,2300,5740,13202000,2,45126,11283,1,468380800,468380800,16921,5640,11281,5640,0,1,5642,929182,0.929182
6040,2300,5740,13202000,2,48326,12083,1,494108800,494108800,18121,6040,12081,6040,0,1,6042,1754463,1.754463
6440,2300,5740,13202000,2,51526,12883,1,519836800,519836800,19321,6440,12881,6440,0,1,6442,1809985,1.809985
6840,2300,5740,13202000,2,54726,13683,1,545564800,545564800,20521,6840,13681,6840,0,1,6842,2613866,2.613866
55,4805,2765,13285825,2,446,113,1,109617400,109617400,166,55,111,55,0,1,57,265294,0.265294
455,4805,2765,13285825,2,3646,913,1,133841400,133841400,1366,455,911,455,0,1,457,1226664,1.226664
855,4805,2765,13285825,2,6846,1713,1,158065400,158065400,2566,855,1711,855,0,1,857,1055380,1.05538
1255,4805,2765,13285825,2,10046,2513,1,182289400,182289400,3766,1255,2511,1255,0,1,1257,1266650,1.26665
1655,4805,2765,13285825,2,13246,3313,1,206513400,206513400,4966,1655,3311,1655,0,1,1657,4184396,4.184396
2055,4805,2765,13285825,2,16446,4113,1,230737400,230737400,6166,2055,4111,2055,0,1,2057,2184990,2.18499
2455,4805,2765,13285825,2,19646,4913,1,254961400,254961400,7366,2455,4911,2455,0,1,2457,4216542,4.216542
2855,4805,2765,13285825,2,22846,5713,1,279185400,279185400,8566,2855,5711,2855,0,1,2857,4214023,4.214023
3255,4805,2765,13285825,2,26046,6513,1,303409400,303409400,9766,3255,6511,3255,0,1,3257,3829560,3.82956
3655,4805,2765,13285825,2,29246,7313,1,327633400,327633400,10966,3655,7311,3655,0,1,3657,1622539,1.622539
4055,4805,2765,13285825,2,32446,8113,1,351857400,351857400,12166,4055,8111,4055,0,1,4057,9031876,9.031876
4455,4805,2765,13285825,2,35646,8913,1,376081400,376081400,13366,4455,8911,4455,0,1,4457,1135021,1.135021
4855,4805,2765,13285825,2,38846,9713,1,400305400,400305400,14566,4855,9711,4855,0,1,4857,6088142,6.088142
5255,4805,2765,13285825,2,42046,10513,1,424529400,424529400,15766,5255,10511,5255,0,1,5257,10569458,10.569458
5655,4805,2765,13285825,2,45246,11313,1,448753400,448753400,16966,5655,11311,5655,0,1,5657,521784,0.521784
6055,4805,2765,13285825,2,48446,12113,1,472977400,472977400,18166,6055,12111,6055,0,1,6057,4137973,4.137973
6455,4805,2765,13285825,2,51646,12913,1,497201400,497201400,19366,6455,12911,6455,0,1,6457,2323657,2.323657
6855,4805,2765,13285825,2,54846,13713,1,521425400,521425400,20566,6855,13711,6855,0,1,6857,17044155,17.044155
55,2305,5765,13288325,2,446,113,1,109857400,109857400,166,55,111,55,0,1,57,269964,0.269964
455,2305,5765,13288325,2,3646,913,1,135681400,135681400,1366,455,911,455,0,1,457,690780,0.69078
855,2305,5765,13288325,2,6846,1713,1,161505400,161505400,2566,855,1711,855,0,1,857,831866,0.831866
1255,2305,5765,13288325,2,10046,2513,1,187329400,187329400,3766,1255,2511,1255,0,1,1257,1566640,1.56664
1655,2305,5765,13288325,2,13246,3313,1,213153400,213153400,4966,1655,3311,1655,0,1,1657,1087103,1.087103
2055,2305,5765,13288325,2,16446,4113,1,238977400,238977400,6166,2055,4111,2055,0,1,2057,17229,0.017229
2455,2305,5765,13288325,2,19646,4913,1,264801400,264801400,7366,2455,4911,2455,0,1,2457,333356,0.333356
2855,2305,5765,13288325,2,22846,5713,1,290625400,290625400,8566,2855,5711,2855,0,1,2857,888867,0.888867
3255,2305,5765,13288325,2,26046,6513,1,316449400,316449400,9766,3255,6511,3255,0,1,3257,1241068,1.241068
3655,2305,5765,13288325,2,29246,7313,1,342273400,342273400,10966,3655,7311,3655,0,1,3657,283397,0.283397
4055,2305,5765,13288325,2,32446,8113,1,368097400,368097400,12166,4055,8111,4055,0,1,4057,1096531,1.096531
4455,2305,5765,13288325,2,35646,8913,1,393921400,393921400,13366,4455,8911,4455,0,1,4457,807813,0.807813
4855,2305,5765,13288325,2,38846,9713,1,419745400,419745400,14566,4855,9711,4855,0,1,4857,68901,0.068901
5255,2305,5765,13288325,2,42046,10513,1,445569400,445569400,15766,5255,10511,5255,0,1,5257,928933,0.928933
5655,2305,5765,13288325,2,45246,11313,1,471393400,471393400,16966,5655,11311,5655,0,1,5657,4241424,4.241424
6055,2305,5765,13288325,2,48446,12113,1,497217400,497217400,18166,6055,12111,6055,0,1,6057,3922299,3.922299
6455,2305,5765,13288325,2,51646,12913,1,523041400,523041400,19366,6455,12911,6455,0,1,6457,2273847,2.273847
6855,2305,5765,13288325,2,54846,13713,1,548865400,548865400,20566,6855,13711,6855,0,1,6857,328267,0.328267
35,4400,3045,13398000,2,286,73,1,109268600,109268600,106,35,71,35,0,1,37,38441,0.038441
535,4400,3045,13398000,2,4286,1073,1,139048600,139048600,1606,535,1071,535,0,1,537,168752,0.168752
1035,4400,3045,13398000,2,8286,2073,1,168828600,168828600,3106,1035,2071,1035,0,1,1037,385289,0.385289
1535,4400,3045,13398000,2,12286,3073,1,198608600,198608600,4606,1535,3071,1535,0,1,1537,68948,0.068948
2035,4400,3045,13398000,2,16286,4073,1,228388600,228388600,6106,2035,4071,2035,0,1,2037,5236133,5.236133
2535,4400,3045,13398000,2,20286,5073,1,258168600,258168600,7606,2535,5071,2535,0,1,2537,230816,0.230816
3035,4400,3045,13398000,2,24286,6073,1,287948600,287948600,9106,3035,6071,3035,0,1,3037,2137287,2.137287
3535,4400,3045,13398000,2,28286,7073,1,317728600,317728600,10606,3535,7071,3535,0,1,3537,29692,0.029692
4035,4400,3045,13398000,2,32286,8073,1,347508600,347508600,12106,4035,8071,4035,0,1,4037,7941331,7.941331
4535,4400,3045,13398000,2,36286,9073,1,377288600,377288600,13606,4535,9071,4535,0,1,4537,11610831,11.610831
5035,4400,3045,13398000,2,40286,10073,1,407068600,407068600,15106,5035,10071,5035,0,1,5037,3317326,3.317326
5535,4400,3045,13398000,2,44286,11073,1,436848600,436848600,16606,5535,11071,5535,0,1,5537,167954,0.167954
6035,4400,3045,13398000,2,48286,12073,1,466628600,466628600,18106,6035,12071,6035,0,1,6037,363288,0.363288
6535,4400,3045,13398000,2,52286,13073,1,496408600,496408600,19606,6535,13071,6535,0,1,6537,592189,0.592189
7035,4400,3045,13398000,2,56286,14073,1,526188600,526188600,21106,7035,14071,7035,0,1,7037,3864110,3.86411
40,6300,2140,13482000,2,326,83,1,110556800,110556800,121,40,81,40,0,1,42,249498,0.249498
440,6300,2140,13482000,2,3526,883,1,137564800,137564800,1321,440,881,440,0,1,442,189081,0.189081
840,6300,2140,13482000,2,6726,1683,1,164572800,164572800,2521,840,1681,840,0,1,842,2207823,2.207823
1240,6300,2140,13482000,2,9926,2483,1,191580800,191580800,3721,1240,2481,1240,0,1,1242,3214809,3.214809
1640,6300,2140,13482000,2,13126,3283,1,218588800,218588800,4921,1640,3281,1640,0,1,1642,4227695,4.227695
2040,6300,2140,13482000,2,16326,4083,1,245596800,245596800,6121,2040,4081,2040,0,1,2042,4197375,4.197375
2440,6300,2140,13482000,2,19526,4883,1,272604800,272604800,7321,2440,4881,2440,0,1,2442,70415,0.070415
2840,6300,2140,13482000,2,22726,5683,1,299612800,299612800,8521,2840,5681,2840,0,1,2842,3036582,3.036582
3240,6300,2140,13482000,2,25926,6483,1,326620800,326620800,9721,3240,6481,3240,0,1,3242,3778256,3.778256
3640,6300,2140,13482000,2,29126,7283,1,353628800,353628800,10921,3640,7281,3640,0,1,3642,1205540,1.20554
4040,6300,2140,13482000,2,32326,8083,1,380636800,380636800,12121,4040,8081,4040,0,1,4042,9236847,9.236847
4440,6300,2140,13482000,2,35526,8883,1,407644800,407644800,13321,4440,8881,4440,0,1,4442,12273,0.012273
4840,6300,2140,13482000,2,38726,9683,1,434652800,434652800,14521,4840,9681,4840,0,1,4842,562905,0.562905
5240,6300,2140,13482000,2,41926,10483,1,461660800,461660800,15721,5240,10481,5240,0,1,5242,3967701,3.967701
5640,6300,2140,13482000,2,45126,11283,1,488668800,488668800,16921,5640,11281,5640,0,1,5642,7476140,7.47614
6040,6300,2140,13482000,2,48326,12083,1,515676800,515676800,18121,6040,12081,6040,0,1,6042,4788398,4.788398
6440,6300,2140,13482000,2,51526,12883,1,542684800,542684800,19321,6440,12881,6440,0,1,6442,13593601,13.593601
6840,6300,2140,13482000,2,54726,13683,1,569692800,569692800,20521,6840,13681,6840,0,1,6842,9657875,9.657875
35,6600,2045,13497000,2,286,73,1,110396600,110396600,106,35,71,35,0,1,37,80056,0.080056
535,6600,2045,13497000,2,4286,1073,1,144976600,144976600,1606,535,1071,535,0,1,537,230719,0.230719
1035,6600,2045,13497000,2,8286,2073,1,179556600,179556600,3106,1035,2071,1035,0,1,1037,725846,0.725846
1535,6600,2045,13497000,2,12286,3073,1,214136600,214136600,4606,1535,3071,1535,0,1,1537,1043000,1.043
2035,6600,2045,13497000,2,16286,4073,1,248716600,248716600,6106,2035,4071,2035,0,1,2037,1069827,1.069827
2535,6600,2045,13497000,2,20286,5073,1,283296600,283296600,7606,2535,5071,2535,0,1,2537,2155612,2.155612
3035,6600,2045,13497000,2,24286,6073,1,317876600,317876600,9106,3035,6071,3035,0,1,3037,1078723,1.078723
3535,6600,2045,13497000,2,28286,7073,1,352456600,352456600,10606,3535,7071,3535,0,1,3537,404437,0.404437
4035,6600,2045,13497000,2,32286,8073,1,387036600,387036600,12106,4035,8071,4035,0,1,4037,5280650,5.28065
4535,6600,2045,13497000,2,36286,9073,1,421616600,421616600,13606,4535,9071,4535,0,1,4537,1591759,1.591759
5035,6600,2045,13497000,2,40286,10073,1,456196600,456196600,15106,5035,10071,5035,0,1,5037,3112385,3.112385
5535,6600,2045,13497000,2,44286,11073,1,490776600,490776600,16606,5535,11071,5535,0,1,5537,297876,0.297876
6035,6600,2045,13497000,2,48286,12073,1,525356600,525356600,18106,6035,12071,6035,0,1,6037,533130,0.53313
6535,6600,2045,13497000,2,52286,13073,1,559936600,559936600,19606,6535,13071,6535,0,1,6537,3653386,3.653386
7035,6600,2045,13497000,2,56286,14073,1,594516600,594516600,21106,7035,14071,7035,0,1,7037,15394831,15.394831
39,3343,4041,13509063,2,318,81,1,110376312,110376312,118,39,79,39,0,1,41,11151,0.011151
539,3343,4041,13509063,2,4318,1081,1,139912312,139912312,1618,539,1079,539,0,1,541,113306,0.113306
1039,3343,4041,13509063,2,8318,2081,1,169448312,169448312,3118,1039,2079,1039,0,1,1041,303068,0.303068
1539,3343,4041,13509063,2,12318,3081,1,198984312,198984312,4618,1539,3079,1539,0,1,1541,502566,0.502566
2039,3343,4041,13509063,2,16318,4081,1,228520312,228520312,6118,2039,4079,2039,0,1,2041,373666,0.373666
2539,3343,4041,13509063,2,20318,5081,1,258056312,258056312,7618,2539,5079,2539,0,1,2541,990545,0.990545
3039,3343,4041,13509063,2,24318,6081,1,287592312,287592312,9118,3039,6079,3039,0,1,3041,1038494,1.038494
3539,3343,4041,13509063,2,28318,7081,1,317128312,317128312,10618,3539,7079,3539,0,1,3541,288797,0.288797
4039,3343,4041,13509063,2,32318,8081,1,346664312,346664312,12118,4039,8079,4039,0,1,4041,1071246,1.071246
4539,3343,4041,13509063,2,36318,9081,1,376200312,376200312,13618,4539,9079,4539,0,1,4541,68060,0.06806
5039,3343,4041,13509063,2,40318,10081,1,405736312,405736312,15118,5039,10079,5039,0,1,5041,721564,0.721564
5539,3343,4041,13509063,2,44318,11081,1,435272312,435272312,16618,5539,11079,5539,0,1,5541,3686570,3.68657
6039,3343,4041,13509063,2,48318,12081,1,464808312,464808312,18118,6039,12079,6039,0,1,6041,2525438,2.525438
6539,3343,4041,13509063,2,52318,13081,1,494344312,494344312,19618,6539,13079,6539,0,1,6541,1500377,1.500377
7039,3343,4041,13509063,2,56318,14081,1,523880312,523880312,21118,7039,14079,7039,0,1,7041,311826,0.311826
35,3340,4045,13510300,2,286,73,1,110150200,110150200,106,35,71,35,0,1,37,242641,0.242641
535,3340,4045,13510300,2,4286,1073,1,139690200,139690200,1606,535,1071,535,0,1,537,1445443,1.445443
1035,3340,4045,13510300,2,8286,2073,1,169230200,169230200,3106,1035,2071,1035,0,1,1037,2716892,2.716892
1535,3340,4045,13510300,2,12286,3073,1,198770200,198770200,4606,1535,3071,1535,0,1,1537,3970212,3.970212
2035,3340,4045,13510300,2,16286,4073,1,228310200,228310200,6106,2035,4071,2035,0,1,2037,5230716,5.230716
39,4443,3041,13511163,2,318,81,1,110424312,110424312,118,39,79,39,0,1,41,10198,0.010198
539,4443,3041,13511163,2,4318,1081,1,140360312,140360312,1618,539,1079,539,0,1,541,87271,0.087271
1039,4443,3041,13511163,2,8318,2081,1,170296312,170296312,3118,1039,2079,1039,0,1,1041,14858,0.014858
1539,4443,3041,13511163,2,12318,3081,1,200232312,200232312,4618,1539,3079,1539,0,1,1541,312727,0.312727
2039,4443,3041,13511163,2,16318,4081,1,230168312,230168312,6118,2039,4079,2039,0,1,2041,855833,0.855833
2539,4443,3041,13511163,2,20318,5081,1,260104312,260104312,7618,2539,5079,2539,0,1,2541,993459,0.993459
3039,4443,3041,13511163,2,24318,6081,1,290040312,290040312,9118,3039,6079,3039,0,1,3041,1781734,1.781734
3539,4443,3041,13511163,2,28318,7081,1,319976312,319976312,10618,3539,7079,3539,0,1,3541,731618,0.731618
4039,4443,3041,13511163,2,32318,8081,1,349912312,349912312,12118,4039,8079,4039,0,1,4041,1410216,1.410216
4539,4443,3041,13511163,2,36318,9081,1,379848312,379848312,13618,4539,9079,4539,0,1,4541,233590,0.23359
5039,4443,3041,13511163,2,40318,10081,1,409784312,409784312,15118,5039,10079,5039,0,1,5041,1912152,1.912152
5539,4443,3041,13511163,2,44318,11081,1,439720312,439720312,16618,5539,11079,5539,0,1,5541,911293,0.911293
6039,4443,3041,13511163,2,48318,12081,1,469656312,469656312,18118,6039,12079,6039,0,1,6041,2747444,2.747444
6539,4443,3041,13511163,2,52318,13081,1,499592312,499592312,19618,6539,13079,6539,0,1,6541,872361,0.872361
7039,4443,3041,13511163,2,56318,14081,1,529528312,529528312,21118,7039,14079,7039,0,1,7041,544454,0.544454
35,4440,3045,13519800,2,286,73,1,110254200,110254200,106,35,71,35,0,1,37,246964,0.246964
535,4440,3045,13519800,2,4286,1073,1,140194200,140194200,1606,535,1071,535,0,1,537,1445395,1.445395
1035,4440,3045,13519800,2,8286,2073,1,170134200,170134200,3106,1035,2071,1035,0,1,1037,2679896,2.679896
1535,4440,3045,13519800,2,12286,3073,1,200074200,200074200,4606,1535,3071,1535,0,1,1537,3969340,3.96934
2035,4440,3045,13519800,2,16286,4073,1,230014200,230014200,6106,2035,4071,2035,0,1,2037,5254648,5.254648
40,4050,3340,13527000,2,326,83,1,110580800,110580800,121,40,81,40,0,1,42,43726,0.043726
440,4050,3340,13527000,2,3526,883,1,134228800,134228800,1321,440,881,440,0,1,442,13763,0.013763
840,4050,3340,13527000,2,6726,1683,1,157876800,157876800,2521,840,1681,840,0,1,842,143544,0.143544
1240,4050,3340,13527000,2,9926,2483,1,181524800,181524800,3721,1240,2481,1240,0,1,1242,14101,0.014101
1640,4050,3340,13527000,2,13126,3283,1,205172800,205172800,4921,1640,3281,1640,0,1,1642,1176057,1.176057
2040,4050,3340,13527000,2,16326,4083,1,228820800,228820800,6121,2040,4081,2040,0,1,2042,31706,0.031706
2440,4050,3340,13527000,2,19526,4883,1,252468800,252468800,7321,2440,4881,2440,0,1,2442,173298,0.173298
2840,4050,3340,13527000,2,22726,5683,1,276116800,276116800,8521,2840,5681,2840,0,1,2842,663145,0.663145
3240,4050,3340,13527000,2,25926,6483,1,299764800,299764800,9721,3240,6481,3240,0,1,3242,2204762,2.204762
3640,4050,3340,13527000,2,29126,7283,1,323412800,323412800,10921,3640,7281,3640,0,1,3642,395899,0.395899
4040,4050,3340,13527000,2,32326,8083,1,347060800,347060800,12121,4040,8081,4040,0,1,4042,204680,0.20468
4440,4050,3340,13527000,2,35526,8883,1,370708800,370708800,13321,4440,8881,4440,0,1,4442,23703,0.023703
4840,4050,3340,13527000,2,38726,9683,1,394356800,394356800,14521,4840,9681,4840,0,1,4842,4271926,4.271926
5240,4050,3340,13527000,2,41926,10483,1,418004800,418004800,15721,5240,10481,5240,0,1,5242,2388970,2.38897
5640,4050,3340,13527000,2,45126,11283,1,441652800,441652800,16921,5640,11281,5640,0,1,5642,681402,0.681402
6040,4050,3340,13527000,2,48326,12083,1,465300800,465300800,18121,6040,12081,6040,0,1,6042,3004032,3.004032
6440,4050,3340,13527000,2,51526,12883,1,488948800,488948800,19321,6440,12881,6440,0,1,6442,1925245,1.925245
6840,4050,3340,13527000,2,54726,13683,1,512596800,512596800,20521,6840,13681,6840,0,1,6842,2966026,2.966026
35,2240,6045,13540800,2,286,73,1,110646200,110646200,106,35,71,35,0,1,37,242449,0.242449
535,2240,6045,13540800,2,4286,1073,1,143786200,143786200,1606,535,1071,535,0,1,537,1450785,1.450785
1035,2240,6045,13540800,2,8286,2073,1,176926200,176926200,3106,1035,2071,1035,0,1,1037,2712515,2.712515
1535,2240,6045,13540800,2,12286,3073,1,210066200,210066200,4606,1535,3071,1535,0,1,1537,3978470,3.97847
2035,2240,6045,13540800,2,16286,4073,1,243206200,243206200,6106,2035,4071,2035,0,1,2037,5245387,5.245387
2535,2240,6045,13540800,2,20286,5073,1,276346200,276346200,7606,2535,5071,2535,0,1,2537,6504638,6.504638
40,5550,2440,13542000,2,326,83,1,110892800,110892800,121,40,81,40,0,1,42,246206,0.246206
440,5550,2440,13542000,2,3526,883,1,136460800,136460800,1321,440,881,440,0,1,442,1255981,1.255981
840,5550,2440,13542000,2,6726,1683,1,162028800,162028800,2521,840,1681,840,0,1,842,1097540,1.09754
1240,5550,2440,13542000,2,9926,2483,1,187596800,187596800,3721,1240,2481,1240,0,1,1242,651338,0.651338
1640,5550,2440,13542000,2,13126,3283,1,213164800,213164800,4921,1640,3281,1640,0,1,1642,123259,0.123259
2040,5550,2440,13542000,2,16326,4083,1,238732800,238732800,6121,2040,4081,2040,0,1,2042,2067405,2.067405
2440,5550,2440,13542000,2,19526,4883,1,264300800,264300800,7321,2440,4881,2440,0,1,2442,6390887,6.390887
2840,5550,2440,13542000,2,22726,5683,1,289868800,289868800,8521,2840,5681,2840,0,1,2842,2352013,2.352013
3240,5550,2440,13542000,2,25926,6483,1,315436800,315436800,9721,3240,6481,3240,0,1,3242,167367,0.167367
3640,5550,2440,13542000,2,29126,7283,1,341004800,341004800,10921,3640,7281,3640,0,1,3642,8853110,8.85311
4040,5550,2440,13542000,2,32326,8083,1,366572800,366572800,12121,4040,8081,4040,0,1,4042,8275390,8.27539
4440,5550,2440,13542000,2,35526,8883,1,392140800,392140800,13321,4440,8881,4440,0,1,4442,1265572,1.265572
4840,5550,2440,13542000,2,38726,9683,1,417708800,417708800,14521,4840,9681,4840,0,1,4842,2229909,2.229909
5240,5550,2440,13542000,2,41926,10483,1,443276800,443276800,15721,5240,10481,5240,0,1,5242,548981,0.548981
5640,5550,2440,13542000,2,45126,11283,1,468844800,468844800,16921,5640,11281,5640,0,1,5642,451214,0.451214
6040,5550,2440,13542000,2,48326,12083,1,494412800,494412800,18121,6040,12081,6040,0,1,6042,776926,0.776926
6440,5550,2440,13542000,2,51526,12883,1,519980800,519980800,19321,6440,12881,6440,0,1,6442,7168239,7.168239
6840,5550,2440,13542000,2,54726,13683,1,545548800,545548800,20521,6840,13681,6840,0,1,6842,11741991,11.741991
39,2243,6041,13549963,2,318,81,1,110984312,110984312,118,39,79,39,0,1,41,62189,0.062189
539,2243,6041,13549963,2,4318,1081,1,144120312,144120312,1618,539,1079,539,0,1,541,46609,0.046609
1039,2243,6041,13549963,2,8318,2081,1,177256312,177256312,3118,1039,2079,1039,0,1,1041,11485,0.011485
1539,2243,6041,13549963,2,12318,3081,1,210392312,210392312,4618,1539,3079,1539,0,1,1541,141151,0.141151
2039,2243,6041,13549963,2,16318,4081,1,243528312,243528312,6118,2039,4079,2039,0,1,2041,342223,0.342223
2539,2243,6041,13549963,2,20318,5081,1,276664312,276664312,7618,2539,5079,2539,0,1,2541,738818,0.738818
3039,2243,6041,13549963,2,24318,6081,1,309800312,309800312,9118,3039,6079,3039,0,1,3041,268039,0.268039
3539,2243,6041,13549963,2,28318,7081,1,342936312,342936312,10618,3539,7079,3539,0,1,3541,26600,0.0266
4039,2243,6041,13549963,2,32318,8081,1,376072312,376072312,12118,4039,8079,4039,0,1,4041,842625,0.842625
4539,2243,6041,13549963,2,36318,9081,1,409208312,409208312,13618,4539,9079,4539,0,1,4541,999201,0.999201
5039,2243,6041,13549963,2,40318,10081,1,442344312,442344312,15118,5039,10079,5039,0,1,5041,590241,0.590241
5539,2243,6041,13549963,2,44318,11081,1,475480312,475480312,16618,5539,11079,5539,0,1,5541,311043,0.311043
6039,2243,6041,13549963,2,48318,12081,1,508616312,508616312,18118,6039,12079,6039,0,1,6041,858050,0.85805
6539,2243,6041,13549963,2,52318,13081,1,541752312,541752312,19618,6539,13079,6539,0,1,6541,2335126,2.335126
7039,2243,6041,13549963,2,56318,14081,1,574888312,574888312,21118,7039,14079,7039,0,1,7041,150689,0.150689
40,2800,4840,13552000,2,326,83,1,110860800,110860800,121,40,81,40,0,1,42,239679,0.239679
440,2800,4840,13552000,2,3526,883,1,135308800,135308800,1321,440,881,440,0,1,442,830106,0.830106
840,2800,4840,13552000,2,6726,1683,1,159756800,159756800,2521,840,1681,840,0,1,842,504646,0.504646
1240,2800,4840,13552000,2,9926,2483,1,184204800,184204800,3721,1240,2481,1240,0,1,1242,775546,0.775546
1640,2800,4840,13552000,2,13126,3283,1,208652800,208652800,4921,1640,3281,1640,0,1,1642,4193811,4.193811
2040,2800,4840,13552000,2,16326,4083,1,233100800,233100800,6121,2040,4081,2040,0,1,2042,658508,0.658508
2440,2800,4840,13552000,2,19526,4883,1,257548800,257548800,7321,2440,4881,2440,0,1,2442,3494521,3.494521
2840,2800,4840,13552000,2,22726,5683,1,281996800,281996800,8521,2840,5681,2840,0,1,2842,1555703,1.555703
3240,2800,4840,13552000,2,25926,6483,1,306444800,306444800,9721,3240,6481,3240,0,1,3242,8217907,8.217907
3640,2800,4840,13552000,2,29126,7283,1,330892800,330892800,10921,3640,7281,3640,0,1,3642,4924879,4.924879
4040,2800,4840,13552000,2,32326,8083,1,355340800,355340800,12121,4040,8081,4040,0,1,4042,364569,0.364569
4440,2800,4840,13552000,2,35526,8883,1,379788800,379788800,13321,4440,8881,4440,0,1,4442,4118564,4.118564
4840,2800,4840,13552000,2,38726,9683,1,404236800,404236800,14521,4840,9681,4840,0,1,4842,3342089,3.342089
5240,2800,4840,13552000,2,41926,10483,1,428684800,428684800,15721,5240,10481,5240,0,1,5242,1044657,1.044657
5640,2800,4840,13552000,2,45126,11283,1,453132800,453132800,16921,5640,11281,5640,0,1,5642,1016800,1.0168
6040,2800,4840,13552000,2,48326,12083,1,477580800,477580800,18121,6040,12081,6040,0,1,6042,5867419,5.867419
6440,2800,4840,13552000,2,51526,12883,1,502028800,502028800,19321,6440,12881,6440,0,1,6442,210225,0.210225
6840,2800,4840,13552000,2,54726,13683,1,526476800,526476800,20521,6840,13681,6840,0,1,6842,2847055,2.847055
39,6643,2041,13558363,2,318,81,1,111176312,111176312,118,39,79,39,0,1,41,24025,0.024025
539,6643,2041,13558363,2,4318,1081,1,145912312,145912312,1618,539,1079,539,0,1,541,58432,0.058432
1039,6643,2041,13558363,2,8318,2081,1,180648312,180648312,3118,1039,2079,1039,0,1,1041,433076,0.433076
1539,6643,2041,13558363,2,12318,3081,1,215384312,215384312,4618,1539,3079,1539,0,1,1541,31242,0.031242
2039,6643,2041,13558363,2,16318,4081,1,250120312,250120312,6118,2039,4079,2039,0,1,2041,402351,0.402351
2539,6643,2041,13558363,2,20318,5081,1,284856312,284856312,7618,2539,5079,2539,0,1,2541,727547,0.727547
3039,6643,2041,13558363,2,24318,6081,1,319592312,319592312,9118,3039,6079,3039,0,1,3041,2035222,2.035222
3539,6643,2041,13558363,2,28318,7081,1,354328312,354328312,10618,3539,7079,3539,0,1,3541,644269,0.644269
4039,6643,2041,13558363,2,32318,8081,1,389064312,389064312,12118,4039,8079,4039,0,1,4041,1137546,1.137546
4539,6643,2041,13558363,2,36318,9081,1,423800312,423800312,13618,4539,9079,4539,0,1,4541,1788616,1.788616
5039,6643,2041,13558363,2,40318,10081,1,458536312,458536312,15118,5039,10079,5039,0,1,5041,1589589,1.589589
5539,6643,2041,13558363,2,44318,11081,1,493272312,493272312,16618,5539,11079,5539,0,1,5541,1603113,1.603113
6039,6643,2041,13558363,2,48318,12081,1,528008312,528008312,18118,6039,12079,6039,0,1,6041,213988,0.213988
6539,6643,2041,13558363,2,52318,13081,1,562744312,562744312,19618,6539,13079,6539,0,1,6541,2879055,2.879055
7039,6643,2041,13558363,2,56318,14081,1,597480312,597480312,21118,7039,14079,7039,0,1,7041,12832200,12.8322
44,3353,4055,13596415,2,358,91,1,111378936,111378936,133,44,89,44,0,1,46,9923,0.009923
544,3353,4055,13596415,2,4358,1091,1,141010936,141010936,1633,544,1089,544,0,1,546,184891,0.184891
1044,3353,4055,13596415,2,8358,2091,1,170642936,170642936,3133,1044,2089,1044,0,1,1046,503649,0.503649
1544,3353,4055,13596415,2,12358,3091,1,200274936,200274936,4633,1544,3089,1544,0,1,1546,106218,0.106218
2044,3353,4055,13596415,2,16358,4091,1,229906936,229906936,6133,2044,4089,2044,0,1,2046,1187934,1.187934
2544,3353,4055,13596415,2,20358,5091,1,259538936,259538936,7633,2544,5089,2544,0,1,2546,417065,0.417065
3044,3353,4055,13596415,2,24358,6091,1,289170936,289170936,9133,3044,6089,3044,0,1,3046,424199,0.424199
3544,3353,4055,13596415,2,28358,7091,1,318802936,318802936,10633,3544,7089,3544,0,1,3546,215306,0.215306
4044,3353,4055,13596415,2,32358,8091,1,348434936,348434936,12133,4044,8089,4044,0,1,4046,407035,0.407035
4544,3353,4055,13596415,2,36358,9091,1,378066936,378066936,13633,4544,9089,4544,0,1,4546,481294,0.481294
5044,3353,4055,13596415,2,40358,10091,1,407698936,407698936,15133,5044,10089,5044,0,1,5046,1133814,1.133814
5544,3353,4055,13596415,2,44358,11091,1,437330936,437330936,16633,5544,11089,5544,0,1,5546,1324458,1.324458
6044,3353,4055,13596415,2,48358,12091,1,466962936,466962936,18133,6044,12089,6044,0,1,6046,324212,0.324212
6544,3353,4055,13596415,2,52358,13091,1,496594936,496594936,19633,6544,13089,6544,0,1,6546,175523,0.175523
7044,3353,4055,13596415,2,56358,14091,1,526226936,526226936,21133,7044,14089,7044,0,1,7046,1849274,1.849274
44,4453,3055,13603915,2,358,91,1,111474136,111474136,133,44,89,44,0,1,46,21923,0.021923
544,4453,3055,13603915,2,4358,1091,1,141506136,141506136,1633,544,1089,544,0,1,546,164468,0.164468
1044,4453,3055,13603915,2,8358,2091,1,171538136,171538136,3133,1044,2089,1044,0,1,1046,36899,0.036899
1544,4453,3055,13603915,2,12358,3091,1,201570136,201570136,4633,1544,3089,1544,0,1,1546,584433,0.584433
2044,4453,3055,13603915,2,16358,4091,1,231602136,231602136,6133,2044,4089,2044,0,1,2046,1428107,1.428107
2544,4453,3055,13603915,2,20358,5091,1,261634136,261634136,7633,2544,5089,2544,0,1,2546,1353649,1.353649
3044,4453,3055,13603915,2,24358,6091,1,291666136,291666136,9133,3044,6089,3044,0,1,3046,190277,0.190277
3544,4453,3055,13603915,2,28358,7091,1,321698136,321698136,10633,3544,7089,3544,0,1,3546,1079455,1.079455
4044,4453,3055,13603915,2,32358,8091,1,351730136,351730136,12133,4044,8089,4044,0,1,4046,1108904,1.108904
4544,4453,3055,13603915,2,36358,9091,1,381762136,381762136,13633,4544,9089,4544,0,1,4546,1849163,1.849163
5044,4453,3055,13603915,2,40358,10091,1,411794136,411794136,15133,5044,10089,5044,0,1,5046,1157259,1.157259
5544,4453,3055,13603915,2,44358,11091,1,441826136,441826136,16633,5544,11089,5544,0,1,5546,2724003,2.724003
6044,4453,3055,13603915,2,48358,12091,1,471858136,471858136,18133,6044,12089,6044,0,1,6046,258380,0.25838
6544,4453,3055,13603915,2,52358,13091,1,501890136,501890136,19633,6544,13089,6544,0,1,6546,275540,0.27554
7044,4453,3055,13603915,2,56358,14091,1,531922136,531922136,21133,7044,14089,7044,0,1,7046,100493,0.100493
40,2050,6640,13612000,2,326,83,1,111676800,111676800,121,40,81,40,0,1,42,34670,0.03467
440,2050,6640,13612000,2,3526,883,1,139484800,139484800,1321,440,881,440,0,1,442,27944,0.027944
840,2050,6640,13612000,2,6726,1683,1,167292800,167292800,2521,840,1681,840,0,1,842,24824,0.024824
1240,2050,6640,13612000,2,9926,2483,1,195100800,195100800,3721,1240,2481,1240,0,1,1242,92007,0.092007
1640,2050,6640,13612000,2,13126,3283,1,222908800,222908800,4921,1640,3281,1640,0,1,1642,102727,0.102727
2040,2050,6640,13612000,2,16326,4083,1,250716800,250716800,6121,2040,4081,2040,0,1,2042,129061,0.129061
2440,2050,6640,13612000,2,19526,4883,1,278524800,278524800,7321,2440,4881,2440,0,1,2442,702401,0.702401
2840,2050,6640,13612000,2,22726,5683,1,306332800,306332800,8521,2840,5681,2840,0,1,2842,798765,0.798765
3240,2050,6640,13612000,2,25926,6483,1,334140800,334140800,9721,3240,6481,3240,0,1,3242,1260353,1.260353
3640,2050,6640,13612000,2,29126,7283,1,361948800,361948800,10921,3640,7281,3640,0,1,3642,295523,0.295523
4040,2050,6640,13612000,2,32326,8083,1,389756800,389756800,12121,4040,8081,4040,0,1,4042,1967912,1.967912
4440,2050,6640,13612000,2,35526,8883,1,417564800,417564800,13321,4440,8881,4440,0,1,4442,239308,0.239308
4840,2050,6640,13612000,2,38726,9683,1,445372800,445372800,14521,4840,9681,4840,0,1,4842,978459,0.978459
5240,2050,6640,13612000,2,41926,10483,1,473180800,473180800,15721,5240,10481,5240,0,1,5242,339969,0.339969
5640,2050,6640,13612000,2,45126,11283,1,500988800,500988800,16921,5640,11281,5640,0,1,5642,765529,0.765529
6040,2050,6640,13612000,2,48326,12083,1,528796800,528796800,18121,6040,12081,6040,0,1,6042,1870139,1.870139
6440,2050,6640,13612000,2,51526,12883,1,556604800,556604800,19321,6440,12881,6440,0,1,6442,2083604,2.083604
6840,2050,6640,13612000,2,54726,13683,1,584412800,584412800,20521,6840,13681,6840,0,1,6842,166213,0.166213
44,2253,6055,13641915,2,358,91,1,112059736,112059736,133,44,89,44,0,1,46,43405,0.043405
544,2253,6055,13641915,2,4358,1091,1,145291736,145291736,1633,544,1089,544,0,1,546,58189,0.058189
1044,2253,6055,13641915,2,8358,2091,1,178523736,178523736,3133,1044,2089,1044,0,1,1046,120326,0.120326
1544,2253,6055,13641915,2,12358,3091,1,211755736,211755736,4633,1544,3089,1544,0,1,1546,287383,0.287383
2044,2253,6055,13641915,2,16358,4091,1,244987736,244987736,6133,2044,4089,2044,0,1,2046,400937,0.400937
2544,2253,6055,13641915,2,20358,5091,1,278219736,278219736,7633,2544,5089,2544,0,1,2546,151456,0.151456
3044,2253,6055,13641915,2,24358,6091,1,311451736,311451736,9133,3044,6089,3044,0,1,3046,49003,0.049003
3544,2253,6055,13641915,2,28358,7091,1,344683736,344683736,10633,3544,7089,3544,0,1,3546,143068,0.143068
4044,2253,6055,13641915,2,32358,8091,1,377915736,377915736,12133,4044,8089,4044,0,1,4046,948102,0.948102
4544,2253,6055,13641915,2,36358,9091,1,411147736,411147736,13633,4544,9089,4544,0,1,4546,1931385,1.931385
5044,2253,6055,13641915,2,40358,10091,1,444379736,444379736,15133,5044,10089,5044,0,1,5046,1176824,1.176824
5544,2253,6055,13641915,2,44358,11091,1,477611736,477611736,16633,5544,11089,5544,0,1,5546,3467056,3.467056
6044,2253,6055,13641915,2,48358,12091,1,510843736,510843736,18133,6044,12089,6044,0,1,6046,750865,0.750865
6544,2253,6055,13641915,2,52358,13091,1,544075736,544075736,19633,6544,13089,6544,0,1,6546,2626356,2.626356
7044,2253,6055,13641915,2,56358,14091,1,577307736,577307736,21133,7044,14089,7044,0,1,7046,129125,0.129125
55,4055,3365,13645075,2,446,113,1,112425400,112425400,166,55,111,55,0,1,57,34248,0.034248
455,4055,3365,13645075,2,3646,913,1,136169400,136169400,1366,455,911,455,0,1,457,24945,0.024945
855,4055,3365,13645075,2,6846,1713,1,159913400,159913400,2566,855,1711,855,0,1,857,51194,0.051194
1255,4055,3365,13645075,2,10046,2513,1,183657400,183657400,3766,1255,2511,1255,0,1,1257,244144,0.244144
1655,4055,3365,13645075,2,13246,3313,1,207401400,207401400,4966,1655,3311,1655,0,1,1657,986140,0.98614
2055,4055,3365,13645075,2,16446,4113,1,231145400,231145400,6166,2055,4111,2055,0,1,2057,268447,0.268447
2455,4055,3365,13645075,2,19646,4913,1,254889400,254889400,7366,2455,4911,2455,0,1,2457,232074,0.232074
2855,4055,3365,13645075,2,22846,5713,1,278633400,278633400,8566,2855,5711,2855,0,1,2857,326405,0.326405
3255,4055,3365,13645075,2,26046,6513,1,302377400,302377400,9766,3255,6511,3255,0,1,3257,1338856,1.338856
3655,4055,3365,13645075,2,29246,7313,1,326121400,326121400,10966,3655,7311,3655,0,1,3657,61532,0.061532
4055,4055,3365,13645075,2,32446,8113,1,349865400,349865400,12166,4055,8111,4055,0,1,4057,939393,0.939393
4455,4055,3365,13645075,2,35646,8913,1,373609400,373609400,13366,4455,8911,4455,0,1,4457,449796,0.449796
4855,4055,3365,13645075,2,38846,9713,1,397353400,397353400,14566,4855,9711,4855,0,1,4857,467644,0.467644
5255,4055,3365,13645075,2,42046,10513,1,421097400,421097400,15766,5255,10511,5255,0,1,5257,285151,0.285151
5655,4055,3365,13645075,2,45246,11313,1,444841400,444841400,16966,5655,11311,5655,0,1,5657,411690,0.41169
6055,4055,3365,13645075,2,48446,12113,1,468585400,468585400,18166,6055,12111,6055,0,1,6057,757911,0.757911
6455,4055,3365,13645075,2,51646,12913,1,492329400,492329400,19366,6455,12911,6455,0,1,6457,392431,0.392431
6855,4055,3365,13645075,2,54846,13713,1,516073400,516073400,20566,6855,13711,6855,0,1,6857,4301769,4.301769
55,2805,4865,13646325,2,446,113,1,112545400,112545400,166,55,111,55,0,1,57,274858,0.274858
455,2805,4865,13646325,2,3646,913,1,137089400,137089400,1366,455,911,455,0,1,457,1258204,1.258204
855,2805,4865,13646325,2,6846,1713,1,161633400,161633400,2566,855,1711,855,0,1,857,2262666,2.262666
1255,2805,4865,13646325,2,10046,2513,1,186177400,186177400,3766,1255,2511,1255,0,1,1257,3264435,3.264435
1655,2805,4865,13646325,2,13246,3313,1,210721400,210721400,4966,1655,3311,1655,0,1,1657,3417953,3.417953
2055,2805,4865,13646325,2,16446,4113,1,235265400,235265400,6166,2055,4111,2055,0,1,2057,3818756,3.818756
2455,2805,4865,13646325,2,19646,4913,1,259809400,259809400,7366,2455,4911,2455,0,1,2457,1679006,1.679006
2855,2805,4865,13646325,2,22846,5713,1,284353400,284353400,8566,2855,5711,2855,0,1,2857,201406,0.201406
3255,2805,4865,13646325,2,26046,6513,1,308897400,308897400,9766,3255,6511,3255,0,1,3257,1223988,1.223988
3655,2805,4865,13646325,2,29246,7313,1,333441400,333441400,10966,3655,7311,3655,0,1,3657,2360297,2.360297
4055,2805,4865,13646325,2,32446,8113,1,357985400,357985400,12166,4055,8111,4055,0,1,4057,3198748,3.198748
4455,2805,4865,13646325,2,35646,8913,1,382529400,382529400,13366,4455,8911,4455,0,1,4457,3468272,3.468272
4855,2805,4865,13646325,2,38846,9713,1,407073400,407073400,14566,4855,9711,4855,0,1,4857,3474235,3.474235
5255,2805,4865,13646325,2,42046,10513,1,431617400,431617400,15766,5255,10511,5255,0,1,5257,2445575,2.445575
5655,2805,4865,13646325,2,45246,11313,1,456161400,456161400,16966,5655,11311,5655,0,1,5657,283566,0.283566
6055,2805,4865,13646325,2,48446,12113,1,480705400,480705400,18166,6055,12111,6055,0,1,6057,239263,0.239263
6455,2805,4865,13646325,2,51646,12913,1,505249400,505249400,19366,6455,12911,6455,0,1,6457,2329124,2.329124
6855,2805,4865,13646325,2,54846,13713,1,529793400,529793400,20566,6855,13711,6855,0,1,6857,221825,0.221825
55,6305,2165,13650325,2,446,113,1,112929400,112929400,166,55,111,55,0,1,57,273879,0.273879
455,6305,2165,13650325,2,3646,913,1,140033400,140033400,1366,455,911,455,0,1,457,1285886,1.285886
855,6305,2165,13650325,2,6846,1713,1,167137400,167137400,2566,855,1711,855,0,1,857,2309024,2.309024
1255,6305,2165,13650325,2,10046,2513,1,194241400,194241400,3766,1255,2511,1255,0,1,1257,3338307,3.338307
1655,6305,2165,13650325,2,13246,3313,1,221345400,221345400,4966,1655,3311,1655,0,1,1657,84747,0.084747
2055,6305,2165,13650325,2,16446,4113,1,248449400,248449400,6166,2055,4111,2055,0,1,2057,5402820,5.40282
2455,6305,2165,13650325,2,19646,4913,1,275553400,275553400,7366,2455,4911,2455,0,1,2457,1249129,1.249129
2855,6305,2165,13650325,2,22846,5713,1,302657400,302657400,8566,2855,5711,2855,0,1,2857,2108340,2.10834
3255,6305,2165,13650325,2,26046,6513,1,329761400,329761400,9766,3255,6511,3255,0,1,3257,2406539,2.406539
3655,6305,2165,13650325,2,29246,7313,1,356865400,356865400,10966,3655,7311,3655,0,1,3657,9574834,9.574834
4055,6305,2165,13650325,2,32446,8113,1,383969400,383969400,12166,4055,8111,4055,0,1,4057,4239142,4.239142
4455,6305,2165,13650325,2,35646,8913,1,411073400,411073400,13366,4455,8911,4455,0,1,4457,1473481,1.473481
4855,6305,2165,13650325,2,38846,9713,1,438177400,438177400,14566,4855,9711,4855,0,1,4857,4538686,4.538686
5255,6305,2165,13650325,2,42046,10513,1,465281400,465281400,15766,5255,10511,5255,0,1,5257,3390750,3.39075
5655,6305,2165,13650325,2,45246,11313,1,492385400,492385400,16966,5655,11311,5655,0,1,5657,8085071,8.085071
6055,6305,2165,13650325,2,48446,12113,1,519489400,519489400,18166,6055,12111,6055,0,1,6057,14310366,14.310366
6455,6305,2165,13650325,2,51646,12913,1,546593400,546593400,19366,6455,12911,6455,0,1,6457,16830547,16.830547
6855,6305,2165,13650325,2,54846,13713,1,573697400,573697400,20566,6855,13711,6855,0,1,6857,14914425,14.914425
44,6653,2055,13671915,2,358,91,1,112440536,112440536,133,44,89,44,0,1,46,14903,0.014903
544,6653,2055,13671915,2,4358,1091,1,147272536,147272536,1633,544,1089,544,0,1,546,66449,0.066449
1044,6653,2055,13671915,2,8358,2091,1,182104536,182104536,3133,1044,2089,1044,0,1,1046,342977,0.342977
1544,6653,2055,13671915,2,12358,3091,1,216936536,216936536,4633,1544,3089,1544,0,1,1546,776644,0.776644
2044,6653,2055,13671915,2,16358,4091,1,251768536,251768536,6133,2044,4089,2044,0,1,2046,1078036,1.078036
2544,6653,2055,13671915,2,20358,5091,1,286600536,286600536,7633,2544,5089,2544,0,1,2546,2398180,2.39818
3044,6653,2055,13671915,2,24358,6091,1,321432536,321432536,9133,3044,6089,3044,0,1,3046,1906100,1.9061
3544,6653,2055,13671915,2,28358,7091,1,356264536,356264536,10633,3544,7089,3544,0,1,3546,2701199,2.701199
4044,6653,2055,13671915,2,32358,8091,1,391096536,391096536,12133,4044,8089,4044,0,1,4046,5090092,5.090092
4544,6653,2055,13671915,2,36358,9091,1,425928536,425928536,13633,4544,9089,4544,0,1,4546,2283912,2.283912
5044,6653,2055,13671915,2,40358,10091,1,460760536,460760536,15133,5044,10089,5044,0,1,5046,4865514,4.865514
5544,6653,2055,13671915,2,44358,11091,1,495592536,495592536,16633,5544,11089,5544,0,1,5546,1365589,1.365589
6044,6653,2055,13671915,2,48358,12091,1,530424536,530424536,18133,6044,12089,6044,0,1,6046,4065601,4.065601
6544,6653,2055,13671915,2,52358,13091,1,565256536,565256536,19633,6544,13089,6544,0,1,6546,1425777,1.425777
7044,6653,2055,13671915,2,56358,14091,1,600088536,600088536,21133,7044,14089,7044,0,1,7046,2875084,2.875084
55,5555,2465,13693075,2,446,113,1,113073400,113073400,166,55,111,55,0,1,57,276186,0.276186
455,5555,2465,13693075,2,3646,913,1,138737400,138737400,1366,455,911,455,0,1,457,1304250,1.30425
855,5555,2465,13693075,2,6846,1713,1,164401400,164401400,2566,855,1711,855,0,1,857,2342573,2.342573
1255,5555,2465,13693075,2,10046,2513,1,190065400,190065400,3766,1255,2511,1255,0,1,1257,1926993,1.926993
1655,5555,2465,13693075,2,13246,3313,1,215729400,215729400,4966,1655,3311,1655,0,1,1657,1208478,1.208478
2055,5555,2465,13693075,2,16446,4113,1,241393400,241393400,6166,2055,4111,2055,0,1,2057,1240177,1.240177
2455,5555,2465,13693075,2,19646,4913,1,267057400,267057400,7366,2455,4911,2455,0,1,2457,4258245,4.258245
2855,5555,2465,13693075,2,22846,5713,1,292721400,292721400,8566,2855,5711,2855,0,1,2857,4104010,4.10401
3255,5555,2465,13693075,2,26046,6513,1,318385400,318385400,9766,3255,6511,3255,0,1,3257,5031868,5.031868
3655,5555,2465,13693075,2,29246,7313,1,344049400,344049400,10966,3655,7311,3655,0,1,3657,415042,0.415042
4055,5555,2465,13693075,2,32446,8113,1,369713400,369713400,12166,4055,8111,4055,0,1,4057,1051354,1.051354
4455,5555,2465,13693075,2,35646,8913,1,395377400,395377400,13366,4455,8911,4455,0,1,4457,3887814,3.887814
4855,5555,2465,13693075,2,38846,9713,1,421041400,421041400,14566,4855,9711,4855,0,1,4857,6310560,6.31056
5255,5555,2465,13693075,2,42046,10513,1,446705400,446705400,15766,5255,10511,5255,0,1,5257,1607329,1.607329
5655,5555,2465,13693075,2,45246,11313,1,472369400,472369400,16966,5655,11311,5655,0,1,5657,3744712,3.744712
6055,5555,2465,13693075,2,48446,12113,1,498033400,498033400,18166,6055,12111,6055,0,1,6057,6977948,6.977948
6455,5555,2465,13693075,2,51646,12913,1,523697400,523697400,19366,6455,12911,6455,0,1,6457,10684221,10.684221
6855,5555,2465,13693075,2,54846,13713,1,549361400,549361400,20566,6855,13711,6855,0,1,6857,6819837,6.819837
55,2055,6665,13696575,2,446,113,1,113409400,113409400,166,55,111,55,0,1,57,26623,0.026623
455,2055,6665,13696575,2,3646,913,1,141313400,141313400,1366,455,911,455,0,1,457,61366,0.061366
855,2055,6665,13696575,2,6846,1713,1,169217400,169217400,2566,855,1711,855,0,1,857,263027,0.263027
1255,2055,6665,13696575,2,10046,2513,1,197121400,197121400,3766,1255,2511,1255,0,1,1257,18898,0.018898
1655,2055,6665,13696575,2,13246,3313,1,225025400,225025400,4966,1655,3311,1655,0,1,1657,326221,0.326221
2055,2055,6665,13696575,2,16446,4113,1,252929400,252929400,6166,2055,4111,2055,0,1,2057,1070820,1.07082
2455,2055,6665,13696575,2,19646,4913,1,280833400,280833400,7366,2455,4911,2455,0,1,2457,12693,0.012693
2855,2055,6665,13696575,2,22846,5713,1,308737400,308737400,8566,2855,5711,2855,0,1,2857,612555,0.612555
3255,2055,6665,13696575,2,26046,6513,1,336641400,336641400,9766,3255,6511,3255,0,1,3257,22365,0.022365
3655,2055,6665,13696575,2,29246,7313,1,364545400,364545400,10966,3655,7311,3655,0,1,3657,187933,0.187933
4055,2055,6665,13696575,2,32446,8113,1,392449400,392449400,12166,4055,8111,4055,0,1,4057,163190,0.16319
4455,2055,6665,13696575,2,35646,8913,1,420353400,420353400,13366,4455,8911,4455,0,1,4457,2057891,2.057891
4855,2055,6665,13696575,2,38846,9713,1,448257400,448257400,14566,4855,9711,4855,0,1,4857,958974,0.958974
5255,2055,6665,13696575,2,42046,10513,1,476161400,476161400,15766,5255,10511,5255,0,1,5257,732118,0.732118
5655,2055,6665,13696575,2,45246,11313,1,504065400,504065400,16966,5655,11311,5655,0,1,5657,220398,0.220398
6055,2055,6665,13696575,2,48446,12113,1,531969400,531969400,18166,6055,12111,6055,0,1,6057,811889,0.811889
6455,2055,6665,13696575,2,51646,12913,1,559873400,559873400,19366,6455,12911,6455,0,1,6457,84339,0.084339
6855,2055,6665,13696575,2,54846,13713,1,587777400,587777400,20566,6855,13711,6855,0,1,6857,1595384,1.595384
39,3893,3541,13785113,2,318,81,1,112600312,112600312,118,39,79,39,0,1,41,243194,0.243194
539,3893,3541,13785113,2,4318,1081,1,142336312,142336312,1618,539,1079,539,0,1,541,79997,0.079997
1039,3893,3541,13785113,2,8318,2081,1,172072312,172072312,3118,1039,2079,1039,0,1,1041,2881406,2.881406
1539,3893,3541,13785113,2,12318,3081,1,201808312,201808312,4618,1539,3079,1539,0,1,1541,2404408,2.404408
2039,3893,3541,13785113,2,16318,4081,1,231544312,231544312,6118,2039,4079,2039,0,1,2041,913737,0.913737
2539,3893,3541,13785113,2,20318,5081,1,261280312,261280312,7618,2539,5079,2539,0,1,2541,3525712,3.525712
3039,3893,3541,13785113,2,24318,6081,1,291016312,291016312,9118,3039,6079,3039,0,1,3041,5608315,5.608315
3539,3893,3541,13785113,2,28318,7081,1,320752312,320752312,10618,3539,7079,3539,0,1,3541,1559106,1.559106
4039,3893,3541,13785113,2,32318,8081,1,350488312,350488312,12118,4039,8079,4039,0,1,4041,4615377,4.615377
4539,3893,3541,13785113,2,36318,9081,1,380224312,380224312,13618,4539,9079,4539,0,1,4541,1730152,1.730152
5039,3893,3541,13785113,2,40318,10081,1,409960312,409960312,15118,5039,10079,5039,0,1,5041,4218072,4.218072
5539,3893,3541,13785113,2,44318,11081,1,439696312,439696312,16618,5539,11079,5539,0,1,5541,2643045,2.643045
6039,3893,3541,13785113,2,48318,12081,1,469432312,469432312,18118,6039,12079,6039,0,1,6041,13737483,13.737483
6539,3893,3541,13785113,2,52318,13081,1,499168312,499168312,19618,6539,13079,6539,0,1,6541,4761902,4.761902
7039,3893,3541,13785113,2,56318,14081,1,528904312,528904312,21118,7039,14079,7039,0,1,7041,6390467,6.390467
40,4550,3040,13832000,2,326,83,1,113084800,113084800,121,40,81,40,0,1,42,245369,0.245369
440,4550,3040,13832000,2,3526,883,1,137372800,137372800,1321,440,881,440,0,1,442,1212059,1.212059
840,4550,3040,13832000,2,6726,1683,1,161660800,161660800,2521,840,1681,840,0,1,842,2215758,2.215758
1240,4550,3040,13832000,2,9926,2483,1,185948800,185948800,3721,1240,2481,1240,0,1,1242,21877,0.021877
1640,4550,3040,13832000,2,13126,3283,1,210236800,210236800,4921,1640,3281,1640,0,1,1642,1402870,1.40287
2040,4550,3040,13832000,2,16326,4083,1,234524800,234524800,6121,2040,4081,2040,0,1,2042,819223,0.819223
2440,4550,3040,13832000,2,19526,4883,1,258812800,258812800,7321,2440,4881,2440,0,1,2442,1135917,1.135917
2840,4550,3040,13832000,2,22726,5683,1,283100800,283100800,8521,2840,5681,2840,0,1,2842,7103113,7.103113
3240,4550,3040,13832000,2,25926,6483,1,307388800,307388800,9721,3240,6481,3240,0,1,3242,2609984,2.609984
3640,4550,3040,13832000,2,29126,7283,1,331676800,331676800,10921,3640,7281,3640,0,1,3642,402195,0.402195
4040,4550,3040,13832000,2,32326,8083,1,355964800,355964800,12121,4040,8081,4040,0,1,4042,2566018,2.566018
4440,4550,3040,13832000,2,35526,8883,1,380252800,380252800,13321,4440,8881,4440,0,1,4442,2172896,2.172896
40,3800,3640,13832000,2,326,83,1,113036800,113036800,121,40,81,40,0,1,42,245807,0.245807
440,3800,3640,13832000,2,3526,883,1,136844800,136844800,1321,440,881,440,0,1,442,1267108,1.267108
840,3800,3640,13832000,2,6726,1683,1,160652800,160652800,2521,840,1681,840,0,1,842,2315301,2.315301
1240,3800,3640,13832000,2,9926,2483,1,184460800,184460800,3721,1240,2481,1240,0,1,1242,3353765,3.353765
4840,4550,3040,13832000,2,38726,9683,1,404540800,404540800,14521,4840,9681,4840,0,1,4842,841453,0.841453
1640,3800,3640,13832000,2,13126,3283,1,208268800,208268800,4921,1640,3281,1640,0,1,1642,848462,0.848462
2040,3800,3640,13832000,2,16326,4083,1,232076800,232076800,6121,2040,4081,2040,0,1,2042,2479410,2.47941
2440,3800,3640,13832000,2,19526,4883,1,255884800,255884800,7321,2440,4881,2440,0,1,2442,6451776,6.451776
5240,4550,3040,13832000,2,41926,10483,1,428828800,428828800,15721,5240,10481,5240,0,1,5242,738076,0.738076
2840,3800,3640,13832000,2,22726,5683,1,279692800,279692800,8521,2840,5681,2840,0,1,2842,65902,0.065902
3240,3800,3640,13832000,2,25926,6483,1,303500800,303500800,9721,3240,6481,3240,0,1,3242,8534803,8.534803
5640,4550,3040,13832000,2,45126,11283,1,453116800,453116800,16921,5640,11281,5640,0,1,5642,1302738,1.302738
3640,3800,3640,13832000,2,29126,7283,1,327308800,327308800,10921,3640,7281,3640,0,1,3642,1940666,1.940666
4040,3800,3640,13832000,2,32326,8083,1,351116800,351116800,12121,4040,8081,4040,0,1,4042,2470747,2.470747
6040,4550,3040,13832000,2,48326,12083,1,477404800,477404800,18121,6040,12081,6040,0,1,6042,10332481,10.332481
4440,3800,3640,13832000,2,35526,8883,1,374924800,374924800,13321,4440,8881,4440,0,1,4442,116863,0.116863
6440,4550,3040,13832000,2,51526,12883,1,501692800,501692800,19321,6440,12881,6440,0,1,6442,2438458,2.438458
4840,3800,3640,13832000,2,38726,9683,1,398732800,398732800,14521,4840,9681,4840,0,1,4842,2160340,2.16034
5240,3800,3640,13832000,2,41926,10483,1,422540800,422540800,15721,5240,10481,5240,0,1,5242,7355551,7.355551
6840,4550,3040,13832000,2,54726,13683,1,525980800,525980800,20521,6840,13681,6840,0,1,6842,2776434,2.776434
5640,3800,3640,13832000,2,45126,11283,1,446348800,446348800,16921,5640,11281,5640,0,1,5642,9533925,9.533925
6040,3800,3640,13832000,2,48326,12083,1,470156800,470156800,18121,6040,12081,6040,0,1,6042,452440,0.45244
6440,3800,3640,13832000,2,51526,12883,1,493964800,493964800,19321,6440,12881,6440,0,1,6442,428875,0.428875
6840,3800,3640,13832000,2,54726,13683,1,517772800,517772800,20521,6840,13681,6840,0,1,6842,280359,0.280359
40,5050,2740,13837000,2,326,83,1,113188800,113188800,121,40,81,40,0,1,42,9595,0.009595
440,5050,2740,13837000,2,3526,883,1,138116800,138116800,1321,440,881,440,0,1,442,54556,0.054556
840,5050,2740,13837000,2,6726,1683,1,163044800,163044800,2521,840,1681,840,0,1,842,40377,0.040377
1240,5050,2740,13837000,2,9926,2483,1,187972800,187972800,3721,1240,2481,1240,0,1,1242,28049,0.028049
1640,5050,2740,13837000,2,13126,3283,1,212900800,212900800,4921,1640,3281,1640,0,1,1642,209652,0.209652
2040,5050,2740,13837000,2,16326,4083,1,237828800,237828800,6121,2040,4081,2040,0,1,2042,137555,0.137555
2440,5050,2740,13837000,2,19526,4883,1,262756800,262756800,7321,2440,4881,2440,0,1,2442,238307,0.238307
2840,5050,2740,13837000,2,22726,5683,1,287684800,287684800,8521,2840,5681,2840,0,1,2842,1370149,1.370149
3240,5050,2740,13837000,2,25926,6483,1,312612800,312612800,9721,3240,6481,3240,0,1,3242,80612,0.080612
3640,5050,2740,13837000,2,29126,7283,1,337540800,337540800,10921,3640,7281,3640,0,1,3642,278232,0.278232
4040,5050,2740,13837000,2,32326,8083,1,362468800,362468800,12121,4040,8081,4040,0,1,4042,1409867,1.409867
4440,5050,2740,13837000,2,35526,8883,1,387396800,387396800,13321,4440,8881,4440,0,1,4442,2256373,2.256373
4840,5050,2740,13837000,2,38726,9683,1,412324800,412324800,14521,4840,9681,4840,0,1,4842,1073453,1.073453
5240,5050,2740,13837000,2,41926,10483,1,437252800,437252800,15721,5240,10481,5240,0,1,5242,1518790,1.51879
5640,5050,2740,13837000,2,45126,11283,1,462180800,462180800,16921,5640,11281,5640,0,1,5642,442819,0.442819
6040,5050,2740,13837000,2,48326,12083,1,487108800,487108800,18121,6040,12081,6040,0,1,6042,2859033,2.859033
6440,5050,2740,13837000,2,51526,12883,1,512036800,512036800,19321,6440,12881,6440,0,1,6442,686855,0.686855
6840,5050,2740,13837000,2,54726,13683,1,536964800,536964800,20521,6840,13681,6840,0,1,6842,1013034,1.013034
40,3050,4540,13847000,2,326,83,1,113204800,113204800,121,40,81,40,0,1,42,23846,0.023846
440,3050,4540,13847000,2,3526,883,1,137492800,137492800,1321,440,881,440,0,1,442,103289,0.103289
840,3050,4540,13847000,2,6726,1683,1,161780800,161780800,2521,840,1681,840,0,1,842,149903,0.149903
1240,3050,4540,13847000,2,9926,2483,1,186068800,186068800,3721,1240,2481,1240,0,1,1242,137980,0.13798
1640,3050,4540,13847000,2,13126,3283,1,210356800,210356800,4921,1640,3281,1640,0,1,1642,239544,0.239544
2040,3050,4540,13847000,2,16326,4083,1,234644800,234644800,6121,2040,4081,2040,0,1,2042,16854,0.016854
2440,3050,4540,13847000,2,19526,4883,1,258932800,258932800,7321,2440,4881,2440,0,1,2442,143186,0.143186
2840,3050,4540,13847000,2,22726,5683,1,283220800,283220800,8521,2840,5681,2840,0,1,2842,670085,0.670085
3240,3050,4540,13847000,2,25926,6483,1,307508800,307508800,9721,3240,6481,3240,0,1,3242,1106831,1.106831
3640,3050,4540,13847000,2,29126,7283,1,331796800,331796800,10921,3640,7281,3640,0,1,3642,1373326,1.373326
4040,3050,4540,13847000,2,32326,8083,1,356084800,356084800,12121,4040,8081,4040,0,1,4042,361568,0.361568
4440,3050,4540,13847000,2,35526,8883,1,380372800,380372800,13321,4440,8881,4440,0,1,4442,629728,0.629728
4840,3050,4540,13847000,2,38726,9683,1,404660800,404660800,14521,4840,9681,4840,0,1,4842,86744,0.086744
5240,3050,4540,13847000,2,41926,10483,1,428948800,428948800,15721,5240,10481,5240,0,1,5242,537850,0.53785
5640,3050,4540,13847000,2,45126,11283,1,453236800,453236800,16921,5640,11281,5640,0,1,5642,3211211,3.211211
6040,3050,4540,13847000,2,48326,12083,1,477524800,477524800,18121,6040,12081,6040,0,1,6042,20692,0.020692
6440,3050,4540,13847000,2,51526,12883,1,501812800,501812800,19321,6440,12881,6440,0,1,6442,1783757,1.783757
6840,3050,4540,13847000,2,54726,13683,1,526100800,526100800,20521,6840,13681,6840,0,1,6842,1602513,1.602513
40,2550,5440,13872000,2,326,83,1,113532800,113532800,121,40,81,40,0,1,42,240656,0.240656
440,2550,5440,13872000,2,3526,883,1,139100800,139100800,1321,440,881,440,0,1,442,507478,0.507478
840,2550,5440,13872000,2,6726,1683,1,164668800,164668800,2521,840,1681,840,0,1,842,58948,0.058948
1240,2550,5440,13872000,2,9926,2483,1,190236800,190236800,3721,1240,2481,1240,0,1,1242,894593,0.894593
1640,2550,5440,13872000,2,13126,3283,1,215804800,215804800,4921,1640,3281,1640,0,1,1642,844567,0.844567
2040,2550,5440,13872000,2,16326,4083,1,241372800,241372800,6121,2040,4081,2040,0,1,2042,156701,0.156701
2440,2550,5440,13872000,2,19526,4883,1,266940800,266940800,7321,2440,4881,2440,0,1,2442,809251,0.809251
2840,2550,5440,13872000,2,22726,5683,1,292508800,292508800,8521,2840,5681,2840,0,1,2842,2483749,2.483749
3240,2550,5440,13872000,2,25926,6483,1,318076800,318076800,9721,3240,6481,3240,0,1,3242,2475507,2.475507
3640,2550,5440,13872000,2,29126,7283,1,343644800,343644800,10921,3640,7281,3640,0,1,3642,1131481,1.131481
4040,2550,5440,13872000,2,32326,8083,1,369212800,369212800,12121,4040,8081,4040,0,1,4042,1308425,1.308425
4440,2550,5440,13872000,2,35526,8883,1,394780800,394780800,13321,4440,8881,4440,0,1,4442,455304,0.455304
4840,2550,5440,13872000,2,38726,9683,1,420348800,420348800,14521,4840,9681,4840,0,1,4842,707558,0.707558
5240,2550,5440,13872000,2,41926,10483,1,445916800,445916800,15721,5240,10481,5240,0,1,5242,2611896,2.611896
5640,2550,5440,13872000,2,45126,11283,1,471484800,471484800,16921,5640,11281,5640,0,1,5642,784356,0.784356
6040,2550,5440,13872000,2,48326,12083,1,497052800,497052800,18121,6040,12081,6040,0,1,6042,4298348,4.298348
6440,2550,5440,13872000,2,51526,12883,1,522620800,522620800,19321,6440,12881,6440,0,1,6442,804775,0.804775
6840,2550,5440,13872000,2,54726,13683,1,548188800,548188800,20521,6840,13681,6840,0,1,6842,412095,0.412095
44,3903,3555,13875165,2,358,91,1,113626536,113626536,133,44,89,44,0,1,46,54476,0.054476
544,3903,3555,13875165,2,4358,1091,1,143458536,143458536,1633,544,1089,544,0,1,546,1572671,1.572671
1044,3903,3555,13875165,2,8358,2091,1,173290536,173290536,3133,1044,2089,1044,0,1,1046,2901276,2.901276
1544,3903,3555,13875165,2,12358,3091,1,203122536,203122536,4633,1544,3089,1544,0,1,1546,4232390,4.23239
2044,3903,3555,13875165,2,16358,4091,1,232954536,232954536,6133,2044,4089,2044,0,1,2046,2065658,2.065658
2544,3903,3555,13875165,2,20358,5091,1,262786536,262786536,7633,2544,5089,2544,0,1,2546,126686,0.126686
3044,3903,3555,13875165,2,24358,6091,1,292618536,292618536,9133,3044,6089,3044,0,1,3046,4135414,4.135414
3544,3903,3555,13875165,2,28358,7091,1,322450536,322450536,10633,3544,7089,3544,0,1,3546,1736688,1.736688
4044,3903,3555,13875165,2,32358,8091,1,352282536,352282536,12133,4044,8089,4044,0,1,4046,3554467,3.554467
4544,3903,3555,13875165,2,36358,9091,1,382114536,382114536,13633,4544,9089,4544,0,1,4546,615300,0.6153
5044,3903,3555,13875165,2,40358,10091,1,411946536,411946536,15133,5044,10089,5044,0,1,5046,26783,0.026783
5544,3903,3555,13875165,2,44358,11091,1,441778536,441778536,16633,5544,11089,5544,0,1,5546,8359769,8.359769
6044,3903,3555,13875165,2,48358,12091,1,471610536,471610536,18133,6044,12089,6044,0,1,6046,16351668,16.351668
6544,3903,3555,13875165,2,52358,13091,1,501442536,501442536,19633,6544,13089,6544,0,1,6546,17815987,17.815987
7044,3903,3555,13875165,2,56358,14091,1,531274536,531274536,21133,7044,14089,7044,0,1,7046,5154505,5.154505
40,2300,6040,13892000,2,326,83,1,113804800,113804800,121,40,81,40,0,1,42,255225,0.255225
440,2300,6040,13892000,2,3526,883,1,140492800,140492800,1321,440,881,440,0,1,442,1250046,1.250046
840,2300,6040,13892000,2,6726,1683,1,167180800,167180800,2521,840,1681,840,0,1,842,277574,0.277574
1240,2300,6040,13892000,2,9926,2483,1,193868800,193868800,3721,1240,2481,1240,0,1,1242,1407167,1.407167
1640,2300,6040,13892000,2,13126,3283,1,220556800,220556800,4921,1640,3281,1640,0,1,1642,1813218,1.813218
2040,2300,6040,13892000,2,16326,4083,1,247244800,247244800,6121,2040,4081,2040,0,1,2042,277161,0.277161
2440,2300,6040,13892000,2,19526,4883,1,273932800,273932800,7321,2440,4881,2440,0,1,2442,2765023,2.765023
2840,2300,6040,13892000,2,22726,5683,1,300620800,300620800,8521,2840,5681,2840,0,1,2842,203510,0.20351
3240,2300,6040,13892000,2,25926,6483,1,327308800,327308800,9721,3240,6481,3240,0,1,3242,1830650,1.83065
3640,2300,6040,13892000,2,29126,7283,1,353996800,353996800,10921,3640,7281,3640,0,1,3642,4663740,4.66374
4040,2300,6040,13892000,2,32326,8083,1,380684800,380684800,12121,4040,8081,4040,0,1,4042,1973281,1.973281
4440,2300,6040,13892000,2,35526,8883,1,407372800,407372800,13321,4440,8881,4440,0,1,4442,37729,0.037729
4840,2300,6040,13892000,2,38726,9683,1,434060800,434060800,14521,4840,9681,4840,0,1,4842,643950,0.64395
5240,2300,6040,13892000,2,41926,10483,1,460748800,460748800,15721,5240,10481,5240,0,1,5242,1260688,1.260688
5640,2300,6040,13892000,2,45126,11283,1,487436800,487436800,16921,5640,11281,5640,0,1,5642,3807844,3.807844
6040,2300,6040,13892000,2,48326,12083,1,514124800,514124800,18121,6040,12081,6040,0,1,6042,1923877,1.923877
6440,2300,6040,13892000,2,51526,12883,1,540812800,540812800,19321,6440,12881,6440,0,1,6442,239641,0.239641
6840,2300,6040,13892000,2,54726,13683,1,567500800,567500800,20521,6840,13681,6840,0,1,6842,3381846,3.381846
55,3805,3665,13945325,2,446,113,1,114849400,114849400,166,55,111,55,0,1,57,293710,0.29371
455,3805,3665,13945325,2,3646,913,1,138753400,138753400,1366,455,911,455,0,1,457,1353204,1.353204
855,3805,3665,13945325,2,6846,1713,1,162657400,162657400,2566,855,1711,855,0,1,857,2429028,2.429028
1255,3805,3665,13945325,2,10046,2513,1,186561400,186561400,3766,1255,2511,1255,0,1,1257,3519727,3.519727
1655,3805,3665,13945325,2,13246,3313,1,210465400,210465400,4966,1655,3311,1655,0,1,1657,3963708,3.963708
2055,3805,3665,13945325,2,16446,4113,1,234369400,234369400,6166,2055,4111,2055,0,1,2057,732754,0.732754
2455,3805,3665,13945325,2,19646,4913,1,258273400,258273400,7366,2455,4911,2455,0,1,2457,155186,0.155186
2855,3805,3665,13945325,2,22846,5713,1,282177400,282177400,8566,2855,5711,2855,0,1,2857,3047550,3.04755
3255,3805,3665,13945325,2,26046,6513,1,306081400,306081400,9766,3255,6511,3255,0,1,3257,854740,0.85474
3655,3805,3665,13945325,2,29246,7313,1,329985400,329985400,10966,3655,7311,3655,0,1,3657,735285,0.735285
4055,3805,3665,13945325,2,32446,8113,1,353889400,353889400,12166,4055,8111,4055,0,1,4057,1536974,1.536974
4455,3805,3665,13945325,2,35646,8913,1,377793400,377793400,13366,4455,8911,4455,0,1,4457,3620929,3.620929
4855,3805,3665,13945325,2,38846,9713,1,401697400,401697400,14566,4855,9711,4855,0,1,4857,1496446,1.496446
5255,3805,3665,13945325,2,42046,10513,1,425601400,425601400,15766,5255,10511,5255,0,1,5257,4017309,4.017309
5655,3805,3665,13945325,2,45246,11313,1,449505400,449505400,16966,5655,11311,5655,0,1,5657,2240274,2.240274
6055,3805,3665,13945325,2,48446,12113,1,473409400,473409400,18166,6055,12111,6055,0,1,6057,3699420,3.69942
6455,3805,3665,13945325,2,51646,12913,1,497313400,497313400,19366,6455,12911,6455,0,1,6457,3348205,3.348205
6855,3805,3665,13945325,2,54846,13713,1,521217400,521217400,20566,6855,13711,6855,0,1,6857,2769960,2.76996
55,3055,4565,13946075,2,446,113,1,114921400,114921400,166,55,111,55,0,1,57,20105,0.020105
455,3055,4565,13946075,2,3646,913,1,139305400,139305400,1366,455,911,455,0,1,457,54503,0.054503
855,3055,4565,13946075,2,6846,1713,1,163689400,163689400,2566,855,1711,855,0,1,857,53297,0.053297
1255,3055,4565,13946075,2,10046,2513,1,188073400,188073400,3766,1255,2511,1255,0,1,1257,52675,0.052675
1655,3055,4565,13946075,2,13246,3313,1,212457400,212457400,4966,1655,3311,1655,0,1,1657,798525,0.798525
2055,3055,4565,13946075,2,16446,4113,1,236841400,236841400,6166,2055,4111,2055,0,1,2057,212926,0.212926
2455,3055,4565,13946075,2,19646,4913,1,261225400,261225400,7366,2455,4911,2455,0,1,2457,2057273,2.057273
2855,3055,4565,13946075,2,22846,5713,1,285609400,285609400,8566,2855,5711,2855,0,1,2857,1275002,1.275002
3255,3055,4565,13946075,2,26046,6513,1,309993400,309993400,9766,3255,6511,3255,0,1,3257,437338,0.437338
3655,3055,4565,13946075,2,29246,7313,1,334377400,334377400,10966,3655,7311,3655,0,1,3657,60703,0.060703
4055,3055,4565,13946075,2,32446,8113,1,358761400,358761400,12166,4055,8111,4055,0,1,4057,178204,0.178204
4455,3055,4565,13946075,2,35646,8913,1,383145400,383145400,13366,4455,8911,4455,0,1,4457,48225,0.048225
4855,3055,4565,13946075,2,38846,9713,1,407529400,407529400,14566,4855,9711,4855,0,1,4857,36528,0.036528
5255,3055,4565,13946075,2,42046,10513,1,431913400,431913400,15766,5255,10511,5255,0,1,5257,622096,0.622096
5655,3055,4565,13946075,2,45246,11313,1,456297400,456297400,16966,5655,11311,5655,0,1,5657,3194974,3.194974
6055,3055,4565,13946075,2,48446,12113,1,480681400,480681400,18166,6055,12111,6055,0,1,6057,162282,0.162282
6455,3055,4565,13946075,2,51646,12913,1,505065400,505065400,19366,6455,12911,6455,0,1,6457,463537,0.463537
6855,3055,4565,13946075,2,54846,13713,1,529449400,529449400,20566,6855,13711,6855,0,1,6857,1798058,1.798058
55,4555,3065,13961075,2,446,113,1,115041400,115041400,166,55,111,55,0,1,57,284853,0.284853
455,4555,3065,13961075,2,3646,913,1,139425400,139425400,1366,455,911,455,0,1,457,593063,0.593063
855,4555,3065,13961075,2,6846,1713,1,163809400,163809400,2566,855,1711,855,0,1,857,81341,0.081341
1255,4555,3065,13961075,2,10046,2513,1,188193400,188193400,3766,1255,2511,1255,0,1,1257,2677087,2.677087
1655,4555,3065,13961075,2,13246,3313,1,212577400,212577400,4966,1655,3311,1655,0,1,1657,3555458,3.555458
2055,4555,3065,13961075,2,16446,4113,1,236961400,236961400,6166,2055,4111,2055,0,1,2057,5457278,5.457278
2455,4555,3065,13961075,2,19646,4913,1,261345400,261345400,7366,2455,4911,2455,0,1,2457,1959361,1.959361
2855,4555,3065,13961075,2,22846,5713,1,285729400,285729400,8566,2855,5711,2855,0,1,2857,1100885,1.100885
3255,4555,3065,13961075,2,26046,6513,1,310113400,310113400,9766,3255,6511,3255,0,1,3257,6818192,6.818192
3655,4555,3065,13961075,2,29246,7313,1,334497400,334497400,10966,3655,7311,3655,0,1,3657,1818630,1.81863
4055,4555,3065,13961075,2,32446,8113,1,358881400,358881400,12166,4055,8111,4055,0,1,4057,2149938,2.149938
4455,4555,3065,13961075,2,35646,8913,1,383265400,383265400,13366,4455,8911,4455,0,1,4457,72912,0.072912
4855,4555,3065,13961075,2,38846,9713,1,407649400,407649400,14566,4855,9711,4855,0,1,4857,1318055,1.318055
5255,4555,3065,13961075,2,42046,10513,1,432033400,432033400,15766,5255,10511,5255,0,1,5257,2686990,2.68699
5655,4555,3065,13961075,2,45246,11313,1,456417400,456417400,16966,5655,11311,5655,0,1,5657,804203,0.804203
6055,4555,3065,13961075,2,48446,12113,1,480801400,480801400,18166,6055,12111,6055,0,1,6057,4414998,4.414998
6455,4555,3065,13961075,2,51646,12913,1,505185400,505185400,19366,6455,12911,6455,0,1,6457,2176926,2.176926
6855,4555,3065,13961075,2,54846,13713,1,529569400,529569400,20566,6855,13711,6855,0,1,6857,8921537,8.921537
55,2555,5465,13963075,2,446,113,1,115233400,115233400,166,55,111,55,0,1,57,289064,0.289064
455,2555,5465,13963075,2,3646,913,1,140897400,140897400,1366,455,911,455,0,1,457,153932,0.153932
855,2555,5465,13963075,2,6846,1713,1,166561400,166561400,2566,855,1711,855,0,1,857,2323850,2.32385
1255,2555,5465,13963075,2,10046,2513,1,192225400,192225400,3766,1255,2511,1255,0,1,1257,1869554,1.869554
1655,2555,5465,13963075,2,13246,3313,1,217889400,217889400,4966,1655,3311,1655,0,1,1657,27845,0.027845
2055,2555,5465,13963075,2,16446,4113,1,243553400,243553400,6166,2055,4111,2055,0,1,2057,674360,0.67436
2455,2555,5465,13963075,2,19646,4913,1,269217400,269217400,7366,2455,4911,2455,0,1,2457,547121,0.547121
2855,2555,5465,13963075,2,22846,5713,1,294881400,294881400,8566,2855,5711,2855,0,1,2857,831678,0.831678
3255,2555,5465,13963075,2,26046,6513,1,320545400,320545400,9766,3255,6511,3255,0,1,3257,2497843,2.497843
3655,2555,5465,13963075,2,29246,7313,1,346209400,346209400,10966,3655,7311,3655,0,1,3657,3000682,3.000682
4055,2555,5465,13963075,2,32446,8113,1,371873400,371873400,12166,4055,8111,4055,0,1,4057,750274,0.750274
4455,2555,5465,13963075,2,35646,8913,1,397537400,397537400,13366,4455,8911,4455,0,1,4457,403164,0.403164
4855,2555,5465,13963075,2,38846,9713,1,423201400,423201400,14566,4855,9711,4855,0,1,4857,476112,0.476112
5255,2555,5465,13963075,2,42046,10513,1,448865400,448865400,15766,5255,10511,5255,0,1,5257,1695079,1.695079
5655,2555,5465,13963075,2,45246,11313,1,474529400,474529400,16966,5655,11311,5655,0,1,5657,1631257,1.631257
6055,2555,5465,13963075,2,48446,12113,1,500193400,500193400,18166,6055,12111,6055,0,1,6057,4369474,4.369474
6455,2555,5465,13963075,2,51646,12913,1,525857400,525857400,19366,6455,12911,6455,0,1,6457,446941,0.446941
6855,2555,5465,13963075,2,54846,13713,1,551521400,551521400,20566,6855,13711,6855,0,1,6857,202509,0.202509
55,5055,2765,13977075,2,446,113,1,115257400,115257400,166,55,111,55,0,1,57,27048,0.027048
455,5055,2765,13977075,2,3646,913,1,140281400,140281400,1366,455,911,455,0,1,457,26673,0.026673
855,5055,2765,13977075,2,6846,1713,1,165305400,165305400,2566,855,1711,855,0,1,857,391297,0.391297
1255,5055,2765,13977075,2,10046,2513,1,190329400,190329400,3766,1255,2511,1255,0,1,1257,186254,0.186254
1655,5055,2765,13977075,2,13246,3313,1,215353400,215353400,4966,1655,3311,1655,0,1,1657,877248,0.877248
2055,5055,2765,13977075,2,16446,4113,1,240377400,240377400,6166,2055,4111,2055,0,1,2057,195279,0.195279
2455,5055,2765,13977075,2,19646,4913,1,265401400,265401400,7366,2455,4911,2455,0,1,2457,391582,0.391582
2855,5055,2765,13977075,2,22846,5713,1,290425400,290425400,8566,2855,5711,2855,0,1,2857,259622,0.259622
3255,5055,2765,13977075,2,26046,6513,1,315449400,315449400,9766,3255,6511,3255,0,1,3257,971511,0.971511
3655,5055,2765,13977075,2,29246,7313,1,340473400,340473400,10966,3655,7311,3655,0,1,3657,517221,0.517221
4055,5055,2765,13977075,2,32446,8113,1,365497400,365497400,12166,4055,8111,4055,0,1,4057,380211,0.380211
4455,5055,2765,13977075,2,35646,8913,1,390521400,390521400,13366,4455,8911,4455,0,1,4457,3615417,3.615417
4855,5055,2765,13977075,2,38846,9713,1,415545400,415545400,14566,4855,9711,4855,0,1,4857,1473150,1.47315
5255,5055,2765,13977075,2,42046,10513,1,440569400,440569400,15766,5255,10511,5255,0,1,5257,585615,0.585615
5655,5055,2765,13977075,2,45246,11313,1,465593400,465593400,16966,5655,11311,5655,0,1,5657,635369,0.635369
6055,5055,2765,13977075,2,48446,12113,1,490617400,490617400,18166,6055,12111,6055,0,1,6057,209836,0.209836
6455,5055,2765,13977075,2,51646,12913,1,515641400,515641400,19366,6455,12911,6455,0,1,6457,1041477,1.041477
6855,5055,2765,13977075,2,54846,13713,1,540665400,540665400,20566,6855,13711,6855,0,1,6857,1947208,1.947208
55,2305,6065,13979825,2,446,113,1,115521400,115521400,166,55,111,55,0,1,57,279706,0.279706
455,2305,6065,13979825,2,3646,913,1,142305400,142305400,1366,455,911,455,0,1,457,1286888,1.286888
855,2305,6065,13979825,2,6846,1713,1,169089400,169089400,2566,855,1711,855,0,1,857,1712864,1.712864
1255,2305,6065,13979825,2,10046,2513,1,195873400,195873400,3766,1255,2511,1255,0,1,1257,2710233,2.710233
1655,2305,6065,13979825,2,13246,3313,1,222657400,222657400,4966,1655,3311,1655,0,1,1657,934497,0.934497
2055,2305,6065,13979825,2,16446,4113,1,249441400,249441400,6166,2055,4111,2055,0,1,2057,95066,0.095066
2455,2305,6065,13979825,2,19646,4913,1,276225400,276225400,7366,2455,4911,2455,0,1,2457,2585675,2.585675
2855,2305,6065,13979825,2,22846,5713,1,303009400,303009400,8566,2855,5711,2855,0,1,2857,58823,0.058823
3255,2305,6065,13979825,2,26046,6513,1,329793400,329793400,9766,3255,6511,3255,0,1,3257,836261,0.836261
3655,2305,6065,13979825,2,29246,7313,1,356577400,356577400,10966,3655,7311,3655,0,1,3657,2644969,2.644969
4055,2305,6065,13979825,2,32446,8113,1,383361400,383361400,12166,4055,8111,4055,0,1,4057,1450473,1.450473
4455,2305,6065,13979825,2,35646,8913,1,410145400,410145400,13366,4455,8911,4455,0,1,4457,5751754,5.751754
4855,2305,6065,13979825,2,38846,9713,1,436929400,436929400,14566,4855,9711,4855,0,1,4857,138278,0.138278
5255,2305,6065,13979825,2,42046,10513,1,463713400,463713400,15766,5255,10511,5255,0,1,5257,3757741,3.757741
5655,2305,6065,13979825,2,45246,11313,1,490497400,490497400,16966,5655,11311,5655,0,1,5657,494730,0.49473
6055,2305,6065,13979825,2,48446,12113,1,517281400,517281400,18166,6055,12111,6055,0,1,6057,2606779,2.606779
6455,2305,6065,13979825,2,51646,12913,1,544065400,544065400,19366,6455,12911,6455,0,1,6457,1505096,1.505096
6855,2305,6065,13979825,2,54846,13713,1,570849400,570849400,20566,6855,13711,6855,0,1,6857,708616,0.708616
40,3550,3940,13987000,2,326,83,1,114292800,114292800,121,40,81,40,0,1,42,244986,0.244986
440,3550,3940,13987000,2,3526,883,1,138260800,138260800,1321,440,881,440,0,1,442,1287190,1.28719
840,3550,3940,13987000,2,6726,1683,1,162228800,162228800,2521,840,1681,840,0,1,842,2349285,2.349285
1240,3550,3940,13987000,2,9926,2483,1,186196800,186196800,3721,1240,2481,1240,0,1,1242,32081,0.032081
1640,3550,3940,13987000,2,13126,3283,1,210164800,210164800,4921,1640,3281,1640,0,1,1642,2438488,2.438488
2040,3550,3940,13987000,2,16326,4083,1,234132800,234132800,6121,2040,4081,2040,0,1,2042,5532878,5.532878
2440,3550,3940,13987000,2,19526,4883,1,258100800,258100800,7321,2440,4881,2440,0,1,2442,285830,0.28583
2840,3550,3940,13987000,2,22726,5683,1,282068800,282068800,8521,2840,5681,2840,0,1,2842,1689853,1.689853
3240,3550,3940,13987000,2,25926,6483,1,306036800,306036800,9721,3240,6481,3240,0,1,3242,676062,0.676062
3640,3550,3940,13987000,2,29126,7283,1,330004800,330004800,10921,3640,7281,3640,0,1,3642,3140751,3.140751
4040,3550,3940,13987000,2,32326,8083,1,353972800,353972800,12121,4040,8081,4040,0,1,4042,3448604,3.448604
4440,3550,3940,13987000,2,35526,8883,1,377940800,377940800,13321,4440,8881,4440,0,1,4442,955930,0.95593
4840,3550,3940,13987000,2,38726,9683,1,401908800,401908800,14521,4840,9681,4840,0,1,4842,508236,0.508236
5240,3550,3940,13987000,2,41926,10483,1,425876800,425876800,15721,5240,10481,5240,0,1,5242,4633880,4.63388
5640,3550,3940,13987000,2,45126,11283,1,449844800,449844800,16921,5640,11281,5640,0,1,5642,4987179,4.987179
6040,3550,3940,13987000,2,48326,12083,1,473812800,473812800,18121,6040,12081,6040,0,1,6042,2090915,2.090915
6440,3550,3940,13987000,2,51526,12883,1,497780800,497780800,19321,6440,12881,6440,0,1,6442,3190402,3.190402
6840,3550,3940,13987000,2,54726,13683,1,521748800,521748800,20521,6840,13681,6840,0,1,6842,7651168,7.651168
40,3300,4240,13992000,2,326,83,1,114348800,114348800,121,40,81,40,0,1,42,241732,0.241732
440,3300,4240,13992000,2,3526,883,1,138476800,138476800,1321,440,881,440,0,1,442,1259242,1.259242
840,3300,4240,13992000,2,6726,1683,1,162604800,162604800,2521,840,1681,840,0,1,842,297962,0.297962
1240,3300,4240,13992000,2,9926,2483,1,186732800,186732800,3721,1240,2481,1240,0,1,1242,813897,0.813897
1640,3300,4240,13992000,2,13126,3283,1,210860800,210860800,4921,1640,3281,1640,0,1,1642,2812762,2.812762
2040,3300,4240,13992000,2,16326,4083,1,234988800,234988800,6121,2040,4081,2040,0,1,2042,1463523,1.463523
2440,3300,4240,13992000,2,19526,4883,1,259116800,259116800,7321,2440,4881,2440,0,1,2442,2400485,2.400485
2840,3300,4240,13992000,2,22726,5683,1,283244800,283244800,8521,2840,5681,2840,0,1,2842,1725481,1.725481
3240,3300,4240,13992000,2,25926,6483,1,307372800,307372800,9721,3240,6481,3240,0,1,3242,1254493,1.254493
3640,3300,4240,13992000,2,29126,7283,1,331500800,331500800,10921,3640,7281,3640,0,1,3642,4556826,4.556826
4040,3300,4240,13992000,2,32326,8083,1,355628800,355628800,12121,4040,8081,4040,0,1,4042,467766,0.467766
4440,3300,4240,13992000,2,35526,8883,1,379756800,379756800,13321,4440,8881,4440,0,1,4442,2316973,2.316973
4840,3300,4240,13992000,2,38726,9683,1,403884800,403884800,14521,4840,9681,4840,0,1,4842,1797072,1.797072
5240,3300,4240,13992000,2,41926,10483,1,428012800,428012800,15721,5240,10481,5240,0,1,5242,3860302,3.860302
5640,3300,4240,13992000,2,45126,11283,1,452140800,452140800,16921,5640,11281,5640,0,1,5642,34755,0.034755
6040,3300,4240,13992000,2,48326,12083,1,476268800,476268800,18121,6040,12081,6040,0,1,6042,2965208,2.965208
6440,3300,4240,13992000,2,51526,12883,1,500396800,500396800,19321,6440,12881,6440,0,1,6442,2802368,2.802368
6840,3300,4240,13992000,2,54726,13683,1,524524800,524524800,20521,6840,13681,6840,0,1,6842,52141,0.052141
35,5500,2545,13997500,2,286,73,1,114232600,114232600,106,35,71,35,0,1,37,100406,0.100406
535,5500,2545,13997500,2,4286,1073,1,146412600,146412600,1606,535,1071,535,0,1,537,350503,0.350503
1035,5500,2545,13997500,2,8286,2073,1,178592600,178592600,3106,1035,2071,1035,0,1,1037,492719,0.492719
1535,5500,2545,13997500,2,12286,3073,1,210772600,210772600,4606,1535,3071,1535,0,1,1537,560921,0.560921
2035,5500,2545,13997500,2,16286,4073,1,242952600,242952600,6106,2035,4071,2035,0,1,2037,77344,0.077344
2535,5500,2545,13997500,2,20286,5073,1,275132600,275132600,7606,2535,5071,2535,0,1,2537,3591175,3.591175
3035,5500,2545,13997500,2,24286,6073,1,307312600,307312600,9106,3035,6071,3035,0,1,3037,3982164,3.982164
3535,5500,2545,13997500,2,28286,7073,1,339492600,339492600,10606,3535,7071,3535,0,1,3537,1388984,1.388984
4035,5500,2545,13997500,2,32286,8073,1,371672600,371672600,12106,4035,8071,4035,0,1,4037,1463798,1.463798
4535,5500,2545,13997500,2,36286,9073,1,403852600,403852600,13606,4535,9071,4535,0,1,4537,364248,0.364248
5035,5500,2545,13997500,2,40286,10073,1,436032600,436032600,15106,5035,10071,5035,0,1,5037,76726,0.076726
5535,5500,2545,13997500,2,44286,11073,1,468212600,468212600,16606,5535,11071,5535,0,1,5537,4565469,4.565469
6035,5500,2545,13997500,2,48286,12073,1,500392600,500392600,18106,6035,12071,6035,0,1,6037,5668157,5.668157
6535,5500,2545,13997500,2,52286,13073,1,532572600,532572600,19606,6535,13071,6535,0,1,6537,636676,0.636676
7035,5500,2545,13997500,2,56286,14073,1,564752600,564752600,21106,7035,14071,7035,0,1,7037,18495589,18.495589
40,6550,2140,14017000,2,326,83,1,114916800,114916800,121,40,81,40,0,1,42,25854,0.025854
440,6550,2140,14017000,2,3526,883,1,142724800,142724800,1321,440,881,440,0,1,442,118375,0.118375
840,6550,2140,14017000,2,6726,1683,1,170532800,170532800,2521,840,1681,840,0,1,842,100332,0.100332
1240,6550,2140,14017000,2,9926,2483,1,198340800,198340800,3721,1240,2481,1240,0,1,1242,1117921,1.117921
1640,6550,2140,14017000,2,13126,3283,1,226148800,226148800,4921,1640,3281,1640,0,1,1642,318539,0.318539
2040,6550,2140,14017000,2,16326,4083,1,253956800,253956800,6121,2040,4081,2040,0,1,2042,264851,0.264851
2440,6550,2140,14017000,2,19526,4883,1,281764800,281764800,7321,2440,4881,2440,0,1,2442,1843930,1.84393
2840,6550,2140,14017000,2,22726,5683,1,309572800,309572800,8521,2840,5681,2840,0,1,2842,66044,0.066044
3240,6550,2140,14017000,2,25926,6483,1,337380800,337380800,9721,3240,6481,3240,0,1,3242,2914611,2.914611
3640,6550,2140,14017000,2,29126,7283,1,365188800,365188800,10921,3640,7281,3640,0,1,3642,447039,0.447039
4040,6550,2140,14017000,2,32326,8083,1,392996800,392996800,12121,4040,8081,4040,0,1,4042,303529,0.303529
4440,6550,2140,14017000,2,35526,8883,1,420804800,420804800,13321,4440,8881,4440,0,1,4442,283334,0.283334
4840,6550,2140,14017000,2,38726,9683,1,448612800,448612800,14521,4840,9681,4840,0,1,4842,244017,0.244017
5240,6550,2140,14017000,2,41926,10483,1,476420800,476420800,15721,5240,10481,5240,0,1,5242,1770587,1.770587
5640,6550,2140,14017000,2,45126,11283,1,504228800,504228800,16921,5640,11281,5640,0,1,5642,441556,0.441556
6040,6550,2140,14017000,2,48326,12083,1,532036800,532036800,18121,6040,12081,6040,0,1,6042,640039,0.640039
6440,6550,2140,14017000,2,51526,12883,1,559844800,559844800,19321,6440,12881,6440,0,1,6442,1057739,1.057739
6840,6550,2140,14017000,2,54726,13683,1,587652800,587652800,20521,6840,13681,6840,0,1,6842,853999,0.853999
39,2793,5041,14079513,2,318,81,1,115080312,115080312,118,39,79,39,0,1,41,259405,0.259405
539,2793,5041,14079513,2,4318,1081,1,146416312,146416312,1618,539,1079,539,0,1,541,1059534,1.059534
1039,2793,5041,14079513,2,8318,2081,1,177752312,177752312,3118,1039,2079,1039,0,1,1041,2265291,2.265291
1539,2793,5041,14079513,2,12318,3081,1,209088312,209088312,4618,1539,3079,1539,0,1,1541,2547000,2.547
2039,2793,5041,14079513,2,16318,4081,1,240424312,240424312,6118,2039,4079,2039,0,1,2041,219029,0.219029
2539,2793,5041,14079513,2,20318,5081,1,271760312,271760312,7618,2539,5079,2539,0,1,2541,2526918,2.526918
3039,2793,5041,14079513,2,24318,6081,1,303096312,303096312,9118,3039,6079,3039,0,1,3041,1119499,1.119499
3539,2793,5041,14079513,2,28318,7081,1,334432312,334432312,10618,3539,7079,3539,0,1,3541,2693130,2.69313
4039,2793,5041,14079513,2,32318,8081,1,365768312,365768312,12118,4039,8079,4039,0,1,4041,4834670,4.83467
4539,2793,5041,14079513,2,36318,9081,1,397104312,397104312,13618,4539,9079,4539,0,1,4541,2394668,2.394668
5039,2793,5041,14079513,2,40318,10081,1,428440312,428440312,15118,5039,10079,5039,0,1,5041,553030,0.55303
5539,2793,5041,14079513,2,44318,11081,1,459776312,459776312,16618,5539,11079,5539,0,1,5541,491146,0.491146
6039,2793,5041,14079513,2,48318,12081,1,491112312,491112312,18118,6039,12079,6039,0,1,6041,1475090,1.47509
6539,2793,5041,14079513,2,52318,13081,1,522448312,522448312,19618,6539,13079,6539,0,1,6541,2991907,2.991907
7039,2793,5041,14079513,2,56318,14081,1,553784312,553784312,21118,7039,14079,7039,0,1,7041,2125277,2.125277
39,5543,2541,14084763,2,318,81,1,115200312,115200312,118,39,79,39,0,1,41,26917,0.026917
539,5543,2541,14084763,2,4318,1081,1,147536312,147536312,1618,539,1079,539,0,1,541,36594,0.036594
1039,5543,2541,14084763,2,8318,2081,1,179872312,179872312,3118,1039,2079,1039,0,1,1041,94544,0.094544
1539,5543,2541,14084763,2,12318,3081,1,212208312,212208312,4618,1539,3079,1539,0,1,1541,209938,0.209938
2039,5543,2541,14084763,2,16318,4081,1,244544312,244544312,6118,2039,4079,2039,0,1,2041,771413,0.771413
2539,5543,2541,14084763,2,20318,5081,1,276880312,276880312,7618,2539,5079,2539,0,1,2541,15088,0.015088
3039,5543,2541,14084763,2,24318,6081,1,309216312,309216312,9118,3039,6079,3039,0,1,3041,49381,0.049381
3539,5543,2541,14084763,2,28318,7081,1,341552312,341552312,10618,3539,7079,3539,0,1,3541,1472171,1.472171
4039,5543,2541,14084763,2,32318,8081,1,373888312,373888312,12118,4039,8079,4039,0,1,4041,610927,0.610927
4539,5543,2541,14084763,2,36318,9081,1,406224312,406224312,13618,4539,9079,4539,0,1,4541,955,0.000955
5039,5543,2541,14084763,2,40318,10081,1,438560312,438560312,15118,5039,10079,5039,0,1,5041,1007447,1.007447
5539,5543,2541,14084763,2,44318,11081,1,470896312,470896312,16618,5539,11079,5539,0,1,5541,4790638,4.790638
6039,5543,2541,14084763,2,48318,12081,1,503232312,503232312,18118,6039,12079,6039,0,1,6041,719551,0.719551
6539,5543,2541,14084763,2,52318,13081,1,535568312,535568312,19618,6539,13079,6539,0,1,6541,316513,0.316513
7039,5543,2541,14084763,2,56318,14081,1,567904312,567904312,21118,7039,14079,7039,0,1,7041,3183828,3.183828
55,3555,3965,14095575,2,446,113,1,116073400,116073400,166,55,111,55,0,1,57,291575,0.291575
455,3555,3965,14095575,2,3646,913,1,140137400,140137400,1366,455,911,455,0,1,457,1141429,1.141429
855,3555,3965,14095575,2,6846,1713,1,164201400,164201400,2566,855,1711,855,0,1,857,1182280,1.18228
1255,3555,3965,14095575,2,10046,2513,1,188265400,188265400,3766,1255,2511,1255,0,1,1257,1632620,1.63262
1655,3555,3965,14095575,2,13246,3313,1,212329400,212329400,4966,1655,3311,1655,0,1,1657,2951970,2.95197
2055,3555,3965,14095575,2,16446,4113,1,236393400,236393400,6166,2055,4111,2055,0,1,2057,647951,0.647951
2455,3555,3965,14095575,2,19646,4913,1,260457400,260457400,7366,2455,4911,2455,0,1,2457,1191563,1.191563
2855,3555,3965,14095575,2,22846,5713,1,284521400,284521400,8566,2855,5711,2855,0,1,2857,517048,0.517048
3255,3555,3965,14095575,2,26046,6513,1,308585400,308585400,9766,3255,6511,3255,0,1,3257,835584,0.835584
3655,3555,3965,14095575,2,29246,7313,1,332649400,332649400,10966,3655,7311,3655,0,1,3657,658024,0.658024
4055,3555,3965,14095575,2,32446,8113,1,356713400,356713400,12166,4055,8111,4055,0,1,4057,349447,0.349447
4455,3555,3965,14095575,2,35646,8913,1,380777400,380777400,13366,4455,8911,4455,0,1,4457,2596999,2.596999
4855,3555,3965,14095575,2,38846,9713,1,404841400,404841400,14566,4855,9711,4855,0,1,4857,669706,0.669706
5255,3555,3965,14095575,2,42046,10513,1,428905400,428905400,15766,5255,10511,5255,0,1,5257,295713,0.295713
5655,3555,3965,14095575,2,45246,11313,1,452969400,452969400,16966,5655,11311,5655,0,1,5657,4077826,4.077826
6055,3555,3965,14095575,2,48446,12113,1,477033400,477033400,18166,6055,12111,6055,0,1,6057,809659,0.809659
6455,3555,3965,14095575,2,51646,12913,1,501097400,501097400,19366,6455,12911,6455,0,1,6457,2113452,2.113452
6855,3555,3965,14095575,2,54846,13713,1,525161400,525161400,20566,6855,13711,6855,0,1,6857,594738,0.594738
55,3305,4265,14095825,2,446,113,1,116097400,116097400,166,55,111,55,0,1,57,39769,0.039769
455,3305,4265,14095825,2,3646,913,1,140321400,140321400,1366,455,911,455,0,1,457,471376,0.471376
855,3305,4265,14095825,2,6846,1713,1,164545400,164545400,2566,855,1711,855,0,1,857,782079,0.782079
1255,3305,4265,14095825,2,10046,2513,1,188769400,188769400,3766,1255,2511,1255,0,1,1257,796817,0.796817
1655,3305,4265,14095825,2,13246,3313,1,212993400,212993400,4966,1655,3311,1655,0,1,1657,4589472,4.589472
2055,3305,4265,14095825,2,16446,4113,1,237217400,237217400,6166,2055,4111,2055,0,1,2057,168294,0.168294
2455,3305,4265,14095825,2,19646,4913,1,261441400,261441400,7366,2455,4911,2455,0,1,2457,125173,0.125173
2855,3305,4265,14095825,2,22846,5713,1,285665400,285665400,8566,2855,5711,2855,0,1,2857,813876,0.813876
3255,3305,4265,14095825,2,26046,6513,1,309889400,309889400,9766,3255,6511,3255,0,1,3257,2010072,2.010072
3655,3305,4265,14095825,2,29246,7313,1,334113400,334113400,10966,3655,7311,3655,0,1,3657,556664,0.556664
4055,3305,4265,14095825,2,32446,8113,1,358337400,358337400,12166,4055,8111,4055,0,1,4057,582772,0.582772
4455,3305,4265,14095825,2,35646,8913,1,382561400,382561400,13366,4455,8911,4455,0,1,4457,891981,0.891981
4855,3305,4265,14095825,2,38846,9713,1,406785400,406785400,14566,4855,9711,4855,0,1,4857,3104321,3.104321
5255,3305,4265,14095825,2,42046,10513,1,431009400,431009400,15766,5255,10511,5255,0,1,5257,809659,0.809659
5655,3305,4265,14095825,2,45246,11313,1,455233400,455233400,16966,5655,11311,5655,0,1,5657,191095,0.191095
6055,3305,4265,14095825,2,48446,12113,1,479457400,479457400,18166,6055,12111,6055,0,1,6057,830593,0.830593
6455,3305,4265,14095825,2,51646,12913,1,503681400,503681400,19366,6455,12911,6455,0,1,6457,1094392,1.094392
6855,3305,4265,14095825,2,54846,13713,1,527905400,527905400,20566,6855,13711,6855,0,1,6857,173515,0.173515
35,5540,2545,14099300,2,286,73,1,115058200,115058200,106,35,71,35,0,1,37,216512,0.216512
535,5540,2545,14099300,2,4286,1073,1,147398200,147398200,1606,535,1071,535,0,1,537,545058,0.545058
1035,5540,2545,14099300,2,8286,2073,1,179738200,179738200,3106,1035,2071,1035,0,1,1037,1633513,1.633513
1535,5540,2545,14099300,2,12286,3073,1,212078200,212078200,4606,1535,3071,1535,0,1,1537,4154354,4.154354
40,5800,2440,14152000,2,326,83,1,115852800,115852800,121,40,81,40,0,1,42,13200,0.0132
440,5800,2440,14152000,2,3526,883,1,142220800,142220800,1321,440,881,440,0,1,442,479,0.000479
840,5800,2440,14152000,2,6726,1683,1,168588800,168588800,2521,840,1681,840,0,1,842,129326,0.129326
1240,5800,2440,14152000,2,9926,2483,1,194956800,194956800,3721,1240,2481,1240,0,1,1242,12120,0.01212
1640,5800,2440,14152000,2,13126,3283,1,221324800,221324800,4921,1640,3281,1640,0,1,1642,288484,0.288484
2040,5800,2440,14152000,2,16326,4083,1,247692800,247692800,6121,2040,4081,2040,0,1,2042,13770,0.01377
2440,5800,2440,14152000,2,19526,4883,1,274060800,274060800,7321,2440,4881,2440,0,1,2442,597341,0.597341
2840,5800,2440,14152000,2,22726,5683,1,300428800,300428800,8521,2840,5681,2840,0,1,2842,1054115,1.054115
3240,5800,2440,14152000,2,25926,6483,1,326796800,326796800,9721,3240,6481,3240,0,1,3242,867713,0.867713
3640,5800,2440,14152000,2,29126,7283,1,353164800,353164800,10921,3640,7281,3640,0,1,3642,201471,0.201471
4040,5800,2440,14152000,2,32326,8083,1,379532800,379532800,12121,4040,8081,4040,0,1,4042,545946,0.545946
4440,5800,2440,14152000,2,35526,8883,1,405900800,405900800,13321,4440,8881,4440,0,1,4442,1136647,1.136647
4840,5800,2440,14152000,2,38726,9683,1,432268800,432268800,14521,4840,9681,4840,0,1,4842,2412278,2.412278
5240,5800,2440,14152000,2,41926,10483,1,458636800,458636800,15721,5240,10481,5240,0,1,5242,5169472,5.169472
5640,5800,2440,14152000,2,45126,11283,1,485004800,485004800,16921,5640,11281,5640,0,1,5642,743507,0.743507
6040,5800,2440,14152000,2,48326,12083,1,511372800,511372800,18121,6040,12081,6040,0,1,6042,1302255,1.302255
6440,5800,2440,14152000,2,51526,12883,1,537740800,537740800,19321,6440,12881,6440,0,1,6442,28477,0.028477
6840,5800,2440,14152000,2,54726,13683,1,564108800,564108800,20521,6840,13681,6840,0,1,6842,1894797,1.894797
44,2803,5055,14169165,2,358,91,1,116119336,116119336,133,44,89,44,0,1,46,211379,0.211379
544,2803,5055,14169165,2,4358,1091,1,147551336,147551336,1633,544,1089,544,0,1,546,1540676,1.540676
1044,2803,5055,14169165,2,8358,2091,1,178983336,178983336,3133,1044,2089,1044,0,1,1046,2844876,2.844876
1544,2803,5055,14169165,2,12358,3091,1,210415336,210415336,4633,1544,3089,1544,0,1,1546,158764,0.158764
2044,2803,5055,14169165,2,16358,4091,1,241847336,241847336,6133,2044,4089,2044,0,1,2046,2105993,2.105993
2544,2803,5055,14169165,2,20358,5091,1,273279336,273279336,7633,2544,5089,2544,0,1,2546,762346,0.762346
3044,2803,5055,14169165,2,24358,6091,1,304711336,304711336,9133,3044,6089,3044,0,1,3046,2699228,2.699228
3544,2803,5055,14169165,2,28358,7091,1,336143336,336143336,10633,3544,7089,3544,0,1,3546,6356563,6.356563
4044,2803,5055,14169165,2,32358,8091,1,367575336,367575336,12133,4044,8089,4044,0,1,4046,1425198,1.425198
4544,2803,5055,14169165,2,36358,9091,1,399007336,399007336,13633,4544,9089,4544,0,1,4546,3210672,3.210672
5044,2803,5055,14169165,2,40358,10091,1,430439336,430439336,15133,5044,10089,5044,0,1,5046,2869795,2.869795
5544,2803,5055,14169165,2,44358,11091,1,461871336,461871336,16633,5544,11089,5544,0,1,5546,490462,0.490462
6044,2803,5055,14169165,2,48358,12091,1,493303336,493303336,18133,6044,12089,6044,0,1,6046,1913087,1.913087
6544,2803,5055,14169165,2,52358,13091,1,524735336,524735336,19633,6544,13089,6544,0,1,6546,283837,0.283837
7044,2803,5055,14169165,2,56358,14091,1,556167336,556167336,21133,7044,14089,7044,0,1,7046,6145099,6.145099
44,5553,2555,14187915,2,358,91,1,116357336,116357336,133,44,89,44,0,1,46,20096,0.020096
544,5553,2555,14187915,2,4358,1091,1,148789336,148789336,1633,544,1089,544,0,1,546,35030,0.03503
1044,5553,2555,14187915,2,8358,2091,1,181221336,181221336,3133,1044,2089,1044,0,1,1046,399651,0.399651
1544,5553,2555,14187915,2,12358,3091,1,213653336,213653336,4633,1544,3089,1544,0,1,1546,613171,0.613171
2044,5553,2555,14187915,2,16358,4091,1,246085336,246085336,6133,2044,4089,2044,0,1,2046,488100,0.4881
2544,5553,2555,14187915,2,20358,5091,1,278517336,278517336,7633,2544,5089,2544,0,1,2546,240513,0.240513
3044,5553,2555,14187915,2,24358,6091,1,310949336,310949336,9133,3044,6089,3044,0,1,3046,2184069,2.184069
3544,5553,2555,14187915,2,28358,7091,1,343381336,343381336,10633,3544,7089,3544,0,1,3546,707291,0.707291
4044,5553,2555,14187915,2,32358,8091,1,375813336,375813336,12133,4044,8089,4044,0,1,4046,1185260,1.18526
4544,5553,2555,14187915,2,36358,9091,1,408245336,408245336,13633,4544,9089,4544,0,1,4546,3617638,3.617638
5044,5553,2555,14187915,2,40358,10091,1,440677336,440677336,15133,5044,10089,5044,0,1,5046,1674343,1.674343
5544,5553,2555,14187915,2,44358,11091,1,473109336,473109336,16633,5544,11089,5544,0,1,5546,605632,0.605632
6044,5553,2555,14187915,2,48358,12091,1,505541336,505541336,18133,6044,12089,6044,0,1,6046,1313346,1.313346
6544,5553,2555,14187915,2,52358,13091,1,537973336,537973336,19633,6544,13089,6544,0,1,6546,726179,0.726179
7044,5553,2555,14187915,2,56358,14091,1,570405336,570405336,21133,7044,14089,7044,0,1,7046,2635267,2.635267
55,6555,2165,14191575,2,446,113,1,117369400,117369400,166,55,111,55,0,1,57,10840,0.01084
455,6555,2165,14191575,2,3646,913,1,145273400,145273400,1366,455,911,455,0,1,457,66223,0.066223
855,6555,2165,14191575,2,6846,1713,1,173177400,173177400,2566,855,1711,855,0,1,857,47055,0.047055
1255,6555,2165,14191575,2,10046,2513,1,201081400,201081400,3766,1255,2511,1255,0,1,1257,26834,0.026834
1655,6555,2165,14191575,2,13246,3313,1,228985400,228985400,4966,1655,3311,1655,0,1,1657,944373,0.944373
2055,6555,2165,14191575,2,16446,4113,1,256889400,256889400,6166,2055,4111,2055,0,1,2057,41528,0.041528
2455,6555,2165,14191575,2,19646,4913,1,284793400,284793400,7366,2455,4911,2455,0,1,2457,2239729,2.239729
2855,6555,2165,14191575,2,22846,5713,1,312697400,312697400,8566,2855,5711,2855,0,1,2857,55684,0.055684
3255,6555,2165,14191575,2,26046,6513,1,340601400,340601400,9766,3255,6511,3255,0,1,3257,889854,0.889854
3655,6555,2165,14191575,2,29246,7313,1,368505400,368505400,10966,3655,7311,3655,0,1,3657,446380,0.44638
4055,6555,2165,14191575,2,32446,8113,1,396409400,396409400,12166,4055,8111,4055,0,1,4057,485955,0.485955
4455,6555,2165,14191575,2,35646,8913,1,424313400,424313400,13366,4455,8911,4455,0,1,4457,96188,0.096188
4855,6555,2165,14191575,2,38846,9713,1,452217400,452217400,14566,4855,9711,4855,0,1,4857,3189593,3.189593
5255,6555,2165,14191575,2,42046,10513,1,480121400,480121400,15766,5255,10511,5255,0,1,5257,2178446,2.178446
5655,6555,2165,14191575,2,45246,11313,1,508025400,508025400,16966,5655,11311,5655,0,1,5657,1002167,1.002167
6055,6555,2165,14191575,2,48446,12113,1,535929400,535929400,18166,6055,12111,6055,0,1,6057,68820,0.06882
6455,6555,2165,14191575,2,51646,12913,1,563833400,563833400,19366,6455,12911,6455,0,1,6457,1511698,1.511698
6855,6555,2165,14191575,2,54846,13713,1,591737400,591737400,20566,6855,13711,6855,0,1,6857,3054275,3.054275
40,2050,6940,14227000,2,326,83,1,116692800,116692800,121,40,81,40,0,1,42,41009,0.041009
440,2050,6940,14227000,2,3526,883,1,145460800,145460800,1321,440,881,440,0,1,442,25665,0.025665
840,2050,6940,14227000,2,6726,1683,1,174228800,174228800,2521,840,1681,840,0,1,842,111328,0.111328
1240,2050,6940,14227000,2,9926,2483,1,202996800,202996800,3721,1240,2481,1240,0,1,1242,18387,0.018387
1640,2050,6940,14227000,2,13126,3283,1,231764800,231764800,4921,1640,3281,1640,0,1,1642,109525,0.109525
2040,2050,6940,14227000,2,16326,4083,1,260532800,260532800,6121,2040,4081,2040,0,1,2042,517437,0.517437
2440,2050,6940,14227000,2,19526,4883,1,289300800,289300800,7321,2440,4881,2440,0,1,2442,497052,0.497052
2840,2050,6940,14227000,2,22726,5683,1,318068800,318068800,8521,2840,5681,2840,0,1,2842,312969,0.312969
3240,2050,6940,14227000,2,25926,6483,1,346836800,346836800,9721,3240,6481,3240,0,1,3242,246054,0.246054
3640,2050,6940,14227000,2,29126,7283,1,375604800,375604800,10921,3640,7281,3640,0,1,3642,103760,0.10376
4040,2050,6940,14227000,2,32326,8083,1,404372800,404372800,12121,4040,8081,4040,0,1,4042,1045796,1.045796
4440,2050,6940,14227000,2,35526,8883,1,433140800,433140800,13321,4440,8881,4440,0,1,4442,1003632,1.003632
4840,2050,6940,14227000,2,38726,9683,1,461908800,461908800,14521,4840,9681,4840,0,1,4842,904088,0.904088
5240,2050,6940,14227000,2,41926,10483,1,490676800,490676800,15721,5240,10481,5240,0,1,5242,236121,0.236121
5640,2050,6940,14227000,2,45126,11283,1,519444800,519444800,16921,5640,11281,5640,0,1,5642,440292,0.440292
6040,2050,6940,14227000,2,48326,12083,1,548212800,548212800,18121,6040,12081,6040,0,1,6042,667029,0.667029
6440,2050,6940,14227000,2,51526,12883,1,576980800,576980800,19321,6440,12881,6440,0,1,6442,3367605,3.367605
6840,2050,6940,14227000,2,54726,13683,1,605748800,605748800,20521,6840,13681,6840,0,1,6842,634641,0.634641
55,5805,2465,14309325,2,446,113,1,118113400,118113400,166,55,111,55,0,1,57,20196,0.020196
455,5805,2465,14309325,2,3646,913,1,144577400,144577400,1366,455,911,455,0,1,457,69716,0.069716
855,5805,2465,14309325,2,6846,1713,1,171041400,171041400,2566,855,1711,855,0,1,857,25600,0.0256
1255,5805,2465,14309325,2,10046,2513,1,197505400,197505400,3766,1255,2511,1255,0,1,1257,185900,0.1859
1655,5805,2465,14309325,2,13246,3313,1,223969400,223969400,4966,1655,3311,1655,0,1,1657,207525,0.207525
2055,5805,2465,14309325,2,16446,4113,1,250433400,250433400,6166,2055,4111,2055,0,1,2057,863922,0.863922
2455,5805,2465,14309325,2,19646,4913,1,276897400,276897400,7366,2455,4911,2455,0,1,2457,2876232,2.876232
2855,5805,2465,14309325,2,22846,5713,1,303361400,303361400,8566,2855,5711,2855,0,1,2857,201402,0.201402
3255,5805,2465,14309325,2,26046,6513,1,329825400,329825400,9766,3255,6511,3255,0,1,3257,1508689,1.508689
3655,5805,2465,14309325,2,29246,7313,1,356289400,356289400,10966,3655,7311,3655,0,1,3657,852886,0.852886
4055,5805,2465,14309325,2,32446,8113,1,382753400,382753400,12166,4055,8111,4055,0,1,4057,381072,0.381072
4455,5805,2465,14309325,2,35646,8913,1,409217400,409217400,13366,4455,8911,4455,0,1,4457,929357,0.929357
4855,5805,2465,14309325,2,38846,9713,1,435681400,435681400,14566,4855,9711,4855,0,1,4857,748152,0.748152
5255,5805,2465,14309325,2,42046,10513,1,462145400,462145400,15766,5255,10511,5255,0,1,5257,387578,0.387578
5655,5805,2465,14309325,2,45246,11313,1,488609400,488609400,16966,5655,11311,5655,0,1,5657,2796929,2.796929
6055,5805,2465,14309325,2,48446,12113,1,515073400,515073400,18166,6055,12111,6055,0,1,6057,342731,0.342731
6455,5805,2465,14309325,2,51646,12913,1,541537400,541537400,19366,6455,12911,6455,0,1,6457,1117365,1.117365
6855,5805,2465,14309325,2,54846,13713,1,568001400,568001400,20566,6855,13711,6855,0,1,6857,1906305,1.906305
55,2055,6965,14313075,2,446,113,1,118473400,118473400,166,55,111,55,0,1,57,10269,0.010269
455,2055,6965,14313075,2,3646,913,1,147337400,147337400,1366,455,911,455,0,1,457,120072,0.120072
855,2055,6965,14313075,2,6846,1713,1,176201400,176201400,2566,855,1711,855,0,1,857,111139,0.111139
1255,2055,6965,14313075,2,10046,2513,1,205065400,205065400,3766,1255,2511,1255,0,1,1257,127070,0.12707
1655,2055,6965,14313075,2,13246,3313,1,233929400,233929400,4966,1655,3311,1655,0,1,1657,398132,0.398132
2055,2055,6965,14313075,2,16446,4113,1,262793400,262793400,6166,2055,4111,2055,0,1,2057,185843,0.185843
2455,2055,6965,14313075,2,19646,4913,1,291657400,291657400,7366,2455,4911,2455,0,1,2457,158969,0.158969
2855,2055,6965,14313075,2,22846,5713,1,320521400,320521400,8566,2855,5711,2855,0,1,2857,1333428,1.333428
3255,2055,6965,14313075,2,26046,6513,1,349385400,349385400,9766,3255,6511,3255,0,1,3257,133352,0.133352
3655,2055,6965,14313075,2,29246,7313,1,378249400,378249400,10966,3655,7311,3655,0,1,3657,1175522,1.175522
4055,2055,6965,14313075,2,32446,8113,1,407113400,407113400,12166,4055,8111,4055,0,1,4057,1361105,1.361105
4455,2055,6965,14313075,2,35646,8913,1,435977400,435977400,13366,4455,8911,4455,0,1,4457,1348048,1.348048
4855,2055,6965,14313075,2,38846,9713,1,464841400,464841400,14566,4855,9711,4855,0,1,4857,207536,0.207536
5255,2055,6965,14313075,2,42046,10513,1,493705400,493705400,15766,5255,10511,5255,0,1,5257,995983,0.995983
5655,2055,6965,14313075,2,45246,11313,1,522569400,522569400,16966,5655,11311,5655,0,1,5657,1013128,1.013128
6055,2055,6965,14313075,2,48446,12113,1,551433400,551433400,18166,6055,12111,6055,0,1,6057,1521187,1.521187
6455,2055,6965,14313075,2,51646,12913,1,580297400,580297400,19366,6455,12911,6455,0,1,6457,1220412,1.220412
6855,2055,6965,14313075,2,54846,13713,1,609161400,609161400,20566,6855,13711,6855,0,1,6857,714822,0.714822
40,4300,3340,14362000,2,326,83,1,117340800,117340800,121,40,81,40,0,1,42,106872,0.106872
440,4300,3340,14362000,2,3526,883,1,141788800,141788800,1321,440,881,440,0,1,442,1291733,1.291733
840,4300,3340,14362000,2,6726,1683,1,166236800,166236800,2521,840,1681,840,0,1,842,590663,0.590663
1240,4300,3340,14362000,2,9926,2483,1,190684800,190684800,3721,1240,2481,1240,0,1,1242,1144327,1.144327
1640,4300,3340,14362000,2,13126,3283,1,215132800,215132800,4921,1640,3281,1640,0,1,1642,1393317,1.393317
2040,4300,3340,14362000,2,16326,4083,1,239580800,239580800,6121,2040,4081,2040,0,1,2042,64639,0.064639
2440,4300,3340,14362000,2,19526,4883,1,264028800,264028800,7321,2440,4881,2440,0,1,2442,358841,0.358841
2840,4300,3340,14362000,2,22726,5683,1,288476800,288476800,8521,2840,5681,2840,0,1,2842,2916869,2.916869
3240,4300,3340,14362000,2,25926,6483,1,312924800,312924800,9721,3240,6481,3240,0,1,3242,2470401,2.470401
3640,4300,3340,14362000,2,29126,7283,1,337372800,337372800,10921,3640,7281,3640,0,1,3642,3095912,3.095912
4040,4300,3340,14362000,2,32326,8083,1,361820800,361820800,12121,4040,8081,4040,0,1,4042,769584,0.769584
4440,4300,3340,14362000,2,35526,8883,1,386268800,386268800,13321,4440,8881,4440,0,1,4442,3867059,3.867059
4840,4300,3340,14362000,2,38726,9683,1,410716800,410716800,14521,4840,9681,4840,0,1,4842,2919214,2.919214
5240,4300,3340,14362000,2,41926,10483,1,435164800,435164800,15721,5240,10481,5240,0,1,5242,3091541,3.091541
5640,4300,3340,14362000,2,45126,11283,1,459612800,459612800,16921,5640,11281,5640,0,1,5642,954464,0.954464
6040,4300,3340,14362000,2,48326,12083,1,484060800,484060800,18121,6040,12081,6040,0,1,6042,626851,0.626851
6440,4300,3340,14362000,2,51526,12883,1,508508800,508508800,19321,6440,12881,6440,0,1,6442,1338740,1.33874
6840,4300,3340,14362000,2,54726,13683,1,532956800,532956800,20521,6840,13681,6840,0,1,6842,1167197,1.167197
40,2800,5140,14392000,2,326,83,1,117676800,117676800,121,40,81,40,0,1,42,58774,0.058774
440,2800,5140,14392000,2,3526,883,1,143084800,143084800,1321,440,881,440,0,1,442,1295025,1.295025
840,2800,5140,14392000,2,6726,1683,1,168492800,168492800,2521,840,1681,840,0,1,842,1239275,1.239275
1240,2800,5140,14392000,2,9926,2483,1,193900800,193900800,3721,1240,2481,1240,0,1,1242,278591,0.278591
1640,2800,5140,14392000,2,13126,3283,1,219308800,219308800,4921,1640,3281,1640,0,1,1642,584109,0.584109
2040,2800,5140,14392000,2,16326,4083,1,244716800,244716800,6121,2040,4081,2040,0,1,2042,2361047,2.361047
2440,2800,5140,14392000,2,19526,4883,1,270124800,270124800,7321,2440,4881,2440,0,1,2442,1602532,1.602532
2840,2800,5140,14392000,2,22726,5683,1,295532800,295532800,8521,2840,5681,2840,0,1,2842,2870720,2.87072
3240,2800,5140,14392000,2,25926,6483,1,320940800,320940800,9721,3240,6481,3240,0,1,3242,104977,0.104977
3640,2800,5140,14392000,2,29126,7283,1,346348800,346348800,10921,3640,7281,3640,0,1,3642,93332,0.093332
4040,2800,5140,14392000,2,32326,8083,1,371756800,371756800,12121,4040,8081,4040,0,1,4042,4644421,4.644421
4440,2800,5140,14392000,2,35526,8883,1,397164800,397164800,13321,4440,8881,4440,0,1,4442,3391599,3.391599
4840,2800,5140,14392000,2,38726,9683,1,422572800,422572800,14521,4840,9681,4840,0,1,4842,7648928,7.648928
5240,2800,5140,14392000,2,41926,10483,1,447980800,447980800,15721,5240,10481,5240,0,1,5242,2480294,2.480294
5640,2800,5140,14392000,2,45126,11283,1,473388800,473388800,16921,5640,11281,5640,0,1,5642,111462,0.111462
6040,2800,5140,14392000,2,48326,12083,1,498796800,498796800,18121,6040,12081,6040,0,1,6042,1398169,1.398169
6440,2800,5140,14392000,2,51526,12883,1,524204800,524204800,19321,6440,12881,6440,0,1,6442,1713165,1.713165
6840,2800,5140,14392000,2,54726,13683,1,549612800,549612800,20521,6840,13681,6840,0,1,6842,12276474,12.276474
55,4305,3365,14486325,2,446,113,1,119265400,119265400,166,55,111,55,0,1,57,288602,0.288602
455,4305,3365,14486325,2,3646,913,1,143809400,143809400,1366,455,911,455,0,1,457,188722,0.188722
855,4305,3365,14486325,2,6846,1713,1,168353400,168353400,2566,855,1711,855,0,1,857,485148,0.485148
1255,4305,3365,14486325,2,10046,2513,1,192897400,192897400,3766,1255,2511,1255,0,1,1257,479384,0.479384
1655,4305,3365,14486325,2,13246,3313,1,217441400,217441400,4966,1655,3311,1655,0,1,1657,369996,0.369996
2055,4305,3365,14486325,2,16446,4113,1,241985400,241985400,6166,2055,4111,2055,0,1,2057,346849,0.346849
2455,4305,3365,14486325,2,19646,4913,1,266529400,266529400,7366,2455,4911,2455,0,1,2457,763025,0.763025
2855,4305,3365,14486325,2,22846,5713,1,291073400,291073400,8566,2855,5711,2855,0,1,2857,340943,0.340943
3255,4305,3365,14486325,2,26046,6513,1,315617400,315617400,9766,3255,6511,3255,0,1,3257,648056,0.648056
3655,4305,3365,14486325,2,29246,7313,1,340161400,340161400,10966,3655,7311,3655,0,1,3657,1706761,1.706761
4055,4305,3365,14486325,2,32446,8113,1,364705400,364705400,12166,4055,8111,4055,0,1,4057,1165729,1.165729
4455,4305,3365,14486325,2,35646,8913,1,389249400,389249400,13366,4455,8911,4455,0,1,4457,2429699,2.429699
4855,4305,3365,14486325,2,38846,9713,1,413793400,413793400,14566,4855,9711,4855,0,1,4857,2335394,2.335394
5255,4305,3365,14486325,2,42046,10513,1,438337400,438337400,15766,5255,10511,5255,0,1,5257,3930880,3.93088
5655,4305,3365,14486325,2,45246,11313,1,462881400,462881400,16966,5655,11311,5655,0,1,5657,3018237,3.018237
6055,4305,3365,14486325,2,48446,12113,1,487425400,487425400,18166,6055,12111,6055,0,1,6057,357097,0.357097
6455,4305,3365,14486325,2,51646,12913,1,511969400,511969400,19366,6455,12911,6455,0,1,6457,2186351,2.186351
6855,4305,3365,14486325,2,54846,13713,1,536513400,536513400,20566,6855,13711,6855,0,1,6857,4389985,4.389985
55,2805,5165,14487825,2,446,113,1,119409400,119409400,166,55,111,55,0,1,57,319207,0.319207
455,2805,5165,14487825,2,3646,913,1,144913400,144913400,1366,455,911,455,0,1,457,1333222,1.333222
855,2805,5165,14487825,2,6846,1713,1,170417400,170417400,2566,855,1711,855,0,1,857,1637119,1.637119
1255,2805,5165,14487825,2,10046,2513,1,195921400,195921400,3766,1255,2511,1255,0,1,1257,1225374,1.225374
1655,2805,5165,14487825,2,13246,3313,1,221425400,221425400,4966,1655,3311,1655,0,1,1657,2034826,2.034826
2055,2805,5165,14487825,2,16446,4113,1,246929400,246929400,6166,2055,4111,2055,0,1,2057,1913921,1.913921
2455,2805,5165,14487825,2,19646,4913,1,272433400,272433400,7366,2455,4911,2455,0,1,2457,6674415,6.674415
2855,2805,5165,14487825,2,22846,5713,1,297937400,297937400,8566,2855,5711,2855,0,1,2857,3174202,3.174202
3255,2805,5165,14487825,2,26046,6513,1,323441400,323441400,9766,3255,6511,3255,0,1,3257,1758345,1.758345
3655,2805,5165,14487825,2,29246,7313,1,348945400,348945400,10966,3655,7311,3655,0,1,3657,535440,0.53544
4055,2805,5165,14487825,2,32446,8113,1,374449400,374449400,12166,4055,8111,4055,0,1,4057,1407961,1.407961
4455,2805,5165,14487825,2,35646,8913,1,399953400,399953400,13366,4455,8911,4455,0,1,4457,721547,0.721547
4855,2805,5165,14487825,2,38846,9713,1,425457400,425457400,14566,4855,9711,4855,0,1,4857,2770639,2.770639
5255,2805,5165,14487825,2,42046,10513,1,450961400,450961400,15766,5255,10511,5255,0,1,5257,4380926,4.380926
5655,2805,5165,14487825,2,45246,11313,1,476465400,476465400,16966,5655,11311,5655,0,1,5657,2007454,2.007454
6055,2805,5165,14487825,2,48446,12113,1,501969400,501969400,18166,6055,12111,6055,0,1,6057,4764391,4.764391
6455,2805,5165,14487825,2,51646,12913,1,527473400,527473400,19366,6455,12911,6455,0,1,6457,3052682,3.052682
6855,2805,5165,14487825,2,54846,13713,1,552977400,552977400,20566,6855,13711,6855,0,1,6857,2327110,2.32711
40,5300,2740,14522000,2,326,83,1,118748800,118748800,121,40,81,40,0,1,42,262765,0.262765
440,5300,2740,14522000,2,3526,883,1,144476800,144476800,1321,440,881,440,0,1,442,1343538,1.343538
840,5300,2740,14522000,2,6726,1683,1,170204800,170204800,2521,840,1681,840,0,1,842,507110,0.50711
1240,5300,2740,14522000,2,9926,2483,1,195932800,195932800,3721,1240,2481,1240,0,1,1242,20622,0.020622
1640,5300,2740,14522000,2,13126,3283,1,221660800,221660800,4921,1640,3281,1640,0,1,1642,539326,0.539326
2040,5300,2740,14522000,2,16326,4083,1,247388800,247388800,6121,2040,4081,2040,0,1,2042,321326,0.321326
2440,5300,2740,14522000,2,19526,4883,1,273116800,273116800,7321,2440,4881,2440,0,1,2442,1727992,1.727992
2840,5300,2740,14522000,2,22726,5683,1,298844800,298844800,8521,2840,5681,2840,0,1,2842,465415,0.465415
3240,5300,2740,14522000,2,25926,6483,1,324572800,324572800,9721,3240,6481,3240,0,1,3242,3053967,3.053967
3640,5300,2740,14522000,2,29126,7283,1,350300800,350300800,10921,3640,7281,3640,0,1,3642,654345,0.654345
4040,5300,2740,14522000,2,32326,8083,1,376028800,376028800,12121,4040,8081,4040,0,1,4042,1388178,1.388178
4440,5300,2740,14522000,2,35526,8883,1,401756800,401756800,13321,4440,8881,4440,0,1,4442,429276,0.429276
4840,5300,2740,14522000,2,38726,9683,1,427484800,427484800,14521,4840,9681,4840,0,1,4842,223247,0.223247
5240,5300,2740,14522000,2,41926,10483,1,453212800,453212800,15721,5240,10481,5240,0,1,5242,4615825,4.615825
5640,5300,2740,14522000,2,45126,11283,1,478940800,478940800,16921,5640,11281,5640,0,1,5642,4884402,4.884402
6040,5300,2740,14522000,2,48326,12083,1,504668800,504668800,18121,6040,12081,6040,0,1,6042,1543505,1.543505
6440,5300,2740,14522000,2,51526,12883,1,530396800,530396800,19321,6440,12881,6440,0,1,6442,5212459,5.212459
6840,5300,2740,14522000,2,54726,13683,1,556124800,556124800,20521,6840,13681,6840,0,1,6842,728531,0.728531
40,6800,2140,14552000,2,326,83,1,119276800,119276800,121,40,81,40,0,1,42,255761,0.255761
440,6800,2140,14552000,2,3526,883,1,147884800,147884800,1321,440,881,440,0,1,442,1370297,1.370297
840,6800,2140,14552000,2,6726,1683,1,176492800,176492800,2521,840,1681,840,0,1,842,217225,0.217225
1240,6800,2140,14552000,2,9926,2483,1,205100800,205100800,3721,1240,2481,1240,0,1,1242,868872,0.868872
1640,6800,2140,14552000,2,13126,3283,1,233708800,233708800,4921,1640,3281,1640,0,1,1642,1266638,1.266638
2040,6800,2140,14552000,2,16326,4083,1,262316800,262316800,6121,2040,4081,2040,0,1,2042,17900,0.0179
2440,6800,2140,14552000,2,19526,4883,1,290924800,290924800,7321,2440,4881,2440,0,1,2442,58123,0.058123
2840,6800,2140,14552000,2,22726,5683,1,319532800,319532800,8521,2840,5681,2840,0,1,2842,2395228,2.395228
3240,6800,2140,14552000,2,25926,6483,1,348140800,348140800,9721,3240,6481,3240,0,1,3242,5332195,5.332195
3640,6800,2140,14552000,2,29126,7283,1,376748800,376748800,10921,3640,7281,3640,0,1,3642,1804788,1.804788
4040,6800,2140,14552000,2,32326,8083,1,405356800,405356800,12121,4040,8081,4040,0,1,4042,3493337,3.493337
4440,6800,2140,14552000,2,35526,8883,1,433964800,433964800,13321,4440,8881,4440,0,1,4442,1477006,1.477006
4840,6800,2140,14552000,2,38726,9683,1,462572800,462572800,14521,4840,9681,4840,0,1,4842,2326819,2.326819
5240,6800,2140,14552000,2,41926,10483,1,491180800,491180800,15721,5240,10481,5240,0,1,5242,6374371,6.374371
5640,6800,2140,14552000,2,45126,11283,1,519788800,519788800,16921,5640,11281,5640,0,1,5642,680452,0.680452
6040,6800,2140,14552000,2,48326,12083,1,548396800,548396800,18121,6040,12081,6040,0,1,6042,290760,0.29076
6440,6800,2140,14552000,2,51526,12883,1,577004800,577004800,19321,6440,12881,6440,0,1,6442,39870,0.03987
6840,6800,2140,14552000,2,54726,13683,1,605612800,605612800,20521,6840,13681,6840,0,1,6842,606157,0.606157
40,2300,6340,14582000,2,326,83,1,119420800,119420800,121,40,81,40,0,1,42,268929,0.268929
440,2300,6340,14582000,2,3526,883,1,147068800,147068800,1321,440,881,440,0,1,442,1192501,1.192501
840,2300,6340,14582000,2,6726,1683,1,174716800,174716800,2521,840,1681,840,0,1,842,1177461,1.177461
1240,2300,6340,14582000,2,9926,2483,1,202364800,202364800,3721,1240,2481,1240,0,1,1242,185618,0.185618
1640,2300,6340,14582000,2,13126,3283,1,230012800,230012800,4921,1640,3281,1640,0,1,1642,361596,0.361596
2040,2300,6340,14582000,2,16326,4083,1,257660800,257660800,6121,2040,4081,2040,0,1,2042,4637854,4.637854
2440,2300,6340,14582000,2,19526,4883,1,285308800,285308800,7321,2440,4881,2440,0,1,2442,603129,0.603129
2840,2300,6340,14582000,2,22726,5683,1,312956800,312956800,8521,2840,5681,2840,0,1,2842,77146,0.077146
3240,2300,6340,14582000,2,25926,6483,1,340604800,340604800,9721,3240,6481,3240,0,1,3242,3499873,3.499873
3640,2300,6340,14582000,2,29126,7283,1,368252800,368252800,10921,3640,7281,3640,0,1,3642,1331315,1.331315
4040,2300,6340,14582000,2,32326,8083,1,395900800,395900800,12121,4040,8081,4040,0,1,4042,4407035,4.407035
4440,2300,6340,14582000,2,35526,8883,1,423548800,423548800,13321,4440,8881,4440,0,1,4442,1244490,1.24449
4840,2300,6340,14582000,2,38726,9683,1,451196800,451196800,14521,4840,9681,4840,0,1,4842,473986,0.473986
5240,2300,6340,14582000,2,41926,10483,1,478844800,478844800,15721,5240,10481,5240,0,1,5242,1825177,1.825177
5640,2300,6340,14582000,2,45126,11283,1,506492800,506492800,16921,5640,11281,5640,0,1,5642,737031,0.737031
6040,2300,6340,14582000,2,48326,12083,1,534140800,534140800,18121,6040,12081,6040,0,1,6042,660819,0.660819
6440,2300,6340,14582000,2,51526,12883,1,561788800,561788800,19321,6440,12881,6440,0,1,6442,487551,0.487551
6840,2300,6340,14582000,2,54726,13683,1,589436800,589436800,20521,6840,13681,6840,0,1,6842,672886,0.672886
40,4800,3040,14592000,2,326,83,1,119244800,119244800,121,40,81,40,0,1,42,255988,0.255988
440,4800,3040,14592000,2,3526,883,1,144332800,144332800,1321,440,881,440,0,1,442,173846,0.173846
840,4800,3040,14592000,2,6726,1683,1,169420800,169420800,2521,840,1681,840,0,1,842,2304176,2.304176
1240,4800,3040,14592000,2,9926,2483,1,194508800,194508800,3721,1240,2481,1240,0,1,1242,3347011,3.347011
1640,4800,3040,14592000,2,13126,3283,1,219596800,219596800,4921,1640,3281,1640,0,1,1642,1104992,1.104992
2040,4800,3040,14592000,2,16326,4083,1,244684800,244684800,6121,2040,4081,2040,0,1,2042,1643189,1.643189
2440,4800,3040,14592000,2,19526,4883,1,269772800,269772800,7321,2440,4881,2440,0,1,2442,3169212,3.169212
2840,4800,3040,14592000,2,22726,5683,1,294860800,294860800,8521,2840,5681,2840,0,1,2842,5294643,5.294643
3240,4800,3040,14592000,2,25926,6483,1,319948800,319948800,9721,3240,6481,3240,0,1,3242,123975,0.123975
3640,4800,3040,14592000,2,29126,7283,1,345036800,345036800,10921,3640,7281,3640,0,1,3642,756749,0.756749
4040,4800,3040,14592000,2,32326,8083,1,370124800,370124800,12121,4040,8081,4040,0,1,4042,1117869,1.117869
4440,4800,3040,14592000,2,35526,8883,1,395212800,395212800,13321,4440,8881,4440,0,1,4442,1091492,1.091492
4840,4800,3040,14592000,2,38726,9683,1,420300800,420300800,14521,4840,9681,4840,0,1,4842,12741296,12.741296
5240,4800,3040,14592000,2,41926,10483,1,445388800,445388800,15721,5240,10481,5240,0,1,5242,5170344,5.170344
5640,4800,3040,14592000,2,45126,11283,1,470476800,470476800,16921,5640,11281,5640,0,1,5642,1834099,1.834099
6040,4800,3040,14592000,2,48326,12083,1,495564800,495564800,18121,6040,12081,6040,0,1,6042,1306851,1.306851
6440,4800,3040,14592000,2,51526,12883,1,520652800,520652800,19321,6440,12881,6440,0,1,6442,7574649,7.574649
6840,4800,3040,14592000,2,54726,13683,1,545740800,545740800,20521,6840,13681,6840,0,1,6842,3057034,3.057034
40,2550,5740,14637000,2,326,83,1,119748800,119748800,121,40,81,40,0,1,42,276474,0.276474
440,2550,5740,14637000,2,3526,883,1,146276800,146276800,1321,440,881,440,0,1,442,1319442,1.319442
840,2550,5740,14637000,2,6726,1683,1,172804800,172804800,2521,840,1681,840,0,1,842,2404279,2.404279
1240,2550,5740,14637000,2,9926,2483,1,199332800,199332800,3721,1240,2481,1240,0,1,1242,1937776,1.937776
1640,2550,5740,14637000,2,13126,3283,1,225860800,225860800,4921,1640,3281,1640,0,1,1642,3179765,3.179765
2040,2550,5740,14637000,2,16326,4083,1,252388800,252388800,6121,2040,4081,2040,0,1,2042,133539,0.133539
2440,2550,5740,14637000,2,19526,4883,1,278916800,278916800,7321,2440,4881,2440,0,1,2442,421152,0.421152
2840,2550,5740,14637000,2,22726,5683,1,305444800,305444800,8521,2840,5681,2840,0,1,2842,1452311,1.452311
3240,2550,5740,14637000,2,25926,6483,1,331972800,331972800,9721,3240,6481,3240,0,1,3242,270591,0.270591
3640,2550,5740,14637000,2,29126,7283,1,358500800,358500800,10921,3640,7281,3640,0,1,3642,1783184,1.783184
4040,2550,5740,14637000,2,32326,8083,1,385028800,385028800,12121,4040,8081,4040,0,1,4042,1584002,1.584002
4440,2550,5740,14637000,2,35526,8883,1,411556800,411556800,13321,4440,8881,4440,0,1,4442,780795,0.780795
4840,2550,5740,14637000,2,38726,9683,1,438084800,438084800,14521,4840,9681,4840,0,1,4842,1986468,1.986468
5240,2550,5740,14637000,2,41926,10483,1,464612800,464612800,15721,5240,10481,5240,0,1,5242,735326,0.735326
5640,2550,5740,14637000,2,45126,11283,1,491140800,491140800,16921,5640,11281,5640,0,1,5642,1146553,1.146553
6040,2550,5740,14637000,2,48326,12083,1,517668800,517668800,18121,6040,12081,6040,0,1,6042,3661408,3.661408
6440,2550,5740,14637000,2,51526,12883,1,544196800,544196800,19321,6440,12881,6440,0,1,6442,2215046,2.215046
6840,2550,5740,14637000,2,54726,13683,1,570724800,570724800,20521,6840,13681,6840,0,1,6842,313047,0.313047
35,2240,6545,14660800,2,286,73,1,119746200,119746200,106,35,71,35,0,1,37,258720,0.25872
535,2240,6545,14660800,2,4286,1073,1,154886200,154886200,1606,535,1071,535,0,1,537,1589848,1.589848
1035,2240,6545,14660800,2,8286,2073,1,190026200,190026200,3106,1035,2071,1035,0,1,1037,2938315,2.938315
1535,2240,6545,14660800,2,12286,3073,1,225166200,225166200,4606,1535,3071,1535,0,1,1537,4304765,4.304765
2035,2240,6545,14660800,2,16286,4073,1,260306200,260306200,6106,2035,4071,2035,0,1,2037,5671484,5.671484
2535,2240,6545,14660800,2,20286,5073,1,295446200,295446200,7606,2535,5071,2535,0,1,2537,7038462,7.038462
55,5305,2765,14668325,2,446,113,1,120897400,120897400,166,55,111,55,0,1,57,293670,0.29367
455,5305,2765,14668325,2,3646,913,1,146721400,146721400,1366,455,911,455,0,1,457,1392312,1.392312
855,5305,2765,14668325,2,6846,1713,1,172545400,172545400,2566,855,1711,855,0,1,857,38787,0.038787
1255,5305,2765,14668325,2,10046,2513,1,198369400,198369400,3766,1255,2511,1255,0,1,1257,3621924,3.621924
1655,5305,2765,14668325,2,13246,3313,1,224193400,224193400,4966,1655,3311,1655,0,1,1657,3753726,3.753726
2055,5305,2765,14668325,2,16446,4113,1,250017400,250017400,6166,2055,4111,2055,0,1,2057,3816499,3.816499
2455,5305,2765,14668325,2,19646,4913,1,275841400,275841400,7366,2455,4911,2455,0,1,2457,307833,0.307833
2855,5305,2765,14668325,2,22846,5713,1,301665400,301665400,8566,2855,5711,2855,0,1,2857,2455957,2.455957
3255,5305,2765,14668325,2,26046,6513,1,327489400,327489400,9766,3255,6511,3255,0,1,3257,3466572,3.466572
3655,5305,2765,14668325,2,29246,7313,1,353313400,353313400,10966,3655,7311,3655,0,1,3657,1439822,1.439822
4055,5305,2765,14668325,2,32446,8113,1,379137400,379137400,12166,4055,8111,4055,0,1,4057,1948718,1.948718
4455,5305,2765,14668325,2,35646,8913,1,404961400,404961400,13366,4455,8911,4455,0,1,4457,1699209,1.699209
4855,5305,2765,14668325,2,38846,9713,1,430785400,430785400,14566,4855,9711,4855,0,1,4857,942062,0.942062
5255,5305,2765,14668325,2,42046,10513,1,456609400,456609400,15766,5255,10511,5255,0,1,5257,2608091,2.608091
5655,5305,2765,14668325,2,45246,11313,1,482433400,482433400,16966,5655,11311,5655,0,1,5657,238205,0.238205
6055,5305,2765,14668325,2,48446,12113,1,508257400,508257400,18166,6055,12111,6055,0,1,6057,5886664,5.886664
6455,5305,2765,14668325,2,51646,12913,1,534081400,534081400,19366,6455,12911,6455,0,1,6457,293008,0.293008
6855,5305,2765,14668325,2,54846,13713,1,559905400,559905400,20566,6855,13711,6855,0,1,6857,5875858,5.875858
55,2305,6365,14671325,2,446,113,1,121185400,121185400,166,55,111,55,0,1,57,292970,0.29297
455,2305,6365,14671325,2,3646,913,1,148929400,148929400,1366,455,911,455,0,1,457,1349859,1.349859
855,2305,6365,14671325,2,6846,1713,1,176673400,176673400,2566,855,1711,855,0,1,857,1664215,1.664215
1255,2305,6365,14671325,2,10046,2513,1,204417400,204417400,3766,1255,2511,1255,0,1,1257,2147533,2.147533
1655,2305,6365,14671325,2,13246,3313,1,232161400,232161400,4966,1655,3311,1655,0,1,1657,4436390,4.43639
2055,2305,6365,14671325,2,16446,4113,1,259905400,259905400,6166,2055,4111,2055,0,1,2057,1114005,1.114005
2455,2305,6365,14671325,2,19646,4913,1,287649400,287649400,7366,2455,4911,2455,0,1,2457,6137556,6.137556
2855,2305,6365,14671325,2,22846,5713,1,315393400,315393400,8566,2855,5711,2855,0,1,2857,230530,0.23053
3255,2305,6365,14671325,2,26046,6513,1,343137400,343137400,9766,3255,6511,3255,0,1,3257,896533,0.896533
3655,2305,6365,14671325,2,29246,7313,1,370881400,370881400,10966,3655,7311,3655,0,1,3657,3040366,3.040366
4055,2305,6365,14671325,2,32446,8113,1,398625400,398625400,12166,4055,8111,4055,0,1,4057,523233,0.523233
4455,2305,6365,14671325,2,35646,8913,1,426369400,426369400,13366,4455,8911,4455,0,1,4457,424171,0.424171
4855,2305,6365,14671325,2,38846,9713,1,454113400,454113400,14566,4855,9711,4855,0,1,4857,1043260,1.04326
5255,2305,6365,14671325,2,42046,10513,1,481857400,481857400,15766,5255,10511,5255,0,1,5257,1547328,1.547328
5655,2305,6365,14671325,2,45246,11313,1,509601400,509601400,16966,5655,11311,5655,0,1,5657,1084068,1.084068
6055,2305,6365,14671325,2,48446,12113,1,537345400,537345400,18166,6055,12111,6055,0,1,6057,974401,0.974401
6455,2305,6365,14671325,2,51646,12913,1,565089400,565089400,19366,6455,12911,6455,0,1,6457,42682,0.042682
6855,2305,6365,14671325,2,54846,13713,1,592833400,592833400,20566,6855,13711,6855,0,1,6857,1048685,1.048685
39,2243,6541,14671463,2,318,81,1,120112312,120112312,118,39,79,39,0,1,41,54960,0.05496
539,2243,6541,14671463,2,4318,1081,1,155248312,155248312,1618,539,1079,539,0,1,541,149181,0.149181
1039,2243,6541,14671463,2,8318,2081,1,190384312,190384312,3118,1039,2079,1039,0,1,1041,47908,0.047908
1539,2243,6541,14671463,2,12318,3081,1,225520312,225520312,4618,1539,3079,1539,0,1,1541,859973,0.859973
2039,2243,6541,14671463,2,16318,4081,1,260656312,260656312,6118,2039,4079,2039,0,1,2041,97578,0.097578
2539,2243,6541,14671463,2,20318,5081,1,295792312,295792312,7618,2539,5079,2539,0,1,2541,150606,0.150606
3039,2243,6541,14671463,2,24318,6081,1,330928312,330928312,9118,3039,6079,3039,0,1,3041,933796,0.933796
3539,2243,6541,14671463,2,28318,7081,1,366064312,366064312,10618,3539,7079,3539,0,1,3541,398596,0.398596
4039,2243,6541,14671463,2,32318,8081,1,401200312,401200312,12118,4039,8079,4039,0,1,4041,839741,0.839741
4539,2243,6541,14671463,2,36318,9081,1,436336312,436336312,13618,4539,9079,4539,0,1,4541,53694,0.053694
5039,2243,6541,14671463,2,40318,10081,1,471472312,471472312,15118,5039,10079,5039,0,1,5041,886858,0.886858
5539,2243,6541,14671463,2,44318,11081,1,506608312,506608312,16618,5539,11079,5539,0,1,5541,1570290,1.57029
6039,2243,6541,14671463,2,48318,12081,1,541744312,541744312,18118,6039,12079,6039,0,1,6041,2424821,2.424821
6539,2243,6541,14671463,2,52318,13081,1,576880312,576880312,19618,6539,13079,6539,0,1,6541,1516583,1.516583
7039,2243,6541,14671463,2,56318,14081,1,612016312,612016312,21118,7039,14079,7039,0,1,7041,2856074,2.856074
55,4805,3065,14727325,2,446,113,1,121281400,121281400,166,55,111,55,0,1,57,326423,0.326423
455,4805,3065,14727325,2,3646,913,1,146465400,146465400,1366,455,911,455,0,1,457,1369875,1.369875
855,4805,3065,14727325,2,6846,1713,1,171649400,171649400,2566,855,1711,855,0,1,857,2468324,2.468324
1255,4805,3065,14727325,2,10046,2513,1,196833400,196833400,3766,1255,2511,1255,0,1,1257,151147,0.151147
1655,4805,3065,14727325,2,13246,3313,1,222017400,222017400,4966,1655,3311,1655,0,1,1657,4641037,4.641037
2055,4805,3065,14727325,2,16446,4113,1,247201400,247201400,6166,2055,4111,2055,0,1,2057,2643056,2.643056
2455,4805,3065,14727325,2,19646,4913,1,272385400,272385400,7366,2455,4911,2455,0,1,2457,6623525,6.623525
2855,4805,3065,14727325,2,22846,5713,1,297569400,297569400,8566,2855,5711,2855,0,1,2857,7928342,7.928342
3255,4805,3065,14727325,2,26046,6513,1,322753400,322753400,9766,3255,6511,3255,0,1,3257,25517,0.025517
3655,4805,3065,14727325,2,29246,7313,1,347937400,347937400,10966,3655,7311,3655,0,1,3657,7063424,7.063424
4055,4805,3065,14727325,2,32446,8113,1,373121400,373121400,12166,4055,8111,4055,0,1,4057,8747178,8.747178
4455,4805,3065,14727325,2,35646,8913,1,398305400,398305400,13366,4455,8911,4455,0,1,4457,7040027,7.040027
4855,4805,3065,14727325,2,38846,9713,1,423489400,423489400,14566,4855,9711,4855,0,1,4857,6562978,6.562978
5255,4805,3065,14727325,2,42046,10513,1,448673400,448673400,15766,5255,10511,5255,0,1,5257,142038,0.142038
5655,4805,3065,14727325,2,45246,11313,1,473857400,473857400,16966,5655,11311,5655,0,1,5657,6531278,6.531278
6055,4805,3065,14727325,2,48446,12113,1,499041400,499041400,18166,6055,12111,6055,0,1,6057,9830484,9.830484
6455,4805,3065,14727325,2,51646,12913,1,524225400,524225400,19366,6455,12911,6455,0,1,6457,17760657,17.760657
6855,4805,3065,14727325,2,54846,13713,1,549409400,549409400,20566,6855,13711,6855,0,1,6857,7687942,7.687942
55,2555,5765,14729575,2,446,113,1,121497400,121497400,166,55,111,55,0,1,57,305564,0.305564
455,2555,5765,14729575,2,3646,913,1,148121400,148121400,1366,455,911,455,0,1,457,1366665,1.366665
855,2555,5765,14729575,2,6846,1713,1,174745400,174745400,2566,855,1711,855,0,1,857,919438,0.919438
1255,2555,5765,14729575,2,10046,2513,1,201369400,201369400,3766,1255,2511,1255,0,1,1257,1284601,1.284601
1655,2555,5765,14729575,2,13246,3313,1,227993400,227993400,4966,1655,3311,1655,0,1,1657,315866,0.315866
2055,2555,5765,14729575,2,16446,4113,1,254617400,254617400,6166,2055,4111,2055,0,1,2057,5709114,5.709114
2455,2555,5765,14729575,2,19646,4913,1,281241400,281241400,7366,2455,4911,2455,0,1,2457,737731,0.737731
2855,2555,5765,14729575,2,22846,5713,1,307865400,307865400,8566,2855,5711,2855,0,1,2857,4206960,4.20696
3255,2555,5765,14729575,2,26046,6513,1,334489400,334489400,9766,3255,6511,3255,0,1,3257,1513213,1.513213
3655,2555,5765,14729575,2,29246,7313,1,361113400,361113400,10966,3655,7311,3655,0,1,3657,3373446,3.373446
4055,2555,5765,14729575,2,32446,8113,1,387737400,387737400,12166,4055,8111,4055,0,1,4057,2129666,2.129666
4455,2555,5765,14729575,2,35646,8913,1,414361400,414361400,13366,4455,8911,4455,0,1,4457,1645461,1.645461
4855,2555,5765,14729575,2,38846,9713,1,440985400,440985400,14566,4855,9711,4855,0,1,4857,3754332,3.754332
5255,2555,5765,14729575,2,42046,10513,1,467609400,467609400,15766,5255,10511,5255,0,1,5257,5511765,5.511765
5655,2555,5765,14729575,2,45246,11313,1,494233400,494233400,16966,5655,11311,5655,0,1,5657,100929,0.100929
6055,2555,5765,14729575,2,48446,12113,1,520857400,520857400,18166,6055,12111,6055,0,1,6057,198881,0.198881
6455,2555,5765,14729575,2,51646,12913,1,547481400,547481400,19366,6455,12911,6455,0,1,6457,3259566,3.259566
6855,2555,5765,14729575,2,54846,13713,1,574105400,574105400,20566,6855,13711,6855,0,1,6857,193842,0.193842
55,6805,2165,14732825,2,446,113,1,121809400,121809400,166,55,111,55,0,1,57,293447,0.293447
455,6805,2165,14732825,2,3646,913,1,150513400,150513400,1366,455,911,455,0,1,457,1418768,1.418768
855,6805,2165,14732825,2,6846,1713,1,179217400,179217400,2566,855,1711,855,0,1,857,1018468,1.018468
1255,6805,2165,14732825,2,10046,2513,1,207921400,207921400,3766,1255,2511,1255,0,1,1257,414258,0.414258
1655,6805,2165,14732825,2,13246,3313,1,236625400,236625400,4966,1655,3311,1655,0,1,1657,911820,0.91182
2055,6805,2165,14732825,2,16446,4113,1,265329400,265329400,6166,2055,4111,2055,0,1,2057,147280,0.14728
2455,6805,2165,14732825,2,19646,4913,1,294033400,294033400,7366,2455,4911,2455,0,1,2457,1928397,1.928397
2855,6805,2165,14732825,2,22846,5713,1,322737400,322737400,8566,2855,5711,2855,0,1,2857,5048859,5.048859
3255,6805,2165,14732825,2,26046,6513,1,351441400,351441400,9766,3255,6511,3255,0,1,3257,858243,0.858243
3655,6805,2165,14732825,2,29246,7313,1,380145400,380145400,10966,3655,7311,3655,0,1,3657,51389,0.051389
4055,6805,2165,14732825,2,32446,8113,1,408849400,408849400,12166,4055,8111,4055,0,1,4057,1656201,1.656201
4455,6805,2165,14732825,2,35646,8913,1,437553400,437553400,13366,4455,8911,4455,0,1,4457,3318986,3.318986
4855,6805,2165,14732825,2,38846,9713,1,466257400,466257400,14566,4855,9711,4855,0,1,4857,10966868,10.966868
5255,6805,2165,14732825,2,42046,10513,1,494961400,494961400,15766,5255,10511,5255,0,1,5257,4532738,4.532738
5655,6805,2165,14732825,2,45246,11313,1,523665400,523665400,16966,5655,11311,5655,0,1,5657,737965,0.737965
6055,6805,2165,14732825,2,48446,12113,1,552369400,552369400,18166,6055,12111,6055,0,1,6057,2743049,2.743049
6455,6805,2165,14732825,2,51646,12913,1,581073400,581073400,19366,6455,12911,6455,0,1,6457,5056154,5.056154
6855,6805,2165,14732825,2,54846,13713,1,609777400,609777400,20566,6855,13711,6855,0,1,6857,1673861,1.673861
40,4050,3640,14742000,2,326,83,1,120396800,120396800,121,40,81,40,0,1,42,23791,0.023791
440,4050,3640,14742000,2,3526,883,1,145004800,145004800,1321,440,881,440,0,1,442,159421,0.159421
840,4050,3640,14742000,2,6726,1683,1,169612800,169612800,2521,840,1681,840,0,1,842,68675,0.068675
1240,4050,3640,14742000,2,9926,2483,1,194220800,194220800,3721,1240,2481,1240,0,1,1242,36104,0.036104
1640,4050,3640,14742000,2,13126,3283,1,218828800,218828800,4921,1640,3281,1640,0,1,1642,4596,0.004596
2040,4050,3640,14742000,2,16326,4083,1,243436800,243436800,6121,2040,4081,2040,0,1,2042,117976,0.117976
2440,4050,3640,14742000,2,19526,4883,1,268044800,268044800,7321,2440,4881,2440,0,1,2442,61994,0.061994
2840,4050,3640,14742000,2,22726,5683,1,292652800,292652800,8521,2840,5681,2840,0,1,2842,173605,0.173605
3240,4050,3640,14742000,2,25926,6483,1,317260800,317260800,9721,3240,6481,3240,0,1,3242,721612,0.721612
3640,4050,3640,14742000,2,29126,7283,1,341868800,341868800,10921,3640,7281,3640,0,1,3642,1144524,1.144524
4040,4050,3640,14742000,2,32326,8083,1,366476800,366476800,12121,4040,8081,4040,0,1,4042,721137,0.721137
4440,4050,3640,14742000,2,35526,8883,1,391084800,391084800,13321,4440,8881,4440,0,1,4442,1902343,1.902343
4840,4050,3640,14742000,2,38726,9683,1,415692800,415692800,14521,4840,9681,4840,0,1,4842,1798752,1.798752
5240,4050,3640,14742000,2,41926,10483,1,440300800,440300800,15721,5240,10481,5240,0,1,5242,27145,0.027145
5640,4050,3640,14742000,2,45126,11283,1,464908800,464908800,16921,5640,11281,5640,0,1,5642,955044,0.955044
6040,4050,3640,14742000,2,48326,12083,1,489516800,489516800,18121,6040,12081,6040,0,1,6042,168079,0.168079
6440,4050,3640,14742000,2,51526,12883,1,514124800,514124800,19321,6440,12881,6440,0,1,6442,158131,0.158131
6840,4050,3640,14742000,2,54726,13683,1,538732800,538732800,20521,6840,13681,6840,0,1,6842,1607001,1.607001
40,3050,4840,14762000,2,326,83,1,120620800,120620800,121,40,81,40,0,1,42,24467,0.024467
440,3050,4840,14762000,2,3526,883,1,145868800,145868800,1321,440,881,440,0,1,442,91849,0.091849
840,3050,4840,14762000,2,6726,1683,1,171116800,171116800,2521,840,1681,840,0,1,842,13562,0.013562
1240,3050,4840,14762000,2,9926,2483,1,196364800,196364800,3721,1240,2481,1240,0,1,1242,63719,0.063719
1640,3050,4840,14762000,2,13126,3283,1,221612800,221612800,4921,1640,3281,1640,0,1,1642,1161162,1.161162
2040,3050,4840,14762000,2,16326,4083,1,246860800,246860800,6121,2040,4081,2040,0,1,2042,969522,0.969522
2440,3050,4840,14762000,2,19526,4883,1,272108800,272108800,7321,2440,4881,2440,0,1,2442,153266,0.153266
2840,3050,4840,14762000,2,22726,5683,1,297356800,297356800,8521,2840,5681,2840,0,1,2842,47045,0.047045
3240,3050,4840,14762000,2,25926,6483,1,322604800,322604800,9721,3240,6481,3240,0,1,3242,471445,0.471445
3640,3050,4840,14762000,2,29126,7283,1,347852800,347852800,10921,3640,7281,3640,0,1,3642,2199803,2.199803
4040,3050,4840,14762000,2,32326,8083,1,373100800,373100800,12121,4040,8081,4040,0,1,4042,333326,0.333326
4440,3050,4840,14762000,2,35526,8883,1,398348800,398348800,13321,4440,8881,4440,0,1,4442,352453,0.352453
4840,3050,4840,14762000,2,38726,9683,1,423596800,423596800,14521,4840,9681,4840,0,1,4842,1791546,1.791546
5240,3050,4840,14762000,2,41926,10483,1,448844800,448844800,15721,5240,10481,5240,0,1,5242,281113,0.281113
5640,3050,4840,14762000,2,45126,11283,1,474092800,474092800,16921,5640,11281,5640,0,1,5642,56325,0.056325
6040,3050,4840,14762000,2,48326,12083,1,499340800,499340800,18121,6040,12081,6040,0,1,6042,645348,0.645348
6440,3050,4840,14762000,2,51526,12883,1,524588800,524588800,19321,6440,12881,6440,0,1,6442,672806,0.672806
6840,3050,4840,14762000,2,54726,13683,1,549836800,549836800,20521,6840,13681,6840,0,1,6842,454735,0.454735
40,6050,2440,14762000,2,326,83,1,120812800,120812800,121,40,81,40,0,1,42,258202,0.258202
440,6050,2440,14762000,2,3526,883,1,147980800,147980800,1321,440,881,440,0,1,442,1304613,1.304613
840,6050,2440,14762000,2,6726,1683,1,175148800,175148800,2521,840,1681,840,0,1,842,720720,0.72072
1240,6050,2440,14762000,2,9926,2483,1,202316800,202316800,3721,1240,2481,1240,0,1,1242,1979829,1.979829
1640,6050,2440,14762000,2,13126,3283,1,229484800,229484800,4921,1640,3281,1640,0,1,1642,2854624,2.854624
2040,6050,2440,14762000,2,16326,4083,1,256652800,256652800,6121,2040,4081,2040,0,1,2042,5268130,5.26813
2440,6050,2440,14762000,2,19526,4883,1,283820800,283820800,7321,2440,4881,2440,0,1,2442,202794,0.202794
2840,6050,2440,14762000,2,22726,5683,1,310988800,310988800,8521,2840,5681,2840,0,1,2842,3714166,3.714166
3240,6050,2440,14762000,2,25926,6483,1,338156800,338156800,9721,3240,6481,3240,0,1,3242,1175825,1.175825
3640,6050,2440,14762000,2,29126,7283,1,365324800,365324800,10921,3640,7281,3640,0,1,3642,1672775,1.672775
4040,6050,2440,14762000,2,32326,8083,1,392492800,392492800,12121,4040,8081,4040,0,1,4042,2017225,2.017225
4440,6050,2440,14762000,2,35526,8883,1,419660800,419660800,13321,4440,8881,4440,0,1,4442,1743072,1.743072
4840,6050,2440,14762000,2,38726,9683,1,446828800,446828800,14521,4840,9681,4840,0,1,4842,1403799,1.403799
5240,6050,2440,14762000,2,41926,10483,1,473996800,473996800,15721,5240,10481,5240,0,1,5242,1106741,1.106741
5640,6050,2440,14762000,2,45126,11283,1,501164800,501164800,16921,5640,11281,5640,0,1,5642,2244377,2.244377
6040,6050,2440,14762000,2,48326,12083,1,528332800,528332800,18121,6040,12081,6040,0,1,6042,4502861,4.502861
6440,6050,2440,14762000,2,51526,12883,1,555500800,555500800,19321,6440,12881,6440,0,1,6442,462209,0.462209
6840,6050,2440,14762000,2,54726,13683,1,582668800,582668800,20521,6840,13681,6840,0,1,6842,9030779,9.030779
44,2253,6555,14768415,2,358,91,1,121247736,121247736,133,44,89,44,0,1,46,19451,0.019451
544,2253,6555,14768415,2,4358,1091,1,156479736,156479736,1633,544,1089,544,0,1,546,70746,0.070746
1044,2253,6555,14768415,2,8358,2091,1,191711736,191711736,3133,1044,2089,1044,0,1,1046,15477,0.015477
1544,2253,6555,14768415,2,12358,3091,1,226943736,226943736,4633,1544,3089,1544,0,1,1546,588456,0.588456
2044,2253,6555,14768415,2,16358,4091,1,262175736,262175736,6133,2044,4089,2044,0,1,2046,40638,0.040638
2544,2253,6555,14768415,2,20358,5091,1,297407736,297407736,7633,2544,5089,2544,0,1,2546,195004,0.195004
3044,2253,6555,14768415,2,24358,6091,1,332639736,332639736,9133,3044,6089,3044,0,1,3046,903241,0.903241
3544,2253,6555,14768415,2,28358,7091,1,367871736,367871736,10633,3544,7089,3544,0,1,3546,1342022,1.342022
4044,2253,6555,14768415,2,32358,8091,1,403103736,403103736,12133,4044,8089,4044,0,1,4046,307601,0.307601
4544,2253,6555,14768415,2,36358,9091,1,438335736,438335736,13633,4544,9089,4544,0,1,4546,323341,0.323341
5044,2253,6555,14768415,2,40358,10091,1,473567736,473567736,15133,5044,10089,5044,0,1,5046,8312281,8.312281
5544,2253,6555,14768415,2,44358,11091,1,508799736,508799736,16633,5544,11089,5544,0,1,5546,829204,0.829204
6044,2253,6555,14768415,2,48358,12091,1,544031736,544031736,18133,6044,12089,6044,0,1,6046,1202742,1.202742
6544,2253,6555,14768415,2,52358,13091,1,579263736,579263736,19633,6544,13089,6544,0,1,6546,1525431,1.525431
7044,2253,6555,14768415,2,56358,14091,1,614495736,614495736,21133,7044,14089,7044,0,1,7046,2124797,2.124797
55,4055,3665,14861575,2,446,113,1,122289400,122289400,166,55,111,55,0,1,57,11261,0.011261
455,4055,3665,14861575,2,3646,913,1,146993400,146993400,1366,455,911,455,0,1,457,178815,0.178815
855,4055,3665,14861575,2,6846,1713,1,171697400,171697400,2566,855,1711,855,0,1,857,226286,0.226286
1255,4055,3665,14861575,2,10046,2513,1,196401400,196401400,3766,1255,2511,1255,0,1,1257,303344,0.303344
1655,4055,3665,14861575,2,13246,3313,1,221105400,221105400,4966,1655,3311,1655,0,1,1657,543274,0.543274
2055,4055,3665,14861575,2,16446,4113,1,245809400,245809400,6166,2055,4111,2055,0,1,2057,361427,0.361427
2455,4055,3665,14861575,2,19646,4913,1,270513400,270513400,7366,2455,4911,2455,0,1,2457,269615,0.269615
2855,4055,3665,14861575,2,22846,5713,1,295217400,295217400,8566,2855,5711,2855,0,1,2857,277735,0.277735
3255,4055,3665,14861575,2,26046,6513,1,319921400,319921400,9766,3255,6511,3255,0,1,3257,3136061,3.136061
3655,4055,3665,14861575,2,29246,7313,1,344625400,344625400,10966,3655,7311,3655,0,1,3657,32339,0.032339
4055,4055,3665,14861575,2,32446,8113,1,369329400,369329400,12166,4055,8111,4055,0,1,4057,375665,0.375665
4455,4055,3665,14861575,2,35646,8913,1,394033400,394033400,13366,4455,8911,4455,0,1,4457,290729,0.290729
4855,4055,3665,14861575,2,38846,9713,1,418737400,418737400,14566,4855,9711,4855,0,1,4857,291976,0.291976
5255,4055,3665,14861575,2,42046,10513,1,443441400,443441400,15766,5255,10511,5255,0,1,5257,30700,0.0307
5655,4055,3665,14861575,2,45246,11313,1,468145400,468145400,16966,5655,11311,5655,0,1,5657,763434,0.763434
6055,4055,3665,14861575,2,48446,12113,1,492849400,492849400,18166,6055,12111,6055,0,1,6057,3536802,3.536802
6455,4055,3665,14861575,2,51646,12913,1,517553400,517553400,19366,6455,12911,6455,0,1,6457,4162983,4.162983
6855,4055,3665,14861575,2,54846,13713,1,542257400,542257400,20566,6855,13711,6855,0,1,6857,856550,0.85655
55,3055,4865,14862575,2,446,113,1,122385400,122385400,166,55,111,55,0,1,57,10151,0.010151
455,3055,4865,14862575,2,3646,913,1,147729400,147729400,1366,455,911,455,0,1,457,11186,0.011186
855,3055,4865,14862575,2,6846,1713,1,173073400,173073400,2566,855,1711,855,0,1,857,158255,0.158255
1255,3055,4865,14862575,2,10046,2513,1,198417400,198417400,3766,1255,2511,1255,0,1,1257,230335,0.230335
1655,3055,4865,14862575,2,13246,3313,1,223761400,223761400,4966,1655,3311,1655,0,1,1657,533365,0.533365
2055,3055,4865,14862575,2,16446,4113,1,249105400,249105400,6166,2055,4111,2055,0,1,2057,707752,0.707752
2455,3055,4865,14862575,2,19646,4913,1,274449400,274449400,7366,2455,4911,2455,0,1,2457,41598,0.041598
2855,3055,4865,14862575,2,22846,5713,1,299793400,299793400,8566,2855,5711,2855,0,1,2857,801356,0.801356
3255,3055,4865,14862575,2,26046,6513,1,325137400,325137400,9766,3255,6511,3255,0,1,3257,346202,0.346202
3655,3055,4865,14862575,2,29246,7313,1,350481400,350481400,10966,3655,7311,3655,0,1,3657,370463,0.370463
4055,3055,4865,14862575,2,32446,8113,1,375825400,375825400,12166,4055,8111,4055,0,1,4057,1699936,1.699936
4455,3055,4865,14862575,2,35646,8913,1,401169400,401169400,13366,4455,8911,4455,0,1,4457,45463,0.045463
4855,3055,4865,14862575,2,38846,9713,1,426513400,426513400,14566,4855,9711,4855,0,1,4857,1693733,1.693733
5255,3055,4865,14862575,2,42046,10513,1,451857400,451857400,15766,5255,10511,5255,0,1,5257,105723,0.105723
5655,3055,4865,14862575,2,45246,11313,1,477201400,477201400,16966,5655,11311,5655,0,1,5657,5632229,5.632229
6055,3055,4865,14862575,2,48446,12113,1,502545400,502545400,18166,6055,12111,6055,0,1,6057,1125742,1.125742
6455,3055,4865,14862575,2,51646,12913,1,527889400,527889400,19366,6455,12911,6455,0,1,6457,1626500,1.6265
6855,3055,4865,14862575,2,54846,13713,1,553233400,553233400,20566,6855,13711,6855,0,1,6857,584258,0.584258
55,6055,2465,14925575,2,446,113,1,123153400,123153400,166,55,111,55,0,1,57,294134,0.294134
455,6055,2465,14925575,2,3646,913,1,150417400,150417400,1366,455,911,455,0,1,457,1400198,1.400198
855,6055,2465,14925575,2,6846,1713,1,177681400,177681400,2566,855,1711,855,0,1,857,1106421,1.106421
1255,6055,2465,14925575,2,10046,2513,1,204945400,204945400,3766,1255,2511,1255,0,1,1257,1344249,1.344249
1655,6055,2465,14925575,2,13246,3313,1,232209400,232209400,4966,1655,3311,1655,0,1,1657,1274174,1.274174
2055,6055,2465,14925575,2,16446,4113,1,259473400,259473400,6166,2055,4111,2055,0,1,2057,5892981,5.892981
2455,6055,2465,14925575,2,19646,4913,1,286737400,286737400,7366,2455,4911,2455,0,1,2457,1626554,1.626554
2855,6055,2465,14925575,2,22846,5713,1,314001400,314001400,8566,2855,5711,2855,0,1,2857,314552,0.314552
3255,6055,2465,14925575,2,26046,6513,1,341265400,341265400,9766,3255,6511,3255,0,1,3257,306192,0.306192
3655,6055,2465,14925575,2,29246,7313,1,368529400,368529400,10966,3655,7311,3655,0,1,3657,239729,0.239729
4055,6055,2465,14925575,2,32446,8113,1,395793400,395793400,12166,4055,8111,4055,0,1,4057,1200365,1.200365
4455,6055,2465,14925575,2,35646,8913,1,423057400,423057400,13366,4455,8911,4455,0,1,4457,982981,0.982981
4855,6055,2465,14925575,2,38846,9713,1,450321400,450321400,14566,4855,9711,4855,0,1,4857,1025908,1.025908
5255,6055,2465,14925575,2,42046,10513,1,477585400,477585400,15766,5255,10511,5255,0,1,5257,1122616,1.122616
5655,6055,2465,14925575,2,45246,11313,1,504849400,504849400,16966,5655,11311,5655,0,1,5657,7778603,7.778603
6055,6055,2465,14925575,2,48446,12113,1,532113400,532113400,18166,6055,12111,6055,0,1,6057,3467320,3.46732
6455,6055,2465,14925575,2,51646,12913,1,559377400,559377400,19366,6455,12911,6455,0,1,6457,83316,0.083316
6855,6055,2465,14925575,2,54846,13713,1,586641400,586641400,20566,6855,13711,6855,0,1,6857,3306761,3.306761
40,3800,3940,14972000,2,326,83,1,122252800,122252800,121,40,81,40,0,1,42,267637,0.267637
440,3800,3940,14972000,2,3526,883,1,147020800,147020800,1321,440,881,440,0,1,442,1019748,1.019748
840,3800,3940,14972000,2,6726,1683,1,171788800,171788800,2521,840,1681,840,0,1,842,2525289,2.525289
1240,3800,3940,14972000,2,9926,2483,1,196556800,196556800,3721,1240,2481,1240,0,1,1242,1317832,1.317832
1640,3800,3940,14972000,2,13126,3283,1,221324800,221324800,4921,1640,3281,1640,0,1,1642,4824164,4.824164
2040,3800,3940,14972000,2,16326,4083,1,246092800,246092800,6121,2040,4081,2040,0,1,2042,267326,0.267326
2440,3800,3940,14972000,2,19526,4883,1,270860800,270860800,7321,2440,4881,2440,0,1,2442,5018857,5.018857
2840,3800,3940,14972000,2,22726,5683,1,295628800,295628800,8521,2840,5681,2840,0,1,2842,1841479,1.841479
3240,3800,3940,14972000,2,25926,6483,1,320396800,320396800,9721,3240,6481,3240,0,1,3242,247612,0.247612
3640,3800,3940,14972000,2,29126,7283,1,345164800,345164800,10921,3640,7281,3640,0,1,3642,5577602,5.577602
4040,3800,3940,14972000,2,32326,8083,1,369932800,369932800,12121,4040,8081,4040,0,1,4042,2512750,2.51275
4440,3800,3940,14972000,2,35526,8883,1,394700800,394700800,13321,4440,8881,4440,0,1,4442,7877686,7.877686
4840,3800,3940,14972000,2,38726,9683,1,419468800,419468800,14521,4840,9681,4840,0,1,4842,4858894,4.858894
5240,3800,3940,14972000,2,41926,10483,1,444236800,444236800,15721,5240,10481,5240,0,1,5242,3673954,3.673954
5640,3800,3940,14972000,2,45126,11283,1,469004800,469004800,16921,5640,11281,5640,0,1,5642,4228022,4.228022
6040,3800,3940,14972000,2,48326,12083,1,493772800,493772800,18121,6040,12081,6040,0,1,6042,4104171,4.104171
6440,3800,3940,14972000,2,51526,12883,1,518540800,518540800,19321,6440,12881,6440,0,1,6442,4825433,4.825433
6840,3800,3940,14972000,2,54726,13683,1,543308800,543308800,20521,6840,13681,6840,0,1,6842,5750232,5.750232
40,3300,4540,14982000,2,326,83,1,122364800,122364800,121,40,81,40,0,1,42,264152,0.264152
440,3300,4540,14982000,2,3526,883,1,147452800,147452800,1321,440,881,440,0,1,442,158292,0.158292
840,3300,4540,14982000,2,6726,1683,1,172540800,172540800,2521,840,1681,840,0,1,842,441252,0.441252
1240,3300,4540,14982000,2,9926,2483,1,197628800,197628800,3721,1240,2481,1240,0,1,1242,260220,0.26022
1640,3300,4540,14982000,2,13126,3283,1,222716800,222716800,4921,1640,3281,1640,0,1,1642,1371084,1.371084
2040,3300,4540,14982000,2,16326,4083,1,247804800,247804800,6121,2040,4081,2040,0,1,2042,791093,0.791093
2440,3300,4540,14982000,2,19526,4883,1,272892800,272892800,7321,2440,4881,2440,0,1,2442,2120751,2.120751
2840,3300,4540,14982000,2,22726,5683,1,297980800,297980800,8521,2840,5681,2840,0,1,2842,728656,0.728656
3240,3300,4540,14982000,2,25926,6483,1,323068800,323068800,9721,3240,6481,3240,0,1,3242,9349064,9.349064
3640,3300,4540,14982000,2,29126,7283,1,348156800,348156800,10921,3640,7281,3640,0,1,3642,279101,0.279101
4040,3300,4540,14982000,2,32326,8083,1,373244800,373244800,12121,4040,8081,4040,0,1,4042,725916,0.725916
4440,3300,4540,14982000,2,35526,8883,1,398332800,398332800,13321,4440,8881,4440,0,1,4442,557278,0.557278
4840,3300,4540,14982000,2,38726,9683,1,423420800,423420800,14521,4840,9681,4840,0,1,4842,308575,0.308575
5240,3300,4540,14982000,2,41926,10483,1,448508800,448508800,15721,5240,10481,5240,0,1,5242,2997756,2.997756
5640,3300,4540,14982000,2,45126,11283,1,473596800,473596800,16921,5640,11281,5640,0,1,5642,1104445,1.104445
6040,3300,4540,14982000,2,48326,12083,1,498684800,498684800,18121,6040,12081,6040,0,1,6042,519610,0.51961
6440,3300,4540,14982000,2,51526,12883,1,523772800,523772800,19321,6440,12881,6440,0,1,6442,117057,0.117057
6840,3300,4540,14982000,2,54726,13683,1,548860800,548860800,20521,6840,13681,6840,0,1,6842,385256,0.385256
40,3550,4240,15052000,2,326,83,1,122908800,122908800,121,40,81,40,0,1,42,258312,0.258312
440,3550,4240,15052000,2,3526,883,1,147836800,147836800,1321,440,881,440,0,1,442,1347255,1.347255
840,3550,4240,15052000,2,6726,1683,1,172764800,172764800,2521,840,1681,840,0,1,842,1398911,1.398911
1240,3550,4240,15052000,2,9926,2483,1,197692800,197692800,3721,1240,2481,1240,0,1,1242,1552701,1.552701
1640,3550,4240,15052000,2,13126,3283,1,222620800,222620800,4921,1640,3281,1640,0,1,1642,1984873,1.984873
2040,3550,4240,15052000,2,16326,4083,1,247548800,247548800,6121,2040,4081,2040,0,1,2042,3845454,3.845454
2440,3550,4240,15052000,2,19526,4883,1,272476800,272476800,7321,2440,4881,2440,0,1,2442,202038,0.202038
2840,3550,4240,15052000,2,22726,5683,1,297404800,297404800,8521,2840,5681,2840,0,1,2842,2860441,2.860441
3240,3550,4240,15052000,2,25926,6483,1,322332800,322332800,9721,3240,6481,3240,0,1,3242,428838,0.428838
3640,3550,4240,15052000,2,29126,7283,1,347260800,347260800,10921,3640,7281,3640,0,1,3642,4309314,4.309314
4040,3550,4240,15052000,2,32326,8083,1,372188800,372188800,12121,4040,8081,4040,0,1,4042,458999,0.458999
4440,3550,4240,15052000,2,35526,8883,1,397116800,397116800,13321,4440,8881,4440,0,1,4442,2813764,2.813764
4840,3550,4240,15052000,2,38726,9683,1,422044800,422044800,14521,4840,9681,4840,0,1,4842,1248080,1.24808
5240,3550,4240,15052000,2,41926,10483,1,446972800,446972800,15721,5240,10481,5240,0,1,5242,386002,0.386002
5640,3550,4240,15052000,2,45126,11283,1,471900800,471900800,16921,5640,11281,5640,0,1,5642,300799,0.300799
6040,3550,4240,15052000,2,48326,12083,1,496828800,496828800,18121,6040,12081,6040,0,1,6042,2033727,2.033727
6440,3550,4240,15052000,2,51526,12883,1,521756800,521756800,19321,6440,12881,6440,0,1,6442,1218540,1.21854
6840,3550,4240,15052000,2,54726,13683,1,546684800,546684800,20521,6840,13681,6840,0,1,6842,5635730,5.63573
35,4950,3045,15072750,2,286,73,1,122820600,122820600,106,35,71,35,0,1,37,23605,0.023605
535,4950,3045,15072750,2,4286,1073,1,154800600,154800600,1606,535,1071,535,0,1,537,805083,0.805083
1035,4950,3045,15072750,2,8286,2073,1,186780600,186780600,3106,1035,2071,1035,0,1,1037,122815,0.122815
1535,4950,3045,15072750,2,12286,3073,1,218760600,218760600,4606,1535,3071,1535,0,1,1537,219324,0.219324
2035,4950,3045,15072750,2,16286,4073,1,250740600,250740600,6106,2035,4071,2035,0,1,2037,2666989,2.666989
2535,4950,3045,15072750,2,20286,5073,1,282720600,282720600,7606,2535,5071,2535,0,1,2537,2163598,2.163598
3035,4950,3045,15072750,2,24286,6073,1,314700600,314700600,9106,3035,6071,3035,0,1,3037,1094760,1.09476
3535,4950,3045,15072750,2,28286,7073,1,346680600,346680600,10606,3535,7071,3535,0,1,3537,2873636,2.873636
4035,4950,3045,15072750,2,32286,8073,1,378660600,378660600,12106,4035,8071,4035,0,1,4037,3604598,3.604598
4535,4950,3045,15072750,2,36286,9073,1,410640600,410640600,13606,4535,9071,4535,0,1,4537,991807,0.991807
5035,4950,3045,15072750,2,40286,10073,1,442620600,442620600,15106,5035,10071,5035,0,1,5037,1589294,1.589294
5535,4950,3045,15072750,2,44286,11073,1,474600600,474600600,16606,5535,11071,5535,0,1,5537,7607172,7.607172
6035,4950,3045,15072750,2,48286,12073,1,506580600,506580600,18106,6035,12071,6035,0,1,6037,6568476,6.568476
6535,4950,3045,15072750,2,52286,13073,1,538560600,538560600,19606,6535,13071,6535,0,1,6537,6793265,6.793265
7035,4950,3045,15072750,2,56286,14073,1,570540600,570540600,21106,7035,14071,7035,0,1,7037,7584451,7.584451
55,3805,3965,15086825,2,446,113,1,124113400,124113400,166,55,111,55,0,1,57,317292,0.317292
455,3805,3965,15086825,2,3646,913,1,148977400,148977400,1366,455,911,455,0,1,457,1459226,1.459226
855,3805,3965,15086825,2,6846,1713,1,173841400,173841400,2566,855,1711,855,0,1,857,2633952,2.633952
1255,3805,3965,15086825,2,10046,2513,1,198705400,198705400,3766,1255,2511,1255,0,1,1257,822005,0.822005
1655,3805,3965,15086825,2,13246,3313,1,223569400,223569400,4966,1655,3311,1655,0,1,1657,410762,0.410762
2055,3805,3965,15086825,2,16446,4113,1,248433400,248433400,6166,2055,4111,2055,0,1,2057,93064,0.093064
2455,3805,3965,15086825,2,19646,4913,1,273297400,273297400,7366,2455,4911,2455,0,1,2457,1217253,1.217253
2855,3805,3965,15086825,2,22846,5713,1,298161400,298161400,8566,2855,5711,2855,0,1,2857,2609519,2.609519
3255,3805,3965,15086825,2,26046,6513,1,323025400,323025400,9766,3255,6511,3255,0,1,3257,8624063,8.624063
3655,3805,3965,15086825,2,29246,7313,1,347889400,347889400,10966,3655,7311,3655,0,1,3657,6425783,6.425783
4055,3805,3965,15086825,2,32446,8113,1,372753400,372753400,12166,4055,8111,4055,0,1,4057,1819586,1.819586
4455,3805,3965,15086825,2,35646,8913,1,397617400,397617400,13366,4455,8911,4455,0,1,4457,6247150,6.24715
4855,3805,3965,15086825,2,38846,9713,1,422481400,422481400,14566,4855,9711,4855,0,1,4857,1397083,1.397083
5255,3805,3965,15086825,2,42046,10513,1,447345400,447345400,15766,5255,10511,5255,0,1,5257,897649,0.897649
5655,3805,3965,15086825,2,45246,11313,1,472209400,472209400,16966,5655,11311,5655,0,1,5657,311328,0.311328
6055,3805,3965,15086825,2,48446,12113,1,497073400,497073400,18166,6055,12111,6055,0,1,6057,3542109,3.542109
6455,3805,3965,15086825,2,51646,12913,1,521937400,521937400,19366,6455,12911,6455,0,1,6457,5310579,5.310579
6855,3805,3965,15086825,2,54846,13713,1,546801400,546801400,20566,6855,13711,6855,0,1,6857,937897,0.937897
40,7050,2140,15087000,2,326,83,1,123636800,123636800,121,40,81,40,0,1,42,262023,0.262023
440,7050,2140,15087000,2,3526,883,1,153044800,153044800,1321,440,881,440,0,1,442,1402792,1.402792
840,7050,2140,15087000,2,6726,1683,1,182452800,182452800,2521,840,1681,840,0,1,842,2565185,2.565185
1240,7050,2140,15087000,2,9926,2483,1,211860800,211860800,3721,1240,2481,1240,0,1,1242,3728383,3.728383
1640,7050,2140,15087000,2,13126,3283,1,241268800,241268800,4921,1640,3281,1640,0,1,1642,2597832,2.597832
2040,7050,2140,15087000,2,16326,4083,1,270676800,270676800,6121,2040,4081,2040,0,1,2042,53965,0.053965
2440,7050,2140,15087000,2,19526,4883,1,300084800,300084800,7321,2440,4881,2440,0,1,2442,7273154,7.273154
2840,7050,2140,15087000,2,22726,5683,1,329492800,329492800,8521,2840,5681,2840,0,1,2842,4687469,4.687469
3240,7050,2140,15087000,2,25926,6483,1,358900800,358900800,9721,3240,6481,3240,0,1,3242,4410120,4.41012
3640,7050,2140,15087000,2,29126,7283,1,388308800,388308800,10921,3640,7281,3640,0,1,3642,943343,0.943343
4040,7050,2140,15087000,2,32326,8083,1,417716800,417716800,12121,4040,8081,4040,0,1,4042,145948,0.145948
4440,7050,2140,15087000,2,35526,8883,1,447124800,447124800,13321,4440,8881,4440,0,1,4442,1229567,1.229567
4840,7050,2140,15087000,2,38726,9683,1,476532800,476532800,14521,4840,9681,4840,0,1,4842,13300477,13.300477
5240,7050,2140,15087000,2,41926,10483,1,505940800,505940800,15721,5240,10481,5240,0,1,5242,15453228,15.453228
5640,7050,2140,15087000,2,45126,11283,1,535348800,535348800,16921,5640,11281,5640,0,1,5642,16639726,16.639726
6040,7050,2140,15087000,2,48326,12083,1,564756800,564756800,18121,6040,12081,6040,0,1,6042,17920863,17.920863
6440,7050,2140,15087000,2,51526,12883,1,594164800,594164800,19321,6440,12881,6440,0,1,6442,19041428,19.041428
6840,7050,2140,15087000,2,54726,13683,1,623572800,623572800,20521,6840,13681,6840,0,1,6842,20261760,20.26176
55,3305,4565,15087325,2,446,113,1,124161400,124161400,166,55,111,55,0,1,57,231573,0.231573
455,3305,4565,15087325,2,3646,913,1,149345400,149345400,1366,455,911,455,0,1,457,1444579,1.444579
855,3305,4565,15087325,2,6846,1713,1,174529400,174529400,2566,855,1711,855,0,1,857,575688,0.575688
1255,3305,4565,15087325,2,10046,2513,1,199713400,199713400,3766,1255,2511,1255,0,1,1257,1500778,1.500778
1655,3305,4565,15087325,2,13246,3313,1,224897400,224897400,4966,1655,3311,1655,0,1,1657,232035,0.232035
2055,3305,4565,15087325,2,16446,4113,1,250081400,250081400,6166,2055,4111,2055,0,1,2057,193663,0.193663
2455,3305,4565,15087325,2,19646,4913,1,275265400,275265400,7366,2455,4911,2455,0,1,2457,1210635,1.210635
2855,3305,4565,15087325,2,22846,5713,1,300449400,300449400,8566,2855,5711,2855,0,1,2857,1685103,1.685103
3255,3305,4565,15087325,2,26046,6513,1,325633400,325633400,9766,3255,6511,3255,0,1,3257,92734,0.092734
3655,3305,4565,15087325,2,29246,7313,1,350817400,350817400,10966,3655,7311,3655,0,1,3657,89575,0.089575
4055,3305,4565,15087325,2,32446,8113,1,376001400,376001400,12166,4055,8111,4055,0,1,4057,104004,0.104004
4455,3305,4565,15087325,2,35646,8913,1,401185400,401185400,13366,4455,8911,4455,0,1,4457,1970041,1.970041
4855,3305,4565,15087325,2,38846,9713,1,426369400,426369400,14566,4855,9711,4855,0,1,4857,2055231,2.055231
5255,3305,4565,15087325,2,42046,10513,1,451553400,451553400,15766,5255,10511,5255,0,1,5257,710134,0.710134
5655,3305,4565,15087325,2,45246,11313,1,476737400,476737400,16966,5655,11311,5655,0,1,5657,3812963,3.812963
6055,3305,4565,15087325,2,48446,12113,1,501921400,501921400,18166,6055,12111,6055,0,1,6057,626947,0.626947
6455,3305,4565,15087325,2,51646,12913,1,527105400,527105400,19366,6455,12911,6455,0,1,6457,2302960,2.30296
6855,3305,4565,15087325,2,54846,13713,1,552289400,552289400,20566,6855,13711,6855,0,1,6857,1025881,1.025881
55,3555,4265,15162075,2,446,113,1,124737400,124737400,166,55,111,55,0,1,57,314049,0.314049
455,3555,4265,15162075,2,3646,913,1,149761400,149761400,1366,455,911,455,0,1,457,1249278,1.249278
855,3555,4265,15162075,2,6846,1713,1,174785400,174785400,2566,855,1711,855,0,1,857,2378987,2.378987
1255,3555,4265,15162075,2,10046,2513,1,199809400,199809400,3766,1255,2511,1255,0,1,1257,3328493,3.328493
1655,3555,4265,15162075,2,13246,3313,1,224833400,224833400,4966,1655,3311,1655,0,1,1657,4209450,4.20945
2055,3555,4265,15162075,2,16446,4113,1,249857400,249857400,6166,2055,4111,2055,0,1,2057,2587620,2.58762
2455,3555,4265,15162075,2,19646,4913,1,274881400,274881400,7366,2455,4911,2455,0,1,2457,1521119,1.521119
2855,3555,4265,15162075,2,22846,5713,1,299905400,299905400,8566,2855,5711,2855,0,1,2857,1184887,1.184887
3255,3555,4265,15162075,2,26046,6513,1,324929400,324929400,9766,3255,6511,3255,0,1,3257,3448167,3.448167
3655,3555,4265,15162075,2,29246,7313,1,349953400,349953400,10966,3655,7311,3655,0,1,3657,4116883,4.116883
4055,3555,4265,15162075,2,32446,8113,1,374977400,374977400,12166,4055,8111,4055,0,1,4057,2310285,2.310285
4455,3555,4265,15162075,2,35646,8913,1,400001400,400001400,13366,4455,8911,4455,0,1,4457,302828,0.302828
4855,3555,4265,15162075,2,38846,9713,1,425025400,425025400,14566,4855,9711,4855,0,1,4857,5681510,5.68151
5255,3555,4265,15162075,2,42046,10513,1,450049400,450049400,15766,5255,10511,5255,0,1,5257,854782,0.854782
5655,3555,4265,15162075,2,45246,11313,1,475073400,475073400,16966,5655,11311,5655,0,1,5657,3854482,3.854482
6055,3555,4265,15162075,2,48446,12113,1,500097400,500097400,18166,6055,12111,6055,0,1,6057,844380,0.84438
6455,3555,4265,15162075,2,51646,12913,1,525121400,525121400,19366,6455,12911,6455,0,1,6457,711575,0.711575
6855,3555,4265,15162075,2,54846,13713,1,550145400,550145400,20566,6855,13711,6855,0,1,6857,407905,0.407905
35,3340,4545,15180300,2,286,73,1,123650200,123650200,106,35,71,35,0,1,37,269059,0.269059
535,3340,4545,15180300,2,4286,1073,1,155190200,155190200,1606,535,1071,535,0,1,537,1624051,1.624051
1035,3340,4545,15180300,2,8286,2073,1,186730200,186730200,3106,1035,2071,1035,0,1,1037,3041970,3.04197
1535,3340,4545,15180300,2,12286,3073,1,218270200,218270200,4606,1535,3071,1535,0,1,1537,4458780,4.45878
2035,3340,4545,15180300,2,16286,4073,1,249810200,249810200,6106,2035,4071,2035,0,1,2037,5872682,5.872682
39,3343,4541,15180563,2,318,81,1,123904312,123904312,118,39,79,39,0,1,41,10353,0.010353
539,3343,4541,15180563,2,4318,1081,1,155440312,155440312,1618,539,1079,539,0,1,541,10492,0.010492
1039,3343,4541,15180563,2,8318,2081,1,186976312,186976312,3118,1039,2079,1039,0,1,1041,95877,0.095877
1539,3343,4541,15180563,2,12318,3081,1,218512312,218512312,4618,1539,3079,1539,0,1,1541,401477,0.401477
2039,3343,4541,15180563,2,16318,4081,1,250048312,250048312,6118,2039,4079,2039,0,1,2041,178560,0.17856
2539,3343,4541,15180563,2,20318,5081,1,281584312,281584312,7618,2539,5079,2539,0,1,2541,217382,0.217382
3039,3343,4541,15180563,2,24318,6081,1,313120312,313120312,9118,3039,6079,3039,0,1,3041,278038,0.278038
3539,3343,4541,15180563,2,28318,7081,1,344656312,344656312,10618,3539,7079,3539,0,1,3541,615881,0.615881
4039,3343,4541,15180563,2,32318,8081,1,376192312,376192312,12118,4039,8079,4039,0,1,4041,511740,0.51174
4539,3343,4541,15180563,2,36318,9081,1,407728312,407728312,13618,4539,9079,4539,0,1,4541,2107016,2.107016
5039,3343,4541,15180563,2,40318,10081,1,439264312,439264312,15118,5039,10079,5039,0,1,5041,5755599,5.755599
5539,3343,4541,15180563,2,44318,11081,1,470800312,470800312,16618,5539,11079,5539,0,1,5541,167110,0.16711
6039,3343,4541,15180563,2,48318,12081,1,502336312,502336312,18118,6039,12079,6039,0,1,6041,246253,0.246253
6539,3343,4541,15180563,2,52318,13081,1,533872312,533872312,19618,6539,13079,6539,0,1,6541,4901473,4.901473
7039,3343,4541,15180563,2,56318,14081,1,565408312,565408312,21118,7039,14079,7039,0,1,7041,8281376,8.281376
39,4993,3041,15183713,2,318,81,1,123976312,123976312,118,39,79,39,0,1,41,266789,0.266789
539,4993,3041,15183713,2,4318,1081,1,156112312,156112312,1618,539,1079,539,0,1,541,1645196,1.645196
1039,4993,3041,15183713,2,8318,2081,1,188248312,188248312,3118,1039,2079,1039,0,1,1041,2455128,2.455128
1539,4993,3041,15183713,2,12318,3081,1,220384312,220384312,4618,1539,3079,1539,0,1,1541,1099755,1.099755
2039,4993,3041,15183713,2,16318,4081,1,252520312,252520312,6118,2039,4079,2039,0,1,2041,3844865,3.844865
2539,4993,3041,15183713,2,20318,5081,1,284656312,284656312,7618,2539,5079,2539,0,1,2541,1514091,1.514091
3039,4993,3041,15183713,2,24318,6081,1,316792312,316792312,9118,3039,6079,3039,0,1,3041,3149988,3.149988
3539,4993,3041,15183713,2,28318,7081,1,348928312,348928312,10618,3539,7079,3539,0,1,3541,10133785,10.133785
4039,4993,3041,15183713,2,32318,8081,1,381064312,381064312,12118,4039,8079,4039,0,1,4041,2643260,2.64326
4539,4993,3041,15183713,2,36318,9081,1,413200312,413200312,13618,4539,9079,4539,0,1,4541,12907635,12.907635
5039,4993,3041,15183713,2,40318,10081,1,445336312,445336312,15118,5039,10079,5039,0,1,5041,14343674,14.343674
5539,4993,3041,15183713,2,44318,11081,1,477472312,477472312,16618,5539,11079,5539,0,1,5541,787687,0.787687
6039,4993,3041,15183713,2,48318,12081,1,509608312,509608312,18118,6039,12079,6039,0,1,6041,17150674,17.150674
6539,4993,3041,15183713,2,52318,13081,1,541744312,541744312,19618,6539,13079,6539,0,1,6541,18685182,18.685182
7039,4993,3041,15183713,2,56318,14081,1,573880312,573880312,21118,7039,14079,7039,0,1,7041,20027860,20.02786
40,4550,3340,15197000,2,326,83,1,124100800,124100800,121,40,81,40,0,1,42,276016,0.276016
440,4550,3340,15197000,2,3526,883,1,149348800,149348800,1321,440,881,440,0,1,442,1366778,1.366778
840,4550,3340,15197000,2,6726,1683,1,174596800,174596800,2521,840,1681,840,0,1,842,469715,0.469715
1240,4550,3340,15197000,2,9926,2483,1,199844800,199844800,3721,1240,2481,1240,0,1,1242,1068357,1.068357
1640,4550,3340,15197000,2,13126,3283,1,225092800,225092800,4921,1640,3281,1640,0,1,1642,2231551,2.231551
2040,4550,3340,15197000,2,16326,4083,1,250340800,250340800,6121,2040,4081,2040,0,1,2042,769357,0.769357
2440,4550,3340,15197000,2,19526,4883,1,275588800,275588800,7321,2440,4881,2440,0,1,2442,4818503,4.818503
2840,4550,3340,15197000,2,22726,5683,1,300836800,300836800,8521,2840,5681,2840,0,1,2842,1324871,1.324871
3240,4550,3340,15197000,2,25926,6483,1,326084800,326084800,9721,3240,6481,3240,0,1,3242,1467730,1.46773
3640,4550,3340,15197000,2,29126,7283,1,351332800,351332800,10921,3640,7281,3640,0,1,3642,63427,0.063427
4040,4550,3340,15197000,2,32326,8083,1,376580800,376580800,12121,4040,8081,4040,0,1,4042,1417218,1.417218
4440,4550,3340,15197000,2,35526,8883,1,401828800,401828800,13321,4440,8881,4440,0,1,4442,12089967,12.089967
4840,4550,3340,15197000,2,38726,9683,1,427076800,427076800,14521,4840,9681,4840,0,1,4842,3393611,3.393611
5240,4550,3340,15197000,2,41926,10483,1,452324800,452324800,15721,5240,10481,5240,0,1,5242,146216,0.146216
5640,4550,3340,15197000,2,45126,11283,1,477572800,477572800,16921,5640,11281,5640,0,1,5642,536638,0.536638
6040,4550,3340,15197000,2,48326,12083,1,502820800,502820800,18121,6040,12081,6040,0,1,6042,615402,0.615402
6440,4550,3340,15197000,2,51526,12883,1,528068800,528068800,19321,6440,12881,6440,0,1,6442,5801708,5.801708
6840,4550,3340,15197000,2,54726,13683,1,553316800,553316800,20521,6840,13681,6840,0,1,6842,773885,0.773885
40,5550,2740,15207000,2,326,83,1,124308800,124308800,121,40,81,40,0,1,42,278349,0.278349
440,5550,2740,15207000,2,3526,883,1,150836800,150836800,1321,440,881,440,0,1,442,914254,0.914254
840,5550,2740,15207000,2,6726,1683,1,177364800,177364800,2521,840,1681,840,0,1,842,676914,0.676914
1240,5550,2740,15207000,2,9926,2483,1,203892800,203892800,3721,1240,2481,1240,0,1,1242,3754111,3.754111
1640,5550,2740,15207000,2,13126,3283,1,230420800,230420800,4921,1640,3281,1640,0,1,1642,4890166,4.890166
2040,5550,2740,15207000,2,16326,4083,1,256948800,256948800,6121,2040,4081,2040,0,1,2042,101499,0.101499
2440,5550,2740,15207000,2,19526,4883,1,283476800,283476800,7321,2440,4881,2440,0,1,2442,1878007,1.878007
2840,5550,2740,15207000,2,22726,5683,1,310004800,310004800,8521,2840,5681,2840,0,1,2842,573268,0.573268
3240,5550,2740,15207000,2,25926,6483,1,336532800,336532800,9721,3240,6481,3240,0,1,3242,873613,0.873613
3640,5550,2740,15207000,2,29126,7283,1,363060800,363060800,10921,3640,7281,3640,0,1,3642,155920,0.15592
4040,5550,2740,15207000,2,32326,8083,1,389588800,389588800,12121,4040,8081,4040,0,1,4042,1831639,1.831639
4440,5550,2740,15207000,2,35526,8883,1,416116800,416116800,13321,4440,8881,4440,0,1,4442,711347,0.711347
4840,5550,2740,15207000,2,38726,9683,1,442644800,442644800,14521,4840,9681,4840,0,1,4842,7992969,7.992969
5240,5550,2740,15207000,2,41926,10483,1,469172800,469172800,15721,5240,10481,5240,0,1,5242,3196506,3.196506
5640,5550,2740,15207000,2,45126,11283,1,495700800,495700800,16921,5640,11281,5640,0,1,5642,5208377,5.208377
6040,5550,2740,15207000,2,48326,12083,1,522228800,522228800,18121,6040,12081,6040,0,1,6042,7425320,7.42532
6440,5550,2740,15207000,2,51526,12883,1,548756800,548756800,19321,6440,12881,6440,0,1,6442,2466731,2.466731
6840,5550,2740,15207000,2,54726,13683,1,575284800,575284800,20521,6840,13681,6840,0,1,6842,7864158,7.864158
40,2800,5440,15232000,2,326,83,1,124492800,124492800,121,40,81,40,0,1,42,265971,0.265971
440,2800,5440,15232000,2,3526,883,1,150860800,150860800,1321,440,881,440,0,1,442,1332858,1.332858
840,2800,5440,15232000,2,6726,1683,1,177228800,177228800,2521,840,1681,840,0,1,842,12403,0.012403
1240,2800,5440,15232000,2,9926,2483,1,203596800,203596800,3721,1240,2481,1240,0,1,1242,775740,0.77574
1640,2800,5440,15232000,2,13126,3283,1,229964800,229964800,4921,1640,3281,1640,0,1,1642,2471730,2.47173
2040,2800,5440,15232000,2,16326,4083,1,256332800,256332800,6121,2040,4081,2040,0,1,2042,3279562,3.279562
2440,2800,5440,15232000,2,19526,4883,1,282700800,282700800,7321,2440,4881,2440,0,1,2442,3467752,3.467752
2840,2800,5440,15232000,2,22726,5683,1,309068800,309068800,8521,2840,5681,2840,0,1,2842,885327,0.885327
3240,2800,5440,15232000,2,25926,6483,1,335436800,335436800,9721,3240,6481,3240,0,1,3242,442776,0.442776
3640,2800,5440,15232000,2,29126,7283,1,361804800,361804800,10921,3640,7281,3640,0,1,3642,2195237,2.195237
4040,2800,5440,15232000,2,32326,8083,1,388172800,388172800,12121,4040,8081,4040,0,1,4042,6961747,6.961747
4440,2800,5440,15232000,2,35526,8883,1,414540800,414540800,13321,4440,8881,4440,0,1,4442,5195692,5.195692
4840,2800,5440,15232000,2,38726,9683,1,440908800,440908800,14521,4840,9681,4840,0,1,4842,530508,0.530508
5240,2800,5440,15232000,2,41926,10483,1,467276800,467276800,15721,5240,10481,5240,0,1,5242,179726,0.179726
5640,2800,5440,15232000,2,45126,11283,1,493644800,493644800,16921,5640,11281,5640,0,1,5642,1350923,1.350923
6040,2800,5440,15232000,2,48326,12083,1,520012800,520012800,18121,6040,12081,6040,0,1,6042,4934684,4.934684
6440,2800,5440,15232000,2,51526,12883,1,546380800,546380800,19321,6440,12881,6440,0,1,6442,1585406,1.585406
6840,2800,5440,15232000,2,54726,13683,1,572748800,572748800,20521,6840,13681,6840,0,1,6842,7314693,7.314693
40,2300,6640,15272000,2,326,83,1,125036800,125036800,121,40,81,40,0,1,42,148630,0.14863
440,2300,6640,15272000,2,3526,883,1,153644800,153644800,1321,440,881,440,0,1,442,964734,0.964734
840,2300,6640,15272000,2,6726,1683,1,182252800,182252800,2521,840,1681,840,0,1,842,569427,0.569427
1240,2300,6640,15272000,2,9926,2483,1,210860800,210860800,3721,1240,2481,1240,0,1,1242,179224,0.179224
1640,2300,6640,15272000,2,13126,3283,1,239468800,239468800,4921,1640,3281,1640,0,1,1642,1400479,1.400479
2040,2300,6640,15272000,2,16326,4083,1,268076800,268076800,6121,2040,4081,2040,0,1,2042,291499,0.291499
2440,2300,6640,15272000,2,19526,4883,1,296684800,296684800,7321,2440,4881,2440,0,1,2442,4225648,4.225648
2840,2300,6640,15272000,2,22726,5683,1,325292800,325292800,8521,2840,5681,2840,0,1,2842,253550,0.25355
3240,2300,6640,15272000,2,25926,6483,1,353900800,353900800,9721,3240,6481,3240,0,1,3242,126253,0.126253
3640,2300,6640,15272000,2,29126,7283,1,382508800,382508800,10921,3640,7281,3640,0,1,3642,3859302,3.859302
4040,2300,6640,15272000,2,32326,8083,1,411116800,411116800,12121,4040,8081,4040,0,1,4042,3640251,3.640251
4440,2300,6640,15272000,2,35526,8883,1,439724800,439724800,13321,4440,8881,4440,0,1,4442,269479,0.269479
4840,2300,6640,15272000,2,38726,9683,1,468332800,468332800,14521,4840,9681,4840,0,1,4842,518654,0.518654
5240,2300,6640,15272000,2,41926,10483,1,496940800,496940800,15721,5240,10481,5240,0,1,5242,931942,0.931942
5640,2300,6640,15272000,2,45126,11283,1,525548800,525548800,16921,5640,11281,5640,0,1,5642,904601,0.904601
6040,2300,6640,15272000,2,48326,12083,1,554156800,554156800,18121,6040,12081,6040,0,1,6042,63987,0.063987
6440,2300,6640,15272000,2,51526,12883,1,582764800,582764800,19321,6440,12881,6440,0,1,6442,1189377,1.189377
6840,2300,6640,15272000,2,54726,13683,1,611372800,611372800,20521,6840,13681,6840,0,1,6842,375534,0.375534
44,3353,4555,15272915,2,358,91,1,124966936,124966936,133,44,89,44,0,1,46,10948,0.010948
544,3353,4555,15272915,2,4358,1091,1,156598936,156598936,1633,544,1089,544,0,1,546,21776,0.021776
1044,3353,4555,15272915,2,8358,2091,1,188230936,188230936,3133,1044,2089,1044,0,1,1046,78207,0.078207
1544,3353,4555,15272915,2,12358,3091,1,219862936,219862936,4633,1544,3089,1544,0,1,1546,142303,0.142303
2044,3353,4555,15272915,2,16358,4091,1,251494936,251494936,6133,2044,4089,2044,0,1,2046,2314629,2.314629
2544,3353,4555,15272915,2,20358,5091,1,283126936,283126936,7633,2544,5089,2544,0,1,2546,347214,0.347214
3044,3353,4555,15272915,2,24358,6091,1,314758936,314758936,9133,3044,6089,3044,0,1,3046,1197988,1.197988
3544,3353,4555,15272915,2,28358,7091,1,346390936,346390936,10633,3544,7089,3544,0,1,3546,1866221,1.866221
4044,3353,4555,15272915,2,32358,8091,1,378022936,378022936,12133,4044,8089,4044,0,1,4046,172033,0.172033
4544,3353,4555,15272915,2,36358,9091,1,409654936,409654936,13633,4544,9089,4544,0,1,4546,662103,0.662103
5044,3353,4555,15272915,2,40358,10091,1,441286936,441286936,15133,5044,10089,5044,0,1,5046,2422255,2.422255
5544,3353,4555,15272915,2,44358,11091,1,472918936,472918936,16633,5544,11089,5544,0,1,5546,2086019,2.086019
6044,3353,4555,15272915,2,48358,12091,1,504550936,504550936,18133,6044,12089,6044,0,1,6046,56105,0.056105
6544,3353,4555,15272915,2,52358,13091,1,536182936,536182936,19633,6544,13089,6544,0,1,6546,817137,0.817137
7044,3353,4555,15272915,2,56358,14091,1,567814936,567814936,21133,7044,14089,7044,0,1,7046,5064286,5.064286
55,7055,2165,15274075,2,446,113,1,126249400,126249400,166,55,111,55,0,1,57,305655,0.305655
455,7055,2165,15274075,2,3646,913,1,155753400,155753400,1366,455,911,455,0,1,457,1460338,1.460338
855,7055,2165,15274075,2,6846,1713,1,185257400,185257400,2566,855,1711,855,0,1,857,2635773,2.635773
1255,7055,2165,15274075,2,10046,2513,1,214761400,214761400,3766,1255,2511,1255,0,1,1257,899428,0.899428
1655,7055,2165,15274075,2,13246,3313,1,244265400,244265400,4966,1655,3311,1655,0,1,1657,3010711,3.010711
2055,7055,2165,15274075,2,16446,4113,1,273769400,273769400,6166,2055,4111,2055,0,1,2057,1894654,1.894654
2455,7055,2165,15274075,2,19646,4913,1,303273400,303273400,7366,2455,4911,2455,0,1,2457,5453755,5.453755
2855,7055,2165,15274075,2,22846,5713,1,332777400,332777400,8566,2855,5711,2855,0,1,2857,2057912,2.057912
3255,7055,2165,15274075,2,26046,6513,1,362281400,362281400,9766,3255,6511,3255,0,1,3257,4008075,4.008075
3655,7055,2165,15274075,2,29246,7313,1,391785400,391785400,10966,3655,7311,3655,0,1,3657,292095,0.292095
4055,7055,2165,15274075,2,32446,8113,1,421289400,421289400,12166,4055,8111,4055,0,1,4057,1723337,1.723337
4455,7055,2165,15274075,2,35646,8913,1,450793400,450793400,13366,4455,8911,4455,0,1,4457,2268712,2.268712
4855,7055,2165,15274075,2,38846,9713,1,480297400,480297400,14566,4855,9711,4855,0,1,4857,9303635,9.303635
5255,7055,2165,15274075,2,42046,10513,1,509801400,509801400,15766,5255,10511,5255,0,1,5257,2409443,2.409443
5655,7055,2165,15274075,2,45246,11313,1,539305400,539305400,16966,5655,11311,5655,0,1,5657,16845828,16.845828
6055,7055,2165,15274075,2,48446,12113,1,568809400,568809400,18166,6055,12111,6055,0,1,6057,18186592,18.186592
6455,7055,2165,15274075,2,51646,12913,1,598313400,598313400,19366,6455,12911,6455,0,1,6457,19398269,19.398269
6855,7055,2165,15274075,2,54846,13713,1,627817400,627817400,20566,6855,13711,6855,0,1,6857,20634179,20.634179
44,5003,3055,15284165,2,358,91,1,125109736,125109736,133,44,89,44,0,1,46,281988,0.281988
544,5003,3055,15284165,2,4358,1091,1,157341736,157341736,1633,544,1089,544,0,1,546,764742,0.764742
1044,5003,3055,15284165,2,8358,2091,1,189573736,189573736,3133,1044,2089,1044,0,1,1046,3088543,3.088543
1544,5003,3055,15284165,2,12358,3091,1,221805736,221805736,4633,1544,3089,1544,0,1,1546,959767,0.959767
2044,5003,3055,15284165,2,16358,4091,1,254037736,254037736,6133,2044,4089,2044,0,1,2046,5865915,5.865915
2544,5003,3055,15284165,2,20358,5091,1,286269736,286269736,7633,2544,5089,2544,0,1,2546,7352753,7.352753
3044,5003,3055,15284165,2,24358,6091,1,318501736,318501736,9133,3044,6089,3044,0,1,3046,3289940,3.28994
3544,5003,3055,15284165,2,28358,7091,1,350733736,350733736,10633,3544,7089,3544,0,1,3546,4201901,4.201901
4044,5003,3055,15284165,2,32358,8091,1,382965736,382965736,12133,4044,8089,4044,0,1,4046,11566140,11.56614
4544,5003,3055,15284165,2,36358,9091,1,415197736,415197736,13633,4544,9089,4544,0,1,4546,12149294,12.149294
5044,5003,3055,15284165,2,40358,10091,1,447429736,447429736,15133,5044,10089,5044,0,1,5046,13865601,13.865601
5544,5003,3055,15284165,2,44358,11091,1,479661736,479661736,16633,5544,11089,5544,0,1,5546,15941893,15.941893
6044,5003,3055,15284165,2,48358,12091,1,511893736,511893736,18133,6044,12089,6044,0,1,6046,17422738,17.422738
6544,5003,3055,15284165,2,52358,13091,1,544125736,544125736,19633,6544,13089,6544,0,1,6546,18713565,18.713565
7044,5003,3055,15284165,2,56358,14091,1,576357736,576357736,21133,7044,14089,7044,0,1,7046,20155994,20.155994
55,4555,3365,15327575,2,446,113,1,126105400,126105400,166,55,111,55,0,1,57,315242,0.315242
455,4555,3365,15327575,2,3646,913,1,151449400,151449400,1366,455,911,455,0,1,457,210540,0.21054
855,4555,3365,15327575,2,6846,1713,1,176793400,176793400,2566,855,1711,855,0,1,857,684971,0.684971
1255,4555,3365,15327575,2,10046,2513,1,202137400,202137400,3766,1255,2511,1255,0,1,1257,1635861,1.635861
1655,4555,3365,15327575,2,13246,3313,1,227481400,227481400,4966,1655,3311,1655,0,1,1657,3705850,3.70585
2055,4555,3365,15327575,2,16446,4113,1,252825400,252825400,6166,2055,4111,2055,0,1,2057,2448055,2.448055
2455,4555,3365,15327575,2,19646,4913,1,278169400,278169400,7366,2455,4911,2455,0,1,2457,313399,0.313399
2855,4555,3365,15327575,2,22846,5713,1,303513400,303513400,8566,2855,5711,2855,0,1,2857,302405,0.302405
3255,4555,3365,15327575,2,26046,6513,1,328857400,328857400,9766,3255,6511,3255,0,1,3257,6563240,6.56324
3655,4555,3365,15327575,2,29246,7313,1,354201400,354201400,10966,3655,7311,3655,0,1,3657,24550,0.02455
4055,4555,3365,15327575,2,32446,8113,1,379545400,379545400,12166,4055,8111,4055,0,1,4057,11713338,11.713338
4455,4555,3365,15327575,2,35646,8913,1,404889400,404889400,13366,4455,8911,4455,0,1,4457,3191168,3.191168
4855,4555,3365,15327575,2,38846,9713,1,430233400,430233400,14566,4855,9711,4855,0,1,4857,2591881,2.591881
5255,4555,3365,15327575,2,42046,10513,1,455577400,455577400,15766,5255,10511,5255,0,1,5257,3694734,3.694734
5655,4555,3365,15327575,2,45246,11313,1,480921400,480921400,16966,5655,11311,5655,0,1,5657,2263127,2.263127
6055,4555,3365,15327575,2,48446,12113,1,506265400,506265400,18166,6055,12111,6055,0,1,6057,3089103,3.089103
6455,4555,3365,15327575,2,51646,12913,1,531609400,531609400,19366,6455,12911,6455,0,1,6457,2046132,2.046132
6855,4555,3365,15327575,2,54846,13713,1,556953400,556953400,20566,6855,13711,6855,0,1,6857,4425996,4.425996
55,2805,5465,15329325,2,446,113,1,126273400,126273400,166,55,111,55,0,1,57,306157,0.306157
455,2805,5465,15329325,2,3646,913,1,152737400,152737400,1366,455,911,455,0,1,457,542898,0.542898
855,2805,5465,15329325,2,6846,1713,1,179201400,179201400,2566,855,1711,855,0,1,857,2065592,2.065592
1255,2805,5465,15329325,2,10046,2513,1,205665400,205665400,3766,1255,2511,1255,0,1,1257,2110250,2.11025
1655,2805,5465,15329325,2,13246,3313,1,232129400,232129400,4966,1655,3311,1655,0,1,1657,2924412,2.924412
2055,2805,5465,15329325,2,16446,4113,1,258593400,258593400,6166,2055,4111,2055,0,1,2057,324293,0.324293
2455,2805,5465,15329325,2,19646,4913,1,285057400,285057400,7366,2455,4911,2455,0,1,2457,1811908,1.811908
2855,2805,5465,15329325,2,22846,5713,1,311521400,311521400,8566,2855,5711,2855,0,1,2857,1872872,1.872872
3255,2805,5465,15329325,2,26046,6513,1,337985400,337985400,9766,3255,6511,3255,0,1,3257,3348126,3.348126
3655,2805,5465,15329325,2,29246,7313,1,364449400,364449400,10966,3655,7311,3655,0,1,3657,35442,0.035442
4055,2805,5465,15329325,2,32446,8113,1,390913400,390913400,12166,4055,8111,4055,0,1,4057,8198694,8.198694
4455,2805,5465,15329325,2,35646,8913,1,417377400,417377400,13366,4455,8911,4455,0,1,4457,2058854,2.058854
4855,2805,5465,15329325,2,38846,9713,1,443841400,443841400,14566,4855,9711,4855,0,1,4857,6500101,6.500101
5255,2805,5465,15329325,2,42046,10513,1,470305400,470305400,15766,5255,10511,5255,0,1,5257,549010,0.54901
5655,2805,5465,15329325,2,45246,11313,1,496769400,496769400,16966,5655,11311,5655,0,1,5657,3510515,3.510515
6055,2805,5465,15329325,2,48446,12113,1,523233400,523233400,18166,6055,12111,6055,0,1,6057,2560499,2.560499
6455,2805,5465,15329325,2,51646,12913,1,549697400,549697400,19366,6455,12911,6455,0,1,6457,1735892,1.735892
6855,2805,5465,15329325,2,54846,13713,1,576161400,576161400,20566,6855,13711,6855,0,1,6857,355076,0.355076
40,5050,3040,15352000,2,326,83,1,125404800,125404800,121,40,81,40,0,1,42,22921,0.022921
440,5050,3040,15352000,2,3526,883,1,151292800,151292800,1321,440,881,440,0,1,442,75723,0.075723
840,5050,3040,15352000,2,6726,1683,1,177180800,177180800,2521,840,1681,840,0,1,842,16374,0.016374
1240,5050,3040,15352000,2,9926,2483,1,203068800,203068800,3721,1240,2481,1240,0,1,1242,963875,0.963875
1640,5050,3040,15352000,2,13126,3283,1,228956800,228956800,4921,1640,3281,1640,0,1,1642,223821,0.223821
2040,5050,3040,15352000,2,16326,4083,1,254844800,254844800,6121,2040,4081,2040,0,1,2042,289918,0.289918
2440,5050,3040,15352000,2,19526,4883,1,280732800,280732800,7321,2440,4881,2440,0,1,2442,335390,0.33539
2840,5050,3040,15352000,2,22726,5683,1,306620800,306620800,8521,2840,5681,2840,0,1,2842,781173,0.781173
3240,5050,3040,15352000,2,25926,6483,1,332508800,332508800,9721,3240,6481,3240,0,1,3242,690969,0.690969
3640,5050,3040,15352000,2,29126,7283,1,358396800,358396800,10921,3640,7281,3640,0,1,3642,285214,0.285214
4040,5050,3040,15352000,2,32326,8083,1,384284800,384284800,12121,4040,8081,4040,0,1,4042,225446,0.225446
4440,5050,3040,15352000,2,35526,8883,1,410172800,410172800,13321,4440,8881,4440,0,1,4442,182647,0.182647
4840,5050,3040,15352000,2,38726,9683,1,436060800,436060800,14521,4840,9681,4840,0,1,4842,4554878,4.554878
5240,5050,3040,15352000,2,41926,10483,1,461948800,461948800,15721,5240,10481,5240,0,1,5242,104243,0.104243
5640,5050,3040,15352000,2,45126,11283,1,487836800,487836800,16921,5640,11281,5640,0,1,5642,317326,0.317326
6040,5050,3040,15352000,2,48326,12083,1,513724800,513724800,18121,6040,12081,6040,0,1,6042,333903,0.333903
6440,5050,3040,15352000,2,51526,12883,1,539612800,539612800,19321,6440,12881,6440,0,1,6442,198949,0.198949
6840,5050,3040,15352000,2,54726,13683,1,565500800,565500800,20521,6840,13681,6840,0,1,6842,1117717,1.117717
55,5555,2765,15359575,2,446,113,1,126537400,126537400,166,55,111,55,0,1,57,311785,0.311785
455,5555,2765,15359575,2,3646,913,1,153161400,153161400,1366,455,911,455,0,1,457,1465354,1.465354
855,5555,2765,15359575,2,6846,1713,1,179785400,179785400,2566,855,1711,855,0,1,857,2614668,2.614668
1255,5555,2765,15359575,2,10046,2513,1,206409400,206409400,3766,1255,2511,1255,0,1,1257,3695566,3.695566
1655,5555,2765,15359575,2,13246,3313,1,233033400,233033400,4966,1655,3311,1655,0,1,1657,295609,0.295609
2055,5555,2765,15359575,2,16446,4113,1,259657400,259657400,6166,2055,4111,2055,0,1,2057,275584,0.275584
2455,5555,2765,15359575,2,19646,4913,1,286281400,286281400,7366,2455,4911,2455,0,1,2457,7336554,7.336554
2855,5555,2765,15359575,2,22846,5713,1,312905400,312905400,8566,2855,5711,2855,0,1,2857,293290,0.29329
3255,5555,2765,15359575,2,26046,6513,1,339529400,339529400,9766,3255,6511,3255,0,1,3257,487366,0.487366
3655,5555,2765,15359575,2,29246,7313,1,366153400,366153400,10966,3655,7311,3655,0,1,3657,4469433,4.469433
4055,5555,2765,15359575,2,32446,8113,1,392777400,392777400,12166,4055,8111,4055,0,1,4057,1345646,1.345646
4455,5555,2765,15359575,2,35646,8913,1,419401400,419401400,13366,4455,8911,4455,0,1,4457,1674608,1.674608
4855,5555,2765,15359575,2,38846,9713,1,446025400,446025400,14566,4855,9711,4855,0,1,4857,2858552,2.858552
5255,5555,2765,15359575,2,42046,10513,1,472649400,472649400,15766,5255,10511,5255,0,1,5257,4602072,4.602072
5655,5555,2765,15359575,2,45246,11313,1,499273400,499273400,16966,5655,11311,5655,0,1,5657,875623,0.875623
6055,5555,2765,15359575,2,48446,12113,1,525897400,525897400,18166,6055,12111,6055,0,1,6057,1392037,1.392037
6455,5555,2765,15359575,2,51646,12913,1,552521400,552521400,19366,6455,12911,6455,0,1,6457,13749521,13.749521
6855,5555,2765,15359575,2,54846,13713,1,579145400,579145400,20566,6855,13711,6855,0,1,6857,3069070,3.06907
55,2305,6665,15362825,2,446,113,1,126849400,126849400,166,55,111,55,0,1,57,305992,0.305992
455,2305,6665,15362825,2,3646,913,1,155553400,155553400,1366,455,911,455,0,1,457,90661,0.090661
855,2305,6665,15362825,2,6846,1713,1,184257400,184257400,2566,855,1711,855,0,1,857,2159175,2.159175
1255,2305,6665,15362825,2,10046,2513,1,212961400,212961400,3766,1255,2511,1255,0,1,1257,24276,0.024276
1655,2305,6665,15362825,2,13246,3313,1,241665400,241665400,4966,1655,3311,1655,0,1,1657,2536991,2.536991
2055,2305,6665,15362825,2,16446,4113,1,270369400,270369400,6166,2055,4111,2055,0,1,2057,3409243,3.409243
2455,2305,6665,15362825,2,19646,4913,1,299073400,299073400,7366,2455,4911,2455,0,1,2457,968721,0.968721
2855,2305,6665,15362825,2,22846,5713,1,327777400,327777400,8566,2855,5711,2855,0,1,2857,479722,0.479722
3255,2305,6665,15362825,2,26046,6513,1,356481400,356481400,9766,3255,6511,3255,0,1,3257,1791235,1.791235
3655,2305,6665,15362825,2,29246,7313,1,385185400,385185400,10966,3655,7311,3655,0,1,3657,1739529,1.739529
4055,2305,6665,15362825,2,32446,8113,1,413889400,413889400,12166,4055,8111,4055,0,1,4057,987703,0.987703
4455,2305,6665,15362825,2,35646,8913,1,442593400,442593400,13366,4455,8911,4455,0,1,4457,231537,0.231537
4855,2305,6665,15362825,2,38846,9713,1,471297400,471297400,14566,4855,9711,4855,0,1,4857,1809334,1.809334
5255,2305,6665,15362825,2,42046,10513,1,500001400,500001400,15766,5255,10511,5255,0,1,5257,819273,0.819273
5655,2305,6665,15362825,2,45246,11313,1,528705400,528705400,16966,5655,11311,5655,0,1,5657,151103,0.151103
6055,2305,6665,15362825,2,48446,12113,1,557409400,557409400,18166,6055,12111,6055,0,1,6057,116183,0.116183
6455,2305,6665,15362825,2,51646,12913,1,586113400,586113400,19366,6455,12911,6455,0,1,6457,210398,0.210398
6855,2305,6665,15362825,2,54846,13713,1,614817400,614817400,20566,6855,13711,6855,0,1,6857,167677,0.167677
40,6300,2440,15372000,2,326,83,1,125772800,125772800,121,40,81,40,0,1,42,282015,0.282015
440,6300,2440,15372000,2,3526,883,1,153740800,153740800,1321,440,881,440,0,1,442,53937,0.053937
840,6300,2440,15372000,2,6726,1683,1,181708800,181708800,2521,840,1681,840,0,1,842,857627,0.857627
1240,6300,2440,15372000,2,9926,2483,1,209676800,209676800,3721,1240,2481,1240,0,1,1242,1196373,1.196373
1640,6300,2440,15372000,2,13126,3283,1,237644800,237644800,4921,1640,3281,1640,0,1,1642,4777849,4.777849
2040,6300,2440,15372000,2,16326,4083,1,265612800,265612800,6121,2040,4081,2040,0,1,2042,2125155,2.125155
2440,6300,2440,15372000,2,19526,4883,1,293580800,293580800,7321,2440,4881,2440,0,1,2442,3525037,3.525037
2840,6300,2440,15372000,2,22726,5683,1,321548800,321548800,8521,2840,5681,2840,0,1,2842,59378,0.059378
3240,6300,2440,15372000,2,25926,6483,1,349516800,349516800,9721,3240,6481,3240,0,1,3242,6467053,6.467053
3640,6300,2440,15372000,2,29126,7283,1,377484800,377484800,10921,3640,7281,3640,0,1,3642,2891400,2.8914
4040,6300,2440,15372000,2,32326,8083,1,405452800,405452800,12121,4040,8081,4040,0,1,4042,6429710,6.42971
4440,6300,2440,15372000,2,35526,8883,1,433420800,433420800,13321,4440,8881,4440,0,1,4442,2108510,2.10851
4840,6300,2440,15372000,2,38726,9683,1,461388800,461388800,14521,4840,9681,4840,0,1,4842,1678073,1.678073
5240,6300,2440,15372000,2,41926,10483,1,489356800,489356800,15721,5240,10481,5240,0,1,5242,6327127,6.327127
5640,6300,2440,15372000,2,45126,11283,1,517324800,517324800,16921,5640,11281,5640,0,1,5642,14636595,14.636595
6040,6300,2440,15372000,2,48326,12083,1,545292800,545292800,18121,6040,12081,6040,0,1,6042,889802,0.889802
6440,6300,2440,15372000,2,51526,12883,1,573260800,573260800,19321,6440,12881,6440,0,1,6442,7811789,7.811789
6840,6300,2440,15372000,2,54726,13683,1,601228800,601228800,20521,6840,13681,6840,0,1,6842,19714149,19.714149
35,6050,2545,15397250,2,286,73,1,125584600,125584600,106,35,71,35,0,1,37,42302,0.042302
535,6050,2545,15397250,2,4286,1073,1,159964600,159964600,1606,535,1071,535,0,1,537,144599,0.144599
1035,6050,2545,15397250,2,8286,2073,1,194344600,194344600,3106,1035,2071,1035,0,1,1037,615104,0.615104
1535,6050,2545,15397250,2,12286,3073,1,228724600,228724600,4606,1535,3071,1535,0,1,1537,1661484,1.661484
2035,6050,2545,15397250,2,16286,4073,1,263104600,263104600,6106,2035,4071,2035,0,1,2037,802810,0.80281
2535,6050,2545,15397250,2,20286,5073,1,297484600,297484600,7606,2535,5071,2535,0,1,2537,95675,0.095675
3035,6050,2545,15397250,2,24286,6073,1,331864600,331864600,9106,3035,6071,3035,0,1,3037,1127068,1.127068
3535,6050,2545,15397250,2,28286,7073,1,366244600,366244600,10606,3535,7071,3535,0,1,3537,8681215,8.681215
4035,6050,2545,15397250,2,32286,8073,1,400624600,400624600,12106,4035,8071,4035,0,1,4037,10288646,10.288646
4535,6050,2545,15397250,2,36286,9073,1,435004600,435004600,13606,4535,9071,4535,0,1,4537,661953,0.661953
5035,6050,2545,15397250,2,40286,10073,1,469384600,469384600,15106,5035,10071,5035,0,1,5037,6514210,6.51421
5535,6050,2545,15397250,2,44286,11073,1,503764600,503764600,16606,5535,11071,5535,0,1,5537,2831884,2.831884
6035,6050,2545,15397250,2,48286,12073,1,538144600,538144600,18106,6035,12071,6035,0,1,6037,12486940,12.48694
6535,6050,2545,15397250,2,52286,13073,1,572524600,572524600,19606,6535,13071,6535,0,1,6537,6504309,6.504309
7035,6050,2545,15397250,2,56286,14073,1,606904600,606904600,21106,7035,14071,7035,0,1,7037,14516990,14.51699
40,2550,6040,15402000,2,326,83,1,125964800,125964800,121,40,81,40,0,1,42,285110,0.28511
440,2550,6040,15402000,2,3526,883,1,153452800,153452800,1321,440,881,440,0,1,442,1375840,1.37584
840,2550,6040,15402000,2,6726,1683,1,180940800,180940800,2521,840,1681,840,0,1,842,1180530,1.18053
1240,2550,6040,15402000,2,9926,2483,1,208428800,208428800,3721,1240,2481,1240,0,1,1242,90998,0.090998
1640,2550,6040,15402000,2,13126,3283,1,235916800,235916800,4921,1640,3281,1640,0,1,1642,2929351,2.929351
2040,2550,6040,15402000,2,16326,4083,1,263404800,263404800,6121,2040,4081,2040,0,1,2042,1275343,1.275343
2440,2550,6040,15402000,2,19526,4883,1,290892800,290892800,7321,2440,4881,2440,0,1,2442,423596,0.423596
2840,2550,6040,15402000,2,22726,5683,1,318380800,318380800,8521,2840,5681,2840,0,1,2842,372746,0.372746
3240,2550,6040,15402000,2,25926,6483,1,345868800,345868800,9721,3240,6481,3240,0,1,3242,7774672,7.774672
3640,2550,6040,15402000,2,29126,7283,1,373356800,373356800,10921,3640,7281,3640,0,1,3642,884242,0.884242
4040,2550,6040,15402000,2,32326,8083,1,400844800,400844800,12121,4040,8081,4040,0,1,4042,515957,0.515957
4440,2550,6040,15402000,2,35526,8883,1,428332800,428332800,13321,4440,8881,4440,0,1,4442,3334873,3.334873
4840,2550,6040,15402000,2,38726,9683,1,455820800,455820800,14521,4840,9681,4840,0,1,4842,3266788,3.266788
5240,2550,6040,15402000,2,41926,10483,1,483308800,483308800,15721,5240,10481,5240,0,1,5242,505041,0.505041
5640,2550,6040,15402000,2,45126,11283,1,510796800,510796800,16921,5640,11281,5640,0,1,5642,409504,0.409504
6040,2550,6040,15402000,2,48326,12083,1,538284800,538284800,18121,6040,12081,6040,0,1,6042,9794969,9.794969
6440,2550,6040,15402000,2,51526,12883,1,565772800,565772800,19321,6440,12881,6440,0,1,6442,1340612,1.340612
6840,2550,6040,15402000,2,54726,13683,1,593260800,593260800,20521,6840,13681,6840,0,1,6842,82228,0.082228
39,2793,5541,15476013,2,318,81,1,126408312,126408312,118,39,79,39,0,1,41,284887,0.284887
539,2793,5541,15476013,2,4318,1081,1,159744312,159744312,1618,539,1079,539,0,1,541,1693763,1.693763
1039,2793,5541,15476013,2,8318,2081,1,193080312,193080312,3118,1039,2079,1039,0,1,1041,318408,0.318408
1539,2793,5541,15476013,2,12318,3081,1,226416312,226416312,4618,1539,3079,1539,0,1,1541,472009,0.472009
2039,2793,5541,15476013,2,16318,4081,1,259752312,259752312,6118,2039,4079,2039,0,1,2041,1006071,1.006071
2539,2793,5541,15476013,2,20318,5081,1,293088312,293088312,7618,2539,5079,2539,0,1,2541,1158942,1.158942
3039,2793,5541,15476013,2,24318,6081,1,326424312,326424312,9118,3039,6079,3039,0,1,3041,1040928,1.040928
3539,2793,5541,15476013,2,28318,7081,1,359760312,359760312,10618,3539,7079,3539,0,1,3541,160728,0.160728
4039,2793,5541,15476013,2,32318,8081,1,393096312,393096312,12118,4039,8079,4039,0,1,4041,3357115,3.357115
4539,2793,5541,15476013,2,36318,9081,1,426432312,426432312,13618,4539,9079,4539,0,1,4541,5999054,5.999054
5039,2793,5541,15476013,2,40318,10081,1,459768312,459768312,15118,5039,10079,5039,0,1,5041,2066260,2.06626
5539,2793,5541,15476013,2,44318,11081,1,493104312,493104312,16618,5539,11079,5539,0,1,5541,193629,0.193629
6039,2793,5541,15476013,2,48318,12081,1,526440312,526440312,18118,6039,12079,6039,0,1,6041,2338525,2.338525
6539,2793,5541,15476013,2,52318,13081,1,559776312,559776312,19618,6539,13079,6539,0,1,6541,729277,0.729277
7039,2793,5541,15476013,2,56318,14081,1,593112312,593112312,21118,7039,14079,7039,0,1,7041,1673526,1.673526
39,6093,2541,15482313,2,318,81,1,126552312,126552312,118,39,79,39,0,1,41,18842,0.018842
539,6093,2541,15482313,2,4318,1081,1,161088312,161088312,1618,539,1079,539,0,1,541,142617,0.142617
1039,6093,2541,15482313,2,8318,2081,1,195624312,195624312,3118,1039,2079,1039,0,1,1041,78791,0.078791
1539,6093,2541,15482313,2,12318,3081,1,230160312,230160312,4618,1539,3079,1539,0,1,1541,1428715,1.428715
2039,6093,2541,15482313,2,16318,4081,1,264696312,264696312,6118,2039,4079,2039,0,1,2041,2577028,2.577028
2539,6093,2541,15482313,2,20318,5081,1,299232312,299232312,7618,2539,5079,2539,0,1,2541,544557,0.544557
3039,6093,2541,15482313,2,24318,6081,1,333768312,333768312,9118,3039,6079,3039,0,1,3041,640988,0.640988
3539,6093,2541,15482313,2,28318,7081,1,368304312,368304312,10618,3539,7079,3539,0,1,3541,69993,0.069993
4039,6093,2541,15482313,2,32318,8081,1,402840312,402840312,12118,4039,8079,4039,0,1,4041,1729974,1.729974
4539,6093,2541,15482313,2,36318,9081,1,437376312,437376312,13618,4539,9079,4539,0,1,4541,1921044,1.921044
5039,6093,2541,15482313,2,40318,10081,1,471912312,471912312,15118,5039,10079,5039,0,1,5041,385587,0.385587
5539,6093,2541,15482313,2,44318,11081,1,506448312,506448312,16618,5539,11079,5539,0,1,5541,1149062,1.149062
6039,6093,2541,15482313,2,48318,12081,1,540984312,540984312,18118,6039,12079,6039,0,1,6041,2217281,2.217281
6539,6093,2541,15482313,2,52318,13081,1,575520312,575520312,19618,6539,13079,6539,0,1,6541,4014138,4.014138
7039,6093,2541,15482313,2,56318,14081,1,610056312,610056312,21118,7039,14079,7039,0,1,7041,13124142,13.124142
55,5055,3065,15493575,2,446,113,1,127521400,127521400,166,55,111,55,0,1,57,56880,0.05688
455,5055,3065,15493575,2,3646,913,1,153505400,153505400,1366,455,911,455,0,1,457,134366,0.134366
855,5055,3065,15493575,2,6846,1713,1,179489400,179489400,2566,855,1711,855,0,1,857,107293,0.107293
1255,5055,3065,15493575,2,10046,2513,1,205473400,205473400,3766,1255,2511,1255,0,1,1257,319118,0.319118
1655,5055,3065,15493575,2,13246,3313,1,231457400,231457400,4966,1655,3311,1655,0,1,1657,701045,0.701045
2055,5055,3065,15493575,2,16446,4113,1,257441400,257441400,6166,2055,4111,2055,0,1,2057,238029,0.238029
2455,5055,3065,15493575,2,19646,4913,1,283425400,283425400,7366,2455,4911,2455,0,1,2457,719489,0.719489
2855,5055,3065,15493575,2,22846,5713,1,309409400,309409400,8566,2855,5711,2855,0,1,2857,481487,0.481487
3255,5055,3065,15493575,2,26046,6513,1,335393400,335393400,9766,3255,6511,3255,0,1,3257,1060186,1.060186
3655,5055,3065,15493575,2,29246,7313,1,361377400,361377400,10966,3655,7311,3655,0,1,3657,1653223,1.653223
4055,5055,3065,15493575,2,32446,8113,1,387361400,387361400,12166,4055,8111,4055,0,1,4057,1119826,1.119826
4455,5055,3065,15493575,2,35646,8913,1,413345400,413345400,13366,4455,8911,4455,0,1,4457,1062745,1.062745
4855,5055,3065,15493575,2,38846,9713,1,439329400,439329400,14566,4855,9711,4855,0,1,4857,2803849,2.803849
5255,5055,3065,15493575,2,42046,10513,1,465313400,465313400,15766,5255,10511,5255,0,1,5257,1536476,1.536476
5655,5055,3065,15493575,2,45246,11313,1,491297400,491297400,16966,5655,11311,5655,0,1,5657,1098202,1.098202
6055,5055,3065,15493575,2,48446,12113,1,517281400,517281400,18166,6055,12111,6055,0,1,6057,2311012,2.311012
6455,5055,3065,15493575,2,51646,12913,1,543265400,543265400,19366,6455,12911,6455,0,1,6457,135902,0.135902
6855,5055,3065,15493575,2,54846,13713,1,569249400,569249400,20566,6855,13711,6855,0,1,6857,1201678,1.201678
55,2555,6065,15496075,2,446,113,1,127761400,127761400,166,55,111,55,0,1,57,321093,0.321093
455,2555,6065,15496075,2,3646,913,1,155345400,155345400,1366,455,911,455,0,1,457,1311984,1.311984
855,2555,6065,15496075,2,6846,1713,1,182929400,182929400,2566,855,1711,855,0,1,857,2229059,2.229059
1255,2555,6065,15496075,2,10046,2513,1,210513400,210513400,3766,1255,2511,1255,0,1,1257,1879810,1.87981
1655,2555,6065,15496075,2,13246,3313,1,238097400,238097400,4966,1655,3311,1655,0,1,1657,657988,0.657988
2055,2555,6065,15496075,2,16446,4113,1,265681400,265681400,6166,2055,4111,2055,0,1,2057,3439605,3.439605
2455,2555,6065,15496075,2,19646,4913,1,293265400,293265400,7366,2455,4911,2455,0,1,2457,203479,0.203479
2855,2555,6065,15496075,2,22846,5713,1,320849400,320849400,8566,2855,5711,2855,0,1,2857,561660,0.56166
3255,2555,6065,15496075,2,26046,6513,1,348433400,348433400,9766,3255,6511,3255,0,1,3257,845832,0.845832
3655,2555,6065,15496075,2,29246,7313,1,376017400,376017400,10966,3655,7311,3655,0,1,3657,2078392,2.078392
4055,2555,6065,15496075,2,32446,8113,1,403601400,403601400,12166,4055,8111,4055,0,1,4057,1168813,1.168813
4455,2555,6065,15496075,2,35646,8913,1,431185400,431185400,13366,4455,8911,4455,0,1,4457,293671,0.293671
4855,2555,6065,15496075,2,38846,9713,1,458769400,458769400,14566,4855,9711,4855,0,1,4857,502826,0.502826
5255,2555,6065,15496075,2,42046,10513,1,486353400,486353400,15766,5255,10511,5255,0,1,5257,661940,0.66194
5655,2555,6065,15496075,2,45246,11313,1,513937400,513937400,16966,5655,11311,5655,0,1,5657,1054894,1.054894
6055,2555,6065,15496075,2,48446,12113,1,541521400,541521400,18166,6055,12111,6055,0,1,6057,5178059,5.178059
6455,2555,6065,15496075,2,51646,12913,1,569105400,569105400,19366,6455,12911,6455,0,1,6457,2347860,2.34786
6855,2555,6065,15496075,2,54846,13713,1,596689400,596689400,20566,6855,13711,6855,0,1,6857,1191982,1.191982
35,6090,2545,15499050,2,286,73,1,126410200,126410200,106,35,71,35,0,1,37,56047,0.056047
535,6090,2545,15499050,2,4286,1073,1,160950200,160950200,1606,535,1071,535,0,1,537,1175043,1.175043
1035,6090,2545,15499050,2,8286,2073,1,195490200,195490200,3106,1035,2071,1035,0,1,1037,2782520,2.78252
1535,6090,2545,15499050,2,12286,3073,1,230030200,230030200,4606,1535,3071,1535,0,1,1537,4674861,4.674861
55,6305,2465,15541825,2,446,113,1,128193400,128193400,166,55,111,55,0,1,57,318690,0.31869
455,6305,2465,15541825,2,3646,913,1,156257400,156257400,1366,455,911,455,0,1,457,1469320,1.46932
855,6305,2465,15541825,2,6846,1713,1,184321400,184321400,2566,855,1711,855,0,1,857,495792,0.495792
1255,6305,2465,15541825,2,10046,2513,1,212385400,212385400,3766,1255,2511,1255,0,1,1257,3800820,3.80082
1655,6305,2465,15541825,2,13246,3313,1,240449400,240449400,4966,1655,3311,1655,0,1,1657,532896,0.532896
2055,6305,2465,15541825,2,16446,4113,1,268513400,268513400,6166,2055,4111,2055,0,1,2057,1332827,1.332827
2455,6305,2465,15541825,2,19646,4913,1,296577400,296577400,7366,2455,4911,2455,0,1,2457,1012704,1.012704
2855,6305,2465,15541825,2,22846,5713,1,324641400,324641400,8566,2855,5711,2855,0,1,2857,2040964,2.040964
3255,6305,2465,15541825,2,26046,6513,1,352705400,352705400,9766,3255,6511,3255,0,1,3257,424067,0.424067
3655,6305,2465,15541825,2,29246,7313,1,380769400,380769400,10966,3655,7311,3655,0,1,3657,6910410,6.91041
4055,6305,2465,15541825,2,32446,8113,1,408833400,408833400,12166,4055,8111,4055,0,1,4057,276419,0.276419
4455,6305,2465,15541825,2,35646,8913,1,436897400,436897400,13366,4455,8911,4455,0,1,4457,6777218,6.777218
4855,6305,2465,15541825,2,38846,9713,1,464961400,464961400,14566,4855,9711,4855,0,1,4857,14439408,14.439408
5255,6305,2465,15541825,2,42046,10513,1,493025400,493025400,15766,5255,10511,5255,0,1,5257,6437838,6.437838
5655,6305,2465,15541825,2,45246,11313,1,521089400,521089400,16966,5655,11311,5655,0,1,5657,982191,0.982191
6055,6305,2465,15541825,2,48446,12113,1,549153400,549153400,18166,6055,12111,6055,0,1,6057,3334380,3.33438
6455,6305,2465,15541825,2,51646,12913,1,577217400,577217400,19366,6455,12911,6455,0,1,6457,11947250,11.94725
6855,6305,2465,15541825,2,54846,13713,1,605281400,605281400,20566,6855,13711,6855,0,1,6857,6551405,6.551405
44,2803,5555,15570665,2,358,91,1,127507336,127507336,133,44,89,44,0,1,46,289025,0.289025
544,2803,5555,15570665,2,4358,1091,1,160939336,160939336,1633,544,1089,544,0,1,546,675523,0.675523
1044,2803,5555,15570665,2,8358,2091,1,194371336,194371336,3133,1044,2089,1044,0,1,1046,490273,0.490273
1544,2803,5555,15570665,2,12358,3091,1,227803336,227803336,4633,1544,3089,1544,0,1,1546,2181887,2.181887
2044,2803,5555,15570665,2,16358,4091,1,261235336,261235336,6133,2044,4089,2044,0,1,2046,2757377,2.757377
2544,2803,5555,15570665,2,20358,5091,1,294667336,294667336,7633,2544,5089,2544,0,1,2546,1199405,1.199405
3044,2803,5555,15570665,2,24358,6091,1,328099336,328099336,9133,3044,6089,3044,0,1,3046,3158479,3.158479
3544,2803,5555,15570665,2,28358,7091,1,361531336,361531336,10633,3544,7089,3544,0,1,3546,1331112,1.331112
4044,2803,5555,15570665,2,32358,8091,1,394963336,394963336,12133,4044,8089,4044,0,1,4046,3114904,3.114904
4544,2803,5555,15570665,2,36358,9091,1,428395336,428395336,13633,4544,9089,4544,0,1,4546,1309591,1.309591
5044,2803,5555,15570665,2,40358,10091,1,461827336,461827336,15133,5044,10089,5044,0,1,5046,598804,0.598804
5544,2803,5555,15570665,2,44358,11091,1,495259336,495259336,16633,5544,11089,5544,0,1,5546,269133,0.269133
6044,2803,5555,15570665,2,48358,12091,1,528691336,528691336,18133,6044,12089,6044,0,1,6046,10977454,10.977454
6544,2803,5555,15570665,2,52358,13091,1,562123336,562123336,19633,6544,13089,6544,0,1,6546,803769,0.803769
7044,2803,5555,15570665,2,56358,14091,1,595555336,595555336,21133,7044,14089,7044,0,1,7046,4556889,4.556889
44,6103,2555,15593165,2,358,91,1,127792936,127792936,133,44,89,44,0,1,46,28631,0.028631
544,6103,2555,15593165,2,4358,1091,1,162424936,162424936,1633,544,1089,544,0,1,546,76376,0.076376
1044,6103,2555,15593165,2,8358,2091,1,197056936,197056936,3133,1044,2089,1044,0,1,1046,301938,0.301938
1544,6103,2555,15593165,2,12358,3091,1,231688936,231688936,4633,1544,3089,1544,0,1,1546,551509,0.551509
2044,6103,2555,15593165,2,16358,4091,1,266320936,266320936,6133,2044,4089,2044,0,1,2046,1842909,1.842909
2544,6103,2555,15593165,2,20358,5091,1,300952936,300952936,7633,2544,5089,2544,0,1,2546,52341,0.052341
3044,6103,2555,15593165,2,24358,6091,1,335584936,335584936,9133,3044,6089,3044,0,1,3046,400125,0.400125
3544,6103,2555,15593165,2,28358,7091,1,370216936,370216936,10633,3544,7089,3544,0,1,3546,394370,0.39437
4044,6103,2555,15593165,2,32358,8091,1,404848936,404848936,12133,4044,8089,4044,0,1,4046,3569592,3.569592
4544,6103,2555,15593165,2,36358,9091,1,439480936,439480936,13633,4544,9089,4544,0,1,4546,1866087,1.866087
5044,6103,2555,15593165,2,40358,10091,1,474112936,474112936,15133,5044,10089,5044,0,1,5046,82183,0.082183
5544,6103,2555,15593165,2,44358,11091,1,508744936,508744936,16633,5544,11089,5544,0,1,5546,1426581,1.426581
6044,6103,2555,15593165,2,48358,12091,1,543376936,543376936,18133,6044,12089,6044,0,1,6046,1756967,1.756967
6544,6103,2555,15593165,2,52358,13091,1,578008936,578008936,19633,6544,13089,6544,0,1,6546,2940100,2.9401
7044,6103,2555,15593165,2,56358,14091,1,612640936,612640936,21133,7044,14089,7044,0,1,7046,9283088,9.283088
35,4400,3545,15598000,2,286,73,1,127008600,127008600,106,35,71,35,0,1,37,60935,0.060935
535,4400,3545,15598000,2,4286,1073,1,158788600,158788600,1606,535,1071,535,0,1,537,151052,0.151052
1035,4400,3545,15598000,2,8286,2073,1,190568600,190568600,3106,1035,2071,1035,0,1,1037,81174,0.081174
1535,4400,3545,15598000,2,12286,3073,1,222348600,222348600,4606,1535,3071,1535,0,1,1537,717677,0.717677
2035,4400,3545,15598000,2,16286,4073,1,254128600,254128600,6106,2035,4071,2035,0,1,2037,1595988,1.595988
2535,4400,3545,15598000,2,20286,5073,1,285908600,285908600,7606,2535,5071,2535,0,1,2537,4814793,4.814793
3035,4400,3545,15598000,2,24286,6073,1,317688600,317688600,9106,3035,6071,3035,0,1,3037,1848940,1.84894
3535,4400,3545,15598000,2,28286,7073,1,349468600,349468600,10606,3535,7071,3535,0,1,3537,4005537,4.005537
4035,4400,3545,15598000,2,32286,8073,1,381248600,381248600,12106,4035,8071,4035,0,1,4037,3324565,3.324565
4535,4400,3545,15598000,2,36286,9073,1,413028600,413028600,13606,4535,9071,4535,0,1,4537,4185803,4.185803
5035,4400,3545,15598000,2,40286,10073,1,444808600,444808600,15106,5035,10071,5035,0,1,5037,7382999,7.382999
5535,4400,3545,15598000,2,44286,11073,1,476588600,476588600,16606,5535,11071,5535,0,1,5537,625315,0.625315
6035,4400,3545,15598000,2,48286,12073,1,508368600,508368600,18106,6035,12071,6035,0,1,6037,2322865,2.322865
6535,4400,3545,15598000,2,52286,13073,1,540148600,540148600,19606,6535,13071,6535,0,1,6537,2797209,2.797209
7035,4400,3545,15598000,2,56286,14073,1,571928600,571928600,21106,7035,14071,7035,0,1,7037,4877274,4.877274
40,4300,3640,15652000,2,326,83,1,127756800,127756800,121,40,81,40,0,1,42,279725,0.279725
440,4300,3640,15652000,2,3526,883,1,153164800,153164800,1321,440,881,440,0,1,442,872318,0.872318
840,4300,3640,15652000,2,6726,1683,1,178572800,178572800,2521,840,1681,840,0,1,842,823681,0.823681
1240,4300,3640,15652000,2,9926,2483,1,203980800,203980800,3721,1240,2481,1240,0,1,1242,1158451,1.158451
1640,4300,3640,15652000,2,13126,3283,1,229388800,229388800,4921,1640,3281,1640,0,1,1642,1042475,1.042475
2040,4300,3640,15652000,2,16326,4083,1,254796800,254796800,6121,2040,4081,2040,0,1,2042,2758699,2.758699
2440,4300,3640,15652000,2,19526,4883,1,280204800,280204800,7321,2440,4881,2440,0,1,2442,441625,0.441625
2840,4300,3640,15652000,2,22726,5683,1,305612800,305612800,8521,2840,5681,2840,0,1,2842,2482761,2.482761
3240,4300,3640,15652000,2,25926,6483,1,331020800,331020800,9721,3240,6481,3240,0,1,3242,713264,0.713264
3640,4300,3640,15652000,2,29126,7283,1,356428800,356428800,10921,3640,7281,3640,0,1,3642,2576318,2.576318
4040,4300,3640,15652000,2,32326,8083,1,381836800,381836800,12121,4040,8081,4040,0,1,4042,1287710,1.28771
4440,4300,3640,15652000,2,35526,8883,1,407244800,407244800,13321,4440,8881,4440,0,1,4442,2408136,2.408136
4840,4300,3640,15652000,2,38726,9683,1,432652800,432652800,14521,4840,9681,4840,0,1,4842,2274159,2.274159
5240,4300,3640,15652000,2,41926,10483,1,458060800,458060800,15721,5240,10481,5240,0,1,5242,196203,0.196203
5640,4300,3640,15652000,2,45126,11283,1,483468800,483468800,16921,5640,11281,5640,0,1,5642,1138206,1.138206
6040,4300,3640,15652000,2,48326,12083,1,508876800,508876800,18121,6040,12081,6040,0,1,6042,75821,0.075821
6440,4300,3640,15652000,2,51526,12883,1,534284800,534284800,19321,6440,12881,6440,0,1,6442,882347,0.882347
6840,4300,3640,15652000,2,54726,13683,1,559692800,559692800,20521,6840,13681,6840,0,1,6842,1002365,1.002365
40,3050,5140,15677000,2,326,83,1,128036800,128036800,121,40,81,40,0,1,42,10510,0.01051
440,3050,5140,15677000,2,3526,883,1,154244800,154244800,1321,440,881,440,0,1,442,49115,0.049115
840,3050,5140,15677000,2,6726,1683,1,180452800,180452800,2521,840,1681,840,0,1,842,14334,0.014334
1240,3050,5140,15677000,2,9926,2483,1,206660800,206660800,3721,1240,2481,1240,0,1,1242,234841,0.234841
1640,3050,5140,15677000,2,13126,3283,1,232868800,232868800,4921,1640,3281,1640,0,1,1642,262750,0.26275
2040,3050,5140,15677000,2,16326,4083,1,259076800,259076800,6121,2040,4081,2040,0,1,2042,164519,0.164519
2440,3050,5140,15677000,2,19526,4883,1,285284800,285284800,7321,2440,4881,2440,0,1,2442,92057,0.092057
2840,3050,5140,15677000,2,22726,5683,1,311492800,311492800,8521,2840,5681,2840,0,1,2842,1183160,1.18316
3240,3050,5140,15677000,2,25926,6483,1,337700800,337700800,9721,3240,6481,3240,0,1,3242,213083,0.213083
3640,3050,5140,15677000,2,29126,7283,1,363908800,363908800,10921,3640,7281,3640,0,1,3642,570171,0.570171
4040,3050,5140,15677000,2,32326,8083,1,390116800,390116800,12121,4040,8081,4040,0,1,4042,1025259,1.025259
4440,3050,5140,15677000,2,35526,8883,1,416324800,416324800,13321,4440,8881,4440,0,1,4442,99074,0.099074
4840,3050,5140,15677000,2,38726,9683,1,442532800,442532800,14521,4840,9681,4840,0,1,4842,1433439,1.433439
5240,3050,5140,15677000,2,41926,10483,1,468740800,468740800,15721,5240,10481,5240,0,1,5242,2273935,2.273935
5640,3050,5140,15677000,2,45126,11283,1,494948800,494948800,16921,5640,11281,5640,0,1,5642,392905,0.392905
6040,3050,5140,15677000,2,48326,12083,1,521156800,521156800,18121,6040,12081,6040,0,1,6042,1494533,1.494533
6440,3050,5140,15677000,2,51526,12883,1,547364800,547364800,19321,6440,12881,6440,0,1,6442,669300,0.6693
6840,3050,5140,15677000,2,54726,13683,1,573572800,573572800,20521,6840,13681,6840,0,1,6842,2199107,2.199107
39,3893,4041,15731613,2,318,81,1,128328312,128328312,118,39,79,39,0,1,41,275462,0.275462
539,3893,4041,15731613,2,4318,1081,1,160064312,160064312,1618,539,1079,539,0,1,541,353193,0.353193
1039,3893,4041,15731613,2,8318,2081,1,191800312,191800312,3118,1039,2079,1039,0,1,1041,199410,0.19941
1539,3893,4041,15731613,2,12318,3081,1,223536312,223536312,4618,1539,3079,1539,0,1,1541,4143433,4.143433
2039,3893,4041,15731613,2,16318,4081,1,255272312,255272312,6118,2039,4079,2039,0,1,2041,369045,0.369045
2539,3893,4041,15731613,2,20318,5081,1,287008312,287008312,7618,2539,5079,2539,0,1,2541,1064147,1.064147
3039,3893,4041,15731613,2,24318,6081,1,318744312,318744312,9118,3039,6079,3039,0,1,3041,7189004,7.189004
3539,3893,4041,15731613,2,28318,7081,1,350480312,350480312,10618,3539,7079,3539,0,1,3541,455166,0.455166
4039,3893,4041,15731613,2,32318,8081,1,382216312,382216312,12118,4039,8079,4039,0,1,4041,2388713,2.388713
4539,3893,4041,15731613,2,36318,9081,1,413952312,413952312,13618,4539,9079,4539,0,1,4541,26561,0.026561
5039,3893,4041,15731613,2,40318,10081,1,445688312,445688312,15118,5039,10079,5039,0,1,5041,3647415,3.647415
5539,3893,4041,15731613,2,44318,11081,1,477424312,477424312,16618,5539,11079,5539,0,1,5541,17109888,17.109888
6039,3893,4041,15731613,2,48318,12081,1,509160312,509160312,18118,6039,12079,6039,0,1,6041,3176690,3.17669
6539,3893,4041,15731613,2,52318,13081,1,540896312,540896312,19618,6539,13079,6539,0,1,6541,7992787,7.992787
7039,3893,4041,15731613,2,56318,14081,1,572632312,572632312,21118,7039,14079,7039,0,1,7041,14942140,14.94214
39,4443,3541,15732663,2,318,81,1,128352312,128352312,118,39,79,39,0,1,41,11229,0.011229
539,4443,3541,15732663,2,4318,1081,1,160288312,160288312,1618,539,1079,539,0,1,541,207620,0.20762
1039,4443,3541,15732663,2,8318,2081,1,192224312,192224312,3118,1039,2079,1039,0,1,1041,168792,0.168792
1539,4443,3541,15732663,2,12318,3081,1,224160312,224160312,4618,1539,3079,1539,0,1,1541,452173,0.452173
2039,4443,3541,15732663,2,16318,4081,1,256096312,256096312,6118,2039,4079,2039,0,1,2041,2322282,2.322282
2539,4443,3541,15732663,2,20318,5081,1,288032312,288032312,7618,2539,5079,2539,0,1,2541,259821,0.259821
3039,4443,3541,15732663,2,24318,6081,1,319968312,319968312,9118,3039,6079,3039,0,1,3041,214755,0.214755
3539,4443,3541,15732663,2,28318,7081,1,351904312,351904312,10618,3539,7079,3539,0,1,3541,2267361,2.267361
4039,4443,3541,15732663,2,32318,8081,1,383840312,383840312,12118,4039,8079,4039,0,1,4041,319401,0.319401
4539,4443,3541,15732663,2,36318,9081,1,415776312,415776312,13618,4539,9079,4539,0,1,4541,149746,0.149746
5039,4443,3541,15732663,2,40318,10081,1,447712312,447712312,15118,5039,10079,5039,0,1,5041,2505556,2.505556
5539,4443,3541,15732663,2,44318,11081,1,479648312,479648312,16618,5539,11079,5539,0,1,5541,1013138,1.013138
6039,4443,3541,15732663,2,48318,12081,1,511584312,511584312,18118,6039,12079,6039,0,1,6041,6783624,6.783624
6539,4443,3541,15732663,2,52318,13081,1,543520312,543520312,19618,6539,13079,6539,0,1,6541,15533057,15.533057
7039,4443,3541,15732663,2,56318,14081,1,575456312,575456312,21118,7039,14079,7039,0,1,7041,1514425,1.514425
35,4440,3545,15739800,2,286,73,1,128154200,128154200,106,35,71,35,0,1,37,279524,0.279524
535,4440,3545,15739800,2,4286,1073,1,160094200,160094200,1606,535,1071,535,0,1,537,1681986,1.681986
1035,4440,3545,15739800,2,8286,2073,1,192034200,192034200,3106,1035,2071,1035,0,1,1037,3114072,3.114072
1535,4440,3545,15739800,2,12286,3073,1,223974200,223974200,4606,1535,3071,1535,0,1,1537,4615947,4.615947
2035,4440,3545,15739800,2,16286,4073,1,255914200,255914200,6106,2035,4071,2035,0,1,2037,6107533,6.107533
55,4305,3665,15777825,2,446,113,1,129729400,129729400,166,55,111,55,0,1,57,314577,0.314577
455,4305,3665,15777825,2,3646,913,1,155233400,155233400,1366,455,911,455,0,1,457,106053,0.106053
855,4305,3665,15777825,2,6846,1713,1,180737400,180737400,2566,855,1711,855,0,1,857,1135814,1.135814
1255,4305,3665,15777825,2,10046,2513,1,206241400,206241400,3766,1255,2511,1255,0,1,1257,2334576,2.334576
1655,4305,3665,15777825,2,13246,3313,1,231745400,231745400,4966,1655,3311,1655,0,1,1657,1314849,1.314849
2055,4305,3665,15777825,2,16446,4113,1,257249400,257249400,6166,2055,4111,2055,0,1,2057,1234745,1.234745
2455,4305,3665,15777825,2,19646,4913,1,282753400,282753400,7366,2455,4911,2455,0,1,2457,1103153,1.103153
2855,4305,3665,15777825,2,22846,5713,1,308257400,308257400,8566,2855,5711,2855,0,1,2857,1501118,1.501118
3255,4305,3665,15777825,2,26046,6513,1,333761400,333761400,9766,3255,6511,3255,0,1,3257,1043737,1.043737
3655,4305,3665,15777825,2,29246,7313,1,359265400,359265400,10966,3655,7311,3655,0,1,3657,155246,0.155246
4055,4305,3665,15777825,2,32446,8113,1,384769400,384769400,12166,4055,8111,4055,0,1,4057,17661,0.017661
4455,4305,3665,15777825,2,35646,8913,1,410273400,410273400,13366,4455,8911,4455,0,1,4457,6934393,6.934393
4855,4305,3665,15777825,2,38846,9713,1,435777400,435777400,14566,4855,9711,4855,0,1,4857,1164972,1.164972
5255,4305,3665,15777825,2,42046,10513,1,461281400,461281400,15766,5255,10511,5255,0,1,5257,4938214,4.938214
5655,4305,3665,15777825,2,45246,11313,1,486785400,486785400,16966,5655,11311,5655,0,1,5657,2087082,2.087082
6055,4305,3665,15777825,2,48446,12113,1,512289400,512289400,18166,6055,12111,6055,0,1,6057,602731,0.602731
6455,4305,3665,15777825,2,51646,12913,1,537793400,537793400,19366,6455,12911,6455,0,1,6457,79853,0.079853
6855,4305,3665,15777825,2,54846,13713,1,563297400,563297400,20566,6855,13711,6855,0,1,6857,1359374,1.359374
55,3055,5165,15779075,2,446,113,1,129849400,129849400,166,55,111,55,0,1,57,41091,0.041091
455,3055,5165,15779075,2,3646,913,1,156153400,156153400,1366,455,911,455,0,1,457,127396,0.127396
855,3055,5165,15779075,2,6846,1713,1,182457400,182457400,2566,855,1711,855,0,1,857,14739,0.014739
1255,3055,5165,15779075,2,10046,2513,1,208761400,208761400,3766,1255,2511,1255,0,1,1257,341686,0.341686
1655,3055,5165,15779075,2,13246,3313,1,235065400,235065400,4966,1655,3311,1655,0,1,1657,856008,0.856008
2055,3055,5165,15779075,2,16446,4113,1,261369400,261369400,6166,2055,4111,2055,0,1,2057,821662,0.821662
2455,3055,5165,15779075,2,19646,4913,1,287673400,287673400,7366,2455,4911,2455,0,1,2457,162501,0.162501
2855,3055,5165,15779075,2,22846,5713,1,313977400,313977400,8566,2855,5711,2855,0,1,2857,692218,0.692218
3255,3055,5165,15779075,2,26046,6513,1,340281400,340281400,9766,3255,6511,3255,0,1,3257,393770,0.39377
3655,3055,5165,15779075,2,29246,7313,1,366585400,366585400,10966,3655,7311,3655,0,1,3657,29748,0.029748
4055,3055,5165,15779075,2,32446,8113,1,392889400,392889400,12166,4055,8111,4055,0,1,4057,201173,0.201173
4455,3055,5165,15779075,2,35646,8913,1,419193400,419193400,13366,4455,8911,4455,0,1,4457,1153345,1.153345
4855,3055,5165,15779075,2,38846,9713,1,445497400,445497400,14566,4855,9711,4855,0,1,4857,1115072,1.115072
5255,3055,5165,15779075,2,42046,10513,1,471801400,471801400,15766,5255,10511,5255,0,1,5257,1525323,1.525323
5655,3055,5165,15779075,2,45246,11313,1,498105400,498105400,16966,5655,11311,5655,0,1,5657,185160,0.18516
6055,3055,5165,15779075,2,48446,12113,1,524409400,524409400,18166,6055,12111,6055,0,1,6057,2226106,2.226106
6455,3055,5165,15779075,2,51646,12913,1,550713400,550713400,19366,6455,12911,6455,0,1,6457,2622969,2.622969
6855,3055,5165,15779075,2,54846,13713,1,577017400,577017400,20566,6855,13711,6855,0,1,6857,856208,0.856208
35,2240,7045,15780800,2,286,73,1,128846200,128846200,106,35,71,35,0,1,37,276518,0.276518
535,2240,7045,15780800,2,4286,1073,1,165986200,165986200,1606,535,1071,535,0,1,537,1704658,1.704658
1035,2240,7045,15780800,2,8286,2073,1,203126200,203126200,3106,1035,2071,1035,0,1,1037,3161095,3.161095
1535,2240,7045,15780800,2,12286,3073,1,240266200,240266200,4606,1535,3071,1535,0,1,1537,4630735,4.630735
2035,2240,7045,15780800,2,16286,4073,1,277406200,277406200,6106,2035,4071,2035,0,1,2037,6102036,6.102036
2535,2240,7045,15780800,2,20286,5073,1,314546200,314546200,7606,2535,5071,2535,0,1,2537,7610201,7.610201
39,2243,7041,15792963,2,318,81,1,129240312,129240312,118,39,79,39,0,1,41,26430,0.02643
539,2243,7041,15792963,2,4318,1081,1,166376312,166376312,1618,539,1079,539,0,1,541,34214,0.034214
1039,2243,7041,15792963,2,8318,2081,1,203512312,203512312,3118,1039,2079,1039,0,1,1041,235683,0.235683
1539,2243,7041,15792963,2,12318,3081,1,240648312,240648312,4618,1539,3079,1539,0,1,1541,1565933,1.565933
2039,2243,7041,15792963,2,16318,4081,1,277784312,277784312,6118,2039,4079,2039,0,1,2041,242031,0.242031
2539,2243,7041,15792963,2,20318,5081,1,314920312,314920312,7618,2539,5079,2539,0,1,2541,190656,0.190656
3039,2243,7041,15792963,2,24318,6081,1,352056312,352056312,9118,3039,6079,3039,0,1,3041,1274155,1.274155
3539,2243,7041,15792963,2,28318,7081,1,389192312,389192312,10618,3539,7079,3539,0,1,3541,390750,0.39075
4039,2243,7041,15792963,2,32318,8081,1,426328312,426328312,12118,4039,8079,4039,0,1,4041,764146,0.764146
4539,2243,7041,15792963,2,36318,9081,1,463464312,463464312,13618,4539,9079,4539,0,1,4541,373671,0.373671
5039,2243,7041,15792963,2,40318,10081,1,500600312,500600312,15118,5039,10079,5039,0,1,5041,2615449,2.615449
5539,2243,7041,15792963,2,44318,11081,1,537736312,537736312,16618,5539,11079,5539,0,1,5541,750306,0.750306
6039,2243,7041,15792963,2,48318,12081,1,574872312,574872312,18118,6039,12079,6039,0,1,6041,2345464,2.345464
6539,2243,7041,15792963,2,52318,13081,1,612008312,612008312,19618,6539,13079,6539,0,1,6541,1262965,1.262965
7039,2243,7041,15792963,2,56318,14081,1,649144312,649144312,21118,7039,14079,7039,0,1,7041,2831627,2.831627
44,3903,4055,15826665,2,358,91,1,129414536,129414536,133,44,89,44,0,1,46,305356,0.305356
544,3903,4055,15826665,2,4358,1091,1,161246536,161246536,1633,544,1089,544,0,1,546,1793374,1.793374
1044,3903,4055,15826665,2,8358,2091,1,193078536,193078536,3133,1044,2089,1044,0,1,1046,3305048,3.305048
1544,3903,4055,15826665,2,12358,3091,1,224910536,224910536,4633,1544,3089,1544,0,1,1546,1800316,1.800316
2044,3903,4055,15826665,2,16358,4091,1,256742536,256742536,6133,2044,4089,2044,0,1,2046,5189049,5.189049
2544,3903,4055,15826665,2,20358,5091,1,288574536,288574536,7633,2544,5089,2544,0,1,2546,2760556,2.760556
3044,3903,4055,15826665,2,24358,6091,1,320406536,320406536,9133,3044,6089,3044,0,1,3046,437564,0.437564
3544,3903,4055,15826665,2,28358,7091,1,352238536,352238536,10633,3544,7089,3544,0,1,3546,759430,0.75943
4044,3903,4055,15826665,2,32358,8091,1,384070536,384070536,12133,4044,8089,4044,0,1,4046,268780,0.26878
4544,3903,4055,15826665,2,36358,9091,1,415902536,415902536,13633,4544,9089,4544,0,1,4546,1393771,1.393771
5044,3903,4055,15826665,2,40358,10091,1,447734536,447734536,15133,5044,10089,5044,0,1,5046,1676328,1.676328
5544,3903,4055,15826665,2,44358,11091,1,479566536,479566536,16633,5544,11089,5544,0,1,5546,5350607,5.350607
6044,3903,4055,15826665,2,48358,12091,1,511398536,511398536,18133,6044,12089,6044,0,1,6046,10656846,10.656846
6544,3903,4055,15826665,2,52358,13091,1,543230536,543230536,19633,6544,13089,6544,0,1,6546,1312502,1.312502
7044,3903,4055,15826665,2,56358,14091,1,575062536,575062536,21133,7044,14089,7044,0,1,7046,8116931,8.116931
44,4453,3555,15830415,2,358,91,1,129462136,129462136,133,44,89,44,0,1,46,11376,0.011376
544,4453,3555,15830415,2,4358,1091,1,161494136,161494136,1633,544,1089,544,0,1,546,134700,0.1347
1044,4453,3555,15830415,2,8358,2091,1,193526136,193526136,3133,1044,2089,1044,0,1,1046,92883,0.092883
1544,4453,3555,15830415,2,12358,3091,1,225558136,225558136,4633,1544,3089,1544,0,1,1546,377090,0.37709
2044,4453,3555,15830415,2,16358,4091,1,257590136,257590136,6133,2044,4089,2044,0,1,2046,1873670,1.87367
2544,4453,3555,15830415,2,20358,5091,1,289622136,289622136,7633,2544,5089,2544,0,1,2546,1135594,1.135594
3044,4453,3555,15830415,2,24358,6091,1,321654136,321654136,9133,3044,6089,3044,0,1,3046,1841908,1.841908
3544,4453,3555,15830415,2,28358,7091,1,353686136,353686136,10633,3544,7089,3544,0,1,3546,1619939,1.619939
4044,4453,3555,15830415,2,32358,8091,1,385718136,385718136,12133,4044,8089,4044,0,1,4046,1163184,1.163184
4544,4453,3555,15830415,2,36358,9091,1,417750136,417750136,13633,4544,9089,4544,0,1,4546,1703722,1.703722
5044,4453,3555,15830415,2,40358,10091,1,449782136,449782136,15133,5044,10089,5044,0,1,5046,520536,0.520536
5544,4453,3555,15830415,2,44358,11091,1,481814136,481814136,16633,5544,11089,5544,0,1,5546,810731,0.810731
6044,4453,3555,15830415,2,48358,12091,1,513846136,513846136,18133,6044,12089,6044,0,1,6046,382234,0.382234
6544,4453,3555,15830415,2,52358,13091,1,545878136,545878136,19633,6544,13089,6544,0,1,6546,212207,0.212207
7044,4453,3555,15830415,2,56358,14091,1,577910136,577910136,21133,7044,14089,7044,0,1,7046,4009302,4.009302
40,5800,2740,15892000,2,326,83,1,129868800,129868800,121,40,81,40,0,1,42,12543,0.012543
440,5800,2740,15892000,2,3526,883,1,157196800,157196800,1321,440,881,440,0,1,442,161884,0.161884
840,5800,2740,15892000,2,6726,1683,1,184524800,184524800,2521,840,1681,840,0,1,842,184926,0.184926
1240,5800,2740,15892000,2,9926,2483,1,211852800,211852800,3721,1240,2481,1240,0,1,1242,180019,0.180019
1640,5800,2740,15892000,2,13126,3283,1,239180800,239180800,4921,1640,3281,1640,0,1,1642,1363901,1.363901
2040,5800,2740,15892000,2,16326,4083,1,266508800,266508800,6121,2040,4081,2040,0,1,2042,1469817,1.469817
2440,5800,2740,15892000,2,19526,4883,1,293836800,293836800,7321,2440,4881,2440,0,1,2442,550641,0.550641
2840,5800,2740,15892000,2,22726,5683,1,321164800,321164800,8521,2840,5681,2840,0,1,2842,1222292,1.222292
3240,5800,2740,15892000,2,25926,6483,1,348492800,348492800,9721,3240,6481,3240,0,1,3242,1026542,1.026542
3640,5800,2740,15892000,2,29126,7283,1,375820800,375820800,10921,3640,7281,3640,0,1,3642,639686,0.639686
4040,5800,2740,15892000,2,32326,8083,1,403148800,403148800,12121,4040,8081,4040,0,1,4042,1383010,1.38301
4440,5800,2740,15892000,2,35526,8883,1,430476800,430476800,13321,4440,8881,4440,0,1,4442,117351,0.117351
4840,5800,2740,15892000,2,38726,9683,1,457804800,457804800,14521,4840,9681,4840,0,1,4842,2623831,2.623831
5240,5800,2740,15892000,2,41926,10483,1,485132800,485132800,15721,5240,10481,5240,0,1,5242,1920477,1.920477
5640,5800,2740,15892000,2,45126,11283,1,512460800,512460800,16921,5640,11281,5640,0,1,5642,4918221,4.918221
6040,5800,2740,15892000,2,48326,12083,1,539788800,539788800,18121,6040,12081,6040,0,1,6042,786291,0.786291
6440,5800,2740,15892000,2,51526,12883,1,567116800,567116800,19321,6440,12881,6440,0,1,6442,1027118,1.027118
6840,5800,2740,15892000,2,54726,13683,1,594444800,594444800,20521,6840,13681,6840,0,1,6842,837073,0.837073
44,2253,7055,15894915,2,358,91,1,130435736,130435736,133,44,89,44,0,1,46,38933,0.038933
544,2253,7055,15894915,2,4358,1091,1,167667736,167667736,1633,544,1089,544,0,1,546,158160,0.15816
1044,2253,7055,15894915,2,8358,2091,1,204899736,204899736,3133,1044,2089,1044,0,1,1046,29291,0.029291
1544,2253,7055,15894915,2,12358,3091,1,242131736,242131736,4633,1544,3089,1544,0,1,1546,693571,0.693571
2044,2253,7055,15894915,2,16358,4091,1,279363736,279363736,6133,2044,4089,2044,0,1,2046,156704,0.156704
2544,2253,7055,15894915,2,20358,5091,1,316595736,316595736,7633,2544,5089,2544,0,1,2546,232039,0.232039
3044,2253,7055,15894915,2,24358,6091,1,353827736,353827736,9133,3044,6089,3044,0,1,3046,61804,0.061804
3544,2253,7055,15894915,2,28358,7091,1,391059736,391059736,10633,3544,7089,3544,0,1,3546,115605,0.115605
4044,2253,7055,15894915,2,32358,8091,1,428291736,428291736,12133,4044,8089,4044,0,1,4046,1626807,1.626807
4544,2253,7055,15894915,2,36358,9091,1,465523736,465523736,13633,4544,9089,4544,0,1,4546,417569,0.417569
5044,2253,7055,15894915,2,40358,10091,1,502755736,502755736,15133,5044,10089,5044,0,1,5046,3235940,3.23594
5544,2253,7055,15894915,2,44358,11091,1,539987736,539987736,16633,5544,11089,5544,0,1,5546,1315383,1.315383
6044,2253,7055,15894915,2,48358,12091,1,577219736,577219736,18133,6044,12089,6044,0,1,6046,2623322,2.623322
6544,2253,7055,15894915,2,52358,13091,1,614451736,614451736,19633,6544,13089,6544,0,1,6546,1974497,1.974497
7044,2253,7055,15894915,2,56358,14091,1,651683736,651683736,21133,7044,14089,7044,0,1,7046,699279,0.699279
40,4050,3940,15957000,2,326,83,1,130212800,130212800,121,40,81,40,0,1,42,15039,0.015039
440,4050,3940,15957000,2,3526,883,1,155780800,155780800,1321,440,881,440,0,1,442,12194,0.012194
840,4050,3940,15957000,2,6726,1683,1,181348800,181348800,2521,840,1681,840,0,1,842,258910,0.25891
1240,4050,3940,15957000,2,9926,2483,1,206916800,206916800,3721,1240,2481,1240,0,1,1242,477194,0.477194
1640,4050,3940,15957000,2,13126,3283,1,232484800,232484800,4921,1640,3281,1640,0,1,1642,193322,0.193322
2040,4050,3940,15957000,2,16326,4083,1,258052800,258052800,6121,2040,4081,2040,0,1,2042,69211,0.069211
2440,4050,3940,15957000,2,19526,4883,1,283620800,283620800,7321,2440,4881,2440,0,1,2442,298912,0.298912
2840,4050,3940,15957000,2,22726,5683,1,309188800,309188800,8521,2840,5681,2840,0,1,2842,536480,0.53648
3240,4050,3940,15957000,2,25926,6483,1,334756800,334756800,9721,3240,6481,3240,0,1,3242,454219,0.454219
3640,4050,3940,15957000,2,29126,7283,1,360324800,360324800,10921,3640,7281,3640,0,1,3642,288028,0.288028
4040,4050,3940,15957000,2,32326,8083,1,385892800,385892800,12121,4040,8081,4040,0,1,4042,1012003,1.012003
4440,4050,3940,15957000,2,35526,8883,1,411460800,411460800,13321,4440,8881,4440,0,1,4442,1526940,1.52694
4840,4050,3940,15957000,2,38726,9683,1,437028800,437028800,14521,4840,9681,4840,0,1,4842,148178,0.148178
5240,4050,3940,15957000,2,41926,10483,1,462596800,462596800,15721,5240,10481,5240,0,1,5242,1035135,1.035135
5640,4050,3940,15957000,2,45126,11283,1,488164800,488164800,16921,5640,11281,5640,0,1,5642,632019,0.632019
6040,4050,3940,15957000,2,48326,12083,1,513732800,513732800,18121,6040,12081,6040,0,1,6042,937504,0.937504
6440,4050,3940,15957000,2,51526,12883,1,539300800,539300800,19321,6440,12881,6440,0,1,6442,819965,0.819965
6840,4050,3940,15957000,2,54726,13683,1,564868800,564868800,20521,6840,13681,6840,0,1,6842,626939,0.626939
40,2300,6940,15962000,2,326,83,1,130652800,130652800,121,40,81,40,0,1,42,293432,0.293432
440,2300,6940,15962000,2,3526,883,1,160220800,160220800,1321,440,881,440,0,1,442,1445061,1.445061
840,2300,6940,15962000,2,6726,1683,1,189788800,189788800,2521,840,1681,840,0,1,842,1908185,1.908185
1240,2300,6940,15962000,2,9926,2483,1,219356800,219356800,3721,1240,2481,1240,0,1,1242,417671,0.417671
1640,2300,6940,15962000,2,13126,3283,1,248924800,248924800,4921,1640,3281,1640,0,1,1642,769384,0.769384
2040,2300,6940,15962000,2,16326,4083,1,278492800,278492800,6121,2040,4081,2040,0,1,2042,985163,0.985163
2440,2300,6940,15962000,2,19526,4883,1,308060800,308060800,7321,2440,4881,2440,0,1,2442,1627887,1.627887
2840,2300,6940,15962000,2,22726,5683,1,337628800,337628800,8521,2840,5681,2840,0,1,2842,251394,0.251394
3240,2300,6940,15962000,2,25926,6483,1,367196800,367196800,9721,3240,6481,3240,0,1,3242,1989803,1.989803
3640,2300,6940,15962000,2,29126,7283,1,396764800,396764800,10921,3640,7281,3640,0,1,3642,309740,0.30974
4040,2300,6940,15962000,2,32326,8083,1,426332800,426332800,12121,4040,8081,4040,0,1,4042,3546271,3.546271
4440,2300,6940,15962000,2,35526,8883,1,455900800,455900800,13321,4440,8881,4440,0,1,4442,3365548,3.365548
4840,2300,6940,15962000,2,38726,9683,1,485468800,485468800,14521,4840,9681,4840,0,1,4842,1319347,1.319347
5240,2300,6940,15962000,2,41926,10483,1,515036800,515036800,15721,5240,10481,5240,0,1,5242,2258746,2.258746
5640,2300,6940,15962000,2,45126,11283,1,544604800,544604800,16921,5640,11281,5640,0,1,5642,5218711,5.218711
6040,2300,6940,15962000,2,48326,12083,1,574172800,574172800,18121,6040,12081,6040,0,1,6042,1440378,1.440378
6440,2300,6940,15962000,2,51526,12883,1,603740800,603740800,19321,6440,12881,6440,0,1,6442,235253,0.235253
6840,2300,6940,15962000,2,54726,13683,1,633308800,633308800,20521,6840,13681,6840,0,1,6842,79179,0.079179
40,3300,4840,15972000,2,326,83,1,130380800,130380800,121,40,81,40,0,1,42,280498,0.280498
440,3300,4840,15972000,2,3526,883,1,156428800,156428800,1321,440,881,440,0,1,442,695758,0.695758
840,3300,4840,15972000,2,6726,1683,1,182476800,182476800,2521,840,1681,840,0,1,842,2654112,2.654112
1240,3300,4840,15972000,2,9926,2483,1,208524800,208524800,3721,1240,2481,1240,0,1,1242,1830612,1.830612
1640,3300,4840,15972000,2,13126,3283,1,234572800,234572800,4921,1640,3281,1640,0,1,1642,709013,0.709013
2040,3300,4840,15972000,2,16326,4083,1,260620800,260620800,6121,2040,4081,2040,0,1,2042,2179982,2.179982
2440,3300,4840,15972000,2,19526,4883,1,286668800,286668800,7321,2440,4881,2440,0,1,2442,2642630,2.64263
2840,3300,4840,15972000,2,22726,5683,1,312716800,312716800,8521,2840,5681,2840,0,1,2842,2286568,2.286568
3240,3300,4840,15972000,2,25926,6483,1,338764800,338764800,9721,3240,6481,3240,0,1,3242,2552585,2.552585
3640,3300,4840,15972000,2,29126,7283,1,364812800,364812800,10921,3640,7281,3640,0,1,3642,986895,0.986895
4040,3300,4840,15972000,2,32326,8083,1,390860800,390860800,12121,4040,8081,4040,0,1,4042,493024,0.493024
4440,3300,4840,15972000,2,35526,8883,1,416908800,416908800,13321,4440,8881,4440,0,1,4442,483300,0.4833
4840,3300,4840,15972000,2,38726,9683,1,442956800,442956800,14521,4840,9681,4840,0,1,4842,204369,0.204369
5240,3300,4840,15972000,2,41926,10483,1,469004800,469004800,15721,5240,10481,5240,0,1,5242,52448,0.052448
5640,3300,4840,15972000,2,45126,11283,1,495052800,495052800,16921,5640,11281,5640,0,1,5642,704623,0.704623
6040,3300,4840,15972000,2,48326,12083,1,521100800,521100800,18121,6040,12081,6040,0,1,6042,422352,0.422352
6440,3300,4840,15972000,2,51526,12883,1,547148800,547148800,19321,6440,12881,6440,0,1,6442,2109112,2.109112
6840,3300,4840,15972000,2,54726,13683,1,573196800,573196800,20521,6840,13681,6840,0,1,6842,75029,0.075029
40,6550,2440,15982000,2,326,83,1,130732800,130732800,121,40,81,40,0,1,42,15313,0.015313
440,6550,2440,15982000,2,3526,883,1,159500800,159500800,1321,440,881,440,0,1,442,39015,0.039015
840,6550,2440,15982000,2,6726,1683,1,188268800,188268800,2521,840,1681,840,0,1,842,89468,0.089468
1240,6550,2440,15982000,2,9926,2483,1,217036800,217036800,3721,1240,2481,1240,0,1,1242,525789,0.525789
1640,6550,2440,15982000,2,13126,3283,1,245804800,245804800,4921,1640,3281,1640,0,1,1642,494837,0.494837
2040,6550,2440,15982000,2,16326,4083,1,274572800,274572800,6121,2040,4081,2040,0,1,2042,15391,0.015391
2440,6550,2440,15982000,2,19526,4883,1,303340800,303340800,7321,2440,4881,2440,0,1,2442,333437,0.333437
2840,6550,2440,15982000,2,22726,5683,1,332108800,332108800,8521,2840,5681,2840,0,1,2842,319850,0.31985
3240,6550,2440,15982000,2,25926,6483,1,360876800,360876800,9721,3240,6481,3240,0,1,3242,11183,0.011183
3640,6550,2440,15982000,2,29126,7283,1,389644800,389644800,10921,3640,7281,3640,0,1,3642,506997,0.506997
4040,6550,2440,15982000,2,32326,8083,1,418412800,418412800,12121,4040,8081,4040,0,1,4042,386417,0.386417
4440,6550,2440,15982000,2,35526,8883,1,447180800,447180800,13321,4440,8881,4440,0,1,4442,2379845,2.379845
4840,6550,2440,15982000,2,38726,9683,1,475948800,475948800,14521,4840,9681,4840,0,1,4842,324631,0.324631
5240,6550,2440,15982000,2,41926,10483,1,504716800,504716800,15721,5240,10481,5240,0,1,5242,1795189,1.795189
5640,6550,2440,15982000,2,45126,11283,1,533484800,533484800,16921,5640,11281,5640,0,1,5642,384545,0.384545
6040,6550,2440,15982000,2,48326,12083,1,562252800,562252800,18121,6040,12081,6040,0,1,6042,163904,0.163904
6440,6550,2440,15982000,2,51526,12883,1,591020800,591020800,19321,6440,12881,6440,0,1,6442,573648,0.573648
6840,6550,2440,15982000,2,54726,13683,1,619788800,619788800,20521,6840,13681,6840,0,1,6842,855762,0.855762
40,4800,3340,16032000,2,326,83,1,130860800,130860800,121,40,81,40,0,1,42,285449,0.285449
440,4800,3340,16032000,2,3526,883,1,156908800,156908800,1321,440,881,440,0,1,442,1436229,1.436229
840,4800,3340,16032000,2,6726,1683,1,182956800,182956800,2521,840,1681,840,0,1,842,1760140,1.76014
1240,4800,3340,16032000,2,9926,2483,1,209004800,209004800,3721,1240,2481,1240,0,1,1242,3780506,3.780506
1640,4800,3340,16032000,2,13126,3283,1,235052800,235052800,4921,1640,3281,1640,0,1,1642,2961652,2.961652
2040,4800,3340,16032000,2,16326,4083,1,261100800,261100800,6121,2040,4081,2040,0,1,2042,1860080,1.86008
2440,4800,3340,16032000,2,19526,4883,1,287148800,287148800,7321,2440,4881,2440,0,1,2442,7306174,7.306174
2840,4800,3340,16032000,2,22726,5683,1,313196800,313196800,8521,2840,5681,2840,0,1,2842,2348061,2.348061
3240,4800,3340,16032000,2,25926,6483,1,339244800,339244800,9721,3240,6481,3240,0,1,3242,3710402,3.710402
3640,4800,3340,16032000,2,29126,7283,1,365292800,365292800,10921,3640,7281,3640,0,1,3642,1952206,1.952206
4040,4800,3340,16032000,2,32326,8083,1,391340800,391340800,12121,4040,8081,4040,0,1,4042,45363,0.045363
4440,4800,3340,16032000,2,35526,8883,1,417388800,417388800,13321,4440,8881,4440,0,1,4442,9522441,9.522441
4840,4800,3340,16032000,2,38726,9683,1,443436800,443436800,14521,4840,9681,4840,0,1,4842,1512761,1.512761
5240,4800,3340,16032000,2,41926,10483,1,469484800,469484800,15721,5240,10481,5240,0,1,5242,430753,0.430753
5640,4800,3340,16032000,2,45126,11283,1,495532800,495532800,16921,5640,11281,5640,0,1,5642,4908742,4.908742
6040,4800,3340,16032000,2,48326,12083,1,521580800,521580800,18121,6040,12081,6040,0,1,6042,3917948,3.917948
6440,4800,3340,16032000,2,51526,12883,1,547628800,547628800,19321,6440,12881,6440,0,1,6442,3012274,3.012274
6840,4800,3340,16032000,2,54726,13683,1,573676800,573676800,20521,6840,13681,6840,0,1,6842,974639,0.974639
55,5805,2765,16050825,2,446,113,1,132177400,132177400,166,55,111,55,0,1,57,22333,0.022333
455,5805,2765,16050825,2,3646,913,1,159601400,159601400,1366,455,911,455,0,1,457,102884,0.102884
855,5805,2765,16050825,2,6846,1713,1,187025400,187025400,2566,855,1711,855,0,1,857,477438,0.477438
1255,5805,2765,16050825,2,10046,2513,1,214449400,214449400,3766,1255,2511,1255,0,1,1257,427283,0.427283
1655,5805,2765,16050825,2,13246,3313,1,241873400,241873400,4966,1655,3311,1655,0,1,1657,1100559,1.100559
2055,5805,2765,16050825,2,16446,4113,1,269297400,269297400,6166,2055,4111,2055,0,1,2057,976564,0.976564
2455,5805,2765,16050825,2,19646,4913,1,296721400,296721400,7366,2455,4911,2455,0,1,2457,1058782,1.058782
2855,5805,2765,16050825,2,22846,5713,1,324145400,324145400,8566,2855,5711,2855,0,1,2857,591451,0.591451
3255,5805,2765,16050825,2,26046,6513,1,351569400,351569400,9766,3255,6511,3255,0,1,3257,42785,0.042785
3655,5805,2765,16050825,2,29246,7313,1,378993400,378993400,10966,3655,7311,3655,0,1,3657,172563,0.172563
4055,5805,2765,16050825,2,32446,8113,1,406417400,406417400,12166,4055,8111,4055,0,1,4057,1977241,1.977241
4455,5805,2765,16050825,2,35646,8913,1,433841400,433841400,13366,4455,8911,4455,0,1,4457,537457,0.537457
4855,5805,2765,16050825,2,38846,9713,1,461265400,461265400,14566,4855,9711,4855,0,1,4857,1381858,1.381858
5255,5805,2765,16050825,2,42046,10513,1,488689400,488689400,15766,5255,10511,5255,0,1,5257,1869101,1.869101
5655,5805,2765,16050825,2,45246,11313,1,516113400,516113400,16966,5655,11311,5655,0,1,5657,5079279,5.079279
6055,5805,2765,16050825,2,48446,12113,1,543537400,543537400,18166,6055,12111,6055,0,1,6057,805321,0.805321
6455,5805,2765,16050825,2,51646,12913,1,570961400,570961400,19366,6455,12911,6455,0,1,6457,1298705,1.298705
6855,5805,2765,16050825,2,54846,13713,1,598385400,598385400,20566,6855,13711,6855,0,1,6857,99508,0.099508
55,2305,6965,16054325,2,446,113,1,132513400,132513400,166,55,111,55,0,1,57,319920,0.31992
455,2305,6965,16054325,2,3646,913,1,162177400,162177400,1366,455,911,455,0,1,457,1478930,1.47893
855,2305,6965,16054325,2,6846,1713,1,191841400,191841400,2566,855,1711,855,0,1,857,1761400,1.7614
1255,2305,6965,16054325,2,10046,2513,1,221505400,221505400,3766,1255,2511,1255,0,1,1257,1958916,1.958916
1655,2305,6965,16054325,2,13246,3313,1,251169400,251169400,4966,1655,3311,1655,0,1,1657,3455366,3.455366
2055,2305,6965,16054325,2,16446,4113,1,280833400,280833400,6166,2055,4111,2055,0,1,2057,1310536,1.310536
2455,2305,6965,16054325,2,19646,4913,1,310497400,310497400,7366,2455,4911,2455,0,1,2457,4059012,4.059012
2855,2305,6965,16054325,2,22846,5713,1,340161400,340161400,8566,2855,5711,2855,0,1,2857,214669,0.214669
3255,2305,6965,16054325,2,26046,6513,1,369825400,369825400,9766,3255,6511,3255,0,1,3257,1559097,1.559097
3655,2305,6965,16054325,2,29246,7313,1,399489400,399489400,10966,3655,7311,3655,0,1,3657,1391151,1.391151
4055,2305,6965,16054325,2,32446,8113,1,429153400,429153400,12166,4055,8111,4055,0,1,4057,3137332,3.137332
4455,2305,6965,16054325,2,35646,8913,1,458817400,458817400,13366,4455,8911,4455,0,1,4457,394355,0.394355
4855,2305,6965,16054325,2,38846,9713,1,488481400,488481400,14566,4855,9711,4855,0,1,4857,1018633,1.018633
5255,2305,6965,16054325,2,42046,10513,1,518145400,518145400,15766,5255,10511,5255,0,1,5257,442202,0.442202
5655,2305,6965,16054325,2,45246,11313,1,547809400,547809400,16966,5655,11311,5655,0,1,5657,1976898,1.976898
6055,2305,6965,16054325,2,48446,12113,1,577473400,577473400,18166,6055,12111,6055,0,1,6057,1353082,1.353082
6455,2305,6965,16054325,2,51646,12913,1,607137400,607137400,19366,6455,12911,6455,0,1,6457,317694,0.317694
6855,2305,6965,16054325,2,54846,13713,1,636801400,636801400,20566,6855,13711,6855,0,1,6857,1182783,1.182783
40,2800,5740,16072000,2,326,83,1,131308800,131308800,121,40,81,40,0,1,42,287238,0.287238
440,2800,5740,16072000,2,3526,883,1,158636800,158636800,1321,440,881,440,0,1,442,830832,0.830832
840,2800,5740,16072000,2,6726,1683,1,185964800,185964800,2521,840,1681,840,0,1,842,45644,0.045644
1240,2800,5740,16072000,2,9926,2483,1,213292800,213292800,3721,1240,2481,1240,0,1,1242,1117309,1.117309
1640,2800,5740,16072000,2,13126,3283,1,240620800,240620800,4921,1640,3281,1640,0,1,1642,1376652,1.376652
2040,2800,5740,16072000,2,16326,4083,1,267948800,267948800,6121,2040,4081,2040,0,1,2042,365761,0.365761
2440,2800,5740,16072000,2,19526,4883,1,295276800,295276800,7321,2440,4881,2440,0,1,2442,4510325,4.510325
2840,2800,5740,16072000,2,22726,5683,1,322604800,322604800,8521,2840,5681,2840,0,1,2842,844589,0.844589
3240,2800,5740,16072000,2,25926,6483,1,349932800,349932800,9721,3240,6481,3240,0,1,3242,3048524,3.048524
3640,2800,5740,16072000,2,29126,7283,1,377260800,377260800,10921,3640,7281,3640,0,1,3642,614299,0.614299
4040,2800,5740,16072000,2,32326,8083,1,404588800,404588800,12121,4040,8081,4040,0,1,4042,6352102,6.352102
4440,2800,5740,16072000,2,35526,8883,1,431916800,431916800,13321,4440,8881,4440,0,1,4442,1665060,1.66506
4840,2800,5740,16072000,2,38726,9683,1,459244800,459244800,14521,4840,9681,4840,0,1,4842,250360,0.25036
5240,2800,5740,16072000,2,41926,10483,1,486572800,486572800,15721,5240,10481,5240,0,1,5242,1008693,1.008693
5640,2800,5740,16072000,2,45126,11283,1,513900800,513900800,16921,5640,11281,5640,0,1,5642,2120363,2.120363
6040,2800,5740,16072000,2,48326,12083,1,541228800,541228800,18121,6040,12081,6040,0,1,6042,1557804,1.557804
6440,2800,5740,16072000,2,51526,12883,1,568556800,568556800,19321,6440,12881,6440,0,1,6442,8882544,8.882544
6840,2800,5740,16072000,2,54726,13683,1,595884800,595884800,20521,6840,13681,6840,0,1,6842,27217,0.027217
55,4055,3965,16078075,2,446,113,1,132153400,132153400,166,55,111,55,0,1,57,27254,0.027254
455,4055,3965,16078075,2,3646,913,1,157817400,157817400,1366,455,911,455,0,1,457,222499,0.222499
855,4055,3965,16078075,2,6846,1713,1,183481400,183481400,2566,855,1711,855,0,1,857,41589,0.041589
1255,4055,3965,16078075,2,10046,2513,1,209145400,209145400,3766,1255,2511,1255,0,1,1257,377826,0.377826
1655,4055,3965,16078075,2,13246,3313,1,234809400,234809400,4966,1655,3311,1655,0,1,1657,63733,0.063733
2055,4055,3965,16078075,2,16446,4113,1,260473400,260473400,6166,2055,4111,2055,0,1,2057,484328,0.484328
2455,4055,3965,16078075,2,19646,4913,1,286137400,286137400,7366,2455,4911,2455,0,1,2457,177251,0.177251
2855,4055,3965,16078075,2,22846,5713,1,311801400,311801400,8566,2855,5711,2855,0,1,2857,609156,0.609156
3255,4055,3965,16078075,2,26046,6513,1,337465400,337465400,9766,3255,6511,3255,0,1,3257,109459,0.109459
3655,4055,3965,16078075,2,29246,7313,1,363129400,363129400,10966,3655,7311,3655,0,1,3657,399390,0.39939
4055,4055,3965,16078075,2,32446,8113,1,388793400,388793400,12166,4055,8111,4055,0,1,4057,765713,0.765713
4455,4055,3965,16078075,2,35646,8913,1,414457400,414457400,13366,4455,8911,4455,0,1,4457,49308,0.049308
4855,4055,3965,16078075,2,38846,9713,1,440121400,440121400,14566,4855,9711,4855,0,1,4857,302016,0.302016
5255,4055,3965,16078075,2,42046,10513,1,465785400,465785400,15766,5255,10511,5255,0,1,5257,276792,0.276792
5655,4055,3965,16078075,2,45246,11313,1,491449400,491449400,16966,5655,11311,5655,0,1,5657,1182173,1.182173
6055,4055,3965,16078075,2,48446,12113,1,517113400,517113400,18166,6055,12111,6055,0,1,6057,130179,0.130179
6455,4055,3965,16078075,2,51646,12913,1,542777400,542777400,19366,6455,12911,6455,0,1,6457,2284375,2.284375
6855,4055,3965,16078075,2,54846,13713,1,568441400,568441400,20566,6855,13711,6855,0,1,6857,1171343,1.171343
55,3305,4865,16078825,2,446,113,1,132225400,132225400,166,55,111,55,0,1,57,330513,0.330513
455,3305,4865,16078825,2,3646,913,1,158369400,158369400,1366,455,911,455,0,1,457,1538377,1.538377
855,3305,4865,16078825,2,6846,1713,1,184513400,184513400,2566,855,1711,855,0,1,857,805878,0.805878
1255,3305,4865,16078825,2,10046,2513,1,210657400,210657400,3766,1255,2511,1255,0,1,1257,544873,0.544873
1655,3305,4865,16078825,2,13246,3313,1,236801400,236801400,4966,1655,3311,1655,0,1,1657,1544144,1.544144
2055,3305,4865,16078825,2,16446,4113,1,262945400,262945400,6166,2055,4111,2055,0,1,2057,5625397,5.625397
2455,3305,4865,16078825,2,19646,4913,1,289089400,289089400,7366,2455,4911,2455,0,1,2457,246579,0.246579
2855,3305,4865,16078825,2,22846,5713,1,315233400,315233400,8566,2855,5711,2855,0,1,2857,346790,0.34679
3255,3305,4865,16078825,2,26046,6513,1,341377400,341377400,9766,3255,6511,3255,0,1,3257,638394,0.638394
3655,3305,4865,16078825,2,29246,7313,1,367521400,367521400,10966,3655,7311,3655,0,1,3657,737162,0.737162
4055,3305,4865,16078825,2,32446,8113,1,393665400,393665400,12166,4055,8111,4055,0,1,4057,785190,0.78519
4455,3305,4865,16078825,2,35646,8913,1,419809400,419809400,13366,4455,8911,4455,0,1,4457,265519,0.265519
4855,3305,4865,16078825,2,38846,9713,1,445953400,445953400,14566,4855,9711,4855,0,1,4857,293128,0.293128
5255,3305,4865,16078825,2,42046,10513,1,472097400,472097400,15766,5255,10511,5255,0,1,5257,1535728,1.535728
5655,3305,4865,16078825,2,45246,11313,1,498241400,498241400,16966,5655,11311,5655,0,1,5657,340078,0.340078
6055,3305,4865,16078825,2,48446,12113,1,524385400,524385400,18166,6055,12111,6055,0,1,6057,594485,0.594485
6455,3305,4865,16078825,2,51646,12913,1,550529400,550529400,19366,6455,12911,6455,0,1,6457,590536,0.590536
6855,3305,4865,16078825,2,54846,13713,1,576673400,576673400,20566,6855,13711,6855,0,1,6857,2314628,2.314628
40,5300,3040,16112000,2,326,83,1,131564800,131564800,121,40,81,40,0,1,42,281215,0.281215
440,5300,3040,16112000,2,3526,883,1,158252800,158252800,1321,440,881,440,0,1,442,1459990,1.45999
840,5300,3040,16112000,2,6726,1683,1,184940800,184940800,2521,840,1681,840,0,1,842,1401894,1.401894
1240,5300,3040,16112000,2,9926,2483,1,211628800,211628800,3721,1240,2481,1240,0,1,1242,1426666,1.426666
1640,5300,3040,16112000,2,13126,3283,1,238316800,238316800,4921,1640,3281,1640,0,1,1642,339052,0.339052
2040,5300,3040,16112000,2,16326,4083,1,265004800,265004800,6121,2040,4081,2040,0,1,2042,4078686,4.078686
2440,5300,3040,16112000,2,19526,4883,1,291692800,291692800,7321,2440,4881,2440,0,1,2442,276755,0.276755
2840,5300,3040,16112000,2,22726,5683,1,318380800,318380800,8521,2840,5681,2840,0,1,2842,3252774,3.252774
3240,5300,3040,16112000,2,25926,6483,1,345068800,345068800,9721,3240,6481,3240,0,1,3242,5044033,5.044033
3640,5300,3040,16112000,2,29126,7283,1,371756800,371756800,10921,3640,7281,3640,0,1,3642,1832239,1.832239
4040,5300,3040,16112000,2,32326,8083,1,398444800,398444800,12121,4040,8081,4040,0,1,4042,561726,0.561726
4440,5300,3040,16112000,2,35526,8883,1,425132800,425132800,13321,4440,8881,4440,0,1,4442,2777586,2.777586
4840,5300,3040,16112000,2,38726,9683,1,451820800,451820800,14521,4840,9681,4840,0,1,4842,2787336,2.787336
5240,5300,3040,16112000,2,41926,10483,1,478508800,478508800,15721,5240,10481,5240,0,1,5242,2369534,2.369534
5640,5300,3040,16112000,2,45126,11283,1,505196800,505196800,16921,5640,11281,5640,0,1,5642,4740948,4.740948
6040,5300,3040,16112000,2,48326,12083,1,531884800,531884800,18121,6040,12081,6040,0,1,6042,938943,0.938943
6440,5300,3040,16112000,2,51526,12883,1,558572800,558572800,19321,6440,12881,6440,0,1,6442,5730929,5.730929
40,3800,4240,16112000,2,326,83,1,131468800,131468800,121,40,81,40,0,1,42,282367,0.282367
440,3800,4240,16112000,2,3526,883,1,157196800,157196800,1321,440,881,440,0,1,442,1456436,1.456436
840,3800,4240,16112000,2,6726,1683,1,182924800,182924800,2521,840,1681,840,0,1,842,2632356,2.632356
6840,5300,3040,16112000,2,54726,13683,1,585260800,585260800,20521,6840,13681,6840,0,1,6842,2492077,2.492077
1240,3800,4240,16112000,2,9926,2483,1,208652800,208652800,3721,1240,2481,1240,0,1,1242,1969051,1.969051
1640,3800,4240,16112000,2,13126,3283,1,234380800,234380800,4921,1640,3281,1640,0,1,1642,279282,0.279282
2040,3800,4240,16112000,2,16326,4083,1,260108800,260108800,6121,2040,4081,2040,0,1,2042,4014341,4.014341
2440,3800,4240,16112000,2,19526,4883,1,285836800,285836800,7321,2440,4881,2440,0,1,2442,1140355,1.140355
2840,3800,4240,16112000,2,22726,5683,1,311564800,311564800,8521,2840,5681,2840,0,1,2842,280161,0.280161
3240,3800,4240,16112000,2,25926,6483,1,337292800,337292800,9721,3240,6481,3240,0,1,3242,3028256,3.028256
3640,3800,4240,16112000,2,29126,7283,1,363020800,363020800,10921,3640,7281,3640,0,1,3642,6958181,6.958181
4040,3800,4240,16112000,2,32326,8083,1,388748800,388748800,12121,4040,8081,4040,0,1,4042,308662,0.308662
4440,3800,4240,16112000,2,35526,8883,1,414476800,414476800,13321,4440,8881,4440,0,1,4442,5226953,5.226953
4840,3800,4240,16112000,2,38726,9683,1,440204800,440204800,14521,4840,9681,4840,0,1,4842,1863441,1.863441
5240,3800,4240,16112000,2,41926,10483,1,465932800,465932800,15721,5240,10481,5240,0,1,5242,2259954,2.259954
5640,3800,4240,16112000,2,45126,11283,1,491660800,491660800,16921,5640,11281,5640,0,1,5642,7453885,7.453885
6040,3800,4240,16112000,2,48326,12083,1,517388800,517388800,18121,6040,12081,6040,0,1,6042,4726963,4.726963
6440,3800,4240,16112000,2,51526,12883,1,543116800,543116800,19321,6440,12881,6440,0,1,6442,5322074,5.322074
6840,3800,4240,16112000,2,54726,13683,1,568844800,568844800,20521,6840,13681,6840,0,1,6842,3024654,3.024654
40,3550,4540,16117000,2,326,83,1,131524800,131524800,121,40,81,40,0,1,42,282185,0.282185
440,3550,4540,16117000,2,3526,883,1,157412800,157412800,1321,440,881,440,0,1,442,1481228,1.481228
840,3550,4540,16117000,2,6726,1683,1,183300800,183300800,2521,840,1681,840,0,1,842,1345211,1.345211
1240,3550,4540,16117000,2,9926,2483,1,209188800,209188800,3721,1240,2481,1240,0,1,1242,2426237,2.426237
1640,3550,4540,16117000,2,13126,3283,1,235076800,235076800,4921,1640,3281,1640,0,1,1642,1612562,1.612562
2040,3550,4540,16117000,2,16326,4083,1,260964800,260964800,6121,2040,4081,2040,0,1,2042,1331084,1.331084
2440,3550,4540,16117000,2,19526,4883,1,286852800,286852800,7321,2440,4881,2440,0,1,2442,553676,0.553676
2840,3550,4540,16117000,2,22726,5683,1,312740800,312740800,8521,2840,5681,2840,0,1,2842,3487987,3.487987
3240,3550,4540,16117000,2,25926,6483,1,338628800,338628800,9721,3240,6481,3240,0,1,3242,642011,0.642011
3640,3550,4540,16117000,2,29126,7283,1,364516800,364516800,10921,3640,7281,3640,0,1,3642,872983,0.872983
4040,3550,4540,16117000,2,32326,8083,1,390404800,390404800,12121,4040,8081,4040,0,1,4042,4055600,4.0556
4440,3550,4540,16117000,2,35526,8883,1,416292800,416292800,13321,4440,8881,4440,0,1,4442,9409176,9.409176
4840,3550,4540,16117000,2,38726,9683,1,442180800,442180800,14521,4840,9681,4840,0,1,4842,134322,0.134322
5240,3550,4540,16117000,2,41926,10483,1,468068800,468068800,15721,5240,10481,5240,0,1,5242,2299380,2.29938
5640,3550,4540,16117000,2,45126,11283,1,493956800,493956800,16921,5640,11281,5640,0,1,5642,998703,0.998703
6040,3550,4540,16117000,2,48326,12083,1,519844800,519844800,18121,6040,12081,6040,0,1,6042,1237631,1.237631
6440,3550,4540,16117000,2,51526,12883,1,545732800,545732800,19321,6440,12881,6440,0,1,6442,912527,0.912527
6840,3550,4540,16117000,2,54726,13683,1,571620800,571620800,20521,6840,13681,6840,0,1,6842,536263,0.536263
55,6555,2465,16158075,2,446,113,1,133233400,133233400,166,55,111,55,0,1,57,9896,0.009896
455,6555,2465,16158075,2,3646,913,1,162097400,162097400,1366,455,911,455,0,1,457,25076,0.025076
855,6555,2465,16158075,2,6846,1713,1,190961400,190961400,2566,855,1711,855,0,1,857,16333,0.016333
1255,6555,2465,16158075,2,10046,2513,1,219825400,219825400,3766,1255,2511,1255,0,1,1257,111510,0.11151
1655,6555,2465,16158075,2,13246,3313,1,248689400,248689400,4966,1655,3311,1655,0,1,1657,210187,0.210187
2055,6555,2465,16158075,2,16446,4113,1,277553400,277553400,6166,2055,4111,2055,0,1,2057,1385929,1.385929
2455,6555,2465,16158075,2,19646,4913,1,306417400,306417400,7366,2455,4911,2455,0,1,2457,218825,0.218825
2855,6555,2465,16158075,2,22846,5713,1,335281400,335281400,8566,2855,5711,2855,0,1,2857,1256679,1.256679
3255,6555,2465,16158075,2,26046,6513,1,364145400,364145400,9766,3255,6511,3255,0,1,3257,585512,0.585512
3655,6555,2465,16158075,2,29246,7313,1,393009400,393009400,10966,3655,7311,3655,0,1,3657,279009,0.279009
4055,6555,2465,16158075,2,32446,8113,1,421873400,421873400,12166,4055,8111,4055,0,1,4057,391315,0.391315
4455,6555,2465,16158075,2,35646,8913,1,450737400,450737400,13366,4455,8911,4455,0,1,4457,876352,0.876352
4855,6555,2465,16158075,2,38846,9713,1,479601400,479601400,14566,4855,9711,4855,0,1,4857,4762926,4.762926
5255,6555,2465,16158075,2,42046,10513,1,508465400,508465400,15766,5255,10511,5255,0,1,5257,21364,0.021364
5655,6555,2465,16158075,2,45246,11313,1,537329400,537329400,16966,5655,11311,5655,0,1,5657,1942352,1.942352
6055,6555,2465,16158075,2,48446,12113,1,566193400,566193400,18166,6055,12111,6055,0,1,6057,1382913,1.382913
6455,6555,2465,16158075,2,51646,12913,1,595057400,595057400,19366,6455,12911,6455,0,1,6457,247004,0.247004
6855,6555,2465,16158075,2,54846,13713,1,623921400,623921400,20566,6855,13711,6855,0,1,6857,1022661,1.022661
40,2550,6340,16167000,2,326,83,1,132180800,132180800,121,40,81,40,0,1,42,296490,0.29649
440,2550,6340,16167000,2,3526,883,1,160628800,160628800,1321,440,881,440,0,1,442,426435,0.426435
840,2550,6340,16167000,2,6726,1683,1,189076800,189076800,2521,840,1681,840,0,1,842,430583,0.430583
1240,2550,6340,16167000,2,9926,2483,1,217524800,217524800,3721,1240,2481,1240,0,1,1242,2812583,2.812583
1640,2550,6340,16167000,2,13126,3283,1,245972800,245972800,4921,1640,3281,1640,0,1,1642,2035857,2.035857
2040,2550,6340,16167000,2,16326,4083,1,274420800,274420800,6121,2040,4081,2040,0,1,2042,1980046,1.980046
2440,2550,6340,16167000,2,19526,4883,1,302868800,302868800,7321,2440,4881,2440,0,1,2442,566857,0.566857
2840,2550,6340,16167000,2,22726,5683,1,331316800,331316800,8521,2840,5681,2840,0,1,2842,356766,0.356766
3240,2550,6340,16167000,2,25926,6483,1,359764800,359764800,9721,3240,6481,3240,0,1,3242,5816232,5.816232
3640,2550,6340,16167000,2,29126,7283,1,388212800,388212800,10921,3640,7281,3640,0,1,3642,3169606,3.169606
4040,2550,6340,16167000,2,32326,8083,1,416660800,416660800,12121,4040,8081,4040,0,1,4042,632312,0.632312
4440,2550,6340,16167000,2,35526,8883,1,445108800,445108800,13321,4440,8881,4440,0,1,4442,602783,0.602783
4840,2550,6340,16167000,2,38726,9683,1,473556800,473556800,14521,4840,9681,4840,0,1,4842,5053556,5.053556
5240,2550,6340,16167000,2,41926,10483,1,502004800,502004800,15721,5240,10481,5240,0,1,5242,1976501,1.976501
5640,2550,6340,16167000,2,45126,11283,1,530452800,530452800,16921,5640,11281,5640,0,1,5642,4046027,4.046027
6040,2550,6340,16167000,2,48326,12083,1,558900800,558900800,18121,6040,12081,6040,0,1,6042,2692920,2.69292
6440,2550,6340,16167000,2,51526,12883,1,587348800,587348800,19321,6440,12881,6440,0,1,6442,1742485,1.742485
6840,2550,6340,16167000,2,54726,13683,1,615796800,615796800,20521,6840,13681,6840,0,1,6842,75858,0.075858
55,4805,3365,16168825,2,446,113,1,132945400,132945400,166,55,111,55,0,1,57,324392,0.324392
455,4805,3365,16168825,2,3646,913,1,159089400,159089400,1366,455,911,455,0,1,457,313708,0.313708
855,4805,3365,16168825,2,6846,1713,1,185233400,185233400,2566,855,1711,855,0,1,857,1840521,1.840521
1255,4805,3365,16168825,2,10046,2513,1,211377400,211377400,3766,1255,2511,1255,0,1,1257,355623,0.355623
1655,4805,3365,16168825,2,13246,3313,1,237521400,237521400,4966,1655,3311,1655,0,1,1657,361170,0.36117
2055,4805,3365,16168825,2,16446,4113,1,263665400,263665400,6166,2055,4111,2055,0,1,2057,1006237,1.006237
2455,4805,3365,16168825,2,19646,4913,1,289809400,289809400,7366,2455,4911,2455,0,1,2457,6244350,6.24435
2855,4805,3365,16168825,2,22846,5713,1,315953400,315953400,8566,2855,5711,2855,0,1,2857,369719,0.369719
3255,4805,3365,16168825,2,26046,6513,1,342097400,342097400,9766,3255,6511,3255,0,1,3257,1170247,1.170247
3655,4805,3365,16168825,2,29246,7313,1,368241400,368241400,10966,3655,7311,3655,0,1,3657,2914738,2.914738
4055,4805,3365,16168825,2,32446,8113,1,394385400,394385400,12166,4055,8111,4055,0,1,4057,4636873,4.636873
4455,4805,3365,16168825,2,35646,8913,1,420529400,420529400,13366,4455,8911,4455,0,1,4457,2117762,2.117762
4855,4805,3365,16168825,2,38846,9713,1,446673400,446673400,14566,4855,9711,4855,0,1,4857,2449064,2.449064
5255,4805,3365,16168825,2,42046,10513,1,472817400,472817400,15766,5255,10511,5255,0,1,5257,1615049,1.615049
5655,4805,3365,16168825,2,45246,11313,1,498961400,498961400,16966,5655,11311,5655,0,1,5657,49208,0.049208
6055,4805,3365,16168825,2,48446,12113,1,525105400,525105400,18166,6055,12111,6055,0,1,6057,7138155,7.138155
6455,4805,3365,16168825,2,51646,12913,1,551249400,551249400,19366,6455,12911,6455,0,1,6457,6182702,6.182702
6855,4805,3365,16168825,2,54846,13713,1,577393400,577393400,20566,6855,13711,6855,0,1,6857,20751568,20.751568
55,2805,5765,16170825,2,446,113,1,133137400,133137400,166,55,111,55,0,1,57,334719,0.334719
455,2805,5765,16170825,2,3646,913,1,160561400,160561400,1366,455,911,455,0,1,457,1492632,1.492632
855,2805,5765,16170825,2,6846,1713,1,187985400,187985400,2566,855,1711,855,0,1,857,2675804,2.675804
1255,2805,5765,16170825,2,10046,2513,1,215409400,215409400,3766,1255,2511,1255,0,1,1257,2053349,2.053349
1655,2805,5765,16170825,2,13246,3313,1,242833400,242833400,4966,1655,3311,1655,0,1,1657,4824849,4.824849
2055,2805,5765,16170825,2,16446,4113,1,270257400,270257400,6166,2055,4111,2055,0,1,2057,756796,0.756796
2455,2805,5765,16170825,2,19646,4913,1,297681400,297681400,7366,2455,4911,2455,0,1,2457,507951,0.507951
2855,2805,5765,16170825,2,22846,5713,1,325105400,325105400,8566,2855,5711,2855,0,1,2857,1907408,1.907408
3255,2805,5765,16170825,2,26046,6513,1,352529400,352529400,9766,3255,6511,3255,0,1,3257,1498964,1.498964
3655,2805,5765,16170825,2,29246,7313,1,379953400,379953400,10966,3655,7311,3655,0,1,3657,170827,0.170827
4055,2805,5765,16170825,2,32446,8113,1,407377400,407377400,12166,4055,8111,4055,0,1,4057,4812808,4.812808
4455,2805,5765,16170825,2,35646,8913,1,434801400,434801400,13366,4455,8911,4455,0,1,4457,140430,0.14043
4855,2805,5765,16170825,2,38846,9713,1,462225400,462225400,14566,4855,9711,4855,0,1,4857,463787,0.463787
5255,2805,5765,16170825,2,42046,10513,1,489649400,489649400,15766,5255,10511,5255,0,1,5257,1150760,1.15076
5655,2805,5765,16170825,2,45246,11313,1,517073400,517073400,16966,5655,11311,5655,0,1,5657,1174765,1.174765
6055,2805,5765,16170825,2,48446,12113,1,544497400,544497400,18166,6055,12111,6055,0,1,6057,1823540,1.82354
6455,2805,5765,16170825,2,51646,12913,1,571921400,571921400,19366,6455,12911,6455,0,1,6457,1671061,1.671061
6855,2805,5765,16170825,2,54846,13713,1,599345400,599345400,20566,6855,13711,6855,0,1,6857,7603138,7.603138
55,3805,4265,16228325,2,446,113,1,133377400,133377400,166,55,111,55,0,1,57,340181,0.340181
455,3805,4265,16228325,2,3646,913,1,159201400,159201400,1366,455,911,455,0,1,457,371374,0.371374
855,3805,4265,16228325,2,6846,1713,1,185025400,185025400,2566,855,1711,855,0,1,857,165386,0.165386
1255,3805,4265,16228325,2,10046,2513,1,210849400,210849400,3766,1255,2511,1255,0,1,1257,4075988,4.075988
1655,3805,4265,16228325,2,13246,3313,1,236673400,236673400,4966,1655,3311,1655,0,1,1657,5293198,5.293198
2055,3805,4265,16228325,2,16446,4113,1,262497400,262497400,6166,2055,4111,2055,0,1,2057,81454,0.081454
2455,3805,4265,16228325,2,19646,4913,1,288321400,288321400,7366,2455,4911,2455,0,1,2457,92088,0.092088
2855,3805,4265,16228325,2,22846,5713,1,314145400,314145400,8566,2855,5711,2855,0,1,2857,5746191,5.746191
3255,3805,4265,16228325,2,26046,6513,1,339969400,339969400,9766,3255,6511,3255,0,1,3257,426281,0.426281
3655,3805,4265,16228325,2,29246,7313,1,365793400,365793400,10966,3655,7311,3655,0,1,3657,4411013,4.411013
4055,3805,4265,16228325,2,32446,8113,1,391617400,391617400,12166,4055,8111,4055,0,1,4057,290344,0.290344
4455,3805,4265,16228325,2,35646,8913,1,417441400,417441400,13366,4455,8911,4455,0,1,4457,3337218,3.337218
4855,3805,4265,16228325,2,38846,9713,1,443265400,443265400,14566,4855,9711,4855,0,1,4857,1130144,1.130144
5255,3805,4265,16228325,2,42046,10513,1,469089400,469089400,15766,5255,10511,5255,0,1,5257,3485402,3.485402
5655,3805,4265,16228325,2,45246,11313,1,494913400,494913400,16966,5655,11311,5655,0,1,5657,2155224,2.155224
6055,3805,4265,16228325,2,48446,12113,1,520737400,520737400,18166,6055,12111,6055,0,1,6057,1638182,1.638182
6455,3805,4265,16228325,2,51646,12913,1,546561400,546561400,19366,6455,12911,6455,0,1,6457,924678,0.924678
6855,3805,4265,16228325,2,54846,13713,1,572385400,572385400,20566,6855,13711,6855,0,1,6857,325904,0.325904
55,3555,4565,16228575,2,446,113,1,133401400,133401400,166,55,111,55,0,1,57,333657,0.333657
455,3555,4565,16228575,2,3646,913,1,159385400,159385400,1366,455,911,455,0,1,457,1548440,1.54844
855,3555,4565,16228575,2,6846,1713,1,185369400,185369400,2566,855,1711,855,0,1,857,112003,0.112003
1255,3555,4565,16228575,2,10046,2513,1,211353400,211353400,3766,1255,2511,1255,0,1,1257,3302272,3.302272
1655,3555,4565,16228575,2,13246,3313,1,237337400,237337400,4966,1655,3311,1655,0,1,1657,16507,0.016507
2055,3555,4565,16228575,2,16446,4113,1,263321400,263321400,6166,2055,4111,2055,0,1,2057,2386685,2.386685
2455,3555,4565,16228575,2,19646,4913,1,289305400,289305400,7366,2455,4911,2455,0,1,2457,1124646,1.124646
2855,3555,4565,16228575,2,22846,5713,1,315289400,315289400,8566,2855,5711,2855,0,1,2857,814520,0.81452
3255,3555,4565,16228575,2,26046,6513,1,341273400,341273400,9766,3255,6511,3255,0,1,3257,36652,0.036652
3655,3555,4565,16228575,2,29246,7313,1,367257400,367257400,10966,3655,7311,3655,0,1,3657,738765,0.738765
4055,3555,4565,16228575,2,32446,8113,1,393241400,393241400,12166,4055,8111,4055,0,1,4057,2113557,2.113557
4455,3555,4565,16228575,2,35646,8913,1,419225400,419225400,13366,4455,8911,4455,0,1,4457,9345521,9.345521
4855,3555,4565,16228575,2,38846,9713,1,445209400,445209400,14566,4855,9711,4855,0,1,4857,409657,0.409657
5255,3555,4565,16228575,2,42046,10513,1,471193400,471193400,15766,5255,10511,5255,0,1,5257,77447,0.077447
5655,3555,4565,16228575,2,45246,11313,1,497177400,497177400,16966,5655,11311,5655,0,1,5657,708128,0.708128
6055,3555,4565,16228575,2,48446,12113,1,523161400,523161400,18166,6055,12111,6055,0,1,6057,6968378,6.968378
6455,3555,4565,16228575,2,51646,12913,1,549145400,549145400,19366,6455,12911,6455,0,1,6457,489980,0.48998
6855,3555,4565,16228575,2,54846,13713,1,575129400,575129400,20566,6855,13711,6855,0,1,6857,11190559,11.190559
55,5305,3065,16259825,2,446,113,1,133761400,133761400,166,55,111,55,0,1,57,325511,0.325511
455,5305,3065,16259825,2,3646,913,1,160545400,160545400,1366,455,911,455,0,1,457,1449066,1.449066
855,5305,3065,16259825,2,6846,1713,1,187329400,187329400,2566,855,1711,855,0,1,857,635271,0.635271
1255,5305,3065,16259825,2,10046,2513,1,214113400,214113400,3766,1255,2511,1255,0,1,1257,226237,0.226237
1655,5305,3065,16259825,2,13246,3313,1,240897400,240897400,4966,1655,3311,1655,0,1,1657,5096824,5.096824
2055,5305,3065,16259825,2,16446,4113,1,267681400,267681400,6166,2055,4111,2055,0,1,2057,4502664,4.502664
2455,5305,3065,16259825,2,19646,4913,1,294465400,294465400,7366,2455,4911,2455,0,1,2457,2057921,2.057921
2855,5305,3065,16259825,2,22846,5713,1,321249400,321249400,8566,2855,5711,2855,0,1,2857,1327666,1.327666
3255,5305,3065,16259825,2,26046,6513,1,348033400,348033400,9766,3255,6511,3255,0,1,3257,1722534,1.722534
3655,5305,3065,16259825,2,29246,7313,1,374817400,374817400,10966,3655,7311,3655,0,1,3657,1398664,1.398664
4055,5305,3065,16259825,2,32446,8113,1,401601400,401601400,12166,4055,8111,4055,0,1,4057,305673,0.305673
4455,5305,3065,16259825,2,35646,8913,1,428385400,428385400,13366,4455,8911,4455,0,1,4457,1830558,1.830558
4855,5305,3065,16259825,2,38846,9713,1,455169400,455169400,14566,4855,9711,4855,0,1,4857,3766175,3.766175
5255,5305,3065,16259825,2,42046,10513,1,481953400,481953400,15766,5255,10511,5255,0,1,5257,1063662,1.063662
5655,5305,3065,16259825,2,45246,11313,1,508737400,508737400,16966,5655,11311,5655,0,1,5657,2466687,2.466687
6055,5305,3065,16259825,2,48446,12113,1,535521400,535521400,18166,6055,12111,6055,0,1,6057,10565318,10.565318
6455,5305,3065,16259825,2,51646,12913,1,562305400,562305400,19366,6455,12911,6455,0,1,6457,2955119,2.955119
6855,5305,3065,16259825,2,54846,13713,1,589089400,589089400,20566,6855,13711,6855,0,1,6857,1188836,1.188836
55,2555,6365,16262575,2,446,113,1,134025400,134025400,166,55,111,55,0,1,57,337395,0.337395
455,2555,6365,16262575,2,3646,913,1,162569400,162569400,1366,455,911,455,0,1,457,113594,0.113594
855,2555,6365,16262575,2,6846,1713,1,191113400,191113400,2566,855,1711,855,0,1,857,396050,0.39605
1255,2555,6365,16262575,2,10046,2513,1,219657400,219657400,3766,1255,2511,1255,0,1,1257,581793,0.581793
1655,2555,6365,16262575,2,13246,3313,1,248201400,248201400,4966,1655,3311,1655,0,1,1657,631762,0.631762
2055,2555,6365,16262575,2,16446,4113,1,276745400,276745400,6166,2055,4111,2055,0,1,2057,3162831,3.162831
2455,2555,6365,16262575,2,19646,4913,1,305289400,305289400,7366,2455,4911,2455,0,1,2457,1097889,1.097889
2855,2555,6365,16262575,2,22846,5713,1,333833400,333833400,8566,2855,5711,2855,0,1,2857,83823,0.083823
3255,2555,6365,16262575,2,26046,6513,1,362377400,362377400,9766,3255,6511,3255,0,1,3257,2092949,2.092949
3655,2555,6365,16262575,2,29246,7313,1,390921400,390921400,10966,3655,7311,3655,0,1,3657,1237726,1.237726
4055,2555,6365,16262575,2,32446,8113,1,419465400,419465400,12166,4055,8111,4055,0,1,4057,450255,0.450255
4455,2555,6365,16262575,2,35646,8913,1,448009400,448009400,13366,4455,8911,4455,0,1,4457,361924,0.361924
4855,2555,6365,16262575,2,38846,9713,1,476553400,476553400,14566,4855,9711,4855,0,1,4857,941693,0.941693
5255,2555,6365,16262575,2,42046,10513,1,505097400,505097400,15766,5255,10511,5255,0,1,5257,5710447,5.710447
5655,2555,6365,16262575,2,45246,11313,1,533641400,533641400,16966,5655,11311,5655,0,1,5657,94428,0.094428
6055,2555,6365,16262575,2,48446,12113,1,562185400,562185400,18166,6055,12111,6055,0,1,6057,430133,0.430133
6455,2555,6365,16262575,2,51646,12913,1,590729400,590729400,19366,6455,12911,6455,0,1,6457,6519576,6.519576
6855,2555,6365,16262575,2,54846,13713,1,619273400,619273400,20566,6855,13711,6855,0,1,6857,58992,0.058992
40,4550,3640,16562000,2,326,83,1,135116800,135116800,121,40,81,40,0,1,42,299373,0.299373
440,4550,3640,16562000,2,3526,883,1,161324800,161324800,1321,440,881,440,0,1,442,1475248,1.475248
840,4550,3640,16562000,2,6726,1683,1,187532800,187532800,2521,840,1681,840,0,1,842,576448,0.576448
1240,4550,3640,16562000,2,9926,2483,1,213740800,213740800,3721,1240,2481,1240,0,1,1242,3872812,3.872812
1640,4550,3640,16562000,2,13126,3283,1,239948800,239948800,4921,1640,3281,1640,0,1,1642,799736,0.799736
2040,4550,3640,16562000,2,16326,4083,1,266156800,266156800,6121,2040,4081,2040,0,1,2042,4477301,4.477301
2440,4550,3640,16562000,2,19526,4883,1,292364800,292364800,7321,2440,4881,2440,0,1,2442,2900802,2.900802
2840,4550,3640,16562000,2,22726,5683,1,318572800,318572800,8521,2840,5681,2840,0,1,2842,1461264,1.461264
3240,4550,3640,16562000,2,25926,6483,1,344780800,344780800,9721,3240,6481,3240,0,1,3242,1423374,1.423374
3640,4550,3640,16562000,2,29126,7283,1,370988800,370988800,10921,3640,7281,3640,0,1,3642,2066082,2.066082
4040,4550,3640,16562000,2,32326,8083,1,397196800,397196800,12121,4040,8081,4040,0,1,4042,2994883,2.994883
4440,4550,3640,16562000,2,35526,8883,1,423404800,423404800,13321,4440,8881,4440,0,1,4442,6521323,6.521323
4840,4550,3640,16562000,2,38726,9683,1,449612800,449612800,14521,4840,9681,4840,0,1,4842,4075836,4.075836
5240,4550,3640,16562000,2,41926,10483,1,475820800,475820800,15721,5240,10481,5240,0,1,5242,283385,0.283385
5640,4550,3640,16562000,2,45126,11283,1,502028800,502028800,16921,5640,11281,5640,0,1,5642,65459,0.065459
6040,4550,3640,16562000,2,48326,12083,1,528236800,528236800,18121,6040,12081,6040,0,1,6042,1790618,1.790618
6440,4550,3640,16562000,2,51526,12883,1,554444800,554444800,19321,6440,12881,6440,0,1,6442,149672,0.149672
6840,4550,3640,16562000,2,54726,13683,1,580652800,580652800,20521,6840,13681,6840,0,1,6842,3529046,3.529046
40,6050,2740,16577000,2,326,83,1,135428800,135428800,121,40,81,40,0,1,42,291993,0.291993
440,6050,2740,16577000,2,3526,883,1,163556800,163556800,1321,440,881,440,0,1,442,1485779,1.485779
840,6050,2740,16577000,2,6726,1683,1,191684800,191684800,2521,840,1681,840,0,1,842,90249,0.090249
1240,6050,2740,16577000,2,9926,2483,1,219812800,219812800,3721,1240,2481,1240,0,1,1242,508969,0.508969
1640,6050,2740,16577000,2,13126,3283,1,247940800,247940800,4921,1640,3281,1640,0,1,1642,4685087,4.685087
2040,6050,2740,16577000,2,16326,4083,1,276068800,276068800,6121,2040,4081,2040,0,1,2042,1184845,1.184845
2440,6050,2740,16577000,2,19526,4883,1,304196800,304196800,7321,2440,4881,2440,0,1,2442,873592,0.873592
2840,6050,2740,16577000,2,22726,5683,1,332324800,332324800,8521,2840,5681,2840,0,1,2842,205305,0.205305
3240,6050,2740,16577000,2,25926,6483,1,360452800,360452800,9721,3240,6481,3240,0,1,3242,201287,0.201287
3640,6050,2740,16577000,2,29126,7283,1,388580800,388580800,10921,3640,7281,3640,0,1,3642,3924514,3.924514
4040,6050,2740,16577000,2,32326,8083,1,416708800,416708800,12121,4040,8081,4040,0,1,4042,140802,0.140802
4440,6050,2740,16577000,2,35526,8883,1,444836800,444836800,13321,4440,8881,4440,0,1,4442,6593617,6.593617
4840,6050,2740,16577000,2,38726,9683,1,472964800,472964800,14521,4840,9681,4840,0,1,4842,735075,0.735075
5240,6050,2740,16577000,2,41926,10483,1,501092800,501092800,15721,5240,10481,5240,0,1,5242,8562912,8.562912
5640,6050,2740,16577000,2,45126,11283,1,529220800,529220800,16921,5640,11281,5640,0,1,5642,312628,0.312628
6040,6050,2740,16577000,2,48326,12083,1,557348800,557348800,18121,6040,12081,6040,0,1,6042,3113477,3.113477
6440,6050,2740,16577000,2,51526,12883,1,585476800,585476800,19321,6440,12881,6440,0,1,6442,1818653,1.818653
6840,6050,2740,16577000,2,54726,13683,1,613604800,613604800,20521,6840,13681,6840,0,1,6842,7587088,7.587088
40,3050,5440,16592000,2,326,83,1,135452800,135452800,121,40,81,40,0,1,42,265,0.000265
440,3050,5440,16592000,2,3526,883,1,162620800,162620800,1321,440,881,440,0,1,442,63342,0.063342
840,3050,5440,16592000,2,6726,1683,1,189788800,189788800,2521,840,1681,840,0,1,842,41308,0.041308
1240,3050,5440,16592000,2,9926,2483,1,216956800,216956800,3721,1240,2481,1240,0,1,1242,89982,0.089982
1640,3050,5440,16592000,2,13126,3283,1,244124800,244124800,4921,1640,3281,1640,0,1,1642,440433,0.440433
2040,3050,5440,16592000,2,16326,4083,1,271292800,271292800,6121,2040,4081,2040,0,1,2042,20004,0.020004
2440,3050,5440,16592000,2,19526,4883,1,298460800,298460800,7321,2440,4881,2440,0,1,2442,248978,0.248978
2840,3050,5440,16592000,2,22726,5683,1,325628800,325628800,8521,2840,5681,2840,0,1,2842,361688,0.361688
3240,3050,5440,16592000,2,25926,6483,1,352796800,352796800,9721,3240,6481,3240,0,1,3242,1113735,1.113735
3640,3050,5440,16592000,2,29126,7283,1,379964800,379964800,10921,3640,7281,3640,0,1,3642,332637,0.332637
4040,3050,5440,16592000,2,32326,8083,1,407132800,407132800,12121,4040,8081,4040,0,1,4042,117491,0.117491
4440,3050,5440,16592000,2,35526,8883,1,434300800,434300800,13321,4440,8881,4440,0,1,4442,195990,0.19599
4840,3050,5440,16592000,2,38726,9683,1,461468800,461468800,14521,4840,9681,4840,0,1,4842,1405983,1.405983
5240,3050,5440,16592000,2,41926,10483,1,488636800,488636800,15721,5240,10481,5240,0,1,5242,741155,0.741155
5640,3050,5440,16592000,2,45126,11283,1,515804800,515804800,16921,5640,11281,5640,0,1,5642,1317555,1.317555
6040,3050,5440,16592000,2,48326,12083,1,542972800,542972800,18121,6040,12081,6040,0,1,6042,1297739,1.297739
6440,3050,5440,16592000,2,51526,12883,1,570140800,570140800,19321,6440,12881,6440,0,1,6442,3138526,3.138526
6840,3050,5440,16592000,2,54726,13683,1,597308800,597308800,20521,6840,13681,6840,0,1,6842,26004,0.026004
40,6800,2440,16592000,2,326,83,1,135692800,135692800,121,40,81,40,0,1,42,290706,0.290706
440,6800,2440,16592000,2,3526,883,1,165260800,165260800,1321,440,881,440,0,1,442,1537259,1.537259
840,6800,2440,16592000,2,6726,1683,1,194828800,194828800,2521,840,1681,840,0,1,842,289847,0.289847
1240,6800,2440,16592000,2,9926,2483,1,224396800,224396800,3721,1240,2481,1240,0,1,1242,2022810,2.02281
1640,6800,2440,16592000,2,13126,3283,1,253964800,253964800,4921,1640,3281,1640,0,1,1642,1016002,1.016002
2040,6800,2440,16592000,2,16326,4083,1,283532800,283532800,6121,2040,4081,2040,0,1,2042,477649,0.477649
2440,6800,2440,16592000,2,19526,4883,1,313100800,313100800,7321,2440,4881,2440,0,1,2442,7245038,7.245038
2840,6800,2440,16592000,2,22726,5683,1,342668800,342668800,8521,2840,5681,2840,0,1,2842,2224186,2.224186
3240,6800,2440,16592000,2,25926,6483,1,372236800,372236800,9721,3240,6481,3240,0,1,3242,2194840,2.19484
3640,6800,2440,16592000,2,29126,7283,1,401804800,401804800,10921,3640,7281,3640,0,1,3642,639392,0.639392
4040,6800,2440,16592000,2,32326,8083,1,431372800,431372800,12121,4040,8081,4040,0,1,4042,5386344,5.386344
4440,6800,2440,16592000,2,35526,8883,1,460940800,460940800,13321,4440,8881,4440,0,1,4442,3639416,3.639416
4840,6800,2440,16592000,2,38726,9683,1,490508800,490508800,14521,4840,9681,4840,0,1,4842,4168216,4.168216
5240,6800,2440,16592000,2,41926,10483,1,520076800,520076800,15721,5240,10481,5240,0,1,5242,3901236,3.901236
5640,6800,2440,16592000,2,45126,11283,1,549644800,549644800,16921,5640,11281,5640,0,1,5642,2027577,2.027577
6040,6800,2440,16592000,2,48326,12083,1,579212800,579212800,18121,6040,12081,6040,0,1,6042,2323216,2.323216
6440,6800,2440,16592000,2,51526,12883,1,608780800,608780800,19321,6440,12881,6440,0,1,6442,900036,0.900036
6840,6800,2440,16592000,2,54726,13683,1,638348800,638348800,20521,6840,13681,6840,0,1,6842,1427811,1.427811
55,4555,3665,16694075,2,446,113,1,137169400,137169400,166,55,111,55,0,1,57,264150,0.26415
455,4555,3665,16694075,2,3646,913,1,163473400,163473400,1366,455,911,455,0,1,457,1555392,1.555392
855,4555,3665,16694075,2,6846,1713,1,189777400,189777400,2566,855,1711,855,0,1,857,2089398,2.089398
1255,4555,3665,16694075,2,10046,2513,1,216081400,216081400,3766,1255,2511,1255,0,1,1257,4025875,4.025875
1655,4555,3665,16694075,2,13246,3313,1,242385400,242385400,4966,1655,3311,1655,0,1,1657,1641522,1.641522
2055,4555,3665,16694075,2,16446,4113,1,268689400,268689400,6166,2055,4111,2055,0,1,2057,4326050,4.32605
2455,4555,3665,16694075,2,19646,4913,1,294993400,294993400,7366,2455,4911,2455,0,1,2457,2012823,2.012823
2855,4555,3665,16694075,2,22846,5713,1,321297400,321297400,8566,2855,5711,2855,0,1,2857,6847736,6.847736
3255,4555,3665,16694075,2,26046,6513,1,347601400,347601400,9766,3255,6511,3255,0,1,3257,1504519,1.504519
3655,4555,3665,16694075,2,29246,7313,1,373905400,373905400,10966,3655,7311,3655,0,1,3657,8330494,8.330494
4055,4555,3665,16694075,2,32446,8113,1,400209400,400209400,12166,4055,8111,4055,0,1,4057,2443385,2.443385
4455,4555,3665,16694075,2,35646,8913,1,426513400,426513400,13366,4455,8911,4455,0,1,4457,5634339,5.634339
4855,4555,3665,16694075,2,38846,9713,1,452817400,452817400,14566,4855,9711,4855,0,1,4857,590896,0.590896
5255,4555,3665,16694075,2,42046,10513,1,479121400,479121400,15766,5255,10511,5255,0,1,5257,2430198,2.430198
5655,4555,3665,16694075,2,45246,11313,1,505425400,505425400,16966,5655,11311,5655,0,1,5657,250513,0.250513
6055,4555,3665,16694075,2,48446,12113,1,531729400,531729400,18166,6055,12111,6055,0,1,6057,266756,0.266756
6455,4555,3665,16694075,2,51646,12913,1,558033400,558033400,19366,6455,12911,6455,0,1,6457,785563,0.785563
6855,4555,3665,16694075,2,54846,13713,1,584337400,584337400,20566,6855,13711,6855,0,1,6857,1922899,1.922899
55,3055,5465,16695575,2,446,113,1,137313400,137313400,166,55,111,55,0,1,57,15187,0.015187
455,3055,5465,16695575,2,3646,913,1,164577400,164577400,1366,455,911,455,0,1,457,185000,0.185
855,3055,5465,16695575,2,6846,1713,1,191841400,191841400,2566,855,1711,855,0,1,857,153759,0.153759
1255,3055,5465,16695575,2,10046,2513,1,219105400,219105400,3766,1255,2511,1255,0,1,1257,124862,0.124862
1655,3055,5465,16695575,2,13246,3313,1,246369400,246369400,4966,1655,3311,1655,0,1,1657,383012,0.383012
2055,3055,5465,16695575,2,16446,4113,1,273633400,273633400,6166,2055,4111,2055,0,1,2057,101417,0.101417
2455,3055,5465,16695575,2,19646,4913,1,300897400,300897400,7366,2455,4911,2455,0,1,2457,119420,0.11942
2855,3055,5465,16695575,2,22846,5713,1,328161400,328161400,8566,2855,5711,2855,0,1,2857,1496324,1.496324
3255,3055,5465,16695575,2,26046,6513,1,355425400,355425400,9766,3255,6511,3255,0,1,3257,63414,0.063414
3655,3055,5465,16695575,2,29246,7313,1,382689400,382689400,10966,3655,7311,3655,0,1,3657,2682293,2.682293
4055,3055,5465,16695575,2,32446,8113,1,409953400,409953400,12166,4055,8111,4055,0,1,4057,170501,0.170501
4455,3055,5465,16695575,2,35646,8913,1,437217400,437217400,13366,4455,8911,4455,0,1,4457,306661,0.306661
4855,3055,5465,16695575,2,38846,9713,1,464481400,464481400,14566,4855,9711,4855,0,1,4857,843382,0.843382
5255,3055,5465,16695575,2,42046,10513,1,491745400,491745400,15766,5255,10511,5255,0,1,5257,2276295,2.276295
5655,3055,5465,16695575,2,45246,11313,1,519009400,519009400,16966,5655,11311,5655,0,1,5657,217201,0.217201
6055,3055,5465,16695575,2,48446,12113,1,546273400,546273400,18166,6055,12111,6055,0,1,6057,890428,0.890428
6455,3055,5465,16695575,2,51646,12913,1,573537400,573537400,19366,6455,12911,6455,0,1,6457,74520,0.07452
6855,3055,5465,16695575,2,54846,13713,1,600801400,600801400,20566,6855,13711,6855,0,1,6857,3450416,3.450416
55,6055,2765,16742075,2,446,113,1,137817400,137817400,166,55,111,55,0,1,57,331009,0.331009
455,6055,2765,16742075,2,3646,913,1,166041400,166041400,1366,455,911,455,0,1,457,1579887,1.579887
855,6055,2765,16742075,2,6846,1713,1,194265400,194265400,2566,855,1711,855,0,1,857,213636,0.213636
1255,6055,2765,16742075,2,10046,2513,1,222489400,222489400,3766,1255,2511,1255,0,1,1257,2111563,2.111563
1655,6055,2765,16742075,2,13246,3313,1,250713400,250713400,4966,1655,3311,1655,0,1,1657,605140,0.60514
2055,6055,2765,16742075,2,16446,4113,1,278937400,278937400,6166,2055,4111,2055,0,1,2057,36358,0.036358
2455,6055,2765,16742075,2,19646,4913,1,307161400,307161400,7366,2455,4911,2455,0,1,2457,3740719,3.740719
2855,6055,2765,16742075,2,22846,5713,1,335385400,335385400,8566,2855,5711,2855,0,1,2857,1518421,1.518421
3255,6055,2765,16742075,2,26046,6513,1,363609400,363609400,9766,3255,6511,3255,0,1,3257,122942,0.122942
3655,6055,2765,16742075,2,29246,7313,1,391833400,391833400,10966,3655,7311,3655,0,1,3657,6606412,6.606412
4055,6055,2765,16742075,2,32446,8113,1,420057400,420057400,12166,4055,8111,4055,0,1,4057,460508,0.460508
4455,6055,2765,16742075,2,35646,8913,1,448281400,448281400,13366,4455,8911,4455,0,1,4457,2955984,2.955984
4855,6055,2765,16742075,2,38846,9713,1,476505400,476505400,14566,4855,9711,4855,0,1,4857,6582639,6.582639
5255,6055,2765,16742075,2,42046,10513,1,504729400,504729400,15766,5255,10511,5255,0,1,5257,2602611,2.602611
5655,6055,2765,16742075,2,45246,11313,1,532953400,532953400,16966,5655,11311,5655,0,1,5657,4924736,4.924736
6055,6055,2765,16742075,2,48446,12113,1,561177400,561177400,18166,6055,12111,6055,0,1,6057,6596046,6.596046
6455,6055,2765,16742075,2,51646,12913,1,589401400,589401400,19366,6455,12911,6455,0,1,6457,819178,0.819178
6855,6055,2765,16742075,2,54846,13713,1,617625400,617625400,20566,6855,13711,6855,0,1,6857,2940590,2.94059
35,5500,3045,16747500,2,286,73,1,136372600,136372600,106,35,71,35,0,1,37,119297,0.119297
535,5500,3045,16747500,2,4286,1073,1,170552600,170552600,1606,535,1071,535,0,1,537,461771,0.461771
1035,5500,3045,16747500,2,8286,2073,1,204732600,204732600,3106,1035,2071,1035,0,1,1037,308147,0.308147
1535,5500,3045,16747500,2,12286,3073,1,238912600,238912600,4606,1535,3071,1535,0,1,1537,1272520,1.27252
2035,5500,3045,16747500,2,16286,4073,1,273092600,273092600,6106,2035,4071,2035,0,1,2037,215131,0.215131
2535,5500,3045,16747500,2,20286,5073,1,307272600,307272600,7606,2535,5071,2535,0,1,2537,2627853,2.627853
3035,5500,3045,16747500,2,24286,6073,1,341452600,341452600,9106,3035,6071,3035,0,1,3037,8230227,8.230227
3535,5500,3045,16747500,2,28286,7073,1,375632600,375632600,10606,3535,7071,3535,0,1,3537,509031,0.509031
4035,5500,3045,16747500,2,32286,8073,1,409812600,409812600,12106,4035,8071,4035,0,1,4037,227571,0.227571
4535,5500,3045,16747500,2,36286,9073,1,443992600,443992600,13606,4535,9071,4535,0,1,4537,3849036,3.849036
5035,5500,3045,16747500,2,40286,10073,1,478172600,478172600,15106,5035,10071,5035,0,1,5037,3074545,3.074545
5535,5500,3045,16747500,2,44286,11073,1,512352600,512352600,16606,5535,11071,5535,0,1,5537,7063810,7.06381
6035,5500,3045,16747500,2,48286,12073,1,546532600,546532600,18106,6035,12071,6035,0,1,6037,1129904,1.129904
6535,5500,3045,16747500,2,52286,13073,1,580712600,580712600,19606,6535,13071,6535,0,1,6537,1477706,1.477706
7035,5500,3045,16747500,2,56286,14073,1,614892600,614892600,21106,7035,14071,7035,0,1,7037,16578843,16.578843
55,6805,2465,16774325,2,446,113,1,138273400,138273400,166,55,111,55,0,1,57,336114,0.336114
455,6805,2465,16774325,2,3646,913,1,167937400,167937400,1366,455,911,455,0,1,457,1614365,1.614365
855,6805,2465,16774325,2,6846,1713,1,197601400,197601400,2566,855,1711,855,0,1,857,2587773,2.587773
1255,6805,2465,16774325,2,10046,2513,1,227265400,227265400,3766,1255,2511,1255,0,1,1257,901015,0.901015
1655,6805,2465,16774325,2,13246,3313,1,256929400,256929400,4966,1655,3311,1655,0,1,1657,195408,0.195408
2055,6805,2465,16774325,2,16446,4113,1,286593400,286593400,6166,2055,4111,2055,0,1,2057,60215,0.060215
2455,6805,2465,16774325,2,19646,4913,1,316257400,316257400,7366,2455,4911,2455,0,1,2457,34617,0.034617
2855,6805,2465,16774325,2,22846,5713,1,345921400,345921400,8566,2855,5711,2855,0,1,2857,3438332,3.438332
3255,6805,2465,16774325,2,26046,6513,1,375585400,375585400,9766,3255,6511,3255,0,1,3257,3783604,3.783604
3655,6805,2465,16774325,2,29246,7313,1,405249400,405249400,10966,3655,7311,3655,0,1,3657,2324842,2.324842
4055,6805,2465,16774325,2,32446,8113,1,434913400,434913400,12166,4055,8111,4055,0,1,4057,4704610,4.70461
4455,6805,2465,16774325,2,35646,8913,1,464577400,464577400,13366,4455,8911,4455,0,1,4457,1164218,1.164218
4855,6805,2465,16774325,2,38846,9713,1,494241400,494241400,14566,4855,9711,4855,0,1,4857,12020295,12.020295
5255,6805,2465,16774325,2,42046,10513,1,523905400,523905400,15766,5255,10511,5255,0,1,5257,3398569,3.398569
5655,6805,2465,16774325,2,45246,11313,1,553569400,553569400,16966,5655,11311,5655,0,1,5657,8474576,8.474576
6055,6805,2465,16774325,2,48446,12113,1,583233400,583233400,18166,6055,12111,6055,0,1,6057,78934,0.078934
6455,6805,2465,16774325,2,51646,12913,1,612897400,612897400,19366,6455,12911,6455,0,1,6457,3577928,3.577928
6855,6805,2465,16774325,2,54846,13713,1,642561400,642561400,20566,6855,13711,6855,0,1,6857,478820,0.47882
35,6600,2545,16797000,2,286,73,1,136936600,136936600,106,35,71,35,0,1,37,59247,0.059247
535,6600,2545,16797000,2,4286,1073,1,173516600,173516600,1606,535,1071,535,0,1,537,244590,0.24459
1035,6600,2545,16797000,2,8286,2073,1,210096600,210096600,3106,1035,2071,1035,0,1,1037,1073396,1.073396
1535,6600,2545,16797000,2,12286,3073,1,246676600,246676600,4606,1535,3071,1535,0,1,1537,354708,0.354708
2035,6600,2545,16797000,2,16286,4073,1,283256600,283256600,6106,2035,4071,2035,0,1,2037,1937839,1.937839
2535,6600,2545,16797000,2,20286,5073,1,319836600,319836600,7606,2535,5071,2535,0,1,2537,5189997,5.189997
3035,6600,2545,16797000,2,24286,6073,1,356416600,356416600,9106,3035,6071,3035,0,1,3037,4641153,4.641153
3535,6600,2545,16797000,2,28286,7073,1,392996600,392996600,10606,3535,7071,3535,0,1,3537,2060449,2.060449
4035,6600,2545,16797000,2,32286,8073,1,429576600,429576600,12106,4035,8071,4035,0,1,4037,1256158,1.256158
4535,6600,2545,16797000,2,36286,9073,1,466156600,466156600,13606,4535,9071,4535,0,1,4537,37666,0.037666
5035,6600,2545,16797000,2,40286,10073,1,502736600,502736600,15106,5035,10071,5035,0,1,5037,2109161,2.109161
5535,6600,2545,16797000,2,44286,11073,1,539316600,539316600,16606,5535,11071,5535,0,1,5537,855259,0.855259
6035,6600,2545,16797000,2,48286,12073,1,575896600,575896600,18106,6035,12071,6035,0,1,6037,9114604,9.114604
6535,6600,2545,16797000,2,52286,13073,1,612476600,612476600,19606,6535,13071,6535,0,1,6537,4246696,4.246696
7035,6600,2545,16797000,2,56286,14073,1,649056600,649056600,21106,7035,14071,7035,0,1,7037,22233360,22.23336
35,3340,5045,16850300,2,286,73,1,137150200,137150200,106,35,71,35,0,1,37,296363,0.296363
535,3340,5045,16850300,2,4286,1073,1,170690200,170690200,1606,535,1071,535,0,1,537,1807383,1.807383
1035,3340,5045,16850300,2,8286,2073,1,204230200,204230200,3106,1035,2071,1035,0,1,1037,3376015,3.376015
1535,3340,5045,16850300,2,12286,3073,1,237770200,237770200,4606,1535,3071,1535,0,1,1537,4951357,4.951357
2035,3340,5045,16850300,2,16286,4073,1,271310200,271310200,6106,2035,4071,2035,0,1,2037,6529216,6.529216
39,3343,5041,16852063,2,318,81,1,137432312,137432312,118,39,79,39,0,1,41,21741,0.021741
539,3343,5041,16852063,2,4318,1081,1,170968312,170968312,1618,539,1079,539,0,1,541,234332,0.234332
1039,3343,5041,16852063,2,8318,2081,1,204504312,204504312,3118,1039,2079,1039,0,1,1041,412641,0.412641
1539,3343,5041,16852063,2,12318,3081,1,238040312,238040312,4618,1539,3079,1539,0,1,1541,238282,0.238282
2039,3343,5041,16852063,2,16318,4081,1,271576312,271576312,6118,2039,4079,2039,0,1,2041,276975,0.276975
2539,3343,5041,16852063,2,20318,5081,1,305112312,305112312,7618,2539,5079,2539,0,1,2541,1189041,1.189041
3039,3343,5041,16852063,2,24318,6081,1,338648312,338648312,9118,3039,6079,3039,0,1,3041,121300,0.1213
3539,3343,5041,16852063,2,28318,7081,1,372184312,372184312,10618,3539,7079,3539,0,1,3541,114763,0.114763
4039,3343,5041,16852063,2,32318,8081,1,405720312,405720312,12118,4039,8079,4039,0,1,4041,4191659,4.191659
4539,3343,5041,16852063,2,36318,9081,1,439256312,439256312,13618,4539,9079,4539,0,1,4541,2654453,2.654453
5039,3343,5041,16852063,2,40318,10081,1,472792312,472792312,15118,5039,10079,5039,0,1,5041,590755,0.590755
5539,3343,5041,16852063,2,44318,11081,1,506328312,506328312,16618,5539,11079,5539,0,1,5541,1309247,1.309247
6039,3343,5041,16852063,2,48318,12081,1,539864312,539864312,18118,6039,12079,6039,0,1,6041,1640435,1.640435
6539,3343,5041,16852063,2,52318,13081,1,573400312,573400312,19618,6539,13079,6539,0,1,6541,1584756,1.584756
7039,3343,5041,16852063,2,56318,14081,1,606936312,606936312,21118,7039,14079,7039,0,1,7041,895851,0.895851
39,5543,3041,16856263,2,318,81,1,137528312,137528312,118,39,79,39,0,1,41,53675,0.053675
539,5543,3041,16856263,2,4318,1081,1,171864312,171864312,1618,539,1079,539,0,1,541,71600,0.0716
1039,5543,3041,16856263,2,8318,2081,1,206200312,206200312,3118,1039,2079,1039,0,1,1041,163468,0.163468
1539,5543,3041,16856263,2,12318,3081,1,240536312,240536312,4618,1539,3079,1539,0,1,1541,269242,0.269242
2039,5543,3041,16856263,2,16318,4081,1,274872312,274872312,6118,2039,4079,2039,0,1,2041,919686,0.919686
2539,5543,3041,16856263,2,20318,5081,1,309208312,309208312,7618,2539,5079,2539,0,1,2541,865960,0.86596
3039,5543,3041,16856263,2,24318,6081,1,343544312,343544312,9118,3039,6079,3039,0,1,3041,1053673,1.053673
3539,5543,3041,16856263,2,28318,7081,1,377880312,377880312,10618,3539,7079,3539,0,1,3541,179729,0.179729
4039,5543,3041,16856263,2,32318,8081,1,412216312,412216312,12118,4039,8079,4039,0,1,4041,1843684,1.843684
4539,5543,3041,16856263,2,36318,9081,1,446552312,446552312,13618,4539,9079,4539,0,1,4541,6820849,6.820849
5039,5543,3041,16856263,2,40318,10081,1,480888312,480888312,15118,5039,10079,5039,0,1,5041,4151766,4.151766
5539,5543,3041,16856263,2,44318,11081,1,515224312,515224312,16618,5539,11079,5539,0,1,5541,2523617,2.523617
6039,5543,3041,16856263,2,48318,12081,1,549560312,549560312,18118,6039,12079,6039,0,1,6041,817876,0.817876
6539,5543,3041,16856263,2,52318,13081,1,583896312,583896312,19618,6539,13079,6539,0,1,6541,1975563,1.975563
7039,5543,3041,16856263,2,56318,14081,1,618232312,618232312,21118,7039,14079,7039,0,1,7041,1215128,1.215128
40,5050,3340,16867000,2,326,83,1,137620800,137620800,121,40,81,40,0,1,42,336,0.000336
440,5050,3340,16867000,2,3526,883,1,164468800,164468800,1321,440,881,440,0,1,442,56043,0.056043
840,5050,3340,16867000,2,6726,1683,1,191316800,191316800,2521,840,1681,840,0,1,842,247824,0.247824
1240,5050,3340,16867000,2,9926,2483,1,218164800,218164800,3721,1240,2481,1240,0,1,1242,141840,0.14184
1640,5050,3340,16867000,2,13126,3283,1,245012800,245012800,4921,1640,3281,1640,0,1,1642,154713,0.154713
2040,5050,3340,16867000,2,16326,4083,1,271860800,271860800,6121,2040,4081,2040,0,1,2042,323689,0.323689
2440,5050,3340,16867000,2,19526,4883,1,298708800,298708800,7321,2440,4881,2440,0,1,2442,305205,0.305205
2840,5050,3340,16867000,2,22726,5683,1,325556800,325556800,8521,2840,5681,2840,0,1,2842,796420,0.79642
3240,5050,3340,16867000,2,25926,6483,1,352404800,352404800,9721,3240,6481,3240,0,1,3242,55666,0.055666
3640,5050,3340,16867000,2,29126,7283,1,379252800,379252800,10921,3640,7281,3640,0,1,3642,520144,0.520144
4040,5050,3340,16867000,2,32326,8083,1,406100800,406100800,12121,4040,8081,4040,0,1,4042,258787,0.258787
4440,5050,3340,16867000,2,35526,8883,1,432948800,432948800,13321,4440,8881,4440,0,1,4442,523885,0.523885
4840,5050,3340,16867000,2,38726,9683,1,459796800,459796800,14521,4840,9681,4840,0,1,4842,2275303,2.275303
5240,5050,3340,16867000,2,41926,10483,1,486644800,486644800,15721,5240,10481,5240,0,1,5242,1803910,1.80391
5640,5050,3340,16867000,2,45126,11283,1,513492800,513492800,16921,5640,11281,5640,0,1,5642,2141971,2.141971
6040,5050,3340,16867000,2,48326,12083,1,540340800,540340800,18121,6040,12081,6040,0,1,6042,1545009,1.545009
6440,5050,3340,16867000,2,51526,12883,1,567188800,567188800,19321,6440,12881,6440,0,1,6442,209916,0.209916
6840,5050,3340,16867000,2,54726,13683,1,594036800,594036800,20521,6840,13681,6840,0,1,6842,756168,0.756168
35,5540,3045,16869300,2,286,73,1,137358200,137358200,106,35,71,35,0,1,37,230003,0.230003
535,5540,3045,16869300,2,4286,1073,1,171698200,171698200,1606,535,1071,535,0,1,537,620508,0.620508
1035,5540,3045,16869300,2,8286,2073,1,206038200,206038200,3106,1035,2071,1035,0,1,1037,470074,0.470074
1535,5540,3045,16869300,2,12286,3073,1,240378200,240378200,4606,1535,3071,1535,0,1,1537,1030901,1.030901
40,5550,3040,16872000,2,326,83,1,137724800,137724800,121,40,81,40,0,1,42,301079,0.301079
440,5550,3040,16872000,2,3526,883,1,165212800,165212800,1321,440,881,440,0,1,442,1526993,1.526993
840,5550,3040,16872000,2,6726,1683,1,192700800,192700800,2521,840,1681,840,0,1,842,2776467,2.776467
1240,5550,3040,16872000,2,9926,2483,1,220188800,220188800,3721,1240,2481,1240,0,1,1242,3973352,3.973352
1640,5550,3040,16872000,2,13126,3283,1,247676800,247676800,4921,1640,3281,1640,0,1,1642,568064,0.568064
2040,5550,3040,16872000,2,16326,4083,1,275164800,275164800,6121,2040,4081,2040,0,1,2042,6517726,6.517726
2440,5550,3040,16872000,2,19526,4883,1,302652800,302652800,7321,2440,4881,2440,0,1,2442,3175984,3.175984
2840,5550,3040,16872000,2,22726,5683,1,330140800,330140800,8521,2840,5681,2840,0,1,2842,9040264,9.040264
3240,5550,3040,16872000,2,25926,6483,1,357628800,357628800,9721,3240,6481,3240,0,1,3242,1866543,1.866543
3640,5550,3040,16872000,2,29126,7283,1,385116800,385116800,10921,3640,7281,3640,0,1,3642,1440770,1.44077
4040,5550,3040,16872000,2,32326,8083,1,412604800,412604800,12121,4040,8081,4040,0,1,4042,4831955,4.831955
4440,5550,3040,16872000,2,35526,8883,1,440092800,440092800,13321,4440,8881,4440,0,1,4442,1417537,1.417537
4840,5550,3040,16872000,2,38726,9683,1,467580800,467580800,14521,4840,9681,4840,0,1,4842,563920,0.56392
5240,5550,3040,16872000,2,41926,10483,1,495068800,495068800,15721,5240,10481,5240,0,1,5242,3411019,3.411019
5640,5550,3040,16872000,2,45126,11283,1,522556800,522556800,16921,5640,11281,5640,0,1,5642,366639,0.366639
6040,5550,3040,16872000,2,48326,12083,1,550044800,550044800,18121,6040,12081,6040,0,1,6042,4297388,4.297388
6440,5550,3040,16872000,2,51526,12883,1,577532800,577532800,19321,6440,12881,6440,0,1,6442,3483457,3.483457
6840,5550,3040,16872000,2,54726,13683,1,605020800,605020800,20521,6840,13681,6840,0,1,6842,3636740,3.63674
39,2793,6041,16872513,2,318,81,1,137736312,137736312,118,39,79,39,0,1,41,84583,0.084583
539,2793,6041,16872513,2,4318,1081,1,173072312,173072312,1618,539,1079,539,0,1,541,1848019,1.848019
1039,2793,6041,16872513,2,8318,2081,1,208408312,208408312,3118,1039,2079,1039,0,1,1041,1269067,1.269067
1539,2793,6041,16872513,2,12318,3081,1,243744312,243744312,4618,1539,3079,1539,0,1,1541,1206454,1.206454
2039,2793,6041,16872513,2,16318,4081,1,279080312,279080312,6118,2039,4079,2039,0,1,2041,722006,0.722006
2539,2793,6041,16872513,2,20318,5081,1,314416312,314416312,7618,2539,5079,2539,0,1,2541,2244372,2.244372
3039,2793,6041,16872513,2,24318,6081,1,349752312,349752312,9118,3039,6079,3039,0,1,3041,525724,0.525724
3539,2793,6041,16872513,2,28318,7081,1,385088312,385088312,10618,3539,7079,3539,0,1,3541,4003486,4.003486
4039,2793,6041,16872513,2,32318,8081,1,420424312,420424312,12118,4039,8079,4039,0,1,4041,1068536,1.068536
4539,2793,6041,16872513,2,36318,9081,1,455760312,455760312,13618,4539,9079,4539,0,1,4541,3882365,3.882365
5039,2793,6041,16872513,2,40318,10081,1,491096312,491096312,15118,5039,10079,5039,0,1,5041,2096913,2.096913
5539,2793,6041,16872513,2,44318,11081,1,526432312,526432312,16618,5539,11079,5539,0,1,5541,76349,0.076349
6039,2793,6041,16872513,2,48318,12081,1,561768312,561768312,18118,6039,12079,6039,0,1,6041,3605093,3.605093
6539,2793,6041,16872513,2,52318,13081,1,597104312,597104312,19618,6539,13079,6539,0,1,6541,1599384,1.599384
7039,2793,6041,16872513,2,56318,14081,1,632440312,632440312,21118,7039,14079,7039,0,1,7041,2282399,2.282399
39,6643,2541,16879863,2,318,81,1,137904312,137904312,118,39,79,39,0,1,41,866,0.000866
539,6643,2541,16879863,2,4318,1081,1,174640312,174640312,1618,539,1079,539,0,1,541,106594,0.106594
1039,6643,2541,16879863,2,8318,2081,1,211376312,211376312,3118,1039,2079,1039,0,1,1041,420070,0.42007
1539,6643,2541,16879863,2,12318,3081,1,248112312,248112312,4618,1539,3079,1539,0,1,1541,294392,0.294392
2039,6643,2541,16879863,2,16318,4081,1,284848312,284848312,6118,2039,4079,2039,0,1,2041,414483,0.414483
2539,6643,2541,16879863,2,20318,5081,1,321584312,321584312,7618,2539,5079,2539,0,1,2541,261356,0.261356
3039,6643,2541,16879863,2,24318,6081,1,358320312,358320312,9118,3039,6079,3039,0,1,3041,1816127,1.816127
3539,6643,2541,16879863,2,28318,7081,1,395056312,395056312,10618,3539,7079,3539,0,1,3541,3557625,3.557625
4039,6643,2541,16879863,2,32318,8081,1,431792312,431792312,12118,4039,8079,4039,0,1,4041,354380,0.35438
4539,6643,2541,16879863,2,36318,9081,1,468528312,468528312,13618,4539,9079,4539,0,1,4541,3534983,3.534983
5039,6643,2541,16879863,2,40318,10081,1,505264312,505264312,15118,5039,10079,5039,0,1,5041,4294271,4.294271
5539,6643,2541,16879863,2,44318,11081,1,542000312,542000312,16618,5539,11079,5539,0,1,5541,1181672,1.181672
6039,6643,2541,16879863,2,48318,12081,1,578736312,578736312,18118,6039,12079,6039,0,1,6041,1288275,1.288275
6539,6643,2541,16879863,2,52318,13081,1,615472312,615472312,19618,6539,13079,6539,0,1,6541,9502518,9.502518
7039,6643,2541,16879863,2,56318,14081,1,652208312,652208312,21118,7039,14079,7039,0,1,7041,5997463,5.997463
40,2800,6040,16912000,2,326,83,1,138124800,138124800,121,40,81,40,0,1,42,298885,0.298885
440,2800,6040,16912000,2,3526,883,1,166412800,166412800,1321,440,881,440,0,1,442,1503863,1.503863
840,2800,6040,16912000,2,6726,1683,1,194700800,194700800,2521,840,1681,840,0,1,842,2745445,2.745445
1240,2800,6040,16912000,2,9926,2483,1,222988800,222988800,3721,1240,2481,1240,0,1,1242,948754,0.948754
1640,2800,6040,16912000,2,13126,3283,1,251276800,251276800,4921,1640,3281,1640,0,1,1642,2796066,2.796066
2040,2800,6040,16912000,2,16326,4083,1,279564800,279564800,6121,2040,4081,2040,0,1,2042,554353,0.554353
2440,2800,6040,16912000,2,19526,4883,1,307852800,307852800,7321,2440,4881,2440,0,1,2442,552351,0.552351
2840,2800,6040,16912000,2,22726,5683,1,336140800,336140800,8521,2840,5681,2840,0,1,2842,143756,0.143756
3240,2800,6040,16912000,2,25926,6483,1,364428800,364428800,9721,3240,6481,3240,0,1,3242,600433,0.600433
3640,2800,6040,16912000,2,29126,7283,1,392716800,392716800,10921,3640,7281,3640,0,1,3642,11197717,11.197717
4040,2800,6040,16912000,2,32326,8083,1,421004800,421004800,12121,4040,8081,4040,0,1,4042,3660229,3.660229
4440,2800,6040,16912000,2,35526,8883,1,449292800,449292800,13321,4440,8881,4440,0,1,4442,531985,0.531985
4840,2800,6040,16912000,2,38726,9683,1,477580800,477580800,14521,4840,9681,4840,0,1,4842,286714,0.286714
5240,2800,6040,16912000,2,41926,10483,1,505868800,505868800,15721,5240,10481,5240,0,1,5242,555382,0.555382
5640,2800,6040,16912000,2,45126,11283,1,534156800,534156800,16921,5640,11281,5640,0,1,5642,2253934,2.253934
6040,2800,6040,16912000,2,48326,12083,1,562444800,562444800,18121,6040,12081,6040,0,1,6042,3602333,3.602333
6440,2800,6040,16912000,2,51526,12883,1,590732800,590732800,19321,6440,12881,6440,0,1,6442,1189011,1.189011
6840,2800,6040,16912000,2,54726,13683,1,619020800,619020800,20521,6840,13681,6840,0,1,6842,2360136,2.360136
40,2550,6640,16932000,2,326,83,1,138396800,138396800,121,40,81,40,0,1,42,305810,0.30581
440,2550,6640,16932000,2,3526,883,1,167804800,167804800,1321,440,881,440,0,1,442,1484631,1.484631
840,2550,6640,16932000,2,6726,1683,1,197212800,197212800,2521,840,1681,840,0,1,842,706291,0.706291
1240,2550,6640,16932000,2,9926,2483,1,226620800,226620800,3721,1240,2481,1240,0,1,1242,859976,0.859976
1640,2550,6640,16932000,2,13126,3283,1,256028800,256028800,4921,1640,3281,1640,0,1,1642,3094459,3.094459
2040,2550,6640,16932000,2,16326,4083,1,285436800,285436800,6121,2040,4081,2040,0,1,2042,585947,0.585947
2440,2550,6640,16932000,2,19526,4883,1,314844800,314844800,7321,2440,4881,2440,0,1,2442,598386,0.598386
2840,2550,6640,16932000,2,22726,5683,1,344252800,344252800,8521,2840,5681,2840,0,1,2842,3675969,3.675969
3240,2550,6640,16932000,2,25926,6483,1,373660800,373660800,9721,3240,6481,3240,0,1,3242,975580,0.97558
3640,2550,6640,16932000,2,29126,7283,1,403068800,403068800,10921,3640,7281,3640,0,1,3642,1870360,1.87036
4040,2550,6640,16932000,2,32326,8083,1,432476800,432476800,12121,4040,8081,4040,0,1,4042,2816665,2.816665
4440,2550,6640,16932000,2,35526,8883,1,461884800,461884800,13321,4440,8881,4440,0,1,4442,89894,0.089894
4840,2550,6640,16932000,2,38726,9683,1,491292800,491292800,14521,4840,9681,4840,0,1,4842,4230783,4.230783
5240,2550,6640,16932000,2,41926,10483,1,520700800,520700800,15721,5240,10481,5240,0,1,5242,379470,0.37947
5640,2550,6640,16932000,2,45126,11283,1,550108800,550108800,16921,5640,11281,5640,0,1,5642,2106874,2.106874
6040,2550,6640,16932000,2,48326,12083,1,579516800,579516800,18121,6040,12081,6040,0,1,6042,1756326,1.756326
6440,2550,6640,16932000,2,51526,12883,1,608924800,608924800,19321,6440,12881,6440,0,1,6442,1118378,1.118378
6840,2550,6640,16932000,2,54726,13683,1,638332800,638332800,20521,6840,13681,6840,0,1,6842,2184066,2.184066
40,4300,3940,16942000,2,326,83,1,138172800,138172800,121,40,81,40,0,1,42,304933,0.304933
440,4300,3940,16942000,2,3526,883,1,164540800,164540800,1321,440,881,440,0,1,442,1512333,1.512333
840,4300,3940,16942000,2,6726,1683,1,190908800,190908800,2521,840,1681,840,0,1,842,943998,0.943998
1240,4300,3940,16942000,2,9926,2483,1,217276800,217276800,3721,1240,2481,1240,0,1,1242,790695,0.790695
1640,4300,3940,16942000,2,13126,3283,1,243644800,243644800,4921,1640,3281,1640,0,1,1642,325085,0.325085
2040,4300,3940,16942000,2,16326,4083,1,270012800,270012800,6121,2040,4081,2040,0,1,2042,405980,0.40598
2440,4300,3940,16942000,2,19526,4883,1,296380800,296380800,7321,2440,4881,2440,0,1,2442,1547433,1.547433
2840,4300,3940,16942000,2,22726,5683,1,322748800,322748800,8521,2840,5681,2840,0,1,2842,4473114,4.473114
3240,4300,3940,16942000,2,25926,6483,1,349116800,349116800,9721,3240,6481,3240,0,1,3242,2770536,2.770536
3640,4300,3940,16942000,2,29126,7283,1,375484800,375484800,10921,3640,7281,3640,0,1,3642,1311388,1.311388
4040,4300,3940,16942000,2,32326,8083,1,401852800,401852800,12121,4040,8081,4040,0,1,4042,183005,0.183005
4440,4300,3940,16942000,2,35526,8883,1,428220800,428220800,13321,4440,8881,4440,0,1,4442,3005454,3.005454
4840,4300,3940,16942000,2,38726,9683,1,454588800,454588800,14521,4840,9681,4840,0,1,4842,2700723,2.700723
5240,4300,3940,16942000,2,41926,10483,1,480956800,480956800,15721,5240,10481,5240,0,1,5242,2127896,2.127896
5640,4300,3940,16942000,2,45126,11283,1,507324800,507324800,16921,5640,11281,5640,0,1,5642,26974,0.026974
6040,4300,3940,16942000,2,48326,12083,1,533692800,533692800,18121,6040,12081,6040,0,1,6042,421458,0.421458
6440,4300,3940,16942000,2,51526,12883,1,560060800,560060800,19321,6440,12881,6440,0,1,6442,1211984,1.211984
6840,4300,3940,16942000,2,54726,13683,1,586428800,586428800,20521,6840,13681,6840,0,1,6842,2692393,2.692393
44,3353,5055,16949415,2,358,91,1,138554936,138554936,133,44,89,44,0,1,46,19282,0.019282
544,3353,5055,16949415,2,4358,1091,1,172186936,172186936,1633,544,1089,544,0,1,546,126151,0.126151
1044,3353,5055,16949415,2,8358,2091,1,205818936,205818936,3133,1044,2089,1044,0,1,1046,298981,0.298981
1544,3353,5055,16949415,2,12358,3091,1,239450936,239450936,4633,1544,3089,1544,0,1,1546,698732,0.698732
2044,3353,5055,16949415,2,16358,4091,1,273082936,273082936,6133,2044,4089,2044,0,1,2046,1309893,1.309893
2544,3353,5055,16949415,2,20358,5091,1,306714936,306714936,7633,2544,5089,2544,0,1,2546,805663,0.805663
3044,3353,5055,16949415,2,24358,6091,1,340346936,340346936,9133,3044,6089,3044,0,1,3046,118122,0.118122
3544,3353,5055,16949415,2,28358,7091,1,373978936,373978936,10633,3544,7089,3544,0,1,3546,226694,0.226694
4044,3353,5055,16949415,2,32358,8091,1,407610936,407610936,12133,4044,8089,4044,0,1,4046,1290673,1.290673
4544,3353,5055,16949415,2,36358,9091,1,441242936,441242936,13633,4544,9089,4544,0,1,4546,1145108,1.145108
5044,3353,5055,16949415,2,40358,10091,1,474874936,474874936,15133,5044,10089,5044,0,1,5046,785724,0.785724
5544,3353,5055,16949415,2,44358,11091,1,508506936,508506936,16633,5544,11089,5544,0,1,5546,1521005,1.521005
6044,3353,5055,16949415,2,48358,12091,1,542138936,542138936,18133,6044,12089,6044,0,1,6046,958992,0.958992
6544,3353,5055,16949415,2,52358,13091,1,575770936,575770936,19633,6544,13089,6544,0,1,6546,4035566,4.035566
7044,3353,5055,16949415,2,56358,14091,1,609402936,609402936,21133,7044,14089,7044,0,1,7046,1329987,1.329987
40,3300,5140,16962000,2,326,83,1,138396800,138396800,121,40,81,40,0,1,42,307731,0.307731
440,3300,5140,16962000,2,3526,883,1,165404800,165404800,1321,440,881,440,0,1,442,21612,0.021612
840,3300,5140,16962000,2,6726,1683,1,192412800,192412800,2521,840,1681,840,0,1,842,208635,0.208635
1240,3300,5140,16962000,2,9926,2483,1,219420800,219420800,3721,1240,2481,1240,0,1,1242,642662,0.642662
1640,3300,5140,16962000,2,13126,3283,1,246428800,246428800,4921,1640,3281,1640,0,1,1642,422743,0.422743
2040,3300,5140,16962000,2,16326,4083,1,273436800,273436800,6121,2040,4081,2040,0,1,2042,92486,0.092486
2440,3300,5140,16962000,2,19526,4883,1,300444800,300444800,7321,2440,4881,2440,0,1,2442,535865,0.535865
2840,3300,5140,16962000,2,22726,5683,1,327452800,327452800,8521,2840,5681,2840,0,1,2842,1144076,1.144076
3240,3300,5140,16962000,2,25926,6483,1,354460800,354460800,9721,3240,6481,3240,0,1,3242,2792179,2.792179
3640,3300,5140,16962000,2,29126,7283,1,381468800,381468800,10921,3640,7281,3640,0,1,3642,303624,0.303624
4040,3300,5140,16962000,2,32326,8083,1,408476800,408476800,12121,4040,8081,4040,0,1,4042,828653,0.828653
4440,3300,5140,16962000,2,35526,8883,1,435484800,435484800,13321,4440,8881,4440,0,1,4442,135624,0.135624
4840,3300,5140,16962000,2,38726,9683,1,462492800,462492800,14521,4840,9681,4840,0,1,4842,149054,0.149054
5240,3300,5140,16962000,2,41926,10483,1,489500800,489500800,15721,5240,10481,5240,0,1,5242,2494922,2.494922
5640,3300,5140,16962000,2,45126,11283,1,516508800,516508800,16921,5640,11281,5640,0,1,5642,1077843,1.077843
6040,3300,5140,16962000,2,48326,12083,1,543516800,543516800,18121,6040,12081,6040,0,1,6042,2149096,2.149096
6440,3300,5140,16962000,2,51526,12883,1,570524800,570524800,19321,6440,12881,6440,0,1,6442,3999244,3.999244
6840,3300,5140,16962000,2,54726,13683,1,597532800,597532800,20521,6840,13681,6840,0,1,6842,8184688,8.184688
44,5553,3055,16964415,2,358,91,1,138745336,138745336,133,44,89,44,0,1,46,66046,0.066046
544,5553,3055,16964415,2,4358,1091,1,173177336,173177336,1633,544,1089,544,0,1,546,85605,0.085605
1044,5553,3055,16964415,2,8358,2091,1,207609336,207609336,3133,1044,2089,1044,0,1,1046,12508,0.012508
1544,5553,3055,16964415,2,12358,3091,1,242041336,242041336,4633,1544,3089,1544,0,1,1546,56103,0.056103
2044,5553,3055,16964415,2,16358,4091,1,276473336,276473336,6133,2044,4089,2044,0,1,2046,941650,0.94165
2544,5553,3055,16964415,2,20358,5091,1,310905336,310905336,7633,2544,5089,2544,0,1,2546,84574,0.084574
3044,5553,3055,16964415,2,24358,6091,1,345337336,345337336,9133,3044,6089,3044,0,1,3046,2383280,2.38328
3544,5553,3055,16964415,2,28358,7091,1,379769336,379769336,10633,3544,7089,3544,0,1,3546,946580,0.94658
4044,5553,3055,16964415,2,32358,8091,1,414201336,414201336,12133,4044,8089,4044,0,1,4046,1234486,1.234486
4544,5553,3055,16964415,2,36358,9091,1,448633336,448633336,13633,4544,9089,4544,0,1,4546,269428,0.269428
5044,5553,3055,16964415,2,40358,10091,1,483065336,483065336,15133,5044,10089,5044,0,1,5046,935059,0.935059
5544,5553,3055,16964415,2,44358,11091,1,517497336,517497336,16633,5544,11089,5544,0,1,5546,5794895,5.794895
6044,5553,3055,16964415,2,48358,12091,1,551929336,551929336,18133,6044,12089,6044,0,1,6046,2236486,2.236486
6544,5553,3055,16964415,2,52358,13091,1,586361336,586361336,19633,6544,13089,6544,0,1,6546,3944506,3.944506
7044,5553,3055,16964415,2,56358,14091,1,620793336,620793336,21133,7044,14089,7044,0,1,7046,4931427,4.931427
44,2803,6055,16972165,2,358,91,1,138895336,138895336,133,44,89,44,0,1,46,314549,0.314549
544,2803,6055,16972165,2,4358,1091,1,174327336,174327336,1633,544,1089,544,0,1,546,1753939,1.753939
1044,2803,6055,16972165,2,8358,2091,1,209759336,209759336,3133,1044,2089,1044,0,1,1046,617959,0.617959
1544,2803,6055,16972165,2,12358,3091,1,245191336,245191336,4633,1544,3089,1544,0,1,1546,99406,0.099406
2044,2803,6055,16972165,2,16358,4091,1,280623336,280623336,6133,2044,4089,2044,0,1,2046,5673773,5.673773
2544,2803,6055,16972165,2,20358,5091,1,316055336,316055336,7633,2544,5089,2544,0,1,2546,977020,0.97702
3044,2803,6055,16972165,2,24358,6091,1,351487336,351487336,9133,3044,6089,3044,0,1,3046,3440400,3.4404
3544,2803,6055,16972165,2,28358,7091,1,386919336,386919336,10633,3544,7089,3544,0,1,3546,3398585,3.398585
4044,2803,6055,16972165,2,32358,8091,1,422351336,422351336,12133,4044,8089,4044,0,1,4046,2801652,2.801652
4544,2803,6055,16972165,2,36358,9091,1,457783336,457783336,13633,4544,9089,4544,0,1,4546,989419,0.989419
5044,2803,6055,16972165,2,40358,10091,1,493215336,493215336,15133,5044,10089,5044,0,1,5046,748117,0.748117
5544,2803,6055,16972165,2,44358,11091,1,528647336,528647336,16633,5544,11089,5544,0,1,5546,5083831,5.083831
6044,2803,6055,16972165,2,48358,12091,1,564079336,564079336,18133,6044,12089,6044,0,1,6046,3314945,3.314945
6544,2803,6055,16972165,2,52358,13091,1,599511336,599511336,19633,6544,13089,6544,0,1,6546,2634755,2.634755
7044,2803,6055,16972165,2,56358,14091,1,634943336,634943336,21133,7044,14089,7044,0,1,7046,531791,0.531791
44,6653,2555,16998415,2,358,91,1,139228536,139228536,133,44,89,44,0,1,46,15498,0.015498
544,6653,2555,16998415,2,4358,1091,1,176060536,176060536,1633,544,1089,544,0,1,546,33848,0.033848
1044,6653,2555,16998415,2,8358,2091,1,212892536,212892536,3133,1044,2089,1044,0,1,1046,596579,0.596579
1544,6653,2555,16998415,2,12358,3091,1,249724536,249724536,4633,1544,3089,1544,0,1,1546,1577368,1.577368
2044,6653,2555,16998415,2,16358,4091,1,286556536,286556536,6133,2044,4089,2044,0,1,2046,691792,0.691792
2544,6653,2555,16998415,2,20358,5091,1,323388536,323388536,7633,2544,5089,2544,0,1,2546,1510305,1.510305
3044,6653,2555,16998415,2,24358,6091,1,360220536,360220536,9133,3044,6089,3044,0,1,3046,3272795,3.272795
3544,6653,2555,16998415,2,28358,7091,1,397052536,397052536,10633,3544,7089,3544,0,1,3546,131181,0.131181
4044,6653,2555,16998415,2,32358,8091,1,433884536,433884536,12133,4044,8089,4044,0,1,4046,481496,0.481496
4544,6653,2555,16998415,2,36358,9091,1,470716536,470716536,13633,4544,9089,4544,0,1,4546,1796584,1.796584
5044,6653,2555,16998415,2,40358,10091,1,507548536,507548536,15133,5044,10089,5044,0,1,5046,1109904,1.109904
5544,6653,2555,16998415,2,44358,11091,1,544380536,544380536,16633,5544,11089,5544,0,1,5546,994836,0.994836
6044,6653,2555,16998415,2,48358,12091,1,581212536,581212536,18133,6044,12089,6044,0,1,6046,452797,0.452797
6544,6653,2555,16998415,2,52358,13091,1,618044536,618044536,19633,6544,13089,6544,0,1,6546,4303042,4.303042
7044,6653,2555,16998415,2,56358,14091,1,654876536,654876536,21133,7044,14089,7044,0,1,7046,3297618,3.297618
55,5055,3365,17010075,2,446,113,1,139785400,139785400,166,55,111,55,0,1,57,40365,0.040365
455,5055,3365,17010075,2,3646,913,1,166729400,166729400,1366,455,911,455,0,1,457,82378,0.082378
855,5055,3365,17010075,2,6846,1713,1,193673400,193673400,2566,855,1711,855,0,1,857,107240,0.10724
1255,5055,3365,17010075,2,10046,2513,1,220617400,220617400,3766,1255,2511,1255,0,1,1257,170904,0.170904
1655,5055,3365,17010075,2,13246,3313,1,247561400,247561400,4966,1655,3311,1655,0,1,1657,145544,0.145544
2055,5055,3365,17010075,2,16446,4113,1,274505400,274505400,6166,2055,4111,2055,0,1,2057,36582,0.036582
2455,5055,3365,17010075,2,19646,4913,1,301449400,301449400,7366,2455,4911,2455,0,1,2457,125097,0.125097
2855,5055,3365,17010075,2,22846,5713,1,328393400,328393400,8566,2855,5711,2855,0,1,2857,152426,0.152426
3255,5055,3365,17010075,2,26046,6513,1,355337400,355337400,9766,3255,6511,3255,0,1,3257,795695,0.795695
3655,5055,3365,17010075,2,29246,7313,1,382281400,382281400,10966,3655,7311,3655,0,1,3657,798461,0.798461
4055,5055,3365,17010075,2,32446,8113,1,409225400,409225400,12166,4055,8111,4055,0,1,4057,442481,0.442481
4455,5055,3365,17010075,2,35646,8913,1,436169400,436169400,13366,4455,8911,4455,0,1,4457,339876,0.339876
4855,5055,3365,17010075,2,38846,9713,1,463113400,463113400,14566,4855,9711,4855,0,1,4857,1067991,1.067991
5255,5055,3365,17010075,2,42046,10513,1,490057400,490057400,15766,5255,10511,5255,0,1,5257,1376589,1.376589
5655,5055,3365,17010075,2,45246,11313,1,517001400,517001400,16966,5655,11311,5655,0,1,5657,1417583,1.417583
6055,5055,3365,17010075,2,48446,12113,1,543945400,543945400,18166,6055,12111,6055,0,1,6057,1504946,1.504946
6455,5055,3365,17010075,2,51646,12913,1,570889400,570889400,19366,6455,12911,6455,0,1,6457,1015215,1.015215
6855,5055,3365,17010075,2,54846,13713,1,597833400,597833400,20566,6855,13711,6855,0,1,6857,166921,0.166921
55,2805,6065,17012325,2,446,113,1,140001400,140001400,166,55,111,55,0,1,57,166453,0.166453
455,2805,6065,17012325,2,3646,913,1,168385400,168385400,1366,455,911,455,0,1,457,726516,0.726516
855,2805,6065,17012325,2,6846,1713,1,196769400,196769400,2566,855,1711,855,0,1,857,265454,0.265454
1255,2805,6065,17012325,2,10046,2513,1,225153400,225153400,3766,1255,2511,1255,0,1,1257,1319285,1.319285
1655,2805,6065,17012325,2,13246,3313,1,253537400,253537400,4966,1655,3311,1655,0,1,1657,1972315,1.972315
2055,2805,6065,17012325,2,16446,4113,1,281921400,281921400,6166,2055,4111,2055,0,1,2057,218064,0.218064
2455,2805,6065,17012325,2,19646,4913,1,310305400,310305400,7366,2455,4911,2455,0,1,2457,2373228,2.373228
2855,2805,6065,17012325,2,22846,5713,1,338689400,338689400,8566,2855,5711,2855,0,1,2857,5079762,5.079762
3255,2805,6065,17012325,2,26046,6513,1,367073400,367073400,9766,3255,6511,3255,0,1,3257,2419457,2.419457
3655,2805,6065,17012325,2,29246,7313,1,395457400,395457400,10966,3655,7311,3655,0,1,3657,703795,0.703795
4055,2805,6065,17012325,2,32446,8113,1,423841400,423841400,12166,4055,8111,4055,0,1,4057,6741128,6.741128
4455,2805,6065,17012325,2,35646,8913,1,452225400,452225400,13366,4455,8911,4455,0,1,4457,1691222,1.691222
4855,2805,6065,17012325,2,38846,9713,1,480609400,480609400,14566,4855,9711,4855,0,1,4857,176248,0.176248
5255,2805,6065,17012325,2,42046,10513,1,508993400,508993400,15766,5255,10511,5255,0,1,5257,1114783,1.114783
5655,2805,6065,17012325,2,45246,11313,1,537377400,537377400,16966,5655,11311,5655,0,1,5657,3584059,3.584059
6055,2805,6065,17012325,2,48446,12113,1,565761400,565761400,18166,6055,12111,6055,0,1,6057,1239619,1.239619
6455,2805,6065,17012325,2,51646,12913,1,594145400,594145400,19366,6455,12911,6455,0,1,6457,630769,0.630769
6855,2805,6065,17012325,2,54846,13713,1,622529400,622529400,20566,6855,13711,6855,0,1,6857,5551637,5.551637
55,5555,3065,17026075,2,446,113,1,140001400,140001400,166,55,111,55,0,1,57,346766,0.346766
455,5555,3065,17026075,2,3646,913,1,167585400,167585400,1366,455,911,455,0,1,457,948698,0.948698
855,5555,3065,17026075,2,6846,1713,1,195169400,195169400,2566,855,1711,855,0,1,857,1134395,1.134395
1255,5555,3065,17026075,2,10046,2513,1,222753400,222753400,3766,1255,2511,1255,0,1,1257,133346,0.133346
1655,5555,3065,17026075,2,13246,3313,1,250337400,250337400,4966,1655,3311,1655,0,1,1657,1013191,1.013191
2055,5555,3065,17026075,2,16446,4113,1,277921400,277921400,6166,2055,4111,2055,0,1,2057,3266380,3.26638
2455,5555,3065,17026075,2,19646,4913,1,305505400,305505400,7366,2455,4911,2455,0,1,2457,1966458,1.966458
2855,5555,3065,17026075,2,22846,5713,1,333089400,333089400,8566,2855,5711,2855,0,1,2857,76671,0.076671
3255,5555,3065,17026075,2,26046,6513,1,360673400,360673400,9766,3255,6511,3255,0,1,3257,1749476,1.749476
3655,5555,3065,17026075,2,29246,7313,1,388257400,388257400,10966,3655,7311,3655,0,1,3657,110488,0.110488
4055,5555,3065,17026075,2,32446,8113,1,415841400,415841400,12166,4055,8111,4055,0,1,4057,2392005,2.392005
4455,5555,3065,17026075,2,35646,8913,1,443425400,443425400,13366,4455,8911,4455,0,1,4457,3150406,3.150406
4855,5555,3065,17026075,2,38846,9713,1,471009400,471009400,14566,4855,9711,4855,0,1,4857,3146116,3.146116
5255,5555,3065,17026075,2,42046,10513,1,498593400,498593400,15766,5255,10511,5255,0,1,5257,741855,0.741855
5655,5555,3065,17026075,2,45246,11313,1,526177400,526177400,16966,5655,11311,5655,0,1,5657,6614388,6.614388
6055,5555,3065,17026075,2,48446,12113,1,553761400,553761400,18166,6055,12111,6055,0,1,6057,1393148,1.393148
6455,5555,3065,17026075,2,51646,12913,1,581345400,581345400,19366,6455,12911,6455,0,1,6457,14222383,14.222383
6855,5555,3065,17026075,2,54846,13713,1,608929400,608929400,20566,6855,13711,6855,0,1,6857,8270739,8.270739
55,2555,6665,17029075,2,446,113,1,140289400,140289400,166,55,111,55,0,1,57,352972,0.352972
455,2555,6665,17029075,2,3646,913,1,169793400,169793400,1366,455,911,455,0,1,457,1587478,1.587478
855,2555,6665,17029075,2,6846,1713,1,199297400,199297400,2566,855,1711,855,0,1,857,1592748,1.592748
1255,2555,6665,17029075,2,10046,2513,1,228801400,228801400,3766,1255,2511,1255,0,1,1257,3715716,3.715716
1655,2555,6665,17029075,2,13246,3313,1,258305400,258305400,4966,1655,3311,1655,0,1,1657,4182902,4.182902
2055,2555,6665,17029075,2,16446,4113,1,287809400,287809400,6166,2055,4111,2055,0,1,2057,4200804,4.200804
2455,2555,6665,17029075,2,19646,4913,1,317313400,317313400,7366,2455,4911,2455,0,1,2457,468287,0.468287
2855,2555,6665,17029075,2,22846,5713,1,346817400,346817400,8566,2855,5711,2855,0,1,2857,1745760,1.74576
3255,2555,6665,17029075,2,26046,6513,1,376321400,376321400,9766,3255,6511,3255,0,1,3257,2628903,2.628903
3655,2555,6665,17029075,2,29246,7313,1,405825400,405825400,10966,3655,7311,3655,0,1,3657,228254,0.228254
4055,2555,6665,17029075,2,32446,8113,1,435329400,435329400,12166,4055,8111,4055,0,1,4057,4551574,4.551574
4455,2555,6665,17029075,2,35646,8913,1,464833400,464833400,13366,4455,8911,4455,0,1,4457,851044,0.851044
4855,2555,6665,17029075,2,38846,9713,1,494337400,494337400,14566,4855,9711,4855,0,1,4857,200320,0.20032
5255,2555,6665,17029075,2,42046,10513,1,523841400,523841400,15766,5255,10511,5255,0,1,5257,374867,0.374867
5655,2555,6665,17029075,2,45246,11313,1,553345400,553345400,16966,5655,11311,5655,0,1,5657,162959,0.162959
6055,2555,6665,17029075,2,48446,12113,1,582849400,582849400,18166,6055,12111,6055,0,1,6057,1188778,1.188778
6455,2555,6665,17029075,2,51646,12913,1,612353400,612353400,19366,6455,12911,6455,0,1,6457,206865,0.206865
6855,2555,6665,17029075,2,54846,13713,1,641857400,641857400,20566,6855,13711,6855,0,1,6857,589891,0.589891
55,4305,3965,17069325,2,446,113,1,140193400,140193400,166,55,111,55,0,1,57,341905,0.341905
455,4305,3965,17069325,2,3646,913,1,166657400,166657400,1366,455,911,455,0,1,457,74713,0.074713
855,4305,3965,17069325,2,6846,1713,1,193121400,193121400,2566,855,1711,855,0,1,857,1181124,1.181124
1255,4305,3965,17069325,2,10046,2513,1,219585400,219585400,3766,1255,2511,1255,0,1,1257,15504,0.015504
1655,4305,3965,17069325,2,13246,3313,1,246049400,246049400,4966,1655,3311,1655,0,1,1657,1631362,1.631362
2055,4305,3965,17069325,2,16446,4113,1,272513400,272513400,6166,2055,4111,2055,0,1,2057,27330,0.02733
2455,4305,3965,17069325,2,19646,4913,1,298977400,298977400,7366,2455,4911,2455,0,1,2457,423629,0.423629
2855,4305,3965,17069325,2,22846,5713,1,325441400,325441400,8566,2855,5711,2855,0,1,2857,3498678,3.498678
3255,4305,3965,17069325,2,26046,6513,1,351905400,351905400,9766,3255,6511,3255,0,1,3257,413577,0.413577
3655,4305,3965,17069325,2,29246,7313,1,378369400,378369400,10966,3655,7311,3655,0,1,3657,231468,0.231468
4055,4305,3965,17069325,2,32446,8113,1,404833400,404833400,12166,4055,8111,4055,0,1,4057,24202,0.024202
4455,4305,3965,17069325,2,35646,8913,1,431297400,431297400,13366,4455,8911,4455,0,1,4457,1241284,1.241284
4855,4305,3965,17069325,2,38846,9713,1,457761400,457761400,14566,4855,9711,4855,0,1,4857,153367,0.153367
5255,4305,3965,17069325,2,42046,10513,1,484225400,484225400,15766,5255,10511,5255,0,1,5257,3497102,3.497102
5655,4305,3965,17069325,2,45246,11313,1,510689400,510689400,16966,5655,11311,5655,0,1,5657,1926935,1.926935
6055,4305,3965,17069325,2,48446,12113,1,537153400,537153400,18166,6055,12111,6055,0,1,6057,3191724,3.191724
6455,4305,3965,17069325,2,51646,12913,1,563617400,563617400,19366,6455,12911,6455,0,1,6457,2421679,2.421679
6855,4305,3965,17069325,2,54846,13713,1,590081400,590081400,20566,6855,13711,6855,0,1,6857,7726079,7.726079
55,3305,5165,17070325,2,446,113,1,140289400,140289400,166,55,111,55,0,1,57,355896,0.355896
455,3305,5165,17070325,2,3646,913,1,167393400,167393400,1366,455,911,455,0,1,457,1502106,1.502106
855,3305,5165,17070325,2,6846,1713,1,194497400,194497400,2566,855,1711,855,0,1,857,2342125,2.342125
1255,3305,5165,17070325,2,10046,2513,1,221601400,221601400,3766,1255,2511,1255,0,1,1257,2095563,2.095563
1655,3305,5165,17070325,2,13246,3313,1,248705400,248705400,4966,1655,3311,1655,0,1,1657,5555288,5.555288
2055,3305,5165,17070325,2,16446,4113,1,275809400,275809400,6166,2055,4111,2055,0,1,2057,344289,0.344289
2455,3305,5165,17070325,2,19646,4913,1,302913400,302913400,7366,2455,4911,2455,0,1,2457,381994,0.381994
2855,3305,5165,17070325,2,22846,5713,1,330017400,330017400,8566,2855,5711,2855,0,1,2857,1484259,1.484259
3255,3305,5165,17070325,2,26046,6513,1,357121400,357121400,9766,3255,6511,3255,0,1,3257,3312141,3.312141
3655,3305,5165,17070325,2,29246,7313,1,384225400,384225400,10966,3655,7311,3655,0,1,3657,52464,0.052464
4055,3305,5165,17070325,2,32446,8113,1,411329400,411329400,12166,4055,8111,4055,0,1,4057,627535,0.627535
4455,3305,5165,17070325,2,35646,8913,1,438433400,438433400,13366,4455,8911,4455,0,1,4457,1337329,1.337329
4855,3305,5165,17070325,2,38846,9713,1,465537400,465537400,14566,4855,9711,4855,0,1,4857,3759498,3.759498
5255,3305,5165,17070325,2,42046,10513,1,492641400,492641400,15766,5255,10511,5255,0,1,5257,1429186,1.429186
5655,3305,5165,17070325,2,45246,11313,1,519745400,519745400,16966,5655,11311,5655,0,1,5657,184396,0.184396
6055,3305,5165,17070325,2,48446,12113,1,546849400,546849400,18166,6055,12111,6055,0,1,6057,5204063,5.204063
6455,3305,5165,17070325,2,51646,12913,1,573953400,573953400,19366,6455,12911,6455,0,1,6457,2674886,2.674886
6855,3305,5165,17070325,2,54846,13713,1,601057400,601057400,20566,6855,13711,6855,0,1,6857,4009081,4.009081
40,4050,4240,17172000,2,326,83,1,140028800,140028800,121,40,81,40,0,1,42,14683,0.014683
440,4050,4240,17172000,2,3526,883,1,166556800,166556800,1321,440,881,440,0,1,442,39327,0.039327
840,4050,4240,17172000,2,6726,1683,1,193084800,193084800,2521,840,1681,840,0,1,842,27908,0.027908
1240,4050,4240,17172000,2,9926,2483,1,219612800,219612800,3721,1240,2481,1240,0,1,1242,894354,0.894354
1640,4050,4240,17172000,2,13126,3283,1,246140800,246140800,4921,1640,3281,1640,0,1,1642,606600,0.6066
2040,4050,4240,17172000,2,16326,4083,1,272668800,272668800,6121,2040,4081,2040,0,1,2042,19181,0.019181
2440,4050,4240,17172000,2,19526,4883,1,299196800,299196800,7321,2440,4881,2440,0,1,2442,354460,0.35446
2840,4050,4240,17172000,2,22726,5683,1,325724800,325724800,8521,2840,5681,2840,0,1,2842,455491,0.455491
3240,4050,4240,17172000,2,25926,6483,1,352252800,352252800,9721,3240,6481,3240,0,1,3242,1233272,1.233272
3640,4050,4240,17172000,2,29126,7283,1,378780800,378780800,10921,3640,7281,3640,0,1,3642,59377,0.059377
4040,4050,4240,17172000,2,32326,8083,1,405308800,405308800,12121,4040,8081,4040,0,1,4042,176049,0.176049
4440,4050,4240,17172000,2,35526,8883,1,431836800,431836800,13321,4440,8881,4440,0,1,4442,701097,0.701097
4840,4050,4240,17172000,2,38726,9683,1,458364800,458364800,14521,4840,9681,4840,0,1,4842,67916,0.067916
5240,4050,4240,17172000,2,41926,10483,1,484892800,484892800,15721,5240,10481,5240,0,1,5242,1204460,1.20446
5640,4050,4240,17172000,2,45126,11283,1,511420800,511420800,16921,5640,11281,5640,0,1,5642,2042585,2.042585
6040,4050,4240,17172000,2,48326,12083,1,537948800,537948800,18121,6040,12081,6040,0,1,6042,600024,0.600024
6440,4050,4240,17172000,2,51526,12883,1,564476800,564476800,19321,6440,12881,6440,0,1,6442,3679904,3.679904
6840,4050,4240,17172000,2,54726,13683,1,591004800,591004800,20521,6840,13681,6840,0,1,6842,3787149,3.787149
40,3550,4840,17182000,2,326,83,1,140140800,140140800,121,40,81,40,0,1,42,299604,0.299604
440,3550,4840,17182000,2,3526,883,1,166988800,166988800,1321,440,881,440,0,1,442,1068303,1.068303
840,3550,4840,17182000,2,6726,1683,1,193836800,193836800,2521,840,1681,840,0,1,842,2844155,2.844155
1240,3550,4840,17182000,2,9926,2483,1,220684800,220684800,3721,1240,2481,1240,0,1,1242,349356,0.349356
1640,3550,4840,17182000,2,13126,3283,1,247532800,247532800,4921,1640,3281,1640,0,1,1642,2859958,2.859958
2040,3550,4840,17182000,2,16326,4083,1,274380800,274380800,6121,2040,4081,2040,0,1,2042,518180,0.51818
2440,3550,4840,17182000,2,19526,4883,1,301228800,301228800,7321,2440,4881,2440,0,1,2442,430886,0.430886
2840,3550,4840,17182000,2,22726,5683,1,328076800,328076800,8521,2840,5681,2840,0,1,2842,2164889,2.164889
3240,3550,4840,17182000,2,25926,6483,1,354924800,354924800,9721,3240,6481,3240,0,1,3242,3269825,3.269825
3640,3550,4840,17182000,2,29126,7283,1,381772800,381772800,10921,3640,7281,3640,0,1,3642,1876209,1.876209
4040,3550,4840,17182000,2,32326,8083,1,408620800,408620800,12121,4040,8081,4040,0,1,4042,5526191,5.526191
4440,3550,4840,17182000,2,35526,8883,1,435468800,435468800,13321,4440,8881,4440,0,1,4442,4031779,4.031779
4840,3550,4840,17182000,2,38726,9683,1,462316800,462316800,14521,4840,9681,4840,0,1,4842,3893795,3.893795
5240,3550,4840,17182000,2,41926,10483,1,489164800,489164800,15721,5240,10481,5240,0,1,5242,1381210,1.38121
5640,3550,4840,17182000,2,45126,11283,1,516012800,516012800,16921,5640,11281,5640,0,1,5642,31713,0.031713
6040,3550,4840,17182000,2,48326,12083,1,542860800,542860800,18121,6040,12081,6040,0,1,6042,4812983,4.812983
6440,3550,4840,17182000,2,51526,12883,1,569708800,569708800,19321,6440,12881,6440,0,1,6442,3604423,3.604423
6840,3550,4840,17182000,2,54726,13683,1,596556800,596556800,20521,6840,13681,6840,0,1,6842,2369141,2.369141
40,7050,2440,17202000,2,326,83,1,140652800,140652800,121,40,81,40,0,1,42,298111,0.298111
440,7050,2440,17202000,2,3526,883,1,171020800,171020800,1321,440,881,440,0,1,442,1588373,1.588373
840,7050,2440,17202000,2,6726,1683,1,201388800,201388800,2521,840,1681,840,0,1,842,2625017,2.625017
1240,7050,2440,17202000,2,9926,2483,1,231756800,231756800,3721,1240,2481,1240,0,1,1242,4212507,4.212507
1640,7050,2440,17202000,2,13126,3283,1,262124800,262124800,4921,1640,3281,1640,0,1,1642,1637477,1.637477
2040,7050,2440,17202000,2,16326,4083,1,292492800,292492800,6121,2040,4081,2040,0,1,2042,6872321,6.872321
2440,7050,2440,17202000,2,19526,4883,1,322860800,322860800,7321,2440,4881,2440,0,1,2442,1303109,1.303109
2840,7050,2440,17202000,2,22726,5683,1,353228800,353228800,8521,2840,5681,2840,0,1,2842,1891837,1.891837
3240,7050,2440,17202000,2,25926,6483,1,383596800,383596800,9721,3240,6481,3240,0,1,3242,1868535,1.868535
3640,7050,2440,17202000,2,29126,7283,1,413964800,413964800,10921,3640,7281,3640,0,1,3642,8586598,8.586598
4040,7050,2440,17202000,2,32326,8083,1,444332800,444332800,12121,4040,8081,4040,0,1,4042,13507213,13.507213
4440,7050,2440,17202000,2,35526,8883,1,474700800,474700800,13321,4440,8881,4440,0,1,4442,14830772,14.830772
4840,7050,2440,17202000,2,38726,9683,1,505068800,505068800,14521,4840,9681,4840,0,1,4842,7569555,7.569555
5240,7050,2440,17202000,2,41926,10483,1,535436800,535436800,15721,5240,10481,5240,0,1,5242,1953745,1.953745
5640,7050,2440,17202000,2,45126,11283,1,565804800,565804800,16921,5640,11281,5640,0,1,5642,18796861,18.796861
6040,7050,2440,17202000,2,48326,12083,1,596172800,596172800,18121,6040,12081,6040,0,1,6042,20272614,20.272614
6440,7050,2440,17202000,2,51526,12883,1,626540800,626540800,19321,6440,12881,6440,0,1,6442,21481232,21.481232
6840,7050,2440,17202000,2,54726,13683,1,656908800,656908800,20521,6840,13681,6840,0,1,6842,22860872,22.860872
40,3800,4540,17252000,2,326,83,1,140684800,140684800,121,40,81,40,0,1,42,308917,0.308917
440,3800,4540,17252000,2,3526,883,1,167372800,167372800,1321,440,881,440,0,1,442,1597880,1.59788
840,3800,4540,17252000,2,6726,1683,1,194060800,194060800,2521,840,1681,840,0,1,842,2913984,2.913984
1240,3800,4540,17252000,2,9926,2483,1,220748800,220748800,3721,1240,2481,1240,0,1,1242,2885191,2.885191
1640,3800,4540,17252000,2,13126,3283,1,247436800,247436800,4921,1640,3281,1640,0,1,1642,1482929,1.482929
2040,3800,4540,17252000,2,16326,4083,1,274124800,274124800,6121,2040,4081,2040,0,1,2042,6475658,6.475658
2440,3800,4540,17252000,2,19526,4883,1,300812800,300812800,7321,2440,4881,2440,0,1,2442,2824737,2.824737
2840,3800,4540,17252000,2,22726,5683,1,327500800,327500800,8521,2840,5681,2840,0,1,2842,1681210,1.68121
3240,3800,4540,17252000,2,25926,6483,1,354188800,354188800,9721,3240,6481,3240,0,1,3242,4681722,4.681722
3640,3800,4540,17252000,2,29126,7283,1,380876800,380876800,10921,3640,7281,3640,0,1,3642,569709,0.569709
4040,3800,4540,17252000,2,32326,8083,1,407564800,407564800,12121,4040,8081,4040,0,1,4042,3082309,3.082309
4440,3800,4540,17252000,2,35526,8883,1,434252800,434252800,13321,4440,8881,4440,0,1,4442,2506641,2.506641
4840,3800,4540,17252000,2,38726,9683,1,460940800,460940800,14521,4840,9681,4840,0,1,4842,5407620,5.40762
5240,3800,4540,17252000,2,41926,10483,1,487628800,487628800,15721,5240,10481,5240,0,1,5242,8886365,8.886365
5640,3800,4540,17252000,2,45126,11283,1,514316800,514316800,16921,5640,11281,5640,0,1,5642,3315041,3.315041
6040,3800,4540,17252000,2,48326,12083,1,541004800,541004800,18121,6040,12081,6040,0,1,6042,689714,0.689714
6440,3800,4540,17252000,2,51526,12883,1,567692800,567692800,19321,6440,12881,6440,0,1,6442,5183895,5.183895
6840,3800,4540,17252000,2,54726,13683,1,594380800,594380800,20521,6840,13681,6840,0,1,6842,9924533,9.924533
40,6300,2740,17262000,2,326,83,1,140988800,140988800,121,40,81,40,0,1,42,317907,0.317907
440,6300,2740,17262000,2,3526,883,1,169916800,169916800,1321,440,881,440,0,1,442,1567168,1.567168
840,6300,2740,17262000,2,6726,1683,1,198844800,198844800,2521,840,1681,840,0,1,842,2835540,2.83554
1240,6300,2740,17262000,2,9926,2483,1,227772800,227772800,3721,1240,2481,1240,0,1,1242,1272240,1.27224
1640,6300,2740,17262000,2,13126,3283,1,256700800,256700800,4921,1640,3281,1640,0,1,1642,222931,0.222931
2040,6300,2740,17262000,2,16326,4083,1,285628800,285628800,6121,2040,4081,2040,0,1,2042,6585721,6.585721
2440,6300,2740,17262000,2,19526,4883,1,314556800,314556800,7321,2440,4881,2440,0,1,2442,2076048,2.076048
2840,6300,2740,17262000,2,22726,5683,1,343484800,343484800,8521,2840,5681,2840,0,1,2842,9129855,9.129855
3240,6300,2740,17262000,2,25926,6483,1,372412800,372412800,9721,3240,6481,3240,0,1,3242,2960041,2.960041
3640,6300,2740,17262000,2,29126,7283,1,401340800,401340800,10921,3640,7281,3640,0,1,3642,3308777,3.308777
4040,6300,2740,17262000,2,32326,8083,1,430268800,430268800,12121,4040,8081,4040,0,1,4042,643099,0.643099
4440,6300,2740,17262000,2,35526,8883,1,459196800,459196800,13321,4440,8881,4440,0,1,4442,611442,0.611442
4840,6300,2740,17262000,2,38726,9683,1,488124800,488124800,14521,4840,9681,4840,0,1,4842,3928900,3.9289
5240,6300,2740,17262000,2,41926,10483,1,517052800,517052800,15721,5240,10481,5240,0,1,5242,2611295,2.611295
5640,6300,2740,17262000,2,45126,11283,1,545980800,545980800,16921,5640,11281,5640,0,1,5642,15268675,15.268675
6040,6300,2740,17262000,2,48326,12083,1,574908800,574908800,18121,6040,12081,6040,0,1,6042,4423578,4.423578
6440,6300,2740,17262000,2,51526,12883,1,603836800,603836800,19321,6440,12881,6440,0,1,6442,3216710,3.21671
6840,6300,2740,17262000,2,54726,13683,1,632764800,632764800,20521,6840,13681,6840,0,1,6842,17537895,17.537895
55,4055,4265,17294575,2,446,113,1,142017400,142017400,166,55,111,55,0,1,57,24023,0.024023
455,4055,4265,17294575,2,3646,913,1,168641400,168641400,1366,455,911,455,0,1,457,42715,0.042715
855,4055,4265,17294575,2,6846,1713,1,195265400,195265400,2566,855,1711,855,0,1,857,2235,0.002235
1255,4055,4265,17294575,2,10046,2513,1,221889400,221889400,3766,1255,2511,1255,0,1,1257,254234,0.254234
1655,4055,4265,17294575,2,13246,3313,1,248513400,248513400,4966,1655,3311,1655,0,1,1657,835392,0.835392
2055,4055,4265,17294575,2,16446,4113,1,275137400,275137400,6166,2055,4111,2055,0,1,2057,522596,0.522596
2455,4055,4265,17294575,2,19646,4913,1,301761400,301761400,7366,2455,4911,2455,0,1,2457,102135,0.102135
2855,4055,4265,17294575,2,22846,5713,1,328385400,328385400,8566,2855,5711,2855,0,1,2857,180106,0.180106
3255,4055,4265,17294575,2,26046,6513,1,355009400,355009400,9766,3255,6511,3255,0,1,3257,320170,0.32017
3655,4055,4265,17294575,2,29246,7313,1,381633400,381633400,10966,3655,7311,3655,0,1,3657,105024,0.105024
4055,4055,4265,17294575,2,32446,8113,1,408257400,408257400,12166,4055,8111,4055,0,1,4057,1166585,1.166585
4455,4055,4265,17294575,2,35646,8913,1,434881400,434881400,13366,4455,8911,4455,0,1,4457,2762348,2.762348
4855,4055,4265,17294575,2,38846,9713,1,461505400,461505400,14566,4855,9711,4855,0,1,4857,510025,0.510025
5255,4055,4265,17294575,2,42046,10513,1,488129400,488129400,15766,5255,10511,5255,0,1,5257,1357735,1.357735
5655,4055,4265,17294575,2,45246,11313,1,514753400,514753400,16966,5655,11311,5655,0,1,5657,2691215,2.691215
6055,4055,4265,17294575,2,48446,12113,1,541377400,541377400,18166,6055,12111,6055,0,1,6057,68696,0.068696
6455,4055,4265,17294575,2,51646,12913,1,568001400,568001400,19366,6455,12911,6455,0,1,6457,621370,0.62137
6855,4055,4265,17294575,2,54846,13713,1,594625400,594625400,20566,6855,13711,6855,0,1,6857,3169900,3.1699
55,3555,4865,17295075,2,446,113,1,142065400,142065400,166,55,111,55,0,1,57,353189,0.353189
455,3555,4865,17295075,2,3646,913,1,169009400,169009400,1366,455,911,455,0,1,457,1655659,1.655659
855,3555,4865,17295075,2,6846,1713,1,195953400,195953400,2566,855,1711,855,0,1,857,1339609,1.339609
1255,3555,4865,17295075,2,10046,2513,1,222897400,222897400,3766,1255,2511,1255,0,1,1257,1024655,1.024655
1655,3555,4865,17295075,2,13246,3313,1,249841400,249841400,4966,1655,3311,1655,0,1,1657,363412,0.363412
2055,3555,4865,17295075,2,16446,4113,1,276785400,276785400,6166,2055,4111,2055,0,1,2057,78938,0.078938
2455,3555,4865,17295075,2,19646,4913,1,303729400,303729400,7366,2455,4911,2455,0,1,2457,203987,0.203987
2855,3555,4865,17295075,2,22846,5713,1,330673400,330673400,8566,2855,5711,2855,0,1,2857,633726,0.633726
3255,3555,4865,17295075,2,26046,6513,1,357617400,357617400,9766,3255,6511,3255,0,1,3257,2398768,2.398768
3655,3555,4865,17295075,2,29246,7313,1,384561400,384561400,10966,3655,7311,3655,0,1,3657,619050,0.61905
4055,3555,4865,17295075,2,32446,8113,1,411505400,411505400,12166,4055,8111,4055,0,1,4057,1476180,1.47618
4455,3555,4865,17295075,2,35646,8913,1,438449400,438449400,13366,4455,8911,4455,0,1,4457,2244304,2.244304
4855,3555,4865,17295075,2,38846,9713,1,465393400,465393400,14566,4855,9711,4855,0,1,4857,222053,0.222053
5255,3555,4865,17295075,2,42046,10513,1,492337400,492337400,15766,5255,10511,5255,0,1,5257,345144,0.345144
5655,3555,4865,17295075,2,45246,11313,1,519281400,519281400,16966,5655,11311,5655,0,1,5657,3343765,3.343765
6055,3555,4865,17295075,2,48446,12113,1,546225400,546225400,18166,6055,12111,6055,0,1,6057,42006,0.042006
6455,3555,4865,17295075,2,51646,12913,1,573169400,573169400,19366,6455,12911,6455,0,1,6457,5621386,5.621386
6855,3555,4865,17295075,2,54846,13713,1,600113400,600113400,20566,6855,13711,6855,0,1,6857,1558723,1.558723
55,3805,4565,17369825,2,446,113,1,142641400,142641400,166,55,111,55,0,1,57,363434,0.363434
455,3805,4565,17369825,2,3646,913,1,169425400,169425400,1366,455,911,455,0,1,457,876730,0.87673
855,3805,4565,17369825,2,6846,1713,1,196209400,196209400,2566,855,1711,855,0,1,857,3025626,3.025626
1255,3805,4565,17369825,2,10046,2513,1,222993400,222993400,3766,1255,2511,1255,0,1,1257,1440733,1.440733
1655,3805,4565,17369825,2,13246,3313,1,249777400,249777400,4966,1655,3311,1655,0,1,1657,3387200,3.3872
2055,3805,4565,17369825,2,16446,4113,1,276561400,276561400,6166,2055,4111,2055,0,1,2057,665281,0.665281
2455,3805,4565,17369825,2,19646,4913,1,303345400,303345400,7366,2455,4911,2455,0,1,2457,430426,0.430426
2855,3805,4565,17369825,2,22846,5713,1,330129400,330129400,8566,2855,5711,2855,0,1,2857,1326602,1.326602
3255,3805,4565,17369825,2,26046,6513,1,356913400,356913400,9766,3255,6511,3255,0,1,3257,406341,0.406341
3655,3805,4565,17369825,2,29246,7313,1,383697400,383697400,10966,3655,7311,3655,0,1,3657,2355993,2.355993
4055,3805,4565,17369825,2,32446,8113,1,410481400,410481400,12166,4055,8111,4055,0,1,4057,10396074,10.396074
4455,3805,4565,17369825,2,35646,8913,1,437265400,437265400,13366,4455,8911,4455,0,1,4457,398895,0.398895
4855,3805,4565,17369825,2,38846,9713,1,464049400,464049400,14566,4855,9711,4855,0,1,4857,3945592,3.945592
5255,3805,4565,17369825,2,42046,10513,1,490833400,490833400,15766,5255,10511,5255,0,1,5257,3429564,3.429564
5655,3805,4565,17369825,2,45246,11313,1,517617400,517617400,16966,5655,11311,5655,0,1,5657,1433744,1.433744
6055,3805,4565,17369825,2,48446,12113,1,544401400,544401400,18166,6055,12111,6055,0,1,6057,1237227,1.237227
6455,3805,4565,17369825,2,51646,12913,1,571185400,571185400,19366,6455,12911,6455,0,1,6457,5525596,5.525596
6855,3805,4565,17369825,2,54846,13713,1,597969400,597969400,20566,6855,13711,6855,0,1,6857,358209,0.358209
55,7055,2465,17390575,2,446,113,1,143313400,143313400,166,55,111,55,0,1,57,344199,0.344199
455,7055,2465,17390575,2,3646,913,1,173777400,173777400,1366,455,911,455,0,1,457,32777,0.032777
855,7055,2465,17390575,2,6846,1713,1,204241400,204241400,2566,855,1711,855,0,1,857,2922181,2.922181
1255,7055,2465,17390575,2,10046,2513,1,234705400,234705400,3766,1255,2511,1255,0,1,1257,4378841,4.378841
1655,7055,2465,17390575,2,13246,3313,1,265169400,265169400,4966,1655,3311,1655,0,1,1657,3566982,3.566982
2055,7055,2465,17390575,2,16446,4113,1,295633400,295633400,6166,2055,4111,2055,0,1,2057,434906,0.434906
2455,7055,2465,17390575,2,19646,4913,1,326097400,326097400,7366,2455,4911,2455,0,1,2457,8356351,8.356351
2855,7055,2465,17390575,2,22846,5713,1,356561400,356561400,8566,2855,5711,2855,0,1,2857,1052566,1.052566
3255,7055,2465,17390575,2,26046,6513,1,387025400,387025400,9766,3255,6511,3255,0,1,3257,1868582,1.868582
3655,7055,2465,17390575,2,29246,7313,1,417489400,417489400,10966,3655,7311,3655,0,1,3657,4279644,4.279644
4055,7055,2465,17390575,2,32446,8113,1,447953400,447953400,12166,4055,8111,4055,0,1,4057,7564645,7.564645
4455,7055,2465,17390575,2,35646,8913,1,478417400,478417400,13366,4455,8911,4455,0,1,4457,3262207,3.262207
4855,7055,2465,17390575,2,38846,9713,1,508881400,508881400,14566,4855,9711,4855,0,1,4857,11793983,11.793983
5255,7055,2465,17390575,2,42046,10513,1,539345400,539345400,15766,5255,10511,5255,0,1,5257,17837610,17.83761
5655,7055,2465,17390575,2,45246,11313,1,569809400,569809400,16966,5655,11311,5655,0,1,5657,19164809,19.164809
6055,7055,2465,17390575,2,48446,12113,1,600273400,600273400,18166,6055,12111,6055,0,1,6057,20657454,20.657454
6455,7055,2465,17390575,2,51646,12913,1,630737400,630737400,19366,6455,12911,6455,0,1,6457,22048018,22.048018
6855,7055,2465,17390575,2,54846,13713,1,661201400,661201400,20566,6855,13711,6855,0,1,6857,23457453,23.457453
55,6305,2765,17433325,2,446,113,1,143457400,143457400,166,55,111,55,0,1,57,350424,0.350424
455,6305,2765,17433325,2,3646,913,1,172481400,172481400,1366,455,911,455,0,1,457,1647544,1.647544
855,6305,2765,17433325,2,6846,1713,1,201505400,201505400,2566,855,1711,855,0,1,857,2944261,2.944261
1255,6305,2765,17433325,2,10046,2513,1,230529400,230529400,3766,1255,2511,1255,0,1,1257,719744,0.719744
1655,6305,2765,17433325,2,13246,3313,1,259553400,259553400,4966,1655,3311,1655,0,1,1657,1551235,1.551235
2055,6305,2765,17433325,2,16446,4113,1,288577400,288577400,6166,2055,4111,2055,0,1,2057,2167458,2.167458
2455,6305,2765,17433325,2,19646,4913,1,317601400,317601400,7366,2455,4911,2455,0,1,2457,8214186,8.214186
2855,6305,2765,17433325,2,22846,5713,1,346625400,346625400,8566,2855,5711,2855,0,1,2857,1087592,1.087592
3255,6305,2765,17433325,2,26046,6513,1,375649400,375649400,9766,3255,6511,3255,0,1,3257,3181346,3.181346
3655,6305,2765,17433325,2,29246,7313,1,404673400,404673400,10966,3655,7311,3655,0,1,3657,237567,0.237567
4055,6305,2765,17433325,2,32446,8113,1,433697400,433697400,12166,4055,8111,4055,0,1,4057,165978,0.165978
4455,6305,2765,17433325,2,35646,8913,1,462721400,462721400,13366,4455,8911,4455,0,1,4457,1615192,1.615192
4855,6305,2765,17433325,2,38846,9713,1,491745400,491745400,14566,4855,9711,4855,0,1,4857,2166211,2.166211
5255,6305,2765,17433325,2,42046,10513,1,520769400,520769400,15766,5255,10511,5255,0,1,5257,16038241,16.038241
5655,6305,2765,17433325,2,45246,11313,1,549793400,549793400,16966,5655,11311,5655,0,1,5657,7697532,7.697532
6055,6305,2765,17433325,2,48446,12113,1,578817400,578817400,18166,6055,12111,6055,0,1,6057,104952,0.104952
6455,6305,2765,17433325,2,51646,12913,1,607841400,607841400,19366,6455,12911,6455,0,1,6457,19492175,19.492175
6855,6305,2765,17433325,2,54846,13713,1,636865400,636865400,20566,6855,13711,6855,0,1,6857,22741857,22.741857
40,4800,3640,17472000,2,326,83,1,142476800,142476800,121,40,81,40,0,1,42,306638,0.306638
440,4800,3640,17472000,2,3526,883,1,169484800,169484800,1321,440,881,440,0,1,442,1557102,1.557102
840,4800,3640,17472000,2,6726,1683,1,196492800,196492800,2521,840,1681,840,0,1,842,2808570,2.80857
1240,4800,3640,17472000,2,9926,2483,1,223500800,223500800,3721,1240,2481,1240,0,1,1242,2328125,2.328125
1640,4800,3640,17472000,2,13126,3283,1,250508800,250508800,4921,1640,3281,1640,0,1,1642,5340051,5.340051
2040,4800,3640,17472000,2,16326,4083,1,277516800,277516800,6121,2040,4081,2040,0,1,2042,6601873,6.601873
2440,4800,3640,17472000,2,19526,4883,1,304524800,304524800,7321,2440,4881,2440,0,1,2442,5264888,5.264888
2840,4800,3640,17472000,2,22726,5683,1,331532800,331532800,8521,2840,5681,2840,0,1,2842,7813373,7.813373
3240,4800,3640,17472000,2,25926,6483,1,358540800,358540800,9721,3240,6481,3240,0,1,3242,1631990,1.63199
3640,4800,3640,17472000,2,29126,7283,1,385548800,385548800,10921,3640,7281,3640,0,1,3642,27655,0.027655
4040,4800,3640,17472000,2,32326,8083,1,412556800,412556800,12121,4040,8081,4040,0,1,4042,2655036,2.655036
4440,4800,3640,17472000,2,35526,8883,1,439564800,439564800,13321,4440,8881,4440,0,1,4442,5846297,5.846297
4840,4800,3640,17472000,2,38726,9683,1,466572800,466572800,14521,4840,9681,4840,0,1,4842,1813605,1.813605
5240,4800,3640,17472000,2,41926,10483,1,493580800,493580800,15721,5240,10481,5240,0,1,5242,5040133,5.040133
5640,4800,3640,17472000,2,45126,11283,1,520588800,520588800,16921,5640,11281,5640,0,1,5642,8186760,8.18676
6040,4800,3640,17472000,2,48326,12083,1,547596800,547596800,18121,6040,12081,6040,0,1,6042,6693151,6.693151
6440,4800,3640,17472000,2,51526,12883,1,574604800,574604800,19321,6440,12881,6440,0,1,6442,6806273,6.806273
6840,4800,3640,17472000,2,54726,13683,1,601612800,601612800,20521,6840,13681,6840,0,1,6842,4219769,4.219769
40,3050,5740,17507000,2,326,83,1,142868800,142868800,121,40,81,40,0,1,42,23515,0.023515
440,3050,5740,17507000,2,3526,883,1,170996800,170996800,1321,440,881,440,0,1,442,63465,0.063465
840,3050,5740,17507000,2,6726,1683,1,199124800,199124800,2521,840,1681,840,0,1,842,108106,0.108106
1240,3050,5740,17507000,2,9926,2483,1,227252800,227252800,3721,1240,2481,1240,0,1,1242,44431,0.044431
1640,3050,5740,17507000,2,13126,3283,1,255380800,255380800,4921,1640,3281,1640,0,1,1642,140061,0.140061
2040,3050,5740,17507000,2,16326,4083,1,283508800,283508800,6121,2040,4081,2040,0,1,2042,496131,0.496131
2440,3050,5740,17507000,2,19526,4883,1,311636800,311636800,7321,2440,4881,2440,0,1,2442,568973,0.568973
2840,3050,5740,17507000,2,22726,5683,1,339764800,339764800,8521,2840,5681,2840,0,1,2842,216735,0.216735
3240,3050,5740,17507000,2,25926,6483,1,367892800,367892800,9721,3240,6481,3240,0,1,3242,690732,0.690732
3640,3050,5740,17507000,2,29126,7283,1,396020800,396020800,10921,3640,7281,3640,0,1,3642,1932472,1.932472
4040,3050,5740,17507000,2,32326,8083,1,424148800,424148800,12121,4040,8081,4040,0,1,4042,1062382,1.062382
4440,3050,5740,17507000,2,35526,8883,1,452276800,452276800,13321,4440,8881,4440,0,1,4442,829340,0.82934
4840,3050,5740,17507000,2,38726,9683,1,480404800,480404800,14521,4840,9681,4840,0,1,4842,1884923,1.884923
5240,3050,5740,17507000,2,41926,10483,1,508532800,508532800,15721,5240,10481,5240,0,1,5242,757247,0.757247
5640,3050,5740,17507000,2,45126,11283,1,536660800,536660800,16921,5640,11281,5640,0,1,5642,520649,0.520649
6040,3050,5740,17507000,2,48326,12083,1,564788800,564788800,18121,6040,12081,6040,0,1,6042,2039523,2.039523
6440,3050,5740,17507000,2,51526,12883,1,592916800,592916800,19321,6440,12881,6440,0,1,6442,1051159,1.051159
6840,3050,5740,17507000,2,54726,13683,1,621044800,621044800,20521,6840,13681,6840,0,1,6842,1412389,1.412389
35,4950,3545,17547750,2,286,73,1,142760600,142760600,106,35,71,35,0,1,37,112823,0.112823
535,4950,3545,17547750,2,4286,1073,1,176740600,176740600,1606,535,1071,535,0,1,537,941541,0.941541
1035,4950,3545,17547750,2,8286,2073,1,210720600,210720600,3106,1035,2071,1035,0,1,1037,414814,0.414814
1535,4950,3545,17547750,2,12286,3073,1,244700600,244700600,4606,1535,3071,1535,0,1,1537,976433,0.976433
2035,4950,3545,17547750,2,16286,4073,1,278680600,278680600,6106,2035,4071,2035,0,1,2037,2051447,2.051447
2535,4950,3545,17547750,2,20286,5073,1,312660600,312660600,7606,2535,5071,2535,0,1,2537,2164721,2.164721
3035,4950,3545,17547750,2,24286,6073,1,346640600,346640600,9106,3035,6071,3035,0,1,3037,3658118,3.658118
3535,4950,3545,17547750,2,28286,7073,1,380620600,380620600,10606,3535,7071,3535,0,1,3537,1749787,1.749787
4035,4950,3545,17547750,2,32286,8073,1,414600600,414600600,12106,4035,8071,4035,0,1,4037,2014319,2.014319
4535,4950,3545,17547750,2,36286,9073,1,448580600,448580600,13606,4535,9071,4535,0,1,4537,1173039,1.173039
5035,4950,3545,17547750,2,40286,10073,1,482560600,482560600,15106,5035,10071,5035,0,1,5037,9972794,9.972794
5535,4950,3545,17547750,2,44286,11073,1,516540600,516540600,16606,5535,11071,5535,0,1,5537,6573677,6.573677
6035,4950,3545,17547750,2,48286,12073,1,550520600,550520600,18106,6035,12071,6035,0,1,6037,3944388,3.944388
6535,4950,3545,17547750,2,52286,13073,1,584500600,584500600,19606,6535,13071,6535,0,1,6537,5716916,5.716916
7035,4950,3545,17547750,2,56286,14073,1,618480600,618480600,21106,7035,14071,7035,0,1,7037,23783486,23.783486
55,4805,3665,17610325,2,446,113,1,144609400,144609400,166,55,111,55,0,1,57,362254,0.362254
455,4805,3665,17610325,2,3646,913,1,171713400,171713400,1366,455,911,455,0,1,457,1660683,1.660683
855,4805,3665,17610325,2,6846,1713,1,198817400,198817400,2566,855,1711,855,0,1,857,609588,0.609588
1255,4805,3665,17610325,2,10046,2513,1,225921400,225921400,3766,1255,2511,1255,0,1,1257,1054603,1.054603
1655,4805,3665,17610325,2,13246,3313,1,253025400,253025400,4966,1655,3311,1655,0,1,1657,5537271,5.537271
2055,4805,3665,17610325,2,16446,4113,1,280129400,280129400,6166,2055,4111,2055,0,1,2057,4315273,4.315273
2455,4805,3665,17610325,2,19646,4913,1,307233400,307233400,7366,2455,4911,2455,0,1,2457,2999914,2.999914
2855,4805,3665,17610325,2,22846,5713,1,334337400,334337400,8566,2855,5711,2855,0,1,2857,9492953,9.492953
3255,4805,3665,17610325,2,26046,6513,1,361441400,361441400,9766,3255,6511,3255,0,1,3257,2162141,2.162141
3655,4805,3665,17610325,2,29246,7313,1,388545400,388545400,10966,3655,7311,3655,0,1,3657,2104438,2.104438
4055,4805,3665,17610325,2,32446,8113,1,415649400,415649400,12166,4055,8111,4055,0,1,4057,40664,0.040664
4455,4805,3665,17610325,2,35646,8913,1,442753400,442753400,13366,4455,8911,4455,0,1,4457,10309468,10.309468
4855,4805,3665,17610325,2,38846,9713,1,469857400,469857400,14566,4855,9711,4855,0,1,4857,4359717,4.359717
5255,4805,3665,17610325,2,42046,10513,1,496961400,496961400,15766,5255,10511,5255,0,1,5257,6580967,6.580967
5655,4805,3665,17610325,2,45246,11313,1,524065400,524065400,16966,5655,11311,5655,0,1,5657,11115586,11.115586
6055,4805,3665,17610325,2,48446,12113,1,551169400,551169400,18166,6055,12111,6055,0,1,6057,2815463,2.815463
6455,4805,3665,17610325,2,51646,12913,1,578273400,578273400,19366,6455,12911,6455,0,1,6457,21203744,21.203744
6855,4805,3665,17610325,2,54846,13713,1,605377400,605377400,20566,6855,13711,6855,0,1,6857,16641789,16.641789
55,3055,5765,17612075,2,446,113,1,144777400,144777400,166,55,111,55,0,1,57,12596,0.012596
455,3055,5765,17612075,2,3646,913,1,173001400,173001400,1366,455,911,455,0,1,457,19696,0.019696
855,3055,5765,17612075,2,6846,1713,1,201225400,201225400,2566,855,1711,855,0,1,857,95439,0.095439
1255,3055,5765,17612075,2,10046,2513,1,229449400,229449400,3766,1255,2511,1255,0,1,1257,261628,0.261628
1655,3055,5765,17612075,2,13246,3313,1,257673400,257673400,4966,1655,3311,1655,0,1,1657,419673,0.419673
2055,3055,5765,17612075,2,16446,4113,1,285897400,285897400,6166,2055,4111,2055,0,1,2057,88300,0.0883
2455,3055,5765,17612075,2,19646,4913,1,314121400,314121400,7366,2455,4911,2455,0,1,2457,379278,0.379278
2855,3055,5765,17612075,2,22846,5713,1,342345400,342345400,8566,2855,5711,2855,0,1,2857,300049,0.300049
3255,3055,5765,17612075,2,26046,6513,1,370569400,370569400,9766,3255,6511,3255,0,1,3257,570782,0.570782
3655,3055,5765,17612075,2,29246,7313,1,398793400,398793400,10966,3655,7311,3655,0,1,3657,1150792,1.150792
4055,3055,5765,17612075,2,32446,8113,1,427017400,427017400,12166,4055,8111,4055,0,1,4057,929000,0.929
4455,3055,5765,17612075,2,35646,8913,1,455241400,455241400,13366,4455,8911,4455,0,1,4457,1223572,1.223572
4855,3055,5765,17612075,2,38846,9713,1,483465400,483465400,14566,4855,9711,4855,0,1,4857,32802,0.032802
5255,3055,5765,17612075,2,42046,10513,1,511689400,511689400,15766,5255,10511,5255,0,1,5257,204160,0.20416
5655,3055,5765,17612075,2,45246,11313,1,539913400,539913400,16966,5655,11311,5655,0,1,5657,253030,0.25303
6055,3055,5765,17612075,2,48446,12113,1,568137400,568137400,18166,6055,12111,6055,0,1,6057,1155828,1.155828
6455,3055,5765,17612075,2,51646,12913,1,596361400,596361400,19366,6455,12911,6455,0,1,6457,1403573,1.403573
6855,3055,5765,17612075,2,54846,13713,1,624585400,624585400,20566,6855,13711,6855,0,1,6857,569037,0.569037
40,5800,3040,17632000,2,326,83,1,143884800,143884800,121,40,81,40,0,1,42,12814,0.012814
440,5800,3040,17632000,2,3526,883,1,172172800,172172800,1321,440,881,440,0,1,442,96038,0.096038
840,5800,3040,17632000,2,6726,1683,1,200460800,200460800,2521,840,1681,840,0,1,842,108511,0.108511
1240,5800,3040,17632000,2,9926,2483,1,228748800,228748800,3721,1240,2481,1240,0,1,1242,465244,0.465244
1640,5800,3040,17632000,2,13126,3283,1,257036800,257036800,4921,1640,3281,1640,0,1,1642,90182,0.090182
2040,5800,3040,17632000,2,16326,4083,1,285324800,285324800,6121,2040,4081,2040,0,1,2042,418214,0.418214
2440,5800,3040,17632000,2,19526,4883,1,313612800,313612800,7321,2440,4881,2440,0,1,2442,772730,0.77273
2840,5800,3040,17632000,2,22726,5683,1,341900800,341900800,8521,2840,5681,2840,0,1,2842,1746275,1.746275
3240,5800,3040,17632000,2,25926,6483,1,370188800,370188800,9721,3240,6481,3240,0,1,3242,396621,0.396621
3640,5800,3040,17632000,2,29126,7283,1,398476800,398476800,10921,3640,7281,3640,0,1,3642,1883112,1.883112
4040,5800,3040,17632000,2,32326,8083,1,426764800,426764800,12121,4040,8081,4040,0,1,4042,2100469,2.100469
4440,5800,3040,17632000,2,35526,8883,1,455052800,455052800,13321,4440,8881,4440,0,1,4442,310906,0.310906
4840,5800,3040,17632000,2,38726,9683,1,483340800,483340800,14521,4840,9681,4840,0,1,4842,1930922,1.930922
5240,5800,3040,17632000,2,41926,10483,1,511628800,511628800,15721,5240,10481,5240,0,1,5242,2986793,2.986793
5640,5800,3040,17632000,2,45126,11283,1,539916800,539916800,16921,5640,11281,5640,0,1,5642,451925,0.451925
6040,5800,3040,17632000,2,48326,12083,1,568204800,568204800,18121,6040,12081,6040,0,1,6042,271352,0.271352
6440,5800,3040,17632000,2,51526,12883,1,596492800,596492800,19321,6440,12881,6440,0,1,6442,410868,0.410868
6840,5800,3040,17632000,2,54726,13683,1,624780800,624780800,20521,6840,13681,6840,0,1,6842,1567363,1.567363
39,3893,4541,17678113,2,318,81,1,144056312,144056312,118,39,79,39,0,1,41,309487,0.309487
539,3893,4541,17678113,2,4318,1081,1,177792312,177792312,1618,539,1079,539,0,1,541,1646177,1.646177
1039,3893,4541,17678113,2,8318,2081,1,211528312,211528312,3118,1039,2079,1039,0,1,1041,3696575,3.696575
1539,3893,4541,17678113,2,12318,3081,1,245264312,245264312,4618,1539,3079,1539,0,1,1541,2649476,2.649476
2039,3893,4541,17678113,2,16318,4081,1,279000312,279000312,6118,2039,4079,2039,0,1,2041,1434355,1.434355
2539,3893,4541,17678113,2,20318,5081,1,312736312,312736312,7618,2539,5079,2539,0,1,2541,5833076,5.833076
3039,3893,4541,17678113,2,24318,6081,1,346472312,346472312,9118,3039,6079,3039,0,1,3041,3046454,3.046454
3539,3893,4541,17678113,2,28318,7081,1,380208312,380208312,10618,3539,7079,3539,0,1,3541,4358131,4.358131
4039,3893,4541,17678113,2,32318,8081,1,413944312,413944312,12118,4039,8079,4039,0,1,4041,2954825,2.954825
4539,3893,4541,17678113,2,36318,9081,1,447680312,447680312,13618,4539,9079,4539,0,1,4541,7212716,7.212716
5039,3893,4541,17678113,2,40318,10081,1,481416312,481416312,15118,5039,10079,5039,0,1,5041,1798043,1.798043
5539,3893,4541,17678113,2,44318,11081,1,515152312,515152312,16618,5539,11079,5539,0,1,5541,13328557,13.328557
6039,3893,4541,17678113,2,48318,12081,1,548888312,548888312,18118,6039,12079,6039,0,1,6041,4355833,4.355833
6539,3893,4541,17678113,2,52318,13081,1,582624312,582624312,19618,6539,13079,6539,0,1,6541,4328228,4.328228
7039,3893,4541,17678113,2,56318,14081,1,616360312,616360312,21118,7039,14079,7039,0,1,7041,5341167,5.341167
39,4993,3541,17680213,2,318,81,1,144104312,144104312,118,39,79,39,0,1,41,311551,0.311551
539,4993,3541,17680213,2,4318,1081,1,178240312,178240312,1618,539,1079,539,0,1,541,541187,0.541187
1039,4993,3541,17680213,2,8318,2081,1,212376312,212376312,3118,1039,2079,1039,0,1,1041,3049741,3.049741
1539,4993,3541,17680213,2,12318,3081,1,246512312,246512312,4618,1539,3079,1539,0,1,1541,5191947,5.191947
2039,4993,3541,17680213,2,16318,4081,1,280648312,280648312,6118,2039,4079,2039,0,1,2041,1701237,1.701237
2539,4993,3541,17680213,2,20318,5081,1,314784312,314784312,7618,2539,5079,2539,0,1,2541,5745153,5.745153
3039,4993,3541,17680213,2,24318,6081,1,348920312,348920312,9118,3039,6079,3039,0,1,3041,759393,0.759393
3539,4993,3541,17680213,2,28318,7081,1,383056312,383056312,10618,3539,7079,3539,0,1,3541,976490,0.97649
4039,4993,3541,17680213,2,32318,8081,1,417192312,417192312,12118,4039,8079,4039,0,1,4041,13353720,13.35372
4539,4993,3541,17680213,2,36318,9081,1,451328312,451328312,13618,4539,9079,4539,0,1,4541,7138648,7.138648
5039,4993,3541,17680213,2,40318,10081,1,485464312,485464312,15118,5039,10079,5039,0,1,5041,6604564,6.604564
5539,4993,3541,17680213,2,44318,11081,1,519600312,519600312,16618,5539,11079,5539,0,1,5541,18301137,18.301137
6039,4993,3541,17680213,2,48318,12081,1,553736312,553736312,18118,6039,12079,6039,0,1,6041,19956832,19.956832
6539,4993,3541,17680213,2,52318,13081,1,587872312,587872312,19618,6539,13079,6539,0,1,6541,21730535,21.730535
7039,4993,3541,17680213,2,56318,14081,1,622008312,622008312,21118,7039,14079,7039,0,1,7041,23313607,23.313607
40,2550,6940,17697000,2,326,83,1,144612800,144612800,121,40,81,40,0,1,42,318141,0.318141
440,2550,6940,17697000,2,3526,883,1,174980800,174980800,1321,440,881,440,0,1,442,1590711,1.590711
840,2550,6940,17697000,2,6726,1683,1,205348800,205348800,2521,840,1681,840,0,1,842,916309,0.916309
1240,2550,6940,17697000,2,9926,2483,1,235716800,235716800,3721,1240,2481,1240,0,1,1242,1958518,1.958518
1640,2550,6940,17697000,2,13126,3283,1,266084800,266084800,4921,1640,3281,1640,0,1,1642,744104,0.744104
2040,2550,6940,17697000,2,16326,4083,1,296452800,296452800,6121,2040,4081,2040,0,1,2042,1188149,1.188149
2440,2550,6940,17697000,2,19526,4883,1,326820800,326820800,7321,2440,4881,2440,0,1,2442,1036594,1.036594
2840,2550,6940,17697000,2,22726,5683,1,357188800,357188800,8521,2840,5681,2840,0,1,2842,2170911,2.170911
3240,2550,6940,17697000,2,25926,6483,1,387556800,387556800,9721,3240,6481,3240,0,1,3242,489809,0.489809
3640,2550,6940,17697000,2,29126,7283,1,417924800,417924800,10921,3640,7281,3640,0,1,3642,3619559,3.619559
4040,2550,6940,17697000,2,32326,8083,1,448292800,448292800,12121,4040,8081,4040,0,1,4042,250513,0.250513
4440,2550,6940,17697000,2,35526,8883,1,478660800,478660800,13321,4440,8881,4440,0,1,4442,1187377,1.187377
4840,2550,6940,17697000,2,38726,9683,1,509028800,509028800,14521,4840,9681,4840,0,1,4842,650511,0.650511
5240,2550,6940,17697000,2,41926,10483,1,539396800,539396800,15721,5240,10481,5240,0,1,5242,100239,0.100239
5640,2550,6940,17697000,2,45126,11283,1,569764800,569764800,16921,5640,11281,5640,0,1,5642,1255599,1.255599
6040,2550,6940,17697000,2,48326,12083,1,600132800,600132800,18121,6040,12081,6040,0,1,6042,1577520,1.57752
6440,2550,6940,17697000,2,51526,12883,1,630500800,630500800,19321,6440,12881,6440,0,1,6442,282085,0.282085
6840,2550,6940,17697000,2,54726,13683,1,660868800,660868800,20521,6840,13681,6840,0,1,6842,3407356,3.407356
40,5300,3340,17702000,2,326,83,1,144380800,144380800,121,40,81,40,0,1,42,317374,0.317374
440,5300,3340,17702000,2,3526,883,1,172028800,172028800,1321,440,881,440,0,1,442,1634611,1.634611
840,5300,3340,17702000,2,6726,1683,1,199676800,199676800,2521,840,1681,840,0,1,842,2367481,2.367481
1240,5300,3340,17702000,2,9926,2483,1,227324800,227324800,3721,1240,2481,1240,0,1,1242,575486,0.575486
1640,5300,3340,17702000,2,13126,3283,1,254972800,254972800,4921,1640,3281,1640,0,1,1642,5480573,5.480573
2040,5300,3340,17702000,2,16326,4083,1,282620800,282620800,6121,2040,4081,2040,0,1,2042,843636,0.843636
2440,5300,3340,17702000,2,19526,4883,1,310268800,310268800,7321,2440,4881,2440,0,1,2442,830253,0.830253
2840,5300,3340,17702000,2,22726,5683,1,337916800,337916800,8521,2840,5681,2840,0,1,2842,1955995,1.955995
3240,5300,3340,17702000,2,25926,6483,1,365564800,365564800,9721,3240,6481,3240,0,1,3242,2413620,2.41362
3640,5300,3340,17702000,2,29126,7283,1,393212800,393212800,10921,3640,7281,3640,0,1,3642,1246441,1.246441
4040,5300,3340,17702000,2,32326,8083,1,420860800,420860800,12121,4040,8081,4040,0,1,4042,231406,0.231406
4440,5300,3340,17702000,2,35526,8883,1,448508800,448508800,13321,4440,8881,4440,0,1,4442,3178307,3.178307
4840,5300,3340,17702000,2,38726,9683,1,476156800,476156800,14521,4840,9681,4840,0,1,4842,1818156,1.818156
5240,5300,3340,17702000,2,41926,10483,1,503804800,503804800,15721,5240,10481,5240,0,1,5242,3279770,3.27977
5640,5300,3340,17702000,2,45126,11283,1,531452800,531452800,16921,5640,11281,5640,0,1,5642,1856206,1.856206
6040,5300,3340,17702000,2,48326,12083,1,559100800,559100800,18121,6040,12081,6040,0,1,6042,2035561,2.035561
6440,5300,3340,17702000,2,51526,12883,1,586748800,586748800,19321,6440,12881,6440,0,1,6442,1458998,1.458998
6840,5300,3340,17702000,2,54726,13683,1,614396800,614396800,20521,6840,13681,6840,0,1,6842,550921,0.550921
40,2800,6340,17752000,2,326,83,1,144940800,144940800,121,40,81,40,0,1,42,315340,0.31534
440,2800,6340,17752000,2,3526,883,1,174188800,174188800,1321,440,881,440,0,1,442,1087878,1.087878
840,2800,6340,17752000,2,6726,1683,1,203436800,203436800,2521,840,1681,840,0,1,842,892429,0.892429
1240,2800,6340,17752000,2,9926,2483,1,232684800,232684800,3721,1240,2481,1240,0,1,1242,473933,0.473933
1640,2800,6340,17752000,2,13126,3283,1,261932800,261932800,4921,1640,3281,1640,0,1,1642,1137509,1.137509
2040,2800,6340,17752000,2,16326,4083,1,291180800,291180800,6121,2040,4081,2040,0,1,2042,3383100,3.3831
2440,2800,6340,17752000,2,19526,4883,1,320428800,320428800,7321,2440,4881,2440,0,1,2442,21196,0.021196
2840,2800,6340,17752000,2,22726,5683,1,349676800,349676800,8521,2840,5681,2840,0,1,2842,890678,0.890678
3240,2800,6340,17752000,2,25926,6483,1,378924800,378924800,9721,3240,6481,3240,0,1,3242,3259569,3.259569
3640,2800,6340,17752000,2,29126,7283,1,408172800,408172800,10921,3640,7281,3640,0,1,3642,2543301,2.543301
4040,2800,6340,17752000,2,32326,8083,1,437420800,437420800,12121,4040,8081,4040,0,1,4042,43776,0.043776
4440,2800,6340,17752000,2,35526,8883,1,466668800,466668800,13321,4440,8881,4440,0,1,4442,305984,0.305984
4840,2800,6340,17752000,2,38726,9683,1,495916800,495916800,14521,4840,9681,4840,0,1,4842,2007147,2.007147
5240,2800,6340,17752000,2,41926,10483,1,525164800,525164800,15721,5240,10481,5240,0,1,5242,951412,0.951412
5640,2800,6340,17752000,2,45126,11283,1,554412800,554412800,16921,5640,11281,5640,0,1,5642,6615021,6.615021
6040,2800,6340,17752000,2,48326,12083,1,583660800,583660800,18121,6040,12081,6040,0,1,6042,5417066,5.417066
6440,2800,6340,17752000,2,51526,12883,1,612908800,612908800,19321,6440,12881,6440,0,1,6442,4060956,4.060956
6840,2800,6340,17752000,2,54726,13683,1,642156800,642156800,20521,6840,13681,6840,0,1,6842,7528577,7.528577
44,3903,4555,17778165,2,358,91,1,145202536,145202536,133,44,89,44,0,1,46,341416,0.341416
544,3903,4555,17778165,2,4358,1091,1,179034536,179034536,1633,544,1089,544,0,1,546,2013295,2.013295
1044,3903,4555,17778165,2,8358,2091,1,212866536,212866536,3133,1044,2089,1044,0,1,1046,3200064,3.200064
1544,3903,4555,17778165,2,12358,3091,1,246698536,246698536,4633,1544,3089,1544,0,1,1546,2593197,2.593197
2044,3903,4555,17778165,2,16358,4091,1,280530536,280530536,6133,2044,4089,2044,0,1,2046,2823910,2.82391
2544,3903,4555,17778165,2,20358,5091,1,314362536,314362536,7633,2544,5089,2544,0,1,2546,1661630,1.66163
3044,3903,4555,17778165,2,24358,6091,1,348194536,348194536,9133,3044,6089,3044,0,1,3046,383724,0.383724
3544,3903,4555,17778165,2,28358,7091,1,382026536,382026536,10633,3544,7089,3544,0,1,3546,114341,0.114341
4044,3903,4555,17778165,2,32358,8091,1,415858536,415858536,12133,4044,8089,4044,0,1,4046,87455,0.087455
4544,3903,4555,17778165,2,36358,9091,1,449690536,449690536,13633,4544,9089,4544,0,1,4546,5405225,5.405225
5044,3903,4555,17778165,2,40358,10091,1,483522536,483522536,15133,5044,10089,5044,0,1,5046,6438408,6.438408
5544,3903,4555,17778165,2,44358,11091,1,517354536,517354536,16633,5544,11089,5544,0,1,5546,2635487,2.635487
6044,3903,4555,17778165,2,48358,12091,1,551186536,551186536,18133,6044,12089,6044,0,1,6046,4068724,4.068724
6544,3903,4555,17778165,2,52358,13091,1,585018536,585018536,19633,6544,13089,6544,0,1,6546,655951,0.655951
7044,3903,4555,17778165,2,56358,14091,1,618850536,618850536,21133,7044,14089,7044,0,1,7046,3321133,3.321133
44,5003,3555,17785665,2,358,91,1,145297736,145297736,133,44,89,44,0,1,46,328431,0.328431
544,5003,3555,17785665,2,4358,1091,1,179529736,179529736,1633,544,1089,544,0,1,546,1944805,1.944805
1044,5003,3555,17785665,2,8358,2091,1,213761736,213761736,3133,1044,2089,1044,0,1,1046,2786806,2.786806
1544,5003,3555,17785665,2,12358,3091,1,247993736,247993736,4633,1544,3089,1544,0,1,1546,5243858,5.243858
2044,5003,3555,17785665,2,16358,4091,1,282225736,282225736,6133,2044,4089,2044,0,1,2046,6913062,6.913062
2544,5003,3555,17785665,2,20358,5091,1,316457736,316457736,7633,2544,5089,2544,0,1,2546,565182,0.565182
3044,5003,3555,17785665,2,24358,6091,1,350689736,350689736,9133,3044,6089,3044,0,1,3046,3714261,3.714261
3544,5003,3555,17785665,2,28358,7091,1,384921736,384921736,10633,3544,7089,3544,0,1,3546,2205416,2.205416
4044,5003,3555,17785665,2,32358,8091,1,419153736,419153736,12133,4044,8089,4044,0,1,4046,5188740,5.18874
4544,5003,3555,17785665,2,36358,9091,1,453385736,453385736,13633,4544,9089,4544,0,1,4546,1715543,1.715543
5044,5003,3555,17785665,2,40358,10091,1,487617736,487617736,15133,5044,10089,5044,0,1,5046,5451815,5.451815
5544,5003,3555,17785665,2,44358,11091,1,521849736,521849736,16633,5544,11089,5544,0,1,5546,15213515,15.213515
6044,5003,3555,17785665,2,48358,12091,1,556081736,556081736,18133,6044,12089,6044,0,1,6046,20245529,20.245529
6544,5003,3555,17785665,2,52358,13091,1,590313736,590313736,19633,6544,13089,6544,0,1,6546,21848204,21.848204
7044,5003,3555,17785665,2,56358,14091,1,624545736,624545736,21133,7044,14089,7044,0,1,7046,23524098,23.524098
55,5805,3065,17792325,2,446,113,1,146241400,146241400,166,55,111,55,0,1,57,23953,0.023953
455,5805,3065,17792325,2,3646,913,1,174625400,174625400,1366,455,911,455,0,1,457,21636,0.021636
855,5805,3065,17792325,2,6846,1713,1,203009400,203009400,2566,855,1711,855,0,1,857,92180,0.09218
1255,5805,3065,17792325,2,10046,2513,1,231393400,231393400,3766,1255,2511,1255,0,1,1257,79445,0.079445
1655,5805,3065,17792325,2,13246,3313,1,259777400,259777400,4966,1655,3311,1655,0,1,1657,166218,0.166218
2055,5805,3065,17792325,2,16446,4113,1,288161400,288161400,6166,2055,4111,2055,0,1,2057,314118,0.314118
2455,5805,3065,17792325,2,19646,4913,1,316545400,316545400,7366,2455,4911,2455,0,1,2457,260013,0.260013
2855,5805,3065,17792325,2,22846,5713,1,344929400,344929400,8566,2855,5711,2855,0,1,2857,521089,0.521089
3255,5805,3065,17792325,2,26046,6513,1,373313400,373313400,9766,3255,6511,3255,0,1,3257,125018,0.125018
3655,5805,3065,17792325,2,29246,7313,1,401697400,401697400,10966,3655,7311,3655,0,1,3657,1027220,1.02722
4055,5805,3065,17792325,2,32446,8113,1,430081400,430081400,12166,4055,8111,4055,0,1,4057,950129,0.950129
4455,5805,3065,17792325,2,35646,8913,1,458465400,458465400,13366,4455,8911,4455,0,1,4457,1011342,1.011342
4855,5805,3065,17792325,2,38846,9713,1,486849400,486849400,14566,4855,9711,4855,0,1,4857,1081768,1.081768
5255,5805,3065,17792325,2,42046,10513,1,515233400,515233400,15766,5255,10511,5255,0,1,5257,3021295,3.021295
5655,5805,3065,17792325,2,45246,11313,1,543617400,543617400,16966,5655,11311,5655,0,1,5657,1288096,1.288096
6055,5805,3065,17792325,2,48446,12113,1,572001400,572001400,18166,6055,12111,6055,0,1,6057,22732,0.022732
6455,5805,3065,17792325,2,51646,12913,1,600385400,600385400,19366,6455,12911,6455,0,1,6457,4267600,4.2676
6855,5805,3065,17792325,2,54846,13713,1,628769400,628769400,20566,6855,13711,6855,0,1,6857,1730494,1.730494
55,2555,6965,17795575,2,446,113,1,146553400,146553400,166,55,111,55,0,1,57,368820,0.36882
455,2555,6965,17795575,2,3646,913,1,177017400,177017400,1366,455,911,455,0,1,457,576342,0.576342
855,2555,6965,17795575,2,6846,1713,1,207481400,207481400,2566,855,1711,855,0,1,857,72225,0.072225
1255,2555,6965,17795575,2,10046,2513,1,237945400,237945400,3766,1255,2511,1255,0,1,1257,524265,0.524265
1655,2555,6965,17795575,2,13246,3313,1,268409400,268409400,4966,1655,3311,1655,0,1,1657,457788,0.457788
2055,2555,6965,17795575,2,16446,4113,1,298873400,298873400,6166,2055,4111,2055,0,1,2057,2021129,2.021129
2455,2555,6965,17795575,2,19646,4913,1,329337400,329337400,7366,2455,4911,2455,0,1,2457,2003353,2.003353
2855,2555,6965,17795575,2,22846,5713,1,359801400,359801400,8566,2855,5711,2855,0,1,2857,4275332,4.275332
3255,2555,6965,17795575,2,26046,6513,1,390265400,390265400,9766,3255,6511,3255,0,1,3257,1505090,1.50509
3655,2555,6965,17795575,2,29246,7313,1,420729400,420729400,10966,3655,7311,3655,0,1,3657,1076926,1.076926
4055,2555,6965,17795575,2,32446,8113,1,451193400,451193400,12166,4055,8111,4055,0,1,4057,1719369,1.719369
4455,2555,6965,17795575,2,35646,8913,1,481657400,481657400,13366,4455,8911,4455,0,1,4457,2435835,2.435835
4855,2555,6965,17795575,2,38846,9713,1,512121400,512121400,14566,4855,9711,4855,0,1,4857,3925000,3.925
5255,2555,6965,17795575,2,42046,10513,1,542585400,542585400,15766,5255,10511,5255,0,1,5257,1714511,1.714511
5655,2555,6965,17795575,2,45246,11313,1,573049400,573049400,16966,5655,11311,5655,0,1,5657,3120111,3.120111
6055,2555,6965,17795575,2,48446,12113,1,603513400,603513400,18166,6055,12111,6055,0,1,6057,3698521,3.698521
6455,2555,6965,17795575,2,51646,12913,1,633977400,633977400,19366,6455,12911,6455,0,1,6457,553437,0.553437
6855,2555,6965,17795575,2,54846,13713,1,664441400,664441400,20566,6855,13711,6855,0,1,6857,238865,0.238865
35,4400,4045,17798000,2,286,73,1,144748600,144748600,106,35,71,35,0,1,37,51830,0.05183
535,4400,4045,17798000,2,4286,1073,1,178528600,178528600,1606,535,1071,535,0,1,537,32907,0.032907
1035,4400,4045,17798000,2,8286,2073,1,212308600,212308600,3106,1035,2071,1035,0,1,1037,388740,0.38874
1535,4400,4045,17798000,2,12286,3073,1,246088600,246088600,4606,1535,3071,1535,0,1,1537,795737,0.795737
2035,4400,4045,17798000,2,16286,4073,1,279868600,279868600,6106,2035,4071,2035,0,1,2037,3556044,3.556044
2535,4400,4045,17798000,2,20286,5073,1,313648600,313648600,7606,2535,5071,2535,0,1,2537,83454,0.083454
3035,4400,4045,17798000,2,24286,6073,1,347428600,347428600,9106,3035,6071,3035,0,1,3037,1118024,1.118024
3535,4400,4045,17798000,2,28286,7073,1,381208600,381208600,10606,3535,7071,3535,0,1,3537,2331710,2.33171
4035,4400,4045,17798000,2,32286,8073,1,414988600,414988600,12106,4035,8071,4035,0,1,4037,1973840,1.97384
4535,4400,4045,17798000,2,36286,9073,1,448768600,448768600,13606,4535,9071,4535,0,1,4537,317785,0.317785
5035,4400,4045,17798000,2,40286,10073,1,482548600,482548600,15106,5035,10071,5035,0,1,5037,5574480,5.57448
5535,4400,4045,17798000,2,44286,11073,1,516328600,516328600,16606,5535,11071,5535,0,1,5537,1044631,1.044631
6035,4400,4045,17798000,2,48286,12073,1,550108600,550108600,18106,6035,12071,6035,0,1,6037,3686555,3.686555
6535,4400,4045,17798000,2,52286,13073,1,583888600,583888600,19606,6535,13071,6535,0,1,6537,4720950,4.72095
7035,4400,4045,17798000,2,56286,14073,1,617668600,617668600,21106,7035,14071,7035,0,1,7037,10605877,10.605877
55,5305,3365,17851325,2,446,113,1,146625400,146625400,166,55,111,55,0,1,57,357219,0.357219
455,5305,3365,17851325,2,3646,913,1,174369400,174369400,1366,455,911,455,0,1,457,253304,0.253304
855,5305,3365,17851325,2,6846,1713,1,202113400,202113400,2566,855,1711,855,0,1,857,493105,0.493105
1255,5305,3365,17851325,2,10046,2513,1,229857400,229857400,3766,1255,2511,1255,0,1,1257,668638,0.668638
1655,5305,3365,17851325,2,13246,3313,1,257601400,257601400,4966,1655,3311,1655,0,1,1657,1777946,1.777946
2055,5305,3365,17851325,2,16446,4113,1,285345400,285345400,6166,2055,4111,2055,0,1,2057,4634145,4.634145
2455,5305,3365,17851325,2,19646,4913,1,313089400,313089400,7366,2455,4911,2455,0,1,2457,332898,0.332898
2855,5305,3365,17851325,2,22846,5713,1,340833400,340833400,8566,2855,5711,2855,0,1,2857,5288316,5.288316
3255,5305,3365,17851325,2,26046,6513,1,368577400,368577400,9766,3255,6511,3255,0,1,3257,38356,0.038356
3655,5305,3365,17851325,2,29246,7313,1,396321400,396321400,10966,3655,7311,3655,0,1,3657,754533,0.754533
4055,5305,3365,17851325,2,32446,8113,1,424065400,424065400,12166,4055,8111,4055,0,1,4057,543579,0.543579
4455,5305,3365,17851325,2,35646,8913,1,451809400,451809400,13366,4455,8911,4455,0,1,4457,691359,0.691359
4855,5305,3365,17851325,2,38846,9713,1,479553400,479553400,14566,4855,9711,4855,0,1,4857,5761018,5.761018
5255,5305,3365,17851325,2,42046,10513,1,507297400,507297400,15766,5255,10511,5255,0,1,5257,7456073,7.456073
5655,5305,3365,17851325,2,45246,11313,1,535041400,535041400,16966,5655,11311,5655,0,1,5657,2767366,2.767366
6055,5305,3365,17851325,2,48446,12113,1,562785400,562785400,18166,6055,12111,6055,0,1,6057,609255,0.609255
6455,5305,3365,17851325,2,51646,12913,1,590529400,590529400,19366,6455,12911,6455,0,1,6457,1382843,1.382843
6855,5305,3365,17851325,2,54846,13713,1,618273400,618273400,20566,6855,13711,6855,0,1,6857,2942655,2.942655
55,2805,6365,17853825,2,446,113,1,146865400,146865400,166,55,111,55,0,1,57,356551,0.356551
455,2805,6365,17853825,2,3646,913,1,176209400,176209400,1366,455,911,455,0,1,457,1656211,1.656211
855,2805,6365,17853825,2,6846,1713,1,205553400,205553400,2566,855,1711,855,0,1,857,934062,0.934062
1255,2805,6365,17853825,2,10046,2513,1,234897400,234897400,3766,1255,2511,1255,0,1,1257,536873,0.536873
1655,2805,6365,17853825,2,13246,3313,1,264241400,264241400,4966,1655,3311,1655,0,1,1657,5583882,5.583882
2055,2805,6365,17853825,2,16446,4113,1,293585400,293585400,6166,2055,4111,2055,0,1,2057,3545236,3.545236
2455,2805,6365,17853825,2,19646,4913,1,322929400,322929400,7366,2455,4911,2455,0,1,2457,272182,0.272182
2855,2805,6365,17853825,2,22846,5713,1,352273400,352273400,8566,2855,5711,2855,0,1,2857,4097187,4.097187
3255,2805,6365,17853825,2,26046,6513,1,381617400,381617400,9766,3255,6511,3255,0,1,3257,207420,0.20742
3655,2805,6365,17853825,2,29246,7313,1,410961400,410961400,10966,3655,7311,3655,0,1,3657,4924664,4.924664
4055,2805,6365,17853825,2,32446,8113,1,440305400,440305400,12166,4055,8111,4055,0,1,4057,2471553,2.471553
4455,2805,6365,17853825,2,35646,8913,1,469649400,469649400,13366,4455,8911,4455,0,1,4457,1955905,1.955905
4855,2805,6365,17853825,2,38846,9713,1,498993400,498993400,14566,4855,9711,4855,0,1,4857,2075988,2.075988
5255,2805,6365,17853825,2,42046,10513,1,528337400,528337400,15766,5255,10511,5255,0,1,5257,2634745,2.634745
5655,2805,6365,17853825,2,45246,11313,1,557681400,557681400,16966,5655,11311,5655,0,1,5657,195588,0.195588
6055,2805,6365,17853825,2,48446,12113,1,587025400,587025400,18166,6055,12111,6055,0,1,6057,631394,0.631394
6455,2805,6365,17853825,2,51646,12913,1,616369400,616369400,19366,6455,12911,6455,0,1,6457,12227819,12.227819
6855,2805,6365,17853825,2,54846,13713,1,645713400,645713400,20566,6855,13711,6855,0,1,6857,393232,0.393232
40,4550,3940,17927000,2,326,83,1,146132800,146132800,121,40,81,40,0,1,42,325960,0.32596
440,4550,3940,17927000,2,3526,883,1,173300800,173300800,1321,440,881,440,0,1,442,259479,0.259479
840,4550,3940,17927000,2,6726,1683,1,200468800,200468800,2521,840,1681,840,0,1,842,1214355,1.214355
1240,4550,3940,17927000,2,9926,2483,1,227636800,227636800,3721,1240,2481,1240,0,1,1242,618826,0.618826
1640,4550,3940,17927000,2,13126,3283,1,254804800,254804800,4921,1640,3281,1640,0,1,1642,101091,0.101091
2040,4550,3940,17927000,2,16326,4083,1,281972800,281972800,6121,2040,4081,2040,0,1,2042,1297723,1.297723
2440,4550,3940,17927000,2,19526,4883,1,309140800,309140800,7321,2440,4881,2440,0,1,2442,2684320,2.68432
2840,4550,3940,17927000,2,22726,5683,1,336308800,336308800,8521,2840,5681,2840,0,1,2842,1104872,1.104872
3240,4550,3940,17927000,2,25926,6483,1,363476800,363476800,9721,3240,6481,3240,0,1,3242,1964523,1.964523
3640,4550,3940,17927000,2,29126,7283,1,390644800,390644800,10921,3640,7281,3640,0,1,3642,2119451,2.119451
4040,4550,3940,17927000,2,32326,8083,1,417812800,417812800,12121,4040,8081,4040,0,1,4042,12620617,12.620617
4440,4550,3940,17927000,2,35526,8883,1,444980800,444980800,13321,4440,8881,4440,0,1,4442,313591,0.313591
4840,4550,3940,17927000,2,38726,9683,1,472148800,472148800,14521,4840,9681,4840,0,1,4842,2507215,2.507215
5240,4550,3940,17927000,2,41926,10483,1,499316800,499316800,15721,5240,10481,5240,0,1,5242,1062644,1.062644
5640,4550,3940,17927000,2,45126,11283,1,526484800,526484800,16921,5640,11281,5640,0,1,5642,708440,0.70844
6040,4550,3940,17927000,2,48326,12083,1,553652800,553652800,18121,6040,12081,6040,0,1,6042,5060652,5.060652
6440,4550,3940,17927000,2,51526,12883,1,580820800,580820800,19321,6440,12881,6440,0,1,6442,5324704,5.324704
6840,4550,3940,17927000,2,54726,13683,1,607988800,607988800,20521,6840,13681,6840,0,1,6842,433396,0.433396
40,6550,2740,17947000,2,326,83,1,146548800,146548800,121,40,81,40,0,1,42,13097,0.013097
440,6550,2740,17947000,2,3526,883,1,176276800,176276800,1321,440,881,440,0,1,442,95144,0.095144
840,6550,2740,17947000,2,6726,1683,1,206004800,206004800,2521,840,1681,840,0,1,842,92967,0.092967
1240,6550,2740,17947000,2,9926,2483,1,235732800,235732800,3721,1240,2481,1240,0,1,1242,68358,0.068358
1640,6550,2740,17947000,2,13126,3283,1,265460800,265460800,4921,1640,3281,1640,0,1,1642,16652,0.016652
2040,6550,2740,17947000,2,16326,4083,1,295188800,295188800,6121,2040,4081,2040,0,1,2042,1461237,1.461237
2440,6550,2740,17947000,2,19526,4883,1,324916800,324916800,7321,2440,4881,2440,0,1,2442,1983908,1.983908
2840,6550,2740,17947000,2,22726,5683,1,354644800,354644800,8521,2840,5681,2840,0,1,2842,1136549,1.136549
3240,6550,2740,17947000,2,25926,6483,1,384372800,384372800,9721,3240,6481,3240,0,1,3242,2267899,2.267899
3640,6550,2740,17947000,2,29126,7283,1,414100800,414100800,10921,3640,7281,3640,0,1,3642,1014465,1.014465
4040,6550,2740,17947000,2,32326,8083,1,443828800,443828800,12121,4040,8081,4040,0,1,4042,193239,0.193239
4440,6550,2740,17947000,2,35526,8883,1,473556800,473556800,13321,4440,8881,4440,0,1,4442,801920,0.80192
4840,6550,2740,17947000,2,38726,9683,1,503284800,503284800,14521,4840,9681,4840,0,1,4842,349816,0.349816
5240,6550,2740,17947000,2,41926,10483,1,533012800,533012800,15721,5240,10481,5240,0,1,5242,240008,0.240008
5640,6550,2740,17947000,2,45126,11283,1,562740800,562740800,16921,5640,11281,5640,0,1,5642,139084,0.139084
6040,6550,2740,17947000,2,48326,12083,1,592468800,592468800,18121,6040,12081,6040,0,1,6042,2532219,2.532219
6440,6550,2740,17947000,2,51526,12883,1,622196800,622196800,19321,6440,12881,6440,0,1,6442,1541322,1.541322
6840,6550,2740,17947000,2,54726,13683,1,651924800,651924800,20521,6840,13681,6840,0,1,6842,1052760,1.05276
40,3300,5440,17952000,2,326,83,1,146412800,146412800,121,40,81,40,0,1,42,315829,0.315829
440,3300,5440,17952000,2,3526,883,1,174380800,174380800,1321,440,881,440,0,1,442,689593,0.689593
840,3300,5440,17952000,2,6726,1683,1,202348800,202348800,2521,840,1681,840,0,1,842,2918972,2.918972
1240,3300,5440,17952000,2,9926,2483,1,230316800,230316800,3721,1240,2481,1240,0,1,1242,998400,0.9984
1640,3300,5440,17952000,2,13126,3283,1,258284800,258284800,4921,1640,3281,1640,0,1,1642,233775,0.233775
2040,3300,5440,17952000,2,16326,4083,1,286252800,286252800,6121,2040,4081,2040,0,1,2042,1957370,1.95737
2440,3300,5440,17952000,2,19526,4883,1,314220800,314220800,7321,2440,4881,2440,0,1,2442,1962642,1.962642
2840,3300,5440,17952000,2,22726,5683,1,342188800,342188800,8521,2840,5681,2840,0,1,2842,1021926,1.021926
3240,3300,5440,17952000,2,25926,6483,1,370156800,370156800,9721,3240,6481,3240,0,1,3242,1480902,1.480902
3640,3300,5440,17952000,2,29126,7283,1,398124800,398124800,10921,3640,7281,3640,0,1,3642,793953,0.793953
4040,3300,5440,17952000,2,32326,8083,1,426092800,426092800,12121,4040,8081,4040,0,1,4042,932860,0.93286
4440,3300,5440,17952000,2,35526,8883,1,454060800,454060800,13321,4440,8881,4440,0,1,4442,1349775,1.349775
4840,3300,5440,17952000,2,38726,9683,1,482028800,482028800,14521,4840,9681,4840,0,1,4842,325725,0.325725
5240,3300,5440,17952000,2,41926,10483,1,509996800,509996800,15721,5240,10481,5240,0,1,5242,1315069,1.315069
5640,3300,5440,17952000,2,45126,11283,1,537964800,537964800,16921,5640,11281,5640,0,1,5642,2110850,2.11085
6040,3300,5440,17952000,2,48326,12083,1,565932800,565932800,18121,6040,12081,6040,0,1,6042,123242,0.123242
6440,3300,5440,17952000,2,51526,12883,1,593900800,593900800,19321,6440,12881,6440,0,1,6442,1056472,1.056472
6840,3300,5440,17952000,2,54726,13683,1,621868800,621868800,20521,6840,13681,6840,0,1,6842,4713887,4.713887
39,4443,4041,17954163,2,318,81,1,146280312,146280312,118,39,79,39,0,1,41,33412,0.033412
539,4443,4041,17954163,2,4318,1081,1,180216312,180216312,1618,539,1079,539,0,1,541,74783,0.074783
1039,4443,4041,17954163,2,8318,2081,1,214152312,214152312,3118,1039,2079,1039,0,1,1041,12817,0.012817
1539,4443,4041,17954163,2,12318,3081,1,248088312,248088312,4618,1539,3079,1539,0,1,1541,133168,0.133168
2039,4443,4041,17954163,2,16318,4081,1,282024312,282024312,6118,2039,4079,2039,0,1,2041,733151,0.733151
2539,4443,4041,17954163,2,20318,5081,1,315960312,315960312,7618,2539,5079,2539,0,1,2541,174917,0.174917
3039,4443,4041,17954163,2,24318,6081,1,349896312,349896312,9118,3039,6079,3039,0,1,3041,849252,0.849252
3539,4443,4041,17954163,2,28318,7081,1,383832312,383832312,10618,3539,7079,3539,0,1,3541,85467,0.085467
4039,4443,4041,17954163,2,32318,8081,1,417768312,417768312,12118,4039,8079,4039,0,1,4041,176983,0.176983
4539,4443,4041,17954163,2,36318,9081,1,451704312,451704312,13618,4539,9079,4539,0,1,4541,244639,0.244639
5039,4443,4041,17954163,2,40318,10081,1,485640312,485640312,15118,5039,10079,5039,0,1,5041,1854479,1.854479
5539,4443,4041,17954163,2,44318,11081,1,519576312,519576312,16618,5539,11079,5539,0,1,5541,1583898,1.583898
6039,4443,4041,17954163,2,48318,12081,1,553512312,553512312,18118,6039,12079,6039,0,1,6041,7353654,7.353654
6539,4443,4041,17954163,2,52318,13081,1,587448312,587448312,19618,6539,13079,6539,0,1,6541,497331,0.497331
7039,4443,4041,17954163,2,56318,14081,1,621384312,621384312,21118,7039,14079,7039,0,1,7041,2572184,2.572184
35,4440,4045,17959800,2,286,73,1,146054200,146054200,106,35,71,35,0,1,37,313783,0.313783
535,4440,4045,17959800,2,4286,1073,1,179994200,179994200,1606,535,1071,535,0,1,537,1922122,1.922122
1035,4440,4045,17959800,2,8286,2073,1,213934200,213934200,3106,1035,2071,1035,0,1,1037,3558472,3.558472
1535,4440,4045,17959800,2,12286,3073,1,247874200,247874200,4606,1535,3071,1535,0,1,1537,5277713,5.277713
2035,4440,4045,17959800,2,16286,4073,1,281814200,281814200,6106,2035,4071,2035,0,1,2037,6974087,6.974087
44,4453,4055,18056915,2,358,91,1,147450136,147450136,133,44,89,44,0,1,46,50179,0.050179
544,4453,4055,18056915,2,4358,1091,1,181482136,181482136,1633,544,1089,544,0,1,546,282806,0.282806
1044,4453,4055,18056915,2,8358,2091,1,215514136,215514136,3133,1044,2089,1044,0,1,1046,27536,0.027536
1544,4453,4055,18056915,2,12358,3091,1,249546136,249546136,4633,1544,3089,1544,0,1,1546,400593,0.400593
2044,4453,4055,18056915,2,16358,4091,1,283578136,283578136,6133,2044,4089,2044,0,1,2046,298325,0.298325
2544,4453,4055,18056915,2,20358,5091,1,317610136,317610136,7633,2544,5089,2544,0,1,2546,559225,0.559225
3044,4453,4055,18056915,2,24358,6091,1,351642136,351642136,9133,3044,6089,3044,0,1,3046,1526653,1.526653
3544,4453,4055,18056915,2,28358,7091,1,385674136,385674136,10633,3544,7089,3544,0,1,3546,1689228,1.689228
4044,4453,4055,18056915,2,32358,8091,1,419706136,419706136,12133,4044,8089,4044,0,1,4046,992090,0.99209
4544,4453,4055,18056915,2,36358,9091,1,453738136,453738136,13633,4544,9089,4544,0,1,4546,246835,0.246835
5044,4453,4055,18056915,2,40358,10091,1,487770136,487770136,15133,5044,10089,5044,0,1,5046,2870320,2.87032
5544,4453,4055,18056915,2,44358,11091,1,521802136,521802136,16633,5544,11089,5544,0,1,5546,28619,0.028619
6044,4453,4055,18056915,2,48358,12091,1,555834136,555834136,18133,6044,12089,6044,0,1,6046,897377,0.897377
6544,4453,4055,18056915,2,52358,13091,1,589866136,589866136,19633,6544,13089,6544,0,1,6546,223591,0.223591
7044,4453,4055,18056915,2,56358,14091,1,623898136,623898136,21133,7044,14089,7044,0,1,7046,1118300,1.1183
55,4555,3965,18060575,2,446,113,1,148233400,148233400,166,55,111,55,0,1,57,368332,0.368332
455,4555,3965,18060575,2,3646,913,1,175497400,175497400,1366,455,911,455,0,1,457,1681441,1.681441
855,4555,3965,18060575,2,6846,1713,1,202761400,202761400,2566,855,1711,855,0,1,857,3022347,3.022347
1255,4555,3965,18060575,2,10046,2513,1,230025400,230025400,3766,1255,2511,1255,0,1,1257,192092,0.192092
1655,4555,3965,18060575,2,13246,3313,1,257289400,257289400,4966,1655,3311,1655,0,1,1657,2784689,2.784689
2055,4555,3965,18060575,2,16446,4113,1,284553400,284553400,6166,2055,4111,2055,0,1,2057,1772753,1.772753
2455,4555,3965,18060575,2,19646,4913,1,311817400,311817400,7366,2455,4911,2455,0,1,2457,1228169,1.228169
2855,4555,3965,18060575,2,22846,5713,1,339081400,339081400,8566,2855,5711,2855,0,1,2857,3450542,3.450542
3255,4555,3965,18060575,2,26046,6513,1,366345400,366345400,9766,3255,6511,3255,0,1,3257,11059256,11.059256
3655,4555,3965,18060575,2,29246,7313,1,393609400,393609400,10966,3655,7311,3655,0,1,3657,514886,0.514886
4055,4555,3965,18060575,2,32446,8113,1,420873400,420873400,12166,4055,8111,4055,0,1,4057,8505015,8.505015
4455,4555,3965,18060575,2,35646,8913,1,448137400,448137400,13366,4455,8911,4455,0,1,4457,874996,0.874996
4855,4555,3965,18060575,2,38846,9713,1,475401400,475401400,14566,4855,9711,4855,0,1,4857,332402,0.332402
5255,4555,3965,18060575,2,42046,10513,1,502665400,502665400,15766,5255,10511,5255,0,1,5257,1294736,1.294736
5655,4555,3965,18060575,2,45246,11313,1,529929400,529929400,16966,5655,11311,5655,0,1,5657,1751542,1.751542
6055,4555,3965,18060575,2,48446,12113,1,557193400,557193400,18166,6055,12111,6055,0,1,6057,764493,0.764493
6455,4555,3965,18060575,2,51646,12913,1,584457400,584457400,19366,6455,12911,6455,0,1,6457,665021,0.665021
6855,4555,3965,18060575,2,54846,13713,1,611721400,611721400,20566,6855,13711,6855,0,1,6857,7561737,7.561737
55,3305,5465,18061825,2,446,113,1,148353400,148353400,166,55,111,55,0,1,57,97591,0.097591
455,3305,5465,18061825,2,3646,913,1,176417400,176417400,1366,455,911,455,0,1,457,1735590,1.73559
855,3305,5465,18061825,2,6846,1713,1,204481400,204481400,2566,855,1711,855,0,1,857,3111899,3.111899
1255,3305,5465,18061825,2,10046,2513,1,232545400,232545400,3766,1255,2511,1255,0,1,1257,4497045,4.497045
1655,3305,5465,18061825,2,13246,3313,1,260609400,260609400,4966,1655,3311,1655,0,1,1657,2744835,2.744835
2055,3305,5465,18061825,2,16446,4113,1,288673400,288673400,6166,2055,4111,2055,0,1,2057,818043,0.818043
2455,3305,5465,18061825,2,19646,4913,1,316737400,316737400,7366,2455,4911,2455,0,1,2457,1515980,1.51598
2855,3305,5465,18061825,2,22846,5713,1,344801400,344801400,8566,2855,5711,2855,0,1,2857,4479765,4.479765
3255,3305,5465,18061825,2,26046,6513,1,372865400,372865400,9766,3255,6511,3255,0,1,3257,1297594,1.297594
3655,3305,5465,18061825,2,29246,7313,1,400929400,400929400,10966,3655,7311,3655,0,1,3657,474900,0.4749
4055,3305,5465,18061825,2,32446,8113,1,428993400,428993400,12166,4055,8111,4055,0,1,4057,1154337,1.154337
4455,3305,5465,18061825,2,35646,8913,1,457057400,457057400,13366,4455,8911,4455,0,1,4457,424911,0.424911
4855,3305,5465,18061825,2,38846,9713,1,485121400,485121400,14566,4855,9711,4855,0,1,4857,2792982,2.792982
5255,3305,5465,18061825,2,42046,10513,1,513185400,513185400,15766,5255,10511,5255,0,1,5257,139834,0.139834
5655,3305,5465,18061825,2,45246,11313,1,541249400,541249400,16966,5655,11311,5655,0,1,5657,3189192,3.189192
6055,3305,5465,18061825,2,48446,12113,1,569313400,569313400,18166,6055,12111,6055,0,1,6057,3504539,3.504539
6455,3305,5465,18061825,2,51646,12913,1,597377400,597377400,19366,6455,12911,6455,0,1,6457,1826270,1.82627
6855,3305,5465,18061825,2,54846,13713,1,625441400,625441400,20566,6855,13711,6855,0,1,6857,4060589,4.060589
55,6555,2765,18124575,2,446,113,1,149097400,149097400,166,55,111,55,0,1,57,76647,0.076647
455,6555,2765,18124575,2,3646,913,1,178921400,178921400,1366,455,911,455,0,1,457,97835,0.097835
855,6555,2765,18124575,2,6846,1713,1,208745400,208745400,2566,855,1711,855,0,1,857,110331,0.110331
1255,6555,2765,18124575,2,10046,2513,1,238569400,238569400,3766,1255,2511,1255,0,1,1257,152934,0.152934
1655,6555,2765,18124575,2,13246,3313,1,268393400,268393400,4966,1655,3311,1655,0,1,1657,38094,0.038094
2055,6555,2765,18124575,2,16446,4113,1,298217400,298217400,6166,2055,4111,2055,0,1,2057,684071,0.684071
2455,6555,2765,18124575,2,19646,4913,1,328041400,328041400,7366,2455,4911,2455,0,1,2457,250038,0.250038
2855,6555,2765,18124575,2,22846,5713,1,357865400,357865400,8566,2855,5711,2855,0,1,2857,239981,0.239981
3255,6555,2765,18124575,2,26046,6513,1,387689400,387689400,9766,3255,6511,3255,0,1,3257,632898,0.632898
3655,6555,2765,18124575,2,29246,7313,1,417513400,417513400,10966,3655,7311,3655,0,1,3657,343608,0.343608
4055,6555,2765,18124575,2,32446,8113,1,447337400,447337400,12166,4055,8111,4055,0,1,4057,1036102,1.036102
4455,6555,2765,18124575,2,35646,8913,1,477161400,477161400,13366,4455,8911,4455,0,1,4457,923574,0.923574
4855,6555,2765,18124575,2,38846,9713,1,506985400,506985400,14566,4855,9711,4855,0,1,4857,89684,0.089684
5255,6555,2765,18124575,2,42046,10513,1,536809400,536809400,15766,5255,10511,5255,0,1,5257,240527,0.240527
5655,6555,2765,18124575,2,45246,11313,1,566633400,566633400,16966,5655,11311,5655,0,1,5657,1141348,1.141348
6055,6555,2765,18124575,2,48446,12113,1,596457400,596457400,18166,6055,12111,6055,0,1,6057,1797580,1.79758
6455,6555,2765,18124575,2,51646,12913,1,626281400,626281400,19366,6455,12911,6455,0,1,6457,4547414,4.547414
6855,6555,2765,18124575,2,54846,13713,1,656105400,656105400,20566,6855,13711,6855,0,1,6857,1795404,1.795404
40,4300,4240,18232000,2,326,83,1,148588800,148588800,121,40,81,40,0,1,42,322346,0.322346
440,4300,4240,18232000,2,3526,883,1,175916800,175916800,1321,440,881,440,0,1,442,1592227,1.592227
840,4300,4240,18232000,2,6726,1683,1,203244800,203244800,2521,840,1681,840,0,1,842,54235,0.054235
1240,4300,4240,18232000,2,9926,2483,1,230572800,230572800,3721,1240,2481,1240,0,1,1242,2386800,2.3868
1640,4300,4240,18232000,2,13126,3283,1,257900800,257900800,4921,1640,3281,1640,0,1,1642,39019,0.039019
2040,4300,4240,18232000,2,16326,4083,1,285228800,285228800,6121,2040,4081,2040,0,1,2042,3704593,3.704593
2440,4300,4240,18232000,2,19526,4883,1,312556800,312556800,7321,2440,4881,2440,0,1,2442,1648635,1.648635
2840,4300,4240,18232000,2,22726,5683,1,339884800,339884800,8521,2840,5681,2840,0,1,2842,1204022,1.204022
3240,4300,4240,18232000,2,25926,6483,1,367212800,367212800,9721,3240,6481,3240,0,1,3242,1621501,1.621501
3640,4300,4240,18232000,2,29126,7283,1,394540800,394540800,10921,3640,7281,3640,0,1,3642,644030,0.64403
4040,4300,4240,18232000,2,32326,8083,1,421868800,421868800,12121,4040,8081,4040,0,1,4042,590252,0.590252
4440,4300,4240,18232000,2,35526,8883,1,449196800,449196800,13321,4440,8881,4440,0,1,4442,1012517,1.012517
4840,4300,4240,18232000,2,38726,9683,1,476524800,476524800,14521,4840,9681,4840,0,1,4842,376707,0.376707
5240,4300,4240,18232000,2,41926,10483,1,503852800,503852800,15721,5240,10481,5240,0,1,5242,3152673,3.152673
5640,4300,4240,18232000,2,45126,11283,1,531180800,531180800,16921,5640,11281,5640,0,1,5642,1763327,1.763327
6040,4300,4240,18232000,2,48326,12083,1,558508800,558508800,18121,6040,12081,6040,0,1,6042,1056207,1.056207
6440,4300,4240,18232000,2,51526,12883,1,585836800,585836800,19321,6440,12881,6440,0,1,6442,1054937,1.054937
6840,4300,4240,18232000,2,54726,13683,1,613164800,613164800,20521,6840,13681,6840,0,1,6842,3813568,3.813568
40,3550,5140,18247000,2,326,83,1,148756800,148756800,121,40,81,40,0,1,42,320457,0.320457
440,3550,5140,18247000,2,3526,883,1,176564800,176564800,1321,440,881,440,0,1,442,1677406,1.677406
840,3550,5140,18247000,2,6726,1683,1,204372800,204372800,2521,840,1681,840,0,1,842,3047631,3.047631
1240,3550,5140,18247000,2,9926,2483,1,232180800,232180800,3721,1240,2481,1240,0,1,1242,928201,0.928201
1640,3550,5140,18247000,2,13126,3283,1,259988800,259988800,4921,1640,3281,1640,0,1,1642,4959734,4.959734
2040,3550,5140,18247000,2,16326,4083,1,287796800,287796800,6121,2040,4081,2040,0,1,2042,615246,0.615246
2440,3550,5140,18247000,2,19526,4883,1,315604800,315604800,7321,2440,4881,2440,0,1,2442,62550,0.06255
2840,3550,5140,18247000,2,22726,5683,1,343412800,343412800,8521,2840,5681,2840,0,1,2842,3349724,3.349724
3240,3550,5140,18247000,2,25926,6483,1,371220800,371220800,9721,3240,6481,3240,0,1,3242,260316,0.260316
3640,3550,5140,18247000,2,29126,7283,1,399028800,399028800,10921,3640,7281,3640,0,1,3642,2403976,2.403976
4040,3550,5140,18247000,2,32326,8083,1,426836800,426836800,12121,4040,8081,4040,0,1,4042,295816,0.295816
4440,3550,5140,18247000,2,35526,8883,1,454644800,454644800,13321,4440,8881,4440,0,1,4442,1131034,1.131034
4840,3550,5140,18247000,2,38726,9683,1,482452800,482452800,14521,4840,9681,4840,0,1,4842,117289,0.117289
5240,3550,5140,18247000,2,41926,10483,1,510260800,510260800,15721,5240,10481,5240,0,1,5242,662906,0.662906
5640,3550,5140,18247000,2,45126,11283,1,538068800,538068800,16921,5640,11281,5640,0,1,5642,1629554,1.629554
6040,3550,5140,18247000,2,48326,12083,1,565876800,565876800,18121,6040,12081,6040,0,1,6042,989854,0.989854
6440,3550,5140,18247000,2,51526,12883,1,593684800,593684800,19321,6440,12881,6440,0,1,6442,2999073,2.999073
6840,3550,5140,18247000,2,54726,13683,1,621492800,621492800,20521,6840,13681,6840,0,1,6842,3401481,3.401481
39,2793,6541,18269013,2,318,81,1,149064312,149064312,118,39,79,39,0,1,41,329062,0.329062
539,2793,6541,18269013,2,4318,1081,1,186400312,186400312,1618,539,1079,539,0,1,541,838576,0.838576
1039,2793,6541,18269013,2,8318,2081,1,223736312,223736312,3118,1039,2079,1039,0,1,1041,1356470,1.35647
1539,2793,6541,18269013,2,12318,3081,1,261072312,261072312,4618,1539,3079,1539,0,1,1541,350010,0.35001
2039,2793,6541,18269013,2,16318,4081,1,298408312,298408312,6118,2039,4079,2039,0,1,2041,1927588,1.927588
2539,2793,6541,18269013,2,20318,5081,1,335744312,335744312,7618,2539,5079,2539,0,1,2541,111977,0.111977
3039,2793,6541,18269013,2,24318,6081,1,373080312,373080312,9118,3039,6079,3039,0,1,3041,2970152,2.970152
3539,2793,6541,18269013,2,28318,7081,1,410416312,410416312,10618,3539,7079,3539,0,1,3541,2699905,2.699905
4039,2793,6541,18269013,2,32318,8081,1,447752312,447752312,12118,4039,8079,4039,0,1,4041,5756297,5.756297
4539,2793,6541,18269013,2,36318,9081,1,485088312,485088312,13618,4539,9079,4539,0,1,4541,213952,0.213952
5039,2793,6541,18269013,2,40318,10081,1,522424312,522424312,15118,5039,10079,5039,0,1,5041,66642,0.066642
5539,2793,6541,18269013,2,44318,11081,1,559760312,559760312,16618,5539,11079,5539,0,1,5541,6651998,6.651998
6039,2793,6541,18269013,2,48318,12081,1,597096312,597096312,18118,6039,12079,6039,0,1,6041,166434,0.166434
6539,2793,6541,18269013,2,52318,13081,1,634432312,634432312,19618,6539,13079,6539,0,1,6541,2114690,2.11469
7039,2793,6541,18269013,2,56318,14081,1,671768312,671768312,21118,7039,14079,7039,0,1,7041,4149740,4.14974
55,4305,4265,18360825,2,446,113,1,150657400,150657400,166,55,111,55,0,1,57,319562,0.319562
455,4305,4265,18360825,2,3646,913,1,178081400,178081400,1366,455,911,455,0,1,457,192605,0.192605
855,4305,4265,18360825,2,6846,1713,1,205505400,205505400,2566,855,1711,855,0,1,857,561560,0.56156
1255,4305,4265,18360825,2,10046,2513,1,232929400,232929400,3766,1255,2511,1255,0,1,1257,152258,0.152258
1655,4305,4265,18360825,2,13246,3313,1,260353400,260353400,4966,1655,3311,1655,0,1,1657,1314653,1.314653
2055,4305,4265,18360825,2,16446,4113,1,287777400,287777400,6166,2055,4111,2055,0,1,2057,524176,0.524176
2455,4305,4265,18360825,2,19646,4913,1,315201400,315201400,7366,2455,4911,2455,0,1,2457,13324,0.013324
2855,4305,4265,18360825,2,22846,5713,1,342625400,342625400,8566,2855,5711,2855,0,1,2857,3798346,3.798346
3255,4305,4265,18360825,2,26046,6513,1,370049400,370049400,9766,3255,6511,3255,0,1,3257,751695,0.751695
3655,4305,4265,18360825,2,29246,7313,1,397473400,397473400,10966,3655,7311,3655,0,1,3657,23436,0.023436
4055,4305,4265,18360825,2,32446,8113,1,424897400,424897400,12166,4055,8111,4055,0,1,4057,887120,0.88712
4455,4305,4265,18360825,2,35646,8913,1,452321400,452321400,13366,4455,8911,4455,0,1,4457,1590113,1.590113
4855,4305,4265,18360825,2,38846,9713,1,479745400,479745400,14566,4855,9711,4855,0,1,4857,1973297,1.973297
5255,4305,4265,18360825,2,42046,10513,1,507169400,507169400,15766,5255,10511,5255,0,1,5257,580665,0.580665
5655,4305,4265,18360825,2,45246,11313,1,534593400,534593400,16966,5655,11311,5655,0,1,5657,486760,0.48676
6055,4305,4265,18360825,2,48446,12113,1,562017400,562017400,18166,6055,12111,6055,0,1,6057,902260,0.90226
6455,4305,4265,18360825,2,51646,12913,1,589441400,589441400,19366,6455,12911,6455,0,1,6457,22365,0.022365
6855,4305,4265,18360825,2,54846,13713,1,616865400,616865400,20566,6855,13711,6855,0,1,6857,5598016,5.598016
55,3555,5165,18361575,2,446,113,1,150729400,150729400,166,55,111,55,0,1,57,370925,0.370925
455,3555,5165,18361575,2,3646,913,1,178633400,178633400,1366,455,911,455,0,1,457,1753732,1.753732
855,3555,5165,18361575,2,6846,1713,1,206537400,206537400,2566,855,1711,855,0,1,857,1363301,1.363301
1255,3555,5165,18361575,2,10046,2513,1,234441400,234441400,3766,1255,2511,1255,0,1,1257,4554485,4.554485
1655,3555,5165,18361575,2,13246,3313,1,262345400,262345400,4966,1655,3311,1655,0,1,1657,500871,0.500871
2055,3555,5165,18361575,2,16446,4113,1,290249400,290249400,6166,2055,4111,2055,0,1,2057,375841,0.375841
2455,3555,5165,18361575,2,19646,4913,1,318153400,318153400,7366,2455,4911,2455,0,1,2457,1759541,1.759541
2855,3555,5165,18361575,2,22846,5713,1,346057400,346057400,8566,2855,5711,2855,0,1,2857,343477,0.343477
3255,3555,5165,18361575,2,26046,6513,1,373961400,373961400,9766,3255,6511,3255,0,1,3257,943038,0.943038
3655,3555,5165,18361575,2,29246,7313,1,401865400,401865400,10966,3655,7311,3655,0,1,3657,437179,0.437179
4055,3555,5165,18361575,2,32446,8113,1,429769400,429769400,12166,4055,8111,4055,0,1,4057,194862,0.194862
4455,3555,5165,18361575,2,35646,8913,1,457673400,457673400,13366,4455,8911,4455,0,1,4457,1130485,1.130485
4855,3555,5165,18361575,2,38846,9713,1,485577400,485577400,14566,4855,9711,4855,0,1,4857,2713295,2.713295
5255,3555,5165,18361575,2,42046,10513,1,513481400,513481400,15766,5255,10511,5255,0,1,5257,2782829,2.782829
5655,3555,5165,18361575,2,45246,11313,1,541385400,541385400,16966,5655,11311,5655,0,1,5657,5229708,5.229708
6055,3555,5165,18361575,2,48446,12113,1,569289400,569289400,18166,6055,12111,6055,0,1,6057,1952587,1.952587
6455,3555,5165,18361575,2,51646,12913,1,597193400,597193400,19366,6455,12911,6455,0,1,6457,9642888,9.642888
6855,3555,5165,18361575,2,54846,13713,1,625097400,625097400,20566,6855,13711,6855,0,1,6857,1253088,1.253088
44,2803,6555,18373665,2,358,91,1,150283336,150283336,133,44,89,44,0,1,46,340992,0.340992
544,2803,6555,18373665,2,4358,1091,1,187715336,187715336,1633,544,1089,544,0,1,546,1466568,1.466568
1044,2803,6555,18373665,2,8358,2091,1,225147336,225147336,3133,1044,2089,1044,0,1,1046,1160514,1.160514
1544,2803,6555,18373665,2,12358,3091,1,262579336,262579336,4633,1544,3089,1544,0,1,1546,284784,0.284784
2044,2803,6555,18373665,2,16358,4091,1,300011336,300011336,6133,2044,4089,2044,0,1,2046,2193673,2.193673
2544,2803,6555,18373665,2,20358,5091,1,337443336,337443336,7633,2544,5089,2544,0,1,2546,790332,0.790332
3044,2803,6555,18373665,2,24358,6091,1,374875336,374875336,9133,3044,6089,3044,0,1,3046,1841454,1.841454
3544,2803,6555,18373665,2,28358,7091,1,412307336,412307336,10633,3544,7089,3544,0,1,3546,163094,0.163094
4044,2803,6555,18373665,2,32358,8091,1,449739336,449739336,12133,4044,8089,4044,0,1,4046,12041532,12.041532
4544,2803,6555,18373665,2,36358,9091,1,487171336,487171336,13633,4544,9089,4544,0,1,4546,8596099,8.596099
5044,2803,6555,18373665,2,40358,10091,1,524603336,524603336,15133,5044,10089,5044,0,1,5046,3988808,3.988808
5544,2803,6555,18373665,2,44358,11091,1,562035336,562035336,16633,5544,11089,5544,0,1,5546,7478803,7.478803
6044,2803,6555,18373665,2,48358,12091,1,599467336,599467336,18133,6044,12089,6044,0,1,6046,8949620,8.94962
6544,2803,6555,18373665,2,52358,13091,1,636899336,636899336,19633,6544,13089,6544,0,1,6546,357604,0.357604
7044,2803,6555,18373665,2,56358,14091,1,674331336,674331336,21133,7044,14089,7044,0,1,7046,1861262,1.861262
40,5050,3640,18382000,2,326,83,1,149836800,149836800,121,40,81,40,0,1,42,41216,0.041216
440,5050,3640,18382000,2,3526,883,1,177644800,177644800,1321,440,881,440,0,1,442,92705,0.092705
840,5050,3640,18382000,2,6726,1683,1,205452800,205452800,2521,840,1681,840,0,1,842,117801,0.117801
1240,5050,3640,18382000,2,9926,2483,1,233260800,233260800,3721,1240,2481,1240,0,1,1242,411915,0.411915
1640,5050,3640,18382000,2,13126,3283,1,261068800,261068800,4921,1640,3281,1640,0,1,1642,952259,0.952259
2040,5050,3640,18382000,2,16326,4083,1,288876800,288876800,6121,2040,4081,2040,0,1,2042,468716,0.468716
2440,5050,3640,18382000,2,19526,4883,1,316684800,316684800,7321,2440,4881,2440,0,1,2442,38059,0.038059
2840,5050,3640,18382000,2,22726,5683,1,344492800,344492800,8521,2840,5681,2840,0,1,2842,1142541,1.142541
3240,5050,3640,18382000,2,25926,6483,1,372300800,372300800,9721,3240,6481,3240,0,1,3242,99561,0.099561
3640,5050,3640,18382000,2,29126,7283,1,400108800,400108800,10921,3640,7281,3640,0,1,3642,265552,0.265552
4040,5050,3640,18382000,2,32326,8083,1,427916800,427916800,12121,4040,8081,4040,0,1,4042,631960,0.63196
4440,5050,3640,18382000,2,35526,8883,1,455724800,455724800,13321,4440,8881,4440,0,1,4442,600683,0.600683
4840,5050,3640,18382000,2,38726,9683,1,483532800,483532800,14521,4840,9681,4840,0,1,4842,2617281,2.617281
5240,5050,3640,18382000,2,41926,10483,1,511340800,511340800,15721,5240,10481,5240,0,1,5242,1274154,1.274154
5640,5050,3640,18382000,2,45126,11283,1,539148800,539148800,16921,5640,11281,5640,0,1,5642,299999,0.299999
6040,5050,3640,18382000,2,48326,12083,1,566956800,566956800,18121,6040,12081,6040,0,1,6042,965062,0.965062
6440,5050,3640,18382000,2,51526,12883,1,594764800,594764800,19321,6440,12881,6440,0,1,6442,1404504,1.404504
6840,5050,3640,18382000,2,54726,13683,1,622572800,622572800,20521,6840,13681,6840,0,1,6842,1556622,1.556622
40,4050,4540,18387000,2,326,83,1,149844800,149844800,121,40,81,40,0,1,42,61895,0.061895
440,4050,4540,18387000,2,3526,883,1,177332800,177332800,1321,440,881,440,0,1,442,96040,0.09604
840,4050,4540,18387000,2,6726,1683,1,204820800,204820800,2521,840,1681,840,0,1,842,187752,0.187752
1240,4050,4540,18387000,2,9926,2483,1,232308800,232308800,3721,1240,2481,1240,0,1,1242,192481,0.192481
1640,4050,4540,18387000,2,13126,3283,1,259796800,259796800,4921,1640,3281,1640,0,1,1642,23423,0.023423
2040,4050,4540,18387000,2,16326,4083,1,287284800,287284800,6121,2040,4081,2040,0,1,2042,247040,0.24704
2440,4050,4540,18387000,2,19526,4883,1,314772800,314772800,7321,2440,4881,2440,0,1,2442,566072,0.566072
2840,4050,4540,18387000,2,22726,5683,1,342260800,342260800,8521,2840,5681,2840,0,1,2842,115072,0.115072
3240,4050,4540,18387000,2,25926,6483,1,369748800,369748800,9721,3240,6481,3240,0,1,3242,1162332,1.162332
3640,4050,4540,18387000,2,29126,7283,1,397236800,397236800,10921,3640,7281,3640,0,1,3642,614937,0.614937
4040,4050,4540,18387000,2,32326,8083,1,424724800,424724800,12121,4040,8081,4040,0,1,4042,1013364,1.013364
4440,4050,4540,18387000,2,35526,8883,1,452212800,452212800,13321,4440,8881,4440,0,1,4442,155898,0.155898
4840,4050,4540,18387000,2,38726,9683,1,479700800,479700800,14521,4840,9681,4840,0,1,4842,597607,0.597607
5240,4050,4540,18387000,2,41926,10483,1,507188800,507188800,15721,5240,10481,5240,0,1,5242,302102,0.302102
5640,4050,4540,18387000,2,45126,11283,1,534676800,534676800,16921,5640,11281,5640,0,1,5642,1579047,1.579047
6040,4050,4540,18387000,2,48326,12083,1,562164800,562164800,18121,6040,12081,6040,0,1,6042,1490888,1.490888
6440,4050,4540,18387000,2,51526,12883,1,589652800,589652800,19321,6440,12881,6440,0,1,6442,2557017,2.557017
6840,4050,4540,18387000,2,54726,13683,1,617140800,617140800,20521,6840,13681,6840,0,1,6842,458462,0.458462
40,6050,3040,18392000,2,326,83,1,150044800,150044800,121,40,81,40,0,1,42,323179,0.323179
440,6050,3040,18392000,2,3526,883,1,179132800,179132800,1321,440,881,440,0,1,442,423545,0.423545
840,6050,3040,18392000,2,6726,1683,1,208220800,208220800,2521,840,1681,840,0,1,842,2630048,2.630048
1240,6050,3040,18392000,2,9926,2483,1,237308800,237308800,3721,1240,2481,1240,0,1,1242,1100099,1.100099
1640,6050,3040,18392000,2,13126,3283,1,266396800,266396800,4921,1640,3281,1640,0,1,1642,1539485,1.539485
2040,6050,3040,18392000,2,16326,4083,1,295484800,295484800,6121,2040,4081,2040,0,1,2042,997915,0.997915
2440,6050,3040,18392000,2,19526,4883,1,324572800,324572800,7321,2440,4881,2440,0,1,2442,1562328,1.562328
2840,6050,3040,18392000,2,22726,5683,1,353660800,353660800,8521,2840,5681,2840,0,1,2842,541241,0.541241
3240,6050,3040,18392000,2,25926,6483,1,382748800,382748800,9721,3240,6481,3240,0,1,3242,182698,0.182698
3640,6050,3040,18392000,2,29126,7283,1,411836800,411836800,10921,3640,7281,3640,0,1,3642,5595725,5.595725
4040,6050,3040,18392000,2,32326,8083,1,440924800,440924800,12121,4040,8081,4040,0,1,4042,3710705,3.710705
4440,6050,3040,18392000,2,35526,8883,1,470012800,470012800,13321,4440,8881,4440,0,1,4442,892322,0.892322
4840,6050,3040,18392000,2,38726,9683,1,499100800,499100800,14521,4840,9681,4840,0,1,4842,5518385,5.518385
5240,6050,3040,18392000,2,41926,10483,1,528188800,528188800,15721,5240,10481,5240,0,1,5242,275344,0.275344
5640,6050,3040,18392000,2,45126,11283,1,557276800,557276800,16921,5640,11281,5640,0,1,5642,4410393,4.410393
6040,6050,3040,18392000,2,48326,12083,1,586364800,586364800,18121,6040,12081,6040,0,1,6042,157688,0.157688
40,3800,4840,18392000,2,326,83,1,149900800,149900800,121,40,81,40,0,1,42,323375,0.323375
440,3800,4840,18392000,2,3526,883,1,177548800,177548800,1321,440,881,440,0,1,442,1687122,1.687122
840,3800,4840,18392000,2,6726,1683,1,205196800,205196800,2521,840,1681,840,0,1,842,603985,0.603985
1240,3800,4840,18392000,2,9926,2483,1,232844800,232844800,3721,1240,2481,1240,0,1,1242,2271782,2.271782
1640,3800,4840,18392000,2,13126,3283,1,260492800,260492800,4921,1640,3281,1640,0,1,1642,5839475,5.839475
2040,3800,4840,18392000,2,16326,4083,1,288140800,288140800,6121,2040,4081,2040,0,1,2042,2103741,2.103741
6440,6050,3040,18392000,2,51526,12883,1,615452800,615452800,19321,6440,12881,6440,0,1,6442,3524267,3.524267
2440,3800,4840,18392000,2,19526,4883,1,315788800,315788800,7321,2440,4881,2440,0,1,2442,1683977,1.683977
2840,3800,4840,18392000,2,22726,5683,1,343436800,343436800,8521,2840,5681,2840,0,1,2842,2444511,2.444511
3240,3800,4840,18392000,2,25926,6483,1,371084800,371084800,9721,3240,6481,3240,0,1,3242,4942031,4.942031
3640,3800,4840,18392000,2,29126,7283,1,398732800,398732800,10921,3640,7281,3640,0,1,3642,549720,0.54972
6840,6050,3040,18392000,2,54726,13683,1,644540800,644540800,20521,6840,13681,6840,0,1,6842,2396023,2.396023
4040,3800,4840,18392000,2,32326,8083,1,426380800,426380800,12121,4040,8081,4040,0,1,4042,74954,0.074954
4440,3800,4840,18392000,2,35526,8883,1,454028800,454028800,13321,4440,8881,4440,0,1,4442,4673124,4.673124
4840,3800,4840,18392000,2,38726,9683,1,481676800,481676800,14521,4840,9681,4840,0,1,4842,1660758,1.660758
5240,3800,4840,18392000,2,41926,10483,1,509324800,509324800,15721,5240,10481,5240,0,1,5242,3519482,3.519482
5640,3800,4840,18392000,2,45126,11283,1,536972800,536972800,16921,5640,11281,5640,0,1,5642,2759187,2.759187
6040,3800,4840,18392000,2,48326,12083,1,564620800,564620800,18121,6040,12081,6040,0,1,6042,3286680,3.28668
6440,3800,4840,18392000,2,51526,12883,1,592268800,592268800,19321,6440,12881,6440,0,1,6442,651594,0.651594
6840,3800,4840,18392000,2,54726,13683,1,619916800,619916800,20521,6840,13681,6840,0,1,6842,4213576,4.213576
40,3050,6040,18422000,2,326,83,1,150284800,150284800,121,40,81,40,0,1,42,25124,0.025124
440,3050,6040,18422000,2,3526,883,1,179372800,179372800,1321,440,881,440,0,1,442,31234,0.031234
840,3050,6040,18422000,2,6726,1683,1,208460800,208460800,2521,840,1681,840,0,1,842,25234,0.025234
1240,3050,6040,18422000,2,9926,2483,1,237548800,237548800,3721,1240,2481,1240,0,1,1242,354787,0.354787
1640,3050,6040,18422000,2,13126,3283,1,266636800,266636800,4921,1640,3281,1640,0,1,1642,411500,0.4115
2040,3050,6040,18422000,2,16326,4083,1,295724800,295724800,6121,2040,4081,2040,0,1,2042,306886,0.306886
2440,3050,6040,18422000,2,19526,4883,1,324812800,324812800,7321,2440,4881,2440,0,1,2442,69679,0.069679
2840,3050,6040,18422000,2,22726,5683,1,353900800,353900800,8521,2840,5681,2840,0,1,2842,1030470,1.03047
3240,3050,6040,18422000,2,25926,6483,1,382988800,382988800,9721,3240,6481,3240,0,1,3242,588262,0.588262
3640,3050,6040,18422000,2,29126,7283,1,412076800,412076800,10921,3640,7281,3640,0,1,3642,1679077,1.679077
4040,3050,6040,18422000,2,32326,8083,1,441164800,441164800,12121,4040,8081,4040,0,1,4042,62625,0.062625
4440,3050,6040,18422000,2,35526,8883,1,470252800,470252800,13321,4440,8881,4440,0,1,4442,96754,0.096754
4840,3050,6040,18422000,2,38726,9683,1,499340800,499340800,14521,4840,9681,4840,0,1,4842,104346,0.104346
5240,3050,6040,18422000,2,41926,10483,1,528428800,528428800,15721,5240,10481,5240,0,1,5242,954911,0.954911
5640,3050,6040,18422000,2,45126,11283,1,557516800,557516800,16921,5640,11281,5640,0,1,5642,110660,0.11066
6040,3050,6040,18422000,2,48326,12083,1,586604800,586604800,18121,6040,12081,6040,0,1,6042,1456556,1.456556
6440,3050,6040,18422000,2,51526,12883,1,615692800,615692800,19321,6440,12881,6440,0,1,6442,1324857,1.324857
6840,3050,6040,18422000,2,54726,13683,1,644780800,644780800,20521,6840,13681,6840,0,1,6842,1636315,1.636315
35,6050,3045,18422250,2,286,73,1,149924600,149924600,106,35,71,35,0,1,37,17202,0.017202
535,6050,3045,18422250,2,4286,1073,1,186304600,186304600,1606,535,1071,535,0,1,537,232713,0.232713
1035,6050,3045,18422250,2,8286,2073,1,222684600,222684600,3106,1035,2071,1035,0,1,1037,663907,0.663907
1535,6050,3045,18422250,2,12286,3073,1,259064600,259064600,4606,1535,3071,1535,0,1,1537,3462556,3.462556
2035,6050,3045,18422250,2,16286,4073,1,295444600,295444600,6106,2035,4071,2035,0,1,2037,1774415,1.774415
2535,6050,3045,18422250,2,20286,5073,1,331824600,331824600,7606,2535,5071,2535,0,1,2537,143828,0.143828
3035,6050,3045,18422250,2,24286,6073,1,368204600,368204600,9106,3035,6071,3035,0,1,3037,55845,0.055845
3535,6050,3045,18422250,2,28286,7073,1,404584600,404584600,10606,3535,7071,3535,0,1,3537,722210,0.72221
4035,6050,3045,18422250,2,32286,8073,1,440964600,440964600,12106,4035,8071,4035,0,1,4037,1758821,1.758821
4535,6050,3045,18422250,2,36286,9073,1,477344600,477344600,13606,4535,9071,4535,0,1,4537,10432526,10.432526
5035,6050,3045,18422250,2,40286,10073,1,513724600,513724600,15106,5035,10071,5035,0,1,5037,3520621,3.520621
5535,6050,3045,18422250,2,44286,11073,1,550104600,550104600,16606,5535,11071,5535,0,1,5537,16093547,16.093547
6035,6050,3045,18422250,2,48286,12073,1,586484600,586484600,18106,6035,12071,6035,0,1,6037,4174545,4.174545
6535,6050,3045,18422250,2,52286,13073,1,622864600,622864600,19606,6535,13071,6535,0,1,6537,9516952,9.516952
7035,6050,3045,18422250,2,56286,14073,1,659244600,659244600,21106,7035,14071,7035,0,1,7037,25190672,25.190672
55,4055,4565,18511075,2,446,113,1,151881400,151881400,166,55,111,55,0,1,57,40927,0.040927
455,4055,4565,18511075,2,3646,913,1,179465400,179465400,1366,455,911,455,0,1,457,86373,0.086373
855,4055,4565,18511075,2,6846,1713,1,207049400,207049400,2566,855,1711,855,0,1,857,89440,0.08944
1255,4055,4565,18511075,2,10046,2513,1,234633400,234633400,3766,1255,2511,1255,0,1,1257,126325,0.126325
1655,4055,4565,18511075,2,13246,3313,1,262217400,262217400,4966,1655,3311,1655,0,1,1657,1136863,1.136863
2055,4055,4565,18511075,2,16446,4113,1,289801400,289801400,6166,2055,4111,2055,0,1,2057,13565,0.013565
2455,4055,4565,18511075,2,19646,4913,1,317385400,317385400,7366,2455,4911,2455,0,1,2457,939359,0.939359
2855,4055,4565,18511075,2,22846,5713,1,344969400,344969400,8566,2855,5711,2855,0,1,2857,86419,0.086419
3255,4055,4565,18511075,2,26046,6513,1,372553400,372553400,9766,3255,6511,3255,0,1,3257,995328,0.995328
3655,4055,4565,18511075,2,29246,7313,1,400137400,400137400,10966,3655,7311,3655,0,1,3657,214879,0.214879
4055,4055,4565,18511075,2,32446,8113,1,427721400,427721400,12166,4055,8111,4055,0,1,4057,797239,0.797239
4455,4055,4565,18511075,2,35646,8913,1,455305400,455305400,13366,4455,8911,4455,0,1,4457,265470,0.26547
4855,4055,4565,18511075,2,38846,9713,1,482889400,482889400,14566,4855,9711,4855,0,1,4857,695445,0.695445
5255,4055,4565,18511075,2,42046,10513,1,510473400,510473400,15766,5255,10511,5255,0,1,5257,342153,0.342153
5655,4055,4565,18511075,2,45246,11313,1,538057400,538057400,16966,5655,11311,5655,0,1,5657,869591,0.869591
6055,4055,4565,18511075,2,48446,12113,1,565641400,565641400,18166,6055,12111,6055,0,1,6057,1724336,1.724336
6455,4055,4565,18511075,2,51646,12913,1,593225400,593225400,19366,6455,12911,6455,0,1,6457,1490210,1.49021
6855,4055,4565,18511075,2,54846,13713,1,620809400,620809400,20566,6855,13711,6855,0,1,6857,2036879,2.036879
55,3805,4865,18511325,2,446,113,1,151905400,151905400,166,55,111,55,0,1,57,385664,0.385664
455,3805,4865,18511325,2,3646,913,1,179649400,179649400,1366,455,911,455,0,1,457,304494,0.304494
855,3805,4865,18511325,2,6846,1713,1,207393400,207393400,2566,855,1711,855,0,1,857,3230778,3.230778
1255,3805,4865,18511325,2,10046,2513,1,235137400,235137400,3766,1255,2511,1255,0,1,1257,4649687,4.649687
1655,3805,4865,18511325,2,13246,3313,1,262881400,262881400,4966,1655,3311,1655,0,1,1657,225843,0.225843
2055,3805,4865,18511325,2,16446,4113,1,290625400,290625400,6166,2055,4111,2055,0,1,2057,137438,0.137438
2455,3805,4865,18511325,2,19646,4913,1,318369400,318369400,7366,2455,4911,2455,0,1,2457,3642134,3.642134
2855,3805,4865,18511325,2,22846,5713,1,346113400,346113400,8566,2855,5711,2855,0,1,2857,2056584,2.056584
3255,3805,4865,18511325,2,26046,6513,1,373857400,373857400,9766,3255,6511,3255,0,1,3257,1851767,1.851767
3655,3805,4865,18511325,2,29246,7313,1,401601400,401601400,10966,3655,7311,3655,0,1,3657,351573,0.351573
4055,3805,4865,18511325,2,32446,8113,1,429345400,429345400,12166,4055,8111,4055,0,1,4057,950165,0.950165
4455,3805,4865,18511325,2,35646,8913,1,457089400,457089400,13366,4455,8911,4455,0,1,4457,5455442,5.455442
4855,3805,4865,18511325,2,38846,9713,1,484833400,484833400,14566,4855,9711,4855,0,1,4857,4981575,4.981575
5255,3805,4865,18511325,2,42046,10513,1,512577400,512577400,15766,5255,10511,5255,0,1,5257,1828124,1.828124
5655,3805,4865,18511325,2,45246,11313,1,540321400,540321400,16966,5655,11311,5655,0,1,5657,5365091,5.365091
6055,3805,4865,18511325,2,48446,12113,1,568065400,568065400,18166,6055,12111,6055,0,1,6057,1975980,1.97598
6455,3805,4865,18511325,2,51646,12913,1,595809400,595809400,19366,6455,12911,6455,0,1,6457,2256335,2.256335
6855,3805,4865,18511325,2,54846,13713,1,623553400,623553400,20566,6855,13711,6855,0,1,6857,358535,0.358535
35,3340,5545,18520300,2,286,73,1,150650200,150650200,106,35,71,35,0,1,37,325979,0.325979
535,3340,5545,18520300,2,4286,1073,1,186190200,186190200,1606,535,1071,535,0,1,537,1990597,1.990597
1035,3340,5545,18520300,2,8286,2073,1,221730200,221730200,3106,1035,2071,1035,0,1,1037,3709647,3.709647
1535,3340,5545,18520300,2,12286,3073,1,257270200,257270200,4606,1535,3071,1535,0,1,1537,5439186,5.439186
2035,3340,5545,18520300,2,16286,4073,1,292810200,292810200,6106,2035,4071,2035,0,1,2037,7159164,7.159164
39,3343,5541,18523563,2,318,81,1,150960312,150960312,118,39,79,39,0,1,41,40178,0.040178
539,3343,5541,18523563,2,4318,1081,1,186496312,186496312,1618,539,1079,539,0,1,541,200926,0.200926
1039,3343,5541,18523563,2,8318,2081,1,222032312,222032312,3118,1039,2079,1039,0,1,1041,84225,0.084225
1539,3343,5541,18523563,2,12318,3081,1,257568312,257568312,4618,1539,3079,1539,0,1,1541,117010,0.11701
2039,3343,5541,18523563,2,16318,4081,1,293104312,293104312,6118,2039,4079,2039,0,1,2041,712876,0.712876
2539,3343,5541,18523563,2,20318,5081,1,328640312,328640312,7618,2539,5079,2539,0,1,2541,221846,0.221846
3039,3343,5541,18523563,2,24318,6081,1,364176312,364176312,9118,3039,6079,3039,0,1,3041,334616,0.334616
3539,3343,5541,18523563,2,28318,7081,1,399712312,399712312,10618,3539,7079,3539,0,1,3541,1666849,1.666849
4039,3343,5541,18523563,2,32318,8081,1,435248312,435248312,12118,4039,8079,4039,0,1,4041,99926,0.099926
4539,3343,5541,18523563,2,36318,9081,1,470784312,470784312,13618,4539,9079,4539,0,1,4541,653870,0.65387
5039,3343,5541,18523563,2,40318,10081,1,506320312,506320312,15118,5039,10079,5039,0,1,5041,765219,0.765219
5539,3343,5541,18523563,2,44318,11081,1,541856312,541856312,16618,5539,11079,5539,0,1,5541,4763157,4.763157
6039,3343,5541,18523563,2,48318,12081,1,577392312,577392312,18118,6039,12079,6039,0,1,6041,1467139,1.467139
6539,3343,5541,18523563,2,52318,13081,1,612928312,612928312,19618,6539,13079,6539,0,1,6541,380221,0.380221
7039,3343,5541,18523563,2,56318,14081,1,648464312,648464312,21118,7039,14079,7039,0,1,7041,1762476,1.762476
55,5055,3665,18526575,2,446,113,1,152049400,152049400,166,55,111,55,0,1,57,33998,0.033998
455,5055,3665,18526575,2,3646,913,1,179953400,179953400,1366,455,911,455,0,1,457,108533,0.108533
855,5055,3665,18526575,2,6846,1713,1,207857400,207857400,2566,855,1711,855,0,1,857,248215,0.248215
1255,5055,3665,18526575,2,10046,2513,1,235761400,235761400,3766,1255,2511,1255,0,1,1257,274912,0.274912
1655,5055,3665,18526575,2,13246,3313,1,263665400,263665400,4966,1655,3311,1655,0,1,1657,348328,0.348328
2055,5055,3665,18526575,2,16446,4113,1,291569400,291569400,6166,2055,4111,2055,0,1,2057,116910,0.11691
2455,5055,3665,18526575,2,19646,4913,1,319473400,319473400,7366,2455,4911,2455,0,1,2457,66794,0.066794
2855,5055,3665,18526575,2,22846,5713,1,347377400,347377400,8566,2855,5711,2855,0,1,2857,146893,0.146893
3255,5055,3665,18526575,2,26046,6513,1,375281400,375281400,9766,3255,6511,3255,0,1,3257,587065,0.587065
3655,5055,3665,18526575,2,29246,7313,1,403185400,403185400,10966,3655,7311,3655,0,1,3657,347624,0.347624
4055,5055,3665,18526575,2,32446,8113,1,431089400,431089400,12166,4055,8111,4055,0,1,4057,129077,0.129077
4455,5055,3665,18526575,2,35646,8913,1,458993400,458993400,13366,4455,8911,4455,0,1,4457,1636074,1.636074
4855,5055,3665,18526575,2,38846,9713,1,486897400,486897400,14566,4855,9711,4855,0,1,4857,3891116,3.891116
5255,5055,3665,18526575,2,42046,10513,1,514801400,514801400,15766,5255,10511,5255,0,1,5257,2856110,2.85611
5655,5055,3665,18526575,2,45246,11313,1,542705400,542705400,16966,5655,11311,5655,0,1,5657,818627,0.818627
6055,5055,3665,18526575,2,48446,12113,1,570609400,570609400,18166,6055,12111,6055,0,1,6057,232647,0.232647
6455,5055,3665,18526575,2,51646,12913,1,598513400,598513400,19366,6455,12911,6455,0,1,6457,63651,0.063651
6855,5055,3665,18526575,2,54846,13713,1,626417400,626417400,20566,6855,13711,6855,0,1,6857,858746,0.858746
55,3055,6065,18528575,2,446,113,1,152241400,152241400,166,55,111,55,0,1,57,91380,0.09138
455,3055,6065,18528575,2,3646,913,1,181425400,181425400,1366,455,911,455,0,1,457,76251,0.076251
855,3055,6065,18528575,2,6846,1713,1,210609400,210609400,2566,855,1711,855,0,1,857,84154,0.084154
1255,3055,6065,18528575,2,10046,2513,1,239793400,239793400,3766,1255,2511,1255,0,1,1257,25657,0.025657
1655,3055,6065,18528575,2,13246,3313,1,268977400,268977400,4966,1655,3311,1655,0,1,1657,98255,0.098255
2055,3055,6065,18528575,2,16446,4113,1,298161400,298161400,6166,2055,4111,2055,0,1,2057,693823,0.693823
2455,3055,6065,18528575,2,19646,4913,1,327345400,327345400,7366,2455,4911,2455,0,1,2457,174342,0.174342
2855,3055,6065,18528575,2,22846,5713,1,356529400,356529400,8566,2855,5711,2855,0,1,2857,1996773,1.996773
3255,3055,6065,18528575,2,26046,6513,1,385713400,385713400,9766,3255,6511,3255,0,1,3257,278119,0.278119
3655,3055,6065,18528575,2,29246,7313,1,414897400,414897400,10966,3655,7311,3655,0,1,3657,178056,0.178056
4055,3055,6065,18528575,2,32446,8113,1,444081400,444081400,12166,4055,8111,4055,0,1,4057,177467,0.177467
4455,3055,6065,18528575,2,35646,8913,1,473265400,473265400,13366,4455,8911,4455,0,1,4457,544410,0.54441
4855,3055,6065,18528575,2,38846,9713,1,502449400,502449400,14566,4855,9711,4855,0,1,4857,2940180,2.94018
5255,3055,6065,18528575,2,42046,10513,1,531633400,531633400,15766,5255,10511,5255,0,1,5257,1137151,1.137151
5655,3055,6065,18528575,2,45246,11313,1,560817400,560817400,16966,5655,11311,5655,0,1,5657,574907,0.574907
6055,3055,6065,18528575,2,48446,12113,1,590001400,590001400,18166,6055,12111,6055,0,1,6057,2146599,2.146599
6455,3055,6065,18528575,2,51646,12913,1,619185400,619185400,19366,6455,12911,6455,0,1,6457,128013,0.128013
6855,3055,6065,18528575,2,54846,13713,1,648369400,648369400,20566,6855,13711,6855,0,1,6857,1278005,1.278005
39,6093,3041,18528813,2,318,81,1,151080312,151080312,118,39,79,39,0,1,41,14449,0.014449
539,6093,3041,18528813,2,4318,1081,1,187616312,187616312,1618,539,1079,539,0,1,541,79095,0.079095
1039,6093,3041,18528813,2,8318,2081,1,224152312,224152312,3118,1039,2079,1039,0,1,1041,447503,0.447503
1539,6093,3041,18528813,2,12318,3081,1,260688312,260688312,4618,1539,3079,1539,0,1,1541,91237,0.091237
2039,6093,3041,18528813,2,16318,4081,1,297224312,297224312,6118,2039,4079,2039,0,1,2041,1125205,1.125205
2539,6093,3041,18528813,2,20318,5081,1,333760312,333760312,7618,2539,5079,2539,0,1,2541,796093,0.796093
3039,6093,3041,18528813,2,24318,6081,1,370296312,370296312,9118,3039,6079,3039,0,1,3041,4267447,4.267447
3539,6093,3041,18528813,2,28318,7081,1,406832312,406832312,10618,3539,7079,3539,0,1,3541,562198,0.562198
4039,6093,3041,18528813,2,32318,8081,1,443368312,443368312,12118,4039,8079,4039,0,1,4041,1766848,1.766848
4539,6093,3041,18528813,2,36318,9081,1,479904312,479904312,13618,4539,9079,4539,0,1,4541,106243,0.106243
5039,6093,3041,18528813,2,40318,10081,1,516440312,516440312,15118,5039,10079,5039,0,1,5041,2342714,2.342714
5539,6093,3041,18528813,2,44318,11081,1,552976312,552976312,16618,5539,11079,5539,0,1,5541,4232319,4.232319
6039,6093,3041,18528813,2,48318,12081,1,589512312,589512312,18118,6039,12079,6039,0,1,6041,1044546,1.044546
6539,6093,3041,18528813,2,52318,13081,1,626048312,626048312,19618,6539,13079,6539,0,1,6541,511821,0.511821
7039,6093,3041,18528813,2,56318,14081,1,662584312,662584312,21118,7039,14079,7039,0,1,7041,265146,0.265146
40,5550,3340,18537000,2,326,83,1,151140800,151140800,121,40,81,40,0,1,42,339894,0.339894
440,5550,3340,18537000,2,3526,883,1,179588800,179588800,1321,440,881,440,0,1,442,1569929,1.569929
840,5550,3340,18537000,2,6726,1683,1,208036800,208036800,2521,840,1681,840,0,1,842,1275747,1.275747
1240,5550,3340,18537000,2,9926,2483,1,236484800,236484800,3721,1240,2481,1240,0,1,1242,4557545,4.557545
1640,5550,3340,18537000,2,13126,3283,1,264932800,264932800,4921,1640,3281,1640,0,1,1642,5954155,5.954155
2040,5550,3340,18537000,2,16326,4083,1,293380800,293380800,6121,2040,4081,2040,0,1,2042,4004328,4.004328
2440,5550,3340,18537000,2,19526,4883,1,321828800,321828800,7321,2440,4881,2440,0,1,2442,2075029,2.075029
2840,5550,3340,18537000,2,22726,5683,1,350276800,350276800,8521,2840,5681,2840,0,1,2842,1148767,1.148767
3240,5550,3340,18537000,2,25926,6483,1,378724800,378724800,9721,3240,6481,3240,0,1,3242,47365,0.047365
3640,5550,3340,18537000,2,29126,7283,1,407172800,407172800,10921,3640,7281,3640,0,1,3642,3300058,3.300058
4040,5550,3340,18537000,2,32326,8083,1,435620800,435620800,12121,4040,8081,4040,0,1,4042,2780382,2.780382
4440,5550,3340,18537000,2,35526,8883,1,464068800,464068800,13321,4440,8881,4440,0,1,4442,3811655,3.811655
4840,5550,3340,18537000,2,38726,9683,1,492516800,492516800,14521,4840,9681,4840,0,1,4842,1862911,1.862911
5240,5550,3340,18537000,2,41926,10483,1,520964800,520964800,15721,5240,10481,5240,0,1,5242,5699233,5.699233
5640,5550,3340,18537000,2,45126,11283,1,549412800,549412800,16921,5640,11281,5640,0,1,5642,875250,0.87525
6040,5550,3340,18537000,2,48326,12083,1,577860800,577860800,18121,6040,12081,6040,0,1,6042,5899744,5.899744
6440,5550,3340,18537000,2,51526,12883,1,606308800,606308800,19321,6440,12881,6440,0,1,6442,1575223,1.575223
6840,5550,3340,18537000,2,54726,13683,1,634756800,634756800,20521,6840,13681,6840,0,1,6842,1721637,1.721637
35,6090,3045,18544050,2,286,73,1,150910200,150910200,106,35,71,35,0,1,37,91077,0.091077
535,6090,3045,18544050,2,4286,1073,1,187450200,187450200,1606,535,1071,535,0,1,537,1450685,1.450685
1035,6090,3045,18544050,2,8286,2073,1,223990200,223990200,3106,1035,2071,1035,0,1,1037,2763293,2.763293
1535,6090,3045,18544050,2,12286,3073,1,260530200,260530200,4606,1535,3071,1535,0,1,1537,3726433,3.726433
55,6055,3065,18558575,2,446,113,1,152481400,152481400,166,55,111,55,0,1,57,352453,0.352453
455,6055,3065,18558575,2,3646,913,1,181665400,181665400,1366,455,911,455,0,1,457,244977,0.244977
855,6055,3065,18558575,2,6846,1713,1,210849400,210849400,2566,855,1711,855,0,1,857,2621455,2.621455
1255,6055,3065,18558575,2,10046,2513,1,240033400,240033400,3766,1255,2511,1255,0,1,1257,701857,0.701857
1655,6055,3065,18558575,2,13246,3313,1,269217400,269217400,4966,1655,3311,1655,0,1,1657,5915872,5.915872
2055,6055,3065,18558575,2,16446,4113,1,298401400,298401400,6166,2055,4111,2055,0,1,2057,1666442,1.666442
2455,6055,3065,18558575,2,19646,4913,1,327585400,327585400,7366,2455,4911,2455,0,1,2457,2187018,2.187018
2855,6055,3065,18558575,2,22846,5713,1,356769400,356769400,8566,2855,5711,2855,0,1,2857,2462962,2.462962
3255,6055,3065,18558575,2,26046,6513,1,385953400,385953400,9766,3255,6511,3255,0,1,3257,1948651,1.948651
3655,6055,3065,18558575,2,29246,7313,1,415137400,415137400,10966,3655,7311,3655,0,1,3657,627561,0.627561
4055,6055,3065,18558575,2,32446,8113,1,444321400,444321400,12166,4055,8111,4055,0,1,4057,1525668,1.525668
4455,6055,3065,18558575,2,35646,8913,1,473505400,473505400,13366,4455,8911,4455,0,1,4457,3341925,3.341925
4855,6055,3065,18558575,2,38846,9713,1,502689400,502689400,14566,4855,9711,4855,0,1,4857,482248,0.482248
5255,6055,3065,18558575,2,42046,10513,1,531873400,531873400,15766,5255,10511,5255,0,1,5257,862766,0.862766
5655,6055,3065,18558575,2,45246,11313,1,561057400,561057400,16966,5655,11311,5655,0,1,5657,913754,0.913754
6055,6055,3065,18558575,2,48446,12113,1,590241400,590241400,18166,6055,12111,6055,0,1,6057,3605088,3.605088
6455,6055,3065,18558575,2,51646,12913,1,619425400,619425400,19366,6455,12911,6455,0,1,6457,67216,0.067216
6855,6055,3065,18558575,2,54846,13713,1,648609400,648609400,20566,6855,13711,6855,0,1,6857,2611332,2.611332
40,2800,6640,18592000,2,326,83,1,151756800,151756800,121,40,81,40,0,1,42,324528,0.324528
440,2800,6640,18592000,2,3526,883,1,181964800,181964800,1321,440,881,440,0,1,442,1067721,1.067721
840,2800,6640,18592000,2,6726,1683,1,212172800,212172800,2521,840,1681,840,0,1,842,2045627,2.045627
1240,2800,6640,18592000,2,9926,2483,1,242380800,242380800,3721,1240,2481,1240,0,1,1242,1463355,1.463355
1640,2800,6640,18592000,2,13126,3283,1,272588800,272588800,4921,1640,3281,1640,0,1,1642,123440,0.12344
2040,2800,6640,18592000,2,16326,4083,1,302796800,302796800,6121,2040,4081,2040,0,1,2042,172764,0.172764
2440,2800,6640,18592000,2,19526,4883,1,333004800,333004800,7321,2440,4881,2440,0,1,2442,787906,0.787906
2840,2800,6640,18592000,2,22726,5683,1,363212800,363212800,8521,2840,5681,2840,0,1,2842,156510,0.15651
3240,2800,6640,18592000,2,25926,6483,1,393420800,393420800,9721,3240,6481,3240,0,1,3242,2482546,2.482546
3640,2800,6640,18592000,2,29126,7283,1,423628800,423628800,10921,3640,7281,3640,0,1,3642,2837008,2.837008
4040,2800,6640,18592000,2,32326,8083,1,453836800,453836800,12121,4040,8081,4040,0,1,4042,152705,0.152705
4440,2800,6640,18592000,2,35526,8883,1,484044800,484044800,13321,4440,8881,4440,0,1,4442,2347901,2.347901
4840,2800,6640,18592000,2,38726,9683,1,514252800,514252800,14521,4840,9681,4840,0,1,4842,466517,0.466517
5240,2800,6640,18592000,2,41926,10483,1,544460800,544460800,15721,5240,10481,5240,0,1,5242,1481523,1.481523
5640,2800,6640,18592000,2,45126,11283,1,574668800,574668800,16921,5640,11281,5640,0,1,5642,2369304,2.369304
6040,2800,6640,18592000,2,48326,12083,1,604876800,604876800,18121,6040,12081,6040,0,1,6042,714389,0.714389
6440,2800,6640,18592000,2,51526,12883,1,635084800,635084800,19321,6440,12881,6440,0,1,6442,380718,0.380718
6840,2800,6640,18592000,2,54726,13683,1,665292800,665292800,20521,6840,13681,6840,0,1,6842,6260275,6.260275
44,3353,5555,18625915,2,358,91,1,152142936,152142936,133,44,89,44,0,1,46,23128,0.023128
544,3353,5555,18625915,2,4358,1091,1,187774936,187774936,1633,544,1089,544,0,1,546,87309,0.087309
1044,3353,5555,18625915,2,8358,2091,1,223406936,223406936,3133,1044,2089,1044,0,1,1046,121150,0.12115
1544,3353,5555,18625915,2,12358,3091,1,259038936,259038936,4633,1544,3089,1544,0,1,1546,34052,0.034052
2044,3353,5555,18625915,2,16358,4091,1,294670936,294670936,6133,2044,4089,2044,0,1,2046,1228411,1.228411
2544,3353,5555,18625915,2,20358,5091,1,330302936,330302936,7633,2544,5089,2544,0,1,2546,33675,0.033675
3044,3353,5555,18625915,2,24358,6091,1,365934936,365934936,9133,3044,6089,3044,0,1,3046,1420504,1.420504
3544,3353,5555,18625915,2,28358,7091,1,401566936,401566936,10633,3544,7089,3544,0,1,3546,3981004,3.981004
4044,3353,5555,18625915,2,32358,8091,1,437198936,437198936,12133,4044,8089,4044,0,1,4046,1521603,1.521603
4544,3353,5555,18625915,2,36358,9091,1,472830936,472830936,13633,4544,9089,4544,0,1,4546,945927,0.945927
5044,3353,5555,18625915,2,40358,10091,1,508462936,508462936,15133,5044,10089,5044,0,1,5046,591176,0.591176
5544,3353,5555,18625915,2,44358,11091,1,544094936,544094936,16633,5544,11089,5544,0,1,5546,1529753,1.529753
6044,3353,5555,18625915,2,48358,12091,1,579726936,579726936,18133,6044,12089,6044,0,1,6046,1314837,1.314837
6544,3353,5555,18625915,2,52358,13091,1,615358936,615358936,19633,6544,13089,6544,0,1,6546,1752255,1.752255
7044,3353,5555,18625915,2,56358,14091,1,650990936,650990936,21133,7044,14089,7044,0,1,7046,8100703,8.100703
40,6800,2740,18632000,2,326,83,1,152108800,152108800,121,40,81,40,0,1,42,334427,0.334427
440,6800,2740,18632000,2,3526,883,1,182636800,182636800,1321,440,881,440,0,1,442,1738132,1.738132
840,6800,2740,18632000,2,6726,1683,1,213164800,213164800,2521,840,1681,840,0,1,842,401963,0.401963
1240,6800,2740,18632000,2,9926,2483,1,243692800,243692800,3721,1240,2481,1240,0,1,1242,86396,0.086396
1640,6800,2740,18632000,2,13126,3283,1,274220800,274220800,4921,1640,3281,1640,0,1,1642,207376,0.207376
2040,6800,2740,18632000,2,16326,4083,1,304748800,304748800,6121,2040,4081,2040,0,1,2042,1216073,1.216073
2440,6800,2740,18632000,2,19526,4883,1,335276800,335276800,7321,2440,4881,2440,0,1,2442,5362807,5.362807
2840,6800,2740,18632000,2,22726,5683,1,365804800,365804800,8521,2840,5681,2840,0,1,2842,232463,0.232463
3240,6800,2740,18632000,2,25926,6483,1,396332800,396332800,9721,3240,6481,3240,0,1,3242,1716637,1.716637
3640,6800,2740,18632000,2,29126,7283,1,426860800,426860800,10921,3640,7281,3640,0,1,3642,298420,0.29842
4040,6800,2740,18632000,2,32326,8083,1,457388800,457388800,12121,4040,8081,4040,0,1,4042,1771451,1.771451
4440,6800,2740,18632000,2,35526,8883,1,487916800,487916800,13321,4440,8881,4440,0,1,4442,2805637,2.805637
4840,6800,2740,18632000,2,38726,9683,1,518444800,518444800,14521,4840,9681,4840,0,1,4842,460238,0.460238
5240,6800,2740,18632000,2,41926,10483,1,548972800,548972800,15721,5240,10481,5240,0,1,5242,91890,0.09189
5640,6800,2740,18632000,2,45126,11283,1,579500800,579500800,16921,5640,11281,5640,0,1,5642,2437739,2.437739
6040,6800,2740,18632000,2,48326,12083,1,610028800,610028800,18121,6040,12081,6040,0,1,6042,71498,0.071498
6440,6800,2740,18632000,2,51526,12883,1,640556800,640556800,19321,6440,12881,6440,0,1,6442,6222541,6.222541
6840,6800,2740,18632000,2,54726,13683,1,671084800,671084800,20521,6840,13681,6840,0,1,6842,18033,0.018033
44,6103,3055,18644665,2,358,91,1,152380936,152380936,133,44,89,44,0,1,46,24534,0.024534
544,6103,3055,18644665,2,4358,1091,1,189012936,189012936,1633,544,1089,544,0,1,546,312519,0.312519
1044,6103,3055,18644665,2,8358,2091,1,225644936,225644936,3133,1044,2089,1044,0,1,1046,98050,0.09805
1544,6103,3055,18644665,2,12358,3091,1,262276936,262276936,4633,1544,3089,1544,0,1,1546,920557,0.920557
2044,6103,3055,18644665,2,16358,4091,1,298908936,298908936,6133,2044,4089,2044,0,1,2046,216776,0.216776
2544,6103,3055,18644665,2,20358,5091,1,335540936,335540936,7633,2544,5089,2544,0,1,2546,2942047,2.942047
3044,6103,3055,18644665,2,24358,6091,1,372172936,372172936,9133,3044,6089,3044,0,1,3046,835690,0.83569
3544,6103,3055,18644665,2,28358,7091,1,408804936,408804936,10633,3544,7089,3544,0,1,3546,2482016,2.482016
4044,6103,3055,18644665,2,32358,8091,1,445436936,445436936,12133,4044,8089,4044,0,1,4046,3481754,3.481754
4544,6103,3055,18644665,2,36358,9091,1,482068936,482068936,13633,4544,9089,4544,0,1,4546,5806172,5.806172
5044,6103,3055,18644665,2,40358,10091,1,518700936,518700936,15133,5044,10089,5044,0,1,5046,3414747,3.414747
5544,6103,3055,18644665,2,44358,11091,1,555332936,555332936,16633,5544,11089,5544,0,1,5546,486744,0.486744
6044,6103,3055,18644665,2,48358,12091,1,591964936,591964936,18133,6044,12089,6044,0,1,6046,559656,0.559656
6544,6103,3055,18644665,2,52358,13091,1,628596936,628596936,19633,6544,13089,6544,0,1,6546,4101582,4.101582
7044,6103,3055,18644665,2,56358,14091,1,665228936,665228936,21133,7044,14089,7044,0,1,7046,3493197,3.493197
55,5555,3365,18692575,2,446,113,1,153465400,153465400,166,55,111,55,0,1,57,383153,0.383153
455,5555,3365,18692575,2,3646,913,1,182009400,182009400,1366,455,911,455,0,1,457,1774853,1.774853
855,5555,3365,18692575,2,6846,1713,1,210553400,210553400,2566,855,1711,855,0,1,857,1765181,1.765181
1255,5555,3365,18692575,2,10046,2513,1,239097400,239097400,3766,1255,2511,1255,0,1,1257,4178526,4.178526
1655,5555,3365,18692575,2,13246,3313,1,267641400,267641400,4966,1655,3311,1655,0,1,1657,5303153,5.303153
2055,5555,3365,18692575,2,16446,4113,1,296185400,296185400,6166,2055,4111,2055,0,1,2057,964956,0.964956
2455,5555,3365,18692575,2,19646,4913,1,324729400,324729400,7366,2455,4911,2455,0,1,2457,650409,0.650409
2855,5555,3365,18692575,2,22846,5713,1,353273400,353273400,8566,2855,5711,2855,0,1,2857,1795030,1.79503
3255,5555,3365,18692575,2,26046,6513,1,381817400,381817400,9766,3255,6511,3255,0,1,3257,18281,0.018281
3655,5555,3365,18692575,2,29246,7313,1,410361400,410361400,10966,3655,7311,3655,0,1,3657,1650831,1.650831
4055,5555,3365,18692575,2,32446,8113,1,438905400,438905400,12166,4055,8111,4055,0,1,4057,7776808,7.776808
4455,5555,3365,18692575,2,35646,8913,1,467449400,467449400,13366,4455,8911,4455,0,1,4457,4557112,4.557112
4855,5555,3365,18692575,2,38846,9713,1,495993400,495993400,14566,4855,9711,4855,0,1,4857,2748603,2.748603
5255,5555,3365,18692575,2,42046,10513,1,524537400,524537400,15766,5255,10511,5255,0,1,5257,1197044,1.197044
5655,5555,3365,18692575,2,45246,11313,1,553081400,553081400,16966,5655,11311,5655,0,1,5657,2869723,2.869723
6055,5555,3365,18692575,2,48446,12113,1,581625400,581625400,18166,6055,12111,6055,0,1,6057,7927318,7.927318
6455,5555,3365,18692575,2,51646,12913,1,610169400,610169400,19366,6455,12911,6455,0,1,6457,2063009,2.063009
6855,5555,3365,18692575,2,54846,13713,1,638713400,638713400,20566,6855,13711,6855,0,1,6857,10025121,10.025121
55,2805,6665,18695325,2,446,113,1,153729400,153729400,166,55,111,55,0,1,57,374347,0.374347
455,2805,6665,18695325,2,3646,913,1,184033400,184033400,1366,455,911,455,0,1,457,240281,0.240281
855,2805,6665,18695325,2,6846,1713,1,214337400,214337400,2566,855,1711,855,0,1,857,1865295,1.865295
1255,2805,6665,18695325,2,10046,2513,1,244641400,244641400,3766,1255,2511,1255,0,1,1257,3296177,3.296177
1655,2805,6665,18695325,2,13246,3313,1,274945400,274945400,4966,1655,3311,1655,0,1,1657,2802451,2.802451
2055,2805,6665,18695325,2,16446,4113,1,305249400,305249400,6166,2055,4111,2055,0,1,2057,675090,0.67509
2455,2805,6665,18695325,2,19646,4913,1,335553400,335553400,7366,2455,4911,2455,0,1,2457,246988,0.246988
2855,2805,6665,18695325,2,22846,5713,1,365857400,365857400,8566,2855,5711,2855,0,1,2857,2957083,2.957083
3255,2805,6665,18695325,2,26046,6513,1,396161400,396161400,9766,3255,6511,3255,0,1,3257,3513996,3.513996
3655,2805,6665,18695325,2,29246,7313,1,426465400,426465400,10966,3655,7311,3655,0,1,3657,1105062,1.105062
4055,2805,6665,18695325,2,32446,8113,1,456769400,456769400,12166,4055,8111,4055,0,1,4057,2636308,2.636308
4455,2805,6665,18695325,2,35646,8913,1,487073400,487073400,13366,4455,8911,4455,0,1,4457,6908504,6.908504
4855,2805,6665,18695325,2,38846,9713,1,517377400,517377400,14566,4855,9711,4855,0,1,4857,3759270,3.75927
5255,2805,6665,18695325,2,42046,10513,1,547681400,547681400,15766,5255,10511,5255,0,1,5257,1464585,1.464585
5655,2805,6665,18695325,2,45246,11313,1,577985400,577985400,16966,5655,11311,5655,0,1,5657,421155,0.421155
6055,2805,6665,18695325,2,48446,12113,1,608289400,608289400,18166,6055,12111,6055,0,1,6057,5345738,5.345738
6455,2805,6665,18695325,2,51646,12913,1,638593400,638593400,19366,6455,12911,6455,0,1,6457,1056981,1.056981
6855,2805,6665,18695325,2,54846,13713,1,668897400,668897400,20566,6855,13711,6855,0,1,6857,4073730,4.07373
55,6805,2765,18815825,2,446,113,1,154737400,154737400,166,55,111,55,0,1,57,376296,0.376296
455,6805,2765,18815825,2,3646,913,1,185361400,185361400,1366,455,911,455,0,1,457,815141,0.815141
855,6805,2765,18815825,2,6846,1713,1,215985400,215985400,2566,855,1711,855,0,1,857,522485,0.522485
1255,6805,2765,18815825,2,10046,2513,1,246609400,246609400,3766,1255,2511,1255,0,1,1257,1229209,1.229209
1655,6805,2765,18815825,2,13246,3313,1,277233400,277233400,4966,1655,3311,1655,0,1,1657,1366621,1.366621
2055,6805,2765,18815825,2,16446,4113,1,307857400,307857400,6166,2055,4111,2055,0,1,2057,67430,0.06743
2455,6805,2765,18815825,2,19646,4913,1,338481400,338481400,7366,2455,4911,2455,0,1,2457,1249067,1.249067
2855,6805,2765,18815825,2,22846,5713,1,369105400,369105400,8566,2855,5711,2855,0,1,2857,23650,0.02365
3255,6805,2765,18815825,2,26046,6513,1,399729400,399729400,9766,3255,6511,3255,0,1,3257,2547023,2.547023
3655,6805,2765,18815825,2,29246,7313,1,430353400,430353400,10966,3655,7311,3655,0,1,3657,2084247,2.084247
4055,6805,2765,18815825,2,32446,8113,1,460977400,460977400,12166,4055,8111,4055,0,1,4057,3103862,3.103862
4455,6805,2765,18815825,2,35646,8913,1,491601400,491601400,13366,4455,8911,4455,0,1,4457,406443,0.406443
4855,6805,2765,18815825,2,38846,9713,1,522225400,522225400,14566,4855,9711,4855,0,1,4857,570078,0.570078
5255,6805,2765,18815825,2,42046,10513,1,552849400,552849400,15766,5255,10511,5255,0,1,5257,5867902,5.867902
5655,6805,2765,18815825,2,45246,11313,1,583473400,583473400,16966,5655,11311,5655,0,1,5657,4120070,4.12007
6055,6805,2765,18815825,2,48446,12113,1,614097400,614097400,18166,6055,12111,6055,0,1,6057,5118076,5.118076
6455,6805,2765,18815825,2,51646,12913,1,644721400,644721400,19366,6455,12911,6455,0,1,6457,5776182,5.776182
6855,6805,2765,18815825,2,54846,13713,1,675345400,675345400,20566,6855,13711,6855,0,1,6857,3753956,3.753956
40,4800,3940,18912000,2,326,83,1,154092800,154092800,121,40,81,40,0,1,42,179509,0.179509
440,4800,3940,18912000,2,3526,883,1,182060800,182060800,1321,440,881,440,0,1,442,1689742,1.689742
840,4800,3940,18912000,2,6726,1683,1,210028800,210028800,2521,840,1681,840,0,1,842,751335,0.751335
1240,4800,3940,18912000,2,9926,2483,1,237996800,237996800,3721,1240,2481,1240,0,1,1242,835436,0.835436
1640,4800,3940,18912000,2,13126,3283,1,265964800,265964800,4921,1640,3281,1640,0,1,1642,917882,0.917882
2040,4800,3940,18912000,2,16326,4083,1,293932800,293932800,6121,2040,4081,2040,0,1,2042,7254177,7.254177
2440,4800,3940,18912000,2,19526,4883,1,321900800,321900800,7321,2440,4881,2440,0,1,2442,34154,0.034154
2840,4800,3940,18912000,2,22726,5683,1,349868800,349868800,8521,2840,5681,2840,0,1,2842,7482570,7.48257
3240,4800,3940,18912000,2,25926,6483,1,377836800,377836800,9721,3240,6481,3240,0,1,3242,961483,0.961483
3640,4800,3940,18912000,2,29126,7283,1,405804800,405804800,10921,3640,7281,3640,0,1,3642,1586167,1.586167
4040,4800,3940,18912000,2,32326,8083,1,433772800,433772800,12121,4040,8081,4040,0,1,4042,5879738,5.879738
4440,4800,3940,18912000,2,35526,8883,1,461740800,461740800,13321,4440,8881,4440,0,1,4442,1044700,1.0447
4840,4800,3940,18912000,2,38726,9683,1,489708800,489708800,14521,4840,9681,4840,0,1,4842,5233462,5.233462
5240,4800,3940,18912000,2,41926,10483,1,517676800,517676800,15721,5240,10481,5240,0,1,5242,2041896,2.041896
5640,4800,3940,18912000,2,45126,11283,1,545644800,545644800,16921,5640,11281,5640,0,1,5642,295789,0.295789
6040,4800,3940,18912000,2,48326,12083,1,573612800,573612800,18121,6040,12081,6040,0,1,6042,5168210,5.16821
6440,4800,3940,18912000,2,51526,12883,1,601580800,601580800,19321,6440,12881,6440,0,1,6442,5756028,5.756028
6840,4800,3940,18912000,2,54726,13683,1,629548800,629548800,20521,6840,13681,6840,0,1,6842,16335230,16.33523
40,3300,5740,18942000,2,326,83,1,154428800,154428800,121,40,81,40,0,1,42,276212,0.276212
440,3300,5740,18942000,2,3526,883,1,183356800,183356800,1321,440,881,440,0,1,442,176338,0.176338
840,3300,5740,18942000,2,6726,1683,1,212284800,212284800,2521,840,1681,840,0,1,842,264111,0.264111
1240,3300,5740,18942000,2,9926,2483,1,241212800,241212800,3721,1240,2481,1240,0,1,1242,925892,0.925892
1640,3300,5740,18942000,2,13126,3283,1,270140800,270140800,4921,1640,3281,1640,0,1,1642,1742034,1.742034
2040,3300,5740,18942000,2,16326,4083,1,299068800,299068800,6121,2040,4081,2040,0,1,2042,3810464,3.810464
2440,3300,5740,18942000,2,19526,4883,1,327996800,327996800,7321,2440,4881,2440,0,1,2442,3689182,3.689182
2840,3300,5740,18942000,2,22726,5683,1,356924800,356924800,8521,2840,5681,2840,0,1,2842,1407203,1.407203
3240,3300,5740,18942000,2,25926,6483,1,385852800,385852800,9721,3240,6481,3240,0,1,3242,1743928,1.743928
3640,3300,5740,18942000,2,29126,7283,1,414780800,414780800,10921,3640,7281,3640,0,1,3642,217413,0.217413
4040,3300,5740,18942000,2,32326,8083,1,443708800,443708800,12121,4040,8081,4040,0,1,4042,59227,0.059227
4440,3300,5740,18942000,2,35526,8883,1,472636800,472636800,13321,4440,8881,4440,0,1,4442,210598,0.210598
4840,3300,5740,18942000,2,38726,9683,1,501564800,501564800,14521,4840,9681,4840,0,1,4842,4262971,4.262971
5240,3300,5740,18942000,2,41926,10483,1,530492800,530492800,15721,5240,10481,5240,0,1,5242,47124,0.047124
5640,3300,5740,18942000,2,45126,11283,1,559420800,559420800,16921,5640,11281,5640,0,1,5642,204972,0.204972
6040,3300,5740,18942000,2,48326,12083,1,588348800,588348800,18121,6040,12081,6040,0,1,6042,3700431,3.700431
6440,3300,5740,18942000,2,51526,12883,1,617276800,617276800,19321,6440,12881,6440,0,1,6442,143349,0.143349
6840,3300,5740,18942000,2,54726,13683,1,646204800,646204800,20521,6840,13681,6840,0,1,6842,41204,0.041204
55,4805,3965,19051825,2,446,113,1,156273400,156273400,166,55,111,55,0,1,57,398324,0.398324
455,4805,3965,19051825,2,3646,913,1,184337400,184337400,1366,455,911,455,0,1,457,1776859,1.776859
855,4805,3965,19051825,2,6846,1713,1,212401400,212401400,2566,855,1711,855,0,1,857,2233708,2.233708
1255,4805,3965,19051825,2,10046,2513,1,240465400,240465400,3766,1255,2511,1255,0,1,1257,514910,0.51491
1655,4805,3965,19051825,2,13246,3313,1,268529400,268529400,4966,1655,3311,1655,0,1,1657,1612626,1.612626
2055,4805,3965,19051825,2,16446,4113,1,296593400,296593400,6166,2055,4111,2055,0,1,2057,893207,0.893207
2455,4805,3965,19051825,2,19646,4913,1,324657400,324657400,7366,2455,4911,2455,0,1,2457,8450262,8.450262
2855,4805,3965,19051825,2,22846,5713,1,352721400,352721400,8566,2855,5711,2855,0,1,2857,2450181,2.450181
3255,4805,3965,19051825,2,26046,6513,1,380785400,380785400,9766,3255,6511,3255,0,1,3257,2671661,2.671661
3655,4805,3965,19051825,2,29246,7313,1,408849400,408849400,10966,3655,7311,3655,0,1,3657,2491298,2.491298
4055,4805,3965,19051825,2,32446,8113,1,436913400,436913400,12166,4055,8111,4055,0,1,4057,11763400,11.7634
4455,4805,3965,19051825,2,35646,8913,1,464977400,464977400,13366,4455,8911,4455,0,1,4457,13328571,13.328571
4855,4805,3965,19051825,2,38846,9713,1,493041400,493041400,14566,4855,9711,4855,0,1,4857,2319489,2.319489
5255,4805,3965,19051825,2,42046,10513,1,521105400,521105400,15766,5255,10511,5255,0,1,5257,6145338,6.145338
5655,4805,3965,19051825,2,45246,11313,1,549169400,549169400,16966,5655,11311,5655,0,1,5657,474718,0.474718
6055,4805,3965,19051825,2,48446,12113,1,577233400,577233400,18166,6055,12111,6055,0,1,6057,14928472,14.928472
6455,4805,3965,19051825,2,51646,12913,1,605297400,605297400,19366,6455,12911,6455,0,1,6457,15124919,15.124919
6855,4805,3965,19051825,2,54846,13713,1,633361400,633361400,20566,6855,13711,6855,0,1,6857,4689948,4.689948
55,3305,5765,19053325,2,446,113,1,156417400,156417400,166,55,111,55,0,1,57,105260,0.10526
455,3305,5765,19053325,2,3646,913,1,185441400,185441400,1366,455,911,455,0,1,457,976298,0.976298
855,3305,5765,19053325,2,6846,1713,1,214465400,214465400,2566,855,1711,855,0,1,857,809433,0.809433
1255,3305,5765,19053325,2,10046,2513,1,243489400,243489400,3766,1255,2511,1255,0,1,1257,94982,0.094982
1655,3305,5765,19053325,2,13246,3313,1,272513400,272513400,4966,1655,3311,1655,0,1,1657,738031,0.738031
2055,3305,5765,19053325,2,16446,4113,1,301537400,301537400,6166,2055,4111,2055,0,1,2057,1174632,1.174632
2455,3305,5765,19053325,2,19646,4913,1,330561400,330561400,7366,2455,4911,2455,0,1,2457,170363,0.170363
2855,3305,5765,19053325,2,22846,5713,1,359585400,359585400,8566,2855,5711,2855,0,1,2857,1417123,1.417123
3255,3305,5765,19053325,2,26046,6513,1,388609400,388609400,9766,3255,6511,3255,0,1,3257,1197438,1.197438
3655,3305,5765,19053325,2,29246,7313,1,417633400,417633400,10966,3655,7311,3655,0,1,3657,415152,0.415152
4055,3305,5765,19053325,2,32446,8113,1,446657400,446657400,12166,4055,8111,4055,0,1,4057,4881048,4.881048
4455,3305,5765,19053325,2,35646,8913,1,475681400,475681400,13366,4455,8911,4455,0,1,4457,252975,0.252975
4855,3305,5765,19053325,2,38846,9713,1,504705400,504705400,14566,4855,9711,4855,0,1,4857,1362676,1.362676
5255,3305,5765,19053325,2,42046,10513,1,533729400,533729400,15766,5255,10511,5255,0,1,5257,630464,0.630464
5655,3305,5765,19053325,2,45246,11313,1,562753400,562753400,16966,5655,11311,5655,0,1,5657,996968,0.996968
6055,3305,5765,19053325,2,48446,12113,1,591777400,591777400,18166,6055,12111,6055,0,1,6057,1486503,1.486503
6455,3305,5765,19053325,2,51646,12913,1,620801400,620801400,19366,6455,12911,6455,0,1,6457,725760,0.72576
6855,3305,5765,19053325,2,54846,13713,1,649825400,649825400,20566,6855,13711,6855,0,1,6857,8273052,8.273052
40,6300,3040,19152000,2,326,83,1,156204800,156204800,121,40,81,40,0,1,42,345356,0.345356
440,6300,3040,19152000,2,3526,883,1,186092800,186092800,1321,440,881,440,0,1,442,1404297,1.404297
840,6300,3040,19152000,2,6726,1683,1,215980800,215980800,2521,840,1681,840,0,1,842,162011,0.162011
1240,6300,3040,19152000,2,9926,2483,1,245868800,245868800,3721,1240,2481,1240,0,1,1242,1996460,1.99646
1640,6300,3040,19152000,2,13126,3283,1,275756800,275756800,4921,1640,3281,1640,0,1,1642,1590658,1.590658
2040,6300,3040,19152000,2,16326,4083,1,305644800,305644800,6121,2040,4081,2040,0,1,2042,4993322,4.993322
2440,6300,3040,19152000,2,19526,4883,1,335532800,335532800,7321,2440,4881,2440,0,1,2442,54470,0.05447
2840,6300,3040,19152000,2,22726,5683,1,365420800,365420800,8521,2840,5681,2840,0,1,2842,3645390,3.64539
3240,6300,3040,19152000,2,25926,6483,1,395308800,395308800,9721,3240,6481,3240,0,1,3242,6868447,6.868447
3640,6300,3040,19152000,2,29126,7283,1,425196800,425196800,10921,3640,7281,3640,0,1,3642,964404,0.964404
4040,6300,3040,19152000,2,32326,8083,1,455084800,455084800,12121,4040,8081,4040,0,1,4042,1966781,1.966781
4440,6300,3040,19152000,2,35526,8883,1,484972800,484972800,13321,4440,8881,4440,0,1,4442,1587441,1.587441
4840,6300,3040,19152000,2,38726,9683,1,514860800,514860800,14521,4840,9681,4840,0,1,4842,2584175,2.584175
5240,6300,3040,19152000,2,41926,10483,1,544748800,544748800,15721,5240,10481,5240,0,1,5242,12116881,12.116881
5640,6300,3040,19152000,2,45126,11283,1,574636800,574636800,16921,5640,11281,5640,0,1,5642,6437666,6.437666
6040,6300,3040,19152000,2,48326,12083,1,604524800,604524800,18121,6040,12081,6040,0,1,6042,7426666,7.426666
6440,6300,3040,19152000,2,51526,12883,1,634412800,634412800,19321,6440,12881,6440,0,1,6442,22227636,22.227636
6840,6300,3040,19152000,2,54726,13683,1,664300800,664300800,20521,6840,13681,6840,0,1,6842,4617214,4.617214
40,5300,3640,19292000,2,326,83,1,157196800,157196800,121,40,81,40,0,1,42,354277,0.354277
440,5300,3640,19292000,2,3526,883,1,185804800,185804800,1321,440,881,440,0,1,442,407042,0.407042
840,5300,3640,19292000,2,6726,1683,1,214412800,214412800,2521,840,1681,840,0,1,842,2124706,2.124706
1240,5300,3640,19292000,2,9926,2483,1,243020800,243020800,3721,1240,2481,1240,0,1,1242,4546758,4.546758
1640,5300,3640,19292000,2,13126,3283,1,271628800,271628800,4921,1640,3281,1640,0,1,1642,1820550,1.82055
2040,5300,3640,19292000,2,16326,4083,1,300236800,300236800,6121,2040,4081,2040,0,1,2042,1994362,1.994362
2440,5300,3640,19292000,2,19526,4883,1,328844800,328844800,7321,2440,4881,2440,0,1,2442,176545,0.176545
2840,5300,3640,19292000,2,22726,5683,1,357452800,357452800,8521,2840,5681,2840,0,1,2842,529100,0.5291
3240,5300,3640,19292000,2,25926,6483,1,386060800,386060800,9721,3240,6481,3240,0,1,3242,1074795,1.074795
3640,5300,3640,19292000,2,29126,7283,1,414668800,414668800,10921,3640,7281,3640,0,1,3642,2048058,2.048058
4040,5300,3640,19292000,2,32326,8083,1,443276800,443276800,12121,4040,8081,4040,0,1,4042,571633,0.571633
4440,5300,3640,19292000,2,35526,8883,1,471884800,471884800,13321,4440,8881,4440,0,1,4442,822040,0.82204
4840,5300,3640,19292000,2,38726,9683,1,500492800,500492800,14521,4840,9681,4840,0,1,4842,3390221,3.390221
5240,5300,3640,19292000,2,41926,10483,1,529100800,529100800,15721,5240,10481,5240,0,1,5242,92947,0.092947
40,4550,4240,19292000,2,326,83,1,157148800,157148800,121,40,81,40,0,1,42,345276,0.345276
440,4550,4240,19292000,2,3526,883,1,185276800,185276800,1321,440,881,440,0,1,442,1689140,1.68914
840,4550,4240,19292000,2,6726,1683,1,213404800,213404800,2521,840,1681,840,0,1,842,3070243,3.070243
1240,4550,4240,19292000,2,9926,2483,1,241532800,241532800,3721,1240,2481,1240,0,1,1242,414891,0.414891
1640,4550,4240,19292000,2,13126,3283,1,269660800,269660800,4921,1640,3281,1640,0,1,1642,992508,0.992508
5640,5300,3640,19292000,2,45126,11283,1,557708800,557708800,16921,5640,11281,5640,0,1,5642,1030444,1.030444
2040,4550,4240,19292000,2,16326,4083,1,297788800,297788800,6121,2040,4081,2040,0,1,2042,1973518,1.973518
2440,4550,4240,19292000,2,19526,4883,1,325916800,325916800,7321,2440,4881,2440,0,1,2442,8533691,8.533691
2840,4550,4240,19292000,2,22726,5683,1,354044800,354044800,8521,2840,5681,2840,0,1,2842,678202,0.678202
6040,5300,3640,19292000,2,48326,12083,1,586316800,586316800,18121,6040,12081,6040,0,1,6042,18397,0.018397
3240,4550,4240,19292000,2,25926,6483,1,382172800,382172800,9721,3240,6481,3240,0,1,3242,1052142,1.052142
3640,4550,4240,19292000,2,29126,7283,1,410300800,410300800,10921,3640,7281,3640,0,1,3642,1109529,1.109529
6440,5300,3640,19292000,2,51526,12883,1,614924800,614924800,19321,6440,12881,6440,0,1,6442,735934,0.735934
4040,4550,4240,19292000,2,32326,8083,1,438428800,438428800,12121,4040,8081,4040,0,1,4042,2954332,2.954332
4440,4550,4240,19292000,2,35526,8883,1,466556800,466556800,13321,4440,8881,4440,0,1,4442,11524149,11.524149
6840,5300,3640,19292000,2,54726,13683,1,643532800,643532800,20521,6840,13681,6840,0,1,6842,595206,0.595206
4840,4550,4240,19292000,2,38726,9683,1,494684800,494684800,14521,4840,9681,4840,0,1,4842,3668574,3.668574
5240,4550,4240,19292000,2,41926,10483,1,522812800,522812800,15721,5240,10481,5240,0,1,5242,1099734,1.099734
5640,4550,4240,19292000,2,45126,11283,1,550940800,550940800,16921,5640,11281,5640,0,1,5642,281533,0.281533
6040,4550,4240,19292000,2,48326,12083,1,579068800,579068800,18121,6040,12081,6040,0,1,6042,1178117,1.178117
6440,4550,4240,19292000,2,51526,12883,1,607196800,607196800,19321,6440,12881,6440,0,1,6442,793281,0.793281
6840,4550,4240,19292000,2,54726,13683,1,635324800,635324800,20521,6840,13681,6840,0,1,6842,1312300,1.3123
40,3550,5440,19312000,2,326,83,1,157372800,157372800,121,40,81,40,0,1,42,144152,0.144152
440,3550,5440,19312000,2,3526,883,1,186140800,186140800,1321,440,881,440,0,1,442,1723875,1.723875
840,3550,5440,19312000,2,6726,1683,1,214908800,214908800,2521,840,1681,840,0,1,842,136509,0.136509
1240,3550,5440,19312000,2,9926,2483,1,243676800,243676800,3721,1240,2481,1240,0,1,1242,821346,0.821346
1640,3550,5440,19312000,2,13126,3283,1,272444800,272444800,4921,1640,3281,1640,0,1,1642,3699307,3.699307
2040,3550,5440,19312000,2,16326,4083,1,301212800,301212800,6121,2040,4081,2040,0,1,2042,1262437,1.262437
2440,3550,5440,19312000,2,19526,4883,1,329980800,329980800,7321,2440,4881,2440,0,1,2442,814606,0.814606
2840,3550,5440,19312000,2,22726,5683,1,358748800,358748800,8521,2840,5681,2840,0,1,2842,430166,0.430166
3240,3550,5440,19312000,2,25926,6483,1,387516800,387516800,9721,3240,6481,3240,0,1,3242,1269724,1.269724
3640,3550,5440,19312000,2,29126,7283,1,416284800,416284800,10921,3640,7281,3640,0,1,3642,4001523,4.001523
4040,3550,5440,19312000,2,32326,8083,1,445052800,445052800,12121,4040,8081,4040,0,1,4042,1045860,1.04586
4440,3550,5440,19312000,2,35526,8883,1,473820800,473820800,13321,4440,8881,4440,0,1,4442,1834644,1.834644
4840,3550,5440,19312000,2,38726,9683,1,502588800,502588800,14521,4840,9681,4840,0,1,4842,8181318,8.181318
5240,3550,5440,19312000,2,41926,10483,1,531356800,531356800,15721,5240,10481,5240,0,1,5242,2992608,2.992608
5640,3550,5440,19312000,2,45126,11283,1,560124800,560124800,16921,5640,11281,5640,0,1,5642,1559820,1.55982
6040,3550,5440,19312000,2,48326,12083,1,588892800,588892800,18121,6040,12081,6040,0,1,6042,3244704,3.244704
6440,3550,5440,19312000,2,51526,12883,1,617660800,617660800,19321,6440,12881,6440,0,1,6442,1712402,1.712402
6840,3550,5440,19312000,2,54726,13683,1,646428800,646428800,20521,6840,13681,6840,0,1,6842,610971,0.610971
40,7050,2740,19317000,2,326,83,1,157668800,157668800,121,40,81,40,0,1,42,337278,0.337278
440,7050,2740,19317000,2,3526,883,1,188996800,188996800,1321,440,881,440,0,1,442,354864,0.354864
840,7050,2740,19317000,2,6726,1683,1,220324800,220324800,2521,840,1681,840,0,1,842,3282275,3.282275
1240,7050,2740,19317000,2,9926,2483,1,251652800,251652800,3721,1240,2481,1240,0,1,1242,2665257,2.665257
1640,7050,2740,19317000,2,13126,3283,1,282980800,282980800,4921,1640,3281,1640,0,1,1642,163147,0.163147
2040,7050,2740,19317000,2,16326,4083,1,314308800,314308800,6121,2040,4081,2040,0,1,2042,1020242,1.020242
2440,7050,2740,19317000,2,19526,4883,1,345636800,345636800,7321,2440,4881,2440,0,1,2442,9254855,9.254855
2840,7050,2740,19317000,2,22726,5683,1,376964800,376964800,8521,2840,5681,2840,0,1,2842,8286276,8.286276
3240,7050,2740,19317000,2,25926,6483,1,408292800,408292800,9721,3240,6481,3240,0,1,3242,11838118,11.838118
3640,7050,2740,19317000,2,29126,7283,1,439620800,439620800,10921,3640,7281,3640,0,1,3642,5480334,5.480334
4040,7050,2740,19317000,2,32326,8083,1,470948800,470948800,12121,4040,8081,4040,0,1,4042,2988288,2.988288
4440,7050,2740,19317000,2,35526,8883,1,502276800,502276800,13321,4440,8881,4440,0,1,4442,13776126,13.776126
4840,7050,2740,19317000,2,38726,9683,1,533604800,533604800,14521,4840,9681,4840,0,1,4842,1928651,1.928651
5240,7050,2740,19317000,2,41926,10483,1,564932800,564932800,15721,5240,10481,5240,0,1,5242,19745697,19.745697
5640,7050,2740,19317000,2,45126,11283,1,596260800,596260800,16921,5640,11281,5640,0,1,5642,21269164,21.269164
6040,7050,2740,19317000,2,48326,12083,1,627588800,627588800,18121,6040,12081,6040,0,1,6042,22906045,22.906045
6440,7050,2740,19317000,2,51526,12883,1,658916800,658916800,19321,6440,12881,6440,0,1,6442,24320221,24.320221
6840,7050,2740,19317000,2,54726,13683,1,690244800,690244800,20521,6840,13681,6840,0,1,6842,25926501,25.926501
55,6305,3065,19324825,2,446,113,1,158721400,158721400,166,55,111,55,0,1,57,393755,0.393755
455,6305,3065,19324825,2,3646,913,1,188705400,188705400,1366,455,911,455,0,1,457,80100,0.0801
855,6305,3065,19324825,2,6846,1713,1,218689400,218689400,2566,855,1711,855,0,1,857,2475497,2.475497
1255,6305,3065,19324825,2,10046,2513,1,248673400,248673400,3766,1255,2511,1255,0,1,1257,2853000,2.853
1655,6305,3065,19324825,2,13246,3313,1,278657400,278657400,4966,1655,3311,1655,0,1,1657,2884189,2.884189
2055,6305,3065,19324825,2,16446,4113,1,308641400,308641400,6166,2055,4111,2055,0,1,2057,624837,0.624837
2455,6305,3065,19324825,2,19646,4913,1,338625400,338625400,7366,2455,4911,2455,0,1,2457,1971126,1.971126
2855,6305,3065,19324825,2,22846,5713,1,368609400,368609400,8566,2855,5711,2855,0,1,2857,1128914,1.128914
3255,6305,3065,19324825,2,26046,6513,1,398593400,398593400,9766,3255,6511,3255,0,1,3257,2986114,2.986114
3655,6305,3065,19324825,2,29246,7313,1,428577400,428577400,10966,3655,7311,3655,0,1,3657,166063,0.166063
4055,6305,3065,19324825,2,32446,8113,1,458561400,458561400,12166,4055,8111,4055,0,1,4057,324453,0.324453
4455,6305,3065,19324825,2,35646,8913,1,488545400,488545400,13366,4455,8911,4455,0,1,4457,5949469,5.949469
4855,6305,3065,19324825,2,38846,9713,1,518529400,518529400,14566,4855,9711,4855,0,1,4857,6491019,6.491019
5255,6305,3065,19324825,2,42046,10513,1,548513400,548513400,15766,5255,10511,5255,0,1,5257,2676738,2.676738
5655,6305,3065,19324825,2,45246,11313,1,578497400,578497400,16966,5655,11311,5655,0,1,5657,8261382,8.261382
6055,6305,3065,19324825,2,48446,12113,1,608481400,608481400,18166,6055,12111,6055,0,1,6057,11030456,11.030456
6455,6305,3065,19324825,2,51646,12913,1,638465400,638465400,19366,6455,12911,6455,0,1,6457,18619874,18.619874
6855,6305,3065,19324825,2,54846,13713,1,668449400,668449400,20566,6855,13711,6855,0,1,6857,23791337,23.791337
40,3050,6340,19337000,2,326,83,1,157700800,157700800,121,40,81,40,0,1,42,24405,0.024405
440,3050,6340,19337000,2,3526,883,1,187748800,187748800,1321,440,881,440,0,1,442,129732,0.129732
840,3050,6340,19337000,2,6726,1683,1,217796800,217796800,2521,840,1681,840,0,1,842,81700,0.0817
1240,3050,6340,19337000,2,9926,2483,1,247844800,247844800,3721,1240,2481,1240,0,1,1242,707616,0.707616
1640,3050,6340,19337000,2,13126,3283,1,277892800,277892800,4921,1640,3281,1640,0,1,1642,64995,0.064995
2040,3050,6340,19337000,2,16326,4083,1,307940800,307940800,6121,2040,4081,2040,0,1,2042,250428,0.250428
2440,3050,6340,19337000,2,19526,4883,1,337988800,337988800,7321,2440,4881,2440,0,1,2442,370382,0.370382
2840,3050,6340,19337000,2,22726,5683,1,368036800,368036800,8521,2840,5681,2840,0,1,2842,17655,0.017655
3240,3050,6340,19337000,2,25926,6483,1,398084800,398084800,9721,3240,6481,3240,0,1,3242,1347453,1.347453
3640,3050,6340,19337000,2,29126,7283,1,428132800,428132800,10921,3640,7281,3640,0,1,3642,379260,0.37926
4040,3050,6340,19337000,2,32326,8083,1,458180800,458180800,12121,4040,8081,4040,0,1,4042,317734,0.317734
4440,3050,6340,19337000,2,35526,8883,1,488228800,488228800,13321,4440,8881,4440,0,1,4442,1483362,1.483362
4840,3050,6340,19337000,2,38726,9683,1,518276800,518276800,14521,4840,9681,4840,0,1,4842,249424,0.249424
5240,3050,6340,19337000,2,41926,10483,1,548324800,548324800,15721,5240,10481,5240,0,1,5242,484145,0.484145
5640,3050,6340,19337000,2,45126,11283,1,578372800,578372800,16921,5640,11281,5640,0,1,5642,185079,0.185079
6040,3050,6340,19337000,2,48326,12083,1,608420800,608420800,18121,6040,12081,6040,0,1,6042,997983,0.997983
6440,3050,6340,19337000,2,51526,12883,1,638468800,638468800,19321,6440,12881,6440,0,1,6442,3291207,3.291207
6840,3050,6340,19337000,2,54726,13683,1,668516800,668516800,20521,6840,13681,6840,0,1,6842,723375,0.723375
40,5800,3340,19372000,2,326,83,1,157900800,157900800,121,40,81,40,0,1,42,42095,0.042095
440,5800,3340,19372000,2,3526,883,1,187148800,187148800,1321,440,881,440,0,1,442,14469,0.014469
840,5800,3340,19372000,2,6726,1683,1,216396800,216396800,2521,840,1681,840,0,1,842,15251,0.015251
1240,5800,3340,19372000,2,9926,2483,1,245644800,245644800,3721,1240,2481,1240,0,1,1242,330349,0.330349
1640,5800,3340,19372000,2,13126,3283,1,274892800,274892800,4921,1640,3281,1640,0,1,1642,131535,0.131535
2040,5800,3340,19372000,2,16326,4083,1,304140800,304140800,6121,2040,4081,2040,0,1,2042,630317,0.630317
2440,5800,3340,19372000,2,19526,4883,1,333388800,333388800,7321,2440,4881,2440,0,1,2442,39365,0.039365
2840,5800,3340,19372000,2,22726,5683,1,362636800,362636800,8521,2840,5681,2840,0,1,2842,702457,0.702457
3240,5800,3340,19372000,2,25926,6483,1,391884800,391884800,9721,3240,6481,3240,0,1,3242,1266366,1.266366
3640,5800,3340,19372000,2,29126,7283,1,421132800,421132800,10921,3640,7281,3640,0,1,3642,64292,0.064292
4040,5800,3340,19372000,2,32326,8083,1,450380800,450380800,12121,4040,8081,4040,0,1,4042,1336404,1.336404
4440,5800,3340,19372000,2,35526,8883,1,479628800,479628800,13321,4440,8881,4440,0,1,4442,1101795,1.101795
4840,5800,3340,19372000,2,38726,9683,1,508876800,508876800,14521,4840,9681,4840,0,1,4842,446976,0.446976
5240,5800,3340,19372000,2,41926,10483,1,538124800,538124800,15721,5240,10481,5240,0,1,5242,424957,0.424957
5640,5800,3340,19372000,2,45126,11283,1,567372800,567372800,16921,5640,11281,5640,0,1,5642,2887285,2.887285
6040,5800,3340,19372000,2,48326,12083,1,596620800,596620800,18121,6040,12081,6040,0,1,6042,630543,0.630543
6440,5800,3340,19372000,2,51526,12883,1,625868800,625868800,19321,6440,12881,6440,0,1,6442,2113312,2.113312
6840,5800,3340,19372000,2,54726,13683,1,655116800,655116800,20521,6840,13681,6840,0,1,6842,754067,0.754067
55,4555,4265,19427075,2,446,113,1,159297400,159297400,166,55,111,55,0,1,57,395835,0.395835
455,4555,4265,19427075,2,3646,913,1,187521400,187521400,1366,455,911,455,0,1,457,1806722,1.806722
855,4555,4265,19427075,2,6846,1713,1,215745400,215745400,2566,855,1711,855,0,1,857,680749,0.680749
1255,4555,4265,19427075,2,10046,2513,1,243969400,243969400,3766,1255,2511,1255,0,1,1257,869758,0.869758
1655,4555,4265,19427075,2,13246,3313,1,272193400,272193400,4966,1655,3311,1655,0,1,1657,5259886,5.259886
2055,4555,4265,19427075,2,16446,4113,1,300417400,300417400,6166,2055,4111,2055,0,1,2057,4561254,4.561254
2455,4555,4265,19427075,2,19646,4913,1,328641400,328641400,7366,2455,4911,2455,0,1,2457,1322760,1.32276
2855,4555,4265,19427075,2,22846,5713,1,356865400,356865400,8566,2855,5711,2855,0,1,2857,2528108,2.528108
3255,4555,4265,19427075,2,26046,6513,1,385089400,385089400,9766,3255,6511,3255,0,1,3257,342742,0.342742
3655,4555,4265,19427075,2,29246,7313,1,413313400,413313400,10966,3655,7311,3655,0,1,3657,7483538,7.483538
4055,4555,4265,19427075,2,32446,8113,1,441537400,441537400,12166,4055,8111,4055,0,1,4057,14821013,14.821013
4455,4555,4265,19427075,2,35646,8913,1,469761400,469761400,13366,4455,8911,4455,0,1,4457,2843067,2.843067
4855,4555,4265,19427075,2,38846,9713,1,497985400,497985400,14566,4855,9711,4855,0,1,4857,1918672,1.918672
5255,4555,4265,19427075,2,42046,10513,1,526209400,526209400,15766,5255,10511,5255,0,1,5257,2740401,2.740401
5655,4555,4265,19427075,2,45246,11313,1,554433400,554433400,16966,5655,11311,5655,0,1,5657,4554089,4.554089
6055,4555,4265,19427075,2,48446,12113,1,582657400,582657400,18166,6055,12111,6055,0,1,6057,1826406,1.826406
6455,4555,4265,19427075,2,51646,12913,1,610881400,610881400,19366,6455,12911,6455,0,1,6457,489368,0.489368
6855,4555,4265,19427075,2,54846,13713,1,639105400,639105400,20566,6855,13711,6855,0,1,6857,4635929,4.635929
55,3555,5465,19428075,2,446,113,1,159393400,159393400,166,55,111,55,0,1,57,390842,0.390842
455,3555,5465,19428075,2,3646,913,1,188257400,188257400,1366,455,911,455,0,1,457,1853549,1.853549
855,3555,5465,19428075,2,6846,1713,1,217121400,217121400,2566,855,1711,855,0,1,857,198863,0.198863
1255,3555,5465,19428075,2,10046,2513,1,245985400,245985400,3766,1255,2511,1255,0,1,1257,3971577,3.971577
1655,3555,5465,19428075,2,13246,3313,1,274849400,274849400,4966,1655,3311,1655,0,1,1657,63161,0.063161
2055,3555,5465,19428075,2,16446,4113,1,303713400,303713400,6166,2055,4111,2055,0,1,2057,199866,0.199866
2455,3555,5465,19428075,2,19646,4913,1,332577400,332577400,7366,2455,4911,2455,0,1,2457,24286,0.024286
2855,3555,5465,19428075,2,22846,5713,1,361441400,361441400,8566,2855,5711,2855,0,1,2857,1247148,1.247148
3255,3555,5465,19428075,2,26046,6513,1,390305400,390305400,9766,3255,6511,3255,0,1,3257,1274990,1.27499
3655,3555,5465,19428075,2,29246,7313,1,419169400,419169400,10966,3655,7311,3655,0,1,3657,3252152,3.252152
4055,3555,5465,19428075,2,32446,8113,1,448033400,448033400,12166,4055,8111,4055,0,1,4057,2874162,2.874162
4455,3555,5465,19428075,2,35646,8913,1,476897400,476897400,13366,4455,8911,4455,0,1,4457,1114720,1.11472
4855,3555,5465,19428075,2,38846,9713,1,505761400,505761400,14566,4855,9711,4855,0,1,4857,783799,0.783799
5255,3555,5465,19428075,2,42046,10513,1,534625400,534625400,15766,5255,10511,5255,0,1,5257,1518733,1.518733
5655,3555,5465,19428075,2,45246,11313,1,563489400,563489400,16966,5655,11311,5655,0,1,5657,2517039,2.517039
6055,3555,5465,19428075,2,48446,12113,1,592353400,592353400,18166,6055,12111,6055,0,1,6057,144383,0.144383
6455,3555,5465,19428075,2,51646,12913,1,621217400,621217400,19366,6455,12911,6455,0,1,6457,3507533,3.507533
6855,3555,5465,19428075,2,54846,13713,1,650081400,650081400,20566,6855,13711,6855,0,1,6857,5080353,5.080353
40,2800,6940,19432000,2,326,83,1,158572800,158572800,121,40,81,40,0,1,42,345198,0.345198
440,2800,6940,19432000,2,3526,883,1,189740800,189740800,1321,440,881,440,0,1,442,531779,0.531779
840,2800,6940,19432000,2,6726,1683,1,220908800,220908800,2521,840,1681,840,0,1,842,1160364,1.160364
1240,2800,6940,19432000,2,9926,2483,1,252076800,252076800,3721,1240,2481,1240,0,1,1242,3004117,3.004117
1640,2800,6940,19432000,2,13126,3283,1,283244800,283244800,4921,1640,3281,1640,0,1,1642,1362136,1.362136
2040,2800,6940,19432000,2,16326,4083,1,314412800,314412800,6121,2040,4081,2040,0,1,2042,2016740,2.01674
2440,2800,6940,19432000,2,19526,4883,1,345580800,345580800,7321,2440,4881,2440,0,1,2442,66641,0.066641
2840,2800,6940,19432000,2,22726,5683,1,376748800,376748800,8521,2840,5681,2840,0,1,2842,391862,0.391862
3240,2800,6940,19432000,2,25926,6483,1,407916800,407916800,9721,3240,6481,3240,0,1,3242,3984881,3.984881
3640,2800,6940,19432000,2,29126,7283,1,439084800,439084800,10921,3640,7281,3640,0,1,3642,2286407,2.286407
4040,2800,6940,19432000,2,32326,8083,1,470252800,470252800,12121,4040,8081,4040,0,1,4042,455474,0.455474
4440,2800,6940,19432000,2,35526,8883,1,501420800,501420800,13321,4440,8881,4440,0,1,4442,681023,0.681023
4840,2800,6940,19432000,2,38726,9683,1,532588800,532588800,14521,4840,9681,4840,0,1,4842,1802873,1.802873
5240,2800,6940,19432000,2,41926,10483,1,563756800,563756800,15721,5240,10481,5240,0,1,5242,2598003,2.598003
5640,2800,6940,19432000,2,45126,11283,1,594924800,594924800,16921,5640,11281,5640,0,1,5642,897823,0.897823
6040,2800,6940,19432000,2,48326,12083,1,626092800,626092800,18121,6040,12081,6040,0,1,6042,520787,0.520787
6440,2800,6940,19432000,2,51526,12883,1,657260800,657260800,19321,6440,12881,6440,0,1,6442,2680654,2.680654
6840,2800,6940,19432000,2,54726,13683,1,688428800,688428800,20521,6840,13681,6840,0,1,6842,3369253,3.369253
55,5305,3665,19442825,2,446,113,1,159489400,159489400,166,55,111,55,0,1,57,388267,0.388267
455,5305,3665,19442825,2,3646,913,1,188193400,188193400,1366,455,911,455,0,1,457,253256,0.253256
855,5305,3665,19442825,2,6846,1713,1,216897400,216897400,2566,855,1711,855,0,1,857,345591,0.345591
1255,5305,3665,19442825,2,10046,2513,1,245601400,245601400,3766,1255,2511,1255,0,1,1257,2870323,2.870323
1655,5305,3665,19442825,2,13246,3313,1,274305400,274305400,4966,1655,3311,1655,0,1,1657,6271030,6.27103
2055,5305,3665,19442825,2,16446,4113,1,303009400,303009400,6166,2055,4111,2055,0,1,2057,56747,0.056747
2455,5305,3665,19442825,2,19646,4913,1,331713400,331713400,7366,2455,4911,2455,0,1,2457,5332547,5.332547
2855,5305,3665,19442825,2,22846,5713,1,360417400,360417400,8566,2855,5711,2855,0,1,2857,3317180,3.31718
3255,5305,3665,19442825,2,26046,6513,1,389121400,389121400,9766,3255,6511,3255,0,1,3257,4389108,4.389108
3655,5305,3665,19442825,2,29246,7313,1,417825400,417825400,10966,3655,7311,3655,0,1,3657,6529560,6.52956
4055,5305,3665,19442825,2,32446,8113,1,446529400,446529400,12166,4055,8111,4055,0,1,4057,1747644,1.747644
4455,5305,3665,19442825,2,35646,8913,1,475233400,475233400,13366,4455,8911,4455,0,1,4457,4019921,4.019921
4855,5305,3665,19442825,2,38846,9713,1,503937400,503937400,14566,4855,9711,4855,0,1,4857,679334,0.679334
5255,5305,3665,19442825,2,42046,10513,1,532641400,532641400,15766,5255,10511,5255,0,1,5257,6177051,6.177051
5655,5305,3665,19442825,2,45246,11313,1,561345400,561345400,16966,5655,11311,5655,0,1,5657,472339,0.472339
6055,5305,3665,19442825,2,48446,12113,1,590049400,590049400,18166,6055,12111,6055,0,1,6057,1988711,1.988711
6455,5305,3665,19442825,2,51646,12913,1,618753400,618753400,19366,6455,12911,6455,0,1,6457,1014431,1.014431
6855,5305,3665,19442825,2,54846,13713,1,647457400,647457400,20566,6855,13711,6855,0,1,6857,1235624,1.235624
55,3055,6365,19445075,2,446,113,1,159705400,159705400,166,55,111,55,0,1,57,19351,0.019351
455,3055,6365,19445075,2,3646,913,1,189849400,189849400,1366,455,911,455,0,1,457,156284,0.156284
855,3055,6365,19445075,2,6846,1713,1,219993400,219993400,2566,855,1711,855,0,1,857,269293,0.269293
1255,3055,6365,19445075,2,10046,2513,1,250137400,250137400,3766,1255,2511,1255,0,1,1257,65652,0.065652
1655,3055,6365,19445075,2,13246,3313,1,280281400,280281400,4966,1655,3311,1655,0,1,1657,31160,0.03116
2055,3055,6365,19445075,2,16446,4113,1,310425400,310425400,6166,2055,4111,2055,0,1,2057,388579,0.388579
2455,3055,6365,19445075,2,19646,4913,1,340569400,340569400,7366,2455,4911,2455,0,1,2457,61948,0.061948
2855,3055,6365,19445075,2,22846,5713,1,370713400,370713400,8566,2855,5711,2855,0,1,2857,1225119,1.225119
3255,3055,6365,19445075,2,26046,6513,1,400857400,400857400,9766,3255,6511,3255,0,1,3257,579984,0.579984
3655,3055,6365,19445075,2,29246,7313,1,431001400,431001400,10966,3655,7311,3655,0,1,3657,1253736,1.253736
4055,3055,6365,19445075,2,32446,8113,1,461145400,461145400,12166,4055,8111,4055,0,1,4057,109446,0.109446
4455,3055,6365,19445075,2,35646,8913,1,491289400,491289400,13366,4455,8911,4455,0,1,4457,2082873,2.082873
4855,3055,6365,19445075,2,38846,9713,1,521433400,521433400,14566,4855,9711,4855,0,1,4857,1029014,1.029014
5255,3055,6365,19445075,2,42046,10513,1,551577400,551577400,15766,5255,10511,5255,0,1,5257,800475,0.800475
5655,3055,6365,19445075,2,45246,11313,1,581721400,581721400,16966,5655,11311,5655,0,1,5657,727417,0.727417
6055,3055,6365,19445075,2,48446,12113,1,611865400,611865400,18166,6055,12111,6055,0,1,6057,249380,0.24938
6455,3055,6365,19445075,2,51646,12913,1,642009400,642009400,19366,6455,12911,6455,0,1,6457,928382,0.928382
6855,3055,6365,19445075,2,54846,13713,1,672153400,672153400,20566,6855,13711,6855,0,1,6857,231727,0.231727
35,5500,3545,19497500,2,286,73,1,158512600,158512600,106,35,71,35,0,1,37,122373,0.122373
535,5500,3545,19497500,2,4286,1073,1,194692600,194692600,1606,535,1071,535,0,1,537,634326,0.634326
1035,5500,3545,19497500,2,8286,2073,1,230872600,230872600,3106,1035,2071,1035,0,1,1037,1007898,1.007898
1535,5500,3545,19497500,2,12286,3073,1,267052600,267052600,4606,1535,3071,1535,0,1,1537,327106,0.327106
2035,5500,3545,19497500,2,16286,4073,1,303232600,303232600,6106,2035,4071,2035,0,1,2037,1174790,1.17479
2535,5500,3545,19497500,2,20286,5073,1,339412600,339412600,7606,2535,5071,2535,0,1,2537,817171,0.817171
3035,5500,3545,19497500,2,24286,6073,1,375592600,375592600,9106,3035,6071,3035,0,1,3037,291567,0.291567
3535,5500,3545,19497500,2,28286,7073,1,411772600,411772600,10606,3535,7071,3535,0,1,3537,542726,0.542726
4035,5500,3545,19497500,2,32286,8073,1,447952600,447952600,12106,4035,8071,4035,0,1,4037,2499509,2.499509
4535,5500,3545,19497500,2,36286,9073,1,484132600,484132600,13606,4535,9071,4535,0,1,4537,7561929,7.561929
5035,5500,3545,19497500,2,40286,10073,1,520312600,520312600,15106,5035,10071,5035,0,1,5037,189623,0.189623
5535,5500,3545,19497500,2,44286,11073,1,556492600,556492600,16606,5535,11071,5535,0,1,5537,3432082,3.432082
6035,5500,3545,19497500,2,48286,12073,1,592672600,592672600,18106,6035,12071,6035,0,1,6037,2201080,2.20108
6535,5500,3545,19497500,2,52286,13073,1,628852600,628852600,19606,6535,13071,6535,0,1,6537,2680904,2.680904
7035,5500,3545,19497500,2,56286,14073,1,665032600,665032600,21106,7035,14071,7035,0,1,7037,1338431,1.338431
55,7055,2765,19507075,2,446,113,1,160377400,160377400,166,55,111,55,0,1,57,313343,0.313343
455,7055,2765,19507075,2,3646,913,1,191801400,191801400,1366,455,911,455,0,1,457,1889070,1.88907
855,7055,2765,19507075,2,6846,1713,1,223225400,223225400,2566,855,1711,855,0,1,857,1206906,1.206906
1255,7055,2765,19507075,2,10046,2513,1,254649400,254649400,3766,1255,2511,1255,0,1,1257,4530775,4.530775
1655,7055,2765,19507075,2,13246,3313,1,286073400,286073400,4966,1655,3311,1655,0,1,1657,6355980,6.35598
2055,7055,2765,19507075,2,16446,4113,1,317497400,317497400,6166,2055,4111,2055,0,1,2057,685184,0.685184
2455,7055,2765,19507075,2,19646,4913,1,348921400,348921400,7366,2455,4911,2455,0,1,2457,410607,0.410607
2855,7055,2765,19507075,2,22846,5713,1,380345400,380345400,8566,2855,5711,2855,0,1,2857,3032102,3.032102
3255,7055,2765,19507075,2,26046,6513,1,411769400,411769400,9766,3255,6511,3255,0,1,3257,11924515,11.924515
3655,7055,2765,19507075,2,29246,7313,1,443193400,443193400,10966,3655,7311,3655,0,1,3657,1670760,1.67076
4055,7055,2765,19507075,2,32446,8113,1,474617400,474617400,12166,4055,8111,4055,0,1,4057,4295113,4.295113
4455,7055,2765,19507075,2,35646,8913,1,506041400,506041400,13366,4455,8911,4455,0,1,4457,9891852,9.891852
4855,7055,2765,19507075,2,38846,9713,1,537465400,537465400,14566,4855,9711,4855,0,1,4857,688570,0.68857
5255,7055,2765,19507075,2,42046,10513,1,568889400,568889400,15766,5255,10511,5255,0,1,5257,7342624,7.342624
5655,7055,2765,19507075,2,45246,11313,1,600313400,600313400,16966,5655,11311,5655,0,1,5657,20750932,20.750932
6055,7055,2765,19507075,2,48446,12113,1,631737400,631737400,18166,6055,12111,6055,0,1,6057,23258417,23.258417
6455,7055,2765,19507075,2,51646,12913,1,663161400,663161400,19366,6455,12911,6455,0,1,6457,24751097,24.751097
6855,7055,2765,19507075,2,54846,13713,1,694585400,694585400,20566,6855,13711,6855,0,1,6857,26303381,26.303381
40,4300,4540,19522000,2,326,83,1,159004800,159004800,121,40,81,40,0,1,42,352761,0.352761
440,4300,4540,19522000,2,3526,883,1,187292800,187292800,1321,440,881,440,0,1,442,1755812,1.755812
840,4300,4540,19522000,2,6726,1683,1,215580800,215580800,2521,840,1681,840,0,1,842,627646,0.627646
1240,4300,4540,19522000,2,9926,2483,1,243868800,243868800,3721,1240,2481,1240,0,1,1242,1728592,1.728592
1640,4300,4540,19522000,2,13126,3283,1,272156800,272156800,4921,1640,3281,1640,0,1,1642,277236,0.277236
2040,4300,4540,19522000,2,16326,4083,1,300444800,300444800,6121,2040,4081,2040,0,1,2042,289001,0.289001
2440,4300,4540,19522000,2,19526,4883,1,328732800,328732800,7321,2440,4881,2440,0,1,2442,639575,0.639575
2840,4300,4540,19522000,2,22726,5683,1,357020800,357020800,8521,2840,5681,2840,0,1,2842,2241815,2.241815
3240,4300,4540,19522000,2,25926,6483,1,385308800,385308800,9721,3240,6481,3240,0,1,3242,4348157,4.348157
3640,4300,4540,19522000,2,29126,7283,1,413596800,413596800,10921,3640,7281,3640,0,1,3642,2995976,2.995976
4040,4300,4540,19522000,2,32326,8083,1,441884800,441884800,12121,4040,8081,4040,0,1,4042,960304,0.960304
4440,4300,4540,19522000,2,35526,8883,1,470172800,470172800,13321,4440,8881,4440,0,1,4442,190107,0.190107
4840,4300,4540,19522000,2,38726,9683,1,498460800,498460800,14521,4840,9681,4840,0,1,4842,1913163,1.913163
5240,4300,4540,19522000,2,41926,10483,1,526748800,526748800,15721,5240,10481,5240,0,1,5242,3485754,3.485754
5640,4300,4540,19522000,2,45126,11283,1,555036800,555036800,16921,5640,11281,5640,0,1,5642,3415171,3.415171
6040,4300,4540,19522000,2,48326,12083,1,583324800,583324800,18121,6040,12081,6040,0,1,6042,1617004,1.617004
6440,4300,4540,19522000,2,51526,12883,1,611612800,611612800,19321,6440,12881,6440,0,1,6442,2170300,2.1703
6840,4300,4540,19522000,2,54726,13683,1,639900800,639900800,20521,6840,13681,6840,0,1,6842,5503485,5.503485
40,3800,5140,19532000,2,326,83,1,159116800,159116800,121,40,81,40,0,1,42,352688,0.352688
440,3800,5140,19532000,2,3526,883,1,187724800,187724800,1321,440,881,440,0,1,442,1805501,1.805501
840,3800,5140,19532000,2,6726,1683,1,216332800,216332800,2521,840,1681,840,0,1,842,3293497,3.293497
1240,3800,5140,19532000,2,9926,2483,1,244940800,244940800,3721,1240,2481,1240,0,1,1242,746651,0.746651
1640,3800,5140,19532000,2,13126,3283,1,273548800,273548800,4921,1640,3281,1640,0,1,1642,50497,0.050497
2040,3800,5140,19532000,2,16326,4083,1,302156800,302156800,6121,2040,4081,2040,0,1,2042,5279582,5.279582
2440,3800,5140,19532000,2,19526,4883,1,330764800,330764800,7321,2440,4881,2440,0,1,2442,2121533,2.121533
2840,3800,5140,19532000,2,22726,5683,1,359372800,359372800,8521,2840,5681,2840,0,1,2842,2925910,2.92591
3240,3800,5140,19532000,2,25926,6483,1,387980800,387980800,9721,3240,6481,3240,0,1,3242,2964626,2.964626
3640,3800,5140,19532000,2,29126,7283,1,416588800,416588800,10921,3640,7281,3640,0,1,3642,187153,0.187153
4040,3800,5140,19532000,2,32326,8083,1,445196800,445196800,12121,4040,8081,4040,0,1,4042,583814,0.583814
4440,3800,5140,19532000,2,35526,8883,1,473804800,473804800,13321,4440,8881,4440,0,1,4442,8660324,8.660324
4840,3800,5140,19532000,2,38726,9683,1,502412800,502412800,14521,4840,9681,4840,0,1,4842,7379725,7.379725
5240,3800,5140,19532000,2,41926,10483,1,531020800,531020800,15721,5240,10481,5240,0,1,5242,7124802,7.124802
5640,3800,5140,19532000,2,45126,11283,1,559628800,559628800,16921,5640,11281,5640,0,1,5642,1601253,1.601253
6040,3800,5140,19532000,2,48326,12083,1,588236800,588236800,18121,6040,12081,6040,0,1,6042,5623757,5.623757
6440,3800,5140,19532000,2,51526,12883,1,616844800,616844800,19321,6440,12881,6440,0,1,6442,1375676,1.375676
6840,3800,5140,19532000,2,54726,13683,1,645452800,645452800,20521,6840,13681,6840,0,1,6842,2321326,2.321326
55,5805,3365,19533825,2,446,113,1,160305400,160305400,166,55,111,55,0,1,57,24459,0.024459
455,5805,3365,19533825,2,3646,913,1,189649400,189649400,1366,455,911,455,0,1,457,99500,0.0995
855,5805,3365,19533825,2,6846,1713,1,218993400,218993400,2566,855,1711,855,0,1,857,151232,0.151232
1255,5805,3365,19533825,2,10046,2513,1,248337400,248337400,3766,1255,2511,1255,0,1,1257,43796,0.043796
1655,5805,3365,19533825,2,13246,3313,1,277681400,277681400,4966,1655,3311,1655,0,1,1657,288813,0.288813
2055,5805,3365,19533825,2,16446,4113,1,307025400,307025400,6166,2055,4111,2055,0,1,2057,237800,0.2378
2455,5805,3365,19533825,2,19646,4913,1,336369400,336369400,7366,2455,4911,2455,0,1,2457,1212397,1.212397
2855,5805,3365,19533825,2,22846,5713,1,365713400,365713400,8566,2855,5711,2855,0,1,2857,570898,0.570898
3255,5805,3365,19533825,2,26046,6513,1,395057400,395057400,9766,3255,6511,3255,0,1,3257,568895,0.568895
3655,5805,3365,19533825,2,29246,7313,1,424401400,424401400,10966,3655,7311,3655,0,1,3657,923944,0.923944
4055,5805,3365,19533825,2,32446,8113,1,453745400,453745400,12166,4055,8111,4055,0,1,4057,2313900,2.3139
4455,5805,3365,19533825,2,35646,8913,1,483089400,483089400,13366,4455,8911,4455,0,1,4457,2897051,2.897051
4855,5805,3365,19533825,2,38846,9713,1,512433400,512433400,14566,4855,9711,4855,0,1,4857,3490480,3.49048
5255,5805,3365,19533825,2,42046,10513,1,541777400,541777400,15766,5255,10511,5255,0,1,5257,249585,0.249585
5655,5805,3365,19533825,2,45246,11313,1,571121400,571121400,16966,5655,11311,5655,0,1,5657,2167348,2.167348
6055,5805,3365,19533825,2,48446,12113,1,600465400,600465400,18166,6055,12111,6055,0,1,6057,480240,0.48024
6455,5805,3365,19533825,2,51646,12913,1,629809400,629809400,19366,6455,12911,6455,0,1,6457,779242,0.779242
6855,5805,3365,19533825,2,54846,13713,1,659153400,659153400,20566,6855,13711,6855,0,1,6857,936511,0.936511
55,2805,6965,19536825,2,446,113,1,160593400,160593400,166,55,111,55,0,1,57,389114,0.389114
455,2805,6965,19536825,2,3646,913,1,191857400,191857400,1366,455,911,455,0,1,457,1795379,1.795379
855,2805,6965,19536825,2,6846,1713,1,223121400,223121400,2566,855,1711,855,0,1,857,2442958,2.442958
1255,2805,6965,19536825,2,10046,2513,1,254385400,254385400,3766,1255,2511,1255,0,1,1257,674664,0.674664
1655,2805,6965,19536825,2,13246,3313,1,285649400,285649400,4966,1655,3311,1655,0,1,1657,6108503,6.108503
2055,2805,6965,19536825,2,16446,4113,1,316913400,316913400,6166,2055,4111,2055,0,1,2057,3589816,3.589816
2455,2805,6965,19536825,2,19646,4913,1,348177400,348177400,7366,2455,4911,2455,0,1,2457,127107,0.127107
2855,2805,6965,19536825,2,22846,5713,1,379441400,379441400,8566,2855,5711,2855,0,1,2857,2069139,2.069139
3255,2805,6965,19536825,2,26046,6513,1,410705400,410705400,9766,3255,6511,3255,0,1,3257,6383955,6.383955
3655,2805,6965,19536825,2,29246,7313,1,441969400,441969400,10966,3655,7311,3655,0,1,3657,1644298,1.644298
4055,2805,6965,19536825,2,32446,8113,1,473233400,473233400,12166,4055,8111,4055,0,1,4057,1042344,1.042344
4455,2805,6965,19536825,2,35646,8913,1,504497400,504497400,13366,4455,8911,4455,0,1,4457,11049960,11.04996
4855,2805,6965,19536825,2,38846,9713,1,535761400,535761400,14566,4855,9711,4855,0,1,4857,329939,0.329939
5255,2805,6965,19536825,2,42046,10513,1,567025400,567025400,15766,5255,10511,5255,0,1,5257,149358,0.149358
5655,2805,6965,19536825,2,45246,11313,1,598289400,598289400,16966,5655,11311,5655,0,1,5657,3490916,3.490916
6055,2805,6965,19536825,2,48446,12113,1,629553400,629553400,18166,6055,12111,6055,0,1,6057,510893,0.510893
6455,2805,6965,19536825,2,51646,12913,1,660817400,660817400,19366,6455,12911,6455,0,1,6457,2419513,2.419513
6855,2805,6965,19536825,2,54846,13713,1,692081400,692081400,20566,6855,13711,6855,0,1,6857,2223428,2.223428
40,4050,4840,19602000,2,326,83,1,159660800,159660800,121,40,81,40,0,1,42,26441,0.026441
440,4050,4840,19602000,2,3526,883,1,188108800,188108800,1321,440,881,440,0,1,442,14940,0.01494
840,4050,4840,19602000,2,6726,1683,1,216556800,216556800,2521,840,1681,840,0,1,842,278614,0.278614
1240,4050,4840,19602000,2,9926,2483,1,245004800,245004800,3721,1240,2481,1240,0,1,1242,56578,0.056578
1640,4050,4840,19602000,2,13126,3283,1,273452800,273452800,4921,1640,3281,1640,0,1,1642,110789,0.110789
2040,4050,4840,19602000,2,16326,4083,1,301900800,301900800,6121,2040,4081,2040,0,1,2042,345310,0.34531
2440,4050,4840,19602000,2,19526,4883,1,330348800,330348800,7321,2440,4881,2440,0,1,2442,390399,0.390399
2840,4050,4840,19602000,2,22726,5683,1,358796800,358796800,8521,2840,5681,2840,0,1,2842,2130148,2.130148
3240,4050,4840,19602000,2,25926,6483,1,387244800,387244800,9721,3240,6481,3240,0,1,3242,123525,0.123525
3640,4050,4840,19602000,2,29126,7283,1,415692800,415692800,10921,3640,7281,3640,0,1,3642,1678463,1.678463
4040,4050,4840,19602000,2,32326,8083,1,444140800,444140800,12121,4040,8081,4040,0,1,4042,1418260,1.41826
4440,4050,4840,19602000,2,35526,8883,1,472588800,472588800,13321,4440,8881,4440,0,1,4442,708222,0.708222
4840,4050,4840,19602000,2,38726,9683,1,501036800,501036800,14521,4840,9681,4840,0,1,4842,578603,0.578603
5240,4050,4840,19602000,2,41926,10483,1,529484800,529484800,15721,5240,10481,5240,0,1,5242,1158160,1.15816
5640,4050,4840,19602000,2,45126,11283,1,557932800,557932800,16921,5640,11281,5640,0,1,5642,139963,0.139963
6040,4050,4840,19602000,2,48326,12083,1,586380800,586380800,18121,6040,12081,6040,0,1,6042,1275896,1.275896
6440,4050,4840,19602000,2,51526,12883,1,614828800,614828800,19321,6440,12881,6440,0,1,6442,432718,0.432718
6840,4050,4840,19602000,2,54726,13683,1,643276800,643276800,20521,6840,13681,6840,0,1,6842,241917,0.241917
39,3893,5041,19624613,2,318,81,1,159784312,159784312,118,39,79,39,0,1,41,344518,0.344518
539,3893,5041,19624613,2,4318,1081,1,195520312,195520312,1618,539,1079,539,0,1,541,1232355,1.232355
1039,3893,5041,19624613,2,8318,2081,1,231256312,231256312,3118,1039,2079,1039,0,1,1041,1373329,1.373329
1539,3893,5041,19624613,2,12318,3081,1,266992312,266992312,4618,1539,3079,1539,0,1,1541,1393469,1.393469
2039,3893,5041,19624613,2,16318,4081,1,302728312,302728312,6118,2039,4079,2039,0,1,2041,1816337,1.816337
2539,3893,5041,19624613,2,20318,5081,1,338464312,338464312,7618,2539,5079,2539,0,1,2541,1875427,1.875427
3039,3893,5041,19624613,2,24318,6081,1,374200312,374200312,9118,3039,6079,3039,0,1,3041,1868677,1.868677
3539,3893,5041,19624613,2,28318,7081,1,409936312,409936312,10618,3539,7079,3539,0,1,3541,89067,0.089067
4039,3893,5041,19624613,2,32318,8081,1,445672312,445672312,12118,4039,8079,4039,0,1,4041,37515,0.037515
4539,3893,5041,19624613,2,36318,9081,1,481408312,481408312,13618,4539,9079,4539,0,1,4541,1483046,1.483046
5039,3893,5041,19624613,2,40318,10081,1,517144312,517144312,15118,5039,10079,5039,0,1,5041,4450183,4.450183
5539,3893,5041,19624613,2,44318,11081,1,552880312,552880312,16618,5539,11079,5539,0,1,5541,2947536,2.947536
6039,3893,5041,19624613,2,48318,12081,1,588616312,588616312,18118,6039,12079,6039,0,1,6041,3865634,3.865634
6539,3893,5041,19624613,2,52318,13081,1,624352312,624352312,19618,6539,13079,6539,0,1,6541,12835045,12.835045
7039,3893,5041,19624613,2,56318,14081,1,660088312,660088312,21118,7039,14079,7039,0,1,7041,11527271,11.527271
39,5543,3541,19627763,2,318,81,1,159856312,159856312,118,39,79,39,0,1,41,44885,0.044885
539,5543,3541,19627763,2,4318,1081,1,196192312,196192312,1618,539,1079,539,0,1,541,18983,0.018983
1039,5543,3541,19627763,2,8318,2081,1,232528312,232528312,3118,1039,2079,1039,0,1,1041,68077,0.068077
1539,5543,3541,19627763,2,12318,3081,1,268864312,268864312,4618,1539,3079,1539,0,1,1541,81111,0.081111
2039,5543,3541,19627763,2,16318,4081,1,305200312,305200312,6118,2039,4079,2039,0,1,2041,168182,0.168182
2539,5543,3541,19627763,2,20318,5081,1,341536312,341536312,7618,2539,5079,2539,0,1,2541,1519258,1.519258
3039,5543,3541,19627763,2,24318,6081,1,377872312,377872312,9118,3039,6079,3039,0,1,3041,3076033,3.076033
3539,5543,3541,19627763,2,28318,7081,1,414208312,414208312,10618,3539,7079,3539,0,1,3541,2051303,2.051303
4039,5543,3541,19627763,2,32318,8081,1,450544312,450544312,12118,4039,8079,4039,0,1,4041,744244,0.744244
4539,5543,3541,19627763,2,36318,9081,1,486880312,486880312,13618,4539,9079,4539,0,1,4541,389242,0.389242
5039,5543,3541,19627763,2,40318,10081,1,523216312,523216312,15118,5039,10079,5039,0,1,5041,3547032,3.547032
5539,5543,3541,19627763,2,44318,11081,1,559552312,559552312,16618,5539,11079,5539,0,1,5541,5262324,5.262324
6039,5543,3541,19627763,2,48318,12081,1,595888312,595888312,18118,6039,12079,6039,0,1,6041,994020,0.99402
6539,5543,3541,19627763,2,52318,13081,1,632224312,632224312,19618,6539,13079,6539,0,1,6541,925777,0.925777
7039,5543,3541,19627763,2,56318,14081,1,668560312,668560312,21118,7039,14079,7039,0,1,7041,1973573,1.973573
35,5540,3545,19639300,2,286,73,1,159658200,159658200,106,35,71,35,0,1,37,242601,0.242601
535,5540,3545,19639300,2,4286,1073,1,195998200,195998200,1606,535,1071,535,0,1,537,643280,0.64328
1035,5540,3545,19639300,2,8286,2073,1,232338200,232338200,3106,1035,2071,1035,0,1,1037,1157897,1.157897
1535,5540,3545,19639300,2,12286,3073,1,268678200,268678200,4606,1535,3071,1535,0,1,1537,76458,0.076458
55,4305,4565,19652325,2,446,113,1,161121400,161121400,166,55,111,55,0,1,57,390799,0.390799
455,4305,4565,19652325,2,3646,913,1,189505400,189505400,1366,455,911,455,0,1,457,194524,0.194524
855,4305,4565,19652325,2,6846,1713,1,217889400,217889400,2566,855,1711,855,0,1,857,890139,0.890139
1255,4305,4565,19652325,2,10046,2513,1,246273400,246273400,3766,1255,2511,1255,0,1,1257,290472,0.290472
1655,4305,4565,19652325,2,13246,3313,1,274657400,274657400,4966,1655,3311,1655,0,1,1657,361764,0.361764
2055,4305,4565,19652325,2,16446,4113,1,303041400,303041400,6166,2055,4111,2055,0,1,2057,1026986,1.026986
2455,4305,4565,19652325,2,19646,4913,1,331425400,331425400,7366,2455,4911,2455,0,1,2457,1528719,1.528719
2855,4305,4565,19652325,2,22846,5713,1,359809400,359809400,8566,2855,5711,2855,0,1,2857,1158343,1.158343
3255,4305,4565,19652325,2,26046,6513,1,388193400,388193400,9766,3255,6511,3255,0,1,3257,1602303,1.602303
3655,4305,4565,19652325,2,29246,7313,1,416577400,416577400,10966,3655,7311,3655,0,1,3657,861189,0.861189
4055,4305,4565,19652325,2,32446,8113,1,444961400,444961400,12166,4055,8111,4055,0,1,4057,935810,0.93581
4455,4305,4565,19652325,2,35646,8913,1,473345400,473345400,13366,4455,8911,4455,0,1,4457,2534144,2.534144
4855,4305,4565,19652325,2,38846,9713,1,501729400,501729400,14566,4855,9711,4855,0,1,4857,3405308,3.405308
5255,4305,4565,19652325,2,42046,10513,1,530113400,530113400,15766,5255,10511,5255,0,1,5257,5310891,5.310891
5655,4305,4565,19652325,2,45246,11313,1,558497400,558497400,16966,5655,11311,5655,0,1,5657,1859389,1.859389
6055,4305,4565,19652325,2,48446,12113,1,586881400,586881400,18166,6055,12111,6055,0,1,6057,2308372,2.308372
6455,4305,4565,19652325,2,51646,12913,1,615265400,615265400,19366,6455,12911,6455,0,1,6457,2316180,2.31618
6855,4305,4565,19652325,2,54846,13713,1,643649400,643649400,20566,6855,13711,6855,0,1,6857,1671942,1.671942
55,3805,5165,19652825,2,446,113,1,161169400,161169400,166,55,111,55,0,1,57,411829,0.411829
455,3805,5165,19652825,2,3646,913,1,189873400,189873400,1366,455,911,455,0,1,457,1075243,1.075243
855,3805,5165,19652825,2,6846,1713,1,218577400,218577400,2566,855,1711,855,0,1,857,3428220,3.42822
1255,3805,5165,19652825,2,10046,2513,1,247281400,247281400,3766,1255,2511,1255,0,1,1257,1980655,1.980655
1655,3805,5165,19652825,2,13246,3313,1,275985400,275985400,4966,1655,3311,1655,0,1,1657,6397165,6.397165
2055,3805,5165,19652825,2,16446,4113,1,304689400,304689400,6166,2055,4111,2055,0,1,2057,1339227,1.339227
2455,3805,5165,19652825,2,19646,4913,1,333393400,333393400,7366,2455,4911,2455,0,1,2457,3245017,3.245017
2855,3805,5165,19652825,2,22846,5713,1,362097400,362097400,8566,2855,5711,2855,0,1,2857,875663,0.875663
3255,3805,5165,19652825,2,26046,6513,1,390801400,390801400,9766,3255,6511,3255,0,1,3257,458488,0.458488
3655,3805,5165,19652825,2,29246,7313,1,419505400,419505400,10966,3655,7311,3655,0,1,3657,1924522,1.924522
4055,3805,5165,19652825,2,32446,8113,1,448209400,448209400,12166,4055,8111,4055,0,1,4057,2177751,2.177751
4455,3805,5165,19652825,2,35646,8913,1,476913400,476913400,13366,4455,8911,4455,0,1,4457,5738776,5.738776
4855,3805,5165,19652825,2,38846,9713,1,505617400,505617400,14566,4855,9711,4855,0,1,4857,4249502,4.249502
5255,3805,5165,19652825,2,42046,10513,1,534321400,534321400,15766,5255,10511,5255,0,1,5257,2638156,2.638156
5655,3805,5165,19652825,2,45246,11313,1,563025400,563025400,16966,5655,11311,5655,0,1,5657,232723,0.232723
6055,3805,5165,19652825,2,48446,12113,1,591729400,591729400,18166,6055,12111,6055,0,1,6057,1383022,1.383022
6455,3805,5165,19652825,2,51646,12913,1,620433400,620433400,19366,6455,12911,6455,0,1,6457,816639,0.816639
6855,3805,5165,19652825,2,54846,13713,1,649137400,649137400,20566,6855,13711,6855,0,1,6857,2726589,2.726589
39,2793,7041,19665513,2,318,81,1,160392312,160392312,118,39,79,39,0,1,41,351834,0.351834
539,2793,7041,19665513,2,4318,1081,1,199728312,199728312,1618,539,1079,539,0,1,541,2152229,2.152229
1039,2793,7041,19665513,2,8318,2081,1,239064312,239064312,3118,1039,2079,1039,0,1,1041,1456516,1.456516
1539,2793,7041,19665513,2,12318,3081,1,278400312,278400312,4618,1539,3079,1539,0,1,1541,1507392,1.507392
2039,2793,7041,19665513,2,16318,4081,1,317736312,317736312,6118,2039,4079,2039,0,1,2041,4799096,4.799096
2539,2793,7041,19665513,2,20318,5081,1,357072312,357072312,7618,2539,5079,2539,0,1,2541,4869218,4.869218
3039,2793,7041,19665513,2,24318,6081,1,396408312,396408312,9118,3039,6079,3039,0,1,3041,6494072,6.494072
3539,2793,7041,19665513,2,28318,7081,1,435744312,435744312,10618,3539,7079,3539,0,1,3541,2139288,2.139288
4039,2793,7041,19665513,2,32318,8081,1,475080312,475080312,12118,4039,8079,4039,0,1,4041,515404,0.515404
4539,2793,7041,19665513,2,36318,9081,1,514416312,514416312,13618,4539,9079,4539,0,1,4541,1301931,1.301931
5039,2793,7041,19665513,2,40318,10081,1,553752312,553752312,15118,5039,10079,5039,0,1,5041,1978744,1.978744
5539,2793,7041,19665513,2,44318,11081,1,593088312,593088312,16618,5539,11079,5539,0,1,5541,2989097,2.989097
6039,2793,7041,19665513,2,48318,12081,1,632424312,632424312,18118,6039,12079,6039,0,1,6041,3278937,3.278937
6539,2793,7041,19665513,2,52318,13081,1,671760312,671760312,19618,6539,13079,6539,0,1,6541,2265690,2.26569
7039,2793,7041,19665513,2,56318,14081,1,711096312,711096312,21118,7039,14079,7039,0,1,7041,12102548,12.102548
55,4055,4865,19727575,2,446,113,1,161745400,161745400,166,55,111,55,0,1,57,46708,0.046708
455,4055,4865,19727575,2,3646,913,1,190289400,190289400,1366,455,911,455,0,1,457,41621,0.041621
855,4055,4865,19727575,2,6846,1713,1,218833400,218833400,2566,855,1711,855,0,1,857,26437,0.026437
1255,4055,4865,19727575,2,10046,2513,1,247377400,247377400,3766,1255,2511,1255,0,1,1257,160888,0.160888
1655,4055,4865,19727575,2,13246,3313,1,275921400,275921400,4966,1655,3311,1655,0,1,1657,328131,0.328131
2055,4055,4865,19727575,2,16446,4113,1,304465400,304465400,6166,2055,4111,2055,0,1,2057,22894,0.022894
2455,4055,4865,19727575,2,19646,4913,1,333009400,333009400,7366,2455,4911,2455,0,1,2457,149633,0.149633
2855,4055,4865,19727575,2,22846,5713,1,361553400,361553400,8566,2855,5711,2855,0,1,2857,1041130,1.04113
3255,4055,4865,19727575,2,26046,6513,1,390097400,390097400,9766,3255,6511,3255,0,1,3257,220713,0.220713
3655,4055,4865,19727575,2,29246,7313,1,418641400,418641400,10966,3655,7311,3655,0,1,3657,1717628,1.717628
4055,4055,4865,19727575,2,32446,8113,1,447185400,447185400,12166,4055,8111,4055,0,1,4057,276413,0.276413
4455,4055,4865,19727575,2,35646,8913,1,475729400,475729400,13366,4455,8911,4455,0,1,4457,103210,0.10321
4855,4055,4865,19727575,2,38846,9713,1,504273400,504273400,14566,4855,9711,4855,0,1,4857,3091760,3.09176
5255,4055,4865,19727575,2,42046,10513,1,532817400,532817400,15766,5255,10511,5255,0,1,5257,1455666,1.455666
5655,4055,4865,19727575,2,45246,11313,1,561361400,561361400,16966,5655,11311,5655,0,1,5657,119842,0.119842
6055,4055,4865,19727575,2,48446,12113,1,589905400,589905400,18166,6055,12111,6055,0,1,6057,1834793,1.834793
6455,4055,4865,19727575,2,51646,12913,1,618449400,618449400,19366,6455,12911,6455,0,1,6457,2653658,2.653658
6855,4055,4865,19727575,2,54846,13713,1,646993400,646993400,20566,6855,13711,6855,0,1,6857,3296655,3.296655
44,3903,5055,19729665,2,358,91,1,160990536,160990536,133,44,89,44,0,1,46,377909,0.377909
544,3903,5055,19729665,2,4358,1091,1,196822536,196822536,1633,544,1089,544,0,1,546,1469010,1.46901
1044,3903,5055,19729665,2,8358,2091,1,232654536,232654536,3133,1044,2089,1044,0,1,1046,2244816,2.244816
1544,3903,5055,19729665,2,12358,3091,1,268486536,268486536,4633,1544,3089,1544,0,1,1546,3167746,3.167746
2044,3903,5055,19729665,2,16358,4091,1,304318536,304318536,6133,2044,4089,2044,0,1,2046,945952,0.945952
2544,3903,5055,19729665,2,20358,5091,1,340150536,340150536,7633,2544,5089,2544,0,1,2546,559890,0.55989
3044,3903,5055,19729665,2,24358,6091,1,375982536,375982536,9133,3044,6089,3044,0,1,3046,5947190,5.94719
3544,3903,5055,19729665,2,28358,7091,1,411814536,411814536,10633,3544,7089,3544,0,1,3546,6835326,6.835326
4044,3903,5055,19729665,2,32358,8091,1,447646536,447646536,12133,4044,8089,4044,0,1,4046,2473166,2.473166
4544,3903,5055,19729665,2,36358,9091,1,483478536,483478536,13633,4544,9089,4544,0,1,4546,4500942,4.500942
5044,3903,5055,19729665,2,40358,10091,1,519310536,519310536,15133,5044,10089,5044,0,1,5046,1739308,1.739308
5544,3903,5055,19729665,2,44358,11091,1,555142536,555142536,16633,5544,11089,5544,0,1,5546,479840,0.47984
6044,3903,5055,19729665,2,48358,12091,1,590974536,590974536,18133,6044,12089,6044,0,1,6046,940037,0.940037
6544,3903,5055,19729665,2,52358,13091,1,626806536,626806536,19633,6544,13089,6544,0,1,6546,11417477,11.417477
7044,3903,5055,19729665,2,56358,14091,1,662638536,662638536,21133,7044,14089,7044,0,1,7046,12053414,12.053414
44,5553,3555,19740915,2,358,91,1,161133336,161133336,133,44,89,44,0,1,46,24811,0.024811
544,5553,3555,19740915,2,4358,1091,1,197565336,197565336,1633,544,1089,544,0,1,546,88631,0.088631
1044,5553,3555,19740915,2,8358,2091,1,233997336,233997336,3133,1044,2089,1044,0,1,1046,57433,0.057433
1544,5553,3555,19740915,2,12358,3091,1,270429336,270429336,4633,1544,3089,1544,0,1,1546,331727,0.331727
2044,5553,3555,19740915,2,16358,4091,1,306861336,306861336,6133,2044,4089,2044,0,1,2046,53489,0.053489
2544,5553,3555,19740915,2,20358,5091,1,343293336,343293336,7633,2544,5089,2544,0,1,2546,1316579,1.316579
3044,5553,3555,19740915,2,24358,6091,1,379725336,379725336,9133,3044,6089,3044,0,1,3046,1792625,1.792625
3544,5553,3555,19740915,2,28358,7091,1,416157336,416157336,10633,3544,7089,3544,0,1,3546,422369,0.422369
4044,5553,3555,19740915,2,32358,8091,1,452589336,452589336,12133,4044,8089,4044,0,1,4046,1244509,1.244509
4544,5553,3555,19740915,2,36358,9091,1,489021336,489021336,13633,4544,9089,4544,0,1,4546,2688248,2.688248
5044,5553,3555,19740915,2,40358,10091,1,525453336,525453336,15133,5044,10089,5044,0,1,5046,1422774,1.422774
5544,5553,3555,19740915,2,44358,11091,1,561885336,561885336,16633,5544,11089,5544,0,1,5546,6567628,6.567628
6044,5553,3555,19740915,2,48358,12091,1,598317336,598317336,18133,6044,12089,6044,0,1,6046,3492839,3.492839
6544,5553,3555,19740915,2,52358,13091,1,634749336,634749336,19633,6544,13089,6544,0,1,6546,9252849,9.252849
7044,5553,3555,19740915,2,56358,14091,1,671181336,671181336,21133,7044,14089,7044,0,1,7046,6173238,6.173238
44,2803,7055,19775165,2,358,91,1,161671336,161671336,133,44,89,44,0,1,46,366557,0.366557
544,2803,7055,19775165,2,4358,1091,1,201103336,201103336,1633,544,1089,544,0,1,546,1921312,1.921312
1044,2803,7055,19775165,2,8358,2091,1,240535336,240535336,3133,1044,2089,1044,0,1,1046,987825,0.987825
1544,2803,7055,19775165,2,12358,3091,1,279967336,279967336,4633,1544,3089,1544,0,1,1546,3300886,3.300886
2044,2803,7055,19775165,2,16358,4091,1,319399336,319399336,6133,2044,4089,2044,0,1,2046,2519666,2.519666
2544,2803,7055,19775165,2,20358,5091,1,358831336,358831336,7633,2544,5089,2544,0,1,2546,3147438,3.147438
3044,2803,7055,19775165,2,24358,6091,1,398263336,398263336,9133,3044,6089,3044,0,1,3046,2429397,2.429397
3544,2803,7055,19775165,2,28358,7091,1,437695336,437695336,10633,3544,7089,3544,0,1,3546,2113069,2.113069
4044,2803,7055,19775165,2,32358,8091,1,477127336,477127336,12133,4044,8089,4044,0,1,4046,5162968,5.162968
4544,2803,7055,19775165,2,36358,9091,1,516559336,516559336,13633,4544,9089,4544,0,1,4546,12533505,12.533505
5044,2803,7055,19775165,2,40358,10091,1,555991336,555991336,15133,5044,10089,5044,0,1,5046,731702,0.731702
5544,2803,7055,19775165,2,44358,11091,1,595423336,595423336,16633,5544,11089,5544,0,1,5546,7414455,7.414455
6044,2803,7055,19775165,2,48358,12091,1,634855336,634855336,18133,6044,12089,6044,0,1,6046,628695,0.628695
6544,2803,7055,19775165,2,52358,13091,1,674287336,674287336,19633,6544,13089,6544,0,1,6546,2371073,2.371073
7044,2803,7055,19775165,2,56358,14091,1,713719336,713719336,21133,7044,14089,7044,0,1,7046,3282867,3.282867
40,5050,3940,19897000,2,326,83,1,162052800,162052800,121,40,81,40,0,1,42,43807,0.043807
440,5050,3940,19897000,2,3526,883,1,190820800,190820800,1321,440,881,440,0,1,442,29515,0.029515
840,5050,3940,19897000,2,6726,1683,1,219588800,219588800,2521,840,1681,840,0,1,842,60517,0.060517
1240,5050,3940,19897000,2,9926,2483,1,248356800,248356800,3721,1240,2481,1240,0,1,1242,51952,0.051952
1640,5050,3940,19897000,2,13126,3283,1,277124800,277124800,4921,1640,3281,1640,0,1,1642,508366,0.508366
2040,5050,3940,19897000,2,16326,4083,1,305892800,305892800,6121,2040,4081,2040,0,1,2042,440105,0.440105
2440,5050,3940,19897000,2,19526,4883,1,334660800,334660800,7321,2440,4881,2440,0,1,2442,294757,0.294757
2840,5050,3940,19897000,2,22726,5683,1,363428800,363428800,8521,2840,5681,2840,0,1,2842,129657,0.129657
3240,5050,3940,19897000,2,25926,6483,1,392196800,392196800,9721,3240,6481,3240,0,1,3242,1005522,1.005522
3640,5050,3940,19897000,2,29126,7283,1,420964800,420964800,10921,3640,7281,3640,0,1,3642,440348,0.440348
4040,5050,3940,19897000,2,32326,8083,1,449732800,449732800,12121,4040,8081,4040,0,1,4042,1055124,1.055124
4440,5050,3940,19897000,2,35526,8883,1,478500800,478500800,13321,4440,8881,4440,0,1,4442,846091,0.846091
4840,5050,3940,19897000,2,38726,9683,1,507268800,507268800,14521,4840,9681,4840,0,1,4842,789506,0.789506
5240,5050,3940,19897000,2,41926,10483,1,536036800,536036800,15721,5240,10481,5240,0,1,5242,4437918,4.437918
5640,5050,3940,19897000,2,45126,11283,1,564804800,564804800,16921,5640,11281,5640,0,1,5642,481995,0.481995
6040,5050,3940,19897000,2,48326,12083,1,593572800,593572800,18121,6040,12081,6040,0,1,6042,1599122,1.599122
6440,5050,3940,19897000,2,51526,12883,1,622340800,622340800,19321,6440,12881,6440,0,1,6442,833083,0.833083
6840,5050,3940,19897000,2,54726,13683,1,651108800,651108800,20521,6840,13681,6840,0,1,6842,351967,0.351967
40,6550,3040,19912000,2,326,83,1,162364800,162364800,121,40,81,40,0,1,42,40016,0.040016
440,6550,3040,19912000,2,3526,883,1,193052800,193052800,1321,440,881,440,0,1,442,76826,0.076826
840,6550,3040,19912000,2,6726,1683,1,223740800,223740800,2521,840,1681,840,0,1,842,23613,0.023613
1240,6550,3040,19912000,2,9926,2483,1,254428800,254428800,3721,1240,2481,1240,0,1,1242,396999,0.396999
1640,6550,3040,19912000,2,13126,3283,1,285116800,285116800,4921,1640,3281,1640,0,1,1642,431979,0.431979
2040,6550,3040,19912000,2,16326,4083,1,315804800,315804800,6121,2040,4081,2040,0,1,2042,177791,0.177791
2440,6550,3040,19912000,2,19526,4883,1,346492800,346492800,7321,2440,4881,2440,0,1,2442,315078,0.315078
2840,6550,3040,19912000,2,22726,5683,1,377180800,377180800,8521,2840,5681,2840,0,1,2842,416706,0.416706
3240,6550,3040,19912000,2,25926,6483,1,407868800,407868800,9721,3240,6481,3240,0,1,3242,561698,0.561698
3640,6550,3040,19912000,2,29126,7283,1,438556800,438556800,10921,3640,7281,3640,0,1,3642,1683983,1.683983
4040,6550,3040,19912000,2,32326,8083,1,469244800,469244800,12121,4040,8081,4040,0,1,4042,847439,0.847439
4440,6550,3040,19912000,2,35526,8883,1,499932800,499932800,13321,4440,8881,4440,0,1,4442,293715,0.293715
4840,6550,3040,19912000,2,38726,9683,1,530620800,530620800,14521,4840,9681,4840,0,1,4842,1410571,1.410571
5240,6550,3040,19912000,2,41926,10483,1,561308800,561308800,15721,5240,10481,5240,0,1,5242,720497,0.720497
5640,6550,3040,19912000,2,45126,11283,1,591996800,591996800,16921,5640,11281,5640,0,1,5642,780541,0.780541
6040,6550,3040,19912000,2,48326,12083,1,622684800,622684800,18121,6040,12081,6040,0,1,6042,1099864,1.099864
6440,6550,3040,19912000,2,51526,12883,1,653372800,653372800,19321,6440,12881,6440,0,1,6442,164365,0.164365
6840,6550,3040,19912000,2,54726,13683,1,684060800,684060800,20521,6840,13681,6840,0,1,6842,101009,0.101009
40,3300,6040,19932000,2,326,83,1,162444800,162444800,121,40,81,40,0,1,42,33919,0.033919
440,3300,6040,19932000,2,3526,883,1,192332800,192332800,1321,440,881,440,0,1,442,1827910,1.82791
840,3300,6040,19932000,2,6726,1683,1,222220800,222220800,2521,840,1681,840,0,1,842,156208,0.156208
1240,3300,6040,19932000,2,9926,2483,1,252108800,252108800,3721,1240,2481,1240,0,1,1242,736336,0.736336
1640,3300,6040,19932000,2,13126,3283,1,281996800,281996800,4921,1640,3281,1640,0,1,1642,446745,0.446745
2040,3300,6040,19932000,2,16326,4083,1,311884800,311884800,6121,2040,4081,2040,0,1,2042,639617,0.639617
2440,3300,6040,19932000,2,19526,4883,1,341772800,341772800,7321,2440,4881,2440,0,1,2442,1117548,1.117548
2840,3300,6040,19932000,2,22726,5683,1,371660800,371660800,8521,2840,5681,2840,0,1,2842,1395841,1.395841
3240,3300,6040,19932000,2,25926,6483,1,401548800,401548800,9721,3240,6481,3240,0,1,3242,1224326,1.224326
3640,3300,6040,19932000,2,29126,7283,1,431436800,431436800,10921,3640,7281,3640,0,1,3642,496783,0.496783
4040,3300,6040,19932000,2,32326,8083,1,461324800,461324800,12121,4040,8081,4040,0,1,4042,659152,0.659152
4440,3300,6040,19932000,2,35526,8883,1,491212800,491212800,13321,4440,8881,4440,0,1,4442,114163,0.114163
4840,3300,6040,19932000,2,38726,9683,1,521100800,521100800,14521,4840,9681,4840,0,1,4842,1354785,1.354785
5240,3300,6040,19932000,2,41926,10483,1,550988800,550988800,15721,5240,10481,5240,0,1,5242,1228793,1.228793
5640,3300,6040,19932000,2,45126,11283,1,580876800,580876800,16921,5640,11281,5640,0,1,5642,600597,0.600597
6040,3300,6040,19932000,2,48326,12083,1,610764800,610764800,18121,6040,12081,6040,0,1,6042,138407,0.138407
6440,3300,6040,19932000,2,51526,12883,1,640652800,640652800,19321,6440,12881,6440,0,1,6442,310018,0.310018
6840,3300,6040,19932000,2,54726,13683,1,670540800,670540800,20521,6840,13681,6840,0,1,6842,1010416,1.010416
35,4400,4545,19998000,2,286,73,1,162488600,162488600,106,35,71,35,0,1,37,22269,0.022269
535,4400,4545,19998000,2,4286,1073,1,198268600,198268600,1606,535,1071,535,0,1,537,205936,0.205936
1035,4400,4545,19998000,2,8286,2073,1,234048600,234048600,3106,1035,2071,1035,0,1,1037,1133167,1.133167
1535,4400,4545,19998000,2,12286,3073,1,269828600,269828600,4606,1535,3071,1535,0,1,1537,2112361,2.112361
2035,4400,4545,19998000,2,16286,4073,1,305608600,305608600,6106,2035,4071,2035,0,1,2037,2212638,2.212638
2535,4400,4545,19998000,2,20286,5073,1,341388600,341388600,7606,2535,5071,2535,0,1,2537,609596,0.609596
3035,4400,4545,19998000,2,24286,6073,1,377168600,377168600,9106,3035,6071,3035,0,1,3037,1610269,1.610269
3535,4400,4545,19998000,2,28286,7073,1,412948600,412948600,10606,3535,7071,3535,0,1,3537,6135135,6.135135
4035,4400,4545,19998000,2,32286,8073,1,448728600,448728600,12106,4035,8071,4035,0,1,4037,1809405,1.809405
4535,4400,4545,19998000,2,36286,9073,1,484508600,484508600,13606,4535,9071,4535,0,1,4537,3698100,3.6981
5035,4400,4545,19998000,2,40286,10073,1,520288600,520288600,15106,5035,10071,5035,0,1,5037,351203,0.351203
5535,4400,4545,19998000,2,44286,11073,1,556068600,556068600,16606,5535,11071,5535,0,1,5537,1194415,1.194415
6035,4400,4545,19998000,2,48286,12073,1,591848600,591848600,18106,6035,12071,6035,0,1,6037,4432444,4.432444
6535,4400,4545,19998000,2,52286,13073,1,627628600,627628600,19606,6535,13071,6535,0,1,6537,4745657,4.745657
7035,4400,4545,19998000,2,56286,14073,1,663408600,663408600,21106,7035,14071,7035,0,1,7037,2309368,2.309368
35,4950,4045,20022750,2,286,73,1,162700600,162700600,106,35,71,35,0,1,37,79685,0.079685
535,4950,4045,20022750,2,4286,1073,1,198680600,198680600,1606,535,1071,535,0,1,537,1018493,1.018493
1035,4950,4045,20022750,2,8286,2073,1,234660600,234660600,3106,1035,2071,1035,0,1,1037,646319,0.646319
1535,4950,4045,20022750,2,12286,3073,1,270640600,270640600,4606,1535,3071,1535,0,1,1537,1170670,1.17067
2035,4950,4045,20022750,2,16286,4073,1,306620600,306620600,6106,2035,4071,2035,0,1,2037,509099,0.509099
2535,4950,4045,20022750,2,20286,5073,1,342600600,342600600,7606,2535,5071,2535,0,1,2537,1189849,1.189849
3035,4950,4045,20022750,2,24286,6073,1,378580600,378580600,9106,3035,6071,3035,0,1,3037,1081359,1.081359
3535,4950,4045,20022750,2,28286,7073,1,414560600,414560600,10606,3535,7071,3535,0,1,3537,4368689,4.368689
4035,4950,4045,20022750,2,32286,8073,1,450540600,450540600,12106,4035,8071,4035,0,1,4037,6868945,6.868945
4535,4950,4045,20022750,2,36286,9073,1,486520600,486520600,13606,4535,9071,4535,0,1,4537,334470,0.33447
5035,4950,4045,20022750,2,40286,10073,1,522500600,522500600,15106,5035,10071,5035,0,1,5037,1846147,1.846147
5535,4950,4045,20022750,2,44286,11073,1,558480600,558480600,16606,5535,11071,5535,0,1,5537,4491936,4.491936
6035,4950,4045,20022750,2,48286,12073,1,594460600,594460600,18106,6035,12071,6035,0,1,6037,176017,0.176017
6535,4950,4045,20022750,2,52286,13073,1,630440600,630440600,19606,6535,13071,6535,0,1,6537,698512,0.698512
7035,4950,4045,20022750,2,56286,14073,1,666420600,666420600,21106,7035,14071,7035,0,1,7037,4348827,4.348827
55,5055,3965,20043075,2,446,113,1,164313400,164313400,166,55,111,55,0,1,57,55734,0.055734
455,5055,3965,20043075,2,3646,913,1,193177400,193177400,1366,455,911,455,0,1,457,78756,0.078756
855,5055,3965,20043075,2,6846,1713,1,222041400,222041400,2566,855,1711,855,0,1,857,58323,0.058323
1255,5055,3965,20043075,2,10046,2513,1,250905400,250905400,3766,1255,2511,1255,0,1,1257,164185,0.164185
1655,5055,3965,20043075,2,13246,3313,1,279769400,279769400,4966,1655,3311,1655,0,1,1657,609833,0.609833
2055,5055,3965,20043075,2,16446,4113,1,308633400,308633400,6166,2055,4111,2055,0,1,2057,198306,0.198306
2455,5055,3965,20043075,2,19646,4913,1,337497400,337497400,7366,2455,4911,2455,0,1,2457,123646,0.123646
2855,5055,3965,20043075,2,22846,5713,1,366361400,366361400,8566,2855,5711,2855,0,1,2857,371341,0.371341
3255,5055,3965,20043075,2,26046,6513,1,395225400,395225400,9766,3255,6511,3255,0,1,3257,516219,0.516219
3655,5055,3965,20043075,2,29246,7313,1,424089400,424089400,10966,3655,7311,3655,0,1,3657,1740031,1.740031
4055,5055,3965,20043075,2,32446,8113,1,452953400,452953400,12166,4055,8111,4055,0,1,4057,116206,0.116206
4455,5055,3965,20043075,2,35646,8913,1,481817400,481817400,13366,4455,8911,4455,0,1,4457,2635664,2.635664
4855,5055,3965,20043075,2,38846,9713,1,510681400,510681400,14566,4855,9711,4855,0,1,4857,863114,0.863114
5255,5055,3965,20043075,2,42046,10513,1,539545400,539545400,15766,5255,10511,5255,0,1,5257,394087,0.394087
5655,5055,3965,20043075,2,45246,11313,1,568409400,568409400,16966,5655,11311,5655,0,1,5657,922861,0.922861
6055,5055,3965,20043075,2,48446,12113,1,597273400,597273400,18166,6055,12111,6055,0,1,6057,2243131,2.243131
6455,5055,3965,20043075,2,51646,12913,1,626137400,626137400,19366,6455,12911,6455,0,1,6457,935906,0.935906
6855,5055,3965,20043075,2,54846,13713,1,655001400,655001400,20566,6855,13711,6855,0,1,6857,3438586,3.438586
55,3305,6065,20044825,2,446,113,1,164481400,164481400,166,55,111,55,0,1,57,409913,0.409913
455,3305,6065,20044825,2,3646,913,1,194465400,194465400,1366,455,911,455,0,1,457,824278,0.824278
855,3305,6065,20044825,2,6846,1713,1,224449400,224449400,2566,855,1711,855,0,1,857,3453682,3.453682
1255,3305,6065,20044825,2,10046,2513,1,254433400,254433400,3766,1255,2511,1255,0,1,1257,1494237,1.494237
1655,3305,6065,20044825,2,13246,3313,1,284417400,284417400,4966,1655,3311,1655,0,1,1657,336760,0.33676
2055,3305,6065,20044825,2,16446,4113,1,314401400,314401400,6166,2055,4111,2055,0,1,2057,1405194,1.405194
2455,3305,6065,20044825,2,19646,4913,1,344385400,344385400,7366,2455,4911,2455,0,1,2457,3954117,3.954117
2855,3305,6065,20044825,2,22846,5713,1,374369400,374369400,8566,2855,5711,2855,0,1,2857,3398716,3.398716
3255,3305,6065,20044825,2,26046,6513,1,404353400,404353400,9766,3255,6511,3255,0,1,3257,4685241,4.685241
3655,3305,6065,20044825,2,29246,7313,1,434337400,434337400,10966,3655,7311,3655,0,1,3657,1095925,1.095925
4055,3305,6065,20044825,2,32446,8113,1,464321400,464321400,12166,4055,8111,4055,0,1,4057,249381,0.249381
4455,3305,6065,20044825,2,35646,8913,1,494305400,494305400,13366,4455,8911,4455,0,1,4457,1413692,1.413692
4855,3305,6065,20044825,2,38846,9713,1,524289400,524289400,14566,4855,9711,4855,0,1,4857,191673,0.191673
5255,3305,6065,20044825,2,42046,10513,1,554273400,554273400,15766,5255,10511,5255,0,1,5257,3155198,3.155198
5655,3305,6065,20044825,2,45246,11313,1,584257400,584257400,16966,5655,11311,5655,0,1,5657,963186,0.963186
6055,3305,6065,20044825,2,48446,12113,1,614241400,614241400,18166,6055,12111,6055,0,1,6057,372223,0.372223
6455,3305,6065,20044825,2,51646,12913,1,644225400,644225400,19366,6455,12911,6455,0,1,6457,284161,0.284161
6855,3305,6065,20044825,2,54846,13713,1,674209400,674209400,20566,6855,13711,6855,0,1,6857,4672095,4.672095
55,6555,3065,20091075,2,446,113,1,164961400,164961400,166,55,111,55,0,1,57,16521,0.016521
455,6555,3065,20091075,2,3646,913,1,195745400,195745400,1366,455,911,455,0,1,457,15780,0.01578
855,6555,3065,20091075,2,6846,1713,1,226529400,226529400,2566,855,1711,855,0,1,857,175250,0.17525
1255,6555,3065,20091075,2,10046,2513,1,257313400,257313400,3766,1255,2511,1255,0,1,1257,668284,0.668284
1655,6555,3065,20091075,2,13246,3313,1,288097400,288097400,4966,1655,3311,1655,0,1,1657,205798,0.205798
2055,6555,3065,20091075,2,16446,4113,1,318881400,318881400,6166,2055,4111,2055,0,1,2057,475446,0.475446
2455,6555,3065,20091075,2,19646,4913,1,349665400,349665400,7366,2455,4911,2455,0,1,2457,269581,0.269581
2855,6555,3065,20091075,2,22846,5713,1,380449400,380449400,8566,2855,5711,2855,0,1,2857,1137257,1.137257
3255,6555,3065,20091075,2,26046,6513,1,411233400,411233400,9766,3255,6511,3255,0,1,3257,95468,0.095468
3655,6555,3065,20091075,2,29246,7313,1,442017400,442017400,10966,3655,7311,3655,0,1,3657,154800,0.1548
4055,6555,3065,20091075,2,32446,8113,1,472801400,472801400,12166,4055,8111,4055,0,1,4057,1820576,1.820576
4455,6555,3065,20091075,2,35646,8913,1,503585400,503585400,13366,4455,8911,4455,0,1,4457,729892,0.729892
4855,6555,3065,20091075,2,38846,9713,1,534369400,534369400,14566,4855,9711,4855,0,1,4857,108128,0.108128
5255,6555,3065,20091075,2,42046,10513,1,565153400,565153400,15766,5255,10511,5255,0,1,5257,446364,0.446364
5655,6555,3065,20091075,2,45246,11313,1,595937400,595937400,16966,5655,11311,5655,0,1,5657,868875,0.868875
6055,6555,3065,20091075,2,48446,12113,1,626721400,626721400,18166,6055,12111,6055,0,1,6057,116389,0.116389
6455,6555,3065,20091075,2,51646,12913,1,657505400,657505400,19366,6455,12911,6455,0,1,6457,1814173,1.814173
6855,6555,3065,20091075,2,54846,13713,1,688289400,688289400,20566,6855,13711,6855,0,1,6857,114136,0.114136
35,6600,3045,20097000,2,286,73,1,163476600,163476600,106,35,71,35,0,1,37,13409,0.013409
535,6600,3045,20097000,2,4286,1073,1,202056600,202056600,1606,535,1071,535,0,1,537,303610,0.30361
1035,6600,3045,20097000,2,8286,2073,1,240636600,240636600,3106,1035,2071,1035,0,1,1037,458021,0.458021
1535,6600,3045,20097000,2,12286,3073,1,279216600,279216600,4606,1535,3071,1535,0,1,1537,379794,0.379794
2035,6600,3045,20097000,2,16286,4073,1,317796600,317796600,6106,2035,4071,2035,0,1,2037,2681228,2.681228
2535,6600,3045,20097000,2,20286,5073,1,356376600,356376600,7606,2535,5071,2535,0,1,2537,5450189,5.450189
3035,6600,3045,20097000,2,24286,6073,1,394956600,394956600,9106,3035,6071,3035,0,1,3037,1422842,1.422842
3535,6600,3045,20097000,2,28286,7073,1,433536600,433536600,10606,3535,7071,3535,0,1,3537,2041862,2.041862
4035,6600,3045,20097000,2,32286,8073,1,472116600,472116600,12106,4035,8071,4035,0,1,4037,8521566,8.521566
4535,6600,3045,20097000,2,36286,9073,1,510696600,510696600,13606,4535,9071,4535,0,1,4537,2271499,2.271499
5035,6600,3045,20097000,2,40286,10073,1,549276600,549276600,15106,5035,10071,5035,0,1,5037,1988151,1.988151
5535,6600,3045,20097000,2,44286,11073,1,587856600,587856600,16606,5535,11071,5535,0,1,5537,6079731,6.079731
6035,6600,3045,20097000,2,48286,12073,1,626436600,626436600,18106,6035,12071,6035,0,1,6037,4717465,4.717465
6535,6600,3045,20097000,2,52286,13073,1,665016600,665016600,19606,6535,13071,6535,0,1,6537,9645875,9.645875
7035,6600,3045,20097000,2,56286,14073,1,703596600,703596600,21106,7035,14071,7035,0,1,7037,21960270,21.96027
39,4443,4541,20175663,2,318,81,1,164208312,164208312,118,39,79,39,0,1,41,19993,0.019993
539,4443,4541,20175663,2,4318,1081,1,200144312,200144312,1618,539,1079,539,0,1,541,84556,0.084556
1039,4443,4541,20175663,2,8318,2081,1,236080312,236080312,3118,1039,2079,1039,0,1,1041,102808,0.102808
1539,4443,4541,20175663,2,12318,3081,1,272016312,272016312,4618,1539,3079,1539,0,1,1541,54931,0.054931
2039,4443,4541,20175663,2,16318,4081,1,307952312,307952312,6118,2039,4079,2039,0,1,2041,114014,0.114014
2539,4443,4541,20175663,2,20318,5081,1,343888312,343888312,7618,2539,5079,2539,0,1,2541,83025,0.083025
3039,4443,4541,20175663,2,24318,6081,1,379824312,379824312,9118,3039,6079,3039,0,1,3041,408589,0.408589
3539,4443,4541,20175663,2,28318,7081,1,415760312,415760312,10618,3539,7079,3539,0,1,3541,209910,0.20991
4039,4443,4541,20175663,2,32318,8081,1,451696312,451696312,12118,4039,8079,4039,0,1,4041,1620793,1.620793
4539,4443,4541,20175663,2,36318,9081,1,487632312,487632312,13618,4539,9079,4539,0,1,4541,1173982,1.173982
5039,4443,4541,20175663,2,40318,10081,1,523568312,523568312,15118,5039,10079,5039,0,1,5041,29626,0.029626
5539,4443,4541,20175663,2,44318,11081,1,559504312,559504312,16618,5539,11079,5539,0,1,5541,773088,0.773088
6039,4443,4541,20175663,2,48318,12081,1,595440312,595440312,18118,6039,12079,6039,0,1,6041,3160513,3.160513
6539,4443,4541,20175663,2,52318,13081,1,631376312,631376312,19618,6539,13079,6539,0,1,6541,694822,0.694822
7039,4443,4541,20175663,2,56318,14081,1,667312312,667312312,21118,7039,14079,7039,0,1,7041,2491076,2.491076
39,4993,4041,20176713,2,318,81,1,164232312,164232312,118,39,79,39,0,1,41,355886,0.355886
539,4993,4041,20176713,2,4318,1081,1,200368312,200368312,1618,539,1079,539,0,1,541,2184047,2.184047
1039,4993,4041,20176713,2,8318,2081,1,236504312,236504312,3118,1039,2079,1039,0,1,1041,2746661,2.746661
1539,4993,4041,20176713,2,12318,3081,1,272640312,272640312,4618,1539,3079,1539,0,1,1541,997397,0.997397
2039,4993,4041,20176713,2,16318,4081,1,308776312,308776312,6118,2039,4079,2039,0,1,2041,5388430,5.38843
2539,4993,4041,20176713,2,20318,5081,1,344912312,344912312,7618,2539,5079,2539,0,1,2541,151613,0.151613
3039,4993,4041,20176713,2,24318,6081,1,381048312,381048312,9118,3039,6079,3039,0,1,3041,1655786,1.655786
3539,4993,4041,20176713,2,28318,7081,1,417184312,417184312,10618,3539,7079,3539,0,1,3541,13479894,13.479894
4039,4993,4041,20176713,2,32318,8081,1,453320312,453320312,12118,4039,8079,4039,0,1,4041,5679475,5.679475
4539,4993,4041,20176713,2,36318,9081,1,489456312,489456312,13618,4539,9079,4539,0,1,4541,2687382,2.687382
5039,4993,4041,20176713,2,40318,10081,1,525592312,525592312,15118,5039,10079,5039,0,1,5041,6182213,6.182213
5539,4993,4041,20176713,2,44318,11081,1,561728312,561728312,16618,5539,11079,5539,0,1,5541,15558842,15.558842
6039,4993,4041,20176713,2,48318,12081,1,597864312,597864312,18118,6039,12079,6039,0,1,6041,22771912,22.771912
6539,4993,4041,20176713,2,52318,13081,1,634000312,634000312,19618,6539,13079,6539,0,1,6541,24838866,24.838866
7039,4993,4041,20176713,2,56318,14081,1,670136312,670136312,21118,7039,14079,7039,0,1,7041,26601321,26.601321
35,4440,4545,20179800,2,286,73,1,163954200,163954200,106,35,71,35,0,1,37,381424,0.381424
535,4440,4545,20179800,2,4286,1073,1,199894200,199894200,1606,535,1071,535,0,1,537,2161361,2.161361
1035,4440,4545,20179800,2,8286,2073,1,235834200,235834200,3106,1035,2071,1035,0,1,1037,4007615,4.007615
1535,4440,4545,20179800,2,12286,3073,1,271774200,271774200,4606,1535,3071,1535,0,1,1537,5942691,5.942691
2035,4440,4545,20179800,2,16286,4073,1,307714200,307714200,6106,2035,4071,2035,0,1,2037,7835324,7.835324
35,3340,6045,20190300,2,286,73,1,164150200,164150200,106,35,71,35,0,1,37,356152,0.356152
535,3340,6045,20190300,2,4286,1073,1,201690200,201690200,1606,535,1071,535,0,1,537,2169097,2.169097
1035,3340,6045,20190300,2,8286,2073,1,239230200,239230200,3106,1035,2071,1035,0,1,1037,4046302,4.046302
1535,3340,6045,20190300,2,12286,3073,1,276770200,276770200,4606,1535,3071,1535,0,1,1537,5927668,5.927668
2035,3340,6045,20190300,2,16286,4073,1,314310200,314310200,6106,2035,4071,2035,0,1,2037,7811892,7.811892
39,3343,6041,20195063,2,318,81,1,164488312,164488312,118,39,79,39,0,1,41,54196,0.054196
539,3343,6041,20195063,2,4318,1081,1,202024312,202024312,1618,539,1079,539,0,1,541,151045,0.151045
1039,3343,6041,20195063,2,8318,2081,1,239560312,239560312,3118,1039,2079,1039,0,1,1041,197926,0.197926
1539,3343,6041,20195063,2,12318,3081,1,277096312,277096312,4618,1539,3079,1539,0,1,1541,29444,0.029444
2039,3343,6041,20195063,2,16318,4081,1,314632312,314632312,6118,2039,4079,2039,0,1,2041,330338,0.330338
2539,3343,6041,20195063,2,20318,5081,1,352168312,352168312,7618,2539,5079,2539,0,1,2541,340619,0.340619
3039,3343,6041,20195063,2,24318,6081,1,389704312,389704312,9118,3039,6079,3039,0,1,3041,354088,0.354088
3539,3343,6041,20195063,2,28318,7081,1,427240312,427240312,10618,3539,7079,3539,0,1,3541,703087,0.703087
4039,3343,6041,20195063,2,32318,8081,1,464776312,464776312,12118,4039,8079,4039,0,1,4041,1953401,1.953401
4539,3343,6041,20195063,2,36318,9081,1,502312312,502312312,13618,4539,9079,4539,0,1,4541,679516,0.679516
5039,3343,6041,20195063,2,40318,10081,1,539848312,539848312,15118,5039,10079,5039,0,1,5041,448626,0.448626
5539,3343,6041,20195063,2,44318,11081,1,577384312,577384312,16618,5539,11079,5539,0,1,5541,769721,0.769721
6039,3343,6041,20195063,2,48318,12081,1,614920312,614920312,18118,6039,12079,6039,0,1,6041,1025702,1.025702
6539,3343,6041,20195063,2,52318,13081,1,652456312,652456312,19618,6539,13079,6539,0,1,6541,1619381,1.619381
7039,3343,6041,20195063,2,56318,14081,1,689992312,689992312,21118,7039,14079,7039,0,1,7041,371649,0.371649
39,6643,3041,20201363,2,318,81,1,164632312,164632312,118,39,79,39,0,1,41,34698,0.034698
539,6643,3041,20201363,2,4318,1081,1,203368312,203368312,1618,539,1079,539,0,1,541,321439,0.321439
1039,6643,3041,20201363,2,8318,2081,1,242104312,242104312,3118,1039,2079,1039,0,1,1041,443023,0.443023
1539,6643,3041,20201363,2,12318,3081,1,280840312,280840312,4618,1539,3079,1539,0,1,1541,737856,0.737856
2039,6643,3041,20201363,2,16318,4081,1,319576312,319576312,6118,2039,4079,2039,0,1,2041,5006,0.005006
2539,6643,3041,20201363,2,20318,5081,1,358312312,358312312,7618,2539,5079,2539,0,1,2541,262678,0.262678
3039,6643,3041,20201363,2,24318,6081,1,397048312,397048312,9118,3039,6079,3039,0,1,3041,345951,0.345951
3539,6643,3041,20201363,2,28318,7081,1,435784312,435784312,10618,3539,7079,3539,0,1,3541,529146,0.529146
4039,6643,3041,20201363,2,32318,8081,1,474520312,474520312,12118,4039,8079,4039,0,1,4041,4043910,4.04391
4539,6643,3041,20201363,2,36318,9081,1,513256312,513256312,13618,4539,9079,4539,0,1,4541,198838,0.198838
5039,6643,3041,20201363,2,40318,10081,1,551992312,551992312,15118,5039,10079,5039,0,1,5041,1592799,1.592799
5539,6643,3041,20201363,2,44318,11081,1,590728312,590728312,16618,5539,11079,5539,0,1,5541,2344149,2.344149
6039,6643,3041,20201363,2,48318,12081,1,629464312,629464312,18118,6039,12079,6039,0,1,6041,3097175,3.097175
6539,6643,3041,20201363,2,52318,13081,1,668200312,668200312,19618,6539,13079,6539,0,1,6541,2087677,2.087677
7039,6643,3041,20201363,2,56318,14081,1,706936312,706936312,21118,7039,14079,7039,0,1,7041,7635140,7.63514
40,5550,3640,20202000,2,326,83,1,164556800,164556800,121,40,81,40,0,1,42,368331,0.368331
440,5550,3640,20202000,2,3526,883,1,193964800,193964800,1321,440,881,440,0,1,442,166568,0.166568
840,5550,3640,20202000,2,6726,1683,1,223372800,223372800,2521,840,1681,840,0,1,842,3373296,3.373296
1240,5550,3640,20202000,2,9926,2483,1,252780800,252780800,3721,1240,2481,1240,0,1,1242,4681389,4.681389
1640,5550,3640,20202000,2,13126,3283,1,282188800,282188800,4921,1640,3281,1640,0,1,1642,1494620,1.49462
2040,5550,3640,20202000,2,16326,4083,1,311596800,311596800,6121,2040,4081,2040,0,1,2042,3551794,3.551794
2440,5550,3640,20202000,2,19526,4883,1,341004800,341004800,7321,2440,4881,2440,0,1,2442,5221392,5.221392
2840,5550,3640,20202000,2,22726,5683,1,370412800,370412800,8521,2840,5681,2840,0,1,2842,3040219,3.040219
3240,5550,3640,20202000,2,25926,6483,1,399820800,399820800,9721,3240,6481,3240,0,1,3242,2913481,2.913481
3640,5550,3640,20202000,2,29126,7283,1,429228800,429228800,10921,3640,7281,3640,0,1,3642,3594782,3.594782
4040,5550,3640,20202000,2,32326,8083,1,458636800,458636800,12121,4040,8081,4040,0,1,4042,642207,0.642207
4440,5550,3640,20202000,2,35526,8883,1,488044800,488044800,13321,4440,8881,4440,0,1,4442,3795253,3.795253
4840,5550,3640,20202000,2,38726,9683,1,517452800,517452800,14521,4840,9681,4840,0,1,4842,561785,0.561785
5240,5550,3640,20202000,2,41926,10483,1,546860800,546860800,15721,5240,10481,5240,0,1,5242,181261,0.181261
5640,5550,3640,20202000,2,45126,11283,1,576268800,576268800,16921,5640,11281,5640,0,1,5642,2324772,2.324772
6040,5550,3640,20202000,2,48326,12083,1,605676800,605676800,18121,6040,12081,6040,0,1,6042,5531070,5.53107
6440,5550,3640,20202000,2,51526,12883,1,635084800,635084800,19321,6440,12881,6440,0,1,6442,5800803,5.800803
6840,5550,3640,20202000,2,54726,13683,1,664492800,664492800,20521,6840,13681,6840,0,1,6842,25870235,25.870235
40,6050,3340,20207000,2,326,83,1,164660800,164660800,121,40,81,40,0,1,42,223734,0.223734
440,6050,3340,20207000,2,3526,883,1,194708800,194708800,1321,440,881,440,0,1,442,1657744,1.657744
840,6050,3340,20207000,2,6726,1683,1,224756800,224756800,2521,840,1681,840,0,1,842,188136,0.188136
1240,6050,3340,20207000,2,9926,2483,1,254804800,254804800,3721,1240,2481,1240,0,1,1242,89681,0.089681
1640,6050,3340,20207000,2,13126,3283,1,284852800,284852800,4921,1640,3281,1640,0,1,1642,5173573,5.173573
2040,6050,3340,20207000,2,16326,4083,1,314900800,314900800,6121,2040,4081,2040,0,1,2042,1787005,1.787005
2440,6050,3340,20207000,2,19526,4883,1,344948800,344948800,7321,2440,4881,2440,0,1,2442,2298680,2.29868
2840,6050,3340,20207000,2,22726,5683,1,374996800,374996800,8521,2840,5681,2840,0,1,2842,2888867,2.888867
3240,6050,3340,20207000,2,25926,6483,1,405044800,405044800,9721,3240,6481,3240,0,1,3242,220899,0.220899
3640,6050,3340,20207000,2,29126,7283,1,435092800,435092800,10921,3640,7281,3640,0,1,3642,596108,0.596108
4040,6050,3340,20207000,2,32326,8083,1,465140800,465140800,12121,4040,8081,4040,0,1,4042,1927766,1.927766
4440,6050,3340,20207000,2,35526,8883,1,495188800,495188800,13321,4440,8881,4440,0,1,4442,802555,0.802555
4840,6050,3340,20207000,2,38726,9683,1,525236800,525236800,14521,4840,9681,4840,0,1,4842,1178150,1.17815
5240,6050,3340,20207000,2,41926,10483,1,555284800,555284800,15721,5240,10481,5240,0,1,5242,598940,0.59894
5640,6050,3340,20207000,2,45126,11283,1,585332800,585332800,16921,5640,11281,5640,0,1,5642,2611034,2.611034
6040,6050,3340,20207000,2,48326,12083,1,615380800,615380800,18121,6040,12081,6040,0,1,6042,9241362,9.241362
6440,6050,3340,20207000,2,51526,12883,1,645428800,645428800,19321,6440,12881,6440,0,1,6442,3437701,3.437701
6840,6050,3340,20207000,2,54726,13683,1,675476800,675476800,20521,6840,13681,6840,0,1,6842,4886656,4.886656
40,3050,6640,20252000,2,326,83,1,165116800,165116800,121,40,81,40,0,1,42,18887,0.018887
440,3050,6640,20252000,2,3526,883,1,196124800,196124800,1321,440,881,440,0,1,442,127510,0.12751
840,3050,6640,20252000,2,6726,1683,1,227132800,227132800,2521,840,1681,840,0,1,842,18869,0.018869
1240,3050,6640,20252000,2,9926,2483,1,258140800,258140800,3721,1240,2481,1240,0,1,1242,159751,0.159751
1640,3050,6640,20252000,2,13126,3283,1,289148800,289148800,4921,1640,3281,1640,0,1,1642,290536,0.290536
2040,3050,6640,20252000,2,16326,4083,1,320156800,320156800,6121,2040,4081,2040,0,1,2042,158623,0.158623
2440,3050,6640,20252000,2,19526,4883,1,351164800,351164800,7321,2440,4881,2440,0,1,2442,356016,0.356016
2840,3050,6640,20252000,2,22726,5683,1,382172800,382172800,8521,2840,5681,2840,0,1,2842,45478,0.045478
3240,3050,6640,20252000,2,25926,6483,1,413180800,413180800,9721,3240,6481,3240,0,1,3242,506065,0.506065
3640,3050,6640,20252000,2,29126,7283,1,444188800,444188800,10921,3640,7281,3640,0,1,3642,1072446,1.072446
4040,3050,6640,20252000,2,32326,8083,1,475196800,475196800,12121,4040,8081,4040,0,1,4042,327600,0.3276
4440,3050,6640,20252000,2,35526,8883,1,506204800,506204800,13321,4440,8881,4440,0,1,4442,1152958,1.152958
4840,3050,6640,20252000,2,38726,9683,1,537212800,537212800,14521,4840,9681,4840,0,1,4842,382607,0.382607
5240,3050,6640,20252000,2,41926,10483,1,568220800,568220800,15721,5240,10481,5240,0,1,5242,1093008,1.093008
5640,3050,6640,20252000,2,45126,11283,1,599228800,599228800,16921,5640,11281,5640,0,1,5642,336443,0.336443
6040,3050,6640,20252000,2,48326,12083,1,630236800,630236800,18121,6040,12081,6040,0,1,6042,1186458,1.186458
6440,3050,6640,20252000,2,51526,12883,1,661244800,661244800,19321,6440,12881,6440,0,1,6442,62568,0.062568
6840,3050,6640,20252000,2,54726,13683,1,692252800,692252800,20521,6840,13681,6840,0,1,6842,1911449,1.911449
44,4453,4555,20283415,2,358,91,1,165438136,165438136,133,44,89,44,0,1,46,14415,0.014415
544,4453,4555,20283415,2,4358,1091,1,201470136,201470136,1633,544,1089,544,0,1,546,114526,0.114526
1044,4453,4555,20283415,2,8358,2091,1,237502136,237502136,3133,1044,2089,1044,0,1,1046,33932,0.033932
1544,4453,4555,20283415,2,12358,3091,1,273534136,273534136,4633,1544,3089,1544,0,1,1546,267927,0.267927
2044,4453,4555,20283415,2,16358,4091,1,309566136,309566136,6133,2044,4089,2044,0,1,2046,32285,0.032285
2544,4453,4555,20283415,2,20358,5091,1,345598136,345598136,7633,2544,5089,2544,0,1,2546,255222,0.255222
3044,4453,4555,20283415,2,24358,6091,1,381630136,381630136,9133,3044,6089,3044,0,1,3046,71255,0.071255
3544,4453,4555,20283415,2,28358,7091,1,417662136,417662136,10633,3544,7089,3544,0,1,3546,793830,0.79383
4044,4453,4555,20283415,2,32358,8091,1,453694136,453694136,12133,4044,8089,4044,0,1,4046,188341,0.188341
4544,4453,4555,20283415,2,36358,9091,1,489726136,489726136,13633,4544,9089,4544,0,1,4546,342474,0.342474
5044,4453,4555,20283415,2,40358,10091,1,525758136,525758136,15133,5044,10089,5044,0,1,5046,1656415,1.656415
5544,4453,4555,20283415,2,44358,11091,1,561790136,561790136,16633,5544,11089,5544,0,1,5546,2615049,2.615049
6044,4453,4555,20283415,2,48358,12091,1,597822136,597822136,18133,6044,12089,6044,0,1,6046,3166604,3.166604
6544,4453,4555,20283415,2,52358,13091,1,633854136,633854136,19633,6544,13089,6544,0,1,6546,1872907,1.872907
7044,4453,4555,20283415,2,56358,14091,1,669886136,669886136,21133,7044,14089,7044,0,1,7046,1353324,1.353324
44,5003,4055,20287165,2,358,91,1,165485736,165485736,133,44,89,44,0,1,46,375794,0.375794
544,5003,4055,20287165,2,4358,1091,1,201717736,201717736,1633,544,1089,544,0,1,546,2220333,2.220333
1044,5003,4055,20287165,2,8358,2091,1,237949736,237949736,3133,1044,2089,1044,0,1,1046,4094684,4.094684
1544,5003,4055,20287165,2,12358,3091,1,274181736,274181736,4633,1544,3089,1544,0,1,1546,1637761,1.637761
2044,5003,4055,20287165,2,16358,4091,1,310413736,310413736,6133,2044,4089,2044,0,1,2046,1885158,1.885158
2544,5003,4055,20287165,2,20358,5091,1,346645736,346645736,7633,2544,5089,2544,0,1,2546,1337679,1.337679
3044,5003,4055,20287165,2,24358,6091,1,382877736,382877736,9133,3044,6089,3044,0,1,3046,3629050,3.62905
3544,5003,4055,20287165,2,28358,7091,1,419109736,419109736,10633,3544,7089,3544,0,1,3546,1159850,1.15985
4044,5003,4055,20287165,2,32358,8091,1,455341736,455341736,12133,4044,8089,4044,0,1,4046,15167935,15.167935
4544,5003,4055,20287165,2,36358,9091,1,491573736,491573736,13633,4544,9089,4544,0,1,4546,17328267,17.328267
5044,5003,4055,20287165,2,40358,10091,1,527805736,527805736,15133,5044,10089,5044,0,1,5046,14194296,14.194296
5544,5003,4055,20287165,2,44358,11091,1,564037736,564037736,16633,5544,11089,5544,0,1,5546,9049836,9.049836
6044,5003,4055,20287165,2,48358,12091,1,600269736,600269736,18133,6044,12089,6044,0,1,6046,23021785,23.021785
6544,5003,4055,20287165,2,52358,13091,1,636501736,636501736,19633,6544,13089,6544,0,1,6546,24863816,24.863816
7044,5003,4055,20287165,2,56358,14091,1,672733736,672733736,21133,7044,14089,7044,0,1,7046,26752496,26.752496
44,3353,6055,20302415,2,358,91,1,165730936,165730936,133,44,89,44,0,1,46,59144,0.059144
544,3353,6055,20302415,2,4358,1091,1,203362936,203362936,1633,544,1089,544,0,1,546,36017,0.036017
1044,3353,6055,20302415,2,8358,2091,1,240994936,240994936,3133,1044,2089,1044,0,1,1046,115742,0.115742
1544,3353,6055,20302415,2,12358,3091,1,278626936,278626936,4633,1544,3089,1544,0,1,1546,282499,0.282499
2044,3353,6055,20302415,2,16358,4091,1,316258936,316258936,6133,2044,4089,2044,0,1,2046,454385,0.454385
2544,3353,6055,20302415,2,20358,5091,1,353890936,353890936,7633,2544,5089,2544,0,1,2546,335054,0.335054
3044,3353,6055,20302415,2,24358,6091,1,391522936,391522936,9133,3044,6089,3044,0,1,3046,401548,0.401548
3544,3353,6055,20302415,2,28358,7091,1,429154936,429154936,10633,3544,7089,3544,0,1,3546,1227520,1.22752
4044,3353,6055,20302415,2,32358,8091,1,466786936,466786936,12133,4044,8089,4044,0,1,4046,1211713,1.211713
4544,3353,6055,20302415,2,36358,9091,1,504418936,504418936,13633,4544,9089,4544,0,1,4546,61149,0.061149
5044,3353,6055,20302415,2,40358,10091,1,542050936,542050936,15133,5044,10089,5044,0,1,5046,4132808,4.132808
5544,3353,6055,20302415,2,44358,11091,1,579682936,579682936,16633,5544,11089,5544,0,1,5546,4576659,4.576659
6044,3353,6055,20302415,2,48358,12091,1,617314936,617314936,18133,6044,12089,6044,0,1,6046,631204,0.631204
6544,3353,6055,20302415,2,52358,13091,1,654946936,654946936,19633,6544,13089,6544,0,1,6546,5023029,5.023029
7044,3353,6055,20302415,2,56358,14091,1,692578936,692578936,21133,7044,14089,7044,0,1,7046,3364401,3.364401
44,6653,3055,20324915,2,358,91,1,166016536,166016536,133,44,89,44,0,1,46,55988,0.055988
544,6653,3055,20324915,2,4358,1091,1,204848536,204848536,1633,544,1089,544,0,1,546,160360,0.16036
1044,6653,3055,20324915,2,8358,2091,1,243680536,243680536,3133,1044,2089,1044,0,1,1046,70607,0.070607
1544,6653,3055,20324915,2,12358,3091,1,282512536,282512536,4633,1544,3089,1544,0,1,1546,1278238,1.278238
2044,6653,3055,20324915,2,16358,4091,1,321344536,321344536,6133,2044,4089,2044,0,1,2046,568164,0.568164
2544,6653,3055,20324915,2,20358,5091,1,360176536,360176536,7633,2544,5089,2544,0,1,2546,25229,0.025229
3044,6653,3055,20324915,2,24358,6091,1,399008536,399008536,9133,3044,6089,3044,0,1,3046,3241890,3.24189
3544,6653,3055,20324915,2,28358,7091,1,437840536,437840536,10633,3544,7089,3544,0,1,3546,1260536,1.260536
4044,6653,3055,20324915,2,32358,8091,1,476672536,476672536,12133,4044,8089,4044,0,1,4046,770110,0.77011
4544,6653,3055,20324915,2,36358,9091,1,515504536,515504536,13633,4544,9089,4544,0,1,4546,966805,0.966805
5044,6653,3055,20324915,2,40358,10091,1,554336536,554336536,15133,5044,10089,5044,0,1,5046,1273459,1.273459
5544,6653,3055,20324915,2,44358,11091,1,593168536,593168536,16633,5544,11089,5544,0,1,5546,572973,0.572973
6044,6653,3055,20324915,2,48358,12091,1,632000536,632000536,18133,6044,12089,6044,0,1,6046,992311,0.992311
6544,6653,3055,20324915,2,52358,13091,1,670832536,670832536,19633,6544,13089,6544,0,1,6546,458317,0.458317
7044,6653,3055,20324915,2,56358,14091,1,709664536,709664536,21133,7044,14089,7044,0,1,7046,6384293,6.384293
40,4800,4240,20352000,2,326,83,1,165708800,165708800,121,40,81,40,0,1,42,361282,0.361282
440,4800,4240,20352000,2,3526,883,1,194636800,194636800,1321,440,881,440,0,1,442,1770707,1.770707
840,4800,4240,20352000,2,6726,1683,1,223564800,223564800,2521,840,1681,840,0,1,842,3213606,3.213606
1240,4800,4240,20352000,2,9926,2483,1,252492800,252492800,3721,1240,2481,1240,0,1,1242,3077080,3.07708
1640,4800,4240,20352000,2,13126,3283,1,281420800,281420800,4921,1640,3281,1640,0,1,1642,497946,0.497946
2040,4800,4240,20352000,2,16326,4083,1,310348800,310348800,6121,2040,4081,2040,0,1,2042,2657465,2.657465
2440,4800,4240,20352000,2,19526,4883,1,339276800,339276800,7321,2440,4881,2440,0,1,2442,2822292,2.822292
2840,4800,4240,20352000,2,22726,5683,1,368204800,368204800,8521,2840,5681,2840,0,1,2842,2559717,2.559717
3240,4800,4240,20352000,2,25926,6483,1,397132800,397132800,9721,3240,6481,3240,0,1,3242,5416482,5.416482
3640,4800,4240,20352000,2,29126,7283,1,426060800,426060800,10921,3640,7281,3640,0,1,3642,2216472,2.216472
4040,4800,4240,20352000,2,32326,8083,1,454988800,454988800,12121,4040,8081,4040,0,1,4042,9012625,9.012625
4440,4800,4240,20352000,2,35526,8883,1,483916800,483916800,13321,4440,8881,4440,0,1,4442,3138251,3.138251
4840,4800,4240,20352000,2,38726,9683,1,512844800,512844800,14521,4840,9681,4840,0,1,4842,2367804,2.367804
5240,4800,4240,20352000,2,41926,10483,1,541772800,541772800,15721,5240,10481,5240,0,1,5242,4660747,4.660747
5640,4800,4240,20352000,2,45126,11283,1,570700800,570700800,16921,5640,11281,5640,0,1,5642,6388967,6.388967
6040,4800,4240,20352000,2,48326,12083,1,599628800,599628800,18121,6040,12081,6040,0,1,6042,6122586,6.122586
6440,4800,4240,20352000,2,51526,12883,1,628556800,628556800,19321,6440,12881,6440,0,1,6442,8389949,8.389949
6840,4800,4240,20352000,2,54726,13683,1,657484800,657484800,20521,6840,13681,6840,0,1,6842,3355004,3.355004
55,5555,3665,20359075,2,446,113,1,166929400,166929400,166,55,111,55,0,1,57,416369,0.416369
455,5555,3665,20359075,2,3646,913,1,196433400,196433400,1366,455,911,455,0,1,457,1939193,1.939193
855,5555,3665,20359075,2,6846,1713,1,225937400,225937400,2566,855,1711,855,0,1,857,1525288,1.525288
1255,5555,3665,20359075,2,10046,2513,1,255441400,255441400,3766,1255,2511,1255,0,1,1257,322585,0.322585
1655,5555,3665,20359075,2,13246,3313,1,284945400,284945400,4966,1655,3311,1655,0,1,1657,4725287,4.725287
2055,5555,3665,20359075,2,16446,4113,1,314449400,314449400,6166,2055,4111,2055,0,1,2057,1328330,1.32833
2455,5555,3665,20359075,2,19646,4913,1,343953400,343953400,7366,2455,4911,2455,0,1,2457,1288841,1.288841
2855,5555,3665,20359075,2,22846,5713,1,373457400,373457400,8566,2855,5711,2855,0,1,2857,831383,0.831383
3255,5555,3665,20359075,2,26046,6513,1,402961400,402961400,9766,3255,6511,3255,0,1,3257,4761289,4.761289
3655,5555,3665,20359075,2,29246,7313,1,432465400,432465400,10966,3655,7311,3655,0,1,3657,220528,0.220528
4055,5555,3665,20359075,2,32446,8113,1,461969400,461969400,12166,4055,8111,4055,0,1,4057,3475052,3.475052
4455,5555,3665,20359075,2,35646,8913,1,491473400,491473400,13366,4455,8911,4455,0,1,4457,2653184,2.653184
4855,5555,3665,20359075,2,38846,9713,1,520977400,520977400,14566,4855,9711,4855,0,1,4857,661045,0.661045
5255,5555,3665,20359075,2,42046,10513,1,550481400,550481400,15766,5255,10511,5255,0,1,5257,505763,0.505763
5655,5555,3665,20359075,2,45246,11313,1,579985400,579985400,16966,5655,11311,5655,0,1,5657,366793,0.366793
6055,5555,3665,20359075,2,48446,12113,1,609489400,609489400,18166,6055,12111,6055,0,1,6057,486145,0.486145
6455,5555,3665,20359075,2,51646,12913,1,638993400,638993400,19366,6455,12911,6455,0,1,6457,3976075,3.976075
6855,5555,3665,20359075,2,54846,13713,1,668497400,668497400,20566,6855,13711,6855,0,1,6857,1458598,1.458598
55,3055,6665,20361575,2,446,113,1,167169400,167169400,166,55,111,55,0,1,57,197,0.000197
455,3055,6665,20361575,2,3646,913,1,198273400,198273400,1366,455,911,455,0,1,457,103933,0.103933
855,3055,6665,20361575,2,6846,1713,1,229377400,229377400,2566,855,1711,855,0,1,857,58331,0.058331
1255,3055,6665,20361575,2,10046,2513,1,260481400,260481400,3766,1255,2511,1255,0,1,1257,400306,0.400306
1655,3055,6665,20361575,2,13246,3313,1,291585400,291585400,4966,1655,3311,1655,0,1,1657,381718,0.381718
2055,3055,6665,20361575,2,16446,4113,1,322689400,322689400,6166,2055,4111,2055,0,1,2057,493326,0.493326
2455,3055,6665,20361575,2,19646,4913,1,353793400,353793400,7366,2455,4911,2455,0,1,2457,540172,0.540172
2855,3055,6665,20361575,2,22846,5713,1,384897400,384897400,8566,2855,5711,2855,0,1,2857,955531,0.955531
3255,3055,6665,20361575,2,26046,6513,1,416001400,416001400,9766,3255,6511,3255,0,1,3257,569881,0.569881
3655,3055,6665,20361575,2,29246,7313,1,447105400,447105400,10966,3655,7311,3655,0,1,3657,372228,0.372228
4055,3055,6665,20361575,2,32446,8113,1,478209400,478209400,12166,4055,8111,4055,0,1,4057,663040,0.66304
4455,3055,6665,20361575,2,35646,8913,1,509313400,509313400,13366,4455,8911,4455,0,1,4457,325732,0.325732
4855,3055,6665,20361575,2,38846,9713,1,540417400,540417400,14566,4855,9711,4855,0,1,4857,87453,0.087453
5255,3055,6665,20361575,2,42046,10513,1,571521400,571521400,15766,5255,10511,5255,0,1,5257,1321681,1.321681
5655,3055,6665,20361575,2,45246,11313,1,602625400,602625400,16966,5655,11311,5655,0,1,5657,559953,0.559953
6055,3055,6665,20361575,2,48446,12113,1,633729400,633729400,18166,6055,12111,6055,0,1,6057,211989,0.211989
6455,3055,6665,20361575,2,51646,12913,1,664833400,664833400,19366,6455,12911,6455,0,1,6457,1996005,1.996005
6855,3055,6665,20361575,2,54846,13713,1,695937400,695937400,20566,6855,13711,6855,0,1,6857,575501,0.575501
55,6055,3365,20375075,2,446,113,1,167145400,167145400,166,55,111,55,0,1,57,404141,0.404141
455,6055,3365,20375075,2,3646,913,1,197289400,197289400,1366,455,911,455,0,1,457,1470077,1.470077
855,6055,3365,20375075,2,6846,1713,1,227433400,227433400,2566,855,1711,855,0,1,857,122620,0.12262
1255,6055,3365,20375075,2,10046,2513,1,257577400,257577400,3766,1255,2511,1255,0,1,1257,3550302,3.550302
1655,6055,3365,20375075,2,13246,3313,1,287721400,287721400,4966,1655,3311,1655,0,1,1657,1536130,1.53613
2055,6055,3365,20375075,2,16446,4113,1,317865400,317865400,6166,2055,4111,2055,0,1,2057,613829,0.613829
2455,6055,3365,20375075,2,19646,4913,1,348009400,348009400,7366,2455,4911,2455,0,1,2457,3046552,3.046552
2855,6055,3365,20375075,2,22846,5713,1,378153400,378153400,8566,2855,5711,2855,0,1,2857,358631,0.358631
3255,6055,3365,20375075,2,26046,6513,1,408297400,408297400,9766,3255,6511,3255,0,1,3257,1014099,1.014099
3655,6055,3365,20375075,2,29246,7313,1,438441400,438441400,10966,3655,7311,3655,0,1,3657,131371,0.131371
4055,6055,3365,20375075,2,32446,8113,1,468585400,468585400,12166,4055,8111,4055,0,1,4057,2746987,2.746987
4455,6055,3365,20375075,2,35646,8913,1,498729400,498729400,13366,4455,8911,4455,0,1,4457,604692,0.604692
4855,6055,3365,20375075,2,38846,9713,1,528873400,528873400,14566,4855,9711,4855,0,1,4857,1402504,1.402504
5255,6055,3365,20375075,2,42046,10513,1,559017400,559017400,15766,5255,10511,5255,0,1,5257,2090844,2.090844
5655,6055,3365,20375075,2,45246,11313,1,589161400,589161400,16966,5655,11311,5655,0,1,5657,3870832,3.870832
6055,6055,3365,20375075,2,48446,12113,1,619305400,619305400,18166,6055,12111,6055,0,1,6057,6048649,6.048649
6455,6055,3365,20375075,2,51646,12913,1,649449400,649449400,19366,6455,12911,6455,0,1,6457,4563731,4.563731
6855,6055,3365,20375075,2,54846,13713,1,679593400,679593400,20566,6855,13711,6855,0,1,6857,4050665,4.050665
40,3550,5740,20377000,2,326,83,1,165988800,165988800,121,40,81,40,0,1,42,383918,0.383918
440,3550,5740,20377000,2,3526,883,1,195716800,195716800,1321,440,881,440,0,1,442,1872917,1.872917
840,3550,5740,20377000,2,6726,1683,1,225444800,225444800,2521,840,1681,840,0,1,842,1410395,1.410395
1240,3550,5740,20377000,2,9926,2483,1,255172800,255172800,3721,1240,2481,1240,0,1,1242,3956714,3.956714
1640,3550,5740,20377000,2,13126,3283,1,284900800,284900800,4921,1640,3281,1640,0,1,1642,6497119,6.497119
2040,3550,5740,20377000,2,16326,4083,1,314628800,314628800,6121,2040,4081,2040,0,1,2042,174175,0.174175
2440,3550,5740,20377000,2,19526,4883,1,344356800,344356800,7321,2440,4881,2440,0,1,2442,674594,0.674594
2840,3550,5740,20377000,2,22726,5683,1,374084800,374084800,8521,2840,5681,2840,0,1,2842,338441,0.338441
3240,3550,5740,20377000,2,25926,6483,1,403812800,403812800,9721,3240,6481,3240,0,1,3242,691144,0.691144
3640,3550,5740,20377000,2,29126,7283,1,433540800,433540800,10921,3640,7281,3640,0,1,3642,699643,0.699643
4040,3550,5740,20377000,2,32326,8083,1,463268800,463268800,12121,4040,8081,4040,0,1,4042,7052683,7.052683
4440,3550,5740,20377000,2,35526,8883,1,492996800,492996800,13321,4440,8881,4440,0,1,4442,1052687,1.052687
4840,3550,5740,20377000,2,38726,9683,1,522724800,522724800,14521,4840,9681,4840,0,1,4842,2421428,2.421428
5240,3550,5740,20377000,2,41926,10483,1,552452800,552452800,15721,5240,10481,5240,0,1,5242,5598855,5.598855
5640,3550,5740,20377000,2,45126,11283,1,582180800,582180800,16921,5640,11281,5640,0,1,5642,3058160,3.05816
6040,3550,5740,20377000,2,48326,12083,1,611908800,611908800,18121,6040,12081,6040,0,1,6042,892360,0.89236
6440,3550,5740,20377000,2,51526,12883,1,641636800,641636800,19321,6440,12881,6440,0,1,6442,292513,0.292513
6840,3550,5740,20377000,2,54726,13683,1,671364800,671364800,20521,6840,13681,6840,0,1,6842,3887594,3.887594
55,4805,4265,20493325,2,446,113,1,167937400,167937400,166,55,111,55,0,1,57,431321,0.431321
455,4805,4265,20493325,2,3646,913,1,196961400,196961400,1366,455,911,455,0,1,457,247504,0.247504
855,4805,4265,20493325,2,6846,1713,1,225985400,225985400,2566,855,1711,855,0,1,857,1843792,1.843792
1255,4805,4265,20493325,2,10046,2513,1,255009400,255009400,3766,1255,2511,1255,0,1,1257,1752598,1.752598
1655,4805,4265,20493325,2,13246,3313,1,284033400,284033400,4966,1655,3311,1655,0,1,1657,6437185,6.437185
2055,4805,4265,20493325,2,16446,4113,1,313057400,313057400,6166,2055,4111,2055,0,1,2057,1287100,1.2871
2455,4805,4265,20493325,2,19646,4913,1,342081400,342081400,7366,2455,4911,2455,0,1,2457,4167893,4.167893
2855,4805,4265,20493325,2,22846,5713,1,371105400,371105400,8566,2855,5711,2855,0,1,2857,741027,0.741027
3255,4805,4265,20493325,2,26046,6513,1,400129400,400129400,9766,3255,6511,3255,0,1,3257,496381,0.496381
3655,4805,4265,20493325,2,29246,7313,1,429153400,429153400,10966,3655,7311,3655,0,1,3657,2431757,2.431757
4055,4805,4265,20493325,2,32446,8113,1,458177400,458177400,12166,4055,8111,4055,0,1,4057,10510427,10.510427
4455,4805,4265,20493325,2,35646,8913,1,487201400,487201400,13366,4455,8911,4455,0,1,4457,3485967,3.485967
4855,4805,4265,20493325,2,38846,9713,1,516225400,516225400,14566,4855,9711,4855,0,1,4857,1136361,1.136361
5255,4805,4265,20493325,2,42046,10513,1,545249400,545249400,15766,5255,10511,5255,0,1,5257,14125736,14.125736
5655,4805,4265,20493325,2,45246,11313,1,574273400,574273400,16966,5655,11311,5655,0,1,5657,13561247,13.561247
6055,4805,4265,20493325,2,48446,12113,1,603297400,603297400,18166,6055,12111,6055,0,1,6057,218368,0.218368
6455,4805,4265,20493325,2,51646,12913,1,632321400,632321400,19366,6455,12911,6455,0,1,6457,1138882,1.138882
6855,4805,4265,20493325,2,54846,13713,1,661345400,661345400,20566,6855,13711,6855,0,1,6857,26233695,26.233695
55,3555,5765,20494575,2,446,113,1,168057400,168057400,166,55,111,55,0,1,57,418195,0.418195
455,3555,5765,20494575,2,3646,913,1,197881400,197881400,1366,455,911,455,0,1,457,1962112,1.962112
855,3555,5765,20494575,2,6846,1713,1,227705400,227705400,2566,855,1711,855,0,1,857,394419,0.394419
1255,3555,5765,20494575,2,10046,2513,1,257529400,257529400,3766,1255,2511,1255,0,1,1257,1429712,1.429712
1655,3555,5765,20494575,2,13246,3313,1,287353400,287353400,4966,1655,3311,1655,0,1,1657,709081,0.709081
2055,3555,5765,20494575,2,16446,4113,1,317177400,317177400,6166,2055,4111,2055,0,1,2057,52898,0.052898
2455,3555,5765,20494575,2,19646,4913,1,347001400,347001400,7366,2455,4911,2455,0,1,2457,1314728,1.314728
2855,3555,5765,20494575,2,22846,5713,1,376825400,376825400,8566,2855,5711,2855,0,1,2857,692531,0.692531
3255,3555,5765,20494575,2,26046,6513,1,406649400,406649400,9766,3255,6511,3255,0,1,3257,136458,0.136458
3655,3555,5765,20494575,2,29246,7313,1,436473400,436473400,10966,3655,7311,3655,0,1,3657,2659462,2.659462
4055,3555,5765,20494575,2,32446,8113,1,466297400,466297400,12166,4055,8111,4055,0,1,4057,1428303,1.428303
4455,3555,5765,20494575,2,35646,8913,1,496121400,496121400,13366,4455,8911,4455,0,1,4457,1554331,1.554331
4855,3555,5765,20494575,2,38846,9713,1,525945400,525945400,14566,4855,9711,4855,0,1,4857,1216297,1.216297
5255,3555,5765,20494575,2,42046,10513,1,555769400,555769400,15766,5255,10511,5255,0,1,5257,3734031,3.734031
5655,3555,5765,20494575,2,45246,11313,1,585593400,585593400,16966,5655,11311,5655,0,1,5657,1632930,1.63293
6055,3555,5765,20494575,2,48446,12113,1,615417400,615417400,18166,6055,12111,6055,0,1,6057,1028675,1.028675
6455,3555,5765,20494575,2,51646,12913,1,645241400,645241400,19366,6455,12911,6455,0,1,6457,18914370,18.91437
6855,3555,5765,20494575,2,54846,13713,1,675065400,675065400,20566,6855,13711,6855,0,1,6857,1430647,1.430647
40,4550,4540,20657000,2,326,83,1,168164800,168164800,121,40,81,40,0,1,42,377006,0.377006
440,4550,4540,20657000,2,3526,883,1,197252800,197252800,1321,440,881,440,0,1,442,1854755,1.854755
840,4550,4540,20657000,2,6726,1683,1,226340800,226340800,2521,840,1681,840,0,1,842,3360723,3.360723
1240,4550,4540,20657000,2,9926,2483,1,255428800,255428800,3721,1240,2481,1240,0,1,1242,4878798,4.878798
1640,4550,4540,20657000,2,13126,3283,1,284516800,284516800,4921,1640,3281,1640,0,1,1642,5983284,5.983284
2040,4550,4540,20657000,2,16326,4083,1,313604800,313604800,6121,2040,4081,2040,0,1,2042,2240122,2.240122
2440,4550,4540,20657000,2,19526,4883,1,342692800,342692800,7321,2440,4881,2440,0,1,2442,1805704,1.805704
2840,4550,4540,20657000,2,22726,5683,1,371780800,371780800,8521,2840,5681,2840,0,1,2842,488092,0.488092
3240,4550,4540,20657000,2,25926,6483,1,400868800,400868800,9721,3240,6481,3240,0,1,3242,172934,0.172934
3640,4550,4540,20657000,2,29126,7283,1,429956800,429956800,10921,3640,7281,3640,0,1,3642,2350236,2.350236
4040,4550,4540,20657000,2,32326,8083,1,459044800,459044800,12121,4040,8081,4040,0,1,4042,4309316,4.309316
4440,4550,4540,20657000,2,35526,8883,1,488132800,488132800,13321,4440,8881,4440,0,1,4442,9129553,9.129553
4840,4550,4540,20657000,2,38726,9683,1,517220800,517220800,14521,4840,9681,4840,0,1,4842,1481394,1.481394
5240,4550,4540,20657000,2,41926,10483,1,546308800,546308800,15721,5240,10481,5240,0,1,5242,3138570,3.13857
5640,4550,4540,20657000,2,45126,11283,1,575396800,575396800,16921,5640,11281,5640,0,1,5642,236875,0.236875
6040,4550,4540,20657000,2,48326,12083,1,604484800,604484800,18121,6040,12081,6040,0,1,6042,1014431,1.014431
6440,4550,4540,20657000,2,51526,12883,1,633572800,633572800,19321,6440,12881,6440,0,1,6442,1572235,1.572235
6840,4550,4540,20657000,2,54726,13683,1,662660800,662660800,20521,6840,13681,6840,0,1,6842,3995579,3.995579
40,6800,3040,20672000,2,326,83,1,168524800,168524800,121,40,81,40,0,1,42,356810,0.35681
440,6800,3040,20672000,2,3526,883,1,200012800,200012800,1321,440,881,440,0,1,442,614507,0.614507
840,6800,3040,20672000,2,6726,1683,1,231500800,231500800,2521,840,1681,840,0,1,842,3040766,3.040766
1240,6800,3040,20672000,2,9926,2483,1,262988800,262988800,3721,1240,2481,1240,0,1,1242,1007197,1.007197
1640,6800,3040,20672000,2,13126,3283,1,294476800,294476800,4921,1640,3281,1640,0,1,1642,2862277,2.862277
2040,6800,3040,20672000,2,16326,4083,1,325964800,325964800,6121,2040,4081,2040,0,1,2042,2368795,2.368795
2440,6800,3040,20672000,2,19526,4883,1,357452800,357452800,7321,2440,4881,2440,0,1,2442,366697,0.366697
2840,6800,3040,20672000,2,22726,5683,1,388940800,388940800,8521,2840,5681,2840,0,1,2842,1597676,1.597676
3240,6800,3040,20672000,2,25926,6483,1,420428800,420428800,9721,3240,6481,3240,0,1,3242,2823104,2.823104
3640,6800,3040,20672000,2,29126,7283,1,451916800,451916800,10921,3640,7281,3640,0,1,3642,237608,0.237608
4040,6800,3040,20672000,2,32326,8083,1,483404800,483404800,12121,4040,8081,4040,0,1,4042,1656197,1.656197
4440,6800,3040,20672000,2,35526,8883,1,514892800,514892800,13321,4440,8881,4440,0,1,4442,2324637,2.324637
4840,6800,3040,20672000,2,38726,9683,1,546380800,546380800,14521,4840,9681,4840,0,1,4842,2959475,2.959475
40,3800,5440,20672000,2,326,83,1,168332800,168332800,121,40,81,40,0,1,42,362468,0.362468
440,3800,5440,20672000,2,3526,883,1,197900800,197900800,1321,440,881,440,0,1,442,1861289,1.861289
840,3800,5440,20672000,2,6726,1683,1,227468800,227468800,2521,840,1681,840,0,1,842,883337,0.883337
1240,3800,5440,20672000,2,9926,2483,1,257036800,257036800,3721,1240,2481,1240,0,1,1242,4899675,4.899675
1640,3800,5440,20672000,2,13126,3283,1,286604800,286604800,4921,1640,3281,1640,0,1,1642,3917336,3.917336
2040,3800,5440,20672000,2,16326,4083,1,316172800,316172800,6121,2040,4081,2040,0,1,2042,3388767,3.388767
5240,6800,3040,20672000,2,41926,10483,1,577868800,577868800,15721,5240,10481,5240,0,1,5242,878856,0.878856
2440,3800,5440,20672000,2,19526,4883,1,345740800,345740800,7321,2440,4881,2440,0,1,2442,2607241,2.607241
2840,3800,5440,20672000,2,22726,5683,1,375308800,375308800,8521,2840,5681,2840,0,1,2842,2447032,2.447032
3240,3800,5440,20672000,2,25926,6483,1,404876800,404876800,9721,3240,6481,3240,0,1,3242,835945,0.835945
5640,6800,3040,20672000,2,45126,11283,1,609356800,609356800,16921,5640,11281,5640,0,1,5642,483099,0.483099
3640,3800,5440,20672000,2,29126,7283,1,434444800,434444800,10921,3640,7281,3640,0,1,3642,4087968,4.087968
4040,3800,5440,20672000,2,32326,8083,1,464012800,464012800,12121,4040,8081,4040,0,1,4042,1078707,1.078707
4440,3800,5440,20672000,2,35526,8883,1,493580800,493580800,13321,4440,8881,4440,0,1,4442,3396452,3.396452
6040,6800,3040,20672000,2,48326,12083,1,640844800,640844800,18121,6040,12081,6040,0,1,6042,1748217,1.748217
4840,3800,5440,20672000,2,38726,9683,1,523148800,523148800,14521,4840,9681,4840,0,1,4842,382818,0.382818
5240,3800,5440,20672000,2,41926,10483,1,552716800,552716800,15721,5240,10481,5240,0,1,5242,2685649,2.685649
6440,6800,3040,20672000,2,51526,12883,1,672332800,672332800,19321,6440,12881,6440,0,1,6442,5211609,5.211609
5640,3800,5440,20672000,2,45126,11283,1,582284800,582284800,16921,5640,11281,5640,0,1,5642,6207895,6.207895
6040,3800,5440,20672000,2,48326,12083,1,611852800,611852800,18121,6040,12081,6040,0,1,6042,1342651,1.342651
6840,6800,3040,20672000,2,54726,13683,1,703820800,703820800,20521,6840,13681,6840,0,1,6842,3515545,3.515545
6440,3800,5440,20672000,2,51526,12883,1,641420800,641420800,19321,6440,12881,6440,0,1,6442,6366457,6.366457
6840,3800,5440,20672000,2,54726,13683,1,670988800,670988800,20521,6840,13681,6840,0,1,6842,11404033,11.404033
55,4555,4565,20793575,2,446,113,1,170361400,170361400,166,55,111,55,0,1,57,419599,0.419599
455,4555,4565,20793575,2,3646,913,1,199545400,199545400,1366,455,911,455,0,1,457,1933284,1.933284
855,4555,4565,20793575,2,6846,1713,1,228729400,228729400,2566,855,1711,855,0,1,857,2556535,2.556535
1255,4555,4565,20793575,2,10046,2513,1,257913400,257913400,3766,1255,2511,1255,0,1,1257,3365755,3.365755
1655,4555,4565,20793575,2,13246,3313,1,287097400,287097400,4966,1655,3311,1655,0,1,1657,1193008,1.193008
2055,4555,4565,20793575,2,16446,4113,1,316281400,316281400,6166,2055,4111,2055,0,1,2057,2772188,2.772188
2455,4555,4565,20793575,2,19646,4913,1,345465400,345465400,7366,2455,4911,2455,0,1,2457,1095460,1.09546
2855,4555,4565,20793575,2,22846,5713,1,374649400,374649400,8566,2855,5711,2855,0,1,2857,249326,0.249326
3255,4555,4565,20793575,2,26046,6513,1,403833400,403833400,9766,3255,6511,3255,0,1,3257,523186,0.523186
3655,4555,4565,20793575,2,29246,7313,1,433017400,433017400,10966,3655,7311,3655,0,1,3657,2198306,2.198306
4055,4555,4565,20793575,2,32446,8113,1,462201400,462201400,12166,4055,8111,4055,0,1,4057,559847,0.559847
4455,4555,4565,20793575,2,35646,8913,1,491385400,491385400,13366,4455,8911,4455,0,1,4457,6334133,6.334133
4855,4555,4565,20793575,2,38846,9713,1,520569400,520569400,14566,4855,9711,4855,0,1,4857,6974830,6.97483
5255,4555,4565,20793575,2,42046,10513,1,549753400,549753400,15766,5255,10511,5255,0,1,5257,3869044,3.869044
5655,4555,4565,20793575,2,45246,11313,1,578937400,578937400,16966,5655,11311,5655,0,1,5657,7799253,7.799253
6055,4555,4565,20793575,2,48446,12113,1,608121400,608121400,18166,6055,12111,6055,0,1,6057,894997,0.894997
6455,4555,4565,20793575,2,51646,12913,1,637305400,637305400,19366,6455,12911,6455,0,1,6457,840677,0.840677
6855,4555,4565,20793575,2,54846,13713,1,666489400,666489400,20566,6855,13711,6855,0,1,6857,517111,0.517111
55,3805,5465,20794325,2,446,113,1,170433400,170433400,166,55,111,55,0,1,57,433133,0.433133
455,3805,5465,20794325,2,3646,913,1,200097400,200097400,1366,455,911,455,0,1,457,2001729,2.001729
855,3805,5465,20794325,2,6846,1713,1,229761400,229761400,2566,855,1711,855,0,1,857,3625880,3.62588
1255,3805,5465,20794325,2,10046,2513,1,259425400,259425400,3766,1255,2511,1255,0,1,1257,1333677,1.333677
1655,3805,5465,20794325,2,13246,3313,1,289089400,289089400,4966,1655,3311,1655,0,1,1657,4865793,4.865793
2055,3805,5465,20794325,2,16446,4113,1,318753400,318753400,6166,2055,4111,2055,0,1,2057,1104067,1.104067
2455,3805,5465,20794325,2,19646,4913,1,348417400,348417400,7366,2455,4911,2455,0,1,2457,1574340,1.57434
2855,3805,5465,20794325,2,22846,5713,1,378081400,378081400,8566,2855,5711,2855,0,1,2857,2207890,2.20789
3255,3805,5465,20794325,2,26046,6513,1,407745400,407745400,9766,3255,6511,3255,0,1,3257,4522297,4.522297
3655,3805,5465,20794325,2,29246,7313,1,437409400,437409400,10966,3655,7311,3655,0,1,3657,1255888,1.255888
4055,3805,5465,20794325,2,32446,8113,1,467073400,467073400,12166,4055,8111,4055,0,1,4057,2669452,2.669452
4455,3805,5465,20794325,2,35646,8913,1,496737400,496737400,13366,4455,8911,4455,0,1,4457,8686909,8.686909
4855,3805,5465,20794325,2,38846,9713,1,526401400,526401400,14566,4855,9711,4855,0,1,4857,1822339,1.822339
5255,3805,5465,20794325,2,42046,10513,1,556065400,556065400,15766,5255,10511,5255,0,1,5257,586762,0.586762
5655,3805,5465,20794325,2,45246,11313,1,585729400,585729400,16966,5655,11311,5655,0,1,5657,6936638,6.936638
6055,3805,5465,20794325,2,48446,12113,1,615393400,615393400,18166,6055,12111,6055,0,1,6057,4470440,4.47044
6455,3805,5465,20794325,2,51646,12913,1,645057400,645057400,19366,6455,12911,6455,0,1,6457,4481086,4.481086
6855,3805,5465,20794325,2,54846,13713,1,674721400,674721400,20566,6855,13711,6855,0,1,6857,2315722,2.315722
40,4300,4840,20812000,2,326,83,1,169420800,169420800,121,40,81,40,0,1,42,374268,0.374268
440,4300,4840,20812000,2,3526,883,1,198668800,198668800,1321,440,881,440,0,1,442,861649,0.861649
840,4300,4840,20812000,2,6726,1683,1,227916800,227916800,2521,840,1681,840,0,1,842,241846,0.241846
1240,4300,4840,20812000,2,9926,2483,1,257164800,257164800,3721,1240,2481,1240,0,1,1242,567268,0.567268
1640,4300,4840,20812000,2,13126,3283,1,286412800,286412800,4921,1640,3281,1640,0,1,1642,583364,0.583364
2040,4300,4840,20812000,2,16326,4083,1,315660800,315660800,6121,2040,4081,2040,0,1,2042,706200,0.7062
2440,4300,4840,20812000,2,19526,4883,1,344908800,344908800,7321,2440,4881,2440,0,1,2442,1418036,1.418036
2840,4300,4840,20812000,2,22726,5683,1,374156800,374156800,8521,2840,5681,2840,0,1,2842,1080732,1.080732
3240,4300,4840,20812000,2,25926,6483,1,403404800,403404800,9721,3240,6481,3240,0,1,3242,712441,0.712441
3640,4300,4840,20812000,2,29126,7283,1,432652800,432652800,10921,3640,7281,3640,0,1,3642,2901356,2.901356
4040,4300,4840,20812000,2,32326,8083,1,461900800,461900800,12121,4040,8081,4040,0,1,4042,390356,0.390356
4440,4300,4840,20812000,2,35526,8883,1,491148800,491148800,13321,4440,8881,4440,0,1,4442,134142,0.134142
4840,4300,4840,20812000,2,38726,9683,1,520396800,520396800,14521,4840,9681,4840,0,1,4842,736003,0.736003
5240,4300,4840,20812000,2,41926,10483,1,549644800,549644800,15721,5240,10481,5240,0,1,5242,309964,0.309964
5640,4300,4840,20812000,2,45126,11283,1,578892800,578892800,16921,5640,11281,5640,0,1,5642,1284527,1.284527
6040,4300,4840,20812000,2,48326,12083,1,608140800,608140800,18121,6040,12081,6040,0,1,6042,976222,0.976222
6440,4300,4840,20812000,2,51526,12883,1,637388800,637388800,19321,6440,12881,6440,0,1,6442,171824,0.171824
6840,4300,4840,20812000,2,54726,13683,1,666636800,666636800,20521,6840,13681,6840,0,1,6842,1137336,1.137336
40,4050,5140,20817000,2,326,83,1,169476800,169476800,121,40,81,40,0,1,42,21112,0.021112
440,4050,5140,20817000,2,3526,883,1,198884800,198884800,1321,440,881,440,0,1,442,173726,0.173726
840,4050,5140,20817000,2,6726,1683,1,228292800,228292800,2521,840,1681,840,0,1,842,57140,0.05714
1240,4050,5140,20817000,2,9926,2483,1,257700800,257700800,3721,1240,2481,1240,0,1,1242,420476,0.420476
1640,4050,5140,20817000,2,13126,3283,1,287108800,287108800,4921,1640,3281,1640,0,1,1642,213867,0.213867
2040,4050,5140,20817000,2,16326,4083,1,316516800,316516800,6121,2040,4081,2040,0,1,2042,972624,0.972624
2440,4050,5140,20817000,2,19526,4883,1,345924800,345924800,7321,2440,4881,2440,0,1,2442,135904,0.135904
2840,4050,5140,20817000,2,22726,5683,1,375332800,375332800,8521,2840,5681,2840,0,1,2842,163639,0.163639
3240,4050,5140,20817000,2,25926,6483,1,404740800,404740800,9721,3240,6481,3240,0,1,3242,1312205,1.312205
3640,4050,5140,20817000,2,29126,7283,1,434148800,434148800,10921,3640,7281,3640,0,1,3642,223616,0.223616
4040,4050,5140,20817000,2,32326,8083,1,463556800,463556800,12121,4040,8081,4040,0,1,4042,191716,0.191716
4440,4050,5140,20817000,2,35526,8883,1,492964800,492964800,13321,4440,8881,4440,0,1,4442,227301,0.227301
4840,4050,5140,20817000,2,38726,9683,1,522372800,522372800,14521,4840,9681,4840,0,1,4842,1996433,1.996433
5240,4050,5140,20817000,2,41926,10483,1,551780800,551780800,15721,5240,10481,5240,0,1,5242,793112,0.793112
5640,4050,5140,20817000,2,45126,11283,1,581188800,581188800,16921,5640,11281,5640,0,1,5642,3537484,3.537484
6040,4050,5140,20817000,2,48326,12083,1,610596800,610596800,18121,6040,12081,6040,0,1,6042,1348028,1.348028
6440,4050,5140,20817000,2,51526,12883,1,640004800,640004800,19321,6440,12881,6440,0,1,6442,3458274,3.458274
6840,4050,5140,20817000,2,54726,13683,1,669412800,669412800,20521,6840,13681,6840,0,1,6842,2379732,2.379732
55,6805,3065,20857325,2,446,113,1,171201400,171201400,166,55,111,55,0,1,57,420618,0.420618
455,6805,3065,20857325,2,3646,913,1,202785400,202785400,1366,455,911,455,0,1,457,482032,0.482032
855,6805,3065,20857325,2,6846,1713,1,234369400,234369400,2566,855,1711,855,0,1,857,1539373,1.539373
1255,6805,3065,20857325,2,10046,2513,1,265953400,265953400,3766,1255,2511,1255,0,1,1257,2154258,2.154258
1655,6805,3065,20857325,2,13246,3313,1,297537400,297537400,4966,1655,3311,1655,0,1,1657,1375524,1.375524
2055,6805,3065,20857325,2,16446,4113,1,329121400,329121400,6166,2055,4111,2055,0,1,2057,202580,0.20258
2455,6805,3065,20857325,2,19646,4913,1,360705400,360705400,7366,2455,4911,2455,0,1,2457,1251499,1.251499
2855,6805,3065,20857325,2,22846,5713,1,392289400,392289400,8566,2855,5711,2855,0,1,2857,1705630,1.70563
3255,6805,3065,20857325,2,26046,6513,1,423873400,423873400,9766,3255,6511,3255,0,1,3257,1750422,1.750422
3655,6805,3065,20857325,2,29246,7313,1,455457400,455457400,10966,3655,7311,3655,0,1,3657,386645,0.386645
4055,6805,3065,20857325,2,32446,8113,1,487041400,487041400,12166,4055,8111,4055,0,1,4057,2178881,2.178881
4455,6805,3065,20857325,2,35646,8913,1,518625400,518625400,13366,4455,8911,4455,0,1,4457,2398611,2.398611
4855,6805,3065,20857325,2,38846,9713,1,550209400,550209400,14566,4855,9711,4855,0,1,4857,2731543,2.731543
5255,6805,3065,20857325,2,42046,10513,1,581793400,581793400,15766,5255,10511,5255,0,1,5257,4627746,4.627746
5655,6805,3065,20857325,2,45246,11313,1,613377400,613377400,16966,5655,11311,5655,0,1,5657,2474896,2.474896
6055,6805,3065,20857325,2,48446,12113,1,644961400,644961400,18166,6055,12111,6055,0,1,6057,5446738,5.446738
6455,6805,3065,20857325,2,51646,12913,1,676545400,676545400,19366,6455,12911,6455,0,1,6457,1717701,1.717701
6855,6805,3065,20857325,2,54846,13713,1,708129400,708129400,20566,6855,13711,6855,0,1,6857,5530738,5.530738
40,5300,3940,20882000,2,326,83,1,170012800,170012800,121,40,81,40,0,1,42,379078,0.379078
440,5300,3940,20882000,2,3526,883,1,199580800,199580800,1321,440,881,440,0,1,442,272231,0.272231
840,5300,3940,20882000,2,6726,1683,1,229148800,229148800,2521,840,1681,840,0,1,842,3526844,3.526844
1240,5300,3940,20882000,2,9926,2483,1,258716800,258716800,3721,1240,2481,1240,0,1,1242,853015,0.853015
1640,5300,3940,20882000,2,13126,3283,1,288284800,288284800,4921,1640,3281,1640,0,1,1642,1469772,1.469772
2040,5300,3940,20882000,2,16326,4083,1,317852800,317852800,6121,2040,4081,2040,0,1,2042,711059,0.711059
2440,5300,3940,20882000,2,19526,4883,1,347420800,347420800,7321,2440,4881,2440,0,1,2442,924877,0.924877
2840,5300,3940,20882000,2,22726,5683,1,376988800,376988800,8521,2840,5681,2840,0,1,2842,2172776,2.172776
3240,5300,3940,20882000,2,25926,6483,1,406556800,406556800,9721,3240,6481,3240,0,1,3242,2817109,2.817109
3640,5300,3940,20882000,2,29126,7283,1,436124800,436124800,10921,3640,7281,3640,0,1,3642,389828,0.389828
4040,5300,3940,20882000,2,32326,8083,1,465692800,465692800,12121,4040,8081,4040,0,1,4042,762779,0.762779
4440,5300,3940,20882000,2,35526,8883,1,495260800,495260800,13321,4440,8881,4440,0,1,4442,602072,0.602072
4840,5300,3940,20882000,2,38726,9683,1,524828800,524828800,14521,4840,9681,4840,0,1,4842,3294703,3.294703
5240,5300,3940,20882000,2,41926,10483,1,554396800,554396800,15721,5240,10481,5240,0,1,5242,2042395,2.042395
5640,5300,3940,20882000,2,45126,11283,1,583964800,583964800,16921,5640,11281,5640,0,1,5642,779213,0.779213
6040,5300,3940,20882000,2,48326,12083,1,613532800,613532800,18121,6040,12081,6040,0,1,6042,1240955,1.240955
6440,5300,3940,20882000,2,51526,12883,1,643100800,643100800,19321,6440,12881,6440,0,1,6442,2829814,2.829814
6840,5300,3940,20882000,2,54726,13683,1,672668800,672668800,20521,6840,13681,6840,0,1,6842,615154,0.615154
40,3300,6340,20922000,2,326,83,1,170460800,170460800,121,40,81,40,0,1,42,382640,0.38264
440,3300,6340,20922000,2,3526,883,1,201308800,201308800,1321,440,881,440,0,1,442,1317726,1.317726
840,3300,6340,20922000,2,6726,1683,1,232156800,232156800,2521,840,1681,840,0,1,842,500962,0.500962
1240,3300,6340,20922000,2,9926,2483,1,263004800,263004800,3721,1240,2481,1240,0,1,1242,1435514,1.435514
1640,3300,6340,20922000,2,13126,3283,1,293852800,293852800,4921,1640,3281,1640,0,1,1642,3811894,3.811894
2040,3300,6340,20922000,2,16326,4083,1,324700800,324700800,6121,2040,4081,2040,0,1,2042,39131,0.039131
2440,3300,6340,20922000,2,19526,4883,1,355548800,355548800,7321,2440,4881,2440,0,1,2442,1971567,1.971567
2840,3300,6340,20922000,2,22726,5683,1,386396800,386396800,8521,2840,5681,2840,0,1,2842,1758659,1.758659
3240,3300,6340,20922000,2,25926,6483,1,417244800,417244800,9721,3240,6481,3240,0,1,3242,597768,0.597768
3640,3300,6340,20922000,2,29126,7283,1,448092800,448092800,10921,3640,7281,3640,0,1,3642,1211165,1.211165
4040,3300,6340,20922000,2,32326,8083,1,478940800,478940800,12121,4040,8081,4040,0,1,4042,83788,0.083788
4440,3300,6340,20922000,2,35526,8883,1,509788800,509788800,13321,4440,8881,4440,0,1,4442,147635,0.147635
4840,3300,6340,20922000,2,38726,9683,1,540636800,540636800,14521,4840,9681,4840,0,1,4842,1082497,1.082497
5240,3300,6340,20922000,2,41926,10483,1,571484800,571484800,15721,5240,10481,5240,0,1,5242,1676743,1.676743
5640,3300,6340,20922000,2,45126,11283,1,602332800,602332800,16921,5640,11281,5640,0,1,5642,2580948,2.580948
6040,3300,6340,20922000,2,48326,12083,1,633180800,633180800,18121,6040,12081,6040,0,1,6042,4407313,4.407313
6440,3300,6340,20922000,2,51526,12883,1,664028800,664028800,19321,6440,12881,6440,0,1,6442,3119497,3.119497
6840,3300,6340,20922000,2,54726,13683,1,694876800,694876800,20521,6840,13681,6840,0,1,6842,1105447,1.105447
55,4305,4865,20943825,2,446,113,1,171585400,171585400,166,55,111,55,0,1,57,56576,0.056576
455,4305,4865,20943825,2,3646,913,1,200929400,200929400,1366,455,911,455,0,1,457,102137,0.102137
855,4305,4865,20943825,2,6846,1713,1,230273400,230273400,2566,855,1711,855,0,1,857,219832,0.219832
1255,4305,4865,20943825,2,10046,2513,1,259617400,259617400,3766,1255,2511,1255,0,1,1257,1238788,1.238788
1655,4305,4865,20943825,2,13246,3313,1,288961400,288961400,4966,1655,3311,1655,0,1,1657,1445831,1.445831
2055,4305,4865,20943825,2,16446,4113,1,318305400,318305400,6166,2055,4111,2055,0,1,2057,1118138,1.118138
2455,4305,4865,20943825,2,19646,4913,1,347649400,347649400,7366,2455,4911,2455,0,1,2457,2313368,2.313368
2855,4305,4865,20943825,2,22846,5713,1,376993400,376993400,8566,2855,5711,2855,0,1,2857,1480874,1.480874
3255,4305,4865,20943825,2,26046,6513,1,406337400,406337400,9766,3255,6511,3255,0,1,3257,194067,0.194067
3655,4305,4865,20943825,2,29246,7313,1,435681400,435681400,10966,3655,7311,3655,0,1,3657,2129826,2.129826
4055,4305,4865,20943825,2,32446,8113,1,465025400,465025400,12166,4055,8111,4055,0,1,4057,1678308,1.678308
4455,4305,4865,20943825,2,35646,8913,1,494369400,494369400,13366,4455,8911,4455,0,1,4457,269172,0.269172
4855,4305,4865,20943825,2,38846,9713,1,523713400,523713400,14566,4855,9711,4855,0,1,4857,122285,0.122285
5255,4305,4865,20943825,2,42046,10513,1,553057400,553057400,15766,5255,10511,5255,0,1,5257,212372,0.212372
5655,4305,4865,20943825,2,45246,11313,1,582401400,582401400,16966,5655,11311,5655,0,1,5657,1112395,1.112395
6055,4305,4865,20943825,2,48446,12113,1,611745400,611745400,18166,6055,12111,6055,0,1,6057,523455,0.523455
6455,4305,4865,20943825,2,51646,12913,1,641089400,641089400,19366,6455,12911,6455,0,1,6457,1675642,1.675642
6855,4305,4865,20943825,2,54846,13713,1,670433400,670433400,20566,6855,13711,6855,0,1,6857,194302,0.194302
55,4055,5165,20944075,2,446,113,1,171609400,171609400,166,55,111,55,0,1,57,44482,0.044482
455,4055,5165,20944075,2,3646,913,1,201113400,201113400,1366,455,911,455,0,1,457,89214,0.089214
855,4055,5165,20944075,2,6846,1713,1,230617400,230617400,2566,855,1711,855,0,1,857,506479,0.506479
1255,4055,5165,20944075,2,10046,2513,1,260121400,260121400,3766,1255,2511,1255,0,1,1257,731221,0.731221
1655,4055,5165,20944075,2,13246,3313,1,289625400,289625400,4966,1655,3311,1655,0,1,1657,110710,0.11071
2055,4055,5165,20944075,2,16446,4113,1,319129400,319129400,6166,2055,4111,2055,0,1,2057,706656,0.706656
2455,4055,5165,20944075,2,19646,4913,1,348633400,348633400,7366,2455,4911,2455,0,1,2457,86405,0.086405
2855,4055,5165,20944075,2,22846,5713,1,378137400,378137400,8566,2855,5711,2855,0,1,2857,2323394,2.323394
3255,4055,5165,20944075,2,26046,6513,1,407641400,407641400,9766,3255,6511,3255,0,1,3257,2221865,2.221865
3655,4055,5165,20944075,2,29246,7313,1,437145400,437145400,10966,3655,7311,3655,0,1,3657,128311,0.128311
4055,4055,5165,20944075,2,32446,8113,1,466649400,466649400,12166,4055,8111,4055,0,1,4057,1051403,1.051403
4455,4055,5165,20944075,2,35646,8913,1,496153400,496153400,13366,4455,8911,4455,0,1,4457,789663,0.789663
4855,4055,5165,20944075,2,38846,9713,1,525657400,525657400,14566,4855,9711,4855,0,1,4857,100460,0.10046
5255,4055,5165,20944075,2,42046,10513,1,555161400,555161400,15766,5255,10511,5255,0,1,5257,891880,0.89188
5655,4055,5165,20944075,2,45246,11313,1,584665400,584665400,16966,5655,11311,5655,0,1,5657,476864,0.476864
6055,4055,5165,20944075,2,48446,12113,1,614169400,614169400,18166,6055,12111,6055,0,1,6057,1531484,1.531484
6455,4055,5165,20944075,2,51646,12913,1,643673400,643673400,19366,6455,12911,6455,0,1,6457,63974,0.063974
6855,4055,5165,20944075,2,54846,13713,1,673177400,673177400,20566,6855,13711,6855,0,1,6857,774963,0.774963
55,5305,3965,21034325,2,446,113,1,172353400,172353400,166,55,111,55,0,1,57,418960,0.41896
455,5305,3965,21034325,2,3646,913,1,202017400,202017400,1366,455,911,455,0,1,457,742314,0.742314
855,5305,3965,21034325,2,6846,1713,1,231681400,231681400,2566,855,1711,855,0,1,857,2066785,2.066785
1255,5305,3965,21034325,2,10046,2513,1,261345400,261345400,3766,1255,2511,1255,0,1,1257,2491388,2.491388
1655,5305,3965,21034325,2,13246,3313,1,291009400,291009400,4966,1655,3311,1655,0,1,1657,2200694,2.200694
2055,5305,3965,21034325,2,16446,4113,1,320673400,320673400,6166,2055,4111,2055,0,1,2057,272516,0.272516
2455,5305,3965,21034325,2,19646,4913,1,350337400,350337400,7366,2455,4911,2455,0,1,2457,2491326,2.491326
2855,5305,3965,21034325,2,22846,5713,1,380001400,380001400,8566,2855,5711,2855,0,1,2857,360025,0.360025
3255,5305,3965,21034325,2,26046,6513,1,409665400,409665400,9766,3255,6511,3255,0,1,3257,1824035,1.824035
3655,5305,3965,21034325,2,29246,7313,1,439329400,439329400,10966,3655,7311,3655,0,1,3657,70633,0.070633
4055,5305,3965,21034325,2,32446,8113,1,468993400,468993400,12166,4055,8111,4055,0,1,4057,412451,0.412451
4455,5305,3965,21034325,2,35646,8913,1,498657400,498657400,13366,4455,8911,4455,0,1,4457,476771,0.476771
4855,5305,3965,21034325,2,38846,9713,1,528321400,528321400,14566,4855,9711,4855,0,1,4857,1785928,1.785928
5255,5305,3965,21034325,2,42046,10513,1,557985400,557985400,15766,5255,10511,5255,0,1,5257,1992072,1.992072
5655,5305,3965,21034325,2,45246,11313,1,587649400,587649400,16966,5655,11311,5655,0,1,5657,776671,0.776671
6055,5305,3965,21034325,2,48446,12113,1,617313400,617313400,18166,6055,12111,6055,0,1,6057,2603238,2.603238
6455,5305,3965,21034325,2,51646,12913,1,646977400,646977400,19366,6455,12911,6455,0,1,6457,737191,0.737191
6855,5305,3965,21034325,2,54846,13713,1,676641400,676641400,20566,6855,13711,6855,0,1,6857,7457185,7.457185
55,3305,6365,21036325,2,446,113,1,172545400,172545400,166,55,111,55,0,1,57,430911,0.430911
455,3305,6365,21036325,2,3646,913,1,203489400,203489400,1366,455,911,455,0,1,457,389116,0.389116
855,3305,6365,21036325,2,6846,1713,1,234433400,234433400,2566,855,1711,855,0,1,857,1039957,1.039957
1255,3305,6365,21036325,2,10046,2513,1,265377400,265377400,3766,1255,2511,1255,0,1,1257,1005871,1.005871
1655,3305,6365,21036325,2,13246,3313,1,296321400,296321400,4966,1655,3311,1655,0,1,1657,6385548,6.385548
2055,3305,6365,21036325,2,16446,4113,1,327265400,327265400,6166,2055,4111,2055,0,1,2057,1514655,1.514655
2455,3305,6365,21036325,2,19646,4913,1,358209400,358209400,7366,2455,4911,2455,0,1,2457,2495016,2.495016
2855,3305,6365,21036325,2,22846,5713,1,389153400,389153400,8566,2855,5711,2855,0,1,2857,123465,0.123465
3255,3305,6365,21036325,2,26046,6513,1,420097400,420097400,9766,3255,6511,3255,0,1,3257,4248207,4.248207
3655,3305,6365,21036325,2,29246,7313,1,451041400,451041400,10966,3655,7311,3655,0,1,3657,2322225,2.322225
4055,3305,6365,21036325,2,32446,8113,1,481985400,481985400,12166,4055,8111,4055,0,1,4057,197264,0.197264
4455,3305,6365,21036325,2,35646,8913,1,512929400,512929400,13366,4455,8911,4455,0,1,4457,556759,0.556759
4855,3305,6365,21036325,2,38846,9713,1,543873400,543873400,14566,4855,9711,4855,0,1,4857,879410,0.87941
5255,3305,6365,21036325,2,42046,10513,1,574817400,574817400,15766,5255,10511,5255,0,1,5257,1573009,1.573009
5655,3305,6365,21036325,2,45246,11313,1,605761400,605761400,16966,5655,11311,5655,0,1,5657,1016774,1.016774
6055,3305,6365,21036325,2,48446,12113,1,636705400,636705400,18166,6055,12111,6055,0,1,6057,3230958,3.230958
6455,3305,6365,21036325,2,51646,12913,1,667649400,667649400,19366,6455,12911,6455,0,1,6457,6594745,6.594745
6855,3305,6365,21036325,2,54846,13713,1,698593400,698593400,20566,6855,13711,6855,0,1,6857,343049,0.343049
40,6300,3340,21042000,2,326,83,1,171420800,171420800,121,40,81,40,0,1,42,388852,0.388852
440,6300,3340,21042000,2,3526,883,1,202268800,202268800,1321,440,881,440,0,1,442,1892053,1.892053
840,6300,3340,21042000,2,6726,1683,1,233116800,233116800,2521,840,1681,840,0,1,842,1655062,1.655062
1240,6300,3340,21042000,2,9926,2483,1,263964800,263964800,3721,1240,2481,1240,0,1,1242,4290791,4.290791
1640,6300,3340,21042000,2,13126,3283,1,294812800,294812800,4921,1640,3281,1640,0,1,1642,1383654,1.383654
2040,6300,3340,21042000,2,16326,4083,1,325660800,325660800,6121,2040,4081,2040,0,1,2042,664057,0.664057
2440,6300,3340,21042000,2,19526,4883,1,356508800,356508800,7321,2440,4881,2440,0,1,2442,8195191,8.195191
2840,6300,3340,21042000,2,22726,5683,1,387356800,387356800,8521,2840,5681,2840,0,1,2842,2705115,2.705115
3240,6300,3340,21042000,2,25926,6483,1,418204800,418204800,9721,3240,6481,3240,0,1,3242,1908336,1.908336
3640,6300,3340,21042000,2,29126,7283,1,449052800,449052800,10921,3640,7281,3640,0,1,3642,5349302,5.349302
4040,6300,3340,21042000,2,32326,8083,1,479900800,479900800,12121,4040,8081,4040,0,1,4042,6340972,6.340972
4440,6300,3340,21042000,2,35526,8883,1,510748800,510748800,13321,4440,8881,4440,0,1,4442,5111060,5.11106
4840,6300,3340,21042000,2,38726,9683,1,541596800,541596800,14521,4840,9681,4840,0,1,4842,5586815,5.586815
5240,6300,3340,21042000,2,41926,10483,1,572444800,572444800,15721,5240,10481,5240,0,1,5242,16606835,16.606835
5640,6300,3340,21042000,2,45126,11283,1,603292800,603292800,16921,5640,11281,5640,0,1,5642,142112,0.142112
6040,6300,3340,21042000,2,48326,12083,1,634140800,634140800,18121,6040,12081,6040,0,1,6042,11709885,11.709885
6440,6300,3340,21042000,2,51526,12883,1,664988800,664988800,19321,6440,12881,6440,0,1,6442,22858125,22.858125
6840,6300,3340,21042000,2,54726,13683,1,695836800,695836800,20521,6840,13681,6840,0,1,6842,27108468,27.108468
40,5800,3640,21112000,2,326,83,1,171916800,171916800,121,40,81,40,0,1,42,22429,0.022429
440,5800,3640,21112000,2,3526,883,1,202124800,202124800,1321,440,881,440,0,1,442,153045,0.153045
840,5800,3640,21112000,2,6726,1683,1,232332800,232332800,2521,840,1681,840,0,1,842,229619,0.229619
1240,5800,3640,21112000,2,9926,2483,1,262540800,262540800,3721,1240,2481,1240,0,1,1242,382728,0.382728
1640,5800,3640,21112000,2,13126,3283,1,292748800,292748800,4921,1640,3281,1640,0,1,1642,91341,0.091341
2040,5800,3640,21112000,2,16326,4083,1,322956800,322956800,6121,2040,4081,2040,0,1,2042,60328,0.060328
2440,5800,3640,21112000,2,19526,4883,1,353164800,353164800,7321,2440,4881,2440,0,1,2442,186727,0.186727
2840,5800,3640,21112000,2,22726,5683,1,383372800,383372800,8521,2840,5681,2840,0,1,2842,1044699,1.044699
3240,5800,3640,21112000,2,25926,6483,1,413580800,413580800,9721,3240,6481,3240,0,1,3242,2192692,2.192692
3640,5800,3640,21112000,2,29126,7283,1,443788800,443788800,10921,3640,7281,3640,0,1,3642,239501,0.239501
4040,5800,3640,21112000,2,32326,8083,1,473996800,473996800,12121,4040,8081,4040,0,1,4042,898086,0.898086
4440,5800,3640,21112000,2,35526,8883,1,504204800,504204800,13321,4440,8881,4440,0,1,4442,723618,0.723618
4840,5800,3640,21112000,2,38726,9683,1,534412800,534412800,14521,4840,9681,4840,0,1,4842,612109,0.612109
5240,5800,3640,21112000,2,41926,10483,1,564620800,564620800,15721,5240,10481,5240,0,1,5242,484930,0.48493
5640,5800,3640,21112000,2,45126,11283,1,594828800,594828800,16921,5640,11281,5640,0,1,5642,156017,0.156017
6040,5800,3640,21112000,2,48326,12083,1,625036800,625036800,18121,6040,12081,6040,0,1,6042,198784,0.198784
6440,5800,3640,21112000,2,51526,12883,1,655244800,655244800,19321,6440,12881,6440,0,1,6442,61338,0.061338
6840,5800,3640,21112000,2,54726,13683,1,685452800,685452800,20521,6840,13681,6840,0,1,6842,471947,0.471947
40,3050,6940,21167000,2,326,83,1,172532800,172532800,121,40,81,40,0,1,42,37295,0.037295
440,3050,6940,21167000,2,3526,883,1,204500800,204500800,1321,440,881,440,0,1,442,17271,0.017271
840,3050,6940,21167000,2,6726,1683,1,236468800,236468800,2521,840,1681,840,0,1,842,161349,0.161349
1240,3050,6940,21167000,2,9926,2483,1,268436800,268436800,3721,1240,2481,1240,0,1,1242,21404,0.021404
1640,3050,6940,21167000,2,13126,3283,1,300404800,300404800,4921,1640,3281,1640,0,1,1642,23381,0.023381
2040,3050,6940,21167000,2,16326,4083,1,332372800,332372800,6121,2040,4081,2040,0,1,2042,783890,0.78389
2440,3050,6940,21167000,2,19526,4883,1,364340800,364340800,7321,2440,4881,2440,0,1,2442,868147,0.868147
2840,3050,6940,21167000,2,22726,5683,1,396308800,396308800,8521,2840,5681,2840,0,1,2842,421009,0.421009
3240,3050,6940,21167000,2,25926,6483,1,428276800,428276800,9721,3240,6481,3240,0,1,3242,204858,0.204858
3640,3050,6940,21167000,2,29126,7283,1,460244800,460244800,10921,3640,7281,3640,0,1,3642,640694,0.640694
4040,3050,6940,21167000,2,32326,8083,1,492212800,492212800,12121,4040,8081,4040,0,1,4042,320586,0.320586
4440,3050,6940,21167000,2,35526,8883,1,524180800,524180800,13321,4440,8881,4440,0,1,4442,145983,0.145983
4840,3050,6940,21167000,2,38726,9683,1,556148800,556148800,14521,4840,9681,4840,0,1,4842,659577,0.659577
5240,3050,6940,21167000,2,41926,10483,1,588116800,588116800,15721,5240,10481,5240,0,1,5242,186193,0.186193
5640,3050,6940,21167000,2,45126,11283,1,620084800,620084800,16921,5640,11281,5640,0,1,5642,193422,0.193422
6040,3050,6940,21167000,2,48326,12083,1,652052800,652052800,18121,6040,12081,6040,0,1,6042,103724,0.103724
6440,3050,6940,21167000,2,51526,12883,1,684020800,684020800,19321,6440,12881,6440,0,1,6442,1177482,1.177482
6840,3050,6940,21167000,2,54726,13683,1,715988800,715988800,20521,6840,13681,6840,0,1,6842,335030,0.33503
55,6305,3365,21216325,2,446,113,1,173985400,173985400,166,55,111,55,0,1,57,431663,0.431663
455,6305,3365,21216325,2,3646,913,1,204929400,204929400,1366,455,911,455,0,1,457,1251666,1.251666
855,6305,3365,21216325,2,6846,1713,1,235873400,235873400,2566,855,1711,855,0,1,857,3579326,3.579326
1255,6305,3365,21216325,2,10046,2513,1,266817400,266817400,3766,1255,2511,1255,0,1,1257,1627009,1.627009
1655,6305,3365,21216325,2,13246,3313,1,297761400,297761400,4966,1655,3311,1655,0,1,1657,2897001,2.897001
2055,6305,3365,21216325,2,16446,4113,1,328705400,328705400,6166,2055,4111,2055,0,1,2057,616330,0.61633
2455,6305,3365,21216325,2,19646,4913,1,359649400,359649400,7366,2455,4911,2455,0,1,2457,273682,0.273682
2855,6305,3365,21216325,2,22846,5713,1,390593400,390593400,8566,2855,5711,2855,0,1,2857,711222,0.711222
3255,6305,3365,21216325,2,26046,6513,1,421537400,421537400,9766,3255,6511,3255,0,1,3257,5277763,5.277763
3655,6305,3365,21216325,2,29246,7313,1,452481400,452481400,10966,3655,7311,3655,0,1,3657,2945883,2.945883
4055,6305,3365,21216325,2,32446,8113,1,483425400,483425400,12166,4055,8111,4055,0,1,4057,554139,0.554139
4455,6305,3365,21216325,2,35646,8913,1,514369400,514369400,13366,4455,8911,4455,0,1,4457,5765925,5.765925
4855,6305,3365,21216325,2,38846,9713,1,545313400,545313400,14566,4855,9711,4855,0,1,4857,6618388,6.618388
5255,6305,3365,21216325,2,42046,10513,1,576257400,576257400,15766,5255,10511,5255,0,1,5257,1472360,1.47236
5655,6305,3365,21216325,2,45246,11313,1,607201400,607201400,16966,5655,11311,5655,0,1,5657,9343795,9.343795
6055,6305,3365,21216325,2,48446,12113,1,638145400,638145400,18166,6055,12111,6055,0,1,6057,7085655,7.085655
6455,6305,3365,21216325,2,51646,12913,1,669089400,669089400,19366,6455,12911,6455,0,1,6457,1400678,1.400678
6855,6305,3365,21216325,2,54846,13713,1,700033400,700033400,20566,6855,13711,6855,0,1,6857,18566495,18.566495
55,5805,3665,21275325,2,446,113,1,174369400,174369400,166,55,111,55,0,1,57,87579,0.087579
455,5805,3665,21275325,2,3646,913,1,204673400,204673400,1366,455,911,455,0,1,457,117221,0.117221
855,5805,3665,21275325,2,6846,1713,1,234977400,234977400,2566,855,1711,855,0,1,857,80790,0.08079
1255,5805,3665,21275325,2,10046,2513,1,265281400,265281400,3766,1255,2511,1255,0,1,1257,216728,0.216728
1655,5805,3665,21275325,2,13246,3313,1,295585400,295585400,4966,1655,3311,1655,0,1,1657,85661,0.085661
2055,5805,3665,21275325,2,16446,4113,1,325889400,325889400,6166,2055,4111,2055,0,1,2057,970707,0.970707
2455,5805,3665,21275325,2,19646,4913,1,356193400,356193400,7366,2455,4911,2455,0,1,2457,877481,0.877481
2855,5805,3665,21275325,2,22846,5713,1,386497400,386497400,8566,2855,5711,2855,0,1,2857,1400698,1.400698
3255,5805,3665,21275325,2,26046,6513,1,416801400,416801400,9766,3255,6511,3255,0,1,3257,448806,0.448806
3655,5805,3665,21275325,2,29246,7313,1,447105400,447105400,10966,3655,7311,3655,0,1,3657,822974,0.822974
4055,5805,3665,21275325,2,32446,8113,1,477409400,477409400,12166,4055,8111,4055,0,1,4057,3202004,3.202004
4455,5805,3665,21275325,2,35646,8913,1,507713400,507713400,13366,4455,8911,4455,0,1,4457,2434455,2.434455
4855,5805,3665,21275325,2,38846,9713,1,538017400,538017400,14566,4855,9711,4855,0,1,4857,78004,0.078004
5255,5805,3665,21275325,2,42046,10513,1,568321400,568321400,15766,5255,10511,5255,0,1,5257,31141,0.031141
5655,5805,3665,21275325,2,45246,11313,1,598625400,598625400,16966,5655,11311,5655,0,1,5657,826419,0.826419
6055,5805,3665,21275325,2,48446,12113,1,628929400,628929400,18166,6055,12111,6055,0,1,6057,1300568,1.300568
6455,5805,3665,21275325,2,51646,12913,1,659233400,659233400,19366,6455,12911,6455,0,1,6457,1557060,1.55706
6855,5805,3665,21275325,2,54846,13713,1,689537400,689537400,20566,6855,13711,6855,0,1,6857,66620,0.06662
55,3055,6965,21278075,2,446,113,1,174633400,174633400,166,55,111,55,0,1,57,110372,0.110372
455,3055,6965,21278075,2,3646,913,1,206697400,206697400,1366,455,911,455,0,1,457,16131,0.016131
855,3055,6965,21278075,2,6846,1713,1,238761400,238761400,2566,855,1711,855,0,1,857,50898,0.050898
1255,3055,6965,21278075,2,10046,2513,1,270825400,270825400,3766,1255,2511,1255,0,1,1257,176841,0.176841
1655,3055,6965,21278075,2,13246,3313,1,302889400,302889400,4966,1655,3311,1655,0,1,1657,69872,0.069872
2055,3055,6965,21278075,2,16446,4113,1,334953400,334953400,6166,2055,4111,2055,0,1,2057,277107,0.277107
2455,3055,6965,21278075,2,19646,4913,1,367017400,367017400,7366,2455,4911,2455,0,1,2457,384771,0.384771
2855,3055,6965,21278075,2,22846,5713,1,399081400,399081400,8566,2855,5711,2855,0,1,2857,1150282,1.150282
3255,3055,6965,21278075,2,26046,6513,1,431145400,431145400,9766,3255,6511,3255,0,1,3257,1702063,1.702063
3655,3055,6965,21278075,2,29246,7313,1,463209400,463209400,10966,3655,7311,3655,0,1,3657,1226249,1.226249
4055,3055,6965,21278075,2,32446,8113,1,495273400,495273400,12166,4055,8111,4055,0,1,4057,154247,0.154247
4455,3055,6965,21278075,2,35646,8913,1,527337400,527337400,13366,4455,8911,4455,0,1,4457,931889,0.931889
4855,3055,6965,21278075,2,38846,9713,1,559401400,559401400,14566,4855,9711,4855,0,1,4857,586592,0.586592
5255,3055,6965,21278075,2,42046,10513,1,591465400,591465400,15766,5255,10511,5255,0,1,5257,778060,0.77806
5655,3055,6965,21278075,2,45246,11313,1,623529400,623529400,16966,5655,11311,5655,0,1,5657,457797,0.457797
6055,3055,6965,21278075,2,48446,12113,1,655593400,655593400,18166,6055,12111,6055,0,1,6057,377745,0.377745
6455,3055,6965,21278075,2,51646,12913,1,687657400,687657400,19366,6455,12911,6455,0,1,6457,377405,0.377405
6855,3055,6965,21278075,2,54846,13713,1,719721400,719721400,20566,6855,13711,6855,0,1,6857,2742707,2.742707
40,5050,4240,21412000,2,326,83,1,174268800,174268800,121,40,81,40,0,1,42,79823,0.079823
440,5050,4240,21412000,2,3526,883,1,203996800,203996800,1321,440,881,440,0,1,442,20046,0.020046
840,5050,4240,21412000,2,6726,1683,1,233724800,233724800,2521,840,1681,840,0,1,842,99599,0.099599
1240,5050,4240,21412000,2,9926,2483,1,263452800,263452800,3721,1240,2481,1240,0,1,1242,59336,0.059336
1640,5050,4240,21412000,2,13126,3283,1,293180800,293180800,4921,1640,3281,1640,0,1,1642,1401366,1.401366
2040,5050,4240,21412000,2,16326,4083,1,322908800,322908800,6121,2040,4081,2040,0,1,2042,1117918,1.117918
2440,5050,4240,21412000,2,19526,4883,1,352636800,352636800,7321,2440,4881,2440,0,1,2442,195751,0.195751
2840,5050,4240,21412000,2,22726,5683,1,382364800,382364800,8521,2840,5681,2840,0,1,2842,182388,0.182388
3240,5050,4240,21412000,2,25926,6483,1,412092800,412092800,9721,3240,6481,3240,0,1,3242,1257268,1.257268
3640,5050,4240,21412000,2,29126,7283,1,441820800,441820800,10921,3640,7281,3640,0,1,3642,286946,0.286946
4040,5050,4240,21412000,2,32326,8083,1,471548800,471548800,12121,4040,8081,4040,0,1,4042,310101,0.310101
4440,5050,4240,21412000,2,35526,8883,1,501276800,501276800,13321,4440,8881,4440,0,1,4442,1709737,1.709737
4840,5050,4240,21412000,2,38726,9683,1,531004800,531004800,14521,4840,9681,4840,0,1,4842,2263085,2.263085
5240,5050,4240,21412000,2,41926,10483,1,560732800,560732800,15721,5240,10481,5240,0,1,5242,295336,0.295336
5640,5050,4240,21412000,2,45126,11283,1,590460800,590460800,16921,5640,11281,5640,0,1,5642,279653,0.279653
6040,5050,4240,21412000,2,48326,12083,1,620188800,620188800,18121,6040,12081,6040,0,1,6042,3328793,3.328793
6440,5050,4240,21412000,2,51526,12883,1,649916800,649916800,19321,6440,12881,6440,0,1,6442,4346609,4.346609
6840,5050,4240,21412000,2,54726,13683,1,679644800,679644800,20521,6840,13681,6840,0,1,6842,1500217,1.500217
40,7050,3040,21432000,2,326,83,1,174684800,174684800,121,40,81,40,0,1,42,371069,0.371069
440,7050,3040,21432000,2,3526,883,1,206972800,206972800,1321,440,881,440,0,1,442,1941271,1.941271
840,7050,3040,21432000,2,6726,1683,1,239260800,239260800,2521,840,1681,840,0,1,842,542291,0.542291
1240,7050,3040,21432000,2,9926,2483,1,271548800,271548800,3721,1240,2481,1240,0,1,1242,3797785,3.797785
1640,7050,3040,21432000,2,13126,3283,1,303836800,303836800,4921,1640,3281,1640,0,1,1642,5468671,5.468671
2040,7050,3040,21432000,2,16326,4083,1,336124800,336124800,6121,2040,4081,2040,0,1,2042,8425013,8.425013
2440,7050,3040,21432000,2,19526,4883,1,368412800,368412800,7321,2440,4881,2440,0,1,2442,182736,0.182736
2840,7050,3040,21432000,2,22726,5683,1,400700800,400700800,8521,2840,5681,2840,0,1,2842,6454345,6.454345
3240,7050,3040,21432000,2,25926,6483,1,432988800,432988800,9721,3240,6481,3240,0,1,3242,2458369,2.458369
3640,7050,3040,21432000,2,29126,7283,1,465276800,465276800,10921,3640,7281,3640,0,1,3642,6798627,6.798627
4040,7050,3040,21432000,2,32326,8083,1,497564800,497564800,12121,4040,8081,4040,0,1,4042,5179665,5.179665
4440,7050,3040,21432000,2,35526,8883,1,529852800,529852800,13321,4440,8881,4440,0,1,4442,1729943,1.729943
4840,7050,3040,21432000,2,38726,9683,1,562140800,562140800,14521,4840,9681,4840,0,1,4842,1323488,1.323488
5240,7050,3040,21432000,2,41926,10483,1,594428800,594428800,15721,5240,10481,5240,0,1,5242,21379338,21.379338
5640,7050,3040,21432000,2,45126,11283,1,626716800,626716800,16921,5640,11281,5640,0,1,5642,23012041,23.012041
6040,7050,3040,21432000,2,48326,12083,1,659004800,659004800,18121,6040,12081,6040,0,1,6042,24679941,24.679941
6440,7050,3040,21432000,2,51526,12883,1,691292800,691292800,19321,6440,12881,6440,0,1,6442,26298839,26.298839
6840,7050,3040,21432000,2,54726,13683,1,723580800,723580800,20521,6840,13681,6840,0,1,6842,28002525,28.002525
40,3550,6040,21442000,2,326,83,1,174604800,174604800,121,40,81,40,0,1,42,394662,0.394662
440,3550,6040,21442000,2,3526,883,1,205292800,205292800,1321,440,881,440,0,1,442,954199,0.954199
840,3550,6040,21442000,2,6726,1683,1,235980800,235980800,2521,840,1681,840,0,1,842,208722,0.208722
1240,3550,6040,21442000,2,9926,2483,1,266668800,266668800,3721,1240,2481,1240,0,1,1242,4067827,4.067827
1640,3550,6040,21442000,2,13126,3283,1,297356800,297356800,4921,1640,3281,1640,0,1,1642,4297277,4.297277
2040,3550,6040,21442000,2,16326,4083,1,328044800,328044800,6121,2040,4081,2040,0,1,2042,373647,0.373647
2440,3550,6040,21442000,2,19526,4883,1,358732800,358732800,7321,2440,4881,2440,0,1,2442,295429,0.295429
2840,3550,6040,21442000,2,22726,5683,1,389420800,389420800,8521,2840,5681,2840,0,1,2842,69516,0.069516
3240,3550,6040,21442000,2,25926,6483,1,420108800,420108800,9721,3240,6481,3240,0,1,3242,4759401,4.759401
3640,3550,6040,21442000,2,29126,7283,1,450796800,450796800,10921,3640,7281,3640,0,1,3642,4225166,4.225166
4040,3550,6040,21442000,2,32326,8083,1,481484800,481484800,12121,4040,8081,4040,0,1,4042,2594868,2.594868
4440,3550,6040,21442000,2,35526,8883,1,512172800,512172800,13321,4440,8881,4440,0,1,4442,325111,0.325111
4840,3550,6040,21442000,2,38726,9683,1,542860800,542860800,14521,4840,9681,4840,0,1,4842,1037262,1.037262
5240,3550,6040,21442000,2,41926,10483,1,573548800,573548800,15721,5240,10481,5240,0,1,5242,522591,0.522591
5640,3550,6040,21442000,2,45126,11283,1,604236800,604236800,16921,5640,11281,5640,0,1,5642,3063905,3.063905
6040,3550,6040,21442000,2,48326,12083,1,634924800,634924800,18121,6040,12081,6040,0,1,6042,4629796,4.629796
6440,3550,6040,21442000,2,51526,12883,1,665612800,665612800,19321,6440,12881,6440,0,1,6442,2035772,2.035772
6840,3550,6040,21442000,2,54726,13683,1,696300800,696300800,20521,6840,13681,6840,0,1,6842,3768743,3.768743
35,6050,3545,21447250,2,286,73,1,174264600,174264600,106,35,71,35,0,1,37,87363,0.087363
535,6050,3545,21447250,2,4286,1073,1,212644600,212644600,1606,535,1071,535,0,1,537,186112,0.186112
1035,6050,3545,21447250,2,8286,2073,1,251024600,251024600,3106,1035,2071,1035,0,1,1037,150278,0.150278
1535,6050,3545,21447250,2,12286,3073,1,289404600,289404600,4606,1535,3071,1535,0,1,1537,2667181,2.667181
2035,6050,3545,21447250,2,16286,4073,1,327784600,327784600,6106,2035,4071,2035,0,1,2037,719170,0.71917
2535,6050,3545,21447250,2,20286,5073,1,366164600,366164600,7606,2535,5071,2535,0,1,2537,431243,0.431243
3035,6050,3545,21447250,2,24286,6073,1,404544600,404544600,9106,3035,6071,3035,0,1,3037,2651827,2.651827
3535,6050,3545,21447250,2,28286,7073,1,442924600,442924600,10606,3535,7071,3535,0,1,3537,644361,0.644361
4035,6050,3545,21447250,2,32286,8073,1,481304600,481304600,12106,4035,8071,4035,0,1,4037,2625928,2.625928
4535,6050,3545,21447250,2,36286,9073,1,519684600,519684600,13606,4535,9071,4535,0,1,4537,2259852,2.259852
5035,6050,3545,21447250,2,40286,10073,1,558064600,558064600,15106,5035,10071,5035,0,1,5037,896362,0.896362
5535,6050,3545,21447250,2,44286,11073,1,596444600,596444600,16606,5535,11071,5535,0,1,5537,3070390,3.07039
6035,6050,3545,21447250,2,48286,12073,1,634824600,634824600,18106,6035,12071,6035,0,1,6037,9344298,9.344298
6535,6050,3545,21447250,2,52286,13073,1,673204600,673204600,19606,6535,13071,6535,0,1,6537,4689623,4.689623
7035,6050,3545,21447250,2,56286,14073,1,711584600,711584600,21106,7035,14071,7035,0,1,7037,16013345,16.013345
55,5055,4265,21559575,2,446,113,1,176577400,176577400,166,55,111,55,0,1,57,234,0.000234
455,5055,4265,21559575,2,3646,913,1,206401400,206401400,1366,455,911,455,0,1,457,122075,0.122075
855,5055,4265,21559575,2,6846,1713,1,236225400,236225400,2566,855,1711,855,0,1,857,77145,0.077145
1255,5055,4265,21559575,2,10046,2513,1,266049400,266049400,3766,1255,2511,1255,0,1,1257,726095,0.726095
1655,5055,4265,21559575,2,13246,3313,1,295873400,295873400,4966,1655,3311,1655,0,1,1657,868813,0.868813
2055,5055,4265,21559575,2,16446,4113,1,325697400,325697400,6166,2055,4111,2055,0,1,2057,108965,0.108965
2455,5055,4265,21559575,2,19646,4913,1,355521400,355521400,7366,2455,4911,2455,0,1,2457,22749,0.022749
2855,5055,4265,21559575,2,22846,5713,1,385345400,385345400,8566,2855,5711,2855,0,1,2857,948379,0.948379
3255,5055,4265,21559575,2,26046,6513,1,415169400,415169400,9766,3255,6511,3255,0,1,3257,493304,0.493304
3655,5055,4265,21559575,2,29246,7313,1,444993400,444993400,10966,3655,7311,3655,0,1,3657,1744010,1.74401
4055,5055,4265,21559575,2,32446,8113,1,474817400,474817400,12166,4055,8111,4055,0,1,4057,27567,0.027567
4455,5055,4265,21559575,2,35646,8913,1,504641400,504641400,13366,4455,8911,4455,0,1,4457,2242225,2.242225
4855,5055,4265,21559575,2,38846,9713,1,534465400,534465400,14566,4855,9711,4855,0,1,4857,570169,0.570169
5255,5055,4265,21559575,2,42046,10513,1,564289400,564289400,15766,5255,10511,5255,0,1,5257,429074,0.429074
5655,5055,4265,21559575,2,45246,11313,1,594113400,594113400,16966,5655,11311,5655,0,1,5657,1123513,1.123513
6055,5055,4265,21559575,2,48446,12113,1,623937400,623937400,18166,6055,12111,6055,0,1,6057,1139530,1.13953
6455,5055,4265,21559575,2,51646,12913,1,653761400,653761400,19366,6455,12911,6455,0,1,6457,1790526,1.790526
6855,5055,4265,21559575,2,54846,13713,1,683585400,683585400,20566,6855,13711,6855,0,1,6857,474726,0.474726
55,3555,6065,21561075,2,446,113,1,176721400,176721400,166,55,111,55,0,1,57,437259,0.437259
455,3555,6065,21561075,2,3646,913,1,207505400,207505400,1366,455,911,455,0,1,457,31538,0.031538
855,3555,6065,21561075,2,6846,1713,1,238289400,238289400,2566,855,1711,855,0,1,857,500396,0.500396
1255,3555,6065,21561075,2,10046,2513,1,269073400,269073400,3766,1255,2511,1255,0,1,1257,438180,0.43818
1655,3555,6065,21561075,2,13246,3313,1,299857400,299857400,4966,1655,3311,1655,0,1,1657,272026,0.272026
2055,3555,6065,21561075,2,16446,4113,1,330641400,330641400,6166,2055,4111,2055,0,1,2057,1426789,1.426789
2455,3555,6065,21561075,2,19646,4913,1,361425400,361425400,7366,2455,4911,2455,0,1,2457,998586,0.998586
2855,3555,6065,21561075,2,22846,5713,1,392209400,392209400,8566,2855,5711,2855,0,1,2857,43760,0.04376
3255,3555,6065,21561075,2,26046,6513,1,422993400,422993400,9766,3255,6511,3255,0,1,3257,1750816,1.750816
3655,3555,6065,21561075,2,29246,7313,1,453777400,453777400,10966,3655,7311,3655,0,1,3657,1360854,1.360854
4055,3555,6065,21561075,2,32446,8113,1,484561400,484561400,12166,4055,8111,4055,0,1,4057,4445820,4.44582
4455,3555,6065,21561075,2,35646,8913,1,515345400,515345400,13366,4455,8911,4455,0,1,4457,2182955,2.182955
4855,3555,6065,21561075,2,38846,9713,1,546129400,546129400,14566,4855,9711,4855,0,1,4857,1560465,1.560465
5255,3555,6065,21561075,2,42046,10513,1,576913400,576913400,15766,5255,10511,5255,0,1,5257,3591493,3.591493
5655,3555,6065,21561075,2,45246,11313,1,607697400,607697400,16966,5655,11311,5655,0,1,5657,277530,0.27753
6055,3555,6065,21561075,2,48446,12113,1,638481400,638481400,18166,6055,12111,6055,0,1,6057,2326829,2.326829
6455,3555,6065,21561075,2,51646,12913,1,669265400,669265400,19366,6455,12911,6455,0,1,6457,310645,0.310645
6855,3555,6065,21561075,2,54846,13713,1,700049400,700049400,20566,6855,13711,6855,0,1,6857,3415489,3.415489
39,3893,5541,21571113,2,318,81,1,175512312,175512312,118,39,79,39,0,1,41,396600,0.3966
539,3893,5541,21571113,2,4318,1081,1,213248312,213248312,1618,539,1079,539,0,1,541,2413608,2.413608
1039,3893,5541,21571113,2,8318,2081,1,250984312,250984312,3118,1039,2079,1039,0,1,1041,4494939,4.494939
1539,3893,5541,21571113,2,12318,3081,1,288720312,288720312,4618,1539,3079,1539,0,1,1541,3921557,3.921557
2039,3893,5541,21571113,2,16318,4081,1,326456312,326456312,6118,2039,4079,2039,0,1,2041,1513544,1.513544
2539,3893,5541,21571113,2,20318,5081,1,364192312,364192312,7618,2539,5079,2539,0,1,2541,8529913,8.529913
3039,3893,5541,21571113,2,24318,6081,1,401928312,401928312,9118,3039,6079,3039,0,1,3041,8699364,8.699364
3539,3893,5541,21571113,2,28318,7081,1,439664312,439664312,10618,3539,7079,3539,0,1,3541,542556,0.542556
4039,3893,5541,21571113,2,32318,8081,1,477400312,477400312,12118,4039,8079,4039,0,1,4041,560186,0.560186
4539,3893,5541,21571113,2,36318,9081,1,515136312,515136312,13618,4539,9079,4539,0,1,4541,220823,0.220823
5039,3893,5541,21571113,2,40318,10081,1,552872312,552872312,15118,5039,10079,5039,0,1,5041,4974227,4.974227
5539,3893,5541,21571113,2,44318,11081,1,590608312,590608312,16618,5539,11079,5539,0,1,5541,8888615,8.888615
6039,3893,5541,21571113,2,48318,12081,1,628344312,628344312,18118,6039,12079,6039,0,1,6041,14434059,14.434059
6539,3893,5541,21571113,2,52318,13081,1,666080312,666080312,19618,6539,13079,6539,0,1,6541,151357,0.151357
7039,3893,5541,21571113,2,56318,14081,1,703816312,703816312,21118,7039,14079,7039,0,1,7041,17858776,17.858776
39,6093,3541,21575313,2,318,81,1,175608312,175608312,118,39,79,39,0,1,41,14355,0.014355
539,6093,3541,21575313,2,4318,1081,1,214144312,214144312,1618,539,1079,539,0,1,541,20542,0.020542
1039,6093,3541,21575313,2,8318,2081,1,252680312,252680312,3118,1039,2079,1039,0,1,1041,518406,0.518406
1539,6093,3541,21575313,2,12318,3081,1,291216312,291216312,4618,1539,3079,1539,0,1,1541,127803,0.127803
2039,6093,3541,21575313,2,16318,4081,1,329752312,329752312,6118,2039,4079,2039,0,1,2041,1686745,1.686745
2539,6093,3541,21575313,2,20318,5081,1,368288312,368288312,7618,2539,5079,2539,0,1,2541,2254662,2.254662
3039,6093,3541,21575313,2,24318,6081,1,406824312,406824312,9118,3039,6079,3039,0,1,3041,489095,0.489095
3539,6093,3541,21575313,2,28318,7081,1,445360312,445360312,10618,3539,7079,3539,0,1,3541,2752328,2.752328
4039,6093,3541,21575313,2,32318,8081,1,483896312,483896312,12118,4039,8079,4039,0,1,4041,1474479,1.474479
4539,6093,3541,21575313,2,36318,9081,1,522432312,522432312,13618,4539,9079,4539,0,1,4541,471680,0.47168
5039,6093,3541,21575313,2,40318,10081,1,560968312,560968312,15118,5039,10079,5039,0,1,5041,3172160,3.17216
5539,6093,3541,21575313,2,44318,11081,1,599504312,599504312,16618,5539,11079,5539,0,1,5541,1957223,1.957223
6039,6093,3541,21575313,2,48318,12081,1,638040312,638040312,18118,6039,12079,6039,0,1,6041,4821476,4.821476
6539,6093,3541,21575313,2,52318,13081,1,676576312,676576312,19618,6539,13079,6539,0,1,6541,2044220,2.04422
7039,6093,3541,21575313,2,56318,14081,1,715112312,715112312,21118,7039,14079,7039,0,1,7041,284993,0.284993
35,6090,3545,21589050,2,286,73,1,175410200,175410200,106,35,71,35,0,1,37,132003,0.132003
535,6090,3545,21589050,2,4286,1073,1,213950200,213950200,1606,535,1071,535,0,1,537,1749673,1.749673
1035,6090,3545,21589050,2,8286,2073,1,252490200,252490200,3106,1035,2071,1035,0,1,1037,2797464,2.797464
1535,6090,3545,21589050,2,12286,3073,1,291030200,291030200,4606,1535,3071,1535,0,1,1537,2866953,2.866953
55,7055,3065,21623575,2,446,113,1,177441400,177441400,166,55,111,55,0,1,57,432810,0.43281
455,7055,3065,21623575,2,3646,913,1,209825400,209825400,1366,455,911,455,0,1,457,526279,0.526279
855,7055,3065,21623575,2,6846,1713,1,242209400,242209400,2566,855,1711,855,0,1,857,2787277,2.787277
1255,7055,3065,21623575,2,10046,2513,1,274593400,274593400,3766,1255,2511,1255,0,1,1257,4198332,4.198332
1655,7055,3065,21623575,2,13246,3313,1,306977400,306977400,4966,1655,3311,1655,0,1,1657,3875276,3.875276
2055,7055,3065,21623575,2,16446,4113,1,339361400,339361400,6166,2055,4111,2055,0,1,2057,3628895,3.628895
2455,7055,3065,21623575,2,19646,4913,1,371745400,371745400,7366,2455,4911,2455,0,1,2457,10382278,10.382278
2855,7055,3065,21623575,2,22846,5713,1,404129400,404129400,8566,2855,5711,2855,0,1,2857,12074147,12.074147
3255,7055,3065,21623575,2,26046,6513,1,436513400,436513400,9766,3255,6511,3255,0,1,3257,2774535,2.774535
3655,7055,3065,21623575,2,29246,7313,1,468897400,468897400,10966,3655,7311,3655,0,1,3657,4861405,4.861405
4055,7055,3065,21623575,2,32446,8113,1,501281400,501281400,12166,4055,8111,4055,0,1,4057,3639838,3.639838
4455,7055,3065,21623575,2,35646,8913,1,533665400,533665400,13366,4455,8911,4455,0,1,4457,1994276,1.994276
4855,7055,3065,21623575,2,38846,9713,1,566049400,566049400,14566,4855,9711,4855,0,1,4857,1992177,1.992177
5255,7055,3065,21623575,2,42046,10513,1,598433400,598433400,15766,5255,10511,5255,0,1,5257,4692891,4.692891
5655,7055,3065,21623575,2,45246,11313,1,630817400,630817400,16966,5655,11311,5655,0,1,5657,23787887,23.787887
6055,7055,3065,21623575,2,48446,12113,1,663201400,663201400,18166,6055,12111,6055,0,1,6057,25769602,25.769602
6455,7055,3065,21623575,2,51646,12913,1,695585400,695585400,19366,6455,12911,6455,0,1,6457,27426121,27.426121
6855,7055,3065,21623575,2,54846,13713,1,727969400,727969400,20566,6855,13711,6855,0,1,6857,29194159,29.194159
44,3903,5555,21681165,2,358,91,1,176778536,176778536,133,44,89,44,0,1,46,415253,0.415253
544,3903,5555,21681165,2,4358,1091,1,214610536,214610536,1633,544,1089,544,0,1,546,2450990,2.45099
1044,3903,5555,21681165,2,8358,2091,1,252442536,252442536,3133,1044,2089,1044,0,1,1046,4524618,4.524618
1544,3903,5555,21681165,2,12358,3091,1,290274536,290274536,4633,1544,3089,1544,0,1,1546,4679759,4.679759
2044,3903,5555,21681165,2,16358,4091,1,328106536,328106536,6133,2044,4089,2044,0,1,2046,5919109,5.919109
2544,3903,5555,21681165,2,20358,5091,1,365938536,365938536,7633,2544,5089,2544,0,1,2546,4181209,4.181209
3044,3903,5555,21681165,2,24358,6091,1,403770536,403770536,9133,3044,6089,3044,0,1,3046,1857460,1.85746
3544,3903,5555,21681165,2,28358,7091,1,441602536,441602536,10633,3544,7089,3544,0,1,3546,342137,0.342137
4044,3903,5555,21681165,2,32358,8091,1,479434536,479434536,12133,4044,8089,4044,0,1,4046,5859905,5.859905
4544,3903,5555,21681165,2,36358,9091,1,517266536,517266536,13633,4544,9089,4544,0,1,4546,519357,0.519357
5044,3903,5555,21681165,2,40358,10091,1,555098536,555098536,15133,5044,10089,5044,0,1,5046,4258402,4.258402
5544,3903,5555,21681165,2,44358,11091,1,592930536,592930536,16633,5544,11089,5544,0,1,5546,2050097,2.050097
6044,3903,5555,21681165,2,48358,12091,1,630762536,630762536,18133,6044,12089,6044,0,1,6046,11250453,11.250453
6544,3903,5555,21681165,2,52358,13091,1,668594536,668594536,19633,6544,13089,6544,0,1,6546,3058474,3.058474
7044,3903,5555,21681165,2,56358,14091,1,706426536,706426536,21133,7044,14089,7044,0,1,7046,20848011,20.848011
44,6103,3555,21696165,2,358,91,1,176968936,176968936,133,44,89,44,0,1,46,43398,0.043398
544,6103,3555,21696165,2,4358,1091,1,215600936,215600936,1633,544,1089,544,0,1,546,78943,0.078943
1044,6103,3555,21696165,2,8358,2091,1,254232936,254232936,3133,1044,2089,1044,0,1,1046,123101,0.123101
1544,6103,3555,21696165,2,12358,3091,1,292864936,292864936,4633,1544,3089,1544,0,1,1546,344844,0.344844
2044,6103,3555,21696165,2,16358,4091,1,331496936,331496936,6133,2044,4089,2044,0,1,2046,568514,0.568514
2544,6103,3555,21696165,2,20358,5091,1,370128936,370128936,7633,2544,5089,2544,0,1,2546,1579707,1.579707
3044,6103,3555,21696165,2,24358,6091,1,408760936,408760936,9133,3044,6089,3044,0,1,3046,152856,0.152856
3544,6103,3555,21696165,2,28358,7091,1,447392936,447392936,10633,3544,7089,3544,0,1,3546,1165532,1.165532
4044,6103,3555,21696165,2,32358,8091,1,486024936,486024936,12133,4044,8089,4044,0,1,4046,791371,0.791371
4544,6103,3555,21696165,2,36358,9091,1,524656936,524656936,13633,4544,9089,4544,0,1,4546,527938,0.527938
5044,6103,3555,21696165,2,40358,10091,1,563288936,563288936,15133,5044,10089,5044,0,1,5046,2751834,2.751834
5544,6103,3555,21696165,2,44358,11091,1,601920936,601920936,16633,5544,11089,5544,0,1,5546,1104486,1.104486
6044,6103,3555,21696165,2,48358,12091,1,640552936,640552936,18133,6044,12089,6044,0,1,6046,75842,0.075842
6544,6103,3555,21696165,2,52358,13091,1,679184936,679184936,19633,6544,13089,6544,0,1,6546,688213,0.688213
7044,6103,3555,21696165,2,56358,14091,1,717816936,717816936,21133,7044,14089,7044,0,1,7046,1528100,1.5281
40,4800,4540,21792000,2,326,83,1,177324800,177324800,121,40,81,40,0,1,42,392290,0.39229
440,4800,4540,21792000,2,3526,883,1,207212800,207212800,1321,440,881,440,0,1,442,1946562,1.946562
840,4800,4540,21792000,2,6726,1683,1,237100800,237100800,2521,840,1681,840,0,1,842,365933,0.365933
1240,4800,4540,21792000,2,9926,2483,1,266988800,266988800,3721,1240,2481,1240,0,1,1242,583055,0.583055
1640,4800,4540,21792000,2,13126,3283,1,296876800,296876800,4921,1640,3281,1640,0,1,1642,6737154,6.737154
2040,4800,4540,21792000,2,16326,4083,1,326764800,326764800,6121,2040,4081,2040,0,1,2042,2791114,2.791114
2440,4800,4540,21792000,2,19526,4883,1,356652800,356652800,7321,2440,4881,2440,0,1,2442,3586109,3.586109
2840,4800,4540,21792000,2,22726,5683,1,386540800,386540800,8521,2840,5681,2840,0,1,2842,2587844,2.587844
3240,4800,4540,21792000,2,25926,6483,1,416428800,416428800,9721,3240,6481,3240,0,1,3242,8350283,8.350283
3640,4800,4540,21792000,2,29126,7283,1,446316800,446316800,10921,3640,7281,3640,0,1,3642,1586411,1.586411
4040,4800,4540,21792000,2,32326,8083,1,476204800,476204800,12121,4040,8081,4040,0,1,4042,137428,0.137428
4440,4800,4540,21792000,2,35526,8883,1,506092800,506092800,13321,4440,8881,4440,0,1,4442,1342532,1.342532
4840,4800,4540,21792000,2,38726,9683,1,535980800,535980800,14521,4840,9681,4840,0,1,4842,92142,0.092142
5240,4800,4540,21792000,2,41926,10483,1,565868800,565868800,15721,5240,10481,5240,0,1,5242,1980412,1.980412
5640,4800,4540,21792000,2,45126,11283,1,595756800,595756800,16921,5640,11281,5640,0,1,5642,8688361,8.688361
6040,4800,4540,21792000,2,48326,12083,1,625644800,625644800,18121,6040,12081,6040,0,1,6042,2634309,2.634309
6440,4800,4540,21792000,2,51526,12883,1,655532800,655532800,19321,6440,12881,6440,0,1,6442,4623132,4.623132
6840,4800,4540,21792000,2,54726,13683,1,685420800,685420800,20521,6840,13681,6840,0,1,6842,8690920,8.69092
40,3800,5740,21812000,2,326,83,1,177548800,177548800,121,40,81,40,0,1,42,392584,0.392584
440,3800,5740,21812000,2,3526,883,1,208076800,208076800,1321,440,881,440,0,1,442,2017518,2.017518
840,3800,5740,21812000,2,6726,1683,1,238604800,238604800,2521,840,1681,840,0,1,842,3676628,3.676628
1240,3800,5740,21812000,2,9926,2483,1,269132800,269132800,3721,1240,2481,1240,0,1,1242,3676555,3.676555
1640,3800,5740,21812000,2,13126,3283,1,299660800,299660800,4921,1640,3281,1640,0,1,1642,2194423,2.194423
2040,3800,5740,21812000,2,16326,4083,1,330188800,330188800,6121,2040,4081,2040,0,1,2042,2630471,2.630471
2440,3800,5740,21812000,2,19526,4883,1,360716800,360716800,7321,2440,4881,2440,0,1,2442,6428821,6.428821
2840,3800,5740,21812000,2,22726,5683,1,391244800,391244800,8521,2840,5681,2840,0,1,2842,559628,0.559628
3240,3800,5740,21812000,2,25926,6483,1,421772800,421772800,9721,3240,6481,3240,0,1,3242,2763615,2.763615
3640,3800,5740,21812000,2,29126,7283,1,452300800,452300800,10921,3640,7281,3640,0,1,3642,2594329,2.594329
4040,3800,5740,21812000,2,32326,8083,1,482828800,482828800,12121,4040,8081,4040,0,1,4042,1263626,1.263626
4440,3800,5740,21812000,2,35526,8883,1,513356800,513356800,13321,4440,8881,4440,0,1,4442,328847,0.328847
4840,3800,5740,21812000,2,38726,9683,1,543884800,543884800,14521,4840,9681,4840,0,1,4842,5195213,5.195213
5240,3800,5740,21812000,2,41926,10483,1,574412800,574412800,15721,5240,10481,5240,0,1,5242,4731266,4.731266
5640,3800,5740,21812000,2,45126,11283,1,604940800,604940800,16921,5640,11281,5640,0,1,5642,9028331,9.028331
6040,3800,5740,21812000,2,48326,12083,1,635468800,635468800,18121,6040,12081,6040,0,1,6042,1654100,1.6541
6440,3800,5740,21812000,2,51526,12883,1,665996800,665996800,19321,6440,12881,6440,0,1,6442,2018318,2.018318
6840,3800,5740,21812000,2,54726,13683,1,696524800,696524800,20521,6840,13681,6840,0,1,6842,945077,0.945077
35,3340,6545,21860300,2,286,73,1,177650200,177650200,106,35,71,35,0,1,37,385261,0.385261
535,3340,6545,21860300,2,4286,1073,1,217190200,217190200,1606,535,1071,535,0,1,537,2349265,2.349265
1035,3340,6545,21860300,2,8286,2073,1,256730200,256730200,3106,1035,2071,1035,0,1,1037,4378709,4.378709
1535,3340,6545,21860300,2,12286,3073,1,296270200,296270200,4606,1535,3071,1535,0,1,1537,6419213,6.419213
2035,3340,6545,21860300,2,16286,4073,1,335810200,335810200,6106,2035,4071,2035,0,1,2037,8445319,8.445319
39,3343,6541,21866563,2,318,81,1,178016312,178016312,118,39,79,39,0,1,41,40729,0.040729
539,3343,6541,21866563,2,4318,1081,1,217552312,217552312,1618,539,1079,539,0,1,541,117585,0.117585
1039,3343,6541,21866563,2,8318,2081,1,257088312,257088312,3118,1039,2079,1039,0,1,1041,41967,0.041967
1539,3343,6541,21866563,2,12318,3081,1,296624312,296624312,4618,1539,3079,1539,0,1,1541,18131,0.018131
2039,3343,6541,21866563,2,16318,4081,1,336160312,336160312,6118,2039,4079,2039,0,1,2041,358521,0.358521
2539,3343,6541,21866563,2,20318,5081,1,375696312,375696312,7618,2539,5079,2539,0,1,2541,1522588,1.522588
3039,3343,6541,21866563,2,24318,6081,1,415232312,415232312,9118,3039,6079,3039,0,1,3041,1538432,1.538432
3539,3343,6541,21866563,2,28318,7081,1,454768312,454768312,10618,3539,7079,3539,0,1,3541,98083,0.098083
4039,3343,6541,21866563,2,32318,8081,1,494304312,494304312,12118,4039,8079,4039,0,1,4041,516726,0.516726
4539,3343,6541,21866563,2,36318,9081,1,533840312,533840312,13618,4539,9079,4539,0,1,4541,566819,0.566819
5039,3343,6541,21866563,2,40318,10081,1,573376312,573376312,15118,5039,10079,5039,0,1,5041,734808,0.734808
5539,3343,6541,21866563,2,44318,11081,1,612912312,612912312,16618,5539,11079,5539,0,1,5541,1230574,1.230574
6039,3343,6541,21866563,2,48318,12081,1,652448312,652448312,18118,6039,12079,6039,0,1,6041,1286325,1.286325
6539,3343,6541,21866563,2,52318,13081,1,691984312,691984312,19618,6539,13079,6539,0,1,6541,4643961,4.643961
7039,3343,6541,21866563,2,56318,14081,1,731520312,731520312,21118,7039,14079,7039,0,1,7041,1169463,1.169463
40,5550,3940,21867000,2,326,83,1,177972800,177972800,121,40,81,40,0,1,42,401175,0.401175
440,5550,3940,21867000,2,3526,883,1,208340800,208340800,1321,440,881,440,0,1,442,2013277,2.013277
840,5550,3940,21867000,2,6726,1683,1,238708800,238708800,2521,840,1681,840,0,1,842,3676007,3.676007
1240,5550,3940,21867000,2,9926,2483,1,269076800,269076800,3721,1240,2481,1240,0,1,1242,733187,0.733187
1640,5550,3940,21867000,2,13126,3283,1,299444800,299444800,4921,1640,3281,1640,0,1,1642,2233162,2.233162
2040,5550,3940,21867000,2,16326,4083,1,329812800,329812800,6121,2040,4081,2040,0,1,2042,4955154,4.955154
2440,5550,3940,21867000,2,19526,4883,1,360180800,360180800,7321,2440,4881,2440,0,1,2442,237193,0.237193
2840,5550,3940,21867000,2,22726,5683,1,390548800,390548800,8521,2840,5681,2840,0,1,2842,4194053,4.194053
3240,5550,3940,21867000,2,25926,6483,1,420916800,420916800,9721,3240,6481,3240,0,1,3242,1013966,1.013966
3640,5550,3940,21867000,2,29126,7283,1,451284800,451284800,10921,3640,7281,3640,0,1,3642,1367767,1.367767
4040,5550,3940,21867000,2,32326,8083,1,481652800,481652800,12121,4040,8081,4040,0,1,4042,2226605,2.226605
4440,5550,3940,21867000,2,35526,8883,1,512020800,512020800,13321,4440,8881,4440,0,1,4442,1302382,1.302382
4840,5550,3940,21867000,2,38726,9683,1,542388800,542388800,14521,4840,9681,4840,0,1,4842,1220713,1.220713
5240,5550,3940,21867000,2,41926,10483,1,572756800,572756800,15721,5240,10481,5240,0,1,5242,1741234,1.741234
5640,5550,3940,21867000,2,45126,11283,1,603124800,603124800,16921,5640,11281,5640,0,1,5642,3084320,3.08432
6040,5550,3940,21867000,2,48326,12083,1,633492800,633492800,18121,6040,12081,6040,0,1,6042,5157703,5.157703
6440,5550,3940,21867000,2,51526,12883,1,663860800,663860800,19321,6440,12881,6440,0,1,6442,9870737,9.870737
6840,5550,3940,21867000,2,54726,13683,1,694228800,694228800,20521,6840,13681,6840,0,1,6842,17903136,17.903136
40,6550,3340,21877000,2,326,83,1,178180800,178180800,121,40,81,40,0,1,42,24421,0.024421
440,6550,3340,21877000,2,3526,883,1,209828800,209828800,1321,440,881,440,0,1,442,169155,0.169155
840,6550,3340,21877000,2,6726,1683,1,241476800,241476800,2521,840,1681,840,0,1,842,95727,0.095727
1240,6550,3340,21877000,2,9926,2483,1,273124800,273124800,3721,1240,2481,1240,0,1,1242,19108,0.019108
1640,6550,3340,21877000,2,13126,3283,1,304772800,304772800,4921,1640,3281,1640,0,1,1642,202757,0.202757
2040,6550,3340,21877000,2,16326,4083,1,336420800,336420800,6121,2040,4081,2040,0,1,2042,187354,0.187354
2440,6550,3340,21877000,2,19526,4883,1,368068800,368068800,7321,2440,4881,2440,0,1,2442,123291,0.123291
2840,6550,3340,21877000,2,22726,5683,1,399716800,399716800,8521,2840,5681,2840,0,1,2842,816735,0.816735
3240,6550,3340,21877000,2,25926,6483,1,431364800,431364800,9721,3240,6481,3240,0,1,3242,773919,0.773919
3640,6550,3340,21877000,2,29126,7283,1,463012800,463012800,10921,3640,7281,3640,0,1,3642,2263493,2.263493
4040,6550,3340,21877000,2,32326,8083,1,494660800,494660800,12121,4040,8081,4040,0,1,4042,1870193,1.870193
4440,6550,3340,21877000,2,35526,8883,1,526308800,526308800,13321,4440,8881,4440,0,1,4442,120479,0.120479
4840,6550,3340,21877000,2,38726,9683,1,557956800,557956800,14521,4840,9681,4840,0,1,4842,1370614,1.370614
5240,6550,3340,21877000,2,41926,10483,1,589604800,589604800,15721,5240,10481,5240,0,1,5242,1283500,1.2835
5640,6550,3340,21877000,2,45126,11283,1,621252800,621252800,16921,5640,11281,5640,0,1,5642,677601,0.677601
6040,6550,3340,21877000,2,48326,12083,1,652900800,652900800,18121,6040,12081,6040,0,1,6042,285311,0.285311
6440,6550,3340,21877000,2,51526,12883,1,684548800,684548800,19321,6440,12881,6440,0,1,6442,2831964,2.831964
6840,6550,3340,21877000,2,54726,13683,1,716196800,716196800,20521,6840,13681,6840,0,1,6842,3011683,3.011683
40,3300,6640,21912000,2,326,83,1,178476800,178476800,121,40,81,40,0,1,42,393189,0.393189
440,3300,6640,21912000,2,3526,883,1,210284800,210284800,1321,440,881,440,0,1,442,178751,0.178751
840,3300,6640,21912000,2,6726,1683,1,242092800,242092800,2521,840,1681,840,0,1,842,386831,0.386831
1240,3300,6640,21912000,2,9926,2483,1,273900800,273900800,3721,1240,2481,1240,0,1,1242,438518,0.438518
1640,3300,6640,21912000,2,13126,3283,1,305708800,305708800,4921,1640,3281,1640,0,1,1642,3417273,3.417273
2040,3300,6640,21912000,2,16326,4083,1,337516800,337516800,6121,2040,4081,2040,0,1,2042,771073,0.771073
2440,3300,6640,21912000,2,19526,4883,1,369324800,369324800,7321,2440,4881,2440,0,1,2442,110676,0.110676
2840,3300,6640,21912000,2,22726,5683,1,401132800,401132800,8521,2840,5681,2840,0,1,2842,6945617,6.945617
3240,3300,6640,21912000,2,25926,6483,1,432940800,432940800,9721,3240,6481,3240,0,1,3242,2967478,2.967478
3640,3300,6640,21912000,2,29126,7283,1,464748800,464748800,10921,3640,7281,3640,0,1,3642,103571,0.103571
4040,3300,6640,21912000,2,32326,8083,1,496556800,496556800,12121,4040,8081,4040,0,1,4042,2789746,2.789746
4440,3300,6640,21912000,2,35526,8883,1,528364800,528364800,13321,4440,8881,4440,0,1,4442,1259790,1.25979
4840,3300,6640,21912000,2,38726,9683,1,560172800,560172800,14521,4840,9681,4840,0,1,4842,871114,0.871114
5240,3300,6640,21912000,2,41926,10483,1,591980800,591980800,15721,5240,10481,5240,0,1,5242,1320460,1.32046
5640,3300,6640,21912000,2,45126,11283,1,623788800,623788800,16921,5640,11281,5640,0,1,5642,4118744,4.118744
6040,3300,6640,21912000,2,48326,12083,1,655596800,655596800,18121,6040,12081,6040,0,1,6042,147631,0.147631
6440,3300,6640,21912000,2,51526,12883,1,687404800,687404800,19321,6440,12881,6440,0,1,6442,3582792,3.582792
6840,3300,6640,21912000,2,54726,13683,1,719212800,719212800,20521,6840,13681,6840,0,1,6842,6857328,6.857328
55,4805,4565,21934825,2,446,113,1,179601400,179601400,166,55,111,55,0,1,57,446291,0.446291
455,4805,4565,21934825,2,3646,913,1,209585400,209585400,1366,455,911,455,0,1,457,2031176,2.031176
855,4805,4565,21934825,2,6846,1713,1,239569400,239569400,2566,855,1711,855,0,1,857,2232038,2.232038
1255,4805,4565,21934825,2,10046,2513,1,269553400,269553400,3766,1255,2511,1255,0,1,1257,2682712,2.682712
1655,4805,4565,21934825,2,13246,3313,1,299537400,299537400,4966,1655,3311,1655,0,1,1657,4843404,4.843404
2055,4805,4565,21934825,2,16446,4113,1,329521400,329521400,6166,2055,4111,2055,0,1,2057,467851,0.467851
2455,4805,4565,21934825,2,19646,4913,1,359505400,359505400,7366,2455,4911,2455,0,1,2457,364169,0.364169
2855,4805,4565,21934825,2,22846,5713,1,389489400,389489400,8566,2855,5711,2855,0,1,2857,11123707,11.123707
3255,4805,4565,21934825,2,26046,6513,1,419473400,419473400,9766,3255,6511,3255,0,1,3257,2855662,2.855662
3655,4805,4565,21934825,2,29246,7313,1,449457400,449457400,10966,3655,7311,3655,0,1,3657,4111040,4.11104
4055,4805,4565,21934825,2,32446,8113,1,479441400,479441400,12166,4055,8111,4055,0,1,4057,3238473,3.238473
4455,4805,4565,21934825,2,35646,8913,1,509425400,509425400,13366,4455,8911,4455,0,1,4457,6802161,6.802161
4855,4805,4565,21934825,2,38846,9713,1,539409400,539409400,14566,4855,9711,4855,0,1,4857,5664954,5.664954
5255,4805,4565,21934825,2,42046,10513,1,569393400,569393400,15766,5255,10511,5255,0,1,5257,7849430,7.84943
5655,4805,4565,21934825,2,45246,11313,1,599377400,599377400,16966,5655,11311,5655,0,1,5657,10926583,10.926583
6055,4805,4565,21934825,2,48446,12113,1,629361400,629361400,18166,6055,12111,6055,0,1,6057,268385,0.268385
6455,4805,4565,21934825,2,51646,12913,1,659345400,659345400,19366,6455,12911,6455,0,1,6457,26421226,26.421226
6855,4805,4565,21934825,2,54846,13713,1,689329400,689329400,20566,6855,13711,6855,0,1,6857,19285490,19.28549
55,3805,5765,21935825,2,446,113,1,179697400,179697400,166,55,111,55,0,1,57,479432,0.479432
455,3805,5765,21935825,2,3646,913,1,210321400,210321400,1366,455,911,455,0,1,457,2118991,2.118991
855,3805,5765,21935825,2,6846,1713,1,240945400,240945400,2566,855,1711,855,0,1,857,3707375,3.707375
1255,3805,5765,21935825,2,10046,2513,1,271569400,271569400,3766,1255,2511,1255,0,1,1257,2378750,2.37875
1655,3805,5765,21935825,2,13246,3313,1,302193400,302193400,4966,1655,3311,1655,0,1,1657,1276803,1.276803
2055,3805,5765,21935825,2,16446,4113,1,332817400,332817400,6166,2055,4111,2055,0,1,2057,1199125,1.199125
2455,3805,5765,21935825,2,19646,4913,1,363441400,363441400,7366,2455,4911,2455,0,1,2457,87470,0.08747
2855,3805,5765,21935825,2,22846,5713,1,394065400,394065400,8566,2855,5711,2855,0,1,2857,1008946,1.008946
3255,3805,5765,21935825,2,26046,6513,1,424689400,424689400,9766,3255,6511,3255,0,1,3257,7493495,7.493495
3655,3805,5765,21935825,2,29246,7313,1,455313400,455313400,10966,3655,7311,3655,0,1,3657,9105045,9.105045
4055,3805,5765,21935825,2,32446,8113,1,485937400,485937400,12166,4055,8111,4055,0,1,4057,2594122,2.594122
4455,3805,5765,21935825,2,35646,8913,1,516561400,516561400,13366,4455,8911,4455,0,1,4457,10257375,10.257375
4855,3805,5765,21935825,2,38846,9713,1,547185400,547185400,14566,4855,9711,4855,0,1,4857,3545374,3.545374
5255,3805,5765,21935825,2,42046,10513,1,577809400,577809400,15766,5255,10511,5255,0,1,5257,70072,0.070072
5655,3805,5765,21935825,2,45246,11313,1,608433400,608433400,16966,5655,11311,5655,0,1,5657,8916027,8.916027
6055,3805,5765,21935825,2,48446,12113,1,639057400,639057400,18166,6055,12111,6055,0,1,6057,2030928,2.030928
6455,3805,5765,21935825,2,51646,12913,1,669681400,669681400,19366,6455,12911,6455,0,1,6457,533460,0.53346
6855,3805,5765,21935825,2,54846,13713,1,700305400,700305400,20566,6855,13711,6855,0,1,6857,3252385,3.252385
44,3353,6555,21978915,2,358,91,1,179318936,179318936,133,44,89,44,0,1,46,68467,0.068467
544,3353,6555,21978915,2,4358,1091,1,218950936,218950936,1633,544,1089,544,0,1,546,139993,0.139993
1044,3353,6555,21978915,2,8358,2091,1,258582936,258582936,3133,1044,2089,1044,0,1,1046,103338,0.103338
1544,3353,6555,21978915,2,12358,3091,1,298214936,298214936,4633,1544,3089,1544,0,1,1546,763258,0.763258
2044,3353,6555,21978915,2,16358,4091,1,337846936,337846936,6133,2044,4089,2044,0,1,2046,848531,0.848531
2544,3353,6555,21978915,2,20358,5091,1,377478936,377478936,7633,2544,5089,2544,0,1,2546,121545,0.121545
3044,3353,6555,21978915,2,24358,6091,1,417110936,417110936,9133,3044,6089,3044,0,1,3046,1058149,1.058149
3544,3353,6555,21978915,2,28358,7091,1,456742936,456742936,10633,3544,7089,3544,0,1,3546,1956187,1.956187
4044,3353,6555,21978915,2,32358,8091,1,496374936,496374936,12133,4044,8089,4044,0,1,4046,540973,0.540973
4544,3353,6555,21978915,2,36358,9091,1,536006936,536006936,13633,4544,9089,4544,0,1,4546,293330,0.29333
5044,3353,6555,21978915,2,40358,10091,1,575638936,575638936,15133,5044,10089,5044,0,1,5046,3263123,3.263123
5544,3353,6555,21978915,2,44358,11091,1,615270936,615270936,16633,5544,11089,5544,0,1,5546,958899,0.958899
6044,3353,6555,21978915,2,48358,12091,1,654902936,654902936,18133,6044,12089,6044,0,1,6046,947906,0.947906
6544,3353,6555,21978915,2,52358,13091,1,694534936,694534936,19633,6544,13089,6544,0,1,6546,7502673,7.502673
7044,3353,6555,21978915,2,56358,14091,1,734166936,734166936,21133,7044,14089,7044,0,1,7046,2800450,2.80045
40,6050,3640,22022000,2,326,83,1,179276800,179276800,121,40,81,40,0,1,42,390031,0.390031
440,6050,3640,22022000,2,3526,883,1,210284800,210284800,1321,440,881,440,0,1,442,1951449,1.951449
840,6050,3640,22022000,2,6726,1683,1,241292800,241292800,2521,840,1681,840,0,1,842,1035963,1.035963
1240,6050,3640,22022000,2,9926,2483,1,272300800,272300800,3721,1240,2481,1240,0,1,1242,5010563,5.010563
1640,6050,3640,22022000,2,13126,3283,1,303308800,303308800,4921,1640,3281,1640,0,1,1642,4766311,4.766311
2040,6050,3640,22022000,2,16326,4083,1,334316800,334316800,6121,2040,4081,2040,0,1,2042,681260,0.68126
2440,6050,3640,22022000,2,19526,4883,1,365324800,365324800,7321,2440,4881,2440,0,1,2442,3128669,3.128669
2840,6050,3640,22022000,2,22726,5683,1,396332800,396332800,8521,2840,5681,2840,0,1,2842,74018,0.074018
3240,6050,3640,22022000,2,25926,6483,1,427340800,427340800,9721,3240,6481,3240,0,1,3242,935102,0.935102
3640,6050,3640,22022000,2,29126,7283,1,458348800,458348800,10921,3640,7281,3640,0,1,3642,1156852,1.156852
4040,6050,3640,22022000,2,32326,8083,1,489356800,489356800,12121,4040,8081,4040,0,1,4042,3790329,3.790329
4440,6050,3640,22022000,2,35526,8883,1,520364800,520364800,13321,4440,8881,4440,0,1,4442,2339144,2.339144
40,4550,4840,22022000,2,326,83,1,179180800,179180800,121,40,81,40,0,1,42,399849,0.399849
440,4550,4840,22022000,2,3526,883,1,209228800,209228800,1321,440,881,440,0,1,442,1963815,1.963815
840,4550,4840,22022000,2,6726,1683,1,239276800,239276800,2521,840,1681,840,0,1,842,2955491,2.955491
1240,4550,4840,22022000,2,9926,2483,1,269324800,269324800,3721,1240,2481,1240,0,1,1242,1219919,1.219919
4840,6050,3640,22022000,2,38726,9683,1,551372800,551372800,14521,4840,9681,4840,0,1,4842,456145,0.456145
1640,4550,4840,22022000,2,13126,3283,1,299372800,299372800,4921,1640,3281,1640,0,1,1642,686248,0.686248
2040,4550,4840,22022000,2,16326,4083,1,329420800,329420800,6121,2040,4081,2040,0,1,2042,22208,0.022208
2440,4550,4840,22022000,2,19526,4883,1,359468800,359468800,7321,2440,4881,2440,0,1,2442,730904,0.730904
5240,6050,3640,22022000,2,41926,10483,1,582380800,582380800,15721,5240,10481,5240,0,1,5242,639270,0.63927
2840,4550,4840,22022000,2,22726,5683,1,389516800,389516800,8521,2840,5681,2840,0,1,2842,3294270,3.29427
3240,4550,4840,22022000,2,25926,6483,1,419564800,419564800,9721,3240,6481,3240,0,1,3242,140253,0.140253
5640,6050,3640,22022000,2,45126,11283,1,613388800,613388800,16921,5640,11281,5640,0,1,5642,2542519,2.542519
3640,4550,4840,22022000,2,29126,7283,1,449612800,449612800,10921,3640,7281,3640,0,1,3642,321563,0.321563
4040,4550,4840,22022000,2,32326,8083,1,479660800,479660800,12121,4040,8081,4040,0,1,4042,4987092,4.987092
6040,6050,3640,22022000,2,48326,12083,1,644396800,644396800,18121,6040,12081,6040,0,1,6042,3380456,3.380456
4440,4550,4840,22022000,2,35526,8883,1,509708800,509708800,13321,4440,8881,4440,0,1,4442,1714029,1.714029
4840,4550,4840,22022000,2,38726,9683,1,539756800,539756800,14521,4840,9681,4840,0,1,4842,2309150,2.30915
6440,6050,3640,22022000,2,51526,12883,1,675404800,675404800,19321,6440,12881,6440,0,1,6442,351525,0.351525
5240,4550,4840,22022000,2,41926,10483,1,569804800,569804800,15721,5240,10481,5240,0,1,5242,2235338,2.235338
5640,4550,4840,22022000,2,45126,11283,1,599852800,599852800,16921,5640,11281,5640,0,1,5642,1943607,1.943607
6840,6050,3640,22022000,2,54726,13683,1,706412800,706412800,20521,6840,13681,6840,0,1,6842,200452,0.200452
6040,4550,4840,22022000,2,48326,12083,1,629900800,629900800,18121,6040,12081,6040,0,1,6042,2768523,2.768523
6440,4550,4840,22022000,2,51526,12883,1,659948800,659948800,19321,6440,12881,6440,0,1,6442,4242281,4.242281
6840,4550,4840,22022000,2,54726,13683,1,689996800,689996800,20521,6840,13681,6840,0,1,6842,1900108,1.900108
55,5555,3965,22025575,2,446,113,1,180393400,180393400,166,55,111,55,0,1,57,453653,0.453653
455,5555,3965,22025575,2,3646,913,1,210857400,210857400,1366,455,911,455,0,1,457,646191,0.646191
855,5555,3965,22025575,2,6846,1713,1,241321400,241321400,2566,855,1711,855,0,1,857,1347035,1.347035
1255,5555,3965,22025575,2,10046,2513,1,271785400,271785400,3766,1255,2511,1255,0,1,1257,1232161,1.232161
1655,5555,3965,22025575,2,13246,3313,1,302249400,302249400,4966,1655,3311,1655,0,1,1657,185591,0.185591
2055,5555,3965,22025575,2,16446,4113,1,332713400,332713400,6166,2055,4111,2055,0,1,2057,5185066,5.185066
2455,5555,3965,22025575,2,19646,4913,1,363177400,363177400,7366,2455,4911,2455,0,1,2457,2090427,2.090427
2855,5555,3965,22025575,2,22846,5713,1,393641400,393641400,8566,2855,5711,2855,0,1,2857,5507204,5.507204
3255,5555,3965,22025575,2,26046,6513,1,424105400,424105400,9766,3255,6511,3255,0,1,3257,296584,0.296584
3655,5555,3965,22025575,2,29246,7313,1,454569400,454569400,10966,3655,7311,3655,0,1,3657,1692167,1.692167
4055,5555,3965,22025575,2,32446,8113,1,485033400,485033400,12166,4055,8111,4055,0,1,4057,9648515,9.648515
4455,5555,3965,22025575,2,35646,8913,1,515497400,515497400,13366,4455,8911,4455,0,1,4457,2916586,2.916586
4855,5555,3965,22025575,2,38846,9713,1,545961400,545961400,14566,4855,9711,4855,0,1,4857,1443875,1.443875
5255,5555,3965,22025575,2,42046,10513,1,576425400,576425400,15766,5255,10511,5255,0,1,5257,2110390,2.11039
5655,5555,3965,22025575,2,45246,11313,1,606889400,606889400,16966,5655,11311,5655,0,1,5657,2815446,2.815446
6055,5555,3965,22025575,2,48446,12113,1,637353400,637353400,18166,6055,12111,6055,0,1,6057,237928,0.237928
6455,5555,3965,22025575,2,51646,12913,1,667817400,667817400,19366,6455,12911,6455,0,1,6457,5715730,5.71573
6855,5555,3965,22025575,2,54846,13713,1,698281400,698281400,20566,6855,13711,6855,0,1,6857,2769752,2.769752
55,3305,6665,22027825,2,446,113,1,180609400,180609400,166,55,111,55,0,1,57,450491,0.450491
455,3305,6665,22027825,2,3646,913,1,212513400,212513400,1366,455,911,455,0,1,457,544888,0.544888
855,3305,6665,22027825,2,6846,1713,1,244417400,244417400,2566,855,1711,855,0,1,857,1546424,1.546424
1255,3305,6665,22027825,2,10046,2513,1,276321400,276321400,3766,1255,2511,1255,0,1,1257,22002,0.022002
1655,3305,6665,22027825,2,13246,3313,1,308225400,308225400,4966,1655,3311,1655,0,1,1657,2325673,2.325673
2055,3305,6665,22027825,2,16446,4113,1,340129400,340129400,6166,2055,4111,2055,0,1,2057,1507793,1.507793
2455,3305,6665,22027825,2,19646,4913,1,372033400,372033400,7366,2455,4911,2455,0,1,2457,1204886,1.204886
2855,3305,6665,22027825,2,22846,5713,1,403937400,403937400,8566,2855,5711,2855,0,1,2857,3994302,3.994302
3255,3305,6665,22027825,2,26046,6513,1,435841400,435841400,9766,3255,6511,3255,0,1,3257,2155182,2.155182
3655,3305,6665,22027825,2,29246,7313,1,467745400,467745400,10966,3655,7311,3655,0,1,3657,508454,0.508454
4055,3305,6665,22027825,2,32446,8113,1,499649400,499649400,12166,4055,8111,4055,0,1,4057,1012359,1.012359
4455,3305,6665,22027825,2,35646,8913,1,531553400,531553400,13366,4455,8911,4455,0,1,4457,3115236,3.115236
4855,3305,6665,22027825,2,38846,9713,1,563457400,563457400,14566,4855,9711,4855,0,1,4857,338803,0.338803
5255,3305,6665,22027825,2,42046,10513,1,595361400,595361400,15766,5255,10511,5255,0,1,5257,1257670,1.25767
5655,3305,6665,22027825,2,45246,11313,1,627265400,627265400,16966,5655,11311,5655,0,1,5657,1298308,1.298308
6055,3305,6665,22027825,2,48446,12113,1,659169400,659169400,18166,6055,12111,6055,0,1,6057,431058,0.431058
6455,3305,6665,22027825,2,51646,12913,1,691073400,691073400,19366,6455,12911,6455,0,1,6457,2889147,2.889147
6855,3305,6665,22027825,2,54846,13713,1,722977400,722977400,20566,6855,13711,6855,0,1,6857,5398134,5.398134
40,4050,5440,22032000,2,326,83,1,179292800,179292800,121,40,81,40,0,1,42,14063,0.014063
440,4050,5440,22032000,2,3526,883,1,209660800,209660800,1321,440,881,440,0,1,442,21647,0.021647
840,4050,5440,22032000,2,6726,1683,1,240028800,240028800,2521,840,1681,840,0,1,842,167631,0.167631
1240,4050,5440,22032000,2,9926,2483,1,270396800,270396800,3721,1240,2481,1240,0,1,1242,275063,0.275063
1640,4050,5440,22032000,2,13126,3283,1,300764800,300764800,4921,1640,3281,1640,0,1,1642,153356,0.153356
2040,4050,5440,22032000,2,16326,4083,1,331132800,331132800,6121,2040,4081,2040,0,1,2042,149031,0.149031
2440,4050,5440,22032000,2,19526,4883,1,361500800,361500800,7321,2440,4881,2440,0,1,2442,396761,0.396761
2840,4050,5440,22032000,2,22726,5683,1,391868800,391868800,8521,2840,5681,2840,0,1,2842,398892,0.398892
3240,4050,5440,22032000,2,25926,6483,1,422236800,422236800,9721,3240,6481,3240,0,1,3242,514830,0.51483
3640,4050,5440,22032000,2,29126,7283,1,452604800,452604800,10921,3640,7281,3640,0,1,3642,712515,0.712515
4040,4050,5440,22032000,2,32326,8083,1,482972800,482972800,12121,4040,8081,4040,0,1,4042,909129,0.909129
4440,4050,5440,22032000,2,35526,8883,1,513340800,513340800,13321,4440,8881,4440,0,1,4442,1064538,1.064538
4840,4050,5440,22032000,2,38726,9683,1,543708800,543708800,14521,4840,9681,4840,0,1,4842,368912,0.368912
5240,4050,5440,22032000,2,41926,10483,1,574076800,574076800,15721,5240,10481,5240,0,1,5242,56768,0.056768
5640,4050,5440,22032000,2,45126,11283,1,604444800,604444800,16921,5640,11281,5640,0,1,5642,991120,0.99112
6040,4050,5440,22032000,2,48326,12083,1,634812800,634812800,18121,6040,12081,6040,0,1,6042,296628,0.296628
6440,4050,5440,22032000,2,51526,12883,1,665180800,665180800,19321,6440,12881,6440,0,1,6442,44407,0.044407
6840,4050,5440,22032000,2,54726,13683,1,695548800,695548800,20521,6840,13681,6840,0,1,6842,5611800,5.6118
55,6555,3365,22057575,2,446,113,1,180825400,180825400,166,55,111,55,0,1,57,43985,0.043985
455,6555,3365,22057575,2,3646,913,1,212569400,212569400,1366,455,911,455,0,1,457,27266,0.027266
855,6555,3365,22057575,2,6846,1713,1,244313400,244313400,2566,855,1711,855,0,1,857,76163,0.076163
1255,6555,3365,22057575,2,10046,2513,1,276057400,276057400,3766,1255,2511,1255,0,1,1257,349396,0.349396
1655,6555,3365,22057575,2,13246,3313,1,307801400,307801400,4966,1655,3311,1655,0,1,1657,798153,0.798153
2055,6555,3365,22057575,2,16446,4113,1,339545400,339545400,6166,2055,4111,2055,0,1,2057,48728,0.048728
2455,6555,3365,22057575,2,19646,4913,1,371289400,371289400,7366,2455,4911,2455,0,1,2457,1650096,1.650096
2855,6555,3365,22057575,2,22846,5713,1,403033400,403033400,8566,2855,5711,2855,0,1,2857,506663,0.506663
3255,6555,3365,22057575,2,26046,6513,1,434777400,434777400,9766,3255,6511,3255,0,1,3257,652287,0.652287
3655,6555,3365,22057575,2,29246,7313,1,466521400,466521400,10966,3655,7311,3655,0,1,3657,505219,0.505219
4055,6555,3365,22057575,2,32446,8113,1,498265400,498265400,12166,4055,8111,4055,0,1,4057,25783,0.025783
4455,6555,3365,22057575,2,35646,8913,1,530009400,530009400,13366,4455,8911,4455,0,1,4457,2154798,2.154798
4855,6555,3365,22057575,2,38846,9713,1,561753400,561753400,14566,4855,9711,4855,0,1,4857,253735,0.253735
5255,6555,3365,22057575,2,42046,10513,1,593497400,593497400,15766,5255,10511,5255,0,1,5257,76837,0.076837
5655,6555,3365,22057575,2,45246,11313,1,625241400,625241400,16966,5655,11311,5655,0,1,5657,174266,0.174266
6055,6555,3365,22057575,2,48446,12113,1,656985400,656985400,18166,6055,12111,6055,0,1,6057,173103,0.173103
6455,6555,3365,22057575,2,51646,12913,1,688729400,688729400,19366,6455,12911,6455,0,1,6457,1435377,1.435377
6855,6555,3365,22057575,2,54846,13713,1,720473400,720473400,20566,6855,13711,6855,0,1,6857,1126409,1.126409
40,4300,5140,22102000,2,326,83,1,179836800,179836800,121,40,81,40,0,1,42,406511,0.406511
440,4300,5140,22102000,2,3526,883,1,210044800,210044800,1321,440,881,440,0,1,442,685913,0.685913
840,4300,5140,22102000,2,6726,1683,1,240252800,240252800,2521,840,1681,840,0,1,842,1864906,1.864906
1240,4300,5140,22102000,2,9926,2483,1,270460800,270460800,3721,1240,2481,1240,0,1,1242,2455168,2.455168
1640,4300,5140,22102000,2,13126,3283,1,300668800,300668800,4921,1640,3281,1640,0,1,1642,3054244,3.054244
2040,4300,5140,22102000,2,16326,4083,1,330876800,330876800,6121,2040,4081,2040,0,1,2042,301173,0.301173
2440,4300,5140,22102000,2,19526,4883,1,361084800,361084800,7321,2440,4881,2440,0,1,2442,415512,0.415512
2840,4300,5140,22102000,2,22726,5683,1,391292800,391292800,8521,2840,5681,2840,0,1,2842,615648,0.615648
3240,4300,5140,22102000,2,25926,6483,1,421500800,421500800,9721,3240,6481,3240,0,1,3242,2105018,2.105018
3640,4300,5140,22102000,2,29126,7283,1,451708800,451708800,10921,3640,7281,3640,0,1,3642,2483541,2.483541
4040,4300,5140,22102000,2,32326,8083,1,481916800,481916800,12121,4040,8081,4040,0,1,4042,5305676,5.305676
4440,4300,5140,22102000,2,35526,8883,1,512124800,512124800,13321,4440,8881,4440,0,1,4442,2488146,2.488146
4840,4300,5140,22102000,2,38726,9683,1,542332800,542332800,14521,4840,9681,4840,0,1,4842,433799,0.433799
5240,4300,5140,22102000,2,41926,10483,1,572540800,572540800,15721,5240,10481,5240,0,1,5242,4738766,4.738766
5640,4300,5140,22102000,2,45126,11283,1,602748800,602748800,16921,5640,11281,5640,0,1,5642,2338076,2.338076
6040,4300,5140,22102000,2,48326,12083,1,632956800,632956800,18121,6040,12081,6040,0,1,6042,1233094,1.233094
6440,4300,5140,22102000,2,51526,12883,1,663164800,663164800,19321,6440,12881,6440,0,1,6442,213084,0.213084
6840,4300,5140,22102000,2,54726,13683,1,693372800,693372800,20521,6840,13681,6840,0,1,6842,2079285,2.079285
55,4555,4865,22160075,2,446,113,1,181425400,181425400,166,55,111,55,0,1,57,454444,0.454444
455,4555,4865,22160075,2,3646,913,1,211569400,211569400,1366,455,911,455,0,1,457,1249314,1.249314
855,4555,4865,22160075,2,6846,1713,1,241713400,241713400,2566,855,1711,855,0,1,857,3698250,3.69825
1255,4555,4865,22160075,2,10046,2513,1,271857400,271857400,3766,1255,2511,1255,0,1,1257,1983019,1.983019
1655,4555,4865,22160075,2,13246,3313,1,302001400,302001400,4966,1655,3311,1655,0,1,1657,4792864,4.792864
2055,4555,4865,22160075,2,16446,4113,1,332145400,332145400,6166,2055,4111,2055,0,1,2057,437755,0.437755
2455,4555,4865,22160075,2,19646,4913,1,362289400,362289400,7366,2455,4911,2455,0,1,2457,4065777,4.065777
2855,4555,4865,22160075,2,22846,5713,1,392433400,392433400,8566,2855,5711,2855,0,1,2857,2407884,2.407884
3255,4555,4865,22160075,2,26046,6513,1,422577400,422577400,9766,3255,6511,3255,0,1,3257,11585667,11.585667
3655,4555,4865,22160075,2,29246,7313,1,452721400,452721400,10966,3655,7311,3655,0,1,3657,4163187,4.163187
4055,4555,4865,22160075,2,32446,8113,1,482865400,482865400,12166,4055,8111,4055,0,1,4057,69820,0.06982
4455,4555,4865,22160075,2,35646,8913,1,513009400,513009400,13366,4455,8911,4455,0,1,4457,2327349,2.327349
4855,4555,4865,22160075,2,38846,9713,1,543153400,543153400,14566,4855,9711,4855,0,1,4857,3511904,3.511904
5255,4555,4865,22160075,2,42046,10513,1,573297400,573297400,15766,5255,10511,5255,0,1,5257,911852,0.911852
5655,4555,4865,22160075,2,45246,11313,1,603441400,603441400,16966,5655,11311,5655,0,1,5657,538266,0.538266
6055,4555,4865,22160075,2,48446,12113,1,633585400,633585400,18166,6055,12111,6055,0,1,6057,161368,0.161368
6455,4555,4865,22160075,2,51646,12913,1,663729400,663729400,19366,6455,12911,6455,0,1,6457,1861053,1.861053
6855,4555,4865,22160075,2,54846,13713,1,693873400,693873400,20566,6855,13711,6855,0,1,6857,632875,0.632875
55,4055,5465,22160575,2,446,113,1,181473400,181473400,166,55,111,55,0,1,57,11970,0.01197
455,4055,5465,22160575,2,3646,913,1,211937400,211937400,1366,455,911,455,0,1,457,37397,0.037397
855,4055,5465,22160575,2,6846,1713,1,242401400,242401400,2566,855,1711,855,0,1,857,18502,0.018502
1255,4055,5465,22160575,2,10046,2513,1,272865400,272865400,3766,1255,2511,1255,0,1,1257,102468,0.102468
1655,4055,5465,22160575,2,13246,3313,1,303329400,303329400,4966,1655,3311,1655,0,1,1657,66312,0.066312
2055,4055,5465,22160575,2,16446,4113,1,333793400,333793400,6166,2055,4111,2055,0,1,2057,571817,0.571817
2455,4055,5465,22160575,2,19646,4913,1,364257400,364257400,7366,2455,4911,2455,0,1,2457,2019100,2.0191
2855,4055,5465,22160575,2,22846,5713,1,394721400,394721400,8566,2855,5711,2855,0,1,2857,69691,0.069691
3255,4055,5465,22160575,2,26046,6513,1,425185400,425185400,9766,3255,6511,3255,0,1,3257,1855048,1.855048
3655,4055,5465,22160575,2,29246,7313,1,455649400,455649400,10966,3655,7311,3655,0,1,3657,18372,0.018372
4055,4055,5465,22160575,2,32446,8113,1,486113400,486113400,12166,4055,8111,4055,0,1,4057,430971,0.430971
4455,4055,5465,22160575,2,35646,8913,1,516577400,516577400,13366,4455,8911,4455,0,1,4457,446219,0.446219
4855,4055,5465,22160575,2,38846,9713,1,547041400,547041400,14566,4855,9711,4855,0,1,4857,1902614,1.902614
5255,4055,5465,22160575,2,42046,10513,1,577505400,577505400,15766,5255,10511,5255,0,1,5257,39765,0.039765
5655,4055,5465,22160575,2,45246,11313,1,607969400,607969400,16966,5655,11311,5655,0,1,5657,1108547,1.108547
6055,4055,5465,22160575,2,48446,12113,1,638433400,638433400,18166,6055,12111,6055,0,1,6057,3023617,3.023617
6455,4055,5465,22160575,2,51646,12913,1,668897400,668897400,19366,6455,12911,6455,0,1,6457,2517339,2.517339
6855,4055,5465,22160575,2,54846,13713,1,699361400,699361400,20566,6855,13711,6855,0,1,6857,686439,0.686439
55,6055,3665,22191575,2,446,113,1,181809400,181809400,166,55,111,55,0,1,57,440273,0.440273
455,6055,3665,22191575,2,3646,913,1,212913400,212913400,1366,455,911,455,0,1,457,2086630,2.08663
855,6055,3665,22191575,2,6846,1713,1,244017400,244017400,2566,855,1711,855,0,1,857,448331,0.448331
1255,6055,3665,22191575,2,10046,2513,1,275121400,275121400,3766,1255,2511,1255,0,1,1257,2526023,2.526023
1655,6055,3665,22191575,2,13246,3313,1,306225400,306225400,4966,1655,3311,1655,0,1,1657,2259635,2.259635
2055,6055,3665,22191575,2,16446,4113,1,337329400,337329400,6166,2055,4111,2055,0,1,2057,3461330,3.46133
2455,6055,3665,22191575,2,19646,4913,1,368433400,368433400,7366,2455,4911,2455,0,1,2457,229421,0.229421
2855,6055,3665,22191575,2,22846,5713,1,399537400,399537400,8566,2855,5711,2855,0,1,2857,2111406,2.111406
3255,6055,3665,22191575,2,26046,6513,1,430641400,430641400,9766,3255,6511,3255,0,1,3257,1885762,1.885762
3655,6055,3665,22191575,2,29246,7313,1,461745400,461745400,10966,3655,7311,3655,0,1,3657,204199,0.204199
4055,6055,3665,22191575,2,32446,8113,1,492849400,492849400,12166,4055,8111,4055,0,1,4057,1645624,1.645624
4455,6055,3665,22191575,2,35646,8913,1,523953400,523953400,13366,4455,8911,4455,0,1,4457,459588,0.459588
4855,6055,3665,22191575,2,38846,9713,1,555057400,555057400,14566,4855,9711,4855,0,1,4857,345026,0.345026
5255,6055,3665,22191575,2,42046,10513,1,586161400,586161400,15766,5255,10511,5255,0,1,5257,1182730,1.18273
5655,6055,3665,22191575,2,45246,11313,1,617265400,617265400,16966,5655,11311,5655,0,1,5657,3382572,3.382572
6055,6055,3665,22191575,2,48446,12113,1,648369400,648369400,18166,6055,12111,6055,0,1,6057,800789,0.800789
6455,6055,3665,22191575,2,51646,12913,1,679473400,679473400,19366,6455,12911,6455,0,1,6457,1724367,1.724367
6855,6055,3665,22191575,2,54846,13713,1,710577400,710577400,20566,6855,13711,6855,0,1,6857,908950,0.90895
35,4400,5045,22198000,2,286,73,1,180228600,180228600,106,35,71,35,0,1,37,29180,0.02918
535,4400,5045,22198000,2,4286,1073,1,218008600,218008600,1606,535,1071,535,0,1,537,92721,0.092721
1035,4400,5045,22198000,2,8286,2073,1,255788600,255788600,3106,1035,2071,1035,0,1,1037,414251,0.414251
1535,4400,5045,22198000,2,12286,3073,1,293568600,293568600,4606,1535,3071,1535,0,1,1537,1122170,1.12217
2035,4400,5045,22198000,2,16286,4073,1,331348600,331348600,6106,2035,4071,2035,0,1,2037,2051211,2.051211
2535,4400,5045,22198000,2,20286,5073,1,369128600,369128600,7606,2535,5071,2535,0,1,2537,771748,0.771748
3035,4400,5045,22198000,2,24286,6073,1,406908600,406908600,9106,3035,6071,3035,0,1,3037,3925988,3.925988
3535,4400,5045,22198000,2,28286,7073,1,444688600,444688600,10606,3535,7071,3535,0,1,3537,135515,0.135515
4035,4400,5045,22198000,2,32286,8073,1,482468600,482468600,12106,4035,8071,4035,0,1,4037,4881090,4.88109
4535,4400,5045,22198000,2,36286,9073,1,520248600,520248600,13606,4535,9071,4535,0,1,4537,1691424,1.691424
5035,4400,5045,22198000,2,40286,10073,1,558028600,558028600,15106,5035,10071,5035,0,1,5037,1244270,1.24427
5535,4400,5045,22198000,2,44286,11073,1,595808600,595808600,16606,5535,11071,5535,0,1,5537,1103836,1.103836
6035,4400,5045,22198000,2,48286,12073,1,633588600,633588600,18106,6035,12071,6035,0,1,6037,695319,0.695319
6535,4400,5045,22198000,2,52286,13073,1,671368600,671368600,19606,6535,13071,6535,0,1,6537,6206448,6.206448
7035,4400,5045,22198000,2,56286,14073,1,709148600,709148600,21106,7035,14071,7035,0,1,7037,1126967,1.126967
55,4305,5165,22235325,2,446,113,1,182049400,182049400,166,55,111,55,0,1,57,38518,0.038518
455,4305,5165,22235325,2,3646,913,1,212353400,212353400,1366,455,911,455,0,1,457,86171,0.086171
855,4305,5165,22235325,2,6846,1713,1,242657400,242657400,2566,855,1711,855,0,1,857,472471,0.472471
1255,4305,5165,22235325,2,10046,2513,1,272961400,272961400,3766,1255,2511,1255,0,1,1257,148711,0.148711
1655,4305,5165,22235325,2,13246,3313,1,303265400,303265400,4966,1655,3311,1655,0,1,1657,1310091,1.310091
2055,4305,5165,22235325,2,16446,4113,1,333569400,333569400,6166,2055,4111,2055,0,1,2057,472909,0.472909
2455,4305,5165,22235325,2,19646,4913,1,363873400,363873400,7366,2455,4911,2455,0,1,2457,563351,0.563351
2855,4305,5165,22235325,2,22846,5713,1,394177400,394177400,8566,2855,5711,2855,0,1,2857,468303,0.468303
3255,4305,5165,22235325,2,26046,6513,1,424481400,424481400,9766,3255,6511,3255,0,1,3257,3528888,3.528888
3655,4305,5165,22235325,2,29246,7313,1,454785400,454785400,10966,3655,7311,3655,0,1,3657,32323,0.032323
4055,4305,5165,22235325,2,32446,8113,1,485089400,485089400,12166,4055,8111,4055,0,1,4057,2868278,2.868278
4455,4305,5165,22235325,2,35646,8913,1,515393400,515393400,13366,4455,8911,4455,0,1,4457,1894359,1.894359
4855,4305,5165,22235325,2,38846,9713,1,545697400,545697400,14566,4855,9711,4855,0,1,4857,567464,0.567464
5255,4305,5165,22235325,2,42046,10513,1,576001400,576001400,15766,5255,10511,5255,0,1,5257,2135802,2.135802
5655,4305,5165,22235325,2,45246,11313,1,606305400,606305400,16966,5655,11311,5655,0,1,5657,1528960,1.52896
6055,4305,5165,22235325,2,48446,12113,1,636609400,636609400,18166,6055,12111,6055,0,1,6057,5853746,5.853746
6455,4305,5165,22235325,2,51646,12913,1,666913400,666913400,19366,6455,12911,6455,0,1,6457,1648003,1.648003
6855,4305,5165,22235325,2,54846,13713,1,697217400,697217400,20566,6855,13711,6855,0,1,6857,3413704,3.413704
35,5500,4045,22247500,2,286,73,1,180652600,180652600,106,35,71,35,0,1,37,90593,0.090593
535,5500,4045,22247500,2,4286,1073,1,218832600,218832600,1606,535,1071,535,0,1,537,668196,0.668196
1035,5500,4045,22247500,2,8286,2073,1,257012600,257012600,3106,1035,2071,1035,0,1,1037,1629714,1.629714
1535,5500,4045,22247500,2,12286,3073,1,295192600,295192600,4606,1535,3071,1535,0,1,1537,488641,0.488641
2035,5500,4045,22247500,2,16286,4073,1,333372600,333372600,6106,2035,4071,2035,0,1,2037,1037796,1.037796
2535,5500,4045,22247500,2,20286,5073,1,371552600,371552600,7606,2535,5071,2535,0,1,2537,2371358,2.371358
3035,5500,4045,22247500,2,24286,6073,1,409732600,409732600,9106,3035,6071,3035,0,1,3037,835677,0.835677
3535,5500,4045,22247500,2,28286,7073,1,447912600,447912600,10606,3535,7071,3535,0,1,3537,3048831,3.048831
4035,5500,4045,22247500,2,32286,8073,1,486092600,486092600,12106,4035,8071,4035,0,1,4037,566627,0.566627
4535,5500,4045,22247500,2,36286,9073,1,524272600,524272600,13606,4535,9071,4535,0,1,4537,4503785,4.503785
5035,5500,4045,22247500,2,40286,10073,1,562452600,562452600,15106,5035,10071,5035,0,1,5037,6879691,6.879691
5535,5500,4045,22247500,2,44286,11073,1,600632600,600632600,16606,5535,11071,5535,0,1,5537,1867077,1.867077
6035,5500,4045,22247500,2,48286,12073,1,638812600,638812600,18106,6035,12071,6035,0,1,6037,2943468,2.943468
6535,5500,4045,22247500,2,52286,13073,1,676992600,676992600,19606,6535,13071,6535,0,1,6537,2057838,2.057838
7035,5500,4045,22247500,2,56286,14073,1,715172600,715172600,21106,7035,14071,7035,0,1,7037,2735904,2.735904
39,4443,5041,22397163,2,318,81,1,182136312,182136312,118,39,79,39,0,1,41,24934,0.024934
539,4443,5041,22397163,2,4318,1081,1,220072312,220072312,1618,539,1079,539,0,1,541,130184,0.130184
1039,4443,5041,22397163,2,8318,2081,1,258008312,258008312,3118,1039,2079,1039,0,1,1041,217915,0.217915
1539,4443,5041,22397163,2,12318,3081,1,295944312,295944312,4618,1539,3079,1539,0,1,1541,998435,0.998435
2039,4443,5041,22397163,2,16318,4081,1,333880312,333880312,6118,2039,4079,2039,0,1,2041,149354,0.149354
2539,4443,5041,22397163,2,20318,5081,1,371816312,371816312,7618,2539,5079,2539,0,1,2541,1722455,1.722455
3039,4443,5041,22397163,2,24318,6081,1,409752312,409752312,9118,3039,6079,3039,0,1,3041,954341,0.954341
3539,4443,5041,22397163,2,28318,7081,1,447688312,447688312,10618,3539,7079,3539,0,1,3541,282849,0.282849
4039,4443,5041,22397163,2,32318,8081,1,485624312,485624312,12118,4039,8079,4039,0,1,4041,831156,0.831156
4539,4443,5041,22397163,2,36318,9081,1,523560312,523560312,13618,4539,9079,4539,0,1,4541,3453893,3.453893
5039,4443,5041,22397163,2,40318,10081,1,561496312,561496312,15118,5039,10079,5039,0,1,5041,560678,0.560678
5539,4443,5041,22397163,2,44318,11081,1,599432312,599432312,16618,5539,11079,5539,0,1,5541,351667,0.351667
6039,4443,5041,22397163,2,48318,12081,1,637368312,637368312,18118,6039,12079,6039,0,1,6041,543335,0.543335
6539,4443,5041,22397163,2,52318,13081,1,675304312,675304312,19618,6539,13079,6539,0,1,6541,2781130,2.78113
7039,4443,5041,22397163,2,56318,14081,1,713240312,713240312,21118,7039,14079,7039,0,1,7041,1702406,1.702406
39,5543,4041,22399263,2,318,81,1,182184312,182184312,118,39,79,39,0,1,41,16165,0.016165
539,5543,4041,22399263,2,4318,1081,1,220520312,220520312,1618,539,1079,539,0,1,541,17958,0.017958
1039,5543,4041,22399263,2,8318,2081,1,258856312,258856312,3118,1039,2079,1039,0,1,1041,508877,0.508877
1539,5543,4041,22399263,2,12318,3081,1,297192312,297192312,4618,1539,3079,1539,0,1,1541,949327,0.949327
2039,5543,4041,22399263,2,16318,4081,1,335528312,335528312,6118,2039,4079,2039,0,1,2041,1366820,1.36682
2539,5543,4041,22399263,2,20318,5081,1,373864312,373864312,7618,2539,5079,2539,0,1,2541,1329104,1.329104
3039,5543,4041,22399263,2,24318,6081,1,412200312,412200312,9118,3039,6079,3039,0,1,3041,2113167,2.113167
3539,5543,4041,22399263,2,28318,7081,1,450536312,450536312,10618,3539,7079,3539,0,1,3541,272341,0.272341
4039,5543,4041,22399263,2,32318,8081,1,488872312,488872312,12118,4039,8079,4039,0,1,4041,1616490,1.61649
4539,5543,4041,22399263,2,36318,9081,1,527208312,527208312,13618,4539,9079,4539,0,1,4541,1455268,1.455268
5039,5543,4041,22399263,2,40318,10081,1,565544312,565544312,15118,5039,10079,5039,0,1,5041,1694634,1.694634
5539,5543,4041,22399263,2,44318,11081,1,603880312,603880312,16618,5539,11079,5539,0,1,5541,2878102,2.878102
6039,5543,4041,22399263,2,48318,12081,1,642216312,642216312,18118,6039,12079,6039,0,1,6041,9390898,9.390898
6539,5543,4041,22399263,2,52318,13081,1,680552312,680552312,19618,6539,13079,6539,0,1,6541,501017,0.501017
7039,5543,4041,22399263,2,56318,14081,1,718888312,718888312,21118,7039,14079,7039,0,1,7041,4125586,4.125586
35,4440,5045,22399800,2,286,73,1,181854200,181854200,106,35,71,35,0,1,37,407453,0.407453
535,4440,5045,22399800,2,4286,1073,1,219794200,219794200,1606,535,1071,535,0,1,537,2406367,2.406367
1035,4440,5045,22399800,2,8286,2073,1,257734200,257734200,3106,1035,2071,1035,0,1,1037,4475381,4.475381
1535,4440,5045,22399800,2,12286,3073,1,295674200,295674200,4606,1535,3071,1535,0,1,1537,6590911,6.590911
2035,4440,5045,22399800,2,16286,4073,1,333614200,333614200,6106,2035,4071,2035,0,1,2037,8660045,8.660045
35,5540,4045,22409300,2,286,73,1,181958200,181958200,106,35,71,35,0,1,37,248758,0.248758
535,5540,4045,22409300,2,4286,1073,1,220298200,220298200,1606,535,1071,535,0,1,537,652586,0.652586
1035,5540,4045,22409300,2,8286,2073,1,258638200,258638200,3106,1035,2071,1035,0,1,1037,1717226,1.717226
1535,5540,4045,22409300,2,12286,3073,1,296978200,296978200,4606,1535,3071,1535,0,1,1537,1940703,1.940703
40,5300,4240,22472000,2,326,83,1,182828800,182828800,121,40,81,40,0,1,42,392803,0.392803
440,5300,4240,22472000,2,3526,883,1,213356800,213356800,1321,440,881,440,0,1,442,30618,0.030618
840,5300,4240,22472000,2,6726,1683,1,243884800,243884800,2521,840,1681,840,0,1,842,252772,0.252772
1240,5300,4240,22472000,2,9926,2483,1,274412800,274412800,3721,1240,2481,1240,0,1,1242,719106,0.719106
1640,5300,4240,22472000,2,13126,3283,1,304940800,304940800,4921,1640,3281,1640,0,1,1642,2654066,2.654066
2040,5300,4240,22472000,2,16326,4083,1,335468800,335468800,6121,2040,4081,2040,0,1,2042,1085321,1.085321
2440,5300,4240,22472000,2,19526,4883,1,365996800,365996800,7321,2440,4881,2440,0,1,2442,1127701,1.127701
2840,5300,4240,22472000,2,22726,5683,1,396524800,396524800,8521,2840,5681,2840,0,1,2842,5752084,5.752084
3240,5300,4240,22472000,2,25926,6483,1,427052800,427052800,9721,3240,6481,3240,0,1,3242,5426097,5.426097
3640,5300,4240,22472000,2,29126,7283,1,457580800,457580800,10921,3640,7281,3640,0,1,3642,1521573,1.521573
4040,5300,4240,22472000,2,32326,8083,1,488108800,488108800,12121,4040,8081,4040,0,1,4042,1040263,1.040263
4440,5300,4240,22472000,2,35526,8883,1,518636800,518636800,13321,4440,8881,4440,0,1,4442,1059144,1.059144
4840,5300,4240,22472000,2,38726,9683,1,549164800,549164800,14521,4840,9681,4840,0,1,4842,2648725,2.648725
5240,5300,4240,22472000,2,41926,10483,1,579692800,579692800,15721,5240,10481,5240,0,1,5242,434979,0.434979
5640,5300,4240,22472000,2,45126,11283,1,610220800,610220800,16921,5640,11281,5640,0,1,5642,1167706,1.167706
6040,5300,4240,22472000,2,48326,12083,1,640748800,640748800,18121,6040,12081,6040,0,1,6042,53013,0.053013
6440,5300,4240,22472000,2,51526,12883,1,671276800,671276800,19321,6440,12881,6440,0,1,6442,154847,0.154847
6840,5300,4240,22472000,2,54726,13683,1,701804800,701804800,20521,6840,13681,6840,0,1,6842,955523,0.955523
35,4950,4545,22497750,2,286,73,1,182640600,182640600,106,35,71,35,0,1,37,43017,0.043017
535,4950,4545,22497750,2,4286,1073,1,220620600,220620600,1606,535,1071,535,0,1,537,1030072,1.030072
1035,4950,4545,22497750,2,8286,2073,1,258600600,258600600,3106,1035,2071,1035,0,1,1037,844215,0.844215
1535,4950,4545,22497750,2,12286,3073,1,296580600,296580600,4606,1535,3071,1535,0,1,1537,596355,0.596355
2035,4950,4545,22497750,2,16286,4073,1,334560600,334560600,6106,2035,4071,2035,0,1,2037,335109,0.335109
2535,4950,4545,22497750,2,20286,5073,1,372540600,372540600,7606,2535,5071,2535,0,1,2537,7199657,7.199657
3035,4950,4545,22497750,2,24286,6073,1,410520600,410520600,9106,3035,6071,3035,0,1,3037,1671603,1.671603
3535,4950,4545,22497750,2,28286,7073,1,448500600,448500600,10606,3535,7071,3535,0,1,3537,2810134,2.810134
4035,4950,4545,22497750,2,32286,8073,1,486480600,486480600,12106,4035,8071,4035,0,1,4037,2823330,2.82333
4535,4950,4545,22497750,2,36286,9073,1,524460600,524460600,13606,4535,9071,4535,0,1,4537,543686,0.543686
5035,4950,4545,22497750,2,40286,10073,1,562440600,562440600,15106,5035,10071,5035,0,1,5037,1477379,1.477379
5535,4950,4545,22497750,2,44286,11073,1,600420600,600420600,16606,5535,11071,5535,0,1,5537,4008646,4.008646
6035,4950,4545,22497750,2,48286,12073,1,638400600,638400600,18106,6035,12071,6035,0,1,6037,715230,0.71523
6535,4950,4545,22497750,2,52286,13073,1,676380600,676380600,19606,6535,13071,6535,0,1,6537,2460080,2.46008
7035,4950,4545,22497750,2,56286,14073,1,714360600,714360600,21106,7035,14071,7035,0,1,7037,4086314,4.086314
40,3550,6340,22507000,2,326,83,1,183220800,183220800,121,40,81,40,0,1,42,414196,0.414196
440,3550,6340,22507000,2,3526,883,1,214868800,214868800,1321,440,881,440,0,1,442,2071588,2.071588
840,3550,6340,22507000,2,6726,1683,1,246516800,246516800,2521,840,1681,840,0,1,842,3770870,3.77087
1240,3550,6340,22507000,2,9926,2483,1,278164800,278164800,3721,1240,2481,1240,0,1,1242,1344308,1.344308
1640,3550,6340,22507000,2,13126,3283,1,309812800,309812800,4921,1640,3281,1640,0,1,1642,3743912,3.743912
2040,3550,6340,22507000,2,16326,4083,1,341460800,341460800,6121,2040,4081,2040,0,1,2042,2329727,2.329727
2440,3550,6340,22507000,2,19526,4883,1,373108800,373108800,7321,2440,4881,2440,0,1,2442,708126,0.708126
2840,3550,6340,22507000,2,22726,5683,1,404756800,404756800,8521,2840,5681,2840,0,1,2842,1244890,1.24489
3240,3550,6340,22507000,2,25926,6483,1,436404800,436404800,9721,3240,6481,3240,0,1,3242,810418,0.810418
3640,3550,6340,22507000,2,29126,7283,1,468052800,468052800,10921,3640,7281,3640,0,1,3642,786856,0.786856
4040,3550,6340,22507000,2,32326,8083,1,499700800,499700800,12121,4040,8081,4040,0,1,4042,1112406,1.112406
4440,3550,6340,22507000,2,35526,8883,1,531348800,531348800,13321,4440,8881,4440,0,1,4442,316085,0.316085
4840,3550,6340,22507000,2,38726,9683,1,562996800,562996800,14521,4840,9681,4840,0,1,4842,932335,0.932335
5240,3550,6340,22507000,2,41926,10483,1,594644800,594644800,15721,5240,10481,5240,0,1,5242,3350001,3.350001
5640,3550,6340,22507000,2,45126,11283,1,626292800,626292800,16921,5640,11281,5640,0,1,5642,1502101,1.502101
6040,3550,6340,22507000,2,48326,12083,1,657940800,657940800,18121,6040,12081,6040,0,1,6042,2230872,2.230872
6440,3550,6340,22507000,2,51526,12883,1,689588800,689588800,19321,6440,12881,6440,0,1,6442,4292959,4.292959
6840,3550,6340,22507000,2,54726,13683,1,721236800,721236800,20521,6840,13681,6840,0,1,6842,1259087,1.259087
44,4453,5055,22509915,2,358,91,1,183426136,183426136,133,44,89,44,0,1,46,15690,0.01569
544,4453,5055,22509915,2,4358,1091,1,221458136,221458136,1633,544,1089,544,0,1,546,194000,0.194
1044,4453,5055,22509915,2,8358,2091,1,259490136,259490136,3133,1044,2089,1044,0,1,1046,113561,0.113561
1544,4453,5055,22509915,2,12358,3091,1,297522136,297522136,4633,1544,3089,1544,0,1,1546,20977,0.020977
2044,4453,5055,22509915,2,16358,4091,1,335554136,335554136,6133,2044,4089,2044,0,1,2046,597902,0.597902
2544,4453,5055,22509915,2,20358,5091,1,373586136,373586136,7633,2544,5089,2544,0,1,2546,685868,0.685868
3044,4453,5055,22509915,2,24358,6091,1,411618136,411618136,9133,3044,6089,3044,0,1,3046,484840,0.48484
3544,4453,5055,22509915,2,28358,7091,1,449650136,449650136,10633,3544,7089,3544,0,1,3546,4262837,4.262837
4044,4453,5055,22509915,2,32358,8091,1,487682136,487682136,12133,4044,8089,4044,0,1,4046,628355,0.628355
4544,4453,5055,22509915,2,36358,9091,1,525714136,525714136,13633,4544,9089,4544,0,1,4546,1366110,1.36611
5044,4453,5055,22509915,2,40358,10091,1,563746136,563746136,15133,5044,10089,5044,0,1,5046,1318682,1.318682
5544,4453,5055,22509915,2,44358,11091,1,601778136,601778136,16633,5544,11089,5544,0,1,5546,149327,0.149327
6044,4453,5055,22509915,2,48358,12091,1,639810136,639810136,18133,6044,12089,6044,0,1,6046,961102,0.961102
6544,4453,5055,22509915,2,52358,13091,1,677842136,677842136,19633,6544,13089,6544,0,1,6546,1086010,1.08601
7044,4453,5055,22509915,2,56358,14091,1,715874136,715874136,21133,7044,14089,7044,0,1,7046,691885,0.691885
44,5553,4055,22517415,2,358,91,1,183521336,183521336,133,44,89,44,0,1,46,19929,0.019929
544,5553,4055,22517415,2,4358,1091,1,221953336,221953336,1633,544,1089,544,0,1,546,95865,0.095865
1044,5553,4055,22517415,2,8358,2091,1,260385336,260385336,3133,1044,2089,1044,0,1,1046,184172,0.184172
1544,5553,4055,22517415,2,12358,3091,1,298817336,298817336,4633,1544,3089,1544,0,1,1546,378962,0.378962
2044,5553,4055,22517415,2,16358,4091,1,337249336,337249336,6133,2044,4089,2044,0,1,2046,418796,0.418796
2544,5553,4055,22517415,2,20358,5091,1,375681336,375681336,7633,2544,5089,2544,0,1,2546,840860,0.84086
3044,5553,4055,22517415,2,24358,6091,1,414113336,414113336,9133,3044,6089,3044,0,1,3046,974130,0.97413
3544,5553,4055,22517415,2,28358,7091,1,452545336,452545336,10633,3544,7089,3544,0,1,3546,108946,0.108946
4044,5553,4055,22517415,2,32358,8091,1,490977336,490977336,12133,4044,8089,4044,0,1,4046,1079236,1.079236
4544,5553,4055,22517415,2,36358,9091,1,529409336,529409336,13633,4544,9089,4544,0,1,4546,861979,0.861979
5044,5553,4055,22517415,2,40358,10091,1,567841336,567841336,15133,5044,10089,5044,0,1,5046,6300542,6.300542
5544,5553,4055,22517415,2,44358,11091,1,606273336,606273336,16633,5544,11089,5544,0,1,5546,3057954,3.057954
6044,5553,4055,22517415,2,48358,12091,1,644705336,644705336,18133,6044,12089,6044,0,1,6046,2751962,2.751962
6544,5553,4055,22517415,2,52358,13091,1,683137336,683137336,19633,6544,13089,6544,0,1,6546,247997,0.247997
7044,5553,4055,22517415,2,56358,14091,1,721569336,721569336,21133,7044,14089,7044,0,1,7046,615912,0.615912
55,5305,4265,22625825,2,446,113,1,185217400,185217400,166,55,111,55,0,1,57,452222,0.452222
455,5305,4265,22625825,2,3646,913,1,215841400,215841400,1366,455,911,455,0,1,457,271649,0.271649
855,5305,4265,22625825,2,6846,1713,1,246465400,246465400,2566,855,1711,855,0,1,857,1880288,1.880288
1255,5305,4265,22625825,2,10046,2513,1,277089400,277089400,3766,1255,2511,1255,0,1,1257,1205297,1.205297
1655,5305,4265,22625825,2,13246,3313,1,307713400,307713400,4966,1655,3311,1655,0,1,1657,2013937,2.013937
2055,5305,4265,22625825,2,16446,4113,1,338337400,338337400,6166,2055,4111,2055,0,1,2057,3114035,3.114035
2455,5305,4265,22625825,2,19646,4913,1,368961400,368961400,7366,2455,4911,2455,0,1,2457,1870377,1.870377
2855,5305,4265,22625825,2,22846,5713,1,399585400,399585400,8566,2855,5711,2855,0,1,2857,201433,0.201433
3255,5305,4265,22625825,2,26046,6513,1,430209400,430209400,9766,3255,6511,3255,0,1,3257,3412240,3.41224
3655,5305,4265,22625825,2,29246,7313,1,460833400,460833400,10966,3655,7311,3655,0,1,3657,201855,0.201855
4055,5305,4265,22625825,2,32446,8113,1,491457400,491457400,12166,4055,8111,4055,0,1,4057,384282,0.384282
4455,5305,4265,22625825,2,35646,8913,1,522081400,522081400,13366,4455,8911,4455,0,1,4457,987210,0.98721
4855,5305,4265,22625825,2,38846,9713,1,552705400,552705400,14566,4855,9711,4855,0,1,4857,119295,0.119295
5255,5305,4265,22625825,2,42046,10513,1,583329400,583329400,15766,5255,10511,5255,0,1,5257,1511895,1.511895
5655,5305,4265,22625825,2,45246,11313,1,613953400,613953400,16966,5655,11311,5655,0,1,5657,293161,0.293161
6055,5305,4265,22625825,2,48446,12113,1,644577400,644577400,18166,6055,12111,6055,0,1,6057,2891484,2.891484
6455,5305,4265,22625825,2,51646,12913,1,675201400,675201400,19366,6455,12911,6455,0,1,6457,1416838,1.416838
6855,5305,4265,22625825,2,54846,13713,1,705825400,705825400,20566,6855,13711,6855,0,1,6857,6971634,6.971634
55,3555,6365,22627575,2,446,113,1,185385400,185385400,166,55,111,55,0,1,57,456706,0.456706
455,3555,6365,22627575,2,3646,913,1,217129400,217129400,1366,455,911,455,0,1,457,2171631,2.171631
855,3555,6365,22627575,2,6846,1713,1,248873400,248873400,2566,855,1711,855,0,1,857,3881018,3.881018
1255,3555,6365,22627575,2,10046,2513,1,280617400,280617400,3766,1255,2511,1255,0,1,1257,5610431,5.610431
1655,3555,6365,22627575,2,13246,3313,1,312361400,312361400,4966,1655,3311,1655,0,1,1657,1165366,1.165366
2055,3555,6365,22627575,2,16446,4113,1,344105400,344105400,6166,2055,4111,2055,0,1,2057,617214,0.617214
2455,3555,6365,22627575,2,19646,4913,1,375849400,375849400,7366,2455,4911,2455,0,1,2457,564361,0.564361
2855,3555,6365,22627575,2,22846,5713,1,407593400,407593400,8566,2855,5711,2855,0,1,2857,854749,0.854749
3255,3555,6365,22627575,2,26046,6513,1,439337400,439337400,9766,3255,6511,3255,0,1,3257,551240,0.55124
3655,3555,6365,22627575,2,29246,7313,1,471081400,471081400,10966,3655,7311,3655,0,1,3657,6285847,6.285847
4055,3555,6365,22627575,2,32446,8113,1,502825400,502825400,12166,4055,8111,4055,0,1,4057,2494062,2.494062
4455,3555,6365,22627575,2,35646,8913,1,534569400,534569400,13366,4455,8911,4455,0,1,4457,2608165,2.608165
4855,3555,6365,22627575,2,38846,9713,1,566313400,566313400,14566,4855,9711,4855,0,1,4857,1207661,1.207661
5255,3555,6365,22627575,2,42046,10513,1,598057400,598057400,15766,5255,10511,5255,0,1,5257,2162422,2.162422
5655,3555,6365,22627575,2,45246,11313,1,629801400,629801400,16966,5655,11311,5655,0,1,5657,2353134,2.353134
6055,3555,6365,22627575,2,48446,12113,1,661545400,661545400,18166,6055,12111,6055,0,1,6057,2594843,2.594843
6455,3555,6365,22627575,2,51646,12913,1,693289400,693289400,19366,6455,12911,6455,0,1,6457,2883386,2.883386
6855,3555,6365,22627575,2,54846,13713,1,725033400,725033400,20566,6855,13711,6855,0,1,6857,5299668,5.299668
39,4993,4541,22673213,2,318,81,1,184360312,184360312,118,39,79,39,0,1,41,398878,0.398878
539,4993,4541,22673213,2,4318,1081,1,222496312,222496312,1618,539,1079,539,0,1,541,982539,0.982539
1039,4993,4541,22673213,2,8318,2081,1,260632312,260632312,3118,1039,2079,1039,0,1,1041,1452598,1.452598
1539,4993,4541,22673213,2,12318,3081,1,298768312,298768312,4618,1539,3079,1539,0,1,1541,5421928,5.421928
2039,4993,4541,22673213,2,16318,4081,1,336904312,336904312,6118,2039,4079,2039,0,1,2041,7965444,7.965444
2539,4993,4541,22673213,2,20318,5081,1,375040312,375040312,7618,2539,5079,2539,0,1,2541,2212525,2.212525
3039,4993,4541,22673213,2,24318,6081,1,413176312,413176312,9118,3039,6079,3039,0,1,3041,2929830,2.92983
3539,4993,4541,22673213,2,28318,7081,1,451312312,451312312,10618,3539,7079,3539,0,1,3541,433020,0.43302
4039,4993,4541,22673213,2,32318,8081,1,489448312,489448312,12118,4039,8079,4039,0,1,4041,11711413,11.711413
4539,4993,4541,22673213,2,36318,9081,1,527584312,527584312,13618,4539,9079,4539,0,1,4541,6249512,6.249512
5039,4993,4541,22673213,2,40318,10081,1,565720312,565720312,15118,5039,10079,5039,0,1,5041,21351350,21.35135
5539,4993,4541,22673213,2,44318,11081,1,603856312,603856312,16618,5539,11079,5539,0,1,5541,11928648,11.928648
6039,4993,4541,22673213,2,48318,12081,1,641992312,641992312,18118,6039,12079,6039,0,1,6041,25729443,25.729443
6539,4993,4541,22673213,2,52318,13081,1,680128312,680128312,19618,6539,13079,6539,0,1,6541,27860803,27.860803
7039,4993,4541,22673213,2,56318,14081,1,718264312,718264312,21118,7039,14079,7039,0,1,7041,29881375,29.881375
40,6800,3340,22712000,2,326,83,1,184940800,184940800,121,40,81,40,0,1,42,402354,0.402354
440,6800,3340,22712000,2,3526,883,1,217388800,217388800,1321,440,881,440,0,1,442,2109728,2.109728
840,6800,3340,22712000,2,6726,1683,1,249836800,249836800,2521,840,1681,840,0,1,842,920424,0.920424
1240,6800,3340,22712000,2,9926,2483,1,282284800,282284800,3721,1240,2481,1240,0,1,1242,573910,0.57391
1640,6800,3340,22712000,2,13126,3283,1,314732800,314732800,4921,1640,3281,1640,0,1,1642,1501959,1.501959
2040,6800,3340,22712000,2,16326,4083,1,347180800,347180800,6121,2040,4081,2040,0,1,2042,2009677,2.009677
2440,6800,3340,22712000,2,19526,4883,1,379628800,379628800,7321,2440,4881,2440,0,1,2442,968827,0.968827
2840,6800,3340,22712000,2,22726,5683,1,412076800,412076800,8521,2840,5681,2840,0,1,2842,193753,0.193753
3240,6800,3340,22712000,2,25926,6483,1,444524800,444524800,9721,3240,6481,3240,0,1,3242,244880,0.24488
3640,6800,3340,22712000,2,29126,7283,1,476972800,476972800,10921,3640,7281,3640,0,1,3642,1683172,1.683172
4040,6800,3340,22712000,2,32326,8083,1,509420800,509420800,12121,4040,8081,4040,0,1,4042,2302050,2.30205
4440,6800,3340,22712000,2,35526,8883,1,541868800,541868800,13321,4440,8881,4440,0,1,4442,2097630,2.09763
4840,6800,3340,22712000,2,38726,9683,1,574316800,574316800,14521,4840,9681,4840,0,1,4842,157623,0.157623
5240,6800,3340,22712000,2,41926,10483,1,606764800,606764800,15721,5240,10481,5240,0,1,5242,2743056,2.743056
5640,6800,3340,22712000,2,45126,11283,1,639212800,639212800,16921,5640,11281,5640,0,1,5642,2497174,2.497174
6040,6800,3340,22712000,2,48326,12083,1,671660800,671660800,18121,6040,12081,6040,0,1,6042,744546,0.744546
6440,6800,3340,22712000,2,51526,12883,1,704108800,704108800,19321,6440,12881,6440,0,1,6442,8549027,8.549027
6840,6800,3340,22712000,2,54726,13683,1,736556800,736556800,20521,6840,13681,6840,0,1,6842,587000,0.587
44,5003,4555,22788665,2,358,91,1,185673736,185673736,133,44,89,44,0,1,46,423596,0.423596
544,5003,4555,22788665,2,4358,1091,1,223905736,223905736,1633,544,1089,544,0,1,546,2492033,2.492033
1044,5003,4555,22788665,2,8358,2091,1,262137736,262137736,3133,1044,2089,1044,0,1,1046,1770524,1.770524
1544,5003,4555,22788665,2,12358,3091,1,300369736,300369736,4633,1544,3089,1544,0,1,1546,2292457,2.292457
2044,5003,4555,22788665,2,16358,4091,1,338601736,338601736,6133,2044,4089,2044,0,1,2046,5584769,5.584769
2544,5003,4555,22788665,2,20358,5091,1,376833736,376833736,7633,2544,5089,2544,0,1,2546,6439727,6.439727
3044,5003,4555,22788665,2,24358,6091,1,415065736,415065736,9133,3044,6089,3044,0,1,3046,2421095,2.421095
3544,5003,4555,22788665,2,28358,7091,1,453297736,453297736,10633,3544,7089,3544,0,1,3546,3852826,3.852826
4044,5003,4555,22788665,2,32358,8091,1,491529736,491529736,12133,4044,8089,4044,0,1,4046,5009475,5.009475
4544,5003,4555,22788665,2,36358,9091,1,529761736,529761736,13633,4544,9089,4544,0,1,4546,8239800,8.2398
5044,5003,4555,22788665,2,40358,10091,1,567993736,567993736,15133,5044,10089,5044,0,1,5046,18543779,18.543779
5544,5003,4555,22788665,2,44358,11091,1,606225736,606225736,16633,5544,11089,5544,0,1,5546,2875620,2.87562
6044,5003,4555,22788665,2,48358,12091,1,644457736,644457736,18133,6044,12089,6044,0,1,6046,25869797,25.869797
6544,5003,4555,22788665,2,52358,13091,1,682689736,682689736,19633,6544,13089,6544,0,1,6546,27918579,27.918579
7044,5003,4555,22788665,2,56358,14091,1,720921736,720921736,21133,7044,14089,7044,0,1,7046,30072956,30.072956
40,5800,3940,22852000,2,326,83,1,185932800,185932800,121,40,81,40,0,1,42,54270,0.05427
440,5800,3940,22852000,2,3526,883,1,217100800,217100800,1321,440,881,440,0,1,442,96911,0.096911
840,5800,3940,22852000,2,6726,1683,1,248268800,248268800,2521,840,1681,840,0,1,842,37385,0.037385
1240,5800,3940,22852000,2,9926,2483,1,279436800,279436800,3721,1240,2481,1240,0,1,1242,189948,0.189948
1640,5800,3940,22852000,2,13126,3283,1,310604800,310604800,4921,1640,3281,1640,0,1,1642,161735,0.161735
2040,5800,3940,22852000,2,16326,4083,1,341772800,341772800,6121,2040,4081,2040,0,1,2042,855796,0.855796
2440,5800,3940,22852000,2,19526,4883,1,372940800,372940800,7321,2440,4881,2440,0,1,2442,282027,0.282027
2840,5800,3940,22852000,2,22726,5683,1,404108800,404108800,8521,2840,5681,2840,0,1,2842,955322,0.955322
3240,5800,3940,22852000,2,25926,6483,1,435276800,435276800,9721,3240,6481,3240,0,1,3242,335883,0.335883
3640,5800,3940,22852000,2,29126,7283,1,466444800,466444800,10921,3640,7281,3640,0,1,3642,1278511,1.278511
4040,5800,3940,22852000,2,32326,8083,1,497612800,497612800,12121,4040,8081,4040,0,1,4042,789602,0.789602
4440,5800,3940,22852000,2,35526,8883,1,528780800,528780800,13321,4440,8881,4440,0,1,4442,2257075,2.257075
4840,5800,3940,22852000,2,38726,9683,1,559948800,559948800,14521,4840,9681,4840,0,1,4842,829974,0.829974
5240,5800,3940,22852000,2,41926,10483,1,591116800,591116800,15721,5240,10481,5240,0,1,5242,995787,0.995787
5640,5800,3940,22852000,2,45126,11283,1,622284800,622284800,16921,5640,11281,5640,0,1,5642,105085,0.105085
6040,5800,3940,22852000,2,48326,12083,1,653452800,653452800,18121,6040,12081,6040,0,1,6042,858503,0.858503
6440,5800,3940,22852000,2,51526,12883,1,684620800,684620800,19321,6440,12881,6440,0,1,6442,1968486,1.968486
6840,5800,3940,22852000,2,54726,13683,1,715788800,715788800,20521,6840,13681,6840,0,1,6842,1000798,1.000798
55,6805,3365,22898825,2,446,113,1,187665400,187665400,166,55,111,55,0,1,57,458305,0.458305
455,6805,3365,22898825,2,3646,913,1,220209400,220209400,1366,455,911,455,0,1,457,139033,0.139033
855,6805,3365,22898825,2,6846,1713,1,252753400,252753400,2566,855,1711,855,0,1,857,238401,0.238401
1255,6805,3365,22898825,2,10046,2513,1,285297400,285297400,3766,1255,2511,1255,0,1,1257,2343769,2.343769
1655,6805,3365,22898825,2,13246,3313,1,317841400,317841400,4966,1655,3311,1655,0,1,1657,1400502,1.400502
2055,6805,3365,22898825,2,16446,4113,1,350385400,350385400,6166,2055,4111,2055,0,1,2057,499403,0.499403
2455,6805,3365,22898825,2,19646,4913,1,382929400,382929400,7366,2455,4911,2455,0,1,2457,23786,0.023786
2855,6805,3365,22898825,2,22846,5713,1,415473400,415473400,8566,2855,5711,2855,0,1,2857,1337770,1.33777
3255,6805,3365,22898825,2,26046,6513,1,448017400,448017400,9766,3255,6511,3255,0,1,3257,410969,0.410969
3655,6805,3365,22898825,2,29246,7313,1,480561400,480561400,10966,3655,7311,3655,0,1,3657,1805813,1.805813
4055,6805,3365,22898825,2,32446,8113,1,513105400,513105400,12166,4055,8111,4055,0,1,4057,304345,0.304345
4455,6805,3365,22898825,2,35646,8913,1,545649400,545649400,13366,4455,8911,4455,0,1,4457,3826644,3.826644
4855,6805,3365,22898825,2,38846,9713,1,578193400,578193400,14566,4855,9711,4855,0,1,4857,1203992,1.203992
5255,6805,3365,22898825,2,42046,10513,1,610737400,610737400,15766,5255,10511,5255,0,1,5257,635623,0.635623
5655,6805,3365,22898825,2,45246,11313,1,643281400,643281400,16966,5655,11311,5655,0,1,5657,1976759,1.976759
6055,6805,3365,22898825,2,48446,12113,1,675825400,675825400,18166,6055,12111,6055,0,1,6057,1907134,1.907134
6455,6805,3365,22898825,2,51646,12913,1,708369400,708369400,19366,6455,12911,6455,0,1,6457,4131317,4.131317
6855,6805,3365,22898825,2,54846,13713,1,740913400,740913400,20566,6855,13711,6855,0,1,6857,2049389,2.049389
40,3300,6940,22902000,2,326,83,1,186492800,186492800,121,40,81,40,0,1,42,422100,0.4221
440,3300,6940,22902000,2,3526,883,1,219260800,219260800,1321,440,881,440,0,1,442,1289103,1.289103
840,3300,6940,22902000,2,6726,1683,1,252028800,252028800,2521,840,1681,840,0,1,842,609928,0.609928
1240,3300,6940,22902000,2,9926,2483,1,284796800,284796800,3721,1240,2481,1240,0,1,1242,1659568,1.659568
1640,3300,6940,22902000,2,13126,3283,1,317564800,317564800,4921,1640,3281,1640,0,1,1642,3840974,3.840974
2040,3300,6940,22902000,2,16326,4083,1,350332800,350332800,6121,2040,4081,2040,0,1,2042,623793,0.623793
2440,3300,6940,22902000,2,19526,4883,1,383100800,383100800,7321,2440,4881,2440,0,1,2442,57751,0.057751
2840,3300,6940,22902000,2,22726,5683,1,415868800,415868800,8521,2840,5681,2840,0,1,2842,3175628,3.175628
3240,3300,6940,22902000,2,25926,6483,1,448636800,448636800,9721,3240,6481,3240,0,1,3242,56923,0.056923
3640,3300,6940,22902000,2,29126,7283,1,481404800,481404800,10921,3640,7281,3640,0,1,3642,577192,0.577192
4040,3300,6940,22902000,2,32326,8083,1,514172800,514172800,12121,4040,8081,4040,0,1,4042,455306,0.455306
4440,3300,6940,22902000,2,35526,8883,1,546940800,546940800,13321,4440,8881,4440,0,1,4442,809616,0.809616
4840,3300,6940,22902000,2,38726,9683,1,579708800,579708800,14521,4840,9681,4840,0,1,4842,599611,0.599611
5240,3300,6940,22902000,2,41926,10483,1,612476800,612476800,15721,5240,10481,5240,0,1,5242,1315613,1.315613
5640,3300,6940,22902000,2,45126,11283,1,645244800,645244800,16921,5640,11281,5640,0,1,5642,194521,0.194521
6040,3300,6940,22902000,2,48326,12083,1,678012800,678012800,18121,6040,12081,6040,0,1,6042,409395,0.409395
6440,3300,6940,22902000,2,51526,12883,1,710780800,710780800,19321,6440,12881,6440,0,1,6442,397247,0.397247
6840,3300,6940,22902000,2,54726,13683,1,743548800,743548800,20521,6840,13681,6840,0,1,6842,1824147,1.824147
40,5050,4540,22927000,2,326,83,1,186484800,186484800,121,40,81,40,0,1,42,16007,0.016007
440,5050,4540,22927000,2,3526,883,1,217172800,217172800,1321,440,881,440,0,1,442,58822,0.058822
840,5050,4540,22927000,2,6726,1683,1,247860800,247860800,2521,840,1681,840,0,1,842,36228,0.036228
1240,5050,4540,22927000,2,9926,2483,1,278548800,278548800,3721,1240,2481,1240,0,1,1242,268557,0.268557
1640,5050,4540,22927000,2,13126,3283,1,309236800,309236800,4921,1640,3281,1640,0,1,1642,38945,0.038945
2040,5050,4540,22927000,2,16326,4083,1,339924800,339924800,6121,2040,4081,2040,0,1,2042,552341,0.552341
2440,5050,4540,22927000,2,19526,4883,1,370612800,370612800,7321,2440,4881,2440,0,1,2442,147013,0.147013
2840,5050,4540,22927000,2,22726,5683,1,401300800,401300800,8521,2840,5681,2840,0,1,2842,2197271,2.197271
3240,5050,4540,22927000,2,25926,6483,1,431988800,431988800,9721,3240,6481,3240,0,1,3242,104699,0.104699
3640,5050,4540,22927000,2,29126,7283,1,462676800,462676800,10921,3640,7281,3640,0,1,3642,655868,0.655868
4040,5050,4540,22927000,2,32326,8083,1,493364800,493364800,12121,4040,8081,4040,0,1,4042,1351308,1.351308
4440,5050,4540,22927000,2,35526,8883,1,524052800,524052800,13321,4440,8881,4440,0,1,4442,126583,0.126583
4840,5050,4540,22927000,2,38726,9683,1,554740800,554740800,14521,4840,9681,4840,0,1,4842,144984,0.144984
5240,5050,4540,22927000,2,41926,10483,1,585428800,585428800,15721,5240,10481,5240,0,1,5242,2015614,2.015614
5640,5050,4540,22927000,2,45126,11283,1,616116800,616116800,16921,5640,11281,5640,0,1,5642,1559205,1.559205
6040,5050,4540,22927000,2,48326,12083,1,646804800,646804800,18121,6040,12081,6040,0,1,6042,4757490,4.75749
6440,5050,4540,22927000,2,51526,12883,1,677492800,677492800,19321,6440,12881,6440,0,1,6442,1370208,1.370208
6840,5050,4540,22927000,2,54726,13683,1,708180800,708180800,20521,6840,13681,6840,0,1,6842,1862274,1.862274
40,6300,3640,22932000,2,326,83,1,186636800,186636800,121,40,81,40,0,1,42,421392,0.421392
440,6300,3640,22932000,2,3526,883,1,218444800,218444800,1321,440,881,440,0,1,442,2026255,2.026255
840,6300,3640,22932000,2,6726,1683,1,250252800,250252800,2521,840,1681,840,0,1,842,183409,0.183409
1240,6300,3640,22932000,2,9926,2483,1,282060800,282060800,3721,1240,2481,1240,0,1,1242,2309062,2.309062
1640,6300,3640,22932000,2,13126,3283,1,313868800,313868800,4921,1640,3281,1640,0,1,1642,2275418,2.275418
2040,6300,3640,22932000,2,16326,4083,1,345676800,345676800,6121,2040,4081,2040,0,1,2042,1602481,1.602481
2440,6300,3640,22932000,2,19526,4883,1,377484800,377484800,7321,2440,4881,2440,0,1,2442,8040400,8.0404
2840,6300,3640,22932000,2,22726,5683,1,409292800,409292800,8521,2840,5681,2840,0,1,2842,2962669,2.962669
3240,6300,3640,22932000,2,25926,6483,1,441100800,441100800,9721,3240,6481,3240,0,1,3242,323192,0.323192
3640,6300,3640,22932000,2,29126,7283,1,472908800,472908800,10921,3640,7281,3640,0,1,3642,6320920,6.32092
4040,6300,3640,22932000,2,32326,8083,1,504716800,504716800,12121,4040,8081,4040,0,1,4042,8446367,8.446367
4440,6300,3640,22932000,2,35526,8883,1,536524800,536524800,13321,4440,8881,4440,0,1,4442,4170922,4.170922
4840,6300,3640,22932000,2,38726,9683,1,568332800,568332800,14521,4840,9681,4840,0,1,4842,6079800,6.0798
5240,6300,3640,22932000,2,41926,10483,1,600140800,600140800,15721,5240,10481,5240,0,1,5242,2433261,2.433261
5640,6300,3640,22932000,2,45126,11283,1,631948800,631948800,16921,5640,11281,5640,0,1,5642,4278660,4.27866
6040,6300,3640,22932000,2,48326,12083,1,663756800,663756800,18121,6040,12081,6040,0,1,6042,5145988,5.145988
6440,6300,3640,22932000,2,51526,12883,1,695564800,695564800,19321,6440,12881,6440,0,1,6442,20631358,20.631358
6840,6300,3640,22932000,2,54726,13683,1,727372800,727372800,20521,6840,13681,6840,0,1,6842,21778947,21.778947
40,3800,6040,22952000,2,326,83,1,186764800,186764800,121,40,81,40,0,1,42,409444,0.409444
440,3800,6040,22952000,2,3526,883,1,218252800,218252800,1321,440,881,440,0,1,442,762763,0.762763
840,3800,6040,22952000,2,6726,1683,1,249740800,249740800,2521,840,1681,840,0,1,842,625103,0.625103
1240,3800,6040,22952000,2,9926,2483,1,281228800,281228800,3721,1240,2481,1240,0,1,1242,453656,0.453656
1640,3800,6040,22952000,2,13126,3283,1,312716800,312716800,4921,1640,3281,1640,0,1,1642,1391137,1.391137
2040,3800,6040,22952000,2,16326,4083,1,344204800,344204800,6121,2040,4081,2040,0,1,2042,3859434,3.859434
2440,3800,6040,22952000,2,19526,4883,1,375692800,375692800,7321,2440,4881,2440,0,1,2442,5321809,5.321809
2840,3800,6040,22952000,2,22726,5683,1,407180800,407180800,8521,2840,5681,2840,0,1,2842,2637125,2.637125
3240,3800,6040,22952000,2,25926,6483,1,438668800,438668800,9721,3240,6481,3240,0,1,3242,1721937,1.721937
3640,3800,6040,22952000,2,29126,7283,1,470156800,470156800,10921,3640,7281,3640,0,1,3642,3451185,3.451185
4040,3800,6040,22952000,2,32326,8083,1,501644800,501644800,12121,4040,8081,4040,0,1,4042,691393,0.691393
4440,3800,6040,22952000,2,35526,8883,1,533132800,533132800,13321,4440,8881,4440,0,1,4442,411470,0.41147
4840,3800,6040,22952000,2,38726,9683,1,564620800,564620800,14521,4840,9681,4840,0,1,4842,1583467,1.583467
5240,3800,6040,22952000,2,41926,10483,1,596108800,596108800,15721,5240,10481,5240,0,1,5242,308871,0.308871
5640,3800,6040,22952000,2,45126,11283,1,627596800,627596800,16921,5640,11281,5640,0,1,5642,1089345,1.089345
6040,3800,6040,22952000,2,48326,12083,1,659084800,659084800,18121,6040,12081,6040,0,1,6042,3544167,3.544167
6440,3800,6040,22952000,2,51526,12883,1,690572800,690572800,19321,6440,12881,6440,0,1,6442,1326014,1.326014
6840,3800,6040,22952000,2,54726,13683,1,722060800,722060800,20521,6840,13681,6840,0,1,6842,645596,0.645596
55,5805,3965,23016825,2,446,113,1,188433400,188433400,166,55,111,55,0,1,57,61843,0.061843
455,5805,3965,23016825,2,3646,913,1,219697400,219697400,1366,455,911,455,0,1,457,60076,0.060076
855,5805,3965,23016825,2,6846,1713,1,250961400,250961400,2566,855,1711,855,0,1,857,167615,0.167615
1255,5805,3965,23016825,2,10046,2513,1,282225400,282225400,3766,1255,2511,1255,0,1,1257,587499,0.587499
1655,5805,3965,23016825,2,13246,3313,1,313489400,313489400,4966,1655,3311,1655,0,1,1657,1325960,1.32596
2055,5805,3965,23016825,2,16446,4113,1,344753400,344753400,6166,2055,4111,2055,0,1,2057,35915,0.035915
2455,5805,3965,23016825,2,19646,4913,1,376017400,376017400,7366,2455,4911,2455,0,1,2457,26994,0.026994
2855,5805,3965,23016825,2,22846,5713,1,407281400,407281400,8566,2855,5711,2855,0,1,2857,3051196,3.051196
3255,5805,3965,23016825,2,26046,6513,1,438545400,438545400,9766,3255,6511,3255,0,1,3257,768790,0.76879
3655,5805,3965,23016825,2,29246,7313,1,469809400,469809400,10966,3655,7311,3655,0,1,3657,347962,0.347962
4055,5805,3965,23016825,2,32446,8113,1,501073400,501073400,12166,4055,8111,4055,0,1,4057,1712334,1.712334
4455,5805,3965,23016825,2,35646,8913,1,532337400,532337400,13366,4455,8911,4455,0,1,4457,389325,0.389325
4855,5805,3965,23016825,2,38846,9713,1,563601400,563601400,14566,4855,9711,4855,0,1,4857,1141470,1.14147
5255,5805,3965,23016825,2,42046,10513,1,594865400,594865400,15766,5255,10511,5255,0,1,5257,950,0.00095
5655,5805,3965,23016825,2,45246,11313,1,626129400,626129400,16966,5655,11311,5655,0,1,5657,6278521,6.278521
6055,5805,3965,23016825,2,48446,12113,1,657393400,657393400,18166,6055,12111,6055,0,1,6057,843756,0.843756
6455,5805,3965,23016825,2,51646,12913,1,688657400,688657400,19366,6455,12911,6455,0,1,6457,425860,0.42586
6855,5805,3965,23016825,2,54846,13713,1,719921400,719921400,20566,6855,13711,6855,0,1,6857,2038923,2.038923
55,3305,6965,23019325,2,446,113,1,188673400,188673400,166,55,111,55,0,1,57,413748,0.413748
455,3305,6965,23019325,2,3646,913,1,221537400,221537400,1366,455,911,455,0,1,457,892982,0.892982
855,3305,6965,23019325,2,6846,1713,1,254401400,254401400,2566,855,1711,855,0,1,857,751024,0.751024
1255,3305,6965,23019325,2,10046,2513,1,287265400,287265400,3766,1255,2511,1255,0,1,1257,596875,0.596875
1655,3305,6965,23019325,2,13246,3313,1,320129400,320129400,4966,1655,3311,1655,0,1,1657,1198289,1.198289
2055,3305,6965,23019325,2,16446,4113,1,352993400,352993400,6166,2055,4111,2055,0,1,2057,386692,0.386692
2455,3305,6965,23019325,2,19646,4913,1,385857400,385857400,7366,2455,4911,2455,0,1,2457,645101,0.645101
2855,3305,6965,23019325,2,22846,5713,1,418721400,418721400,8566,2855,5711,2855,0,1,2857,1643128,1.643128
3255,3305,6965,23019325,2,26046,6513,1,451585400,451585400,9766,3255,6511,3255,0,1,3257,3943779,3.943779
3655,3305,6965,23019325,2,29246,7313,1,484449400,484449400,10966,3655,7311,3655,0,1,3657,167895,0.167895
4055,3305,6965,23019325,2,32446,8113,1,517313400,517313400,12166,4055,8111,4055,0,1,4057,376888,0.376888
4455,3305,6965,23019325,2,35646,8913,1,550177400,550177400,13366,4455,8911,4455,0,1,4457,1188229,1.188229
4855,3305,6965,23019325,2,38846,9713,1,583041400,583041400,14566,4855,9711,4855,0,1,4857,678680,0.67868
5255,3305,6965,23019325,2,42046,10513,1,615905400,615905400,15766,5255,10511,5255,0,1,5257,1473527,1.473527
5655,3305,6965,23019325,2,45246,11313,1,648769400,648769400,16966,5655,11311,5655,0,1,5657,138408,0.138408
6055,3305,6965,23019325,2,48446,12113,1,681633400,681633400,18166,6055,12111,6055,0,1,6057,3219703,3.219703
6455,3305,6965,23019325,2,51646,12913,1,714497400,714497400,19366,6455,12911,6455,0,1,6457,2527670,2.52767
6855,3305,6965,23019325,2,54846,13713,1,747361400,747361400,20566,6855,13711,6855,0,1,6857,827349,0.827349
55,5055,4565,23076075,2,446,113,1,188841400,188841400,166,55,111,55,0,1,57,16843,0.016843
455,5055,4565,23076075,2,3646,913,1,219625400,219625400,1366,455,911,455,0,1,457,16644,0.016644
855,5055,4565,23076075,2,6846,1713,1,250409400,250409400,2566,855,1711,855,0,1,857,117484,0.117484
1255,5055,4565,23076075,2,10046,2513,1,281193400,281193400,3766,1255,2511,1255,0,1,1257,180638,0.180638
1655,5055,4565,23076075,2,13246,3313,1,311977400,311977400,4966,1655,3311,1655,0,1,1657,257636,0.257636
2055,5055,4565,23076075,2,16446,4113,1,342761400,342761400,6166,2055,4111,2055,0,1,2057,547336,0.547336
2455,5055,4565,23076075,2,19646,4913,1,373545400,373545400,7366,2455,4911,2455,0,1,2457,453224,0.453224
2855,5055,4565,23076075,2,22846,5713,1,404329400,404329400,8566,2855,5711,2855,0,1,2857,458337,0.458337
3255,5055,4565,23076075,2,26046,6513,1,435113400,435113400,9766,3255,6511,3255,0,1,3257,498357,0.498357
3655,5055,4565,23076075,2,29246,7313,1,465897400,465897400,10966,3655,7311,3655,0,1,3657,19061,0.019061
4055,5055,4565,23076075,2,32446,8113,1,496681400,496681400,12166,4055,8111,4055,0,1,4057,597916,0.597916
4455,5055,4565,23076075,2,35646,8913,1,527465400,527465400,13366,4455,8911,4455,0,1,4457,1360360,1.36036
4855,5055,4565,23076075,2,38846,9713,1,558249400,558249400,14566,4855,9711,4855,0,1,4857,656263,0.656263
5255,5055,4565,23076075,2,42046,10513,1,589033400,589033400,15766,5255,10511,5255,0,1,5257,4032720,4.03272
5655,5055,4565,23076075,2,45246,11313,1,619817400,619817400,16966,5655,11311,5655,0,1,5657,404326,0.404326
6055,5055,4565,23076075,2,48446,12113,1,650601400,650601400,18166,6055,12111,6055,0,1,6057,2722903,2.722903
6455,5055,4565,23076075,2,51646,12913,1,681385400,681385400,19366,6455,12911,6455,0,1,6457,710962,0.710962
6855,5055,4565,23076075,2,54846,13713,1,712169400,712169400,20566,6855,13711,6855,0,1,6857,1501376,1.501376
55,3805,6065,23077325,2,446,113,1,188961400,188961400,166,55,111,55,0,1,57,470581,0.470581
455,3805,6065,23077325,2,3646,913,1,220545400,220545400,1366,455,911,455,0,1,457,2231134,2.231134
855,3805,6065,23077325,2,6846,1713,1,252129400,252129400,2566,855,1711,855,0,1,857,3480649,3.480649
1255,3805,6065,23077325,2,10046,2513,1,283713400,283713400,3766,1255,2511,1255,0,1,1257,857804,0.857804
1655,3805,6065,23077325,2,13246,3313,1,315297400,315297400,4966,1655,3311,1655,0,1,1657,533545,0.533545
2055,3805,6065,23077325,2,16446,4113,1,346881400,346881400,6166,2055,4111,2055,0,1,2057,819200,0.8192
2455,3805,6065,23077325,2,19646,4913,1,378465400,378465400,7366,2455,4911,2455,0,1,2457,1920439,1.920439
2855,3805,6065,23077325,2,22846,5713,1,410049400,410049400,8566,2855,5711,2855,0,1,2857,5050852,5.050852
3255,3805,6065,23077325,2,26046,6513,1,441633400,441633400,9766,3255,6511,3255,0,1,3257,7448882,7.448882
3655,3805,6065,23077325,2,29246,7313,1,473217400,473217400,10966,3655,7311,3655,0,1,3657,6272142,6.272142
4055,3805,6065,23077325,2,32446,8113,1,504801400,504801400,12166,4055,8111,4055,0,1,4057,1453731,1.453731
4455,3805,6065,23077325,2,35646,8913,1,536385400,536385400,13366,4455,8911,4455,0,1,4457,8115029,8.115029
4855,3805,6065,23077325,2,38846,9713,1,567969400,567969400,14566,4855,9711,4855,0,1,4857,1904857,1.904857
5255,3805,6065,23077325,2,42046,10513,1,599553400,599553400,15766,5255,10511,5255,0,1,5257,4604409,4.604409
5655,3805,6065,23077325,2,45246,11313,1,631137400,631137400,16966,5655,11311,5655,0,1,5657,2462496,2.462496
6055,3805,6065,23077325,2,48446,12113,1,662721400,662721400,18166,6055,12111,6055,0,1,6057,331229,0.331229
6455,3805,6065,23077325,2,51646,12913,1,694305400,694305400,19366,6455,12911,6455,0,1,6457,4361251,4.361251
6855,3805,6065,23077325,2,54846,13713,1,725889400,725889400,20566,6855,13711,6855,0,1,6857,1716356,1.716356
55,6305,3665,23107825,2,446,113,1,189249400,189249400,166,55,111,55,0,1,57,302659,0.302659
455,6305,3665,23107825,2,3646,913,1,221153400,221153400,1366,455,911,455,0,1,457,530042,0.530042
855,6305,3665,23107825,2,6846,1713,1,253057400,253057400,2566,855,1711,855,0,1,857,3895594,3.895594
1255,6305,3665,23107825,2,10046,2513,1,284961400,284961400,3766,1255,2511,1255,0,1,1257,5632901,5.632901
1655,6305,3665,23107825,2,13246,3313,1,316865400,316865400,4966,1655,3311,1655,0,1,1657,4475809,4.475809
2055,6305,3665,23107825,2,16446,4113,1,348769400,348769400,6166,2055,4111,2055,0,1,2057,146810,0.14681
2455,6305,3665,23107825,2,19646,4913,1,380673400,380673400,7366,2455,4911,2455,0,1,2457,10855595,10.855595
2855,6305,3665,23107825,2,22846,5713,1,412577400,412577400,8566,2855,5711,2855,0,1,2857,878839,0.878839
3255,6305,3665,23107825,2,26046,6513,1,444481400,444481400,9766,3255,6511,3255,0,1,3257,6504807,6.504807
3655,6305,3665,23107825,2,29246,7313,1,476385400,476385400,10966,3655,7311,3655,0,1,3657,1858421,1.858421
4055,6305,3665,23107825,2,32446,8113,1,508289400,508289400,12166,4055,8111,4055,0,1,4057,457428,0.457428
4455,6305,3665,23107825,2,35646,8913,1,540193400,540193400,13366,4455,8911,4455,0,1,4457,2208365,2.208365
4855,6305,3665,23107825,2,38846,9713,1,572097400,572097400,14566,4855,9711,4855,0,1,4857,3611263,3.611263
5255,6305,3665,23107825,2,42046,10513,1,604001400,604001400,15766,5255,10511,5255,0,1,5257,2362652,2.362652
5655,6305,3665,23107825,2,45246,11313,1,635905400,635905400,16966,5655,11311,5655,0,1,5657,10929088,10.929088
6055,6305,3665,23107825,2,48446,12113,1,667809400,667809400,18166,6055,12111,6055,0,1,6057,4108244,4.108244
6455,6305,3665,23107825,2,51646,12913,1,699713400,699713400,19366,6455,12911,6455,0,1,6457,1873556,1.873556
6855,6305,3665,23107825,2,54846,13713,1,731617400,731617400,20566,6855,13711,6855,0,1,6857,13610867,13.610867
40,4800,4840,23232000,2,326,83,1,188940800,188940800,121,40,81,40,0,1,42,416763,0.416763
440,4800,4840,23232000,2,3526,883,1,219788800,219788800,1321,440,881,440,0,1,442,748475,0.748475
840,4800,4840,23232000,2,6726,1683,1,250636800,250636800,2521,840,1681,840,0,1,842,3274136,3.274136
1240,4800,4840,23232000,2,9926,2483,1,281484800,281484800,3721,1240,2481,1240,0,1,1242,5262586,5.262586
1640,4800,4840,23232000,2,13126,3283,1,312332800,312332800,4921,1640,3281,1640,0,1,1642,5213444,5.213444
2040,4800,4840,23232000,2,16326,4083,1,343180800,343180800,6121,2040,4081,2040,0,1,2042,4541571,4.541571
2440,4800,4840,23232000,2,19526,4883,1,374028800,374028800,7321,2440,4881,2440,0,1,2442,5140311,5.140311
2840,4800,4840,23232000,2,22726,5683,1,404876800,404876800,8521,2840,5681,2840,0,1,2842,12163932,12.163932
3240,4800,4840,23232000,2,25926,6483,1,435724800,435724800,9721,3240,6481,3240,0,1,3242,1031159,1.031159
3640,4800,4840,23232000,2,29126,7283,1,466572800,466572800,10921,3640,7281,3640,0,1,3642,593766,0.593766
4040,4800,4840,23232000,2,32326,8083,1,497420800,497420800,12121,4040,8081,4040,0,1,4042,383819,0.383819
4440,4800,4840,23232000,2,35526,8883,1,528268800,528268800,13321,4440,8881,4440,0,1,4442,4355099,4.355099
4840,4800,4840,23232000,2,38726,9683,1,559116800,559116800,14521,4840,9681,4840,0,1,4842,6649648,6.649648
5240,4800,4840,23232000,2,41926,10483,1,589964800,589964800,15721,5240,10481,5240,0,1,5242,5851855,5.851855
5640,4800,4840,23232000,2,45126,11283,1,620812800,620812800,16921,5640,11281,5640,0,1,5642,1236694,1.236694
6040,4800,4840,23232000,2,48326,12083,1,651660800,651660800,18121,6040,12081,6040,0,1,6042,16299516,16.299516
6440,4800,4840,23232000,2,51526,12883,1,682508800,682508800,19321,6440,12881,6440,0,1,6442,13747121,13.747121
6840,4800,4840,23232000,2,54726,13683,1,713356800,713356800,20521,6840,13681,6840,0,1,6842,12216844,12.216844
40,4050,5740,23247000,2,326,83,1,189108800,189108800,121,40,81,40,0,1,42,41892,0.041892
440,4050,5740,23247000,2,3526,883,1,220436800,220436800,1321,440,881,440,0,1,442,101005,0.101005
840,4050,5740,23247000,2,6726,1683,1,251764800,251764800,2521,840,1681,840,0,1,842,38121,0.038121
1240,4050,5740,23247000,2,9926,2483,1,283092800,283092800,3721,1240,2481,1240,0,1,1242,107182,0.107182
1640,4050,5740,23247000,2,13126,3283,1,314420800,314420800,4921,1640,3281,1640,0,1,1642,22492,0.022492
2040,4050,5740,23247000,2,16326,4083,1,345748800,345748800,6121,2040,4081,2040,0,1,2042,1722526,1.722526
2440,4050,5740,23247000,2,19526,4883,1,377076800,377076800,7321,2440,4881,2440,0,1,2442,241301,0.241301
2840,4050,5740,23247000,2,22726,5683,1,408404800,408404800,8521,2840,5681,2840,0,1,2842,1724898,1.724898
3240,4050,5740,23247000,2,25926,6483,1,439732800,439732800,9721,3240,6481,3240,0,1,3242,824158,0.824158
3640,4050,5740,23247000,2,29126,7283,1,471060800,471060800,10921,3640,7281,3640,0,1,3642,898208,0.898208
4040,4050,5740,23247000,2,32326,8083,1,502388800,502388800,12121,4040,8081,4040,0,1,4042,2230631,2.230631
4440,4050,5740,23247000,2,35526,8883,1,533716800,533716800,13321,4440,8881,4440,0,1,4442,48277,0.048277
4840,4050,5740,23247000,2,38726,9683,1,565044800,565044800,14521,4840,9681,4840,0,1,4842,1144060,1.14406
5240,4050,5740,23247000,2,41926,10483,1,596372800,596372800,15721,5240,10481,5240,0,1,5242,1732071,1.732071
5640,4050,5740,23247000,2,45126,11283,1,627700800,627700800,16921,5640,11281,5640,0,1,5642,3736988,3.736988
6040,4050,5740,23247000,2,48326,12083,1,659028800,659028800,18121,6040,12081,6040,0,1,6042,1249636,1.249636
6440,4050,5740,23247000,2,51526,12883,1,690356800,690356800,19321,6440,12881,6440,0,1,6442,118504,0.118504
6840,4050,5740,23247000,2,54726,13683,1,721684800,721684800,20521,6840,13681,6840,0,1,6842,1015428,1.015428
55,4805,4865,23376325,2,446,113,1,191265400,191265400,166,55,111,55,0,1,57,472486,0.472486
455,4805,4865,23376325,2,3646,913,1,222209400,222209400,1366,455,911,455,0,1,457,2173915,2.173915
855,4805,4865,23376325,2,6846,1713,1,253153400,253153400,2566,855,1711,855,0,1,857,3183284,3.183284
1255,4805,4865,23376325,2,10046,2513,1,284097400,284097400,3766,1255,2511,1255,0,1,1257,1527021,1.527021
1655,4805,4865,23376325,2,13246,3313,1,315041400,315041400,4966,1655,3311,1655,0,1,1657,3141865,3.141865
2055,4805,4865,23376325,2,16446,4113,1,345985400,345985400,6166,2055,4111,2055,0,1,2057,9073465,9.073465
2455,4805,4865,23376325,2,19646,4913,1,376929400,376929400,7366,2455,4911,2455,0,1,2457,4785849,4.785849
2855,4805,4865,23376325,2,22846,5713,1,407873400,407873400,8566,2855,5711,2855,0,1,2857,3623765,3.623765
3255,4805,4865,23376325,2,26046,6513,1,438817400,438817400,9766,3255,6511,3255,0,1,3257,4319378,4.319378
3655,4805,4865,23376325,2,29246,7313,1,469761400,469761400,10966,3655,7311,3655,0,1,3657,6269152,6.269152
4055,4805,4865,23376325,2,32446,8113,1,500705400,500705400,12166,4055,8111,4055,0,1,4057,953086,0.953086
4455,4805,4865,23376325,2,35646,8913,1,531649400,531649400,13366,4455,8911,4455,0,1,4457,3861117,3.861117
4855,4805,4865,23376325,2,38846,9713,1,562593400,562593400,14566,4855,9711,4855,0,1,4857,994827,0.994827
5255,4805,4865,23376325,2,42046,10513,1,593537400,593537400,15766,5255,10511,5255,0,1,5257,4252075,4.252075
5655,4805,4865,23376325,2,45246,11313,1,624481400,624481400,16966,5655,11311,5655,0,1,5657,1719395,1.719395
6055,4805,4865,23376325,2,48446,12113,1,655425400,655425400,18166,6055,12111,6055,0,1,6057,1480227,1.480227
6455,4805,4865,23376325,2,51646,12913,1,686369400,686369400,19366,6455,12911,6455,0,1,6457,9378800,9.3788
6855,4805,4865,23376325,2,54846,13713,1,717313400,717313400,20566,6855,13711,6855,0,1,6857,6878140,6.87814
55,4055,5765,23377075,2,446,113,1,191337400,191337400,166,55,111,55,0,1,57,115027,0.115027
455,4055,5765,23377075,2,3646,913,1,222761400,222761400,1366,455,911,455,0,1,457,61748,0.061748
855,4055,5765,23377075,2,6846,1713,1,254185400,254185400,2566,855,1711,855,0,1,857,189155,0.189155
1255,4055,5765,23377075,2,10046,2513,1,285609400,285609400,3766,1255,2511,1255,0,1,1257,468357,0.468357
1655,4055,5765,23377075,2,13246,3313,1,317033400,317033400,4966,1655,3311,1655,0,1,1657,454124,0.454124
2055,4055,5765,23377075,2,16446,4113,1,348457400,348457400,6166,2055,4111,2055,0,1,2057,162563,0.162563
2455,4055,5765,23377075,2,19646,4913,1,379881400,379881400,7366,2455,4911,2455,0,1,2457,329384,0.329384
2855,4055,5765,23377075,2,22846,5713,1,411305400,411305400,8566,2855,5711,2855,0,1,2857,1785928,1.785928
3255,4055,5765,23377075,2,26046,6513,1,442729400,442729400,9766,3255,6511,3255,0,1,3257,172437,0.172437
3655,4055,5765,23377075,2,29246,7313,1,474153400,474153400,10966,3655,7311,3655,0,1,3657,1153856,1.153856
4055,4055,5765,23377075,2,32446,8113,1,505577400,505577400,12166,4055,8111,4055,0,1,4057,25443,0.025443
4455,4055,5765,23377075,2,35646,8913,1,537001400,537001400,13366,4455,8911,4455,0,1,4457,211238,0.211238
4855,4055,5765,23377075,2,38846,9713,1,568425400,568425400,14566,4855,9711,4855,0,1,4857,915058,0.915058
5255,4055,5765,23377075,2,42046,10513,1,599849400,599849400,15766,5255,10511,5255,0,1,5257,608008,0.608008
5655,4055,5765,23377075,2,45246,11313,1,631273400,631273400,16966,5655,11311,5655,0,1,5657,2860351,2.860351
6055,4055,5765,23377075,2,48446,12113,1,662697400,662697400,18166,6055,12111,6055,0,1,6057,1768561,1.768561
6455,4055,5765,23377075,2,51646,12913,1,694121400,694121400,19366,6455,12911,6455,0,1,6457,2905738,2.905738
6855,4055,5765,23377075,2,54846,13713,1,725545400,725545400,20566,6855,13711,6855,0,1,6857,3014729,3.014729
40,4550,5140,23387000,2,326,83,1,190196800,190196800,121,40,81,40,0,1,42,427320,0.42732
440,4550,5140,23387000,2,3526,883,1,221204800,221204800,1321,440,881,440,0,1,442,149512,0.149512
840,4550,5140,23387000,2,6726,1683,1,252212800,252212800,2521,840,1681,840,0,1,842,3333892,3.333892
1240,4550,5140,23387000,2,9926,2483,1,283220800,283220800,3721,1240,2481,1240,0,1,1242,5515225,5.515225
1640,4550,5140,23387000,2,13126,3283,1,314228800,314228800,4921,1640,3281,1640,0,1,1642,6410196,6.410196
2040,4550,5140,23387000,2,16326,4083,1,345236800,345236800,6121,2040,4081,2040,0,1,2042,1294900,1.2949
2440,4550,5140,23387000,2,19526,4883,1,376244800,376244800,7321,2440,4881,2440,0,1,2442,3180184,3.180184
2840,4550,5140,23387000,2,22726,5683,1,407252800,407252800,8521,2840,5681,2840,0,1,2842,1743778,1.743778
3240,4550,5140,23387000,2,25926,6483,1,438260800,438260800,9721,3240,6481,3240,0,1,3242,4223069,4.223069
3640,4550,5140,23387000,2,29126,7283,1,469268800,469268800,10921,3640,7281,3640,0,1,3642,179360,0.17936
4040,4550,5140,23387000,2,32326,8083,1,500276800,500276800,12121,4040,8081,4040,0,1,4042,1750123,1.750123
4440,4550,5140,23387000,2,35526,8883,1,531284800,531284800,13321,4440,8881,4440,0,1,4442,1325973,1.325973
4840,4550,5140,23387000,2,38726,9683,1,562292800,562292800,14521,4840,9681,4840,0,1,4842,2998288,2.998288
5240,4550,5140,23387000,2,41926,10483,1,593300800,593300800,15721,5240,10481,5240,0,1,5242,2039906,2.039906
5640,4550,5140,23387000,2,45126,11283,1,624308800,624308800,16921,5640,11281,5640,0,1,5642,1234591,1.234591
6040,4550,5140,23387000,2,48326,12083,1,655316800,655316800,18121,6040,12081,6040,0,1,6042,412837,0.412837
6440,4550,5140,23387000,2,51526,12883,1,686324800,686324800,19321,6440,12881,6440,0,1,6442,4111455,4.111455
6840,4550,5140,23387000,2,54726,13683,1,717332800,717332800,20521,6840,13681,6840,0,1,6842,1311088,1.311088
40,4300,5440,23392000,2,326,83,1,190252800,190252800,121,40,81,40,0,1,42,418320,0.41832
440,4300,5440,23392000,2,3526,883,1,221420800,221420800,1321,440,881,440,0,1,442,231506,0.231506
840,4300,5440,23392000,2,6726,1683,1,252588800,252588800,2521,840,1681,840,0,1,842,546069,0.546069
1240,4300,5440,23392000,2,9926,2483,1,283756800,283756800,3721,1240,2481,1240,0,1,1242,658724,0.658724
1640,4300,5440,23392000,2,13126,3283,1,314924800,314924800,4921,1640,3281,1640,0,1,1642,2637303,2.637303
2040,4300,5440,23392000,2,16326,4083,1,346092800,346092800,6121,2040,4081,2040,0,1,2042,971360,0.97136
2440,4300,5440,23392000,2,19526,4883,1,377260800,377260800,7321,2440,4881,2440,0,1,2442,118245,0.118245
2840,4300,5440,23392000,2,22726,5683,1,408428800,408428800,8521,2840,5681,2840,0,1,2842,1281827,1.281827
3240,4300,5440,23392000,2,25926,6483,1,439596800,439596800,9721,3240,6481,3240,0,1,3242,2582785,2.582785
3640,4300,5440,23392000,2,29126,7283,1,470764800,470764800,10921,3640,7281,3640,0,1,3642,29331,0.029331
4040,4300,5440,23392000,2,32326,8083,1,501932800,501932800,12121,4040,8081,4040,0,1,4042,998243,0.998243
4440,4300,5440,23392000,2,35526,8883,1,533100800,533100800,13321,4440,8881,4440,0,1,4442,216092,0.216092
4840,4300,5440,23392000,2,38726,9683,1,564268800,564268800,14521,4840,9681,4840,0,1,4842,3055084,3.055084
5240,4300,5440,23392000,2,41926,10483,1,595436800,595436800,15721,5240,10481,5240,0,1,5242,1944266,1.944266
5640,4300,5440,23392000,2,45126,11283,1,626604800,626604800,16921,5640,11281,5640,0,1,5642,3157718,3.157718
6040,4300,5440,23392000,2,48326,12083,1,657772800,657772800,18121,6040,12081,6040,0,1,6042,141430,0.14143
6440,4300,5440,23392000,2,51526,12883,1,688940800,688940800,19321,6440,12881,6440,0,1,6442,737770,0.73777
6840,4300,5440,23392000,2,54726,13683,1,720108800,720108800,20521,6840,13681,6840,0,1,6842,2621313,2.621313
35,6600,3545,23397000,2,286,73,1,190016600,190016600,106,35,71,35,0,1,37,66667,0.066667
535,6600,3545,23397000,2,4286,1073,1,230596600,230596600,1606,535,1071,535,0,1,537,413900,0.4139
1035,6600,3545,23397000,2,8286,2073,1,271176600,271176600,3106,1035,2071,1035,0,1,1037,979618,0.979618
1535,6600,3545,23397000,2,12286,3073,1,311756600,311756600,4606,1535,3071,1535,0,1,1537,1792538,1.792538
2035,6600,3545,23397000,2,16286,4073,1,352336600,352336600,6106,2035,4071,2035,0,1,2037,1999122,1.999122
2535,6600,3545,23397000,2,20286,5073,1,392916600,392916600,7606,2535,5071,2535,0,1,2537,845562,0.845562
3035,6600,3545,23397000,2,24286,6073,1,433496600,433496600,9106,3035,6071,3035,0,1,3037,3844702,3.844702
3535,6600,3545,23397000,2,28286,7073,1,474076600,474076600,10606,3535,7071,3535,0,1,3537,1226000,1.226
4035,6600,3545,23397000,2,32286,8073,1,514656600,514656600,12106,4035,8071,4035,0,1,4037,5630422,5.630422
4535,6600,3545,23397000,2,36286,9073,1,555236600,555236600,13606,4535,9071,4535,0,1,4537,11484658,11.484658
5035,6600,3545,23397000,2,40286,10073,1,595816600,595816600,15106,5035,10071,5035,0,1,5037,3521936,3.521936
5535,6600,3545,23397000,2,44286,11073,1,636396600,636396600,16606,5535,11071,5535,0,1,5537,119458,0.119458
6035,6600,3545,23397000,2,48286,12073,1,676976600,676976600,18106,6035,12071,6035,0,1,6037,701056,0.701056
6535,6600,3545,23397000,2,52286,13073,1,717556600,717556600,19606,6535,13071,6535,0,1,6537,1911819,1.911819
7035,6600,3545,23397000,2,56286,14073,1,758136600,758136600,21106,7035,14071,7035,0,1,7037,6390653,6.390653
39,3893,6041,23517613,2,318,81,1,191240312,191240312,118,39,79,39,0,1,41,201348,0.201348
539,3893,6041,23517613,2,4318,1081,1,230976312,230976312,1618,539,1079,539,0,1,541,2630648,2.630648
1039,3893,6041,23517613,2,8318,2081,1,270712312,270712312,3118,1039,2079,1039,0,1,1041,2113710,2.11371
1539,3893,6041,23517613,2,12318,3081,1,310448312,310448312,4618,1539,3079,1539,0,1,1541,1325182,1.325182
2039,3893,6041,23517613,2,16318,4081,1,350184312,350184312,6118,2039,4079,2039,0,1,2041,518133,0.518133
2539,3893,6041,23517613,2,20318,5081,1,389920312,389920312,7618,2539,5079,2539,0,1,2541,3567999,3.567999
3039,3893,6041,23517613,2,24318,6081,1,429656312,429656312,9118,3039,6079,3039,0,1,3041,8995618,8.995618
3539,3893,6041,23517613,2,28318,7081,1,469392312,469392312,10618,3539,7079,3539,0,1,3541,608586,0.608586
4039,3893,6041,23517613,2,32318,8081,1,509128312,509128312,12118,4039,8079,4039,0,1,4041,2231732,2.231732
4539,3893,6041,23517613,2,36318,9081,1,548864312,548864312,13618,4539,9079,4539,0,1,4541,6617020,6.61702
5039,3893,6041,23517613,2,40318,10081,1,588600312,588600312,15118,5039,10079,5039,0,1,5041,3423838,3.423838
5539,3893,6041,23517613,2,44318,11081,1,628336312,628336312,16618,5539,11079,5539,0,1,5541,2612063,2.612063
6039,3893,6041,23517613,2,48318,12081,1,668072312,668072312,18118,6039,12079,6039,0,1,6041,5913834,5.913834
6539,3893,6041,23517613,2,52318,13081,1,707808312,707808312,19618,6539,13079,6539,0,1,6541,6623302,6.623302
7039,3893,6041,23517613,2,56318,14081,1,747544312,747544312,21118,7039,14079,7039,0,1,7041,24302198,24.302198
39,6643,3541,23522863,2,318,81,1,191360312,191360312,118,39,79,39,0,1,41,46348,0.046348
539,6643,3541,23522863,2,4318,1081,1,232096312,232096312,1618,539,1079,539,0,1,541,51701,0.051701
1039,6643,3541,23522863,2,8318,2081,1,272832312,272832312,3118,1039,2079,1039,0,1,1041,279015,0.279015
1539,6643,3541,23522863,2,12318,3081,1,313568312,313568312,4618,1539,3079,1539,0,1,1541,354817,0.354817
2039,6643,3541,23522863,2,16318,4081,1,354304312,354304312,6118,2039,4079,2039,0,1,2041,2664006,2.664006
2539,6643,3541,23522863,2,20318,5081,1,395040312,395040312,7618,2539,5079,2539,0,1,2541,2806577,2.806577
3039,6643,3541,23522863,2,24318,6081,1,435776312,435776312,9118,3039,6079,3039,0,1,3041,149919,0.149919
3539,6643,3541,23522863,2,28318,7081,1,476512312,476512312,10618,3539,7079,3539,0,1,3541,786025,0.786025
4039,6643,3541,23522863,2,32318,8081,1,517248312,517248312,12118,4039,8079,4039,0,1,4041,1223366,1.223366
4539,6643,3541,23522863,2,36318,9081,1,557984312,557984312,13618,4539,9079,4539,0,1,4541,836427,0.836427
5039,6643,3541,23522863,2,40318,10081,1,598720312,598720312,15118,5039,10079,5039,0,1,5041,1090231,1.090231
5539,6643,3541,23522863,2,44318,11081,1,639456312,639456312,16618,5539,11079,5539,0,1,5541,652524,0.652524
6039,6643,3541,23522863,2,48318,12081,1,680192312,680192312,18118,6039,12079,6039,0,1,6041,3350910,3.35091
6539,6643,3541,23522863,2,52318,13081,1,720928312,720928312,19618,6539,13079,6539,0,1,6541,5344573,5.344573
7039,6643,3541,23522863,2,56318,14081,1,761664312,761664312,21118,7039,14079,7039,0,1,7041,4006380,4.00638
55,4555,5165,23526575,2,446,113,1,192489400,192489400,166,55,111,55,0,1,57,481423,0.481423
455,4555,5165,23526575,2,3646,913,1,223593400,223593400,1366,455,911,455,0,1,457,2185247,2.185247
855,4555,5165,23526575,2,6846,1713,1,254697400,254697400,2566,855,1711,855,0,1,857,993534,0.993534
1255,4555,5165,23526575,2,10046,2513,1,285801400,285801400,3766,1255,2511,1255,0,1,1257,1531995,1.531995
1655,4555,5165,23526575,2,13246,3313,1,316905400,316905400,4966,1655,3311,1655,0,1,1657,570603,0.570603
2055,4555,5165,23526575,2,16446,4113,1,348009400,348009400,6166,2055,4111,2055,0,1,2057,4078646,4.078646
2455,4555,5165,23526575,2,19646,4913,1,379113400,379113400,7366,2455,4911,2455,0,1,2457,1875213,1.875213
2855,4555,5165,23526575,2,22846,5713,1,410217400,410217400,8566,2855,5711,2855,0,1,2857,4350857,4.350857
3255,4555,5165,23526575,2,26046,6513,1,441321400,441321400,9766,3255,6511,3255,0,1,3257,785920,0.78592
3655,4555,5165,23526575,2,29246,7313,1,472425400,472425400,10966,3655,7311,3655,0,1,3657,1302655,1.302655
4055,4555,5165,23526575,2,32446,8113,1,503529400,503529400,12166,4055,8111,4055,0,1,4057,4946725,4.946725
4455,4555,5165,23526575,2,35646,8913,1,534633400,534633400,13366,4455,8911,4455,0,1,4457,1003209,1.003209
4855,4555,5165,23526575,2,38846,9713,1,565737400,565737400,14566,4855,9711,4855,0,1,4857,2575997,2.575997
5255,4555,5165,23526575,2,42046,10513,1,596841400,596841400,15766,5255,10511,5255,0,1,5257,612155,0.612155
5655,4555,5165,23526575,2,45246,11313,1,627945400,627945400,16966,5655,11311,5655,0,1,5657,61922,0.061922
6055,4555,5165,23526575,2,48446,12113,1,659049400,659049400,18166,6055,12111,6055,0,1,6057,233317,0.233317
6455,4555,5165,23526575,2,51646,12913,1,690153400,690153400,19366,6455,12911,6455,0,1,6457,311357,0.311357
6855,4555,5165,23526575,2,54846,13713,1,721257400,721257400,20566,6855,13711,6855,0,1,6857,4182755,4.182755
55,4305,5465,23526825,2,446,113,1,192513400,192513400,166,55,111,55,0,1,57,472319,0.472319
455,4305,5465,23526825,2,3646,913,1,223777400,223777400,1366,455,911,455,0,1,457,616228,0.616228
855,4305,5465,23526825,2,6846,1713,1,255041400,255041400,2566,855,1711,855,0,1,857,426045,0.426045
1255,4305,5465,23526825,2,10046,2513,1,286305400,286305400,3766,1255,2511,1255,0,1,1257,27256,0.027256
1655,4305,5465,23526825,2,13246,3313,1,317569400,317569400,4966,1655,3311,1655,0,1,1657,3987606,3.987606
2055,4305,5465,23526825,2,16446,4113,1,348833400,348833400,6166,2055,4111,2055,0,1,2057,381365,0.381365
2455,4305,5465,23526825,2,19646,4913,1,380097400,380097400,7366,2455,4911,2455,0,1,2457,1265602,1.265602
2855,4305,5465,23526825,2,22846,5713,1,411361400,411361400,8566,2855,5711,2855,0,1,2857,522402,0.522402
3255,4305,5465,23526825,2,26046,6513,1,442625400,442625400,9766,3255,6511,3255,0,1,3257,5593905,5.593905
3655,4305,5465,23526825,2,29246,7313,1,473889400,473889400,10966,3655,7311,3655,0,1,3657,2656622,2.656622
4055,4305,5465,23526825,2,32446,8113,1,505153400,505153400,12166,4055,8111,4055,0,1,4057,1280855,1.280855
4455,4305,5465,23526825,2,35646,8913,1,536417400,536417400,13366,4455,8911,4455,0,1,4457,241824,0.241824
4855,4305,5465,23526825,2,38846,9713,1,567681400,567681400,14566,4855,9711,4855,0,1,4857,583860,0.58386
5255,4305,5465,23526825,2,42046,10513,1,598945400,598945400,15766,5255,10511,5255,0,1,5257,748880,0.74888
5655,4305,5465,23526825,2,45246,11313,1,630209400,630209400,16966,5655,11311,5655,0,1,5657,488516,0.488516
6055,4305,5465,23526825,2,48446,12113,1,661473400,661473400,18166,6055,12111,6055,0,1,6057,530115,0.530115
6455,4305,5465,23526825,2,51646,12913,1,692737400,692737400,19366,6455,12911,6455,0,1,6457,2179004,2.179004
6855,4305,5465,23526825,2,54846,13713,1,724001400,724001400,20566,6855,13711,6855,0,1,6857,968756,0.968756
35,3340,7045,23530300,2,286,73,1,191150200,191150200,106,35,71,35,0,1,37,413772,0.413772
535,3340,7045,23530300,2,4286,1073,1,232690200,232690200,1606,535,1071,535,0,1,537,2530105,2.530105
1035,3340,7045,23530300,2,8286,2073,1,274230200,274230200,3106,1035,2071,1035,0,1,1037,4726889,4.726889
1535,3340,7045,23530300,2,12286,3073,1,315770200,315770200,4606,1535,3071,1535,0,1,1537,6919125,6.919125
2035,3340,7045,23530300,2,16286,4073,1,357310200,357310200,6106,2035,4071,2035,0,1,2037,9088702,9.088702
40,5550,4240,23532000,2,326,83,1,191388800,191388800,121,40,81,40,0,1,42,425696,0.425696
440,5550,4240,23532000,2,3526,883,1,222716800,222716800,1321,440,881,440,0,1,442,265954,0.265954
840,5550,4240,23532000,2,6726,1683,1,254044800,254044800,2521,840,1681,840,0,1,842,467938,0.467938
1240,5550,4240,23532000,2,9926,2483,1,285372800,285372800,3721,1240,2481,1240,0,1,1242,2268334,2.268334
1640,5550,4240,23532000,2,13126,3283,1,316700800,316700800,4921,1640,3281,1640,0,1,1642,1986550,1.98655
2040,5550,4240,23532000,2,16326,4083,1,348028800,348028800,6121,2040,4081,2040,0,1,2042,1116051,1.116051
2440,5550,4240,23532000,2,19526,4883,1,379356800,379356800,7321,2440,4881,2440,0,1,2442,2330003,2.330003
2840,5550,4240,23532000,2,22726,5683,1,410684800,410684800,8521,2840,5681,2840,0,1,2842,1949208,1.949208
3240,5550,4240,23532000,2,25926,6483,1,442012800,442012800,9721,3240,6481,3240,0,1,3242,3346877,3.346877
3640,5550,4240,23532000,2,29126,7283,1,473340800,473340800,10921,3640,7281,3640,0,1,3642,9228495,9.228495
4040,5550,4240,23532000,2,32326,8083,1,504668800,504668800,12121,4040,8081,4040,0,1,4042,2210365,2.210365
4440,5550,4240,23532000,2,35526,8883,1,535996800,535996800,13321,4440,8881,4440,0,1,4442,37566,0.037566
4840,5550,4240,23532000,2,38726,9683,1,567324800,567324800,14521,4840,9681,4840,0,1,4842,1368928,1.368928
5240,5550,4240,23532000,2,41926,10483,1,598652800,598652800,15721,5240,10481,5240,0,1,5242,1051185,1.051185
5640,5550,4240,23532000,2,45126,11283,1,629980800,629980800,16921,5640,11281,5640,0,1,5642,4185684,4.185684
6040,5550,4240,23532000,2,48326,12083,1,661308800,661308800,18121,6040,12081,6040,0,1,6042,7015232,7.015232
6440,5550,4240,23532000,2,51526,12883,1,692636800,692636800,19321,6440,12881,6440,0,1,6442,2766250,2.76625
6840,5550,4240,23532000,2,54726,13683,1,723964800,723964800,20521,6840,13681,6840,0,1,6842,5609026,5.609026
39,3343,7041,23538063,2,318,81,1,191544312,191544312,118,39,79,39,0,1,41,117310,0.11731
539,3343,7041,23538063,2,4318,1081,1,233080312,233080312,1618,539,1079,539,0,1,541,29587,0.029587
1039,3343,7041,23538063,2,8318,2081,1,274616312,274616312,3118,1039,2079,1039,0,1,1041,382404,0.382404
1539,3343,7041,23538063,2,12318,3081,1,316152312,316152312,4618,1539,3079,1539,0,1,1541,607270,0.60727
2039,3343,7041,23538063,2,16318,4081,1,357688312,357688312,6118,2039,4079,2039,0,1,2041,1401382,1.401382
2539,3343,7041,23538063,2,20318,5081,1,399224312,399224312,7618,2539,5079,2539,0,1,2541,212087,0.212087
3039,3343,7041,23538063,2,24318,6081,1,440760312,440760312,9118,3039,6079,3039,0,1,3041,1323149,1.323149
3539,3343,7041,23538063,2,28318,7081,1,482296312,482296312,10618,3539,7079,3539,0,1,3541,23667,0.023667
4039,3343,7041,23538063,2,32318,8081,1,523832312,523832312,12118,4039,8079,4039,0,1,4041,193654,0.193654
4539,3343,7041,23538063,2,36318,9081,1,565368312,565368312,13618,4539,9079,4539,0,1,4541,509325,0.509325
5039,3343,7041,23538063,2,40318,10081,1,606904312,606904312,15118,5039,10079,5039,0,1,5041,2148374,2.148374
5539,3343,7041,23538063,2,44318,11081,1,648440312,648440312,16618,5539,11079,5539,0,1,5541,606228,0.606228
6039,3343,7041,23538063,2,48318,12081,1,689976312,689976312,18118,6039,12079,6039,0,1,6041,511073,0.511073
6539,3343,7041,23538063,2,52318,13081,1,731512312,731512312,19618,6539,13079,6539,0,1,6541,742248,0.742248
7039,3343,7041,23538063,2,56318,14081,1,773048312,773048312,21118,7039,14079,7039,0,1,7041,4531545,4.531545
40,7050,3340,23547000,2,326,83,1,191700800,191700800,121,40,81,40,0,1,42,415582,0.415582
440,7050,3340,23547000,2,3526,883,1,224948800,224948800,1321,440,881,440,0,1,442,1237876,1.237876
840,7050,3340,23547000,2,6726,1683,1,258196800,258196800,2521,840,1681,840,0,1,842,4000956,4.000956
1240,7050,3340,23547000,2,9926,2483,1,291444800,291444800,3721,1240,2481,1240,0,1,1242,5811804,5.811804
1640,7050,3340,23547000,2,13126,3283,1,324692800,324692800,4921,1640,3281,1640,0,1,1642,3513293,3.513293
2040,7050,3340,23547000,2,16326,4083,1,357940800,357940800,6121,2040,4081,2040,0,1,2042,1575332,1.575332
2440,7050,3340,23547000,2,19526,4883,1,391188800,391188800,7321,2440,4881,2440,0,1,2442,2761490,2.76149
2840,7050,3340,23547000,2,22726,5683,1,424436800,424436800,8521,2840,5681,2840,0,1,2842,8611228,8.611228
3240,7050,3340,23547000,2,25926,6483,1,457684800,457684800,9721,3240,6481,3240,0,1,3242,4781471,4.781471
3640,7050,3340,23547000,2,29126,7283,1,490932800,490932800,10921,3640,7281,3640,0,1,3642,8556096,8.556096
4040,7050,3340,23547000,2,32326,8083,1,524180800,524180800,12121,4040,8081,4040,0,1,4042,197889,0.197889
4440,7050,3340,23547000,2,35526,8883,1,557428800,557428800,13321,4440,8881,4440,0,1,4442,5704546,5.704546
4840,7050,3340,23547000,2,38726,9683,1,590676800,590676800,14521,4840,9681,4840,0,1,4842,18858234,18.858234
5240,7050,3340,23547000,2,41926,10483,1,623924800,623924800,15721,5240,10481,5240,0,1,5242,20497562,20.497562
5640,7050,3340,23547000,2,45126,11283,1,657172800,657172800,16921,5640,11281,5640,0,1,5642,25905847,25.905847
6040,7050,3340,23547000,2,48326,12083,1,690420800,690420800,18121,6040,12081,6040,0,1,6042,27839559,27.839559
6440,7050,3340,23547000,2,51526,12883,1,723668800,723668800,19321,6440,12881,6440,0,1,6442,29625242,29.625242
6840,7050,3340,23547000,2,54726,13683,1,756916800,756916800,20521,6840,13681,6840,0,1,6842,31501115,31.501115
40,3550,6640,23572000,2,326,83,1,191836800,191836800,121,40,81,40,0,1,42,425051,0.425051
440,3550,6640,23572000,2,3526,883,1,224444800,224444800,1321,440,881,440,0,1,442,479729,0.479729
840,3550,6640,23572000,2,6726,1683,1,257052800,257052800,2521,840,1681,840,0,1,842,2507372,2.507372
1240,3550,6640,23572000,2,9926,2483,1,289660800,289660800,3721,1240,2481,1240,0,1,1242,370865,0.370865
1640,3550,6640,23572000,2,13126,3283,1,322268800,322268800,4921,1640,3281,1640,0,1,1642,583420,0.58342
2040,3550,6640,23572000,2,16326,4083,1,354876800,354876800,6121,2040,4081,2040,0,1,2042,309689,0.309689
2440,3550,6640,23572000,2,19526,4883,1,387484800,387484800,7321,2440,4881,2440,0,1,2442,1522725,1.522725
2840,3550,6640,23572000,2,22726,5683,1,420092800,420092800,8521,2840,5681,2840,0,1,2842,1286434,1.286434
3240,3550,6640,23572000,2,25926,6483,1,452700800,452700800,9721,3240,6481,3240,0,1,3242,2860837,2.860837
3640,3550,6640,23572000,2,29126,7283,1,485308800,485308800,10921,3640,7281,3640,0,1,3642,6479595,6.479595
4040,3550,6640,23572000,2,32326,8083,1,517916800,517916800,12121,4040,8081,4040,0,1,4042,3307534,3.307534
4440,3550,6640,23572000,2,35526,8883,1,550524800,550524800,13321,4440,8881,4440,0,1,4442,687048,0.687048
4840,3550,6640,23572000,2,38726,9683,1,583132800,583132800,14521,4840,9681,4840,0,1,4842,1708487,1.708487
5240,3550,6640,23572000,2,41926,10483,1,615740800,615740800,15721,5240,10481,5240,0,1,5242,2845210,2.84521
5640,3550,6640,23572000,2,45126,11283,1,648348800,648348800,16921,5640,11281,5640,0,1,5642,4339327,4.339327
6040,3550,6640,23572000,2,48326,12083,1,680956800,680956800,18121,6040,12081,6040,0,1,6042,5563515,5.563515
6440,3550,6640,23572000,2,51526,12883,1,713564800,713564800,19321,6440,12881,6440,0,1,6442,7187800,7.1878
6840,3550,6640,23572000,2,54726,13683,1,746172800,746172800,20521,6840,13681,6840,0,1,6842,4268199,4.268199
44,3903,6055,23632665,2,358,91,1,192566536,192566536,133,44,89,44,0,1,46,247933,0.247933
544,3903,6055,23632665,2,4358,1091,1,232398536,232398536,1633,544,1089,544,0,1,546,1530750,1.53075
1044,3903,6055,23632665,2,8358,2091,1,272230536,272230536,3133,1044,2089,1044,0,1,1046,4091200,4.0912
1544,3903,6055,23632665,2,12358,3091,1,312062536,312062536,4633,1544,3089,1544,0,1,1546,1692999,1.692999
2044,3903,6055,23632665,2,16358,4091,1,351894536,351894536,6133,2044,4089,2044,0,1,2046,3344630,3.34463
2544,3903,6055,23632665,2,20358,5091,1,391726536,391726536,7633,2544,5089,2544,0,1,2546,1765180,1.76518
3044,3903,6055,23632665,2,24358,6091,1,431558536,431558536,9133,3044,6089,3044,0,1,3046,204990,0.20499
3544,3903,6055,23632665,2,28358,7091,1,471390536,471390536,10633,3544,7089,3544,0,1,3546,1780296,1.780296
4044,3903,6055,23632665,2,32358,8091,1,511222536,511222536,12133,4044,8089,4044,0,1,4046,3713287,3.713287
4544,3903,6055,23632665,2,36358,9091,1,551054536,551054536,13633,4544,9089,4544,0,1,4546,138655,0.138655
5044,3903,6055,23632665,2,40358,10091,1,590886536,590886536,15133,5044,10089,5044,0,1,5046,1570977,1.570977
5544,3903,6055,23632665,2,44358,11091,1,630718536,630718536,16633,5544,11089,5544,0,1,5546,8275633,8.275633
6044,3903,6055,23632665,2,48358,12091,1,670550536,670550536,18133,6044,12089,6044,0,1,6046,8816875,8.816875
6544,3903,6055,23632665,2,52358,13091,1,710382536,710382536,19633,6544,13089,6544,0,1,6546,11626560,11.62656
7044,3903,6055,23632665,2,56358,14091,1,750214536,750214536,21133,7044,14089,7044,0,1,7046,3403809,3.403809
44,6653,3555,23651415,2,358,91,1,192804536,192804536,133,44,89,44,0,1,46,18974,0.018974
544,6653,3555,23651415,2,4358,1091,1,233636536,233636536,1633,544,1089,544,0,1,546,55495,0.055495
1044,6653,3555,23651415,2,8358,2091,1,274468536,274468536,3133,1044,2089,1044,0,1,1046,72181,0.072181
1544,6653,3555,23651415,2,12358,3091,1,315300536,315300536,4633,1544,3089,1544,0,1,1546,550575,0.550575
2044,6653,3555,23651415,2,16358,4091,1,356132536,356132536,6133,2044,4089,2044,0,1,2046,2439614,2.439614
2544,6653,3555,23651415,2,20358,5091,1,396964536,396964536,7633,2544,5089,2544,0,1,2546,134326,0.134326
3044,6653,3555,23651415,2,24358,6091,1,437796536,437796536,9133,3044,6089,3044,0,1,3046,2004331,2.004331
3544,6653,3555,23651415,2,28358,7091,1,478628536,478628536,10633,3544,7089,3544,0,1,3546,1334420,1.33442
4044,6653,3555,23651415,2,32358,8091,1,519460536,519460536,12133,4044,8089,4044,0,1,4046,394940,0.39494
4544,6653,3555,23651415,2,36358,9091,1,560292536,560292536,13633,4544,9089,4544,0,1,4546,747368,0.747368
5044,6653,3555,23651415,2,40358,10091,1,601124536,601124536,15133,5044,10089,5044,0,1,5046,342948,0.342948
5544,6653,3555,23651415,2,44358,11091,1,641956536,641956536,16633,5544,11089,5544,0,1,5546,3963211,3.963211
6044,6653,3555,23651415,2,48358,12091,1,682788536,682788536,18133,6044,12089,6044,0,1,6046,2830776,2.830776
6544,6653,3555,23651415,2,52358,13091,1,723620536,723620536,19633,6544,13089,6544,0,1,6546,2939528,2.939528
7044,6653,3555,23651415,2,56358,14091,1,764452536,764452536,21133,7044,14089,7044,0,1,7046,764898,0.764898
44,3353,7055,23655415,2,358,91,1,192906936,192906936,133,44,89,44,0,1,46,22599,0.022599
544,3353,7055,23655415,2,4358,1091,1,234538936,234538936,1633,544,1089,544,0,1,546,350789,0.350789
1044,3353,7055,23655415,2,8358,2091,1,276170936,276170936,3133,1044,2089,1044,0,1,1046,69373,0.069373
1544,3353,7055,23655415,2,12358,3091,1,317802936,317802936,4633,1544,3089,1544,0,1,1546,251777,0.251777
2044,3353,7055,23655415,2,16358,4091,1,359434936,359434936,6133,2044,4089,2044,0,1,2046,654604,0.654604
2544,3353,7055,23655415,2,20358,5091,1,401066936,401066936,7633,2544,5089,2544,0,1,2546,69680,0.06968
3044,3353,7055,23655415,2,24358,6091,1,442698936,442698936,9133,3044,6089,3044,0,1,3046,89594,0.089594
3544,3353,7055,23655415,2,28358,7091,1,484330936,484330936,10633,3544,7089,3544,0,1,3546,3052203,3.052203
4044,3353,7055,23655415,2,32358,8091,1,525962936,525962936,12133,4044,8089,4044,0,1,4046,277262,0.277262
4544,3353,7055,23655415,2,36358,9091,1,567594936,567594936,13633,4544,9089,4544,0,1,4546,2430596,2.430596
5044,3353,7055,23655415,2,40358,10091,1,609226936,609226936,15133,5044,10089,5044,0,1,5046,71808,0.071808
5544,3353,7055,23655415,2,44358,11091,1,650858936,650858936,16633,5544,11089,5544,0,1,5546,2595506,2.595506
6044,3353,7055,23655415,2,48358,12091,1,692490936,692490936,18133,6044,12089,6044,0,1,6046,4293014,4.293014
6544,3353,7055,23655415,2,52358,13091,1,734122936,734122936,19633,6544,13089,6544,0,1,6546,881527,0.881527
7044,3353,7055,23655415,2,56358,14091,1,775754936,775754936,21133,7044,14089,7044,0,1,7046,1397001,1.397001
55,5555,4265,23692075,2,446,113,1,193857400,193857400,166,55,111,55,0,1,57,488035,0.488035
455,5555,4265,23692075,2,3646,913,1,225281400,225281400,1366,455,911,455,0,1,457,1384722,1.384722
855,5555,4265,23692075,2,6846,1713,1,256705400,256705400,2566,855,1711,855,0,1,857,4020578,4.020578
1255,5555,4265,23692075,2,10046,2513,1,288129400,288129400,3766,1255,2511,1255,0,1,1257,2154267,2.154267
1655,5555,4265,23692075,2,13246,3313,1,319553400,319553400,4966,1655,3311,1655,0,1,1657,3276968,3.276968
2055,5555,4265,23692075,2,16446,4113,1,350977400,350977400,6166,2055,4111,2055,0,1,2057,519291,0.519291
2455,5555,4265,23692075,2,19646,4913,1,382401400,382401400,7366,2455,4911,2455,0,1,2457,2298481,2.298481
2855,5555,4265,23692075,2,22846,5713,1,413825400,413825400,8566,2855,5711,2855,0,1,2857,979348,0.979348
3255,5555,4265,23692075,2,26046,6513,1,445249400,445249400,9766,3255,6511,3255,0,1,3257,3017173,3.017173
3655,5555,4265,23692075,2,29246,7313,1,476673400,476673400,10966,3655,7311,3655,0,1,3657,734536,0.734536
4055,5555,4265,23692075,2,32446,8113,1,508097400,508097400,12166,4055,8111,4055,0,1,4057,2654164,2.654164
4455,5555,4265,23692075,2,35646,8913,1,539521400,539521400,13366,4455,8911,4455,0,1,4457,6023307,6.023307
4855,5555,4265,23692075,2,38846,9713,1,570945400,570945400,14566,4855,9711,4855,0,1,4857,110166,0.110166
5255,5555,4265,23692075,2,42046,10513,1,602369400,602369400,15766,5255,10511,5255,0,1,5257,4592884,4.592884
5655,5555,4265,23692075,2,45246,11313,1,633793400,633793400,16966,5655,11311,5655,0,1,5657,673264,0.673264
6055,5555,4265,23692075,2,48446,12113,1,665217400,665217400,18166,6055,12111,6055,0,1,6057,6819995,6.819995
6455,5555,4265,23692075,2,51646,12913,1,696641400,696641400,19366,6455,12911,6455,0,1,6457,1903905,1.903905
6855,5555,4265,23692075,2,54846,13713,1,728065400,728065400,20566,6855,13711,6855,0,1,6857,3206633,3.206633
55,3555,6665,23694075,2,446,113,1,194049400,194049400,166,55,111,55,0,1,57,476949,0.476949
455,3555,6665,23694075,2,3646,913,1,226753400,226753400,1366,455,911,455,0,1,457,1603808,1.603808
855,3555,6665,23694075,2,6846,1713,1,259457400,259457400,2566,855,1711,855,0,1,857,2263761,2.263761
1255,3555,6665,23694075,2,10046,2513,1,292161400,292161400,3766,1255,2511,1255,0,1,1257,2856496,2.856496
1655,3555,6665,23694075,2,13246,3313,1,324865400,324865400,4966,1655,3311,1655,0,1,1657,810588,0.810588
2055,3555,6665,23694075,2,16446,4113,1,357569400,357569400,6166,2055,4111,2055,0,1,2057,517269,0.517269
2455,3555,6665,23694075,2,19646,4913,1,390273400,390273400,7366,2455,4911,2455,0,1,2457,306920,0.30692
2855,3555,6665,23694075,2,22846,5713,1,422977400,422977400,8566,2855,5711,2855,0,1,2857,736336,0.736336
3255,3555,6665,23694075,2,26046,6513,1,455681400,455681400,9766,3255,6511,3255,0,1,3257,494053,0.494053
3655,3555,6665,23694075,2,29246,7313,1,488385400,488385400,10966,3655,7311,3655,0,1,3657,3866214,3.866214
4055,3555,6665,23694075,2,32446,8113,1,521089400,521089400,12166,4055,8111,4055,0,1,4057,1988361,1.988361
4455,3555,6665,23694075,2,35646,8913,1,553793400,553793400,13366,4455,8911,4455,0,1,4457,3462536,3.462536
4855,3555,6665,23694075,2,38846,9713,1,586497400,586497400,14566,4855,9711,4855,0,1,4857,815144,0.815144
5255,3555,6665,23694075,2,42046,10513,1,619201400,619201400,15766,5255,10511,5255,0,1,5257,5302977,5.302977
5655,3555,6665,23694075,2,45246,11313,1,651905400,651905400,16966,5655,11311,5655,0,1,5657,3587068,3.587068
6055,3555,6665,23694075,2,48446,12113,1,684609400,684609400,18166,6055,12111,6055,0,1,6057,4202067,4.202067
6455,3555,6665,23694075,2,51646,12913,1,717313400,717313400,19366,6455,12911,6455,0,1,6457,1899889,1.899889
6855,3555,6665,23694075,2,54846,13713,1,750017400,750017400,20566,6855,13711,6855,0,1,6857,9823002,9.823002
55,7055,3365,23740075,2,446,113,1,194505400,194505400,166,55,111,55,0,1,57,479017,0.479017
455,7055,3365,23740075,2,3646,913,1,227849400,227849400,1366,455,911,455,0,1,457,2266916,2.266916
855,7055,3365,23740075,2,6846,1713,1,261193400,261193400,2566,855,1711,855,0,1,857,4086442,4.086442
1255,7055,3365,23740075,2,10046,2513,1,294537400,294537400,3766,1255,2511,1255,0,1,1257,4529433,4.529433
1655,7055,3365,23740075,2,13246,3313,1,327881400,327881400,4966,1655,3311,1655,0,1,1657,3238343,3.238343
2055,7055,3365,23740075,2,16446,4113,1,361225400,361225400,6166,2055,4111,2055,0,1,2057,4852603,4.852603
2455,7055,3365,23740075,2,19646,4913,1,394569400,394569400,7366,2455,4911,2455,0,1,2457,11382669,11.382669
2855,7055,3365,23740075,2,22846,5713,1,427913400,427913400,8566,2855,5711,2855,0,1,2857,6974579,6.974579
3255,7055,3365,23740075,2,26046,6513,1,461257400,461257400,9766,3255,6511,3255,0,1,3257,196029,0.196029
3655,7055,3365,23740075,2,29246,7313,1,494601400,494601400,10966,3655,7311,3655,0,1,3657,8737306,8.737306
4055,7055,3365,23740075,2,32446,8113,1,527945400,527945400,12166,4055,8111,4055,0,1,4057,7056650,7.05665
4455,7055,3365,23740075,2,35646,8913,1,561289400,561289400,13366,4455,8911,4455,0,1,4457,20614354,20.614354
4855,7055,3365,23740075,2,38846,9713,1,594633400,594633400,14566,4855,9711,4855,0,1,4857,2948072,2.948072
5255,7055,3365,23740075,2,42046,10513,1,627977400,627977400,15766,5255,10511,5255,0,1,5257,4794237,4.794237
5655,7055,3365,23740075,2,45246,11313,1,661321400,661321400,16966,5655,11311,5655,0,1,5657,15803373,15.803373
6055,7055,3365,23740075,2,48446,12113,1,694665400,694665400,18166,6055,12111,6055,0,1,6057,28283126,28.283126
6455,7055,3365,23740075,2,51646,12913,1,728009400,728009400,19366,6455,12911,6455,0,1,6457,30082356,30.082356
6855,7055,3365,23740075,2,54846,13713,1,761353400,761353400,20566,6855,13711,6855,0,1,6857,32109532,32.109532
40,6050,3940,23837000,2,326,83,1,193892800,193892800,121,40,81,40,0,1,42,421628,0.421628
440,6050,3940,23837000,2,3526,883,1,225860800,225860800,1321,440,881,440,0,1,442,2134579,2.134579
840,6050,3940,23837000,2,6726,1683,1,257828800,257828800,2521,840,1681,840,0,1,842,3857809,3.857809
1240,6050,3940,23837000,2,9926,2483,1,289796800,289796800,3721,1240,2481,1240,0,1,1242,187181,0.187181
1640,6050,3940,23837000,2,13126,3283,1,321764800,321764800,4921,1640,3281,1640,0,1,1642,1621577,1.621577
2040,6050,3940,23837000,2,16326,4083,1,353732800,353732800,6121,2040,4081,2040,0,1,2042,3066525,3.066525
2440,6050,3940,23837000,2,19526,4883,1,385700800,385700800,7321,2440,4881,2440,0,1,2442,3654710,3.65471
2840,6050,3940,23837000,2,22726,5683,1,417668800,417668800,8521,2840,5681,2840,0,1,2842,3544050,3.54405
3240,6050,3940,23837000,2,25926,6483,1,449636800,449636800,9721,3240,6481,3240,0,1,3242,59913,0.059913
3640,6050,3940,23837000,2,29126,7283,1,481604800,481604800,10921,3640,7281,3640,0,1,3642,1448215,1.448215
4040,6050,3940,23837000,2,32326,8083,1,513572800,513572800,12121,4040,8081,4040,0,1,4042,247654,0.247654
4440,6050,3940,23837000,2,35526,8883,1,545540800,545540800,13321,4440,8881,4440,0,1,4442,3284390,3.28439
4840,6050,3940,23837000,2,38726,9683,1,577508800,577508800,14521,4840,9681,4840,0,1,4842,673861,0.673861
5240,6050,3940,23837000,2,41926,10483,1,609476800,609476800,15721,5240,10481,5240,0,1,5242,487068,0.487068
5640,6050,3940,23837000,2,45126,11283,1,641444800,641444800,16921,5640,11281,5640,0,1,5642,3366125,3.366125
6040,6050,3940,23837000,2,48326,12083,1,673412800,673412800,18121,6040,12081,6040,0,1,6042,11769778,11.769778
6440,6050,3940,23837000,2,51526,12883,1,705380800,705380800,19321,6440,12881,6440,0,1,6442,6652669,6.652669
6840,6050,3940,23837000,2,54726,13683,1,737348800,737348800,20521,6840,13681,6840,0,1,6842,373313,0.373313
40,6550,3640,23842000,2,326,83,1,193996800,193996800,121,40,81,40,0,1,42,17844,0.017844
440,6550,3640,23842000,2,3526,883,1,226604800,226604800,1321,440,881,440,0,1,442,65250,0.06525
840,6550,3640,23842000,2,6726,1683,1,259212800,259212800,2521,840,1681,840,0,1,842,38438,0.038438
1240,6550,3640,23842000,2,9926,2483,1,291820800,291820800,3721,1240,2481,1240,0,1,1242,404082,0.404082
1640,6550,3640,23842000,2,13126,3283,1,324428800,324428800,4921,1640,3281,1640,0,1,1642,320978,0.320978
2040,6550,3640,23842000,2,16326,4083,1,357036800,357036800,6121,2040,4081,2040,0,1,2042,744483,0.744483
2440,6550,3640,23842000,2,19526,4883,1,389644800,389644800,7321,2440,4881,2440,0,1,2442,302291,0.302291
2840,6550,3640,23842000,2,22726,5683,1,422252800,422252800,8521,2840,5681,2840,0,1,2842,119833,0.119833
3240,6550,3640,23842000,2,25926,6483,1,454860800,454860800,9721,3240,6481,3240,0,1,3242,1647743,1.647743
3640,6550,3640,23842000,2,29126,7283,1,487468800,487468800,10921,3640,7281,3640,0,1,3642,204977,0.204977
4040,6550,3640,23842000,2,32326,8083,1,520076800,520076800,12121,4040,8081,4040,0,1,4042,141130,0.14113
4440,6550,3640,23842000,2,35526,8883,1,552684800,552684800,13321,4440,8881,4440,0,1,4442,665944,0.665944
4840,6550,3640,23842000,2,38726,9683,1,585292800,585292800,14521,4840,9681,4840,0,1,4842,332633,0.332633
5240,6550,3640,23842000,2,41926,10483,1,617900800,617900800,15721,5240,10481,5240,0,1,5242,259622,0.259622
5640,6550,3640,23842000,2,45126,11283,1,650508800,650508800,16921,5640,11281,5640,0,1,5642,602779,0.602779
6040,6550,3640,23842000,2,48326,12083,1,683116800,683116800,18121,6040,12081,6040,0,1,6042,2048065,2.048065
6440,6550,3640,23842000,2,51526,12883,1,715724800,715724800,19321,6440,12881,6440,0,1,6442,1847783,1.847783
6840,6550,3640,23842000,2,54726,13683,1,748332800,748332800,20521,6840,13681,6840,0,1,6842,1270113,1.270113
55,6055,3965,24008075,2,446,113,1,196473400,196473400,166,55,111,55,0,1,57,475489,0.475489
455,6055,3965,24008075,2,3646,913,1,228537400,228537400,1366,455,911,455,0,1,457,2263283,2.263283
855,6055,3965,24008075,2,6846,1713,1,260601400,260601400,2566,855,1711,855,0,1,857,506451,0.506451
1255,6055,3965,24008075,2,10046,2513,1,292665400,292665400,3766,1255,2511,1255,0,1,1257,770934,0.770934
1655,6055,3965,24008075,2,13246,3313,1,324729400,324729400,4966,1655,3311,1655,0,1,1657,372650,0.37265
2055,6055,3965,24008075,2,16446,4113,1,356793400,356793400,6166,2055,4111,2055,0,1,2057,1441401,1.441401
2455,6055,3965,24008075,2,19646,4913,1,388857400,388857400,7366,2455,4911,2455,0,1,2457,21646,0.021646
2855,6055,3965,24008075,2,22846,5713,1,420921400,420921400,8566,2855,5711,2855,0,1,2857,66374,0.066374
3255,6055,3965,24008075,2,26046,6513,1,452985400,452985400,9766,3255,6511,3255,0,1,3257,722064,0.722064
3655,6055,3965,24008075,2,29246,7313,1,485049400,485049400,10966,3655,7311,3655,0,1,3657,1194100,1.1941
4055,6055,3965,24008075,2,32446,8113,1,517113400,517113400,12166,4055,8111,4055,0,1,4057,3169848,3.169848
4455,6055,3965,24008075,2,35646,8913,1,549177400,549177400,13366,4455,8911,4455,0,1,4457,4220938,4.220938
4855,6055,3965,24008075,2,38846,9713,1,581241400,581241400,14566,4855,9711,4855,0,1,4857,4172790,4.17279
5255,6055,3965,24008075,2,42046,10513,1,613305400,613305400,15766,5255,10511,5255,0,1,5257,2746968,2.746968
5655,6055,3965,24008075,2,45246,11313,1,645369400,645369400,16966,5655,11311,5655,0,1,5657,308779,0.308779
6055,6055,3965,24008075,2,48446,12113,1,677433400,677433400,18166,6055,12111,6055,0,1,6057,56364,0.056364
6455,6055,3965,24008075,2,51646,12913,1,709497400,709497400,19366,6455,12911,6455,0,1,6457,6813958,6.813958
6855,6055,3965,24008075,2,54846,13713,1,741561400,741561400,20566,6855,13711,6855,0,1,6857,3122362,3.122362
55,6555,3665,24024075,2,446,113,1,196689400,196689400,166,55,111,55,0,1,57,60921,0.060921
455,6555,3665,24024075,2,3646,913,1,229393400,229393400,1366,455,911,455,0,1,457,152367,0.152367
855,6555,3665,24024075,2,6846,1713,1,262097400,262097400,2566,855,1711,855,0,1,857,187375,0.187375
1255,6555,3665,24024075,2,10046,2513,1,294801400,294801400,3766,1255,2511,1255,0,1,1257,77749,0.077749
1655,6555,3665,24024075,2,13246,3313,1,327505400,327505400,4966,1655,3311,1655,0,1,1657,506114,0.506114
2055,6555,3665,24024075,2,16446,4113,1,360209400,360209400,6166,2055,4111,2055,0,1,2057,278617,0.278617
2455,6555,3665,24024075,2,19646,4913,1,392913400,392913400,7366,2455,4911,2455,0,1,2457,1734035,1.734035
2855,6555,3665,24024075,2,22846,5713,1,425617400,425617400,8566,2855,5711,2855,0,1,2857,805728,0.805728
3255,6555,3665,24024075,2,26046,6513,1,458321400,458321400,9766,3255,6511,3255,0,1,3257,788666,0.788666
3655,6555,3665,24024075,2,29246,7313,1,491025400,491025400,10966,3655,7311,3655,0,1,3657,3334340,3.33434
4055,6555,3665,24024075,2,32446,8113,1,523729400,523729400,12166,4055,8111,4055,0,1,4057,119308,0.119308
4455,6555,3665,24024075,2,35646,8913,1,556433400,556433400,13366,4455,8911,4455,0,1,4457,1827868,1.827868
4855,6555,3665,24024075,2,38846,9713,1,589137400,589137400,14566,4855,9711,4855,0,1,4857,3159060,3.15906
5255,6555,3665,24024075,2,42046,10513,1,621841400,621841400,15766,5255,10511,5255,0,1,5257,123059,0.123059
5655,6555,3665,24024075,2,45246,11313,1,654545400,654545400,16966,5655,11311,5655,0,1,5657,807270,0.80727
6055,6555,3665,24024075,2,48446,12113,1,687249400,687249400,18166,6055,12111,6055,0,1,6057,3904046,3.904046
6455,6555,3665,24024075,2,51646,12913,1,719953400,719953400,19366,6455,12911,6455,0,1,6457,1086931,1.086931
6855,6555,3665,24024075,2,54846,13713,1,752657400,752657400,20566,6855,13711,6855,0,1,6857,1722468,1.722468
40,5300,4540,24062000,2,326,83,1,195644800,195644800,121,40,81,40,0,1,42,434654,0.434654
440,5300,4540,24062000,2,3526,883,1,227132800,227132800,1321,440,881,440,0,1,442,2234032,2.234032
840,5300,4540,24062000,2,6726,1683,1,258620800,258620800,2521,840,1681,840,0,1,842,260903,0.260903
1240,5300,4540,24062000,2,9926,2483,1,290108800,290108800,3721,1240,2481,1240,0,1,1242,2451795,2.451795
1640,5300,4540,24062000,2,13126,3283,1,321596800,321596800,4921,1640,3281,1640,0,1,1642,337625,0.337625
2040,5300,4540,24062000,2,16326,4083,1,353084800,353084800,6121,2040,4081,2040,0,1,2042,1809888,1.809888
2440,5300,4540,24062000,2,19526,4883,1,384572800,384572800,7321,2440,4881,2440,0,1,2442,1042702,1.042702
2840,5300,4540,24062000,2,22726,5683,1,416060800,416060800,8521,2840,5681,2840,0,1,2842,478200,0.4782
3240,5300,4540,24062000,2,25926,6483,1,447548800,447548800,9721,3240,6481,3240,0,1,3242,3599045,3.599045
3640,5300,4540,24062000,2,29126,7283,1,479036800,479036800,10921,3640,7281,3640,0,1,3642,298670,0.29867
4040,5300,4540,24062000,2,32326,8083,1,510524800,510524800,12121,4040,8081,4040,0,1,4042,63700,0.0637
4440,5300,4540,24062000,2,35526,8883,1,542012800,542012800,13321,4440,8881,4440,0,1,4442,434171,0.434171
4840,5300,4540,24062000,2,38726,9683,1,573500800,573500800,14521,4840,9681,4840,0,1,4842,1661761,1.661761
5240,5300,4540,24062000,2,41926,10483,1,604988800,604988800,15721,5240,10481,5240,0,1,5242,342941,0.342941
5640,5300,4540,24062000,2,45126,11283,1,636476800,636476800,16921,5640,11281,5640,0,1,5642,2374015,2.374015
6040,5300,4540,24062000,2,48326,12083,1,667964800,667964800,18121,6040,12081,6040,0,1,6042,2511580,2.51158
6440,5300,4540,24062000,2,51526,12883,1,699452800,699452800,19321,6440,12881,6440,0,1,6442,541886,0.541886
6840,5300,4540,24062000,2,54726,13683,1,730940800,730940800,20521,6840,13681,6840,0,1,6842,4746085,4.746085
40,3800,6340,24092000,2,326,83,1,195980800,195980800,121,40,81,40,0,1,42,432870,0.43287
440,3800,6340,24092000,2,3526,883,1,228428800,228428800,1321,440,881,440,0,1,442,2235803,2.235803
840,3800,6340,24092000,2,6726,1683,1,260876800,260876800,2521,840,1681,840,0,1,842,4064537,4.064537
1240,3800,6340,24092000,2,9926,2483,1,293324800,293324800,3721,1240,2481,1240,0,1,1242,3334400,3.3344
1640,3800,6340,24092000,2,13126,3283,1,325772800,325772800,4921,1640,3281,1640,0,1,1642,7751365,7.751365
2040,3800,6340,24092000,2,16326,4083,1,358220800,358220800,6121,2040,4081,2040,0,1,2042,418746,0.418746
2440,3800,6340,24092000,2,19526,4883,1,390668800,390668800,7321,2440,4881,2440,0,1,2442,5685153,5.685153
2840,3800,6340,24092000,2,22726,5683,1,423116800,423116800,8521,2840,5681,2840,0,1,2842,231283,0.231283
3240,3800,6340,24092000,2,25926,6483,1,455564800,455564800,9721,3240,6481,3240,0,1,3242,6644188,6.644188
3640,3800,6340,24092000,2,29126,7283,1,488012800,488012800,10921,3640,7281,3640,0,1,3642,6115628,6.115628
4040,3800,6340,24092000,2,32326,8083,1,520460800,520460800,12121,4040,8081,4040,0,1,4042,5004813,5.004813
4440,3800,6340,24092000,2,35526,8883,1,552908800,552908800,13321,4440,8881,4440,0,1,4442,921420,0.92142
4840,3800,6340,24092000,2,38726,9683,1,585356800,585356800,14521,4840,9681,4840,0,1,4842,76743,0.076743
5240,3800,6340,24092000,2,41926,10483,1,617804800,617804800,15721,5240,10481,5240,0,1,5242,403303,0.403303
5640,3800,6340,24092000,2,45126,11283,1,650252800,650252800,16921,5640,11281,5640,0,1,5642,2622687,2.622687
6040,3800,6340,24092000,2,48326,12083,1,682700800,682700800,18121,6040,12081,6040,0,1,6042,1791023,1.791023
6440,3800,6340,24092000,2,51526,12883,1,715148800,715148800,19321,6440,12881,6440,0,1,6442,785000,0.785
6840,3800,6340,24092000,2,54726,13683,1,747596800,747596800,20521,6840,13681,6840,0,1,6842,2963922,2.963922
55,5305,4565,24217325,2,446,113,1,198081400,198081400,166,55,111,55,0,1,57,483966,0.483966
455,5305,4565,24217325,2,3646,913,1,229665400,229665400,1366,455,911,455,0,1,457,2285311,2.285311
855,5305,4565,24217325,2,6846,1713,1,261249400,261249400,2566,855,1711,855,0,1,857,2752009,2.752009
1255,5305,4565,24217325,2,10046,2513,1,292833400,292833400,3766,1255,2511,1255,0,1,1257,1326122,1.326122
1655,5305,4565,24217325,2,13246,3313,1,324417400,324417400,4966,1655,3311,1655,0,1,1657,1809995,1.809995
2055,5305,4565,24217325,2,16446,4113,1,356001400,356001400,6166,2055,4111,2055,0,1,2057,4648916,4.648916
2455,5305,4565,24217325,2,19646,4913,1,387585400,387585400,7366,2455,4911,2455,0,1,2457,888813,0.888813
2855,5305,4565,24217325,2,22846,5713,1,419169400,419169400,8566,2855,5711,2855,0,1,2857,200768,0.200768
3255,5305,4565,24217325,2,26046,6513,1,450753400,450753400,9766,3255,6511,3255,0,1,3257,507945,0.507945
3655,5305,4565,24217325,2,29246,7313,1,482337400,482337400,10966,3655,7311,3655,0,1,3657,408917,0.408917
4055,5305,4565,24217325,2,32446,8113,1,513921400,513921400,12166,4055,8111,4055,0,1,4057,469570,0.46957
4455,5305,4565,24217325,2,35646,8913,1,545505400,545505400,13366,4455,8911,4455,0,1,4457,1085865,1.085865
4855,5305,4565,24217325,2,38846,9713,1,577089400,577089400,14566,4855,9711,4855,0,1,4857,3863650,3.86365
5255,5305,4565,24217325,2,42046,10513,1,608673400,608673400,15766,5255,10511,5255,0,1,5257,1938794,1.938794
5655,5305,4565,24217325,2,45246,11313,1,640257400,640257400,16966,5655,11311,5655,0,1,5657,496021,0.496021
6055,5305,4565,24217325,2,48446,12113,1,671841400,671841400,18166,6055,12111,6055,0,1,6057,169640,0.16964
6455,5305,4565,24217325,2,51646,12913,1,703425400,703425400,19366,6455,12911,6455,0,1,6457,4743334,4.743334
6855,5305,4565,24217325,2,54846,13713,1,735009400,735009400,20566,6855,13711,6855,0,1,6857,8471445,8.471445
55,3805,6365,24218825,2,446,113,1,198225400,198225400,166,55,111,55,0,1,57,496648,0.496648
455,3805,6365,24218825,2,3646,913,1,230769400,230769400,1366,455,911,455,0,1,457,2342621,2.342621
855,3805,6365,24218825,2,6846,1713,1,263313400,263313400,2566,855,1711,855,0,1,857,4228073,4.228073
1255,3805,6365,24218825,2,10046,2513,1,295857400,295857400,3766,1255,2511,1255,0,1,1257,96801,0.096801
1655,3805,6365,24218825,2,13246,3313,1,328401400,328401400,4966,1655,3311,1655,0,1,1657,5321483,5.321483
2055,3805,6365,24218825,2,16446,4113,1,360945400,360945400,6166,2055,4111,2055,0,1,2057,1760120,1.76012
2455,3805,6365,24218825,2,19646,4913,1,393489400,393489400,7366,2455,4911,2455,0,1,2457,5750577,5.750577
2855,3805,6365,24218825,2,22846,5713,1,426033400,426033400,8566,2855,5711,2855,0,1,2857,6619706,6.619706
3255,3805,6365,24218825,2,26046,6513,1,458577400,458577400,9766,3255,6511,3255,0,1,3257,1883159,1.883159
3655,3805,6365,24218825,2,29246,7313,1,491121400,491121400,10966,3655,7311,3655,0,1,3657,3270406,3.270406
4055,3805,6365,24218825,2,32446,8113,1,523665400,523665400,12166,4055,8111,4055,0,1,4057,303418,0.303418
4455,3805,6365,24218825,2,35646,8913,1,556209400,556209400,13366,4455,8911,4455,0,1,4457,5914645,5.914645
4855,3805,6365,24218825,2,38846,9713,1,588753400,588753400,14566,4855,9711,4855,0,1,4857,2373257,2.373257
5255,3805,6365,24218825,2,42046,10513,1,621297400,621297400,15766,5255,10511,5255,0,1,5257,1330198,1.330198
5655,3805,6365,24218825,2,45246,11313,1,653841400,653841400,16966,5655,11311,5655,0,1,5657,9377022,9.377022
6055,3805,6365,24218825,2,48446,12113,1,686385400,686385400,18166,6055,12111,6055,0,1,6057,3083384,3.083384
6455,3805,6365,24218825,2,51646,12913,1,718929400,718929400,19366,6455,12911,6455,0,1,6457,2072186,2.072186
6855,3805,6365,24218825,2,54846,13713,1,751473400,751473400,20566,6855,13711,6855,0,1,6857,3060218,3.060218
35,4400,5545,24398000,2,286,73,1,197968600,197968600,106,35,71,35,0,1,37,109831,0.109831
535,4400,5545,24398000,2,4286,1073,1,237748600,237748600,1606,535,1071,535,0,1,537,905622,0.905622
1035,4400,5545,24398000,2,8286,2073,1,277528600,277528600,3106,1035,2071,1035,0,1,1037,1335150,1.33515
1535,4400,5545,24398000,2,12286,3073,1,317308600,317308600,4606,1535,3071,1535,0,1,1537,665071,0.665071
2035,4400,5545,24398000,2,16286,4073,1,357088600,357088600,6106,2035,4071,2035,0,1,2037,953943,0.953943
2535,4400,5545,24398000,2,20286,5073,1,396868600,396868600,7606,2535,5071,2535,0,1,2537,936776,0.936776
3035,4400,5545,24398000,2,24286,6073,1,436648600,436648600,9106,3035,6071,3035,0,1,3037,1685177,1.685177
3535,4400,5545,24398000,2,28286,7073,1,476428600,476428600,10606,3535,7071,3535,0,1,3537,848836,0.848836
4035,4400,5545,24398000,2,32286,8073,1,516208600,516208600,12106,4035,8071,4035,0,1,4037,3374388,3.374388
4535,4400,5545,24398000,2,36286,9073,1,555988600,555988600,13606,4535,9071,4535,0,1,4537,2787234,2.787234
5035,4400,5545,24398000,2,40286,10073,1,595768600,595768600,15106,5035,10071,5035,0,1,5037,2615825,2.615825
5535,4400,5545,24398000,2,44286,11073,1,635548600,635548600,16606,5535,11071,5535,0,1,5537,714596,0.714596
6035,4400,5545,24398000,2,48286,12073,1,675328600,675328600,18106,6035,12071,6035,0,1,6037,278040,0.27804
6535,4400,5545,24398000,2,52286,13073,1,715108600,715108600,19606,6535,13071,6535,0,1,6537,1521022,1.521022
7035,4400,5545,24398000,2,56286,14073,1,754888600,754888600,21106,7035,14071,7035,0,1,7037,13345942,13.345942
40,5050,4840,24442000,2,326,83,1,198700800,198700800,121,40,81,40,0,1,42,49547,0.049547
440,5050,4840,24442000,2,3526,883,1,230348800,230348800,1321,440,881,440,0,1,442,53563,0.053563
840,5050,4840,24442000,2,6726,1683,1,261996800,261996800,2521,840,1681,840,0,1,842,407762,0.407762
1240,5050,4840,24442000,2,9926,2483,1,293644800,293644800,3721,1240,2481,1240,0,1,1242,59739,0.059739
1640,5050,4840,24442000,2,13126,3283,1,325292800,325292800,4921,1640,3281,1640,0,1,1642,678680,0.67868
2040,5050,4840,24442000,2,16326,4083,1,356940800,356940800,6121,2040,4081,2040,0,1,2042,506865,0.506865
2440,5050,4840,24442000,2,19526,4883,1,388588800,388588800,7321,2440,4881,2440,0,1,2442,1112506,1.112506
2840,5050,4840,24442000,2,22726,5683,1,420236800,420236800,8521,2840,5681,2840,0,1,2842,1502178,1.502178
3240,5050,4840,24442000,2,25926,6483,1,451884800,451884800,9721,3240,6481,3240,0,1,3242,659303,0.659303
3640,5050,4840,24442000,2,29126,7283,1,483532800,483532800,10921,3640,7281,3640,0,1,3642,932371,0.932371
4040,5050,4840,24442000,2,32326,8083,1,515180800,515180800,12121,4040,8081,4040,0,1,4042,275631,0.275631
4440,5050,4840,24442000,2,35526,8883,1,546828800,546828800,13321,4440,8881,4440,0,1,4442,471447,0.471447
4840,5050,4840,24442000,2,38726,9683,1,578476800,578476800,14521,4840,9681,4840,0,1,4842,980327,0.980327
5240,5050,4840,24442000,2,41926,10483,1,610124800,610124800,15721,5240,10481,5240,0,1,5242,3501701,3.501701
5640,5050,4840,24442000,2,45126,11283,1,641772800,641772800,16921,5640,11281,5640,0,1,5642,2174250,2.17425
6040,5050,4840,24442000,2,48326,12083,1,673420800,673420800,18121,6040,12081,6040,0,1,6042,549660,0.54966
6440,5050,4840,24442000,2,51526,12883,1,705068800,705068800,19321,6440,12881,6440,0,1,6442,306038,0.306038
6840,5050,4840,24442000,2,54726,13683,1,736716800,736716800,20521,6840,13681,6840,0,1,6842,927694,0.927694
40,4050,6040,24462000,2,326,83,1,198924800,198924800,121,40,81,40,0,1,42,21937,0.021937
440,4050,6040,24462000,2,3526,883,1,231212800,231212800,1321,440,881,440,0,1,442,261330,0.26133
840,4050,6040,24462000,2,6726,1683,1,263500800,263500800,2521,840,1681,840,0,1,842,135173,0.135173
1240,4050,6040,24462000,2,9926,2483,1,295788800,295788800,3721,1240,2481,1240,0,1,1242,570241,0.570241
1640,4050,6040,24462000,2,13126,3283,1,328076800,328076800,4921,1640,3281,1640,0,1,1642,455984,0.455984
2040,4050,6040,24462000,2,16326,4083,1,360364800,360364800,6121,2040,4081,2040,0,1,2042,62722,0.062722
2440,4050,6040,24462000,2,19526,4883,1,392652800,392652800,7321,2440,4881,2440,0,1,2442,307581,0.307581
2840,4050,6040,24462000,2,22726,5683,1,424940800,424940800,8521,2840,5681,2840,0,1,2842,403020,0.40302
3240,4050,6040,24462000,2,25926,6483,1,457228800,457228800,9721,3240,6481,3240,0,1,3242,2001660,2.00166
3640,4050,6040,24462000,2,29126,7283,1,489516800,489516800,10921,3640,7281,3640,0,1,3642,535969,0.535969
4040,4050,6040,24462000,2,32326,8083,1,521804800,521804800,12121,4040,8081,4040,0,1,4042,2469894,2.469894
4440,4050,6040,24462000,2,35526,8883,1,554092800,554092800,13321,4440,8881,4440,0,1,4442,149142,0.149142
4840,4050,6040,24462000,2,38726,9683,1,586380800,586380800,14521,4840,9681,4840,0,1,4842,298475,0.298475
5240,4050,6040,24462000,2,41926,10483,1,618668800,618668800,15721,5240,10481,5240,0,1,5242,790015,0.790015
5640,4050,6040,24462000,2,45126,11283,1,650956800,650956800,16921,5640,11281,5640,0,1,5642,195413,0.195413
6040,4050,6040,24462000,2,48326,12083,1,683244800,683244800,18121,6040,12081,6040,0,1,6042,134444,0.134444
6440,4050,6040,24462000,2,51526,12883,1,715532800,715532800,19321,6440,12881,6440,0,1,6442,281135,0.281135
6840,4050,6040,24462000,2,54726,13683,1,747820800,747820800,20521,6840,13681,6840,0,1,6842,856129,0.856129
35,6050,4045,24472250,2,286,73,1,198604600,198604600,106,35,71,35,0,1,37,176107,0.176107
535,6050,4045,24472250,2,4286,1073,1,238984600,238984600,1606,535,1071,535,0,1,537,507381,0.507381
1035,6050,4045,24472250,2,8286,2073,1,279364600,279364600,3106,1035,2071,1035,0,1,1037,1839877,1.839877
1535,6050,4045,24472250,2,12286,3073,1,319744600,319744600,4606,1535,3071,1535,0,1,1537,202840,0.20284
2035,6050,4045,24472250,2,16286,4073,1,360124600,360124600,6106,2035,4071,2035,0,1,2037,756795,0.756795
2535,6050,4045,24472250,2,20286,5073,1,400504600,400504600,7606,2535,5071,2535,0,1,2537,921743,0.921743
3035,6050,4045,24472250,2,24286,6073,1,440884600,440884600,9106,3035,6071,3035,0,1,3037,3170133,3.170133
3535,6050,4045,24472250,2,28286,7073,1,481264600,481264600,10606,3535,7071,3535,0,1,3537,1852187,1.852187
4035,6050,4045,24472250,2,32286,8073,1,521644600,521644600,12106,4035,8071,4035,0,1,4037,8458251,8.458251
4535,6050,4045,24472250,2,36286,9073,1,562024600,562024600,13606,4535,9071,4535,0,1,4537,1127868,1.127868
5035,6050,4045,24472250,2,40286,10073,1,602404600,602404600,15106,5035,10071,5035,0,1,5037,3598027,3.598027
5535,6050,4045,24472250,2,44286,11073,1,642784600,642784600,16606,5535,11071,5535,0,1,5537,1242983,1.242983
6035,6050,4045,24472250,2,48286,12073,1,683164600,683164600,18106,6035,12071,6035,0,1,6037,2093290,2.09329
6535,6050,4045,24472250,2,52286,13073,1,723544600,723544600,19606,6535,13071,6535,0,1,6537,3821470,3.82147
7035,6050,4045,24472250,2,56286,14073,1,763924600,763924600,21106,7035,14071,7035,0,1,7037,33823892,33.823892
40,5800,4240,24592000,2,326,83,1,199948800,199948800,121,40,81,40,0,1,42,21974,0.021974
440,5800,4240,24592000,2,3526,883,1,232076800,232076800,1321,440,881,440,0,1,442,10843,0.010843
840,5800,4240,24592000,2,6726,1683,1,264204800,264204800,2521,840,1681,840,0,1,842,81189,0.081189
1240,5800,4240,24592000,2,9926,2483,1,296332800,296332800,3721,1240,2481,1240,0,1,1242,779909,0.779909
1640,5800,4240,24592000,2,13126,3283,1,328460800,328460800,4921,1640,3281,1640,0,1,1642,152708,0.152708
2040,5800,4240,24592000,2,16326,4083,1,360588800,360588800,6121,2040,4081,2040,0,1,2042,1178701,1.178701
2440,5800,4240,24592000,2,19526,4883,1,392716800,392716800,7321,2440,4881,2440,0,1,2442,513238,0.513238
2840,5800,4240,24592000,2,22726,5683,1,424844800,424844800,8521,2840,5681,2840,0,1,2842,570895,0.570895
3240,5800,4240,24592000,2,25926,6483,1,456972800,456972800,9721,3240,6481,3240,0,1,3242,111916,0.111916
3640,5800,4240,24592000,2,29126,7283,1,489100800,489100800,10921,3640,7281,3640,0,1,3642,605104,0.605104
4040,5800,4240,24592000,2,32326,8083,1,521228800,521228800,12121,4040,8081,4040,0,1,4042,5996751,5.996751
4440,5800,4240,24592000,2,35526,8883,1,553356800,553356800,13321,4440,8881,4440,0,1,4442,1915255,1.915255
4840,5800,4240,24592000,2,38726,9683,1,585484800,585484800,14521,4840,9681,4840,0,1,4842,519600,0.5196
5240,5800,4240,24592000,2,41926,10483,1,617612800,617612800,15721,5240,10481,5240,0,1,5242,181499,0.181499
5640,5800,4240,24592000,2,45126,11283,1,649740800,649740800,16921,5640,11281,5640,0,1,5642,202043,0.202043
6040,5800,4240,24592000,2,48326,12083,1,681868800,681868800,18121,6040,12081,6040,0,1,6042,60116,0.060116
6440,5800,4240,24592000,2,51526,12883,1,713996800,713996800,19321,6440,12881,6440,0,1,6442,489078,0.489078
6840,5800,4240,24592000,2,54726,13683,1,746124800,746124800,20521,6840,13681,6840,0,1,6842,426528,0.426528
55,5055,4865,24592575,2,446,113,1,201105400,201105400,166,55,111,55,0,1,57,77701,0.077701
455,5055,4865,24592575,2,3646,913,1,232849400,232849400,1366,455,911,455,0,1,457,59918,0.059918
855,5055,4865,24592575,2,6846,1713,1,264593400,264593400,2566,855,1711,855,0,1,857,200047,0.200047
1255,5055,4865,24592575,2,10046,2513,1,296337400,296337400,3766,1255,2511,1255,0,1,1257,718363,0.718363
1655,5055,4865,24592575,2,13246,3313,1,328081400,328081400,4966,1655,3311,1655,0,1,1657,345827,0.345827
2055,5055,4865,24592575,2,16446,4113,1,359825400,359825400,6166,2055,4111,2055,0,1,2057,308513,0.308513
2455,5055,4865,24592575,2,19646,4913,1,391569400,391569400,7366,2455,4911,2455,0,1,2457,873063,0.873063
2855,5055,4865,24592575,2,22846,5713,1,423313400,423313400,8566,2855,5711,2855,0,1,2857,216450,0.21645
3255,5055,4865,24592575,2,26046,6513,1,455057400,455057400,9766,3255,6511,3255,0,1,3257,446060,0.44606
3655,5055,4865,24592575,2,29246,7313,1,486801400,486801400,10966,3655,7311,3655,0,1,3657,708404,0.708404
4055,5055,4865,24592575,2,32446,8113,1,518545400,518545400,12166,4055,8111,4055,0,1,4057,468309,0.468309
4455,5055,4865,24592575,2,35646,8913,1,550289400,550289400,13366,4455,8911,4455,0,1,4457,986629,0.986629
4855,5055,4865,24592575,2,38846,9713,1,582033400,582033400,14566,4855,9711,4855,0,1,4857,1428776,1.428776
5255,5055,4865,24592575,2,42046,10513,1,613777400,613777400,15766,5255,10511,5255,0,1,5257,449848,0.449848
5655,5055,4865,24592575,2,45246,11313,1,645521400,645521400,16966,5655,11311,5655,0,1,5657,990330,0.99033
6055,5055,4865,24592575,2,48446,12113,1,677265400,677265400,18166,6055,12111,6055,0,1,6057,1595350,1.59535
6455,5055,4865,24592575,2,51646,12913,1,709009400,709009400,19366,6455,12911,6455,0,1,6457,5091030,5.09103
6855,5055,4865,24592575,2,54846,13713,1,740753400,740753400,20566,6855,13711,6855,0,1,6857,59931,0.059931
55,4055,6065,24593575,2,446,113,1,201201400,201201400,166,55,111,55,0,1,57,29729,0.029729
455,4055,6065,24593575,2,3646,913,1,233585400,233585400,1366,455,911,455,0,1,457,39985,0.039985
855,4055,6065,24593575,2,6846,1713,1,265969400,265969400,2566,855,1711,855,0,1,857,343098,0.343098
1255,4055,6065,24593575,2,10046,2513,1,298353400,298353400,3766,1255,2511,1255,0,1,1257,358285,0.358285
1655,4055,6065,24593575,2,13246,3313,1,330737400,330737400,4966,1655,3311,1655,0,1,1657,300630,0.30063
2055,4055,6065,24593575,2,16446,4113,1,363121400,363121400,6166,2055,4111,2055,0,1,2057,250020,0.25002
2455,4055,6065,24593575,2,19646,4913,1,395505400,395505400,7366,2455,4911,2455,0,1,2457,218231,0.218231
2855,4055,6065,24593575,2,22846,5713,1,427889400,427889400,8566,2855,5711,2855,0,1,2857,124115,0.124115
3255,4055,6065,24593575,2,26046,6513,1,460273400,460273400,9766,3255,6511,3255,0,1,3257,1827899,1.827899
3655,4055,6065,24593575,2,29246,7313,1,492657400,492657400,10966,3655,7311,3655,0,1,3657,428288,0.428288
4055,4055,6065,24593575,2,32446,8113,1,525041400,525041400,12166,4055,8111,4055,0,1,4057,2396661,2.396661
4455,4055,6065,24593575,2,35646,8913,1,557425400,557425400,13366,4455,8911,4455,0,1,4457,1058216,1.058216
4855,4055,6065,24593575,2,38846,9713,1,589809400,589809400,14566,4855,9711,4855,0,1,4857,801107,0.801107
5255,4055,6065,24593575,2,42046,10513,1,622193400,622193400,15766,5255,10511,5255,0,1,5257,3570513,3.570513
5655,4055,6065,24593575,2,45246,11313,1,654577400,654577400,16966,5655,11311,5655,0,1,5657,2440585,2.440585
6055,4055,6065,24593575,2,48446,12113,1,686961400,686961400,18166,6055,12111,6055,0,1,6057,678397,0.678397
6455,4055,6065,24593575,2,51646,12913,1,719345400,719345400,19366,6455,12911,6455,0,1,6457,2765503,2.765503
6855,4055,6065,24593575,2,54846,13713,1,751729400,751729400,20566,6855,13711,6855,0,1,6857,1580414,1.580414
39,4443,5541,24618663,2,318,81,1,200064312,200064312,118,39,79,39,0,1,41,21618,0.021618
539,4443,5541,24618663,2,4318,1081,1,240000312,240000312,1618,539,1079,539,0,1,541,29889,0.029889
1039,4443,5541,24618663,2,8318,2081,1,279936312,279936312,3118,1039,2079,1039,0,1,1041,183965,0.183965
1539,4443,5541,24618663,2,12318,3081,1,319872312,319872312,4618,1539,3079,1539,0,1,1541,237604,0.237604
2039,4443,5541,24618663,2,16318,4081,1,359808312,359808312,6118,2039,4079,2039,0,1,2041,349830,0.34983
2539,4443,5541,24618663,2,20318,5081,1,399744312,399744312,7618,2539,5079,2539,0,1,2541,599254,0.599254
3039,4443,5541,24618663,2,24318,6081,1,439680312,439680312,9118,3039,6079,3039,0,1,3041,589709,0.589709
3539,4443,5541,24618663,2,28318,7081,1,479616312,479616312,10618,3539,7079,3539,0,1,3541,1889145,1.889145
4039,4443,5541,24618663,2,32318,8081,1,519552312,519552312,12118,4039,8079,4039,0,1,4041,300949,0.300949
4539,4443,5541,24618663,2,36318,9081,1,559488312,559488312,13618,4539,9079,4539,0,1,4541,3977577,3.977577
5039,4443,5541,24618663,2,40318,10081,1,599424312,599424312,15118,5039,10079,5039,0,1,5041,535470,0.53547
5539,4443,5541,24618663,2,44318,11081,1,639360312,639360312,16618,5539,11079,5539,0,1,5541,234279,0.234279
6039,4443,5541,24618663,2,48318,12081,1,679296312,679296312,18118,6039,12079,6039,0,1,6041,2613094,2.613094
6539,4443,5541,24618663,2,52318,13081,1,719232312,719232312,19618,6539,13079,6539,0,1,6541,174201,0.174201
7039,4443,5541,24618663,2,56318,14081,1,759168312,759168312,21118,7039,14079,7039,0,1,7041,3527741,3.527741
35,4440,5545,24619800,2,286,73,1,199754200,199754200,106,35,71,35,0,1,37,441088,0.441088
535,4440,5545,24619800,2,4286,1073,1,239694200,239694200,1606,535,1071,535,0,1,537,2645176,2.645176
1035,4440,5545,24619800,2,8286,2073,1,279634200,279634200,3106,1035,2071,1035,0,1,1037,4949616,4.949616
1535,4440,5545,24619800,2,12286,3073,1,319574200,319574200,4606,1535,3071,1535,0,1,1537,7234858,7.234858
2035,4440,5545,24619800,2,16286,4073,1,359514200,359514200,6106,2035,4071,2035,0,1,2037,9504833,9.504833
39,6093,4041,24621813,2,318,81,1,200136312,200136312,118,39,79,39,0,1,41,74834,0.074834
539,6093,4041,24621813,2,4318,1081,1,240672312,240672312,1618,539,1079,539,0,1,541,18586,0.018586
1039,6093,4041,24621813,2,8318,2081,1,281208312,281208312,3118,1039,2079,1039,0,1,1041,33418,0.033418
1539,6093,4041,24621813,2,12318,3081,1,321744312,321744312,4618,1539,3079,1539,0,1,1541,116407,0.116407
2039,6093,4041,24621813,2,16318,4081,1,362280312,362280312,6118,2039,4079,2039,0,1,2041,883427,0.883427
2539,6093,4041,24621813,2,20318,5081,1,402816312,402816312,7618,2539,5079,2539,0,1,2541,593237,0.593237
3039,6093,4041,24621813,2,24318,6081,1,443352312,443352312,9118,3039,6079,3039,0,1,3041,1232890,1.23289
3539,6093,4041,24621813,2,28318,7081,1,483888312,483888312,10618,3539,7079,3539,0,1,3541,811107,0.811107
4039,6093,4041,24621813,2,32318,8081,1,524424312,524424312,12118,4039,8079,4039,0,1,4041,64953,0.064953
4539,6093,4041,24621813,2,36318,9081,1,564960312,564960312,13618,4539,9079,4539,0,1,4541,671107,0.671107
5039,6093,4041,24621813,2,40318,10081,1,605496312,605496312,15118,5039,10079,5039,0,1,5041,1067125,1.067125
5539,6093,4041,24621813,2,44318,11081,1,646032312,646032312,16618,5539,11079,5539,0,1,5541,2679098,2.679098
6039,6093,4041,24621813,2,48318,12081,1,686568312,686568312,18118,6039,12079,6039,0,1,6041,2400814,2.400814
6539,6093,4041,24621813,2,52318,13081,1,727104312,727104312,19618,6539,13079,6539,0,1,6541,2332313,2.332313
7039,6093,4041,24621813,2,56318,14081,1,767640312,767640312,21118,7039,14079,7039,0,1,7041,3054662,3.054662
35,6090,4045,24634050,2,286,73,1,199910200,199910200,106,35,71,35,0,1,37,181048,0.181048
535,6090,4045,24634050,2,4286,1073,1,240450200,240450200,1606,535,1071,535,0,1,537,2076720,2.07672
1035,6090,4045,24634050,2,8286,2073,1,280990200,280990200,3106,1035,2071,1035,0,1,1037,2912532,2.912532
1535,6090,4045,24634050,2,12286,3073,1,321530200,321530200,4606,1535,3071,1535,0,1,1537,2173154,2.173154
40,3550,6940,24637000,2,326,83,1,200452800,200452800,121,40,81,40,0,1,42,197550,0.19755
440,3550,6940,24637000,2,3526,883,1,234020800,234020800,1321,440,881,440,0,1,442,409782,0.409782
840,3550,6940,24637000,2,6726,1683,1,267588800,267588800,2521,840,1681,840,0,1,842,376389,0.376389
1240,3550,6940,24637000,2,9926,2483,1,301156800,301156800,3721,1240,2481,1240,0,1,1242,732084,0.732084
1640,3550,6940,24637000,2,13126,3283,1,334724800,334724800,4921,1640,3281,1640,0,1,1642,975443,0.975443
2040,3550,6940,24637000,2,16326,4083,1,368292800,368292800,6121,2040,4081,2040,0,1,2042,396808,0.396808
2440,3550,6940,24637000,2,19526,4883,1,401860800,401860800,7321,2440,4881,2440,0,1,2442,96078,0.096078
2840,3550,6940,24637000,2,22726,5683,1,435428800,435428800,8521,2840,5681,2840,0,1,2842,115335,0.115335
3240,3550,6940,24637000,2,25926,6483,1,468996800,468996800,9721,3240,6481,3240,0,1,3242,694954,0.694954
3640,3550,6940,24637000,2,29126,7283,1,502564800,502564800,10921,3640,7281,3640,0,1,3642,328563,0.328563
4040,3550,6940,24637000,2,32326,8083,1,536132800,536132800,12121,4040,8081,4040,0,1,4042,185840,0.18584
4440,3550,6940,24637000,2,35526,8883,1,569700800,569700800,13321,4440,8881,4440,0,1,4442,1909363,1.909363
4840,3550,6940,24637000,2,38726,9683,1,603268800,603268800,14521,4840,9681,4840,0,1,4842,4032458,4.032458
5240,3550,6940,24637000,2,41926,10483,1,636836800,636836800,15721,5240,10481,5240,0,1,5242,653839,0.653839
5640,3550,6940,24637000,2,45126,11283,1,670404800,670404800,16921,5640,11281,5640,0,1,5642,459337,0.459337
6040,3550,6940,24637000,2,48326,12083,1,703972800,703972800,18121,6040,12081,6040,0,1,6042,761512,0.761512
6440,3550,6940,24637000,2,51526,12883,1,737540800,737540800,19321,6440,12881,6440,0,1,6442,192643,0.192643
6840,3550,6940,24637000,2,54726,13683,1,771108800,771108800,20521,6840,13681,6840,0,1,6842,4787190,4.78719
40,4800,5140,24672000,2,326,83,1,200556800,200556800,121,40,81,40,0,1,42,439282,0.439282
440,4800,5140,24672000,2,3526,883,1,232364800,232364800,1321,440,881,440,0,1,442,2213825,2.213825
840,4800,5140,24672000,2,6726,1683,1,264172800,264172800,2521,840,1681,840,0,1,842,180929,0.180929
1240,4800,5140,24672000,2,9926,2483,1,295980800,295980800,3721,1240,2481,1240,0,1,1242,3873557,3.873557
1640,4800,5140,24672000,2,13126,3283,1,327788800,327788800,4921,1640,3281,1640,0,1,1642,7635058,7.635058
2040,4800,5140,24672000,2,16326,4083,1,359596800,359596800,6121,2040,4081,2040,0,1,2042,6532023,6.532023
2440,4800,5140,24672000,2,19526,4883,1,391404800,391404800,7321,2440,4881,2440,0,1,2442,8442108,8.442108
2840,4800,5140,24672000,2,22726,5683,1,423212800,423212800,8521,2840,5681,2840,0,1,2842,249339,0.249339
3240,4800,5140,24672000,2,25926,6483,1,455020800,455020800,9721,3240,6481,3240,0,1,3242,3159143,3.159143
3640,4800,5140,24672000,2,29126,7283,1,486828800,486828800,10921,3640,7281,3640,0,1,3642,1370023,1.370023
4040,4800,5140,24672000,2,32326,8083,1,518636800,518636800,12121,4040,8081,4040,0,1,4042,7724914,7.724914
4440,4800,5140,24672000,2,35526,8883,1,550444800,550444800,13321,4440,8881,4440,0,1,4442,9062634,9.062634
4840,4800,5140,24672000,2,38726,9683,1,582252800,582252800,14521,4840,9681,4840,0,1,4842,1342957,1.342957
5240,4800,5140,24672000,2,41926,10483,1,614060800,614060800,15721,5240,10481,5240,0,1,5242,9577413,9.577413
5640,4800,5140,24672000,2,45126,11283,1,645868800,645868800,16921,5640,11281,5640,0,1,5642,11863727,11.863727
6040,4800,5140,24672000,2,48326,12083,1,677676800,677676800,18121,6040,12081,6040,0,1,6042,14256608,14.256608
6440,4800,5140,24672000,2,51526,12883,1,709484800,709484800,19321,6440,12881,6440,0,1,6442,186779,0.186779
6840,4800,5140,24672000,2,54726,13683,1,741292800,741292800,20521,6840,13681,6840,0,1,6842,18783048,18.783048
40,4300,5740,24682000,2,326,83,1,200668800,200668800,121,40,81,40,0,1,42,449756,0.449756
440,4300,5740,24682000,2,3526,883,1,232796800,232796800,1321,440,881,440,0,1,442,2204198,2.204198
840,4300,5740,24682000,2,6726,1683,1,264924800,264924800,2521,840,1681,840,0,1,842,128191,0.128191
1240,4300,5740,24682000,2,9926,2483,1,297052800,297052800,3721,1240,2481,1240,0,1,1242,984169,0.984169
1640,4300,5740,24682000,2,13126,3283,1,329180800,329180800,4921,1640,3281,1640,0,1,1642,1736557,1.736557
2040,4300,5740,24682000,2,16326,4083,1,361308800,361308800,6121,2040,4081,2040,0,1,2042,679254,0.679254
2440,4300,5740,24682000,2,19526,4883,1,393436800,393436800,7321,2440,4881,2440,0,1,2442,2466749,2.466749
2840,4300,5740,24682000,2,22726,5683,1,425564800,425564800,8521,2840,5681,2840,0,1,2842,955806,0.955806
3240,4300,5740,24682000,2,25926,6483,1,457692800,457692800,9721,3240,6481,3240,0,1,3242,3808576,3.808576
3640,4300,5740,24682000,2,29126,7283,1,489820800,489820800,10921,3640,7281,3640,0,1,3642,74331,0.074331
4040,4300,5740,24682000,2,32326,8083,1,521948800,521948800,12121,4040,8081,4040,0,1,4042,730030,0.73003
4440,4300,5740,24682000,2,35526,8883,1,554076800,554076800,13321,4440,8881,4440,0,1,4442,804037,0.804037
4840,4300,5740,24682000,2,38726,9683,1,586204800,586204800,14521,4840,9681,4840,0,1,4842,1382447,1.382447
5240,4300,5740,24682000,2,41926,10483,1,618332800,618332800,15721,5240,10481,5240,0,1,5242,5223402,5.223402
5640,4300,5740,24682000,2,45126,11283,1,650460800,650460800,16921,5640,11281,5640,0,1,5642,533014,0.533014
6040,4300,5740,24682000,2,48326,12083,1,682588800,682588800,18121,6040,12081,6040,0,1,6042,537267,0.537267
6440,4300,5740,24682000,2,51526,12883,1,714716800,714716800,19321,6440,12881,6440,0,1,6442,4887676,4.887676
6840,4300,5740,24682000,2,54726,13683,1,746844800,746844800,20521,6840,13681,6840,0,1,6842,734302,0.734302
44,4453,5555,24736415,2,358,91,1,201414136,201414136,133,44,89,44,0,1,46,16682,0.016682
544,4453,5555,24736415,2,4358,1091,1,241446136,241446136,1633,544,1089,544,0,1,546,49787,0.049787
1044,4453,5555,24736415,2,8358,2091,1,281478136,281478136,3133,1044,2089,1044,0,1,1046,587444,0.587444
1544,4453,5555,24736415,2,12358,3091,1,321510136,321510136,4633,1544,3089,1544,0,1,1546,123678,0.123678
2044,4453,5555,24736415,2,16358,4091,1,361542136,361542136,6133,2044,4089,2044,0,1,2046,459633,0.459633
2544,4453,5555,24736415,2,20358,5091,1,401574136,401574136,7633,2544,5089,2544,0,1,2546,1305235,1.305235
3044,4453,5555,24736415,2,24358,6091,1,441606136,441606136,9133,3044,6089,3044,0,1,3046,1023350,1.02335
3544,4453,5555,24736415,2,28358,7091,1,481638136,481638136,10633,3544,7089,3544,0,1,3546,566865,0.566865
4044,4453,5555,24736415,2,32358,8091,1,521670136,521670136,12133,4044,8089,4044,0,1,4046,2259723,2.259723
4544,4453,5555,24736415,2,36358,9091,1,561702136,561702136,13633,4544,9089,4544,0,1,4546,2026310,2.02631
5044,4453,5555,24736415,2,40358,10091,1,601734136,601734136,15133,5044,10089,5044,0,1,5046,383299,0.383299
5544,4453,5555,24736415,2,44358,11091,1,641766136,641766136,16633,5544,11089,5544,0,1,5546,728743,0.728743
6044,4453,5555,24736415,2,48358,12091,1,681798136,681798136,18133,6044,12089,6044,0,1,6046,813163,0.813163
6544,4453,5555,24736415,2,52358,13091,1,721830136,721830136,19633,6544,13089,6544,0,1,6546,1917778,1.917778
7044,4453,5555,24736415,2,56358,14091,1,761862136,761862136,21133,7044,14089,7044,0,1,7046,13606,0.013606
44,6103,4055,24747665,2,358,91,1,201556936,201556936,133,44,89,44,0,1,46,85567,0.085567
544,6103,4055,24747665,2,4358,1091,1,242188936,242188936,1633,544,1089,544,0,1,546,43702,0.043702
1044,6103,4055,24747665,2,8358,2091,1,282820936,282820936,3133,1044,2089,1044,0,1,1046,31413,0.031413
1544,6103,4055,24747665,2,12358,3091,1,323452936,323452936,4633,1544,3089,1544,0,1,1546,268819,0.268819
2044,6103,4055,24747665,2,16358,4091,1,364084936,364084936,6133,2044,4089,2044,0,1,2046,152695,0.152695
2544,6103,4055,24747665,2,20358,5091,1,404716936,404716936,7633,2544,5089,2544,0,1,2546,1022339,1.022339
3044,6103,4055,24747665,2,24358,6091,1,445348936,445348936,9133,3044,6089,3044,0,1,3046,381285,0.381285
3544,6103,4055,24747665,2,28358,7091,1,485980936,485980936,10633,3544,7089,3544,0,1,3546,617658,0.617658
4044,6103,4055,24747665,2,32358,8091,1,526612936,526612936,12133,4044,8089,4044,0,1,4046,3021217,3.021217
4544,6103,4055,24747665,2,36358,9091,1,567244936,567244936,13633,4544,9089,4544,0,1,4546,1704610,1.70461
5044,6103,4055,24747665,2,40358,10091,1,607876936,607876936,15133,5044,10089,5044,0,1,5046,218585,0.218585
5544,6103,4055,24747665,2,44358,11091,1,648508936,648508936,16633,5544,11089,5544,0,1,5546,312757,0.312757
6044,6103,4055,24747665,2,48358,12091,1,689140936,689140936,18133,6044,12089,6044,0,1,6046,6581831,6.581831
6544,6103,4055,24747665,2,52358,13091,1,729772936,729772936,19633,6544,13089,6544,0,1,6546,84368,0.084368
7044,6103,4055,24747665,2,56358,14091,1,770404936,770404936,21133,7044,14089,7044,0,1,7046,1048286,1.048286
40,6800,3640,24752000,2,326,83,1,201356800,201356800,121,40,81,40,0,1,42,433747,0.433747
440,6800,3640,24752000,2,3526,883,1,234764800,234764800,1321,440,881,440,0,1,442,1746728,1.746728
840,6800,3640,24752000,2,6726,1683,1,268172800,268172800,2521,840,1681,840,0,1,842,1675024,1.675024
1240,6800,3640,24752000,2,9926,2483,1,301580800,301580800,3721,1240,2481,1240,0,1,1242,1598660,1.59866
1640,6800,3640,24752000,2,13126,3283,1,334988800,334988800,4921,1640,3281,1640,0,1,1642,164098,0.164098
2040,6800,3640,24752000,2,16326,4083,1,368396800,368396800,6121,2040,4081,2040,0,1,2042,528183,0.528183
2440,6800,3640,24752000,2,19526,4883,1,401804800,401804800,7321,2440,4881,2440,0,1,2442,510866,0.510866
2840,6800,3640,24752000,2,22726,5683,1,435212800,435212800,8521,2840,5681,2840,0,1,2842,1931876,1.931876
3240,6800,3640,24752000,2,25926,6483,1,468620800,468620800,9721,3240,6481,3240,0,1,3242,27557,0.027557
40,4550,5440,24752000,2,326,83,1,201212800,201212800,121,40,81,40,0,1,42,443065,0.443065
440,4550,5440,24752000,2,3526,883,1,233180800,233180800,1321,440,881,440,0,1,442,836759,0.836759
840,4550,5440,24752000,2,6726,1683,1,265148800,265148800,2521,840,1681,840,0,1,842,3898437,3.898437
1240,4550,5440,24752000,2,9926,2483,1,297116800,297116800,3721,1240,2481,1240,0,1,1242,2426884,2.426884
1640,4550,5440,24752000,2,13126,3283,1,329084800,329084800,4921,1640,3281,1640,0,1,1642,2949469,2.949469
3640,6800,3640,24752000,2,29126,7283,1,502028800,502028800,10921,3640,7281,3640,0,1,3642,3803010,3.80301
2040,4550,5440,24752000,2,16326,4083,1,361052800,361052800,6121,2040,4081,2040,0,1,2042,1277045,1.277045
2440,4550,5440,24752000,2,19526,4883,1,393020800,393020800,7321,2440,4881,2440,0,1,2442,1869538,1.869538
2840,4550,5440,24752000,2,22726,5683,1,424988800,424988800,8521,2840,5681,2840,0,1,2842,90905,0.090905
4040,6800,3640,24752000,2,32326,8083,1,535436800,535436800,12121,4040,8081,4040,0,1,4042,2184372,2.184372
3240,4550,5440,24752000,2,25926,6483,1,456956800,456956800,9721,3240,6481,3240,0,1,3242,1614394,1.614394
3640,4550,5440,24752000,2,29126,7283,1,488924800,488924800,10921,3640,7281,3640,0,1,3642,5619942,5.619942
4440,6800,3640,24752000,2,35526,8883,1,568844800,568844800,13321,4440,8881,4440,0,1,4442,2321603,2.321603
4040,4550,5440,24752000,2,32326,8083,1,520892800,520892800,12121,4040,8081,4040,0,1,4042,2768115,2.768115
4840,6800,3640,24752000,2,38726,9683,1,602252800,602252800,14521,4840,9681,4840,0,1,4842,4536528,4.536528
4440,4550,5440,24752000,2,35526,8883,1,552860800,552860800,13321,4440,8881,4440,0,1,4442,10278399,10.278399
4840,4550,5440,24752000,2,38726,9683,1,584828800,584828800,14521,4840,9681,4840,0,1,4842,27802,0.027802
5240,6800,3640,24752000,2,41926,10483,1,635660800,635660800,15721,5240,10481,5240,0,1,5242,1960405,1.960405
5240,4550,5440,24752000,2,41926,10483,1,616796800,616796800,15721,5240,10481,5240,0,1,5242,66873,0.066873
5640,4550,5440,24752000,2,45126,11283,1,648764800,648764800,16921,5640,11281,5640,0,1,5642,3158443,3.158443
5640,6800,3640,24752000,2,45126,11283,1,669068800,669068800,16921,5640,11281,5640,0,1,5642,497336,0.497336
6040,4550,5440,24752000,2,48326,12083,1,680732800,680732800,18121,6040,12081,6040,0,1,6042,3695107,3.695107
6040,6800,3640,24752000,2,48326,12083,1,702476800,702476800,18121,6040,12081,6040,0,1,6042,1533169,1.533169
6440,4550,5440,24752000,2,51526,12883,1,712700800,712700800,19321,6440,12881,6440,0,1,6442,7345843,7.345843
6440,6800,3640,24752000,2,51526,12883,1,735884800,735884800,19321,6440,12881,6440,0,1,6442,5865811,5.865811
6840,4550,5440,24752000,2,54726,13683,1,744668800,744668800,20521,6840,13681,6840,0,1,6842,4598880,4.59888
6840,6800,3640,24752000,2,54726,13683,1,769292800,769292800,20521,6840,13681,6840,0,1,6842,3246023,3.246023
55,5805,4265,24758325,2,446,113,1,202497400,202497400,166,55,111,55,0,1,57,16920,0.01692
455,5805,4265,24758325,2,3646,913,1,234721400,234721400,1366,455,911,455,0,1,457,88335,0.088335
855,5805,4265,24758325,2,6846,1713,1,266945400,266945400,2566,855,1711,855,0,1,857,128178,0.128178
1255,5805,4265,24758325,2,10046,2513,1,299169400,299169400,3766,1255,2511,1255,0,1,1257,1130385,1.130385
1655,5805,4265,24758325,2,13246,3313,1,331393400,331393400,4966,1655,3311,1655,0,1,1657,561756,0.561756
2055,5805,4265,24758325,2,16446,4113,1,363617400,363617400,6166,2055,4111,2055,0,1,2057,1546632,1.546632
2455,5805,4265,24758325,2,19646,4913,1,395841400,395841400,7366,2455,4911,2455,0,1,2457,1106698,1.106698
2855,5805,4265,24758325,2,22846,5713,1,428065400,428065400,8566,2855,5711,2855,0,1,2857,890871,0.890871
3255,5805,4265,24758325,2,26046,6513,1,460289400,460289400,9766,3255,6511,3255,0,1,3257,256941,0.256941
3655,5805,4265,24758325,2,29246,7313,1,492513400,492513400,10966,3655,7311,3655,0,1,3657,575383,0.575383
4055,5805,4265,24758325,2,32446,8113,1,524737400,524737400,12166,4055,8111,4055,0,1,4057,656762,0.656762
4455,5805,4265,24758325,2,35646,8913,1,556961400,556961400,13366,4455,8911,4455,0,1,4457,36261,0.036261
4855,5805,4265,24758325,2,38846,9713,1,589185400,589185400,14566,4855,9711,4855,0,1,4857,1103341,1.103341
5255,5805,4265,24758325,2,42046,10513,1,621409400,621409400,15766,5255,10511,5255,0,1,5257,2020907,2.020907
5655,5805,4265,24758325,2,45246,11313,1,653633400,653633400,16966,5655,11311,5655,0,1,5657,2669356,2.669356
6055,5805,4265,24758325,2,48446,12113,1,685857400,685857400,18166,6055,12111,6055,0,1,6057,308455,0.308455
6455,5805,4265,24758325,2,51646,12913,1,718081400,718081400,19366,6455,12911,6455,0,1,6457,582867,0.582867
6855,5805,4265,24758325,2,54846,13713,1,750305400,750305400,20566,6855,13711,6855,0,1,6857,353610,0.35361
55,3555,6965,24760575,2,446,113,1,202713400,202713400,166,55,111,55,0,1,57,498566,0.498566
455,3555,6965,24760575,2,3646,913,1,236377400,236377400,1366,455,911,455,0,1,457,1965515,1.965515
855,3555,6965,24760575,2,6846,1713,1,270041400,270041400,2566,855,1711,855,0,1,857,2824316,2.824316
1255,3555,6965,24760575,2,10046,2513,1,303705400,303705400,3766,1255,2511,1255,0,1,1257,2629263,2.629263
1655,3555,6965,24760575,2,13246,3313,1,337369400,337369400,4966,1655,3311,1655,0,1,1657,132184,0.132184
2055,3555,6965,24760575,2,16446,4113,1,371033400,371033400,6166,2055,4111,2055,0,1,2057,104495,0.104495
2455,3555,6965,24760575,2,19646,4913,1,404697400,404697400,7366,2455,4911,2455,0,1,2457,1078734,1.078734
2855,3555,6965,24760575,2,22846,5713,1,438361400,438361400,8566,2855,5711,2855,0,1,2857,4925803,4.925803
3255,3555,6965,24760575,2,26046,6513,1,472025400,472025400,9766,3255,6511,3255,0,1,3257,1203673,1.203673
3655,3555,6965,24760575,2,29246,7313,1,505689400,505689400,10966,3655,7311,3655,0,1,3657,10917019,10.917019
4055,3555,6965,24760575,2,32446,8113,1,539353400,539353400,12166,4055,8111,4055,0,1,4057,1735942,1.735942
4455,3555,6965,24760575,2,35646,8913,1,573017400,573017400,13366,4455,8911,4455,0,1,4457,4405375,4.405375
4855,3555,6965,24760575,2,38846,9713,1,606681400,606681400,14566,4855,9711,4855,0,1,4857,1086088,1.086088
5255,3555,6965,24760575,2,42046,10513,1,640345400,640345400,15766,5255,10511,5255,0,1,5257,26382,0.026382
5655,3555,6965,24760575,2,45246,11313,1,674009400,674009400,16966,5655,11311,5655,0,1,5657,3681338,3.681338
6055,3555,6965,24760575,2,48446,12113,1,707673400,707673400,18166,6055,12111,6055,0,1,6057,1034787,1.034787
6455,3555,6965,24760575,2,51646,12913,1,741337400,741337400,19366,6455,12911,6455,0,1,6457,110006,0.110006
6855,3555,6965,24760575,2,54846,13713,1,775001400,775001400,20566,6855,13711,6855,0,1,6857,179891,0.179891
55,4805,5165,24817825,2,446,113,1,202929400,202929400,166,55,111,55,0,1,57,513708,0.513708
455,4805,5165,24817825,2,3646,913,1,234833400,234833400,1366,455,911,455,0,1,457,327895,0.327895
855,4805,5165,24817825,2,6846,1713,1,266737400,266737400,2566,855,1711,855,0,1,857,1877896,1.877896
1255,4805,5165,24817825,2,10046,2513,1,298641400,298641400,3766,1255,2511,1255,0,1,1257,811639,0.811639
1655,4805,5165,24817825,2,13246,3313,1,330545400,330545400,4966,1655,3311,1655,0,1,1657,830878,0.830878
2055,4805,5165,24817825,2,16446,4113,1,362449400,362449400,6166,2055,4111,2055,0,1,2057,3911607,3.911607
2455,4805,5165,24817825,2,19646,4913,1,394353400,394353400,7366,2455,4911,2455,0,1,2457,822410,0.82241
2855,4805,5165,24817825,2,22846,5713,1,426257400,426257400,8566,2855,5711,2855,0,1,2857,6604647,6.604647
3255,4805,5165,24817825,2,26046,6513,1,458161400,458161400,9766,3255,6511,3255,0,1,3257,933458,0.933458
3655,4805,5165,24817825,2,29246,7313,1,490065400,490065400,10966,3655,7311,3655,0,1,3657,1669066,1.669066
4055,4805,5165,24817825,2,32446,8113,1,521969400,521969400,12166,4055,8111,4055,0,1,4057,3040933,3.040933
4455,4805,5165,24817825,2,35646,8913,1,553873400,553873400,13366,4455,8911,4455,0,1,4457,838618,0.838618
4855,4805,5165,24817825,2,38846,9713,1,585777400,585777400,14566,4855,9711,4855,0,1,4857,3387049,3.387049
5255,4805,5165,24817825,2,42046,10513,1,617681400,617681400,15766,5255,10511,5255,0,1,5257,9392445,9.392445
5655,4805,5165,24817825,2,45246,11313,1,649585400,649585400,16966,5655,11311,5655,0,1,5657,869499,0.869499
6055,4805,5165,24817825,2,48446,12113,1,681489400,681489400,18166,6055,12111,6055,0,1,6057,3258519,3.258519
6455,4805,5165,24817825,2,51646,12913,1,713393400,713393400,19366,6455,12911,6455,0,1,6457,7502363,7.502363
6855,4805,5165,24817825,2,54846,13713,1,745297400,745297400,20566,6855,13711,6855,0,1,6857,31808951,31.808951
55,4305,5765,24818325,2,446,113,1,202977400,202977400,166,55,111,55,0,1,57,493078,0.493078
455,4305,5765,24818325,2,3646,913,1,235201400,235201400,1366,455,911,455,0,1,457,52274,0.052274
855,4305,5765,24818325,2,6846,1713,1,267425400,267425400,2566,855,1711,855,0,1,857,2061190,2.06119
1255,4305,5765,24818325,2,10046,2513,1,299649400,299649400,3766,1255,2511,1255,0,1,1257,44303,0.044303
1655,4305,5765,24818325,2,13246,3313,1,331873400,331873400,4966,1655,3311,1655,0,1,1657,212941,0.212941
2055,4305,5765,24818325,2,16446,4113,1,364097400,364097400,6166,2055,4111,2055,0,1,2057,340113,0.340113
2455,4305,5765,24818325,2,19646,4913,1,396321400,396321400,7366,2455,4911,2455,0,1,2457,580378,0.580378
2855,4305,5765,24818325,2,22846,5713,1,428545400,428545400,8566,2855,5711,2855,0,1,2857,2489814,2.489814
3255,4305,5765,24818325,2,26046,6513,1,460769400,460769400,9766,3255,6511,3255,0,1,3257,1357777,1.357777
3655,4305,5765,24818325,2,29246,7313,1,492993400,492993400,10966,3655,7311,3655,0,1,3657,733403,0.733403
4055,4305,5765,24818325,2,32446,8113,1,525217400,525217400,12166,4055,8111,4055,0,1,4057,5237284,5.237284
4455,4305,5765,24818325,2,35646,8913,1,557441400,557441400,13366,4455,8911,4455,0,1,4457,3670164,3.670164
4855,4305,5765,24818325,2,38846,9713,1,589665400,589665400,14566,4855,9711,4855,0,1,4857,977004,0.977004
5255,4305,5765,24818325,2,42046,10513,1,621889400,621889400,15766,5255,10511,5255,0,1,5257,1943725,1.943725
5655,4305,5765,24818325,2,45246,11313,1,654113400,654113400,16966,5655,11311,5655,0,1,5657,215007,0.215007
6055,4305,5765,24818325,2,48446,12113,1,686337400,686337400,18166,6055,12111,6055,0,1,6057,1135855,1.135855
6455,4305,5765,24818325,2,51646,12913,1,718561400,718561400,19366,6455,12911,6455,0,1,6457,420460,0.42046
6855,4305,5765,24818325,2,54846,13713,1,750785400,750785400,20566,6855,13711,6855,0,1,6857,4305962,4.305962
40,6300,3940,24822000,2,326,83,1,201852800,201852800,121,40,81,40,0,1,42,459502,0.459502
440,6300,3940,24822000,2,3526,883,1,234620800,234620800,1321,440,881,440,0,1,442,2230840,2.23084
840,6300,3940,24822000,2,6726,1683,1,267388800,267388800,2521,840,1681,840,0,1,842,737763,0.737763
1240,6300,3940,24822000,2,9926,2483,1,300156800,300156800,3721,1240,2481,1240,0,1,1242,109595,0.109595
1640,6300,3940,24822000,2,13126,3283,1,332924800,332924800,4921,1640,3281,1640,0,1,1642,4057253,4.057253
2040,6300,3940,24822000,2,16326,4083,1,365692800,365692800,6121,2040,4081,2040,0,1,2042,3575068,3.575068
2440,6300,3940,24822000,2,19526,4883,1,398460800,398460800,7321,2440,4881,2440,0,1,2442,396250,0.39625
2840,6300,3940,24822000,2,22726,5683,1,431228800,431228800,8521,2840,5681,2840,0,1,2842,13096301,13.096301
3240,6300,3940,24822000,2,25926,6483,1,463996800,463996800,9721,3240,6481,3240,0,1,3242,4938010,4.93801
3640,6300,3940,24822000,2,29126,7283,1,496764800,496764800,10921,3640,7281,3640,0,1,3642,1805689,1.805689
4040,6300,3940,24822000,2,32326,8083,1,529532800,529532800,12121,4040,8081,4040,0,1,4042,8789218,8.789218
4440,6300,3940,24822000,2,35526,8883,1,562300800,562300800,13321,4440,8881,4440,0,1,4442,6526431,6.526431
4840,6300,3940,24822000,2,38726,9683,1,595068800,595068800,14521,4840,9681,4840,0,1,4842,1520276,1.520276
5240,6300,3940,24822000,2,41926,10483,1,627836800,627836800,15721,5240,10481,5240,0,1,5242,6726518,6.726518
5640,6300,3940,24822000,2,45126,11283,1,660604800,660604800,16921,5640,11281,5640,0,1,5642,616380,0.61638
6040,6300,3940,24822000,2,48326,12083,1,693372800,693372800,18121,6040,12081,6040,0,1,6042,4962569,4.962569
6440,6300,3940,24822000,2,51526,12883,1,726140800,726140800,19321,6440,12881,6440,0,1,6442,18668583,18.668583
6840,6300,3940,24822000,2,54726,13683,1,758908800,758908800,20521,6840,13681,6840,0,1,6842,16403496,16.403496
55,4555,5465,24893075,2,446,113,1,203553400,203553400,166,55,111,55,0,1,57,507300,0.5073
455,4555,5465,24893075,2,3646,913,1,235617400,235617400,1366,455,911,455,0,1,457,2312934,2.312934
855,4555,5465,24893075,2,6846,1713,1,267681400,267681400,2566,855,1711,855,0,1,857,891015,0.891015
1255,4555,5465,24893075,2,10046,2513,1,299745400,299745400,3766,1255,2511,1255,0,1,1257,3307381,3.307381
1655,4555,5465,24893075,2,13246,3313,1,331809400,331809400,4966,1655,3311,1655,0,1,1657,1333475,1.333475
2055,4555,5465,24893075,2,16446,4113,1,363873400,363873400,6166,2055,4111,2055,0,1,2057,433657,0.433657
2455,4555,5465,24893075,2,19646,4913,1,395937400,395937400,7366,2455,4911,2455,0,1,2457,1499116,1.499116
2855,4555,5465,24893075,2,22846,5713,1,428001400,428001400,8566,2855,5711,2855,0,1,2857,250215,0.250215
3255,4555,5465,24893075,2,26046,6513,1,460065400,460065400,9766,3255,6511,3255,0,1,3257,123366,0.123366
3655,4555,5465,24893075,2,29246,7313,1,492129400,492129400,10966,3655,7311,3655,0,1,3657,9339615,9.339615
4055,4555,5465,24893075,2,32446,8113,1,524193400,524193400,12166,4055,8111,4055,0,1,4057,1616084,1.616084
4455,4555,5465,24893075,2,35646,8913,1,556257400,556257400,13366,4455,8911,4455,0,1,4457,7417150,7.41715
4855,4555,5465,24893075,2,38846,9713,1,588321400,588321400,14566,4855,9711,4855,0,1,4857,41572,0.041572
5255,4555,5465,24893075,2,42046,10513,1,620385400,620385400,15766,5255,10511,5255,0,1,5257,1369856,1.369856
5655,4555,5465,24893075,2,45246,11313,1,652449400,652449400,16966,5655,11311,5655,0,1,5657,1372163,1.372163
6055,4555,5465,24893075,2,48446,12113,1,684513400,684513400,18166,6055,12111,6055,0,1,6057,4643669,4.643669
6455,4555,5465,24893075,2,51646,12913,1,716577400,716577400,19366,6455,12911,6455,0,1,6457,1584037,1.584037
6855,4555,5465,24893075,2,54846,13713,1,748641400,748641400,20566,6855,13711,6855,0,1,6857,6248211,6.248211
55,6805,3665,24940325,2,446,113,1,204129400,204129400,166,55,111,55,0,1,57,500396,0.500396
455,6805,3665,24940325,2,3646,913,1,237633400,237633400,1366,455,911,455,0,1,457,895406,0.895406
855,6805,3665,24940325,2,6846,1713,1,271137400,271137400,2566,855,1711,855,0,1,857,3746269,3.746269
1255,6805,3665,24940325,2,10046,2513,1,304641400,304641400,3766,1255,2511,1255,0,1,1257,458321,0.458321
1655,6805,3665,24940325,2,13246,3313,1,338145400,338145400,4966,1655,3311,1655,0,1,1657,594395,0.594395
2055,6805,3665,24940325,2,16446,4113,1,371649400,371649400,6166,2055,4111,2055,0,1,2057,941256,0.941256
2455,6805,3665,24940325,2,19646,4913,1,405153400,405153400,7366,2455,4911,2455,0,1,2457,2122022,2.122022
2855,6805,3665,24940325,2,22846,5713,1,438657400,438657400,8566,2855,5711,2855,0,1,2857,1956133,1.956133
3255,6805,3665,24940325,2,26046,6513,1,472161400,472161400,9766,3255,6511,3255,0,1,3257,628943,0.628943
3655,6805,3665,24940325,2,29246,7313,1,505665400,505665400,10966,3655,7311,3655,0,1,3657,1042485,1.042485
4055,6805,3665,24940325,2,32446,8113,1,539169400,539169400,12166,4055,8111,4055,0,1,4057,442480,0.44248
4455,6805,3665,24940325,2,35646,8913,1,572673400,572673400,13366,4455,8911,4455,0,1,4457,287287,0.287287
4855,6805,3665,24940325,2,38846,9713,1,606177400,606177400,14566,4855,9711,4855,0,1,4857,117920,0.11792
5255,6805,3665,24940325,2,42046,10513,1,639681400,639681400,15766,5255,10511,5255,0,1,5257,4876816,4.876816
5655,6805,3665,24940325,2,45246,11313,1,673185400,673185400,16966,5655,11311,5655,0,1,5657,1153414,1.153414
6055,6805,3665,24940325,2,48446,12113,1,706689400,706689400,18166,6055,12111,6055,0,1,6057,10550233,10.550233
6455,6805,3665,24940325,2,51646,12913,1,740193400,740193400,19366,6455,12911,6455,0,1,6457,4008113,4.008113
6855,6805,3665,24940325,2,54846,13713,1,773697400,773697400,20566,6855,13711,6855,0,1,6857,1277163,1.277163
35,4950,5045,24972750,2,286,73,1,202580600,202580600,106,35,71,35,0,1,37,265422,0.265422
535,4950,5045,24972750,2,4286,1073,1,242560600,242560600,1606,535,1071,535,0,1,537,54855,0.054855
1035,4950,5045,24972750,2,8286,2073,1,282540600,282540600,3106,1035,2071,1035,0,1,1037,19084,0.019084
1535,4950,5045,24972750,2,12286,3073,1,322520600,322520600,4606,1535,3071,1535,0,1,1537,1573678,1.573678
2035,4950,5045,24972750,2,16286,4073,1,362500600,362500600,6106,2035,4071,2035,0,1,2037,2777291,2.777291
2535,4950,5045,24972750,2,20286,5073,1,402480600,402480600,7606,2535,5071,2535,0,1,2537,929770,0.92977
3035,4950,5045,24972750,2,24286,6073,1,442460600,442460600,9106,3035,6071,3035,0,1,3037,8456070,8.45607
3535,4950,5045,24972750,2,28286,7073,1,482440600,482440600,10606,3535,7071,3535,0,1,3537,3763532,3.763532
4035,4950,5045,24972750,2,32286,8073,1,522420600,522420600,12106,4035,8071,4035,0,1,4037,1241709,1.241709
4535,4950,5045,24972750,2,36286,9073,1,562400600,562400600,13606,4535,9071,4535,0,1,4537,5342136,5.342136
5035,4950,5045,24972750,2,40286,10073,1,602380600,602380600,15106,5035,10071,5035,0,1,5037,8296182,8.296182
5535,4950,5045,24972750,2,44286,11073,1,642360600,642360600,16606,5535,11071,5535,0,1,5537,4623052,4.623052
6035,4950,5045,24972750,2,48286,12073,1,682340600,682340600,18106,6035,12071,6035,0,1,6037,6901646,6.901646
6535,4950,5045,24972750,2,52286,13073,1,722320600,722320600,19606,6535,13071,6535,0,1,6537,1064572,1.064572
7035,4950,5045,24972750,2,56286,14073,1,762300600,762300600,21106,7035,14071,7035,0,1,7037,1417595,1.417595
35,5500,4545,24997500,2,286,73,1,202792600,202792600,106,35,71,35,0,1,37,26021,0.026021
535,5500,4545,24997500,2,4286,1073,1,242972600,242972600,1606,535,1071,535,0,1,537,632525,0.632525
1035,5500,4545,24997500,2,8286,2073,1,283152600,283152600,3106,1035,2071,1035,0,1,1037,2197635,2.197635
1535,5500,4545,24997500,2,12286,3073,1,323332600,323332600,4606,1535,3071,1535,0,1,1537,1268975,1.268975
2035,5500,4545,24997500,2,16286,4073,1,363512600,363512600,6106,2035,4071,2035,0,1,2037,3074629,3.074629
2535,5500,4545,24997500,2,20286,5073,1,403692600,403692600,7606,2535,5071,2535,0,1,2537,59297,0.059297
3035,5500,4545,24997500,2,24286,6073,1,443872600,443872600,9106,3035,6071,3035,0,1,3037,1191494,1.191494
3535,5500,4545,24997500,2,28286,7073,1,484052600,484052600,10606,3535,7071,3535,0,1,3537,606949,0.606949
4035,5500,4545,24997500,2,32286,8073,1,524232600,524232600,12106,4035,8071,4035,0,1,4037,8002337,8.002337
4535,5500,4545,24997500,2,36286,9073,1,564412600,564412600,13606,4535,9071,4535,0,1,4537,672236,0.672236
5035,5500,4545,24997500,2,40286,10073,1,604592600,604592600,15106,5035,10071,5035,0,1,5037,2007947,2.007947
5535,5500,4545,24997500,2,44286,11073,1,644772600,644772600,16606,5535,11071,5535,0,1,5537,4008293,4.008293
6035,5500,4545,24997500,2,48286,12073,1,684952600,684952600,18106,6035,12071,6035,0,1,6037,3376352,3.376352
6535,5500,4545,24997500,2,52286,13073,1,725132600,725132600,19606,6535,13071,6535,0,1,6537,6403296,6.403296
7035,5500,4545,24997500,2,56286,14073,1,765312600,765312600,21106,7035,14071,7035,0,1,7037,548477,0.548477
55,6305,3965,24999325,2,446,113,1,204513400,204513400,166,55,111,55,0,1,57,520490,0.52049
455,6305,3965,24999325,2,3646,913,1,237377400,237377400,1366,455,911,455,0,1,457,2362010,2.36201
855,6305,3965,24999325,2,6846,1713,1,270241400,270241400,2566,855,1711,855,0,1,857,2013079,2.013079
1255,6305,3965,24999325,2,10046,2513,1,303105400,303105400,3766,1255,2511,1255,0,1,1257,6092988,6.092988
1655,6305,3965,24999325,2,13246,3313,1,335969400,335969400,4966,1655,3311,1655,0,1,1657,1555432,1.555432
2055,6305,3965,24999325,2,16446,4113,1,368833400,368833400,6166,2055,4111,2055,0,1,2057,5864208,5.864208
2455,6305,3965,24999325,2,19646,4913,1,401697400,401697400,7366,2455,4911,2455,0,1,2457,5041924,5.041924
2855,6305,3965,24999325,2,22846,5713,1,434561400,434561400,8566,2855,5711,2855,0,1,2857,798112,0.798112
3255,6305,3965,24999325,2,26046,6513,1,467425400,467425400,9766,3255,6511,3255,0,1,3257,6650314,6.650314
3655,6305,3965,24999325,2,29246,7313,1,500289400,500289400,10966,3655,7311,3655,0,1,3657,3195778,3.195778
4055,6305,3965,24999325,2,32446,8113,1,533153400,533153400,12166,4055,8111,4055,0,1,4057,210606,0.210606
4455,6305,3965,24999325,2,35646,8913,1,566017400,566017400,13366,4455,8911,4455,0,1,4457,1665513,1.665513
4855,6305,3965,24999325,2,38846,9713,1,598881400,598881400,14566,4855,9711,4855,0,1,4857,1168180,1.16818
5255,6305,3965,24999325,2,42046,10513,1,631745400,631745400,15766,5255,10511,5255,0,1,5257,9510448,9.510448
5655,6305,3965,24999325,2,45246,11313,1,664609400,664609400,16966,5655,11311,5655,0,1,5657,3366361,3.366361
6055,6305,3965,24999325,2,48446,12113,1,697473400,697473400,18166,6055,12111,6055,0,1,6057,6223492,6.223492
6455,6305,3965,24999325,2,51646,12913,1,730337400,730337400,19366,6455,12911,6455,0,1,6457,7715190,7.71519
6855,6305,3965,24999325,2,54846,13713,1,763201400,763201400,20566,6855,13711,6855,0,1,6857,9002362,9.002362
39,4993,5041,25169713,2,318,81,1,204488312,204488312,118,39,79,39,0,1,41,442988,0.442988
539,4993,5041,25169713,2,4318,1081,1,244624312,244624312,1618,539,1079,539,0,1,541,2727435,2.727435
1039,4993,5041,25169713,2,8318,2081,1,284760312,284760312,3118,1039,2079,1039,0,1,1041,2066486,2.066486
1539,4993,5041,25169713,2,12318,3081,1,324896312,324896312,4618,1539,3079,1539,0,1,1541,2876675,2.876675
2039,4993,5041,25169713,2,16318,4081,1,365032312,365032312,6118,2039,4079,2039,0,1,2041,2536486,2.536486
2539,4993,5041,25169713,2,20318,5081,1,405168312,405168312,7618,2539,5079,2539,0,1,2541,229142,0.229142
3039,4993,5041,25169713,2,24318,6081,1,445304312,445304312,9118,3039,6079,3039,0,1,3041,3783659,3.783659
3539,4993,5041,25169713,2,28318,7081,1,485440312,485440312,10618,3539,7079,3539,0,1,3541,6161678,6.161678
4039,4993,5041,25169713,2,32318,8081,1,525576312,525576312,12118,4039,8079,4039,0,1,4041,14101161,14.101161
4539,4993,5041,25169713,2,36318,9081,1,565712312,565712312,13618,4539,9079,4539,0,1,4541,15443926,15.443926
5039,4993,5041,25169713,2,40318,10081,1,605848312,605848312,15118,5039,10079,5039,0,1,5041,10271538,10.271538
5539,4993,5041,25169713,2,44318,11081,1,645984312,645984312,16618,5539,11079,5539,0,1,5541,8184864,8.184864
6039,4993,5041,25169713,2,48318,12081,1,686120312,686120312,18118,6039,12079,6039,0,1,6041,28460276,28.460276
6539,4993,5041,25169713,2,52318,13081,1,726256312,726256312,19618,6539,13079,6539,0,1,6541,30860398,30.860398
7039,4993,5041,25169713,2,56318,14081,1,766392312,766392312,21118,7039,14079,7039,0,1,7041,33175282,33.175282
39,5543,4541,25170763,2,318,81,1,204512312,204512312,118,39,79,39,0,1,41,75284,0.075284
539,5543,4541,25170763,2,4318,1081,1,244848312,244848312,1618,539,1079,539,0,1,541,201196,0.201196
1039,5543,4541,25170763,2,8318,2081,1,285184312,285184312,3118,1039,2079,1039,0,1,1041,141674,0.141674
1539,5543,4541,25170763,2,12318,3081,1,325520312,325520312,4618,1539,3079,1539,0,1,1541,289351,0.289351
2039,5543,4541,25170763,2,16318,4081,1,365856312,365856312,6118,2039,4079,2039,0,1,2041,1029622,1.029622
2539,5543,4541,25170763,2,20318,5081,1,406192312,406192312,7618,2539,5079,2539,0,1,2541,20093,0.020093
3039,5543,4541,25170763,2,24318,6081,1,446528312,446528312,9118,3039,6079,3039,0,1,3041,89766,0.089766
3539,5543,4541,25170763,2,28318,7081,1,486864312,486864312,10618,3539,7079,3539,0,1,3541,235616,0.235616
4039,5543,4541,25170763,2,32318,8081,1,527200312,527200312,12118,4039,8079,4039,0,1,4041,1503008,1.503008
4539,5543,4541,25170763,2,36318,9081,1,567536312,567536312,13618,4539,9079,4539,0,1,4541,1558392,1.558392
5039,5543,4541,25170763,2,40318,10081,1,607872312,607872312,15118,5039,10079,5039,0,1,5041,1244144,1.244144
5539,5543,4541,25170763,2,44318,11081,1,648208312,648208312,16618,5539,11079,5539,0,1,5541,248323,0.248323
6039,5543,4541,25170763,2,48318,12081,1,688544312,688544312,18118,6039,12079,6039,0,1,6041,2755676,2.755676
6539,5543,4541,25170763,2,52318,13081,1,728880312,728880312,19618,6539,13079,6539,0,1,6541,3784745,3.784745
7039,5543,4541,25170763,2,56318,14081,1,769216312,769216312,21118,7039,14079,7039,0,1,7041,6454000,6.454
35,5540,4545,25179300,2,286,73,1,204258200,204258200,106,35,71,35,0,1,37,247713,0.247713
535,5540,4545,25179300,2,4286,1073,1,244598200,244598200,1606,535,1071,535,0,1,537,617214,0.617214
1035,5540,4545,25179300,2,8286,2073,1,284938200,284938200,3106,1035,2071,1035,0,1,1037,2241577,2.241577
1535,5540,4545,25179300,2,12286,3073,1,325278200,325278200,4606,1535,3071,1535,0,1,1537,3733094,3.733094
40,5550,4540,25197000,2,326,83,1,204804800,204804800,121,40,81,40,0,1,42,463988,0.463988
440,5550,4540,25197000,2,3526,883,1,237092800,237092800,1321,440,881,440,0,1,442,2318976,2.318976
840,5550,4540,25197000,2,6726,1683,1,269380800,269380800,2521,840,1681,840,0,1,842,4238045,4.238045
1240,5550,4540,25197000,2,9926,2483,1,301668800,301668800,3721,1240,2481,1240,0,1,1242,2563746,2.563746
1640,5550,4540,25197000,2,13126,3283,1,333956800,333956800,4921,1640,3281,1640,0,1,1642,46500,0.0465
2040,5550,4540,25197000,2,16326,4083,1,366244800,366244800,6121,2040,4081,2040,0,1,2042,2578599,2.578599
2440,5550,4540,25197000,2,19526,4883,1,398532800,398532800,7321,2440,4881,2440,0,1,2442,4352952,4.352952
2840,5550,4540,25197000,2,22726,5683,1,430820800,430820800,8521,2840,5681,2840,0,1,2842,6891610,6.89161
3240,5550,4540,25197000,2,25926,6483,1,463108800,463108800,9721,3240,6481,3240,0,1,3242,1620966,1.620966
3640,5550,4540,25197000,2,29126,7283,1,495396800,495396800,10921,3640,7281,3640,0,1,3642,954579,0.954579
4040,5550,4540,25197000,2,32326,8083,1,527684800,527684800,12121,4040,8081,4040,0,1,4042,1444286,1.444286
4440,5550,4540,25197000,2,35526,8883,1,559972800,559972800,13321,4440,8881,4440,0,1,4442,1324373,1.324373
4840,5550,4540,25197000,2,38726,9683,1,592260800,592260800,14521,4840,9681,4840,0,1,4842,407824,0.407824
5240,5550,4540,25197000,2,41926,10483,1,624548800,624548800,15721,5240,10481,5240,0,1,5242,3433383,3.433383
5640,5550,4540,25197000,2,45126,11283,1,656836800,656836800,16921,5640,11281,5640,0,1,5642,836197,0.836197
6040,5550,4540,25197000,2,48326,12083,1,689124800,689124800,18121,6040,12081,6040,0,1,6042,192648,0.192648
6440,5550,4540,25197000,2,51526,12883,1,721412800,721412800,19321,6440,12881,6440,0,1,6442,11781175,11.781175
6840,5550,4540,25197000,2,54726,13683,1,753700800,753700800,20521,6840,13681,6840,0,1,6842,24410284,24.410284
40,3800,6640,25232000,2,326,83,1,205196800,205196800,121,40,81,40,0,1,42,445618,0.445618
440,3800,6640,25232000,2,3526,883,1,238604800,238604800,1321,440,881,440,0,1,442,2283860,2.28386
840,3800,6640,25232000,2,6726,1683,1,272012800,272012800,2521,840,1681,840,0,1,842,4116444,4.116444
1240,3800,6640,25232000,2,9926,2483,1,305420800,305420800,3721,1240,2481,1240,0,1,1242,2438507,2.438507
1640,3800,6640,25232000,2,13126,3283,1,338828800,338828800,4921,1640,3281,1640,0,1,1642,7865690,7.86569
2040,3800,6640,25232000,2,16326,4083,1,372236800,372236800,6121,2040,4081,2040,0,1,2042,9731561,9.731561
2440,3800,6640,25232000,2,19526,4883,1,405644800,405644800,7321,2440,4881,2440,0,1,2442,4194330,4.19433
2840,3800,6640,25232000,2,22726,5683,1,439052800,439052800,8521,2840,5681,2840,0,1,2842,3389592,3.389592
3240,3800,6640,25232000,2,25926,6483,1,472460800,472460800,9721,3240,6481,3240,0,1,3242,25573,0.025573
3640,3800,6640,25232000,2,29126,7283,1,505868800,505868800,10921,3640,7281,3640,0,1,3642,420167,0.420167
4040,3800,6640,25232000,2,32326,8083,1,539276800,539276800,12121,4040,8081,4040,0,1,4042,1113638,1.113638
4440,3800,6640,25232000,2,35526,8883,1,572684800,572684800,13321,4440,8881,4440,0,1,4442,1630359,1.630359
4840,3800,6640,25232000,2,38726,9683,1,606092800,606092800,14521,4840,9681,4840,0,1,4842,819020,0.81902
5240,3800,6640,25232000,2,41926,10483,1,639500800,639500800,15721,5240,10481,5240,0,1,5242,1371326,1.371326
5640,3800,6640,25232000,2,45126,11283,1,672908800,672908800,16921,5640,11281,5640,0,1,5642,579781,0.579781
6040,3800,6640,25232000,2,48326,12083,1,706316800,706316800,18121,6040,12081,6040,0,1,6042,1762703,1.762703
6440,3800,6640,25232000,2,51526,12883,1,739724800,739724800,19321,6440,12881,6440,0,1,6442,8427705,8.427705
6840,3800,6640,25232000,2,54726,13683,1,773132800,773132800,20521,6840,13681,6840,0,1,6842,2487334,2.487334
44,5003,5055,25290165,2,358,91,1,205861736,205861736,133,44,89,44,0,1,46,472063,0.472063
544,5003,5055,25290165,2,4358,1091,1,246093736,246093736,1633,544,1089,544,0,1,546,2764134,2.764134
1044,5003,5055,25290165,2,8358,2091,1,286325736,286325736,3133,1044,2089,1044,0,1,1046,1953678,1.953678
1544,5003,5055,25290165,2,12358,3091,1,326557736,326557736,4633,1544,3089,1544,0,1,1546,3950977,3.950977
2044,5003,5055,25290165,2,16358,4091,1,366789736,366789736,6133,2044,4089,2044,0,1,2046,3638721,3.638721
2544,5003,5055,25290165,2,20358,5091,1,407021736,407021736,7633,2544,5089,2544,0,1,2546,7211037,7.211037
3044,5003,5055,25290165,2,24358,6091,1,447253736,447253736,9133,3044,6089,3044,0,1,3046,1913954,1.913954
3544,5003,5055,25290165,2,28358,7091,1,487485736,487485736,10633,3544,7089,3544,0,1,3546,756199,0.756199
4044,5003,5055,25290165,2,32358,8091,1,527717736,527717736,12133,4044,8089,4044,0,1,4046,9216181,9.216181
4544,5003,5055,25290165,2,36358,9091,1,567949736,567949736,13633,4544,9089,4544,0,1,4546,2035639,2.035639
5044,5003,5055,25290165,2,40358,10091,1,608181736,608181736,15133,5044,10089,5044,0,1,5046,12398284,12.398284
5544,5003,5055,25290165,2,44358,11091,1,648413736,648413736,16633,5544,11089,5544,0,1,5546,26301256,26.301256
6044,5003,5055,25290165,2,48358,12091,1,688645736,688645736,18133,6044,12089,6044,0,1,6046,28740460,28.74046
6544,5003,5055,25290165,2,52358,13091,1,728877736,728877736,19633,6544,13089,6544,0,1,6546,31035431,31.035431
7044,5003,5055,25290165,2,56358,14091,1,769109736,769109736,21133,7044,14089,7044,0,1,7046,33384202,33.384202
44,5553,4555,25293915,2,358,91,1,205909336,205909336,133,44,89,44,0,1,46,49914,0.049914
544,5553,4555,25293915,2,4358,1091,1,246341336,246341336,1633,544,1089,544,0,1,546,135641,0.135641
1044,5553,4555,25293915,2,8358,2091,1,286773336,286773336,3133,1044,2089,1044,0,1,1046,93590,0.09359
1544,5553,4555,25293915,2,12358,3091,1,327205336,327205336,4633,1544,3089,1544,0,1,1546,887593,0.887593
2044,5553,4555,25293915,2,16358,4091,1,367637336,367637336,6133,2044,4089,2044,0,1,2046,276432,0.276432
2544,5553,4555,25293915,2,20358,5091,1,408069336,408069336,7633,2544,5089,2544,0,1,2546,154220,0.15422
3044,5553,4555,25293915,2,24358,6091,1,448501336,448501336,9133,3044,6089,3044,0,1,3046,299518,0.299518
3544,5553,4555,25293915,2,28358,7091,1,488933336,488933336,10633,3544,7089,3544,0,1,3546,344890,0.34489
4044,5553,4555,25293915,2,32358,8091,1,529365336,529365336,12133,4044,8089,4044,0,1,4046,941410,0.94141
4544,5553,4555,25293915,2,36358,9091,1,569797336,569797336,13633,4544,9089,4544,0,1,4546,6199518,6.199518
5044,5553,4555,25293915,2,40358,10091,1,610229336,610229336,15133,5044,10089,5044,0,1,5046,1576143,1.576143
5544,5553,4555,25293915,2,44358,11091,1,650661336,650661336,16633,5544,11089,5544,0,1,5546,2722784,2.722784
6044,5553,4555,25293915,2,48358,12091,1,691093336,691093336,18133,6044,12089,6044,0,1,6046,3761708,3.761708
6544,5553,4555,25293915,2,52358,13091,1,731525336,731525336,19633,6544,13089,6544,0,1,6546,1398407,1.398407
7044,5553,4555,25293915,2,56358,14091,1,771957336,771957336,21133,7044,14089,7044,0,1,7046,981887,0.981887
55,5555,4565,25358575,2,446,113,1,207321400,207321400,166,55,111,55,0,1,57,522767,0.522767
455,5555,4565,25358575,2,3646,913,1,239705400,239705400,1366,455,911,455,0,1,457,2414062,2.414062
855,5555,4565,25358575,2,6846,1713,1,272089400,272089400,2566,855,1711,855,0,1,857,2704054,2.704054
1255,5555,4565,25358575,2,10046,2513,1,304473400,304473400,3766,1255,2511,1255,0,1,1257,487576,0.487576
1655,5555,4565,25358575,2,13246,3313,1,336857400,336857400,4966,1655,3311,1655,0,1,1657,2402888,2.402888
2055,5555,4565,25358575,2,16446,4113,1,369241400,369241400,6166,2055,4111,2055,0,1,2057,247728,0.247728
2455,5555,4565,25358575,2,19646,4913,1,401625400,401625400,7366,2455,4911,2455,0,1,2457,1393759,1.393759
2855,5555,4565,25358575,2,22846,5713,1,434009400,434009400,8566,2855,5711,2855,0,1,2857,855747,0.855747
3255,5555,4565,25358575,2,26046,6513,1,466393400,466393400,9766,3255,6511,3255,0,1,3257,2166613,2.166613
3655,5555,4565,25358575,2,29246,7313,1,498777400,498777400,10966,3655,7311,3655,0,1,3657,1080604,1.080604
4055,5555,4565,25358575,2,32446,8113,1,531161400,531161400,12166,4055,8111,4055,0,1,4057,5178180,5.17818
4455,5555,4565,25358575,2,35646,8913,1,563545400,563545400,13366,4455,8911,4455,0,1,4457,9582279,9.582279
4855,5555,4565,25358575,2,38846,9713,1,595929400,595929400,14566,4855,9711,4855,0,1,4857,5226152,5.226152
5255,5555,4565,25358575,2,42046,10513,1,628313400,628313400,15766,5255,10511,5255,0,1,5257,335684,0.335684
5655,5555,4565,25358575,2,45246,11313,1,660697400,660697400,16966,5655,11311,5655,0,1,5657,4981759,4.981759
6055,5555,4565,25358575,2,48446,12113,1,693081400,693081400,18166,6055,12111,6055,0,1,6057,8219596,8.219596
6455,5555,4565,25358575,2,51646,12913,1,725465400,725465400,19366,6455,12911,6455,0,1,6457,1830540,1.83054
6855,5555,4565,25358575,2,54846,13713,1,757849400,757849400,20566,6855,13711,6855,0,1,6857,9100474,9.100474
55,3805,6665,25360325,2,446,113,1,207489400,207489400,166,55,111,55,0,1,57,525244,0.525244
455,3805,6665,25360325,2,3646,913,1,240993400,240993400,1366,455,911,455,0,1,457,2461192,2.461192
855,3805,6665,25360325,2,6846,1713,1,274497400,274497400,2566,855,1711,855,0,1,857,4414733,4.414733
1255,3805,6665,25360325,2,10046,2513,1,308001400,308001400,3766,1255,2511,1255,0,1,1257,6353288,6.353288
1655,3805,6665,25360325,2,13246,3313,1,341505400,341505400,4966,1655,3311,1655,0,1,1657,986459,0.986459
2055,3805,6665,25360325,2,16446,4113,1,375009400,375009400,6166,2055,4111,2055,0,1,2057,2395373,2.395373
2455,3805,6665,25360325,2,19646,4913,1,408513400,408513400,7366,2455,4911,2455,0,1,2457,916770,0.91677
2855,3805,6665,25360325,2,22846,5713,1,442017400,442017400,8566,2855,5711,2855,0,1,2857,805284,0.805284
3255,3805,6665,25360325,2,26046,6513,1,475521400,475521400,9766,3255,6511,3255,0,1,3257,5494634,5.494634
3655,3805,6665,25360325,2,29246,7313,1,509025400,509025400,10966,3655,7311,3655,0,1,3657,144554,0.144554
4055,3805,6665,25360325,2,32446,8113,1,542529400,542529400,12166,4055,8111,4055,0,1,4057,1360867,1.360867
4455,3805,6665,25360325,2,35646,8913,1,576033400,576033400,13366,4455,8911,4455,0,1,4457,1897732,1.897732
4855,3805,6665,25360325,2,38846,9713,1,609537400,609537400,14566,4855,9711,4855,0,1,4857,3162885,3.162885
5255,3805,6665,25360325,2,42046,10513,1,643041400,643041400,15766,5255,10511,5255,0,1,5257,666913,0.666913
5655,3805,6665,25360325,2,45246,11313,1,676545400,676545400,16966,5655,11311,5655,0,1,5657,1235609,1.235609
6055,3805,6665,25360325,2,48446,12113,1,710049400,710049400,18166,6055,12111,6055,0,1,6057,6668514,6.668514
6455,3805,6665,25360325,2,51646,12913,1,743553400,743553400,19366,6455,12911,6455,0,1,6457,6726413,6.726413
6855,3805,6665,25360325,2,54846,13713,1,777057400,777057400,20566,6855,13711,6855,0,1,6857,1475968,1.475968
39,3893,6541,25464113,2,318,81,1,206968312,206968312,118,39,79,39,0,1,41,465598,0.465598
539,3893,6541,25464113,2,4318,1081,1,248704312,248704312,1618,539,1079,539,0,1,541,2869687,2.869687
1039,3893,6541,25464113,2,8318,2081,1,290440312,290440312,3118,1039,2079,1039,0,1,1041,5242459,5.242459
1539,3893,6541,25464113,2,12318,3081,1,332176312,332176312,4618,1539,3079,1539,0,1,1541,6614412,6.614412
2039,3893,6541,25464113,2,16318,4081,1,373912312,373912312,6118,2039,4079,2039,0,1,2041,165616,0.165616
2539,3893,6541,25464113,2,20318,5081,1,415648312,415648312,7618,2539,5079,2539,0,1,2541,1112979,1.112979
3039,3893,6541,25464113,2,24318,6081,1,457384312,457384312,9118,3039,6079,3039,0,1,3041,9842514,9.842514
3539,3893,6541,25464113,2,28318,7081,1,499120312,499120312,10618,3539,7079,3539,0,1,3541,1302604,1.302604
4039,3893,6541,25464113,2,32318,8081,1,540856312,540856312,12118,4039,8079,4039,0,1,4041,1110082,1.110082
4539,3893,6541,25464113,2,36318,9081,1,582592312,582592312,13618,4539,9079,4539,0,1,4541,951628,0.951628
5039,3893,6541,25464113,2,40318,10081,1,624328312,624328312,15118,5039,10079,5039,0,1,5041,6358857,6.358857
5539,3893,6541,25464113,2,44318,11081,1,666064312,666064312,16618,5539,11079,5539,0,1,5541,4889404,4.889404
6039,3893,6541,25464113,2,48318,12081,1,707800312,707800312,18118,6039,12079,6039,0,1,6041,425724,0.425724
6539,3893,6541,25464113,2,52318,13081,1,749536312,749536312,19618,6539,13079,6539,0,1,6541,13254083,13.254083
7039,3893,6541,25464113,2,56318,14081,1,791272312,791272312,21118,7039,14079,7039,0,1,7041,30846365,30.846365
44,3903,6555,25584165,2,358,91,1,208354536,208354536,133,44,89,44,0,1,46,489823,0.489823
544,3903,6555,25584165,2,4358,1091,1,250186536,250186536,1633,544,1089,544,0,1,546,824740,0.82474
1044,3903,6555,25584165,2,8358,2091,1,292018536,292018536,3133,1044,2089,1044,0,1,1046,3206512,3.206512
1544,3903,6555,25584165,2,12358,3091,1,333850536,333850536,4633,1544,3089,1544,0,1,1546,7772609,7.772609
2044,3903,6555,25584165,2,16358,4091,1,375682536,375682536,6133,2044,4089,2044,0,1,2046,4283072,4.283072
2544,3903,6555,25584165,2,20358,5091,1,417514536,417514536,7633,2544,5089,2544,0,1,2546,128916,0.128916
3044,3903,6555,25584165,2,24358,6091,1,459346536,459346536,9133,3044,6089,3044,0,1,3046,67140,0.06714
3544,3903,6555,25584165,2,28358,7091,1,501178536,501178536,10633,3544,7089,3544,0,1,3546,191446,0.191446
4044,3903,6555,25584165,2,32358,8091,1,543010536,543010536,12133,4044,8089,4044,0,1,4046,1671675,1.671675
4544,3903,6555,25584165,2,36358,9091,1,584842536,584842536,13633,4544,9089,4544,0,1,4546,301365,0.301365
5044,3903,6555,25584165,2,40358,10091,1,626674536,626674536,15133,5044,10089,5044,0,1,5046,4475136,4.475136
5544,3903,6555,25584165,2,44358,11091,1,668506536,668506536,16633,5544,11089,5544,0,1,5546,7070734,7.070734
6044,3903,6555,25584165,2,48358,12091,1,710338536,710338536,18133,6044,12089,6044,0,1,6046,19562543,19.562543
6544,3903,6555,25584165,2,52358,13091,1,752170536,752170536,19633,6544,13089,6544,0,1,6546,20267963,20.267963
7044,3903,6555,25584165,2,56358,14091,1,794002536,794002536,21133,7044,14089,7044,0,1,7046,9775583,9.775583
40,5300,4840,25652000,2,326,83,1,208460800,208460800,121,40,81,40,0,1,42,466495,0.466495
440,5300,4840,25652000,2,3526,883,1,240908800,240908800,1321,440,881,440,0,1,442,2370788,2.370788
840,5300,4840,25652000,2,6726,1683,1,273356800,273356800,2521,840,1681,840,0,1,842,617211,0.617211
1240,5300,4840,25652000,2,9926,2483,1,305804800,305804800,3721,1240,2481,1240,0,1,1242,5139703,5.139703
1640,5300,4840,25652000,2,13126,3283,1,338252800,338252800,4921,1640,3281,1640,0,1,1642,1574834,1.574834
2040,5300,4840,25652000,2,16326,4083,1,370700800,370700800,6121,2040,4081,2040,0,1,2042,337503,0.337503
40,6050,4240,25652000,2,326,83,1,208508800,208508800,121,40,81,40,0,1,42,444322,0.444322
440,6050,4240,25652000,2,3526,883,1,241436800,241436800,1321,440,881,440,0,1,442,804298,0.804298
840,6050,4240,25652000,2,6726,1683,1,274364800,274364800,2521,840,1681,840,0,1,842,41625,0.041625
2440,5300,4840,25652000,2,19526,4883,1,403148800,403148800,7321,2440,4881,2440,0,1,2442,165366,0.165366
1240,6050,4240,25652000,2,9926,2483,1,307292800,307292800,3721,1240,2481,1240,0,1,1242,4049064,4.049064
1640,6050,4240,25652000,2,13126,3283,1,340220800,340220800,4921,1640,3281,1640,0,1,1642,1222875,1.222875
2840,5300,4840,25652000,2,22726,5683,1,435596800,435596800,8521,2840,5681,2840,0,1,2842,2521368,2.521368
2040,6050,4240,25652000,2,16326,4083,1,373148800,373148800,6121,2040,4081,2040,0,1,2042,1996096,1.996096
3240,5300,4840,25652000,2,25926,6483,1,468044800,468044800,9721,3240,6481,3240,0,1,3242,281819,0.281819
2440,6050,4240,25652000,2,19526,4883,1,406076800,406076800,7321,2440,4881,2440,0,1,2442,650173,0.650173
3640,5300,4840,25652000,2,29126,7283,1,500492800,500492800,10921,3640,7281,3640,0,1,3642,1372089,1.372089
2840,6050,4240,25652000,2,22726,5683,1,439004800,439004800,8521,2840,5681,2840,0,1,2842,379602,0.379602
3240,6050,4240,25652000,2,25926,6483,1,471932800,471932800,9721,3240,6481,3240,0,1,3242,572157,0.572157
4040,5300,4840,25652000,2,32326,8083,1,532940800,532940800,12121,4040,8081,4040,0,1,4042,243162,0.243162
3640,6050,4240,25652000,2,29126,7283,1,504860800,504860800,10921,3640,7281,3640,0,1,3642,402026,0.402026
4440,5300,4840,25652000,2,35526,8883,1,565388800,565388800,13321,4440,8881,4440,0,1,4442,1573738,1.573738
4040,6050,4240,25652000,2,32326,8083,1,537788800,537788800,12121,4040,8081,4040,0,1,4042,795970,0.79597
4840,5300,4840,25652000,2,38726,9683,1,597836800,597836800,14521,4840,9681,4840,0,1,4842,2736466,2.736466
4440,6050,4240,25652000,2,35526,8883,1,570716800,570716800,13321,4440,8881,4440,0,1,4442,299787,0.299787
5240,5300,4840,25652000,2,41926,10483,1,630284800,630284800,15721,5240,10481,5240,0,1,5242,673841,0.673841
4840,6050,4240,25652000,2,38726,9683,1,603644800,603644800,14521,4840,9681,4840,0,1,4842,1072580,1.07258
5640,5300,4840,25652000,2,45126,11283,1,662732800,662732800,16921,5640,11281,5640,0,1,5642,2097978,2.097978
5240,6050,4240,25652000,2,41926,10483,1,636572800,636572800,15721,5240,10481,5240,0,1,5242,1204062,1.204062
6040,5300,4840,25652000,2,48326,12083,1,695180800,695180800,18121,6040,12081,6040,0,1,6042,8406699,8.406699
5640,6050,4240,25652000,2,45126,11283,1,669500800,669500800,16921,5640,11281,5640,0,1,5642,1884908,1.884908
6440,5300,4840,25652000,2,51526,12883,1,727628800,727628800,19321,6440,12881,6440,0,1,6442,9579097,9.579097
6040,6050,4240,25652000,2,48326,12083,1,702428800,702428800,18121,6040,12081,6040,0,1,6042,3834694,3.834694
6840,5300,4840,25652000,2,54726,13683,1,760076800,760076800,20521,6840,13681,6840,0,1,6842,2235794,2.235794
6440,6050,4240,25652000,2,51526,12883,1,735356800,735356800,19321,6440,12881,6440,0,1,6442,195756,0.195756
6840,6050,4240,25652000,2,54726,13683,1,768284800,768284800,20521,6840,13681,6840,0,1,6842,173167,0.173167
40,7050,3640,25662000,2,326,83,1,208716800,208716800,121,40,81,40,0,1,42,446696,0.446696
440,7050,3640,25662000,2,3526,883,1,242924800,242924800,1321,440,881,440,0,1,442,2362614,2.362614
840,7050,3640,25662000,2,6726,1683,1,277132800,277132800,2521,840,1681,840,0,1,842,4318124,4.318124
1240,7050,3640,25662000,2,9926,2483,1,311340800,311340800,3721,1240,2481,1240,0,1,1242,5677594,5.677594
1640,7050,3640,25662000,2,13126,3283,1,345548800,345548800,4921,1640,3281,1640,0,1,1642,4195529,4.195529
2040,7050,3640,25662000,2,16326,4083,1,379756800,379756800,6121,2040,4081,2040,0,1,2042,971625,0.971625
2440,7050,3640,25662000,2,19526,4883,1,413964800,413964800,7321,2440,4881,2440,0,1,2442,2732682,2.732682
2840,7050,3640,25662000,2,22726,5683,1,448172800,448172800,8521,2840,5681,2840,0,1,2842,7788848,7.788848
3240,7050,3640,25662000,2,25926,6483,1,482380800,482380800,9721,3240,6481,3240,0,1,3242,1623819,1.623819
3640,7050,3640,25662000,2,29126,7283,1,516588800,516588800,10921,3640,7281,3640,0,1,3642,4064103,4.064103
4040,7050,3640,25662000,2,32326,8083,1,550796800,550796800,12121,4040,8081,4040,0,1,4042,10834884,10.834884
4440,7050,3640,25662000,2,35526,8883,1,585004800,585004800,13321,4440,8881,4440,0,1,4442,2586008,2.586008
4840,7050,3640,25662000,2,38726,9683,1,619212800,619212800,14521,4840,9681,4840,0,1,4842,15312412,15.312412
5240,7050,3640,25662000,2,41926,10483,1,653420800,653420800,15721,5240,10481,5240,0,1,5242,25979091,25.979091
5640,7050,3640,25662000,2,45126,11283,1,687628800,687628800,16921,5640,11281,5640,0,1,5642,27998665,27.998665
6040,7050,3640,25662000,2,48326,12083,1,721836800,721836800,18121,6040,12081,6040,0,1,6042,30036340,30.03634
6440,7050,3640,25662000,2,51526,12883,1,756044800,756044800,19321,6440,12881,6440,0,1,6442,31979214,31.979214
6840,7050,3640,25662000,2,54726,13683,1,790252800,790252800,20521,6840,13681,6840,0,1,6842,33978200,33.9782
40,4050,6340,25677000,2,326,83,1,208740800,208740800,121,40,81,40,0,1,42,147618,0.147618
440,4050,6340,25677000,2,3526,883,1,241988800,241988800,1321,440,881,440,0,1,442,198757,0.198757
840,4050,6340,25677000,2,6726,1683,1,275236800,275236800,2521,840,1681,840,0,1,842,235354,0.235354
1240,4050,6340,25677000,2,9926,2483,1,308484800,308484800,3721,1240,2481,1240,0,1,1242,327246,0.327246
1640,4050,6340,25677000,2,13126,3283,1,341732800,341732800,4921,1640,3281,1640,0,1,1642,836244,0.836244
2040,4050,6340,25677000,2,16326,4083,1,374980800,374980800,6121,2040,4081,2040,0,1,2042,112987,0.112987
2440,4050,6340,25677000,2,19526,4883,1,408228800,408228800,7321,2440,4881,2440,0,1,2442,171247,0.171247
2840,4050,6340,25677000,2,22726,5683,1,441476800,441476800,8521,2840,5681,2840,0,1,2842,476266,0.476266
3240,4050,6340,25677000,2,25926,6483,1,474724800,474724800,9721,3240,6481,3240,0,1,3242,681101,0.681101
3640,4050,6340,25677000,2,29126,7283,1,507972800,507972800,10921,3640,7281,3640,0,1,3642,747928,0.747928
4040,4050,6340,25677000,2,32326,8083,1,541220800,541220800,12121,4040,8081,4040,0,1,4042,657691,0.657691
4440,4050,6340,25677000,2,35526,8883,1,574468800,574468800,13321,4440,8881,4440,0,1,4442,3081165,3.081165
4840,4050,6340,25677000,2,38726,9683,1,607716800,607716800,14521,4840,9681,4840,0,1,4842,1600470,1.60047
5240,4050,6340,25677000,2,41926,10483,1,640964800,640964800,15721,5240,10481,5240,0,1,5242,1387040,1.38704
5640,4050,6340,25677000,2,45126,11283,1,674212800,674212800,16921,5640,11281,5640,0,1,5642,969682,0.969682
6040,4050,6340,25677000,2,48326,12083,1,707460800,707460800,18121,6040,12081,6040,0,1,6042,2081441,2.081441
6440,4050,6340,25677000,2,51526,12883,1,740708800,740708800,19321,6440,12881,6440,0,1,6442,1943755,1.943755
6840,4050,6340,25677000,2,54726,13683,1,773956800,773956800,20521,6840,13681,6840,0,1,6842,2123305,2.123305
40,6550,3940,25807000,2,326,83,1,209812800,209812800,121,40,81,40,0,1,42,36879,0.036879
440,6550,3940,25807000,2,3526,883,1,243380800,243380800,1321,440,881,440,0,1,442,161401,0.161401
840,6550,3940,25807000,2,6726,1683,1,276948800,276948800,2521,840,1681,840,0,1,842,66080,0.06608
1240,6550,3940,25807000,2,9926,2483,1,310516800,310516800,3721,1240,2481,1240,0,1,1242,141889,0.141889
1640,6550,3940,25807000,2,13126,3283,1,344084800,344084800,4921,1640,3281,1640,0,1,1642,23277,0.023277
2040,6550,3940,25807000,2,16326,4083,1,377652800,377652800,6121,2040,4081,2040,0,1,2042,175615,0.175615
2440,6550,3940,25807000,2,19526,4883,1,411220800,411220800,7321,2440,4881,2440,0,1,2442,679694,0.679694
2840,6550,3940,25807000,2,22726,5683,1,444788800,444788800,8521,2840,5681,2840,0,1,2842,466518,0.466518
3240,6550,3940,25807000,2,25926,6483,1,478356800,478356800,9721,3240,6481,3240,0,1,3242,624102,0.624102
3640,6550,3940,25807000,2,29126,7283,1,511924800,511924800,10921,3640,7281,3640,0,1,3642,2430069,2.430069
4040,6550,3940,25807000,2,32326,8083,1,545492800,545492800,12121,4040,8081,4040,0,1,4042,534544,0.534544
4440,6550,3940,25807000,2,35526,8883,1,579060800,579060800,13321,4440,8881,4440,0,1,4442,230038,0.230038
4840,6550,3940,25807000,2,38726,9683,1,612628800,612628800,14521,4840,9681,4840,0,1,4842,744994,0.744994
5240,6550,3940,25807000,2,41926,10483,1,646196800,646196800,15721,5240,10481,5240,0,1,5242,2905433,2.905433
5640,6550,3940,25807000,2,45126,11283,1,679764800,679764800,16921,5640,11281,5640,0,1,5642,1104415,1.104415
6040,6550,3940,25807000,2,48326,12083,1,713332800,713332800,18121,6040,12081,6040,0,1,6042,2128605,2.128605
6440,6550,3940,25807000,2,51526,12883,1,746900800,746900800,19321,6440,12881,6440,0,1,6442,1508862,1.508862
6840,6550,3940,25807000,2,54726,13683,1,780468800,780468800,20521,6840,13681,6840,0,1,6842,265692,0.265692
55,5305,4865,25808825,2,446,113,1,210945400,210945400,166,55,111,55,0,1,57,514354,0.514354
455,5305,4865,25808825,2,3646,913,1,243489400,243489400,1366,455,911,455,0,1,457,2442162,2.442162
855,5305,4865,25808825,2,6846,1713,1,276033400,276033400,2566,855,1711,855,0,1,857,1362685,1.362685
1255,5305,4865,25808825,2,10046,2513,1,308577400,308577400,3766,1255,2511,1255,0,1,1257,1122923,1.122923
1655,5305,4865,25808825,2,13246,3313,1,341121400,341121400,4966,1655,3311,1655,0,1,1657,280714,0.280714
2055,5305,4865,25808825,2,16446,4113,1,373665400,373665400,6166,2055,4111,2055,0,1,2057,2196444,2.196444
2455,5305,4865,25808825,2,19646,4913,1,406209400,406209400,7366,2455,4911,2455,0,1,2457,2058472,2.058472
2855,5305,4865,25808825,2,22846,5713,1,438753400,438753400,8566,2855,5711,2855,0,1,2857,5068341,5.068341
3255,5305,4865,25808825,2,26046,6513,1,471297400,471297400,9766,3255,6511,3255,0,1,3257,523379,0.523379
3655,5305,4865,25808825,2,29246,7313,1,503841400,503841400,10966,3655,7311,3655,0,1,3657,1248584,1.248584
4055,5305,4865,25808825,2,32446,8113,1,536385400,536385400,12166,4055,8111,4055,0,1,4057,483858,0.483858
4455,5305,4865,25808825,2,35646,8913,1,568929400,568929400,13366,4455,8911,4455,0,1,4457,91381,0.091381
4855,5305,4865,25808825,2,38846,9713,1,601473400,601473400,14566,4855,9711,4855,0,1,4857,939809,0.939809
5255,5305,4865,25808825,2,42046,10513,1,634017400,634017400,15766,5255,10511,5255,0,1,5257,7847404,7.847404
5655,5305,4865,25808825,2,45246,11313,1,666561400,666561400,16966,5655,11311,5655,0,1,5657,4239427,4.239427
6055,5305,4865,25808825,2,48446,12113,1,699105400,699105400,18166,6055,12111,6055,0,1,6057,3649782,3.649782
6455,5305,4865,25808825,2,51646,12913,1,731649400,731649400,19366,6455,12911,6455,0,1,6457,8398913,8.398913
6855,5305,4865,25808825,2,54846,13713,1,764193400,764193400,20566,6855,13711,6855,0,1,6857,1483971,1.483971
55,4055,6365,25810075,2,446,113,1,211065400,211065400,166,55,111,55,0,1,57,35035,0.035035
455,4055,6365,25810075,2,3646,913,1,244409400,244409400,1366,455,911,455,0,1,457,103393,0.103393
855,4055,6365,25810075,2,6846,1713,1,277753400,277753400,2566,855,1711,855,0,1,857,54807,0.054807
1255,4055,6365,25810075,2,10046,2513,1,311097400,311097400,3766,1255,2511,1255,0,1,1257,559946,0.559946
1655,4055,6365,25810075,2,13246,3313,1,344441400,344441400,4966,1655,3311,1655,0,1,1657,374950,0.37495
2055,4055,6365,25810075,2,16446,4113,1,377785400,377785400,6166,2055,4111,2055,0,1,2057,282090,0.28209
2455,4055,6365,25810075,2,19646,4913,1,411129400,411129400,7366,2455,4911,2455,0,1,2457,315131,0.315131
2855,4055,6365,25810075,2,22846,5713,1,444473400,444473400,8566,2855,5711,2855,0,1,2857,449342,0.449342
3255,4055,6365,25810075,2,26046,6513,1,477817400,477817400,9766,3255,6511,3255,0,1,3257,2640247,2.640247
3655,4055,6365,25810075,2,29246,7313,1,511161400,511161400,10966,3655,7311,3655,0,1,3657,95018,0.095018
4055,4055,6365,25810075,2,32446,8113,1,544505400,544505400,12166,4055,8111,4055,0,1,4057,220657,0.220657
4455,4055,6365,25810075,2,35646,8913,1,577849400,577849400,13366,4455,8911,4455,0,1,4457,1604081,1.604081
4855,4055,6365,25810075,2,38846,9713,1,611193400,611193400,14566,4855,9711,4855,0,1,4857,285016,0.285016
5255,4055,6365,25810075,2,42046,10513,1,644537400,644537400,15766,5255,10511,5255,0,1,5257,373476,0.373476
5655,4055,6365,25810075,2,45246,11313,1,677881400,677881400,16966,5655,11311,5655,0,1,5657,1978185,1.978185
6055,4055,6365,25810075,2,48446,12113,1,711225400,711225400,18166,6055,12111,6055,0,1,6057,2064856,2.064856
6455,4055,6365,25810075,2,51646,12913,1,744569400,744569400,19366,6455,12911,6455,0,1,6457,768253,0.768253
6855,4055,6365,25810075,2,54846,13713,1,777913400,777913400,20566,6855,13711,6855,0,1,6857,253273,0.253273
55,6055,4265,25824575,2,446,113,1,211137400,211137400,166,55,111,55,0,1,57,514267,0.514267
455,6055,4265,25824575,2,3646,913,1,244161400,244161400,1366,455,911,455,0,1,457,455097,0.455097
855,6055,4265,25824575,2,6846,1713,1,277185400,277185400,2566,855,1711,855,0,1,857,1726918,1.726918
1255,6055,4265,25824575,2,10046,2513,1,310209400,310209400,3766,1255,2511,1255,0,1,1257,1678948,1.678948
1655,6055,4265,25824575,2,13246,3313,1,343233400,343233400,4966,1655,3311,1655,0,1,1657,3937971,3.937971
2055,6055,4265,25824575,2,16446,4113,1,376257400,376257400,6166,2055,4111,2055,0,1,2057,1665885,1.665885
2455,6055,4265,25824575,2,19646,4913,1,409281400,409281400,7366,2455,4911,2455,0,1,2457,654720,0.65472
2855,6055,4265,25824575,2,22846,5713,1,442305400,442305400,8566,2855,5711,2855,0,1,2857,2240802,2.240802
3255,6055,4265,25824575,2,26046,6513,1,475329400,475329400,9766,3255,6511,3255,0,1,3257,5228004,5.228004
3655,6055,4265,25824575,2,29246,7313,1,508353400,508353400,10966,3655,7311,3655,0,1,3657,944866,0.944866
4055,6055,4265,25824575,2,32446,8113,1,541377400,541377400,12166,4055,8111,4055,0,1,4057,253165,0.253165
4455,6055,4265,25824575,2,35646,8913,1,574401400,574401400,13366,4455,8911,4455,0,1,4457,5566094,5.566094
4855,6055,4265,25824575,2,38846,9713,1,607425400,607425400,14566,4855,9711,4855,0,1,4857,5242757,5.242757
5255,6055,4265,25824575,2,42046,10513,1,640449400,640449400,15766,5255,10511,5255,0,1,5257,83805,0.083805
5655,6055,4265,25824575,2,45246,11313,1,673473400,673473400,16966,5655,11311,5655,0,1,5657,4207577,4.207577
6055,6055,4265,25824575,2,48446,12113,1,706497400,706497400,18166,6055,12111,6055,0,1,6057,551102,0.551102
6455,6055,4265,25824575,2,51646,12913,1,739521400,739521400,19366,6455,12911,6455,0,1,6457,7112604,7.112604
6855,6055,4265,25824575,2,54846,13713,1,772545400,772545400,20566,6855,13711,6855,0,1,6857,705506,0.705506
55,7055,3665,25856575,2,446,113,1,211569400,211569400,166,55,111,55,0,1,57,519281,0.519281
455,7055,3665,25856575,2,3646,913,1,245873400,245873400,1366,455,911,455,0,1,457,607803,0.607803
855,7055,3665,25856575,2,6846,1713,1,280177400,280177400,2566,855,1711,855,0,1,857,1769663,1.769663
1255,7055,3665,25856575,2,10046,2513,1,314481400,314481400,3766,1255,2511,1255,0,1,1257,3408705,3.408705
1655,7055,3665,25856575,2,13246,3313,1,348785400,348785400,4966,1655,3311,1655,0,1,1657,5984561,5.984561
2055,7055,3665,25856575,2,16446,4113,1,383089400,383089400,6166,2055,4111,2055,0,1,2057,2004553,2.004553
2455,7055,3665,25856575,2,19646,4913,1,417393400,417393400,7366,2455,4911,2455,0,1,2457,3804239,3.804239
2855,7055,3665,25856575,2,22846,5713,1,451697400,451697400,8566,2855,5711,2855,0,1,2857,10642916,10.642916
3255,7055,3665,25856575,2,26046,6513,1,486001400,486001400,9766,3255,6511,3255,0,1,3257,3281693,3.281693
3655,7055,3665,25856575,2,29246,7313,1,520305400,520305400,10966,3655,7311,3655,0,1,3657,1980273,1.980273
4055,7055,3665,25856575,2,32446,8113,1,554609400,554609400,12166,4055,8111,4055,0,1,4057,18673610,18.67361
4455,7055,3665,25856575,2,35646,8913,1,588913400,588913400,13366,4455,8911,4455,0,1,4457,14636918,14.636918
4855,7055,3665,25856575,2,38846,9713,1,623217400,623217400,14566,4855,9711,4855,0,1,4857,3523813,3.523813
5255,7055,3665,25856575,2,42046,10513,1,657521400,657521400,15766,5255,10511,5255,0,1,5257,2923418,2.923418
5655,7055,3665,25856575,2,45246,11313,1,691825400,691825400,16966,5655,11311,5655,0,1,5657,28435177,28.435177
6055,7055,3665,25856575,2,48446,12113,1,726129400,726129400,18166,6055,12111,6055,0,1,6057,30745251,30.745251
6455,7055,3665,25856575,2,51646,12913,1,760433400,760433400,19366,6455,12911,6455,0,1,6457,32773869,32.773869
6855,7055,3665,25856575,2,54846,13713,1,794737400,794737400,20566,6855,13711,6855,0,1,6857,34885708,34.885708
40,5050,5140,25957000,2,326,83,1,210916800,210916800,121,40,81,40,0,1,42,17727,0.017727
440,5050,5140,25957000,2,3526,883,1,243524800,243524800,1321,440,881,440,0,1,442,52034,0.052034
840,5050,5140,25957000,2,6726,1683,1,276132800,276132800,2521,840,1681,840,0,1,842,50517,0.050517
1240,5050,5140,25957000,2,9926,2483,1,308740800,308740800,3721,1240,2481,1240,0,1,1242,114844,0.114844
1640,5050,5140,25957000,2,13126,3283,1,341348800,341348800,4921,1640,3281,1640,0,1,1642,108832,0.108832
2040,5050,5140,25957000,2,16326,4083,1,373956800,373956800,6121,2040,4081,2040,0,1,2042,21947,0.021947
2440,5050,5140,25957000,2,19526,4883,1,406564800,406564800,7321,2440,4881,2440,0,1,2442,1920827,1.920827
2840,5050,5140,25957000,2,22726,5683,1,439172800,439172800,8521,2840,5681,2840,0,1,2842,80955,0.080955
3240,5050,5140,25957000,2,25926,6483,1,471780800,471780800,9721,3240,6481,3240,0,1,3242,1029651,1.029651
3640,5050,5140,25957000,2,29126,7283,1,504388800,504388800,10921,3640,7281,3640,0,1,3642,277457,0.277457
4040,5050,5140,25957000,2,32326,8083,1,536996800,536996800,12121,4040,8081,4040,0,1,4042,81638,0.081638
4440,5050,5140,25957000,2,35526,8883,1,569604800,569604800,13321,4440,8881,4440,0,1,4442,1211135,1.211135
4840,5050,5140,25957000,2,38726,9683,1,602212800,602212800,14521,4840,9681,4840,0,1,4842,425546,0.425546
5240,5050,5140,25957000,2,41926,10483,1,634820800,634820800,15721,5240,10481,5240,0,1,5242,293400,0.2934
5640,5050,5140,25957000,2,45126,11283,1,667428800,667428800,16921,5640,11281,5640,0,1,5642,2035140,2.03514
6040,5050,5140,25957000,2,48326,12083,1,700036800,700036800,18121,6040,12081,6040,0,1,6042,241044,0.241044
6440,5050,5140,25957000,2,51526,12883,1,732644800,732644800,19321,6440,12881,6440,0,1,6442,184387,0.184387
6840,5050,5140,25957000,2,54726,13683,1,765252800,765252800,20521,6840,13681,6840,0,1,6842,1085204,1.085204
40,4300,6040,25972000,2,326,83,1,211084800,211084800,121,40,81,40,0,1,42,473327,0.473327
440,4300,6040,25972000,2,3526,883,1,244172800,244172800,1321,440,881,440,0,1,442,30248,0.030248
840,4300,6040,25972000,2,6726,1683,1,277260800,277260800,2521,840,1681,840,0,1,842,225992,0.225992
1240,4300,6040,25972000,2,9926,2483,1,310348800,310348800,3721,1240,2481,1240,0,1,1242,37149,0.037149
1640,4300,6040,25972000,2,13126,3283,1,343436800,343436800,4921,1640,3281,1640,0,1,1642,248415,0.248415
2040,4300,6040,25972000,2,16326,4083,1,376524800,376524800,6121,2040,4081,2040,0,1,2042,2227778,2.227778
2440,4300,6040,25972000,2,19526,4883,1,409612800,409612800,7321,2440,4881,2440,0,1,2442,247848,0.247848
2840,4300,6040,25972000,2,22726,5683,1,442700800,442700800,8521,2840,5681,2840,0,1,2842,120995,0.120995
3240,4300,6040,25972000,2,25926,6483,1,475788800,475788800,9721,3240,6481,3240,0,1,3242,275985,0.275985
3640,4300,6040,25972000,2,29126,7283,1,508876800,508876800,10921,3640,7281,3640,0,1,3642,571078,0.571078
4040,4300,6040,25972000,2,32326,8083,1,541964800,541964800,12121,4040,8081,4040,0,1,4042,186342,0.186342
4440,4300,6040,25972000,2,35526,8883,1,575052800,575052800,13321,4440,8881,4440,0,1,4442,623174,0.623174
4840,4300,6040,25972000,2,38726,9683,1,608140800,608140800,14521,4840,9681,4840,0,1,4842,5257040,5.25704
5240,4300,6040,25972000,2,41926,10483,1,641228800,641228800,15721,5240,10481,5240,0,1,5242,3390394,3.390394
5640,4300,6040,25972000,2,45126,11283,1,674316800,674316800,16921,5640,11281,5640,0,1,5642,158211,0.158211
6040,4300,6040,25972000,2,48326,12083,1,707404800,707404800,18121,6040,12081,6040,0,1,6042,1625527,1.625527
6440,4300,6040,25972000,2,51526,12883,1,740492800,740492800,19321,6440,12881,6440,0,1,6442,646637,0.646637
6840,4300,6040,25972000,2,54726,13683,1,773580800,773580800,20521,6840,13681,6840,0,1,6842,2009562,2.009562
55,6555,3965,25990575,2,446,113,1,212553400,212553400,166,55,111,55,0,1,57,40975,0.040975
455,6555,3965,25990575,2,3646,913,1,246217400,246217400,1366,455,911,455,0,1,457,70104,0.070104
855,6555,3965,25990575,2,6846,1713,1,279881400,279881400,2566,855,1711,855,0,1,857,258948,0.258948
1255,6555,3965,25990575,2,10046,2513,1,313545400,313545400,3766,1255,2511,1255,0,1,1257,387568,0.387568
1655,6555,3965,25990575,2,13246,3313,1,347209400,347209400,4966,1655,3311,1655,0,1,1657,379605,0.379605
2055,6555,3965,25990575,2,16446,4113,1,380873400,380873400,6166,2055,4111,2055,0,1,2057,1228751,1.228751
2455,6555,3965,25990575,2,19646,4913,1,414537400,414537400,7366,2455,4911,2455,0,1,2457,201865,0.201865
2855,6555,3965,25990575,2,22846,5713,1,448201400,448201400,8566,2855,5711,2855,0,1,2857,542621,0.542621
3255,6555,3965,25990575,2,26046,6513,1,481865400,481865400,9766,3255,6511,3255,0,1,3257,69723,0.069723
3655,6555,3965,25990575,2,29246,7313,1,515529400,515529400,10966,3655,7311,3655,0,1,3657,460799,0.460799
4055,6555,3965,25990575,2,32446,8113,1,549193400,549193400,12166,4055,8111,4055,0,1,4057,1482455,1.482455
4455,6555,3965,25990575,2,35646,8913,1,582857400,582857400,13366,4455,8911,4455,0,1,4457,323302,0.323302
4855,6555,3965,25990575,2,38846,9713,1,616521400,616521400,14566,4855,9711,4855,0,1,4857,473541,0.473541
5255,6555,3965,25990575,2,42046,10513,1,650185400,650185400,15766,5255,10511,5255,0,1,5257,2265013,2.265013
5655,6555,3965,25990575,2,45246,11313,1,683849400,683849400,16966,5655,11311,5655,0,1,5657,271423,0.271423
6055,6555,3965,25990575,2,48446,12113,1,717513400,717513400,18166,6055,12111,6055,0,1,6057,666255,0.666255
6455,6555,3965,25990575,2,51646,12913,1,751177400,751177400,19366,6455,12911,6455,0,1,6457,3979319,3.979319
6855,6555,3965,25990575,2,54846,13713,1,784841400,784841400,20566,6855,13711,6855,0,1,6857,97486,0.097486
55,5055,5165,26109075,2,446,113,1,213369400,213369400,166,55,111,55,0,1,57,22233,0.022233
455,5055,5165,26109075,2,3646,913,1,246073400,246073400,1366,455,911,455,0,1,457,140438,0.140438
855,5055,5165,26109075,2,6846,1713,1,278777400,278777400,2566,855,1711,855,0,1,857,335707,0.335707
1255,5055,5165,26109075,2,10046,2513,1,311481400,311481400,3766,1255,2511,1255,0,1,1257,201713,0.201713
1655,5055,5165,26109075,2,13246,3313,1,344185400,344185400,4966,1655,3311,1655,0,1,1657,107657,0.107657
2055,5055,5165,26109075,2,16446,4113,1,376889400,376889400,6166,2055,4111,2055,0,1,2057,161404,0.161404
2455,5055,5165,26109075,2,19646,4913,1,409593400,409593400,7366,2455,4911,2455,0,1,2457,487270,0.48727
2855,5055,5165,26109075,2,22846,5713,1,442297400,442297400,8566,2855,5711,2855,0,1,2857,571478,0.571478
3255,5055,5165,26109075,2,26046,6513,1,475001400,475001400,9766,3255,6511,3255,0,1,3257,60563,0.060563
3655,5055,5165,26109075,2,29246,7313,1,507705400,507705400,10966,3655,7311,3655,0,1,3657,209652,0.209652
4055,5055,5165,26109075,2,32446,8113,1,540409400,540409400,12166,4055,8111,4055,0,1,4057,1906989,1.906989
4455,5055,5165,26109075,2,35646,8913,1,573113400,573113400,13366,4455,8911,4455,0,1,4457,384507,0.384507
4855,5055,5165,26109075,2,38846,9713,1,605817400,605817400,14566,4855,9711,4855,0,1,4857,323304,0.323304
5255,5055,5165,26109075,2,42046,10513,1,638521400,638521400,15766,5255,10511,5255,0,1,5257,3003566,3.003566
5655,5055,5165,26109075,2,45246,11313,1,671225400,671225400,16966,5655,11311,5655,0,1,5657,3095187,3.095187
6055,5055,5165,26109075,2,48446,12113,1,703929400,703929400,18166,6055,12111,6055,0,1,6057,4648950,4.64895
6455,5055,5165,26109075,2,51646,12913,1,736633400,736633400,19366,6455,12911,6455,0,1,6457,215195,0.215195
6855,5055,5165,26109075,2,54846,13713,1,769337400,769337400,20566,6855,13711,6855,0,1,6857,3457772,3.457772
55,4305,6065,26109825,2,446,113,1,213441400,213441400,166,55,111,55,0,1,57,518329,0.518329
455,4305,6065,26109825,2,3646,913,1,246625400,246625400,1366,455,911,455,0,1,457,289043,0.289043
855,4305,6065,26109825,2,6846,1713,1,279809400,279809400,2566,855,1711,855,0,1,857,1899039,1.899039
1255,4305,6065,26109825,2,10046,2513,1,312993400,312993400,3766,1255,2511,1255,0,1,1257,357481,0.357481
1655,4305,6065,26109825,2,13246,3313,1,346177400,346177400,4966,1655,3311,1655,0,1,1657,1721109,1.721109
2055,4305,6065,26109825,2,16446,4113,1,379361400,379361400,6166,2055,4111,2055,0,1,2057,1621035,1.621035
2455,4305,6065,26109825,2,19646,4913,1,412545400,412545400,7366,2455,4911,2455,0,1,2457,1098579,1.098579
2855,4305,6065,26109825,2,22846,5713,1,445729400,445729400,8566,2855,5711,2855,0,1,2857,1753891,1.753891
3255,4305,6065,26109825,2,26046,6513,1,478913400,478913400,9766,3255,6511,3255,0,1,3257,621693,0.621693
3655,4305,6065,26109825,2,29246,7313,1,512097400,512097400,10966,3655,7311,3655,0,1,3657,113198,0.113198
4055,4305,6065,26109825,2,32446,8113,1,545281400,545281400,12166,4055,8111,4055,0,1,4057,1239229,1.239229
4455,4305,6065,26109825,2,35646,8913,1,578465400,578465400,13366,4455,8911,4455,0,1,4457,1027569,1.027569
4855,4305,6065,26109825,2,38846,9713,1,611649400,611649400,14566,4855,9711,4855,0,1,4857,804693,0.804693
5255,4305,6065,26109825,2,42046,10513,1,644833400,644833400,15766,5255,10511,5255,0,1,5257,362574,0.362574
5655,4305,6065,26109825,2,45246,11313,1,678017400,678017400,16966,5655,11311,5655,0,1,5657,346635,0.346635
6055,4305,6065,26109825,2,48446,12113,1,711201400,711201400,18166,6055,12111,6055,0,1,6057,577437,0.577437
6455,4305,6065,26109825,2,51646,12913,1,744385400,744385400,19366,6455,12911,6455,0,1,6457,7276037,7.276037
6855,4305,6065,26109825,2,54846,13713,1,777569400,777569400,20566,6855,13711,6855,0,1,6857,3187390,3.18739
40,4800,5440,26112000,2,326,83,1,212172800,212172800,121,40,81,40,0,1,42,466926,0.466926
440,4800,5440,26112000,2,3526,883,1,244940800,244940800,1321,440,881,440,0,1,442,2262852,2.262852
840,4800,5440,26112000,2,6726,1683,1,277708800,277708800,2521,840,1681,840,0,1,842,1827524,1.827524
1240,4800,5440,26112000,2,9926,2483,1,310476800,310476800,3721,1240,2481,1240,0,1,1242,250376,0.250376
1640,4800,5440,26112000,2,13126,3283,1,343244800,343244800,4921,1640,3281,1640,0,1,1642,3491054,3.491054
2040,4800,5440,26112000,2,16326,4083,1,376012800,376012800,6121,2040,4081,2040,0,1,2042,1695565,1.695565
2440,4800,5440,26112000,2,19526,4883,1,408780800,408780800,7321,2440,4881,2440,0,1,2442,2384154,2.384154
2840,4800,5440,26112000,2,22726,5683,1,441548800,441548800,8521,2840,5681,2840,0,1,2842,4626193,4.626193
3240,4800,5440,26112000,2,25926,6483,1,474316800,474316800,9721,3240,6481,3240,0,1,3242,3544615,3.544615
3640,4800,5440,26112000,2,29126,7283,1,507084800,507084800,10921,3640,7281,3640,0,1,3642,1230513,1.230513
4040,4800,5440,26112000,2,32326,8083,1,539852800,539852800,12121,4040,8081,4040,0,1,4042,5074742,5.074742
4440,4800,5440,26112000,2,35526,8883,1,572620800,572620800,13321,4440,8881,4440,0,1,4442,9444673,9.444673
4840,4800,5440,26112000,2,38726,9683,1,605388800,605388800,14521,4840,9681,4840,0,1,4842,2288230,2.28823
5240,4800,5440,26112000,2,41926,10483,1,638156800,638156800,15721,5240,10481,5240,0,1,5242,3780489,3.780489
5640,4800,5440,26112000,2,45126,11283,1,670924800,670924800,16921,5640,11281,5640,0,1,5642,196413,0.196413
6040,4800,5440,26112000,2,48326,12083,1,703692800,703692800,18121,6040,12081,6040,0,1,6042,20259699,20.259699
6440,4800,5440,26112000,2,51526,12883,1,736460800,736460800,19321,6440,12881,6440,0,1,6442,5266140,5.26614
6840,4800,5440,26112000,2,54726,13683,1,769228800,769228800,20521,6840,13681,6840,0,1,6842,6248429,6.248429
40,4550,5740,26117000,2,326,83,1,212228800,212228800,121,40,81,40,0,1,42,476529,0.476529
440,4550,5740,26117000,2,3526,883,1,245156800,245156800,1321,440,881,440,0,1,442,2343071,2.343071
840,4550,5740,26117000,2,6726,1683,1,278084800,278084800,2521,840,1681,840,0,1,842,211351,0.211351
1240,4550,5740,26117000,2,9926,2483,1,311012800,311012800,3721,1240,2481,1240,0,1,1242,4198336,4.198336
1640,4550,5740,26117000,2,13126,3283,1,343940800,343940800,4921,1640,3281,1640,0,1,1642,2714082,2.714082
2040,4550,5740,26117000,2,16326,4083,1,376868800,376868800,6121,2040,4081,2040,0,1,2042,441984,0.441984
2440,4550,5740,26117000,2,19526,4883,1,409796800,409796800,7321,2440,4881,2440,0,1,2442,2028083,2.028083
2840,4550,5740,26117000,2,22726,5683,1,442724800,442724800,8521,2840,5681,2840,0,1,2842,4816473,4.816473
3240,4550,5740,26117000,2,25926,6483,1,475652800,475652800,9721,3240,6481,3240,0,1,3242,12153558,12.153558
3640,4550,5740,26117000,2,29126,7283,1,508580800,508580800,10921,3640,7281,3640,0,1,3642,70620,0.07062
4040,4550,5740,26117000,2,32326,8083,1,541508800,541508800,12121,4040,8081,4040,0,1,4042,5359822,5.359822
4440,4550,5740,26117000,2,35526,8883,1,574436800,574436800,13321,4440,8881,4440,0,1,4442,364386,0.364386
4840,4550,5740,26117000,2,38726,9683,1,607364800,607364800,14521,4840,9681,4840,0,1,4842,566287,0.566287
5240,4550,5740,26117000,2,41926,10483,1,640292800,640292800,15721,5240,10481,5240,0,1,5242,903866,0.903866
5640,4550,5740,26117000,2,45126,11283,1,673220800,673220800,16921,5640,11281,5640,0,1,5642,2241735,2.241735
6040,4550,5740,26117000,2,48326,12083,1,706148800,706148800,18121,6040,12081,6040,0,1,6042,4661676,4.661676
6440,4550,5740,26117000,2,51526,12883,1,739076800,739076800,19321,6440,12881,6440,0,1,6442,769966,0.769966
6840,4550,5740,26117000,2,54726,13683,1,772004800,772004800,20521,6840,13681,6840,0,1,6842,1983347,1.983347
55,4805,5465,26259325,2,446,113,1,214593400,214593400,166,55,111,55,0,1,57,546856,0.546856
455,4805,5465,26259325,2,3646,913,1,247457400,247457400,1366,455,911,455,0,1,457,2442872,2.442872
855,4805,5465,26259325,2,6846,1713,1,280321400,280321400,2566,855,1711,855,0,1,857,4385958,4.385958
1255,4805,5465,26259325,2,10046,2513,1,313185400,313185400,3766,1255,2511,1255,0,1,1257,4101546,4.101546
1655,4805,5465,26259325,2,13246,3313,1,346049400,346049400,4966,1655,3311,1655,0,1,1657,3775898,3.775898
2055,4805,5465,26259325,2,16446,4113,1,378913400,378913400,6166,2055,4111,2055,0,1,2057,2088397,2.088397
2455,4805,5465,26259325,2,19646,4913,1,411777400,411777400,7366,2455,4911,2455,0,1,2457,2808561,2.808561
2855,4805,5465,26259325,2,22846,5713,1,444641400,444641400,8566,2855,5711,2855,0,1,2857,9691497,9.691497
3255,4805,5465,26259325,2,26046,6513,1,477505400,477505400,9766,3255,6511,3255,0,1,3257,4948369,4.948369
3655,4805,5465,26259325,2,29246,7313,1,510369400,510369400,10966,3655,7311,3655,0,1,3657,7885892,7.885892
4055,4805,5465,26259325,2,32446,8113,1,543233400,543233400,12166,4055,8111,4055,0,1,4057,81423,0.081423
4455,4805,5465,26259325,2,35646,8913,1,576097400,576097400,13366,4455,8911,4455,0,1,4457,3637229,3.637229
4855,4805,5465,26259325,2,38846,9713,1,608961400,608961400,14566,4855,9711,4855,0,1,4857,9197645,9.197645
5255,4805,5465,26259325,2,42046,10513,1,641825400,641825400,15766,5255,10511,5255,0,1,5257,2500433,2.500433
5655,4805,5465,26259325,2,45246,11313,1,674689400,674689400,16966,5655,11311,5655,0,1,5657,6234843,6.234843
6055,4805,5465,26259325,2,48446,12113,1,707553400,707553400,18166,6055,12111,6055,0,1,6057,5230849,5.230849
6455,4805,5465,26259325,2,51646,12913,1,740417400,740417400,19366,6455,12911,6455,0,1,6457,22433346,22.433346
6855,4805,5465,26259325,2,54846,13713,1,773281400,773281400,20566,6855,13711,6855,0,1,6857,27701701,27.701701
55,4555,5765,26259575,2,446,113,1,214617400,214617400,166,55,111,55,0,1,57,534377,0.534377
455,4555,5765,26259575,2,3646,913,1,247641400,247641400,1366,455,911,455,0,1,457,2439883,2.439883
855,4555,5765,26259575,2,6846,1713,1,280665400,280665400,2566,855,1711,855,0,1,857,2882921,2.882921
1255,4555,5765,26259575,2,10046,2513,1,313689400,313689400,3766,1255,2511,1255,0,1,1257,5474962,5.474962
1655,4555,5765,26259575,2,13246,3313,1,346713400,346713400,4966,1655,3311,1655,0,1,1657,595307,0.595307
2055,4555,5765,26259575,2,16446,4113,1,379737400,379737400,6166,2055,4111,2055,0,1,2057,1819461,1.819461
2455,4555,5765,26259575,2,19646,4913,1,412761400,412761400,7366,2455,4911,2455,0,1,2457,143114,0.143114
2855,4555,5765,26259575,2,22846,5713,1,445785400,445785400,8566,2855,5711,2855,0,1,2857,2946405,2.946405
3255,4555,5765,26259575,2,26046,6513,1,478809400,478809400,9766,3255,6511,3255,0,1,3257,1430537,1.430537
3655,4555,5765,26259575,2,29246,7313,1,511833400,511833400,10966,3655,7311,3655,0,1,3657,9358087,9.358087
4055,4555,5765,26259575,2,32446,8113,1,544857400,544857400,12166,4055,8111,4055,0,1,4057,3953882,3.953882
4455,4555,5765,26259575,2,35646,8913,1,577881400,577881400,13366,4455,8911,4455,0,1,4457,5905261,5.905261
4855,4555,5765,26259575,2,38846,9713,1,610905400,610905400,14566,4855,9711,4855,0,1,4857,1442413,1.442413
5255,4555,5765,26259575,2,42046,10513,1,643929400,643929400,15766,5255,10511,5255,0,1,5257,976186,0.976186
5655,4555,5765,26259575,2,45246,11313,1,676953400,676953400,16966,5655,11311,5655,0,1,5657,4597768,4.597768
6055,4555,5765,26259575,2,48446,12113,1,709977400,709977400,18166,6055,12111,6055,0,1,6057,7406546,7.406546
6455,4555,5765,26259575,2,51646,12913,1,743001400,743001400,19366,6455,12911,6455,0,1,6457,5424326,5.424326
6855,4555,5765,26259575,2,54846,13713,1,776025400,776025400,20566,6855,13711,6855,0,1,6857,7547073,7.547073
40,5800,4540,26332000,2,326,83,1,213964800,213964800,121,40,81,40,0,1,42,54568,0.054568
440,5800,4540,26332000,2,3526,883,1,247052800,247052800,1321,440,881,440,0,1,442,120489,0.120489
840,5800,4540,26332000,2,6726,1683,1,280140800,280140800,2521,840,1681,840,0,1,842,17218,0.017218
1240,5800,4540,26332000,2,9926,2483,1,313228800,313228800,3721,1240,2481,1240,0,1,1242,338643,0.338643
1640,5800,4540,26332000,2,13126,3283,1,346316800,346316800,4921,1640,3281,1640,0,1,1642,613020,0.61302
2040,5800,4540,26332000,2,16326,4083,1,379404800,379404800,6121,2040,4081,2040,0,1,2042,51819,0.051819
2440,5800,4540,26332000,2,19526,4883,1,412492800,412492800,7321,2440,4881,2440,0,1,2442,1231893,1.231893
2840,5800,4540,26332000,2,22726,5683,1,445580800,445580800,8521,2840,5681,2840,0,1,2842,857299,0.857299
3240,5800,4540,26332000,2,25926,6483,1,478668800,478668800,9721,3240,6481,3240,0,1,3242,232397,0.232397
3640,5800,4540,26332000,2,29126,7283,1,511756800,511756800,10921,3640,7281,3640,0,1,3642,2167554,2.167554
4040,5800,4540,26332000,2,32326,8083,1,544844800,544844800,12121,4040,8081,4040,0,1,4042,1125221,1.125221
4440,5800,4540,26332000,2,35526,8883,1,577932800,577932800,13321,4440,8881,4440,0,1,4442,3162413,3.162413
4840,5800,4540,26332000,2,38726,9683,1,611020800,611020800,14521,4840,9681,4840,0,1,4842,840388,0.840388
5240,5800,4540,26332000,2,41926,10483,1,644108800,644108800,15721,5240,10481,5240,0,1,5242,238538,0.238538
5640,5800,4540,26332000,2,45126,11283,1,677196800,677196800,16921,5640,11281,5640,0,1,5642,1993644,1.993644
6040,5800,4540,26332000,2,48326,12083,1,710284800,710284800,18121,6040,12081,6040,0,1,6042,990637,0.990637
6440,5800,4540,26332000,2,51526,12883,1,743372800,743372800,19321,6440,12881,6440,0,1,6442,1587645,1.587645
6840,5800,4540,26332000,2,54726,13683,1,776460800,776460800,20521,6840,13681,6840,0,1,6842,663858,0.663858
40,3800,6940,26372000,2,326,83,1,214412800,214412800,121,40,81,40,0,1,42,476178,0.476178
440,3800,6940,26372000,2,3526,883,1,248780800,248780800,1321,440,881,440,0,1,442,2439013,2.439013
840,3800,6940,26372000,2,6726,1683,1,283148800,283148800,2521,840,1681,840,0,1,842,3191867,3.191867
1240,3800,6940,26372000,2,9926,2483,1,317516800,317516800,3721,1240,2481,1240,0,1,1242,6468448,6.468448
1640,3800,6940,26372000,2,13126,3283,1,351884800,351884800,4921,1640,3281,1640,0,1,1642,3201072,3.201072
2040,3800,6940,26372000,2,16326,4083,1,386252800,386252800,6121,2040,4081,2040,0,1,2042,5126319,5.126319
2440,3800,6940,26372000,2,19526,4883,1,420620800,420620800,7321,2440,4881,2440,0,1,2442,434499,0.434499
2840,3800,6940,26372000,2,22726,5683,1,454988800,454988800,8521,2840,5681,2840,0,1,2842,6062308,6.062308
3240,3800,6940,26372000,2,25926,6483,1,489356800,489356800,9721,3240,6481,3240,0,1,3242,3399980,3.39998
3640,3800,6940,26372000,2,29126,7283,1,523724800,523724800,10921,3640,7281,3640,0,1,3642,2280001,2.280001
4040,3800,6940,26372000,2,32326,8083,1,558092800,558092800,12121,4040,8081,4040,0,1,4042,6580798,6.580798
4440,3800,6940,26372000,2,35526,8883,1,592460800,592460800,13321,4440,8881,4440,0,1,4442,505934,0.505934
4840,3800,6940,26372000,2,38726,9683,1,626828800,626828800,14521,4840,9681,4840,0,1,4842,2843328,2.843328
5240,3800,6940,26372000,2,41926,10483,1,661196800,661196800,15721,5240,10481,5240,0,1,5242,3441970,3.44197
5640,3800,6940,26372000,2,45126,11283,1,695564800,695564800,16921,5640,11281,5640,0,1,5642,2603523,2.603523
6040,3800,6940,26372000,2,48326,12083,1,729932800,729932800,18121,6040,12081,6040,0,1,6042,1634559,1.634559
6440,3800,6940,26372000,2,51526,12883,1,764300800,764300800,19321,6440,12881,6440,0,1,6442,371320,0.37132
6840,3800,6940,26372000,2,54726,13683,1,798668800,798668800,20521,6840,13681,6840,0,1,6842,3371018,3.371018
55,5805,4565,26499825,2,446,113,1,216561400,216561400,166,55,111,55,0,1,57,19947,0.019947
455,5805,4565,26499825,2,3646,913,1,249745400,249745400,1366,455,911,455,0,1,457,168613,0.168613
855,5805,4565,26499825,2,6846,1713,1,282929400,282929400,2566,855,1711,855,0,1,857,75077,0.075077
1255,5805,4565,26499825,2,10046,2513,1,316113400,316113400,3766,1255,2511,1255,0,1,1257,227304,0.227304
1655,5805,4565,26499825,2,13246,3313,1,349297400,349297400,4966,1655,3311,1655,0,1,1657,456296,0.456296
2055,5805,4565,26499825,2,16446,4113,1,382481400,382481400,6166,2055,4111,2055,0,1,2057,31308,0.031308
2455,5805,4565,26499825,2,19646,4913,1,415665400,415665400,7366,2455,4911,2455,0,1,2457,228284,0.228284
2855,5805,4565,26499825,2,22846,5713,1,448849400,448849400,8566,2855,5711,2855,0,1,2857,376209,0.376209
3255,5805,4565,26499825,2,26046,6513,1,482033400,482033400,9766,3255,6511,3255,0,1,3257,67887,0.067887
3655,5805,4565,26499825,2,29246,7313,1,515217400,515217400,10966,3655,7311,3655,0,1,3657,1242876,1.242876
4055,5805,4565,26499825,2,32446,8113,1,548401400,548401400,12166,4055,8111,4055,0,1,4057,148473,0.148473
4455,5805,4565,26499825,2,35646,8913,1,581585400,581585400,13366,4455,8911,4455,0,1,4457,2367672,2.367672
4855,5805,4565,26499825,2,38846,9713,1,614769400,614769400,14566,4855,9711,4855,0,1,4857,104579,0.104579
5255,5805,4565,26499825,2,42046,10513,1,647953400,647953400,15766,5255,10511,5255,0,1,5257,1622329,1.622329
5655,5805,4565,26499825,2,45246,11313,1,681137400,681137400,16966,5655,11311,5655,0,1,5657,1192245,1.192245
6055,5805,4565,26499825,2,48446,12113,1,714321400,714321400,18166,6055,12111,6055,0,1,6057,1558112,1.558112
6455,5805,4565,26499825,2,51646,12913,1,747505400,747505400,19366,6455,12911,6455,0,1,6457,740287,0.740287
6855,5805,4565,26499825,2,54846,13713,1,780689400,780689400,20566,6855,13711,6855,0,1,6857,2884621,2.884621
55,3805,6965,26501825,2,446,113,1,216753400,216753400,166,55,111,55,0,1,57,542603,0.542603
455,3805,6965,26501825,2,3646,913,1,251217400,251217400,1366,455,911,455,0,1,457,2554473,2.554473
855,3805,6965,26501825,2,6846,1713,1,285681400,285681400,2566,855,1711,855,0,1,857,4617498,4.617498
1255,3805,6965,26501825,2,10046,2513,1,320145400,320145400,3766,1255,2511,1255,0,1,1257,2897198,2.897198
1655,3805,6965,26501825,2,13246,3313,1,354609400,354609400,4966,1655,3311,1655,0,1,1657,5103824,5.103824
2055,3805,6965,26501825,2,16446,4113,1,389073400,389073400,6166,2055,4111,2055,0,1,2057,965620,0.96562
2455,3805,6965,26501825,2,19646,4913,1,423537400,423537400,7366,2455,4911,2455,0,1,2457,2071545,2.071545
2855,3805,6965,26501825,2,22846,5713,1,458001400,458001400,8566,2855,5711,2855,0,1,2857,595623,0.595623
3255,3805,6965,26501825,2,26046,6513,1,492465400,492465400,9766,3255,6511,3255,0,1,3257,2777383,2.777383
3655,3805,6965,26501825,2,29246,7313,1,526929400,526929400,10966,3655,7311,3655,0,1,3657,161369,0.161369
4055,3805,6965,26501825,2,32446,8113,1,561393400,561393400,12166,4055,8111,4055,0,1,4057,2205353,2.205353
4455,3805,6965,26501825,2,35646,8913,1,595857400,595857400,13366,4455,8911,4455,0,1,4457,931839,0.931839
4855,3805,6965,26501825,2,38846,9713,1,630321400,630321400,14566,4855,9711,4855,0,1,4857,702719,0.702719
5255,3805,6965,26501825,2,42046,10513,1,664785400,664785400,15766,5255,10511,5255,0,1,5257,2718553,2.718553
5655,3805,6965,26501825,2,45246,11313,1,699249400,699249400,16966,5655,11311,5655,0,1,5657,1310349,1.310349
6055,3805,6965,26501825,2,48446,12113,1,733713400,733713400,18166,6055,12111,6055,0,1,6057,2687207,2.687207
6455,3805,6965,26501825,2,51646,12913,1,768177400,768177400,19366,6455,12911,6455,0,1,6457,6641365,6.641365
6855,3805,6965,26501825,2,54846,13713,1,802641400,802641400,20566,6855,13711,6855,0,1,6857,2570310,2.57031
35,4400,6045,26598000,2,286,73,1,215708600,215708600,106,35,71,35,0,1,37,39284,0.039284
535,4400,6045,26598000,2,4286,1073,1,257488600,257488600,1606,535,1071,535,0,1,537,533316,0.533316
1035,4400,6045,26598000,2,8286,2073,1,299268600,299268600,3106,1035,2071,1035,0,1,1037,194855,0.194855
1535,4400,6045,26598000,2,12286,3073,1,341048600,341048600,4606,1535,3071,1535,0,1,1537,627454,0.627454
2035,4400,6045,26598000,2,16286,4073,1,382828600,382828600,6106,2035,4071,2035,0,1,2037,934149,0.934149
2535,4400,6045,26598000,2,20286,5073,1,424608600,424608600,7606,2535,5071,2535,0,1,2537,1275633,1.275633
3035,4400,6045,26598000,2,24286,6073,1,466388600,466388600,9106,3035,6071,3035,0,1,3037,145836,0.145836
3535,4400,6045,26598000,2,28286,7073,1,508168600,508168600,10606,3535,7071,3535,0,1,3537,3882549,3.882549
4035,4400,6045,26598000,2,32286,8073,1,549948600,549948600,12106,4035,8071,4035,0,1,4037,7925563,7.925563
4535,4400,6045,26598000,2,36286,9073,1,591728600,591728600,13606,4535,9071,4535,0,1,4537,2376935,2.376935
5035,4400,6045,26598000,2,40286,10073,1,633508600,633508600,15106,5035,10071,5035,0,1,5037,7004412,7.004412
5535,4400,6045,26598000,2,44286,11073,1,675288600,675288600,16606,5535,11071,5535,0,1,5537,86313,0.086313
6035,4400,6045,26598000,2,48286,12073,1,717068600,717068600,18106,6035,12071,6035,0,1,6037,2150327,2.150327
6535,4400,6045,26598000,2,52286,13073,1,758848600,758848600,19606,6535,13071,6535,0,1,6537,1830246,1.830246
7035,4400,6045,26598000,2,56286,14073,1,800628600,800628600,21106,7035,14071,7035,0,1,7037,14874676,14.874676
35,6600,4045,26697000,2,286,73,1,216556600,216556600,106,35,71,35,0,1,37,133640,0.13364
535,6600,4045,26697000,2,4286,1073,1,259136600,259136600,1606,535,1071,535,0,1,537,577634,0.577634
1035,6600,4045,26697000,2,8286,2073,1,301716600,301716600,3106,1035,2071,1035,0,1,1037,784761,0.784761
1535,6600,4045,26697000,2,12286,3073,1,344296600,344296600,4606,1535,3071,1535,0,1,1537,275821,0.275821
2035,6600,4045,26697000,2,16286,4073,1,386876600,386876600,6106,2035,4071,2035,0,1,2037,2320273,2.320273
2535,6600,4045,26697000,2,20286,5073,1,429456600,429456600,7606,2535,5071,2535,0,1,2537,45657,0.045657
3035,6600,4045,26697000,2,24286,6073,1,472036600,472036600,9106,3035,6071,3035,0,1,3037,2714576,2.714576
3535,6600,4045,26697000,2,28286,7073,1,514616600,514616600,10606,3535,7071,3535,0,1,3537,834932,0.834932
4035,6600,4045,26697000,2,32286,8073,1,557196600,557196600,12106,4035,8071,4035,0,1,4037,6166641,6.166641
4535,6600,4045,26697000,2,36286,9073,1,599776600,599776600,13606,4535,9071,4535,0,1,4537,6150800,6.1508
5035,6600,4045,26697000,2,40286,10073,1,642356600,642356600,15106,5035,10071,5035,0,1,5037,16477025,16.477025
5535,6600,4045,26697000,2,44286,11073,1,684936600,684936600,16606,5535,11071,5535,0,1,5537,5171218,5.171218
6035,6600,4045,26697000,2,48286,12073,1,727516600,727516600,18106,6035,12071,6035,0,1,6037,16297024,16.297024
6535,6600,4045,26697000,2,52286,13073,1,770096600,770096600,19606,6535,13071,6535,0,1,6537,29180056,29.180056
7035,6600,4045,26697000,2,56286,14073,1,812676600,812676600,21106,7035,14071,7035,0,1,7037,35371721,35.371721
40,6300,4240,26712000,2,326,83,1,217068800,217068800,121,40,81,40,0,1,42,482224,0.482224
440,6300,4240,26712000,2,3526,883,1,250796800,250796800,1321,440,881,440,0,1,442,1871276,1.871276
840,6300,4240,26712000,2,6726,1683,1,284524800,284524800,2521,840,1681,840,0,1,842,4253896,4.253896
1240,6300,4240,26712000,2,9926,2483,1,318252800,318252800,3721,1240,2481,1240,0,1,1242,1319154,1.319154
1640,6300,4240,26712000,2,13126,3283,1,351980800,351980800,4921,1640,3281,1640,0,1,1642,111715,0.111715
2040,6300,4240,26712000,2,16326,4083,1,385708800,385708800,6121,2040,4081,2040,0,1,2042,335517,0.335517
2440,6300,4240,26712000,2,19526,4883,1,419436800,419436800,7321,2440,4881,2440,0,1,2442,1435665,1.435665
2840,6300,4240,26712000,2,22726,5683,1,453164800,453164800,8521,2840,5681,2840,0,1,2842,5072388,5.072388
3240,6300,4240,26712000,2,25926,6483,1,486892800,486892800,9721,3240,6481,3240,0,1,3242,194777,0.194777
3640,6300,4240,26712000,2,29126,7283,1,520620800,520620800,10921,3640,7281,3640,0,1,3642,3980220,3.98022
4040,6300,4240,26712000,2,32326,8083,1,554348800,554348800,12121,4040,8081,4040,0,1,4042,6524794,6.524794
4440,6300,4240,26712000,2,35526,8883,1,588076800,588076800,13321,4440,8881,4440,0,1,4442,1822489,1.822489
4840,6300,4240,26712000,2,38726,9683,1,621804800,621804800,14521,4840,9681,4840,0,1,4842,1740710,1.74071
5240,6300,4240,26712000,2,41926,10483,1,655532800,655532800,15721,5240,10481,5240,0,1,5242,11542431,11.542431
5640,6300,4240,26712000,2,45126,11283,1,689260800,689260800,16921,5640,11281,5640,0,1,5642,3557010,3.55701
6040,6300,4240,26712000,2,48326,12083,1,722988800,722988800,18121,6040,12081,6040,0,1,6042,817140,0.81714
6440,6300,4240,26712000,2,51526,12883,1,756716800,756716800,19321,6440,12881,6440,0,1,6442,15525568,15.525568
6840,6300,4240,26712000,2,54726,13683,1,790444800,790444800,20521,6840,13681,6840,0,1,6842,7627574,7.627574
40,6800,3940,26792000,2,326,83,1,217772800,217772800,121,40,81,40,0,1,42,484775,0.484775
440,6800,3940,26792000,2,3526,883,1,252140800,252140800,1321,440,881,440,0,1,442,2492336,2.492336
840,6800,3940,26792000,2,6726,1683,1,286508800,286508800,2521,840,1681,840,0,1,842,2318361,2.318361
1240,6800,3940,26792000,2,9926,2483,1,320876800,320876800,3721,1240,2481,1240,0,1,1242,317226,0.317226
1640,6800,3940,26792000,2,13126,3283,1,355244800,355244800,4921,1640,3281,1640,0,1,1642,2459690,2.45969
2040,6800,3940,26792000,2,16326,4083,1,389612800,389612800,6121,2040,4081,2040,0,1,2042,1448618,1.448618
2440,6800,3940,26792000,2,19526,4883,1,423980800,423980800,7321,2440,4881,2440,0,1,2442,882304,0.882304
2840,6800,3940,26792000,2,22726,5683,1,458348800,458348800,8521,2840,5681,2840,0,1,2842,3099105,3.099105
3240,6800,3940,26792000,2,25926,6483,1,492716800,492716800,9721,3240,6481,3240,0,1,3242,2915885,2.915885
3640,6800,3940,26792000,2,29126,7283,1,527084800,527084800,10921,3640,7281,3640,0,1,3642,1166040,1.16604
4040,6800,3940,26792000,2,32326,8083,1,561452800,561452800,12121,4040,8081,4040,0,1,4042,1910740,1.91074
4440,6800,3940,26792000,2,35526,8883,1,595820800,595820800,13321,4440,8881,4440,0,1,4442,3363470,3.36347
4840,6800,3940,26792000,2,38726,9683,1,630188800,630188800,14521,4840,9681,4840,0,1,4842,220305,0.220305
5240,6800,3940,26792000,2,41926,10483,1,664556800,664556800,15721,5240,10481,5240,0,1,5242,1120569,1.120569
5640,6800,3940,26792000,2,45126,11283,1,698924800,698924800,16921,5640,11281,5640,0,1,5642,2662777,2.662777
6040,6800,3940,26792000,2,48326,12083,1,733292800,733292800,18121,6040,12081,6040,0,1,6042,734285,0.734285
6440,6800,3940,26792000,2,51526,12883,1,767660800,767660800,19321,6440,12881,6440,0,1,6442,2919456,2.919456
6840,6800,3940,26792000,2,54726,13683,1,802028800,802028800,20521,6840,13681,6840,0,1,6842,540979,0.540979
35,4440,6045,26839800,2,286,73,1,217654200,217654200,106,35,71,35,0,1,37,477764,0.477764
535,4440,6045,26839800,2,4286,1073,1,259594200,259594200,1606,535,1071,535,0,1,537,2890315,2.890315
1035,4440,6045,26839800,2,8286,2073,1,301534200,301534200,3106,1035,2071,1035,0,1,1037,5362466,5.362466
1535,4440,6045,26839800,2,12286,3073,1,343474200,343474200,4606,1535,3071,1535,0,1,1537,7869011,7.869011
2035,4440,6045,26839800,2,16286,4073,1,385414200,385414200,6106,2035,4071,2035,0,1,2037,10364639,10.364639
39,4443,6041,26840163,2,318,81,1,217992312,217992312,118,39,79,39,0,1,41,22126,0.022126
539,4443,6041,26840163,2,4318,1081,1,259928312,259928312,1618,539,1079,539,0,1,541,257601,0.257601
1039,4443,6041,26840163,2,8318,2081,1,301864312,301864312,3118,1039,2079,1039,0,1,1041,163746,0.163746
1539,4443,6041,26840163,2,12318,3081,1,343800312,343800312,4618,1539,3079,1539,0,1,1541,1740486,1.740486
2039,4443,6041,26840163,2,16318,4081,1,385736312,385736312,6118,2039,4079,2039,0,1,2041,216390,0.21639
2539,4443,6041,26840163,2,20318,5081,1,427672312,427672312,7618,2539,5079,2539,0,1,2541,147078,0.147078
3039,4443,6041,26840163,2,24318,6081,1,469608312,469608312,9118,3039,6079,3039,0,1,3041,1676088,1.676088
3539,4443,6041,26840163,2,28318,7081,1,511544312,511544312,10618,3539,7079,3539,0,1,3541,699699,0.699699
4039,4443,6041,26840163,2,32318,8081,1,553480312,553480312,12118,4039,8079,4039,0,1,4041,471307,0.471307
4539,4443,6041,26840163,2,36318,9081,1,595416312,595416312,13618,4539,9079,4539,0,1,4541,664923,0.664923
5039,4443,6041,26840163,2,40318,10081,1,637352312,637352312,15118,5039,10079,5039,0,1,5041,2871251,2.871251
5539,4443,6041,26840163,2,44318,11081,1,679288312,679288312,16618,5539,11079,5539,0,1,5541,216794,0.216794
6039,4443,6041,26840163,2,48318,12081,1,721224312,721224312,18118,6039,12079,6039,0,1,6041,5220414,5.220414
6539,4443,6041,26840163,2,52318,13081,1,763160312,763160312,19618,6539,13079,6539,0,1,6541,5712253,5.712253
7039,4443,6041,26840163,2,56318,14081,1,805096312,805096312,21118,7039,14079,7039,0,1,7041,1536133,1.536133
39,6643,4041,26844363,2,318,81,1,218088312,218088312,118,39,79,39,0,1,41,78876,0.078876
539,6643,4041,26844363,2,4318,1081,1,260824312,260824312,1618,539,1079,539,0,1,541,89947,0.089947
1039,6643,4041,26844363,2,8318,2081,1,303560312,303560312,3118,1039,2079,1039,0,1,1041,435015,0.435015
1539,6643,4041,26844363,2,12318,3081,1,346296312,346296312,4618,1539,3079,1539,0,1,1541,230166,0.230166
2039,6643,4041,26844363,2,16318,4081,1,389032312,389032312,6118,2039,4079,2039,0,1,2041,96250,0.09625
2539,6643,4041,26844363,2,20318,5081,1,431768312,431768312,7618,2539,5079,2539,0,1,2541,2081266,2.081266
3039,6643,4041,26844363,2,24318,6081,1,474504312,474504312,9118,3039,6079,3039,0,1,3041,4242610,4.24261
3539,6643,4041,26844363,2,28318,7081,1,517240312,517240312,10618,3539,7079,3539,0,1,3541,849666,0.849666
4039,6643,4041,26844363,2,32318,8081,1,559976312,559976312,12118,4039,8079,4039,0,1,4041,57943,0.057943
4539,6643,4041,26844363,2,36318,9081,1,602712312,602712312,13618,4539,9079,4539,0,1,4541,3699040,3.69904
5039,6643,4041,26844363,2,40318,10081,1,645448312,645448312,15118,5039,10079,5039,0,1,5041,6280808,6.280808
5539,6643,4041,26844363,2,44318,11081,1,688184312,688184312,16618,5539,11079,5539,0,1,5541,563180,0.56318
6039,6643,4041,26844363,2,48318,12081,1,730920312,730920312,18118,6039,12079,6039,0,1,6041,1227073,1.227073
6539,6643,4041,26844363,2,52318,13081,1,773656312,773656312,19618,6539,13079,6539,0,1,6541,321563,0.321563
7039,6643,4041,26844363,2,56318,14081,1,816392312,816392312,21118,7039,14079,7039,0,1,7041,13028273,13.028273
40,5550,4840,26862000,2,326,83,1,218220800,218220800,121,40,81,40,0,1,42,490532,0.490532
440,5550,4840,26862000,2,3526,883,1,251468800,251468800,1321,440,881,440,0,1,442,853606,0.853606
840,5550,4840,26862000,2,6726,1683,1,284716800,284716800,2521,840,1681,840,0,1,842,2803256,2.803256
1240,5550,4840,26862000,2,9926,2483,1,317964800,317964800,3721,1240,2481,1240,0,1,1242,328065,0.328065
1640,5550,4840,26862000,2,13126,3283,1,351212800,351212800,4921,1640,3281,1640,0,1,1642,5334127,5.334127
2040,5550,4840,26862000,2,16326,4083,1,384460800,384460800,6121,2040,4081,2040,0,1,2042,985313,0.985313
2440,5550,4840,26862000,2,19526,4883,1,417708800,417708800,7321,2440,4881,2440,0,1,2442,6367230,6.36723
2840,5550,4840,26862000,2,22726,5683,1,450956800,450956800,8521,2840,5681,2840,0,1,2842,1080074,1.080074
3240,5550,4840,26862000,2,25926,6483,1,484204800,484204800,9721,3240,6481,3240,0,1,3242,2437494,2.437494
3640,5550,4840,26862000,2,29126,7283,1,517452800,517452800,10921,3640,7281,3640,0,1,3642,1555545,1.555545
4040,5550,4840,26862000,2,32326,8083,1,550700800,550700800,12121,4040,8081,4040,0,1,4042,3593663,3.593663
4440,5550,4840,26862000,2,35526,8883,1,583948800,583948800,13321,4440,8881,4440,0,1,4442,55742,0.055742
4840,5550,4840,26862000,2,38726,9683,1,617196800,617196800,14521,4840,9681,4840,0,1,4842,2567079,2.567079
5240,5550,4840,26862000,2,41926,10483,1,650444800,650444800,15721,5240,10481,5240,0,1,5242,4517108,4.517108
5640,5550,4840,26862000,2,45126,11283,1,683692800,683692800,16921,5640,11281,5640,0,1,5642,3108180,3.10818
6040,5550,4840,26862000,2,48326,12083,1,716940800,716940800,18121,6040,12081,6040,0,1,6042,2057096,2.057096
6440,5550,4840,26862000,2,51526,12883,1,750188800,750188800,19321,6440,12881,6440,0,1,6442,9072966,9.072966
6840,5550,4840,26862000,2,54726,13683,1,783436800,783436800,20521,6840,13681,6840,0,1,6842,5530132,5.530132
55,6305,4265,26890825,2,446,113,1,219777400,219777400,166,55,111,55,0,1,57,533761,0.533761
455,6305,4265,26890825,2,3646,913,1,253601400,253601400,1366,455,911,455,0,1,457,2543841,2.543841
855,6305,4265,26890825,2,6846,1713,1,287425400,287425400,2566,855,1711,855,0,1,857,4534224,4.534224
1255,6305,4265,26890825,2,10046,2513,1,321249400,321249400,3766,1255,2511,1255,0,1,1257,3048020,3.04802
1655,6305,4265,26890825,2,13246,3313,1,355073400,355073400,4966,1655,3311,1655,0,1,1657,4063742,4.063742
2055,6305,4265,26890825,2,16446,4113,1,388897400,388897400,6166,2055,4111,2055,0,1,2057,897147,0.897147
2455,6305,4265,26890825,2,19646,4913,1,422721400,422721400,7366,2455,4911,2455,0,1,2457,521528,0.521528
2855,6305,4265,26890825,2,22846,5713,1,456545400,456545400,8566,2855,5711,2855,0,1,2857,1199301,1.199301
3255,6305,4265,26890825,2,26046,6513,1,490369400,490369400,9766,3255,6511,3255,0,1,3257,4272625,4.272625
3655,6305,4265,26890825,2,29246,7313,1,524193400,524193400,10966,3655,7311,3655,0,1,3657,656738,0.656738
4055,6305,4265,26890825,2,32446,8113,1,558017400,558017400,12166,4055,8111,4055,0,1,4057,452316,0.452316
4455,6305,4265,26890825,2,35646,8913,1,591841400,591841400,13366,4455,8911,4455,0,1,4457,5484011,5.484011
4855,6305,4265,26890825,2,38846,9713,1,625665400,625665400,14566,4855,9711,4855,0,1,4857,10988654,10.988654
5255,6305,4265,26890825,2,42046,10513,1,659489400,659489400,15766,5255,10511,5255,0,1,5257,9214939,9.214939
5655,6305,4265,26890825,2,45246,11313,1,693313400,693313400,16966,5655,11311,5655,0,1,5657,6029328,6.029328
6055,6305,4265,26890825,2,48446,12113,1,727137400,727137400,18166,6055,12111,6055,0,1,6057,14787575,14.787575
6455,6305,4265,26890825,2,51646,12913,1,760961400,760961400,19366,6455,12911,6455,0,1,6457,8520656,8.520656
6855,6305,4265,26890825,2,54846,13713,1,794785400,794785400,20566,6855,13711,6855,0,1,6857,4651157,4.651157
40,4050,6640,26892000,2,326,83,1,218556800,218556800,121,40,81,40,0,1,42,34941,0.034941
440,4050,6640,26892000,2,3526,883,1,252764800,252764800,1321,440,881,440,0,1,442,308898,0.308898
840,4050,6640,26892000,2,6726,1683,1,286972800,286972800,2521,840,1681,840,0,1,842,181786,0.181786
1240,4050,6640,26892000,2,9926,2483,1,321180800,321180800,3721,1240,2481,1240,0,1,1242,18860,0.01886
1640,4050,6640,26892000,2,13126,3283,1,355388800,355388800,4921,1640,3281,1640,0,1,1642,54058,0.054058
2040,4050,6640,26892000,2,16326,4083,1,389596800,389596800,6121,2040,4081,2040,0,1,2042,434758,0.434758
2440,4050,6640,26892000,2,19526,4883,1,423804800,423804800,7321,2440,4881,2440,0,1,2442,230717,0.230717
2840,4050,6640,26892000,2,22726,5683,1,458012800,458012800,8521,2840,5681,2840,0,1,2842,123173,0.123173
3240,4050,6640,26892000,2,25926,6483,1,492220800,492220800,9721,3240,6481,3240,0,1,3242,244953,0.244953
3640,4050,6640,26892000,2,29126,7283,1,526428800,526428800,10921,3640,7281,3640,0,1,3642,322901,0.322901
4040,4050,6640,26892000,2,32326,8083,1,560636800,560636800,12121,4040,8081,4040,0,1,4042,94422,0.094422
4440,4050,6640,26892000,2,35526,8883,1,594844800,594844800,13321,4440,8881,4440,0,1,4442,381080,0.38108
4840,4050,6640,26892000,2,38726,9683,1,629052800,629052800,14521,4840,9681,4840,0,1,4842,2523021,2.523021
5240,4050,6640,26892000,2,41926,10483,1,663260800,663260800,15721,5240,10481,5240,0,1,5242,3029718,3.029718
5640,4050,6640,26892000,2,45126,11283,1,697468800,697468800,16921,5640,11281,5640,0,1,5642,3322558,3.322558
6040,4050,6640,26892000,2,48326,12083,1,731676800,731676800,18121,6040,12081,6040,0,1,6042,1181059,1.181059
6440,4050,6640,26892000,2,51526,12883,1,765884800,765884800,19321,6440,12881,6440,0,1,6442,3513028,3.513028
6840,4050,6640,26892000,2,54726,13683,1,800092800,800092800,20521,6840,13681,6840,0,1,6842,1277722,1.277722
44,4453,6055,26962915,2,358,91,1,219402136,219402136,133,44,89,44,0,1,46,123146,0.123146
544,4453,6055,26962915,2,4358,1091,1,261434136,261434136,1633,544,1089,544,0,1,546,291956,0.291956
1044,4453,6055,26962915,2,8358,2091,1,303466136,303466136,3133,1044,2089,1044,0,1,1046,120429,0.120429
1544,4453,6055,26962915,2,12358,3091,1,345498136,345498136,4633,1544,3089,1544,0,1,1546,111868,0.111868
2044,4453,6055,26962915,2,16358,4091,1,387530136,387530136,6133,2044,4089,2044,0,1,2046,340539,0.340539
2544,4453,6055,26962915,2,20358,5091,1,429562136,429562136,7633,2544,5089,2544,0,1,2546,1417116,1.417116
3044,4453,6055,26962915,2,24358,6091,1,471594136,471594136,9133,3044,6089,3044,0,1,3046,1845226,1.845226
3544,4453,6055,26962915,2,28358,7091,1,513626136,513626136,10633,3544,7089,3544,0,1,3546,3345421,3.345421
4044,4453,6055,26962915,2,32358,8091,1,555658136,555658136,12133,4044,8089,4044,0,1,4046,771910,0.77191
4544,4453,6055,26962915,2,36358,9091,1,597690136,597690136,13633,4544,9089,4544,0,1,4546,1719671,1.719671
5044,4453,6055,26962915,2,40358,10091,1,639722136,639722136,15133,5044,10089,5044,0,1,5046,2420345,2.420345
5544,4453,6055,26962915,2,44358,11091,1,681754136,681754136,16633,5544,11089,5544,0,1,5546,1806025,1.806025
6044,4453,6055,26962915,2,48358,12091,1,723786136,723786136,18133,6044,12089,6044,0,1,6046,764137,0.764137
6544,4453,6055,26962915,2,52358,13091,1,765818136,765818136,19633,6544,13089,6544,0,1,6546,131543,0.131543
7044,4453,6055,26962915,2,56358,14091,1,807850136,807850136,21133,7044,14089,7044,0,1,7046,2630334,2.630334
44,6653,4055,26977915,2,358,91,1,219592536,219592536,133,44,89,44,0,1,46,123925,0.123925
544,6653,4055,26977915,2,4358,1091,1,262424536,262424536,1633,544,1089,544,0,1,546,86953,0.086953
1044,6653,4055,26977915,2,8358,2091,1,305256536,305256536,3133,1044,2089,1044,0,1,1046,333259,0.333259
1544,6653,4055,26977915,2,12358,3091,1,348088536,348088536,4633,1544,3089,1544,0,1,1546,276043,0.276043
2044,6653,4055,26977915,2,16358,4091,1,390920536,390920536,6133,2044,4089,2044,0,1,2046,900534,0.900534
2544,6653,4055,26977915,2,20358,5091,1,433752536,433752536,7633,2544,5089,2544,0,1,2546,780404,0.780404
3044,6653,4055,26977915,2,24358,6091,1,476584536,476584536,9133,3044,6089,3044,0,1,3046,843136,0.843136
3544,6653,4055,26977915,2,28358,7091,1,519416536,519416536,10633,3544,7089,3544,0,1,3546,395890,0.39589
4044,6653,4055,26977915,2,32358,8091,1,562248536,562248536,12133,4044,8089,4044,0,1,4046,646747,0.646747
4544,6653,4055,26977915,2,36358,9091,1,605080536,605080536,13633,4544,9089,4544,0,1,4546,329142,0.329142
5044,6653,4055,26977915,2,40358,10091,1,647912536,647912536,15133,5044,10089,5044,0,1,5046,909835,0.909835
5544,6653,4055,26977915,2,44358,11091,1,690744536,690744536,16633,5544,11089,5544,0,1,5546,1102777,1.102777
6044,6653,4055,26977915,2,48358,12091,1,733576536,733576536,18133,6044,12089,6044,0,1,6046,3467896,3.467896
6544,6653,4055,26977915,2,52358,13091,1,776408536,776408536,19633,6544,13089,6544,0,1,6546,2216747,2.216747
7044,6653,4055,26977915,2,56358,14091,1,819240536,819240536,21133,7044,14089,7044,0,1,7046,2220187,2.220187
55,6805,3965,26981825,2,446,113,1,220593400,220593400,166,55,111,55,0,1,57,54723,0.054723
455,6805,3965,26981825,2,3646,913,1,255057400,255057400,1366,455,911,455,0,1,457,2594645,2.594645
855,6805,3965,26981825,2,6846,1713,1,289521400,289521400,2566,855,1711,855,0,1,857,1927833,1.927833
1255,6805,3965,26981825,2,10046,2513,1,323985400,323985400,3766,1255,2511,1255,0,1,1257,1442969,1.442969
1655,6805,3965,26981825,2,13246,3313,1,358449400,358449400,4966,1655,3311,1655,0,1,1657,531654,0.531654
2055,6805,3965,26981825,2,16446,4113,1,392913400,392913400,6166,2055,4111,2055,0,1,2057,1526864,1.526864
2455,6805,3965,26981825,2,19646,4913,1,427377400,427377400,7366,2455,4911,2455,0,1,2457,1846046,1.846046
2855,6805,3965,26981825,2,22846,5713,1,461841400,461841400,8566,2855,5711,2855,0,1,2857,813548,0.813548
3255,6805,3965,26981825,2,26046,6513,1,496305400,496305400,9766,3255,6511,3255,0,1,3257,5106073,5.106073
3655,6805,3965,26981825,2,29246,7313,1,530769400,530769400,10966,3655,7311,3655,0,1,3657,1854633,1.854633
4055,6805,3965,26981825,2,32446,8113,1,565233400,565233400,12166,4055,8111,4055,0,1,4057,1843266,1.843266
4455,6805,3965,26981825,2,35646,8913,1,599697400,599697400,13366,4455,8911,4455,0,1,4457,1186610,1.18661
4855,6805,3965,26981825,2,38846,9713,1,634161400,634161400,14566,4855,9711,4855,0,1,4857,1462313,1.462313
5255,6805,3965,26981825,2,42046,10513,1,668625400,668625400,15766,5255,10511,5255,0,1,5257,551702,0.551702
5655,6805,3965,26981825,2,45246,11313,1,703089400,703089400,16966,5655,11311,5655,0,1,5657,200291,0.200291
6055,6805,3965,26981825,2,48446,12113,1,737553400,737553400,18166,6055,12111,6055,0,1,6057,3687751,3.687751
6455,6805,3965,26981825,2,51646,12913,1,772017400,772017400,19366,6455,12911,6455,0,1,6457,5975746,5.975746
6855,6805,3965,26981825,2,54846,13713,1,806481400,806481400,20566,6855,13711,6855,0,1,6857,574111,0.574111
55,5555,4865,27025075,2,446,113,1,220785400,220785400,166,55,111,55,0,1,57,471112,0.471112
455,5555,4865,27025075,2,3646,913,1,254129400,254129400,1366,455,911,455,0,1,457,2588236,2.588236
855,5555,4865,27025075,2,6846,1713,1,287473400,287473400,2566,855,1711,855,0,1,857,1556825,1.556825
1255,5555,4865,27025075,2,10046,2513,1,320817400,320817400,3766,1255,2511,1255,0,1,1257,3778016,3.778016
1655,5555,4865,27025075,2,13246,3313,1,354161400,354161400,4966,1655,3311,1655,0,1,1657,1431685,1.431685
2055,5555,4865,27025075,2,16446,4113,1,387505400,387505400,6166,2055,4111,2055,0,1,2057,1372159,1.372159
2455,5555,4865,27025075,2,19646,4913,1,420849400,420849400,7366,2455,4911,2455,0,1,2457,4062767,4.062767
2855,5555,4865,27025075,2,22846,5713,1,454193400,454193400,8566,2855,5711,2855,0,1,2857,5154157,5.154157
3255,5555,4865,27025075,2,26046,6513,1,487537400,487537400,9766,3255,6511,3255,0,1,3257,429195,0.429195
3655,5555,4865,27025075,2,29246,7313,1,520881400,520881400,10966,3655,7311,3655,0,1,3657,2377193,2.377193
4055,5555,4865,27025075,2,32446,8113,1,554225400,554225400,12166,4055,8111,4055,0,1,4057,372378,0.372378
4455,5555,4865,27025075,2,35646,8913,1,587569400,587569400,13366,4455,8911,4455,0,1,4457,5054052,5.054052
4855,5555,4865,27025075,2,38846,9713,1,620913400,620913400,14566,4855,9711,4855,0,1,4857,1071466,1.071466
5255,5555,4865,27025075,2,42046,10513,1,654257400,654257400,15766,5255,10511,5255,0,1,5257,1701647,1.701647
5655,5555,4865,27025075,2,45246,11313,1,687601400,687601400,16966,5655,11311,5655,0,1,5657,4982193,4.982193
6055,5555,4865,27025075,2,48446,12113,1,720945400,720945400,18166,6055,12111,6055,0,1,6057,4039315,4.039315
6455,5555,4865,27025075,2,51646,12913,1,754289400,754289400,19366,6455,12911,6455,0,1,6457,1433927,1.433927
6855,5555,4865,27025075,2,54846,13713,1,787633400,787633400,20566,6855,13711,6855,0,1,6857,9054799,9.054799
55,4055,6665,27026575,2,446,113,1,220929400,220929400,166,55,111,55,0,1,57,19930,0.01993
455,4055,6665,27026575,2,3646,913,1,255233400,255233400,1366,455,911,455,0,1,457,160183,0.160183
855,4055,6665,27026575,2,6846,1713,1,289537400,289537400,2566,855,1711,855,0,1,857,132968,0.132968
1255,4055,6665,27026575,2,10046,2513,1,323841400,323841400,3766,1255,2511,1255,0,1,1257,486440,0.48644
1655,4055,6665,27026575,2,13246,3313,1,358145400,358145400,4966,1655,3311,1655,0,1,1657,408190,0.40819
2055,4055,6665,27026575,2,16446,4113,1,392449400,392449400,6166,2055,4111,2055,0,1,2057,175231,0.175231
2455,4055,6665,27026575,2,19646,4913,1,426753400,426753400,7366,2455,4911,2455,0,1,2457,294881,0.294881
2855,4055,6665,27026575,2,22846,5713,1,461057400,461057400,8566,2855,5711,2855,0,1,2857,1089495,1.089495
3255,4055,6665,27026575,2,26046,6513,1,495361400,495361400,9766,3255,6511,3255,0,1,3257,852280,0.85228
3655,4055,6665,27026575,2,29246,7313,1,529665400,529665400,10966,3655,7311,3655,0,1,3657,35707,0.035707
4055,4055,6665,27026575,2,32446,8113,1,563969400,563969400,12166,4055,8111,4055,0,1,4057,312107,0.312107
4455,4055,6665,27026575,2,35646,8913,1,598273400,598273400,13366,4455,8911,4455,0,1,4457,2418093,2.418093
4855,4055,6665,27026575,2,38846,9713,1,632577400,632577400,14566,4855,9711,4855,0,1,4857,139841,0.139841
5255,4055,6665,27026575,2,42046,10513,1,666881400,666881400,15766,5255,10511,5255,0,1,5257,425159,0.425159
5655,4055,6665,27026575,2,45246,11313,1,701185400,701185400,16966,5655,11311,5655,0,1,5657,1124222,1.124222
6055,4055,6665,27026575,2,48446,12113,1,735489400,735489400,18166,6055,12111,6055,0,1,6057,3955035,3.955035
6455,4055,6665,27026575,2,51646,12913,1,769793400,769793400,19366,6455,12911,6455,0,1,6457,257534,0.257534
6855,4055,6665,27026575,2,54846,13713,1,804097400,804097400,20566,6855,13711,6855,0,1,6857,882726,0.882726
40,5300,5140,27242000,2,326,83,1,221276800,221276800,121,40,81,40,0,1,42,198820,0.19882
440,5300,5140,27242000,2,3526,883,1,254684800,254684800,1321,440,881,440,0,1,442,21340,0.02134
840,5300,5140,27242000,2,6726,1683,1,288092800,288092800,2521,840,1681,840,0,1,842,2829335,2.829335
1240,5300,5140,27242000,2,9926,2483,1,321500800,321500800,3721,1240,2481,1240,0,1,1242,3068036,3.068036
1640,5300,5140,27242000,2,13126,3283,1,354908800,354908800,4921,1640,3281,1640,0,1,1642,2140722,2.140722
2040,5300,5140,27242000,2,16326,4083,1,388316800,388316800,6121,2040,4081,2040,0,1,2042,2028499,2.028499
2440,5300,5140,27242000,2,19526,4883,1,421724800,421724800,7321,2440,4881,2440,0,1,2442,605803,0.605803
2840,5300,5140,27242000,2,22726,5683,1,455132800,455132800,8521,2840,5681,2840,0,1,2842,1480922,1.480922
3240,5300,5140,27242000,2,25926,6483,1,488540800,488540800,9721,3240,6481,3240,0,1,3242,5302313,5.302313
3640,5300,5140,27242000,2,29126,7283,1,521948800,521948800,10921,3640,7281,3640,0,1,3642,856874,0.856874
4040,5300,5140,27242000,2,32326,8083,1,555356800,555356800,12121,4040,8081,4040,0,1,4042,1077597,1.077597
4440,5300,5140,27242000,2,35526,8883,1,588764800,588764800,13321,4440,8881,4440,0,1,4442,353563,0.353563
4840,5300,5140,27242000,2,38726,9683,1,622172800,622172800,14521,4840,9681,4840,0,1,4842,1033942,1.033942
5240,5300,5140,27242000,2,41926,10483,1,655580800,655580800,15721,5240,10481,5240,0,1,5242,511504,0.511504
5640,5300,5140,27242000,2,45126,11283,1,688988800,688988800,16921,5640,11281,5640,0,1,5642,1163258,1.163258
6040,5300,5140,27242000,2,48326,12083,1,722396800,722396800,18121,6040,12081,6040,0,1,6042,6417547,6.417547
6440,5300,5140,27242000,2,51526,12883,1,755804800,755804800,19321,6440,12881,6440,0,1,6442,1357567,1.357567
6840,5300,5140,27242000,2,54726,13683,1,789212800,789212800,20521,6840,13681,6840,0,1,6842,2041812,2.041812
40,4300,6340,27262000,2,326,83,1,221500800,221500800,121,40,81,40,0,1,42,490186,0.490186
440,4300,6340,27262000,2,3526,883,1,255548800,255548800,1321,440,881,440,0,1,442,8412,0.008412
840,4300,6340,27262000,2,6726,1683,1,289596800,289596800,2521,840,1681,840,0,1,842,100725,0.100725
1240,4300,6340,27262000,2,9926,2483,1,323644800,323644800,3721,1240,2481,1240,0,1,1242,530725,0.530725
1640,4300,6340,27262000,2,13126,3283,1,357692800,357692800,4921,1640,3281,1640,0,1,1642,3540879,3.540879
2040,4300,6340,27262000,2,16326,4083,1,391740800,391740800,6121,2040,4081,2040,0,1,2042,408746,0.408746
2440,4300,6340,27262000,2,19526,4883,1,425788800,425788800,7321,2440,4881,2440,0,1,2442,66093,0.066093
2840,4300,6340,27262000,2,22726,5683,1,459836800,459836800,8521,2840,5681,2840,0,1,2842,117262,0.117262
3240,4300,6340,27262000,2,25926,6483,1,493884800,493884800,9721,3240,6481,3240,0,1,3242,413290,0.41329
3640,4300,6340,27262000,2,29126,7283,1,527932800,527932800,10921,3640,7281,3640,0,1,3642,1237508,1.237508
4040,4300,6340,27262000,2,32326,8083,1,561980800,561980800,12121,4040,8081,4040,0,1,4042,146060,0.14606
4440,4300,6340,27262000,2,35526,8883,1,596028800,596028800,13321,4440,8881,4440,0,1,4442,3125755,3.125755
4840,4300,6340,27262000,2,38726,9683,1,630076800,630076800,14521,4840,9681,4840,0,1,4842,654033,0.654033
5240,4300,6340,27262000,2,41926,10483,1,664124800,664124800,15721,5240,10481,5240,0,1,5242,542548,0.542548
5640,4300,6340,27262000,2,45126,11283,1,698172800,698172800,16921,5640,11281,5640,0,1,5642,272501,0.272501
6040,4300,6340,27262000,2,48326,12083,1,732220800,732220800,18121,6040,12081,6040,0,1,6042,1571510,1.57151
6440,4300,6340,27262000,2,51526,12883,1,766268800,766268800,19321,6440,12881,6440,0,1,6442,1371230,1.37123
6840,4300,6340,27262000,2,54726,13683,1,800316800,800316800,20521,6840,13681,6840,0,1,6842,5532315,5.532315
55,5305,5165,27400325,2,446,113,1,223809400,223809400,166,55,111,55,0,1,57,547408,0.547408
455,5305,5165,27400325,2,3646,913,1,257313400,257313400,1366,455,911,455,0,1,457,2583245,2.583245
855,5305,5165,27400325,2,6846,1713,1,290817400,290817400,2566,855,1711,855,0,1,857,786819,0.786819
1255,5305,5165,27400325,2,10046,2513,1,324321400,324321400,3766,1255,2511,1255,0,1,1257,221260,0.22126
1655,5305,5165,27400325,2,13246,3313,1,357825400,357825400,4966,1655,3311,1655,0,1,1657,612914,0.612914
2055,5305,5165,27400325,2,16446,4113,1,391329400,391329400,6166,2055,4111,2055,0,1,2057,1777978,1.777978
2455,5305,5165,27400325,2,19646,4913,1,424833400,424833400,7366,2455,4911,2455,0,1,2457,3273855,3.273855
2855,5305,5165,27400325,2,22846,5713,1,458337400,458337400,8566,2855,5711,2855,0,1,2857,1264376,1.264376
3255,5305,5165,27400325,2,26046,6513,1,491841400,491841400,9766,3255,6511,3255,0,1,3257,6568173,6.568173
3655,5305,5165,27400325,2,29246,7313,1,525345400,525345400,10966,3655,7311,3655,0,1,3657,3125607,3.125607
4055,5305,5165,27400325,2,32446,8113,1,558849400,558849400,12166,4055,8111,4055,0,1,4057,288798,0.288798
4455,5305,5165,27400325,2,35646,8913,1,592353400,592353400,13366,4455,8911,4455,0,1,4457,4305351,4.305351
4855,5305,5165,27400325,2,38846,9713,1,625857400,625857400,14566,4855,9711,4855,0,1,4857,1554218,1.554218
5255,5305,5165,27400325,2,42046,10513,1,659361400,659361400,15766,5255,10511,5255,0,1,5257,2505694,2.505694
5655,5305,5165,27400325,2,45246,11313,1,692865400,692865400,16966,5655,11311,5655,0,1,5657,299775,0.299775
6055,5305,5165,27400325,2,48446,12113,1,726369400,726369400,18166,6055,12111,6055,0,1,6057,668557,0.668557
6455,5305,5165,27400325,2,51646,12913,1,759873400,759873400,19366,6455,12911,6455,0,1,6457,2591174,2.591174
6855,5305,5165,27400325,2,54846,13713,1,793377400,793377400,20566,6855,13711,6855,0,1,6857,1393943,1.393943
55,4305,6365,27401325,2,446,113,1,223905400,223905400,166,55,111,55,0,1,57,545463,0.545463
455,4305,6365,27401325,2,3646,913,1,258049400,258049400,1366,455,911,455,0,1,457,96190,0.09619
855,4305,6365,27401325,2,6846,1713,1,292193400,292193400,2566,855,1711,855,0,1,857,323954,0.323954
1255,4305,6365,27401325,2,10046,2513,1,326337400,326337400,3766,1255,2511,1255,0,1,1257,1827457,1.827457
1655,4305,6365,27401325,2,13246,3313,1,360481400,360481400,4966,1655,3311,1655,0,1,1657,580518,0.580518
2055,4305,6365,27401325,2,16446,4113,1,394625400,394625400,6166,2055,4111,2055,0,1,2057,1899245,1.899245
2455,4305,6365,27401325,2,19646,4913,1,428769400,428769400,7366,2455,4911,2455,0,1,2457,786572,0.786572
2855,4305,6365,27401325,2,22846,5713,1,462913400,462913400,8566,2855,5711,2855,0,1,2857,2052172,2.052172
3255,4305,6365,27401325,2,26046,6513,1,497057400,497057400,9766,3255,6511,3255,0,1,3257,2370762,2.370762
3655,4305,6365,27401325,2,29246,7313,1,531201400,531201400,10966,3655,7311,3655,0,1,3657,916584,0.916584
4055,4305,6365,27401325,2,32446,8113,1,565345400,565345400,12166,4055,8111,4055,0,1,4057,579595,0.579595
4455,4305,6365,27401325,2,35646,8913,1,599489400,599489400,13366,4455,8911,4455,0,1,4457,641356,0.641356
4855,4305,6365,27401325,2,38846,9713,1,633633400,633633400,14566,4855,9711,4855,0,1,4857,898922,0.898922
5255,4305,6365,27401325,2,42046,10513,1,667777400,667777400,15766,5255,10511,5255,0,1,5257,2052520,2.05252
5655,4305,6365,27401325,2,45246,11313,1,701921400,701921400,16966,5655,11311,5655,0,1,5657,408524,0.408524
6055,4305,6365,27401325,2,48446,12113,1,736065400,736065400,18166,6055,12111,6055,0,1,6057,1675852,1.675852
6455,4305,6365,27401325,2,51646,12913,1,770209400,770209400,19366,6455,12911,6455,0,1,6457,243027,0.243027
6855,4305,6365,27401325,2,54846,13713,1,804353400,804353400,20566,6855,13711,6855,0,1,6857,2877926,2.877926
39,3893,7041,27410613,2,318,81,1,222696312,222696312,118,39,79,39,0,1,41,500621,0.500621
539,3893,7041,27410613,2,4318,1081,1,266432312,266432312,1618,539,1079,539,0,1,541,2328506,2.328506
1039,3893,7041,27410613,2,8318,2081,1,310168312,310168312,3118,1039,2079,1039,0,1,1041,2926612,2.926612
1539,3893,7041,27410613,2,12318,3081,1,353904312,353904312,4618,1539,3079,1539,0,1,1541,2157510,2.15751
2039,3893,7041,27410613,2,16318,4081,1,397640312,397640312,6118,2039,4079,2039,0,1,2041,1656391,1.656391
2539,3893,7041,27410613,2,20318,5081,1,441376312,441376312,7618,2539,5079,2539,0,1,2541,319693,0.319693
3039,3893,7041,27410613,2,24318,6081,1,485112312,485112312,9118,3039,6079,3039,0,1,3041,4821376,4.821376
3539,3893,7041,27410613,2,28318,7081,1,528848312,528848312,10618,3539,7079,3539,0,1,3541,1064585,1.064585
4039,3893,7041,27410613,2,32318,8081,1,572584312,572584312,12118,4039,8079,4039,0,1,4041,2370546,2.370546
4539,3893,7041,27410613,2,36318,9081,1,616320312,616320312,13618,4539,9079,4539,0,1,4541,6014982,6.014982
5039,3893,7041,27410613,2,40318,10081,1,660056312,660056312,15118,5039,10079,5039,0,1,5041,12078809,12.078809
5539,3893,7041,27410613,2,44318,11081,1,703792312,703792312,16618,5539,11079,5539,0,1,5541,15666800,15.6668
6039,3893,7041,27410613,2,48318,12081,1,747528312,747528312,18118,6039,12079,6039,0,1,6041,23764657,23.764657
6539,3893,7041,27410613,2,52318,13081,1,791264312,791264312,19618,6539,13079,6539,0,1,6541,20057189,20.057189
7039,3893,7041,27410613,2,56318,14081,1,835000312,835000312,21118,7039,14079,7039,0,1,7041,3622894,3.622894
35,4950,5545,27447750,2,286,73,1,222520600,222520600,106,35,71,35,0,1,37,285402,0.285402
535,4950,5545,27447750,2,4286,1073,1,264500600,264500600,1606,535,1071,535,0,1,537,224294,0.224294
1035,4950,5545,27447750,2,8286,2073,1,306480600,306480600,3106,1035,2071,1035,0,1,1037,331463,0.331463
1535,4950,5545,27447750,2,12286,3073,1,348460600,348460600,4606,1535,3071,1535,0,1,1537,1701998,1.701998
2035,4950,5545,27447750,2,16286,4073,1,390440600,390440600,6106,2035,4071,2035,0,1,2037,2760953,2.760953
2535,4950,5545,27447750,2,20286,5073,1,432420600,432420600,7606,2535,5071,2535,0,1,2537,1786458,1.786458
3035,4950,5545,27447750,2,24286,6073,1,474400600,474400600,9106,3035,6071,3035,0,1,3037,2778962,2.778962
3535,4950,5545,27447750,2,28286,7073,1,516380600,516380600,10606,3535,7071,3535,0,1,3537,2369973,2.369973
4035,4950,5545,27447750,2,32286,8073,1,558360600,558360600,12106,4035,8071,4035,0,1,4037,2166614,2.166614
4535,4950,5545,27447750,2,36286,9073,1,600340600,600340600,13606,4535,9071,4535,0,1,4537,834942,0.834942
5035,4950,5545,27447750,2,40286,10073,1,642320600,642320600,15106,5035,10071,5035,0,1,5037,4363259,4.363259
5535,4950,5545,27447750,2,44286,11073,1,684300600,684300600,16606,5535,11071,5535,0,1,5537,914984,0.914984
6035,4950,5545,27447750,2,48286,12073,1,726280600,726280600,18106,6035,12071,6035,0,1,6037,7531843,7.531843
6535,4950,5545,27447750,2,52286,13073,1,768260600,768260600,19606,6535,13071,6535,0,1,6537,7214087,7.214087
7035,4950,5545,27447750,2,56286,14073,1,810240600,810240600,21106,7035,14071,7035,0,1,7037,789197,0.789197
40,6050,4540,27467000,2,326,83,1,223124800,223124800,121,40,81,40,0,1,42,485077,0.485077
440,6050,4540,27467000,2,3526,883,1,257012800,257012800,1321,440,881,440,0,1,442,124037,0.124037
840,6050,4540,27467000,2,6726,1683,1,290900800,290900800,2521,840,1681,840,0,1,842,522277,0.522277
1240,6050,4540,27467000,2,9926,2483,1,324788800,324788800,3721,1240,2481,1240,0,1,1242,1103064,1.103064
1640,6050,4540,27467000,2,13126,3283,1,358676800,358676800,4921,1640,3281,1640,0,1,1642,1084908,1.084908
2040,6050,4540,27467000,2,16326,4083,1,392564800,392564800,6121,2040,4081,2040,0,1,2042,63132,0.063132
2440,6050,4540,27467000,2,19526,4883,1,426452800,426452800,7321,2440,4881,2440,0,1,2442,4280088,4.280088
2840,6050,4540,27467000,2,22726,5683,1,460340800,460340800,8521,2840,5681,2840,0,1,2842,58413,0.058413
3240,6050,4540,27467000,2,25926,6483,1,494228800,494228800,9721,3240,6481,3240,0,1,3242,439862,0.439862
3640,6050,4540,27467000,2,29126,7283,1,528116800,528116800,10921,3640,7281,3640,0,1,3642,2859505,2.859505
4040,6050,4540,27467000,2,32326,8083,1,562004800,562004800,12121,4040,8081,4040,0,1,4042,823760,0.82376
4440,6050,4540,27467000,2,35526,8883,1,595892800,595892800,13321,4440,8881,4440,0,1,4442,4320311,4.320311
4840,6050,4540,27467000,2,38726,9683,1,629780800,629780800,14521,4840,9681,4840,0,1,4842,404015,0.404015
5240,6050,4540,27467000,2,41926,10483,1,663668800,663668800,15721,5240,10481,5240,0,1,5242,3032141,3.032141
5640,6050,4540,27467000,2,45126,11283,1,697556800,697556800,16921,5640,11281,5640,0,1,5642,7541743,7.541743
6040,6050,4540,27467000,2,48326,12083,1,731444800,731444800,18121,6040,12081,6040,0,1,6042,260210,0.26021
6440,6050,4540,27467000,2,51526,12883,1,765332800,765332800,19321,6440,12881,6440,0,1,6442,264701,0.264701
6840,6050,4540,27467000,2,54726,13683,1,799220800,799220800,20521,6840,13681,6840,0,1,6842,3822941,3.822941
40,5050,5440,27472000,2,326,83,1,223132800,223132800,121,40,81,40,0,1,42,45720,0.04572
440,5050,5440,27472000,2,3526,883,1,256700800,256700800,1321,440,881,440,0,1,442,189263,0.189263
840,5050,5440,27472000,2,6726,1683,1,290268800,290268800,2521,840,1681,840,0,1,842,20407,0.020407
1240,5050,5440,27472000,2,9926,2483,1,323836800,323836800,3721,1240,2481,1240,0,1,1242,40362,0.040362
1640,5050,5440,27472000,2,13126,3283,1,357404800,357404800,4921,1640,3281,1640,0,1,1642,200589,0.200589
2040,5050,5440,27472000,2,16326,4083,1,390972800,390972800,6121,2040,4081,2040,0,1,2042,375570,0.37557
2440,5050,5440,27472000,2,19526,4883,1,424540800,424540800,7321,2440,4881,2440,0,1,2442,158920,0.15892
2840,5050,5440,27472000,2,22726,5683,1,458108800,458108800,8521,2840,5681,2840,0,1,2842,184390,0.18439
3240,5050,5440,27472000,2,25926,6483,1,491676800,491676800,9721,3240,6481,3240,0,1,3242,143790,0.14379
3640,5050,5440,27472000,2,29126,7283,1,525244800,525244800,10921,3640,7281,3640,0,1,3642,1651294,1.651294
4040,5050,5440,27472000,2,32326,8083,1,558812800,558812800,12121,4040,8081,4040,0,1,4042,1684066,1.684066
4440,5050,5440,27472000,2,35526,8883,1,592380800,592380800,13321,4440,8881,4440,0,1,4442,307412,0.307412
4840,5050,5440,27472000,2,38726,9683,1,625948800,625948800,14521,4840,9681,4840,0,1,4842,180365,0.180365
5240,5050,5440,27472000,2,41926,10483,1,659516800,659516800,15721,5240,10481,5240,0,1,5242,915667,0.915667
5640,5050,5440,27472000,2,45126,11283,1,693084800,693084800,16921,5640,11281,5640,0,1,5642,22924,0.022924
6040,5050,5440,27472000,2,48326,12083,1,726652800,726652800,18121,6040,12081,6040,0,1,6042,976069,0.976069
6440,5050,5440,27472000,2,51526,12883,1,760220800,760220800,19321,6440,12881,6440,0,1,6442,350439,0.350439
6840,5050,5440,27472000,2,54726,13683,1,793788800,793788800,20521,6840,13681,6840,0,1,6842,113036,0.113036
40,4550,6040,27482000,2,326,83,1,223244800,223244800,121,40,81,40,0,1,42,497327,0.497327
440,4550,6040,27482000,2,3526,883,1,257132800,257132800,1321,440,881,440,0,1,442,2442932,2.442932
840,4550,6040,27482000,2,6726,1683,1,291020800,291020800,2521,840,1681,840,0,1,842,903467,0.903467
1240,4550,6040,27482000,2,9926,2483,1,324908800,324908800,3721,1240,2481,1240,0,1,1242,1209694,1.209694
1640,4550,6040,27482000,2,13126,3283,1,358796800,358796800,4921,1640,3281,1640,0,1,1642,3526683,3.526683
2040,4550,6040,27482000,2,16326,4083,1,392684800,392684800,6121,2040,4081,2040,0,1,2042,4435870,4.43587
2440,4550,6040,27482000,2,19526,4883,1,426572800,426572800,7321,2440,4881,2440,0,1,2442,2420453,2.420453
2840,4550,6040,27482000,2,22726,5683,1,460460800,460460800,8521,2840,5681,2840,0,1,2842,9259588,9.259588
3240,4550,6040,27482000,2,25926,6483,1,494348800,494348800,9721,3240,6481,3240,0,1,3242,935094,0.935094
3640,4550,6040,27482000,2,29126,7283,1,528236800,528236800,10921,3640,7281,3640,0,1,3642,4021185,4.021185
4040,4550,6040,27482000,2,32326,8083,1,562124800,562124800,12121,4040,8081,4040,0,1,4042,10398693,10.398693
4440,4550,6040,27482000,2,35526,8883,1,596012800,596012800,13321,4440,8881,4440,0,1,4442,707755,0.707755
4840,4550,6040,27482000,2,38726,9683,1,629900800,629900800,14521,4840,9681,4840,0,1,4842,796417,0.796417
5240,4550,6040,27482000,2,41926,10483,1,663788800,663788800,15721,5240,10481,5240,0,1,5242,547407,0.547407
5640,4550,6040,27482000,2,45126,11283,1,697676800,697676800,16921,5640,11281,5640,0,1,5642,2378366,2.378366
6040,4550,6040,27482000,2,48326,12083,1,731564800,731564800,18121,6040,12081,6040,0,1,6042,1329703,1.329703
6440,4550,6040,27482000,2,51526,12883,1,765452800,765452800,19321,6440,12881,6440,0,1,6442,3114429,3.114429
6840,4550,6040,27482000,2,54726,13683,1,799340800,799340800,20521,6840,13681,6840,0,1,6842,4101237,4.101237
35,6050,4545,27497250,2,286,73,1,222944600,222944600,106,35,71,35,0,1,37,18956,0.018956
535,6050,4545,27497250,2,4286,1073,1,265324600,265324600,1606,535,1071,535,0,1,537,880595,0.880595
1035,6050,4545,27497250,2,8286,2073,1,307704600,307704600,3106,1035,2071,1035,0,1,1037,1849835,1.849835
1535,6050,4545,27497250,2,12286,3073,1,350084600,350084600,4606,1535,3071,1535,0,1,1537,720442,0.720442
2035,6050,4545,27497250,2,16286,4073,1,392464600,392464600,6106,2035,4071,2035,0,1,2037,1679314,1.679314
2535,6050,4545,27497250,2,20286,5073,1,434844600,434844600,7606,2535,5071,2535,0,1,2537,4196023,4.196023
3035,6050,4545,27497250,2,24286,6073,1,477224600,477224600,9106,3035,6071,3035,0,1,3037,1169774,1.169774
3535,6050,4545,27497250,2,28286,7073,1,519604600,519604600,10606,3535,7071,3535,0,1,3537,327374,0.327374
4035,6050,4545,27497250,2,32286,8073,1,561984600,561984600,12106,4035,8071,4035,0,1,4037,448633,0.448633
4535,6050,4545,27497250,2,36286,9073,1,604364600,604364600,13606,4535,9071,4535,0,1,4537,1351857,1.351857
5035,6050,4545,27497250,2,40286,10073,1,646744600,646744600,15106,5035,10071,5035,0,1,5037,5532426,5.532426
5535,6050,4545,27497250,2,44286,11073,1,689124600,689124600,16606,5535,11071,5535,0,1,5537,11898159,11.898159
6035,6050,4545,27497250,2,48286,12073,1,731504600,731504600,18106,6035,12071,6035,0,1,6037,7264597,7.264597
6535,6050,4545,27497250,2,52286,13073,1,773884600,773884600,19606,6535,13071,6535,0,1,6537,12921917,12.921917
7035,6050,4545,27497250,2,56286,14073,1,816264600,816264600,21106,7035,14071,7035,0,1,7037,2559862,2.559862
44,3903,7055,27535665,2,358,91,1,224142536,224142536,133,44,89,44,0,1,46,524541,0.524541
544,3903,7055,27535665,2,4358,1091,1,267974536,267974536,1633,544,1089,544,0,1,546,3107464,3.107464
1044,3903,7055,27535665,2,8358,2091,1,311806536,311806536,3133,1044,2089,1044,0,1,1046,2404745,2.404745
1544,3903,7055,27535665,2,12358,3091,1,355638536,355638536,4633,1544,3089,1544,0,1,1546,2293197,2.293197
2044,3903,7055,27535665,2,16358,4091,1,399470536,399470536,6133,2044,4089,2044,0,1,2046,547258,0.547258
2544,3903,7055,27535665,2,20358,5091,1,443302536,443302536,7633,2544,5089,2544,0,1,2546,3395962,3.395962
3044,3903,7055,27535665,2,24358,6091,1,487134536,487134536,9133,3044,6089,3044,0,1,3046,1920448,1.920448
3544,3903,7055,27535665,2,28358,7091,1,530966536,530966536,10633,3544,7089,3544,0,1,3546,1196778,1.196778
4044,3903,7055,27535665,2,32358,8091,1,574798536,574798536,12133,4044,8089,4044,0,1,4046,1110231,1.110231
4544,3903,7055,27535665,2,36358,9091,1,618630536,618630536,13633,4544,9089,4544,0,1,4546,1338154,1.338154
5044,3903,7055,27535665,2,40358,10091,1,662462536,662462536,15133,5044,10089,5044,0,1,5046,11039897,11.039897
5544,3903,7055,27535665,2,44358,11091,1,706294536,706294536,16633,5544,11089,5544,0,1,5546,424129,0.424129
6044,3903,7055,27535665,2,48358,12091,1,750126536,750126536,18133,6044,12089,6044,0,1,6046,6765903,6.765903
6544,3903,7055,27535665,2,52358,13091,1,793958536,793958536,19633,6544,13089,6544,0,1,6546,384462,0.384462
7044,3903,7055,27535665,2,56358,14091,1,837790536,837790536,21133,7044,14089,7044,0,1,7046,16180673,16.180673
40,4800,5740,27552000,2,326,83,1,223788800,223788800,121,40,81,40,0,1,42,505990,0.50599
440,4800,5740,27552000,2,3526,883,1,257516800,257516800,1321,440,881,440,0,1,442,2460017,2.460017
840,4800,5740,27552000,2,6726,1683,1,291244800,291244800,2521,840,1681,840,0,1,842,4467549,4.467549
1240,4800,5740,27552000,2,9926,2483,1,324972800,324972800,3721,1240,2481,1240,0,1,1242,2713507,2.713507
1640,4800,5740,27552000,2,13126,3283,1,358700800,358700800,4921,1640,3281,1640,0,1,1642,2164899,2.164899
2040,4800,5740,27552000,2,16326,4083,1,392428800,392428800,6121,2040,4081,2040,0,1,2042,3269362,3.269362
2440,4800,5740,27552000,2,19526,4883,1,426156800,426156800,7321,2440,4881,2440,0,1,2442,9967115,9.967115
2840,4800,5740,27552000,2,22726,5683,1,459884800,459884800,8521,2840,5681,2840,0,1,2842,14553728,14.553728
3240,4800,5740,27552000,2,25926,6483,1,493612800,493612800,9721,3240,6481,3240,0,1,3242,10730543,10.730543
3640,4800,5740,27552000,2,29126,7283,1,527340800,527340800,10921,3640,7281,3640,0,1,3642,5748811,5.748811
4040,4800,5740,27552000,2,32326,8083,1,561068800,561068800,12121,4040,8081,4040,0,1,4042,3288938,3.288938
4440,4800,5740,27552000,2,35526,8883,1,594796800,594796800,13321,4440,8881,4440,0,1,4442,6722324,6.722324
4840,4800,5740,27552000,2,38726,9683,1,628524800,628524800,14521,4840,9681,4840,0,1,4842,5881167,5.881167
5240,4800,5740,27552000,2,41926,10483,1,662252800,662252800,15721,5240,10481,5240,0,1,5242,4887904,4.887904
5640,4800,5740,27552000,2,45126,11283,1,695980800,695980800,16921,5640,11281,5640,0,1,5642,616795,0.616795
6040,4800,5740,27552000,2,48326,12083,1,729708800,729708800,18121,6040,12081,6040,0,1,6042,19987693,19.987693
6440,4800,5740,27552000,2,51526,12883,1,763436800,763436800,19321,6440,12881,6440,0,1,6442,171475,0.171475
6840,4800,5740,27552000,2,54726,13683,1,797164800,797164800,20521,6840,13681,6840,0,1,6842,3869585,3.869585
55,5055,5465,27625575,2,446,113,1,225633400,225633400,166,55,111,55,0,1,57,21203,0.021203
455,5055,5465,27625575,2,3646,913,1,259297400,259297400,1366,455,911,455,0,1,457,203962,0.203962
855,5055,5465,27625575,2,6846,1713,1,292961400,292961400,2566,855,1711,855,0,1,857,102434,0.102434
1255,5055,5465,27625575,2,10046,2513,1,326625400,326625400,3766,1255,2511,1255,0,1,1257,123504,0.123504
1655,5055,5465,27625575,2,13246,3313,1,360289400,360289400,4966,1655,3311,1655,0,1,1657,338102,0.338102
2055,5055,5465,27625575,2,16446,4113,1,393953400,393953400,6166,2055,4111,2055,0,1,2057,294866,0.294866
2455,5055,5465,27625575,2,19646,4913,1,427617400,427617400,7366,2455,4911,2455,0,1,2457,114806,0.114806
2855,5055,5465,27625575,2,22846,5713,1,461281400,461281400,8566,2855,5711,2855,0,1,2857,123485,0.123485
3255,5055,5465,27625575,2,26046,6513,1,494945400,494945400,9766,3255,6511,3255,0,1,3257,92909,0.092909
3655,5055,5465,27625575,2,29246,7313,1,528609400,528609400,10966,3655,7311,3655,0,1,3657,1854323,1.854323
4055,5055,5465,27625575,2,32446,8113,1,562273400,562273400,12166,4055,8111,4055,0,1,4057,462318,0.462318
4455,5055,5465,27625575,2,35646,8913,1,595937400,595937400,13366,4455,8911,4455,0,1,4457,637784,0.637784
4855,5055,5465,27625575,2,38846,9713,1,629601400,629601400,14566,4855,9711,4855,0,1,4857,1263814,1.263814
5255,5055,5465,27625575,2,42046,10513,1,663265400,663265400,15766,5255,10511,5255,0,1,5257,2691546,2.691546
5655,5055,5465,27625575,2,45246,11313,1,696929400,696929400,16966,5655,11311,5655,0,1,5657,2427564,2.427564
6055,5055,5465,27625575,2,48446,12113,1,730593400,730593400,18166,6055,12111,6055,0,1,6057,1515300,1.5153
6455,5055,5465,27625575,2,51646,12913,1,764257400,764257400,19366,6455,12911,6455,0,1,6457,435161,0.435161
6855,5055,5465,27625575,2,54846,13713,1,797921400,797921400,20566,6855,13711,6855,0,1,6857,4290271,4.290271
55,4555,6065,27626075,2,446,113,1,225681400,225681400,166,55,111,55,0,1,57,562341,0.562341
455,4555,6065,27626075,2,3646,913,1,259665400,259665400,1366,455,911,455,0,1,457,1144557,1.144557
855,4555,6065,27626075,2,6846,1713,1,293649400,293649400,2566,855,1711,855,0,1,857,1627105,1.627105
1255,4555,6065,27626075,2,10046,2513,1,327633400,327633400,3766,1255,2511,1255,0,1,1257,4345771,4.345771
1655,4555,6065,27626075,2,13246,3313,1,361617400,361617400,4966,1655,3311,1655,0,1,1657,8251148,8.251148
2055,4555,6065,27626075,2,16446,4113,1,395601400,395601400,6166,2055,4111,2055,0,1,2057,5320331,5.320331
2455,4555,6065,27626075,2,19646,4913,1,429585400,429585400,7366,2455,4911,2455,0,1,2457,3325004,3.325004
2855,4555,6065,27626075,2,22846,5713,1,463569400,463569400,8566,2855,5711,2855,0,1,2857,5387479,5.387479
3255,4555,6065,27626075,2,26046,6513,1,497553400,497553400,9766,3255,6511,3255,0,1,3257,15259,0.015259
3655,4555,6065,27626075,2,29246,7313,1,531537400,531537400,10966,3655,7311,3655,0,1,3657,3432940,3.43294
4055,4555,6065,27626075,2,32446,8113,1,565521400,565521400,12166,4055,8111,4055,0,1,4057,11320724,11.320724
4455,4555,6065,27626075,2,35646,8913,1,599505400,599505400,13366,4455,8911,4455,0,1,4457,822470,0.82247
4855,4555,6065,27626075,2,38846,9713,1,633489400,633489400,14566,4855,9711,4855,0,1,4857,2171387,2.171387
5255,4555,6065,27626075,2,42046,10513,1,667473400,667473400,15766,5255,10511,5255,0,1,5257,2533188,2.533188
5655,4555,6065,27626075,2,45246,11313,1,701457400,701457400,16966,5655,11311,5655,0,1,5657,406611,0.406611
6055,4555,6065,27626075,2,48446,12113,1,735441400,735441400,18166,6055,12111,6055,0,1,6057,5217110,5.21711
6455,4555,6065,27626075,2,51646,12913,1,769425400,769425400,19366,6455,12911,6455,0,1,6457,3575959,3.575959
6855,4555,6065,27626075,2,54846,13713,1,803409400,803409400,20566,6855,13711,6855,0,1,6857,2734079,2.734079
55,6055,4565,27641075,2,446,113,1,225801400,225801400,166,55,111,55,0,1,57,551413,0.551413
455,6055,4565,27641075,2,3646,913,1,259785400,259785400,1366,455,911,455,0,1,457,127303,0.127303
855,6055,4565,27641075,2,6846,1713,1,293769400,293769400,2566,855,1711,855,0,1,857,936560,0.93656
1255,6055,4565,27641075,2,10046,2513,1,327753400,327753400,3766,1255,2511,1255,0,1,1257,6718051,6.718051
1655,6055,4565,27641075,2,13246,3313,1,361737400,361737400,4966,1655,3311,1655,0,1,1657,443690,0.44369
2055,6055,4565,27641075,2,16446,4113,1,395721400,395721400,6166,2055,4111,2055,0,1,2057,6319173,6.319173
2455,6055,4565,27641075,2,19646,4913,1,429705400,429705400,7366,2455,4911,2455,0,1,2457,281581,0.281581
2855,6055,4565,27641075,2,22846,5713,1,463689400,463689400,8566,2855,5711,2855,0,1,2857,1578133,1.578133
3255,6055,4565,27641075,2,26046,6513,1,497673400,497673400,9766,3255,6511,3255,0,1,3257,2151451,2.151451
3655,6055,4565,27641075,2,29246,7313,1,531657400,531657400,10966,3655,7311,3655,0,1,3657,892108,0.892108
4055,6055,4565,27641075,2,32446,8113,1,565641400,565641400,12166,4055,8111,4055,0,1,4057,276173,0.276173
4455,6055,4565,27641075,2,35646,8913,1,599625400,599625400,13366,4455,8911,4455,0,1,4457,8879697,8.879697
4855,6055,4565,27641075,2,38846,9713,1,633609400,633609400,14566,4855,9711,4855,0,1,4857,4589701,4.589701
5255,6055,4565,27641075,2,42046,10513,1,667593400,667593400,15766,5255,10511,5255,0,1,5257,832213,0.832213
5655,6055,4565,27641075,2,45246,11313,1,701577400,701577400,16966,5655,11311,5655,0,1,5657,5608090,5.60809
6055,6055,4565,27641075,2,48446,12113,1,735561400,735561400,18166,6055,12111,6055,0,1,6057,678299,0.678299
6455,6055,4565,27641075,2,51646,12913,1,769545400,769545400,19366,6455,12911,6455,0,1,6457,1625234,1.625234
6855,6055,4565,27641075,2,54846,13713,1,803529400,803529400,20566,6855,13711,6855,0,1,6857,11650299,11.650299
39,4993,5541,27666213,2,318,81,1,224616312,224616312,118,39,79,39,0,1,41,487025,0.487025
539,4993,5541,27666213,2,4318,1081,1,266752312,266752312,1618,539,1079,539,0,1,541,3001184,3.001184
1039,4993,5541,27666213,2,8318,2081,1,308888312,308888312,3118,1039,2079,1039,0,1,1041,5543944,5.543944
1539,4993,5541,27666213,2,12318,3081,1,351024312,351024312,4618,1539,3079,1539,0,1,1541,4115350,4.11535
2039,4993,5541,27666213,2,16318,4081,1,393160312,393160312,6118,2039,4079,2039,0,1,2041,10709084,10.709084
2539,4993,5541,27666213,2,20318,5081,1,435296312,435296312,7618,2539,5079,2539,0,1,2541,13259784,13.259784
3039,4993,5541,27666213,2,24318,6081,1,477432312,477432312,9118,3039,6079,3039,0,1,3041,1186745,1.186745
3539,4993,5541,27666213,2,28318,7081,1,519568312,519568312,10618,3539,7079,3539,0,1,3541,5151570,5.15157
4039,4993,5541,27666213,2,32318,8081,1,561704312,561704312,12118,4039,8079,4039,0,1,4041,2329601,2.329601
4539,4993,5541,27666213,2,36318,9081,1,603840312,603840312,13618,4539,9079,4539,0,1,4541,8706168,8.706168
5039,4993,5541,27666213,2,40318,10081,1,645976312,645976312,15118,5039,10079,5039,0,1,5041,19403646,19.403646
5539,4993,5541,27666213,2,44318,11081,1,688112312,688112312,16618,5539,11079,5539,0,1,5541,4328373,4.328373
6039,4993,5541,27666213,2,48318,12081,1,730248312,730248312,18118,6039,12079,6039,0,1,6041,31236884,31.236884
6539,4993,5541,27666213,2,52318,13081,1,772384312,772384312,19618,6539,13079,6539,0,1,6541,33873264,33.873264
7039,4993,5541,27666213,2,56318,14081,1,814520312,814520312,21118,7039,14079,7039,0,1,7041,36456781,36.456781
39,6093,4541,27668313,2,318,81,1,224664312,224664312,118,39,79,39,0,1,41,71581,0.071581
539,6093,4541,27668313,2,4318,1081,1,267200312,267200312,1618,539,1079,539,0,1,541,14144,0.014144
1039,6093,4541,27668313,2,8318,2081,1,309736312,309736312,3118,1039,2079,1039,0,1,1041,144860,0.14486
1539,6093,4541,27668313,2,12318,3081,1,352272312,352272312,4618,1539,3079,1539,0,1,1541,592879,0.592879
2039,6093,4541,27668313,2,16318,4081,1,394808312,394808312,6118,2039,4079,2039,0,1,2041,152357,0.152357
2539,6093,4541,27668313,2,20318,5081,1,437344312,437344312,7618,2539,5079,2539,0,1,2541,3577345,3.577345
3039,6093,4541,27668313,2,24318,6081,1,479880312,479880312,9118,3039,6079,3039,0,1,3041,1605923,1.605923
3539,6093,4541,27668313,2,28318,7081,1,522416312,522416312,10618,3539,7079,3539,0,1,3541,1218882,1.218882
4039,6093,4541,27668313,2,32318,8081,1,564952312,564952312,12118,4039,8079,4039,0,1,4041,2242837,2.242837
4539,6093,4541,27668313,2,36318,9081,1,607488312,607488312,13618,4539,9079,4539,0,1,4541,49880,0.04988
5039,6093,4541,27668313,2,40318,10081,1,650024312,650024312,15118,5039,10079,5039,0,1,5041,1478174,1.478174
5539,6093,4541,27668313,2,44318,11081,1,692560312,692560312,16618,5539,11079,5539,0,1,5541,758671,0.758671
6039,6093,4541,27668313,2,48318,12081,1,735096312,735096312,18118,6039,12079,6039,0,1,6041,6261441,6.261441
6539,6093,4541,27668313,2,52318,13081,1,777632312,777632312,19618,6539,13079,6539,0,1,6541,4009821,4.009821
7039,6093,4541,27668313,2,56318,14081,1,820168312,820168312,21118,7039,14079,7039,0,1,7041,4715284,4.715284
35,6090,4545,27679050,2,286,73,1,224410200,224410200,106,35,71,35,0,1,37,235948,0.235948
535,6090,4545,27679050,2,4286,1073,1,266950200,266950200,1606,535,1071,535,0,1,537,2456816,2.456816
1035,6090,4545,27679050,2,8286,2073,1,309490200,309490200,3106,1035,2071,1035,0,1,1037,3079239,3.079239
1535,6090,4545,27679050,2,12286,3073,1,352030200,352030200,4606,1535,3071,1535,0,1,1537,1575554,1.575554
55,4805,5765,27700825,2,446,113,1,226257400,226257400,166,55,111,55,0,1,57,235366,0.235366
455,4805,5765,27700825,2,3646,913,1,260081400,260081400,1366,455,911,455,0,1,457,2575836,2.575836
855,4805,5765,27700825,2,6846,1713,1,293905400,293905400,2566,855,1711,855,0,1,857,1129336,1.129336
1255,4805,5765,27700825,2,10046,2513,1,327729400,327729400,3766,1255,2511,1255,0,1,1257,3098312,3.098312
1655,4805,5765,27700825,2,13246,3313,1,361553400,361553400,4966,1655,3311,1655,0,1,1657,2223925,2.223925
2055,4805,5765,27700825,2,16446,4113,1,395377400,395377400,6166,2055,4111,2055,0,1,2057,1994663,1.994663
2455,4805,5765,27700825,2,19646,4913,1,429201400,429201400,7366,2455,4911,2455,0,1,2457,115426,0.115426
2855,4805,5765,27700825,2,22846,5713,1,463025400,463025400,8566,2855,5711,2855,0,1,2857,1899943,1.899943
3255,4805,5765,27700825,2,26046,6513,1,496849400,496849400,9766,3255,6511,3255,0,1,3257,1939609,1.939609
3655,4805,5765,27700825,2,29246,7313,1,530673400,530673400,10966,3655,7311,3655,0,1,3657,1167770,1.16777
4055,4805,5765,27700825,2,32446,8113,1,564497400,564497400,12166,4055,8111,4055,0,1,4057,1185028,1.185028
4455,4805,5765,27700825,2,35646,8913,1,598321400,598321400,13366,4455,8911,4455,0,1,4457,1241960,1.24196
4855,4805,5765,27700825,2,38846,9713,1,632145400,632145400,14566,4855,9711,4855,0,1,4857,9061118,9.061118
5255,4805,5765,27700825,2,42046,10513,1,665969400,665969400,15766,5255,10511,5255,0,1,5257,471777,0.471777
5655,4805,5765,27700825,2,45246,11313,1,699793400,699793400,16966,5655,11311,5655,0,1,5657,6487494,6.487494
6055,4805,5765,27700825,2,48446,12113,1,733617400,733617400,18166,6055,12111,6055,0,1,6057,11880821,11.880821
6455,4805,5765,27700825,2,51646,12913,1,767441400,767441400,19366,6455,12911,6455,0,1,6457,1582648,1.582648
6855,4805,5765,27700825,2,54846,13713,1,801265400,801265400,20566,6855,13711,6855,0,1,6857,16246823,16.246823
35,5500,5045,27747500,2,286,73,1,224932600,224932600,106,35,71,35,0,1,37,18182,0.018182
535,5500,5045,27747500,2,4286,1073,1,267112600,267112600,1606,535,1071,535,0,1,537,554957,0.554957
1035,5500,5045,27747500,2,8286,2073,1,309292600,309292600,3106,1035,2071,1035,0,1,1037,2496567,2.496567
1535,5500,5045,27747500,2,12286,3073,1,351472600,351472600,4606,1535,3071,1535,0,1,1537,1039562,1.039562
2035,5500,5045,27747500,2,16286,4073,1,393652600,393652600,6106,2035,4071,2035,0,1,2037,316814,0.316814
2535,5500,5045,27747500,2,20286,5073,1,435832600,435832600,7606,2535,5071,2535,0,1,2537,1368880,1.36888
3035,5500,5045,27747500,2,24286,6073,1,478012600,478012600,9106,3035,6071,3035,0,1,3037,88072,0.088072
3535,5500,5045,27747500,2,28286,7073,1,520192600,520192600,10606,3535,7071,3535,0,1,3537,3761442,3.761442
4035,5500,5045,27747500,2,32286,8073,1,562372600,562372600,12106,4035,8071,4035,0,1,4037,912044,0.912044
4535,5500,5045,27747500,2,36286,9073,1,604552600,604552600,13606,4535,9071,4535,0,1,4537,19963927,19.963927
5035,5500,5045,27747500,2,40286,10073,1,646732600,646732600,15106,5035,10071,5035,0,1,5037,3598842,3.598842
5535,5500,5045,27747500,2,44286,11073,1,688912600,688912600,16606,5535,11071,5535,0,1,5537,1229769,1.229769
6035,5500,5045,27747500,2,48286,12073,1,731092600,731092600,18106,6035,12071,6035,0,1,6037,612405,0.612405
6535,5500,5045,27747500,2,52286,13073,1,773272600,773272600,19606,6535,13071,6535,0,1,6537,2945331,2.945331
7035,5500,5045,27747500,2,56286,14073,1,815452600,815452600,21106,7035,14071,7035,0,1,7037,26851434,26.851434
40,6550,4240,27772000,2,326,83,1,225628800,225628800,121,40,81,40,0,1,42,22881,0.022881
440,6550,4240,27772000,2,3526,883,1,260156800,260156800,1321,440,881,440,0,1,442,50905,0.050905
840,6550,4240,27772000,2,6726,1683,1,294684800,294684800,2521,840,1681,840,0,1,842,356381,0.356381
1240,6550,4240,27772000,2,9926,2483,1,329212800,329212800,3721,1240,2481,1240,0,1,1242,153729,0.153729
1640,6550,4240,27772000,2,13126,3283,1,363740800,363740800,4921,1640,3281,1640,0,1,1642,155577,0.155577
2040,6550,4240,27772000,2,16326,4083,1,398268800,398268800,6121,2040,4081,2040,0,1,2042,359524,0.359524
2440,6550,4240,27772000,2,19526,4883,1,432796800,432796800,7321,2440,4881,2440,0,1,2442,226470,0.22647
2840,6550,4240,27772000,2,22726,5683,1,467324800,467324800,8521,2840,5681,2840,0,1,2842,142471,0.142471
3240,6550,4240,27772000,2,25926,6483,1,501852800,501852800,9721,3240,6481,3240,0,1,3242,231721,0.231721
3640,6550,4240,27772000,2,29126,7283,1,536380800,536380800,10921,3640,7281,3640,0,1,3642,309612,0.309612
4040,6550,4240,27772000,2,32326,8083,1,570908800,570908800,12121,4040,8081,4040,0,1,4042,2543514,2.543514
4440,6550,4240,27772000,2,35526,8883,1,605436800,605436800,13321,4440,8881,4440,0,1,4442,167057,0.167057
4840,6550,4240,27772000,2,38726,9683,1,639964800,639964800,14521,4840,9681,4840,0,1,4842,665213,0.665213
5240,6550,4240,27772000,2,41926,10483,1,674492800,674492800,15721,5240,10481,5240,0,1,5242,952464,0.952464
5640,6550,4240,27772000,2,45126,11283,1,709020800,709020800,16921,5640,11281,5640,0,1,5642,143239,0.143239
6040,6550,4240,27772000,2,48326,12083,1,743548800,743548800,18121,6040,12081,6040,0,1,6042,695736,0.695736
6440,6550,4240,27772000,2,51526,12883,1,778076800,778076800,19321,6440,12881,6440,0,1,6442,1087323,1.087323
6840,6550,4240,27772000,2,54726,13683,1,812604800,812604800,20521,6840,13681,6840,0,1,6842,2133647,2.133647
40,7050,3940,27777000,2,326,83,1,225732800,225732800,121,40,81,40,0,1,42,487786,0.487786
440,7050,3940,27777000,2,3526,883,1,260900800,260900800,1321,440,881,440,0,1,442,2577411,2.577411
840,7050,3940,27777000,2,6726,1683,1,296068800,296068800,2521,840,1681,840,0,1,842,1508766,1.508766
1240,7050,3940,27777000,2,9926,2483,1,331236800,331236800,3721,1240,2481,1240,0,1,1242,2516428,2.516428
1640,7050,3940,27777000,2,13126,3283,1,366404800,366404800,4921,1640,3281,1640,0,1,1642,2523141,2.523141
2040,7050,3940,27777000,2,16326,4083,1,401572800,401572800,6121,2040,4081,2040,0,1,2042,6749090,6.74909
2440,7050,3940,27777000,2,19526,4883,1,436740800,436740800,7321,2440,4881,2440,0,1,2442,6484128,6.484128
2840,7050,3940,27777000,2,22726,5683,1,471908800,471908800,8521,2840,5681,2840,0,1,2842,3378685,3.378685
3240,7050,3940,27777000,2,25926,6483,1,507076800,507076800,9721,3240,6481,3240,0,1,3242,1278653,1.278653
3640,7050,3940,27777000,2,29126,7283,1,542244800,542244800,10921,3640,7281,3640,0,1,3642,2953808,2.953808
4040,7050,3940,27777000,2,32326,8083,1,577412800,577412800,12121,4040,8081,4040,0,1,4042,10639871,10.639871
4440,7050,3940,27777000,2,35526,8883,1,612580800,612580800,13321,4440,8881,4440,0,1,4442,5801194,5.801194
4840,7050,3940,27777000,2,38726,9683,1,647748800,647748800,14521,4840,9681,4840,0,1,4842,12444816,12.444816
5240,7050,3940,27777000,2,41926,10483,1,682916800,682916800,15721,5240,10481,5240,0,1,5242,26261226,26.261226
5640,7050,3940,27777000,2,45126,11283,1,718084800,718084800,16921,5640,11281,5640,0,1,5642,30547494,30.547494
6040,7050,3940,27777000,2,48326,12083,1,753252800,753252800,18121,6040,12081,6040,0,1,6042,32798908,32.798908
6440,7050,3940,27777000,2,51526,12883,1,788420800,788420800,19321,6440,12881,6440,0,1,6442,34994251,34.994251
6840,7050,3940,27777000,2,54726,13683,1,823588800,823588800,20521,6840,13681,6840,0,1,6842,37088419,37.088419
44,5003,5555,27791665,2,358,91,1,226049736,226049736,133,44,89,44,0,1,46,518958,0.518958
544,5003,5555,27791665,2,4358,1091,1,268281736,268281736,1633,544,1089,544,0,1,546,1257374,1.257374
1044,5003,5555,27791665,2,8358,2091,1,310513736,310513736,3133,1044,2089,1044,0,1,1046,1375792,1.375792
1544,5003,5555,27791665,2,12358,3091,1,352745736,352745736,4633,1544,3089,1544,0,1,1546,4515428,4.515428
2044,5003,5555,27791665,2,16358,4091,1,394977736,394977736,6133,2044,4089,2044,0,1,2046,3789155,3.789155
2544,5003,5555,27791665,2,20358,5091,1,437209736,437209736,7633,2544,5089,2544,0,1,2546,12811804,12.811804
3044,5003,5555,27791665,2,24358,6091,1,479441736,479441736,9133,3044,6089,3044,0,1,3046,389302,0.389302
3544,5003,5555,27791665,2,28358,7091,1,521673736,521673736,10633,3544,7089,3544,0,1,3546,6722544,6.722544
4044,5003,5555,27791665,2,32358,8091,1,563905736,563905736,12133,4044,8089,4044,0,1,4046,5586007,5.586007
4544,5003,5555,27791665,2,36358,9091,1,606137736,606137736,13633,4544,9089,4544,0,1,4546,7493310,7.49331
5044,5003,5555,27791665,2,40358,10091,1,648369736,648369736,15133,5044,10089,5044,0,1,5046,6060439,6.060439
5544,5003,5555,27791665,2,44358,11091,1,690601736,690601736,16633,5544,11089,5544,0,1,5546,25479004,25.479004
6044,5003,5555,27791665,2,48358,12091,1,732833736,732833736,18133,6044,12089,6044,0,1,6046,31537053,31.537053
6544,5003,5555,27791665,2,52358,13091,1,775065736,775065736,19633,6544,13089,6544,0,1,6546,34082342,34.082342
7044,5003,5555,27791665,2,56358,14091,1,817297736,817297736,21133,7044,14089,7044,0,1,7046,36660986,36.660986
44,6103,4555,27799165,2,358,91,1,226144936,226144936,133,44,89,44,0,1,46,75628,0.075628
544,6103,4555,27799165,2,4358,1091,1,268776936,268776936,1633,544,1089,544,0,1,546,121123,0.121123
1044,6103,4555,27799165,2,8358,2091,1,311408936,311408936,3133,1044,2089,1044,0,1,1046,427558,0.427558
1544,6103,4555,27799165,2,12358,3091,1,354040936,354040936,4633,1544,3089,1544,0,1,1546,359531,0.359531
2044,6103,4555,27799165,2,16358,4091,1,396672936,396672936,6133,2044,4089,2044,0,1,2046,304288,0.304288
2544,6103,4555,27799165,2,20358,5091,1,439304936,439304936,7633,2544,5089,2544,0,1,2546,689798,0.689798
3044,6103,4555,27799165,2,24358,6091,1,481936936,481936936,9133,3044,6089,3044,0,1,3046,42488,0.042488
3544,6103,4555,27799165,2,28358,7091,1,524568936,524568936,10633,3544,7089,3544,0,1,3546,1325794,1.325794
4044,6103,4555,27799165,2,32358,8091,1,567200936,567200936,12133,4044,8089,4044,0,1,4046,1132444,1.132444
4544,6103,4555,27799165,2,36358,9091,1,609832936,609832936,13633,4544,9089,4544,0,1,4546,646388,0.646388
5044,6103,4555,27799165,2,40358,10091,1,652464936,652464936,15133,5044,10089,5044,0,1,5046,1006386,1.006386
5544,6103,4555,27799165,2,44358,11091,1,695096936,695096936,16633,5544,11089,5544,0,1,5546,337621,0.337621
6044,6103,4555,27799165,2,48358,12091,1,737728936,737728936,18133,6044,12089,6044,0,1,6046,3134054,3.134054
6544,6103,4555,27799165,2,52358,13091,1,780360936,780360936,19633,6544,13089,6544,0,1,6546,1418498,1.418498
7044,6103,4555,27799165,2,56358,14091,1,822992936,822992936,21133,7044,14089,7044,0,1,7046,3752527,3.752527
39,5543,5041,27942263,2,318,81,1,226840312,226840312,118,39,79,39,0,1,41,75100,0.0751
539,5543,5041,27942263,2,4318,1081,1,269176312,269176312,1618,539,1079,539,0,1,541,236307,0.236307
1039,5543,5041,27942263,2,8318,2081,1,311512312,311512312,3118,1039,2079,1039,0,1,1041,27570,0.02757
1539,5543,5041,27942263,2,12318,3081,1,353848312,353848312,4618,1539,3079,1539,0,1,1541,140619,0.140619
2039,5543,5041,27942263,2,16318,4081,1,396184312,396184312,6118,2039,4079,2039,0,1,2041,739630,0.73963
2539,5543,5041,27942263,2,20318,5081,1,438520312,438520312,7618,2539,5079,2539,0,1,2541,544437,0.544437
3039,5543,5041,27942263,2,24318,6081,1,480856312,480856312,9118,3039,6079,3039,0,1,3041,1346566,1.346566
3539,5543,5041,27942263,2,28318,7081,1,523192312,523192312,10618,3539,7079,3539,0,1,3541,303783,0.303783
4039,5543,5041,27942263,2,32318,8081,1,565528312,565528312,12118,4039,8079,4039,0,1,4041,2170043,2.170043
4539,5543,5041,27942263,2,36318,9081,1,607864312,607864312,13618,4539,9079,4539,0,1,4541,3094984,3.094984
5039,5543,5041,27942263,2,40318,10081,1,650200312,650200312,15118,5039,10079,5039,0,1,5041,988593,0.988593
5539,5543,5041,27942263,2,44318,11081,1,692536312,692536312,16618,5539,11079,5539,0,1,5541,1870913,1.870913
6039,5543,5041,27942263,2,48318,12081,1,734872312,734872312,18118,6039,12079,6039,0,1,6041,6333602,6.333602
6539,5543,5041,27942263,2,52318,13081,1,777208312,777208312,19618,6539,13079,6539,0,1,6541,278712,0.278712
7039,5543,5041,27942263,2,56318,14081,1,819544312,819544312,21118,7039,14079,7039,0,1,7041,1278466,1.278466
35,5540,5045,27949300,2,286,73,1,226558200,226558200,106,35,71,35,0,1,37,266458,0.266458
535,5540,5045,27949300,2,4286,1073,1,268898200,268898200,1606,535,1071,535,0,1,537,540222,0.540222
1035,5540,5045,27949300,2,8286,2073,1,311238200,311238200,3106,1035,2071,1035,0,1,1037,2686541,2.686541
1535,5540,5045,27949300,2,12286,3073,1,353578200,353578200,4606,1535,3071,1535,0,1,1537,5374956,5.374956
55,6555,4265,27957075,2,446,113,1,228417400,228417400,166,55,111,55,0,1,57,91014,0.091014
455,6555,4265,27957075,2,3646,913,1,263041400,263041400,1366,455,911,455,0,1,457,56505,0.056505
855,6555,4265,27957075,2,6846,1713,1,297665400,297665400,2566,855,1711,855,0,1,857,312682,0.312682
1255,6555,4265,27957075,2,10046,2513,1,332289400,332289400,3766,1255,2511,1255,0,1,1257,143156,0.143156
1655,6555,4265,27957075,2,13246,3313,1,366913400,366913400,4966,1655,3311,1655,0,1,1657,708893,0.708893
2055,6555,4265,27957075,2,16446,4113,1,401537400,401537400,6166,2055,4111,2055,0,1,2057,492363,0.492363
2455,6555,4265,27957075,2,19646,4913,1,436161400,436161400,7366,2455,4911,2455,0,1,2457,2405692,2.405692
2855,6555,4265,27957075,2,22846,5713,1,470785400,470785400,8566,2855,5711,2855,0,1,2857,293717,0.293717
3255,6555,4265,27957075,2,26046,6513,1,505409400,505409400,9766,3255,6511,3255,0,1,3257,136882,0.136882
3655,6555,4265,27957075,2,29246,7313,1,540033400,540033400,10966,3655,7311,3655,0,1,3657,1305070,1.30507
4055,6555,4265,27957075,2,32446,8113,1,574657400,574657400,12166,4055,8111,4055,0,1,4057,354310,0.35431
4455,6555,4265,27957075,2,35646,8913,1,609281400,609281400,13366,4455,8911,4455,0,1,4457,51470,0.05147
4855,6555,4265,27957075,2,38846,9713,1,643905400,643905400,14566,4855,9711,4855,0,1,4857,227100,0.2271
5255,6555,4265,27957075,2,42046,10513,1,678529400,678529400,15766,5255,10511,5255,0,1,5257,3631328,3.631328
5655,6555,4265,27957075,2,45246,11313,1,713153400,713153400,16966,5655,11311,5655,0,1,5657,1643849,1.643849
6055,6555,4265,27957075,2,48446,12113,1,747777400,747777400,18166,6055,12111,6055,0,1,6057,430446,0.430446
6455,6555,4265,27957075,2,51646,12913,1,782401400,782401400,19366,6455,12911,6455,0,1,6457,4273744,4.273744
6855,6555,4265,27957075,2,54846,13713,1,817025400,817025400,20566,6855,13711,6855,0,1,6857,539070,0.53907
55,7055,3965,27973075,2,446,113,1,228633400,228633400,166,55,111,55,0,1,57,563093,0.563093
455,7055,3965,27973075,2,3646,913,1,263897400,263897400,1366,455,911,455,0,1,457,2675531,2.675531
855,7055,3965,27973075,2,6846,1713,1,299161400,299161400,2566,855,1711,855,0,1,857,4810717,4.810717
1255,7055,3965,27973075,2,10046,2513,1,334425400,334425400,3766,1255,2511,1255,0,1,1257,6952652,6.952652
1655,7055,3965,27973075,2,13246,3313,1,369689400,369689400,4966,1655,3311,1655,0,1,1657,13499,0.013499
2055,7055,3965,27973075,2,16446,4113,1,404953400,404953400,6166,2055,4111,2055,0,1,2057,865026,0.865026
2455,7055,3965,27973075,2,19646,4913,1,440217400,440217400,7366,2455,4911,2455,0,1,2457,13461899,13.461899
2855,7055,3965,27973075,2,22846,5713,1,475481400,475481400,8566,2855,5711,2855,0,1,2857,13884602,13.884602
3255,7055,3965,27973075,2,26046,6513,1,510745400,510745400,9766,3255,6511,3255,0,1,3257,3019930,3.01993
3655,7055,3965,27973075,2,29246,7313,1,546009400,546009400,10966,3655,7311,3655,0,1,3657,13081627,13.081627
4055,7055,3965,27973075,2,32446,8113,1,581273400,581273400,12166,4055,8111,4055,0,1,4057,8164399,8.164399
4455,7055,3965,27973075,2,35646,8913,1,616537400,616537400,13366,4455,8911,4455,0,1,4457,2717729,2.717729
4855,7055,3965,27973075,2,38846,9713,1,651801400,651801400,14566,4855,9711,4855,0,1,4857,927302,0.927302
5255,7055,3965,27973075,2,42046,10513,1,687065400,687065400,15766,5255,10511,5255,0,1,5257,13731679,13.731679
5655,7055,3965,27973075,2,45246,11313,1,722329400,722329400,16966,5655,11311,5655,0,1,5657,30770205,30.770205
6055,7055,3965,27973075,2,48446,12113,1,757593400,757593400,18166,6055,12111,6055,0,1,6057,33328326,33.328326
6455,7055,3965,27973075,2,51646,12913,1,792857400,792857400,19366,6455,12911,6455,0,1,6457,35508464,35.508464
6855,7055,3965,27973075,2,54846,13713,1,828121400,828121400,20566,6855,13711,6855,0,1,6857,37759302,37.759302
44,5553,5055,28070415,2,358,91,1,228297336,228297336,133,44,89,44,0,1,46,71658,0.071658
544,5553,5055,28070415,2,4358,1091,1,270729336,270729336,1633,544,1089,544,0,1,546,36121,0.036121
1044,5553,5055,28070415,2,8358,2091,1,313161336,313161336,3133,1044,2089,1044,0,1,1046,319409,0.319409
1544,5553,5055,28070415,2,12358,3091,1,355593336,355593336,4633,1544,3089,1544,0,1,1546,33021,0.033021
2044,5553,5055,28070415,2,16358,4091,1,398025336,398025336,6133,2044,4089,2044,0,1,2046,219289,0.219289
2544,5553,5055,28070415,2,20358,5091,1,440457336,440457336,7633,2544,5089,2544,0,1,2546,370618,0.370618
3044,5553,5055,28070415,2,24358,6091,1,482889336,482889336,9133,3044,6089,3044,0,1,3046,4215753,4.215753
3544,5553,5055,28070415,2,28358,7091,1,525321336,525321336,10633,3544,7089,3544,0,1,3546,498837,0.498837
4044,5553,5055,28070415,2,32358,8091,1,567753336,567753336,12133,4044,8089,4044,0,1,4046,243360,0.24336
4544,5553,5055,28070415,2,36358,9091,1,610185336,610185336,13633,4544,9089,4544,0,1,4546,7318338,7.318338
5044,5553,5055,28070415,2,40358,10091,1,652617336,652617336,15133,5044,10089,5044,0,1,5046,1530048,1.530048
5544,5553,5055,28070415,2,44358,11091,1,695049336,695049336,16633,5544,11089,5544,0,1,5546,1473220,1.47322
6044,5553,5055,28070415,2,48358,12091,1,737481336,737481336,18133,6044,12089,6044,0,1,6046,3548365,3.548365
6544,5553,5055,28070415,2,52358,13091,1,779913336,779913336,19633,6544,13089,6544,0,1,6546,246240,0.24624
7044,5553,5055,28070415,2,56358,14091,1,822345336,822345336,21133,7044,14089,7044,0,1,7046,7837229,7.837229
40,5800,4840,28072000,2,326,83,1,227980800,227980800,121,40,81,40,0,1,42,19616,0.019616
440,5800,4840,28072000,2,3526,883,1,262028800,262028800,1321,440,881,440,0,1,442,23039,0.023039
840,5800,4840,28072000,2,6726,1683,1,296076800,296076800,2521,840,1681,840,0,1,842,25473,0.025473
1240,5800,4840,28072000,2,9926,2483,1,330124800,330124800,3721,1240,2481,1240,0,1,1242,806054,0.806054
1640,5800,4840,28072000,2,13126,3283,1,364172800,364172800,4921,1640,3281,1640,0,1,1642,84129,0.084129
2040,5800,4840,28072000,2,16326,4083,1,398220800,398220800,6121,2040,4081,2040,0,1,2042,196386,0.196386
2440,5800,4840,28072000,2,19526,4883,1,432268800,432268800,7321,2440,4881,2440,0,1,2442,536579,0.536579
2840,5800,4840,28072000,2,22726,5683,1,466316800,466316800,8521,2840,5681,2840,0,1,2842,434078,0.434078
3240,5800,4840,28072000,2,25926,6483,1,500364800,500364800,9721,3240,6481,3240,0,1,3242,1271032,1.271032
3640,5800,4840,28072000,2,29126,7283,1,534412800,534412800,10921,3640,7281,3640,0,1,3642,16989,0.016989
4040,5800,4840,28072000,2,32326,8083,1,568460800,568460800,12121,4040,8081,4040,0,1,4042,359137,0.359137
4440,5800,4840,28072000,2,35526,8883,1,602508800,602508800,13321,4440,8881,4440,0,1,4442,154779,0.154779
4840,5800,4840,28072000,2,38726,9683,1,636556800,636556800,14521,4840,9681,4840,0,1,4842,1439132,1.439132
5240,5800,4840,28072000,2,41926,10483,1,670604800,670604800,15721,5240,10481,5240,0,1,5242,2739670,2.73967
5640,5800,4840,28072000,2,45126,11283,1,704652800,704652800,16921,5640,11281,5640,0,1,5642,2696765,2.696765
6040,5800,4840,28072000,2,48326,12083,1,738700800,738700800,18121,6040,12081,6040,0,1,6042,932192,0.932192
6440,5800,4840,28072000,2,51526,12883,1,772748800,772748800,19321,6440,12881,6440,0,1,6442,1143534,1.143534
6840,5800,4840,28072000,2,54726,13683,1,806796800,806796800,20521,6840,13681,6840,0,1,6842,212514,0.212514
40,4050,6940,28107000,2,326,83,1,228372800,228372800,121,40,81,40,0,1,42,20479,0.020479
440,4050,6940,28107000,2,3526,883,1,263540800,263540800,1321,440,881,440,0,1,442,173241,0.173241
840,4050,6940,28107000,2,6726,1683,1,298708800,298708800,2521,840,1681,840,0,1,842,199597,0.199597
1240,4050,6940,28107000,2,9926,2483,1,333876800,333876800,3721,1240,2481,1240,0,1,1242,27231,0.027231
1640,4050,6940,28107000,2,13126,3283,1,369044800,369044800,4921,1640,3281,1640,0,1,1642,1322045,1.322045
2040,4050,6940,28107000,2,16326,4083,1,404212800,404212800,6121,2040,4081,2040,0,1,2042,129702,0.129702
2440,4050,6940,28107000,2,19526,4883,1,439380800,439380800,7321,2440,4881,2440,0,1,2442,1120939,1.120939
2840,4050,6940,28107000,2,22726,5683,1,474548800,474548800,8521,2840,5681,2840,0,1,2842,149677,0.149677
3240,4050,6940,28107000,2,25926,6483,1,509716800,509716800,9721,3240,6481,3240,0,1,3242,34792,0.034792
3640,4050,6940,28107000,2,29126,7283,1,544884800,544884800,10921,3640,7281,3640,0,1,3642,808524,0.808524
4040,4050,6940,28107000,2,32326,8083,1,580052800,580052800,12121,4040,8081,4040,0,1,4042,1868215,1.868215
4440,4050,6940,28107000,2,35526,8883,1,615220800,615220800,13321,4440,8881,4440,0,1,4442,1540778,1.540778
4840,4050,6940,28107000,2,38726,9683,1,650388800,650388800,14521,4840,9681,4840,0,1,4842,253002,0.253002
5240,4050,6940,28107000,2,41926,10483,1,685556800,685556800,15721,5240,10481,5240,0,1,5242,954286,0.954286
5640,4050,6940,28107000,2,45126,11283,1,720724800,720724800,16921,5640,11281,5640,0,1,5642,2391836,2.391836
6040,4050,6940,28107000,2,48326,12083,1,755892800,755892800,18121,6040,12081,6040,0,1,6042,414247,0.414247
6440,4050,6940,28107000,2,51526,12883,1,791060800,791060800,19321,6440,12881,6440,0,1,6442,301856,0.301856
6840,4050,6940,28107000,2,54726,13683,1,826228800,826228800,20521,6840,13681,6840,0,1,6842,77058,0.077058
55,5805,4865,28241325,2,446,113,1,230625400,230625400,166,55,111,55,0,1,57,92735,0.092735
455,5805,4865,28241325,2,3646,913,1,264769400,264769400,1366,455,911,455,0,1,457,70776,0.070776
855,5805,4865,28241325,2,6846,1713,1,298913400,298913400,2566,855,1711,855,0,1,857,369412,0.369412
1255,5805,4865,28241325,2,10046,2513,1,333057400,333057400,3766,1255,2511,1255,0,1,1257,335517,0.335517
1655,5805,4865,28241325,2,13246,3313,1,367201400,367201400,4966,1655,3311,1655,0,1,1657,268264,0.268264
2055,5805,4865,28241325,2,16446,4113,1,401345400,401345400,6166,2055,4111,2055,0,1,2057,44684,0.044684
2455,5805,4865,28241325,2,19646,4913,1,435489400,435489400,7366,2455,4911,2455,0,1,2457,1728260,1.72826
2855,5805,4865,28241325,2,22846,5713,1,469633400,469633400,8566,2855,5711,2855,0,1,2857,244578,0.244578
3255,5805,4865,28241325,2,26046,6513,1,503777400,503777400,9766,3255,6511,3255,0,1,3257,781470,0.78147
3655,5805,4865,28241325,2,29246,7313,1,537921400,537921400,10966,3655,7311,3655,0,1,3657,1234240,1.23424
4055,5805,4865,28241325,2,32446,8113,1,572065400,572065400,12166,4055,8111,4055,0,1,4057,163651,0.163651
4455,5805,4865,28241325,2,35646,8913,1,606209400,606209400,13366,4455,8911,4455,0,1,4457,2664242,2.664242
4855,5805,4865,28241325,2,38846,9713,1,640353400,640353400,14566,4855,9711,4855,0,1,4857,1516002,1.516002
5255,5805,4865,28241325,2,42046,10513,1,674497400,674497400,15766,5255,10511,5255,0,1,5257,452982,0.452982
5655,5805,4865,28241325,2,45246,11313,1,708641400,708641400,16966,5655,11311,5655,0,1,5657,1598077,1.598077
6055,5805,4865,28241325,2,48446,12113,1,742785400,742785400,18166,6055,12111,6055,0,1,6057,621798,0.621798
6455,5805,4865,28241325,2,51646,12913,1,776929400,776929400,19366,6455,12911,6455,0,1,6457,1726183,1.726183
6855,5805,4865,28241325,2,54846,13713,1,811073400,811073400,20566,6855,13711,6855,0,1,6857,959618,0.959618
55,4055,6965,28243075,2,446,113,1,230793400,230793400,166,55,111,55,0,1,57,37771,0.037771
455,4055,6965,28243075,2,3646,913,1,266057400,266057400,1366,455,911,455,0,1,457,78584,0.078584
855,4055,6965,28243075,2,6846,1713,1,301321400,301321400,2566,855,1711,855,0,1,857,172770,0.17277
1255,4055,6965,28243075,2,10046,2513,1,336585400,336585400,3766,1255,2511,1255,0,1,1257,22936,0.022936
1655,4055,6965,28243075,2,13246,3313,1,371849400,371849400,4966,1655,3311,1655,0,1,1657,122921,0.122921
2055,4055,6965,28243075,2,16446,4113,1,407113400,407113400,6166,2055,4111,2055,0,1,2057,257635,0.257635
2455,4055,6965,28243075,2,19646,4913,1,442377400,442377400,7366,2455,4911,2455,0,1,2457,1041938,1.041938
2855,4055,6965,28243075,2,22846,5713,1,477641400,477641400,8566,2855,5711,2855,0,1,2857,160871,0.160871
3255,4055,6965,28243075,2,26046,6513,1,512905400,512905400,9766,3255,6511,3255,0,1,3257,118689,0.118689
3655,4055,6965,28243075,2,29246,7313,1,548169400,548169400,10966,3655,7311,3655,0,1,3657,465799,0.465799
4055,4055,6965,28243075,2,32446,8113,1,583433400,583433400,12166,4055,8111,4055,0,1,4057,845558,0.845558
4455,4055,6965,28243075,2,35646,8913,1,618697400,618697400,13366,4455,8911,4455,0,1,4457,2714105,2.714105
4855,4055,6965,28243075,2,38846,9713,1,653961400,653961400,14566,4855,9711,4855,0,1,4857,838258,0.838258
5255,4055,6965,28243075,2,42046,10513,1,689225400,689225400,15766,5255,10511,5255,0,1,5257,3842362,3.842362
5655,4055,6965,28243075,2,45246,11313,1,724489400,724489400,16966,5655,11311,5655,0,1,5657,199809,0.199809
6055,4055,6965,28243075,2,48446,12113,1,759753400,759753400,18166,6055,12111,6055,0,1,6057,1043291,1.043291
6455,4055,6965,28243075,2,51646,12913,1,795017400,795017400,19366,6455,12911,6455,0,1,6457,668256,0.668256
6855,4055,6965,28243075,2,54846,13713,1,830281400,830281400,20566,6855,13711,6855,0,1,6857,829201,0.829201
40,5550,5140,28527000,2,326,83,1,231636800,231636800,121,40,81,40,0,1,42,524155,0.524155
440,5550,5140,28527000,2,3526,883,1,265844800,265844800,1321,440,881,440,0,1,442,2323387,2.323387
840,5550,5140,28527000,2,6726,1683,1,300052800,300052800,2521,840,1681,840,0,1,842,3951980,3.95198
1240,5550,5140,28527000,2,9926,2483,1,334260800,334260800,3721,1240,2481,1240,0,1,1242,2683114,2.683114
1640,5550,5140,28527000,2,13126,3283,1,368468800,368468800,4921,1640,3281,1640,0,1,1642,3148405,3.148405
2040,5550,5140,28527000,2,16326,4083,1,402676800,402676800,6121,2040,4081,2040,0,1,2042,8905634,8.905634
2440,5550,5140,28527000,2,19526,4883,1,436884800,436884800,7321,2440,4881,2440,0,1,2442,2692388,2.692388
2840,5550,5140,28527000,2,22726,5683,1,471092800,471092800,8521,2840,5681,2840,0,1,2842,5002726,5.002726
3240,5550,5140,28527000,2,25926,6483,1,505300800,505300800,9721,3240,6481,3240,0,1,3242,961233,0.961233
3640,5550,5140,28527000,2,29126,7283,1,539508800,539508800,10921,3640,7281,3640,0,1,3642,7055860,7.05586
4040,5550,5140,28527000,2,32326,8083,1,573716800,573716800,12121,4040,8081,4040,0,1,4042,1514776,1.514776
4440,5550,5140,28527000,2,35526,8883,1,607924800,607924800,13321,4440,8881,4440,0,1,4442,347089,0.347089
4840,5550,5140,28527000,2,38726,9683,1,642132800,642132800,14521,4840,9681,4840,0,1,4842,3670641,3.670641
5240,5550,5140,28527000,2,41926,10483,1,676340800,676340800,15721,5240,10481,5240,0,1,5242,195345,0.195345
5640,5550,5140,28527000,2,45126,11283,1,710548800,710548800,16921,5640,11281,5640,0,1,5642,4982185,4.982185
6040,5550,5140,28527000,2,48326,12083,1,744756800,744756800,18121,6040,12081,6040,0,1,6042,332680,0.33268
6440,5550,5140,28527000,2,51526,12883,1,778964800,778964800,19321,6440,12881,6440,0,1,6442,1577033,1.577033
6840,5550,5140,28527000,2,54726,13683,1,813172800,813172800,20521,6840,13681,6840,0,1,6842,2953841,2.953841
40,4300,6640,28552000,2,326,83,1,231916800,231916800,121,40,81,40,0,1,42,510890,0.51089
440,4300,6640,28552000,2,3526,883,1,266924800,266924800,1321,440,881,440,0,1,442,514405,0.514405
840,4300,6640,28552000,2,6726,1683,1,301932800,301932800,2521,840,1681,840,0,1,842,81715,0.081715
1240,4300,6640,28552000,2,9926,2483,1,336940800,336940800,3721,1240,2481,1240,0,1,1242,659751,0.659751
1640,4300,6640,28552000,2,13126,3283,1,371948800,371948800,4921,1640,3281,1640,0,1,1642,1169732,1.169732
2040,4300,6640,28552000,2,16326,4083,1,406956800,406956800,6121,2040,4081,2040,0,1,2042,561995,0.561995
2440,4300,6640,28552000,2,19526,4883,1,441964800,441964800,7321,2440,4881,2440,0,1,2442,1775542,1.775542
2840,4300,6640,28552000,2,22726,5683,1,476972800,476972800,8521,2840,5681,2840,0,1,2842,833446,0.833446
3240,4300,6640,28552000,2,25926,6483,1,511980800,511980800,9721,3240,6481,3240,0,1,3242,1552205,1.552205
3640,4300,6640,28552000,2,29126,7283,1,546988800,546988800,10921,3640,7281,3640,0,1,3642,1193534,1.193534
4040,4300,6640,28552000,2,32326,8083,1,581996800,581996800,12121,4040,8081,4040,0,1,4042,681523,0.681523
4440,4300,6640,28552000,2,35526,8883,1,617004800,617004800,13321,4440,8881,4440,0,1,4442,1099833,1.099833
4840,4300,6640,28552000,2,38726,9683,1,652012800,652012800,14521,4840,9681,4840,0,1,4842,957930,0.95793
5240,4300,6640,28552000,2,41926,10483,1,687020800,687020800,15721,5240,10481,5240,0,1,5242,138775,0.138775
5640,4300,6640,28552000,2,45126,11283,1,722028800,722028800,16921,5640,11281,5640,0,1,5642,3415740,3.41574
6040,4300,6640,28552000,2,48326,12083,1,757036800,757036800,18121,6040,12081,6040,0,1,6042,771811,0.771811
6440,4300,6640,28552000,2,51526,12883,1,792044800,792044800,19321,6440,12881,6440,0,1,6442,1025353,1.025353
6840,4300,6640,28552000,2,54726,13683,1,827052800,827052800,20521,6840,13681,6840,0,1,6842,2926954,2.926954
40,6300,4540,28602000,2,326,83,1,232284800,232284800,121,40,81,40,0,1,42,531556,0.531556
440,6300,4540,28602000,2,3526,883,1,266972800,266972800,1321,440,881,440,0,1,442,2571564,2.571564
840,6300,4540,28602000,2,6726,1683,1,301660800,301660800,2521,840,1681,840,0,1,842,464820,0.46482
1240,6300,4540,28602000,2,9926,2483,1,336348800,336348800,3721,1240,2481,1240,0,1,1242,2710649,2.710649
1640,6300,4540,28602000,2,13126,3283,1,371036800,371036800,4921,1640,3281,1640,0,1,1642,563331,0.563331
2040,6300,4540,28602000,2,16326,4083,1,405724800,405724800,6121,2040,4081,2040,0,1,2042,8626806,8.626806
2440,6300,4540,28602000,2,19526,4883,1,440412800,440412800,7321,2440,4881,2440,0,1,2442,595954,0.595954
2840,6300,4540,28602000,2,22726,5683,1,475100800,475100800,8521,2840,5681,2840,0,1,2842,15143072,15.143072
3240,6300,4540,28602000,2,25926,6483,1,509788800,509788800,9721,3240,6481,3240,0,1,3242,2993711,2.993711
3640,6300,4540,28602000,2,29126,7283,1,544476800,544476800,10921,3640,7281,3640,0,1,3642,584732,0.584732
4040,6300,4540,28602000,2,32326,8083,1,579164800,579164800,12121,4040,8081,4040,0,1,4042,2866633,2.866633
4440,6300,4540,28602000,2,35526,8883,1,613852800,613852800,13321,4440,8881,4440,0,1,4442,738124,0.738124
4840,6300,4540,28602000,2,38726,9683,1,648540800,648540800,14521,4840,9681,4840,0,1,4842,1417660,1.41766
5240,6300,4540,28602000,2,41926,10483,1,683228800,683228800,15721,5240,10481,5240,0,1,5242,1322980,1.32298
5640,6300,4540,28602000,2,45126,11283,1,717916800,717916800,16921,5640,11281,5640,0,1,5642,3172183,3.172183
6040,6300,4540,28602000,2,48326,12083,1,752604800,752604800,18121,6040,12081,6040,0,1,6042,5305904,5.305904
6440,6300,4540,28602000,2,51526,12883,1,787292800,787292800,19321,6440,12881,6440,0,1,6442,13400487,13.400487
6840,6300,4540,28602000,2,54726,13683,1,821980800,821980800,20521,6840,13681,6840,0,1,6842,1331483,1.331483
55,5555,5165,28691575,2,446,113,1,234249400,234249400,166,55,111,55,0,1,57,596317,0.596317
455,5555,5165,28691575,2,3646,913,1,268553400,268553400,1366,455,911,455,0,1,457,1373025,1.373025
855,5555,5165,28691575,2,6846,1713,1,302857400,302857400,2566,855,1711,855,0,1,857,2308878,2.308878
1255,5555,5165,28691575,2,10046,2513,1,337161400,337161400,3766,1255,2511,1255,0,1,1257,1605578,1.605578
1655,5555,5165,28691575,2,13246,3313,1,371465400,371465400,4966,1655,3311,1655,0,1,1657,338399,0.338399
2055,5555,5165,28691575,2,16446,4113,1,405769400,405769400,6166,2055,4111,2055,0,1,2057,2507445,2.507445
2455,5555,5165,28691575,2,19646,4913,1,440073400,440073400,7366,2455,4911,2455,0,1,2457,7116652,7.116652
2855,5555,5165,28691575,2,22846,5713,1,474377400,474377400,8566,2855,5711,2855,0,1,2857,6126058,6.126058
3255,5555,5165,28691575,2,26046,6513,1,508681400,508681400,9766,3255,6511,3255,0,1,3257,7212942,7.212942
3655,5555,5165,28691575,2,29246,7313,1,542985400,542985400,10966,3655,7311,3655,0,1,3657,5089334,5.089334
4055,5555,5165,28691575,2,32446,8113,1,577289400,577289400,12166,4055,8111,4055,0,1,4057,1052219,1.052219
4455,5555,5165,28691575,2,35646,8913,1,611593400,611593400,13366,4455,8911,4455,0,1,4457,5374213,5.374213
4855,5555,5165,28691575,2,38846,9713,1,645897400,645897400,14566,4855,9711,4855,0,1,4857,1952632,1.952632
5255,5555,5165,28691575,2,42046,10513,1,680201400,680201400,15766,5255,10511,5255,0,1,5257,1650400,1.6504
5655,5555,5165,28691575,2,45246,11313,1,714505400,714505400,16966,5655,11311,5655,0,1,5657,595123,0.595123
6055,5555,5165,28691575,2,48446,12113,1,748809400,748809400,18166,6055,12111,6055,0,1,6057,127811,0.127811
6455,5555,5165,28691575,2,51646,12913,1,783113400,783113400,19366,6455,12911,6455,0,1,6457,1341639,1.341639
6855,5555,5165,28691575,2,54846,13713,1,817417400,817417400,20566,6855,13711,6855,0,1,6857,1296929,1.296929
55,4305,6665,28692825,2,446,113,1,234369400,234369400,166,55,111,55,0,1,57,256600,0.2566
455,4305,6665,28692825,2,3646,913,1,269473400,269473400,1366,455,911,455,0,1,457,288263,0.288263
855,4305,6665,28692825,2,6846,1713,1,304577400,304577400,2566,855,1711,855,0,1,857,47305,0.047305
1255,4305,6665,28692825,2,10046,2513,1,339681400,339681400,3766,1255,2511,1255,0,1,1257,911248,0.911248
1655,4305,6665,28692825,2,13246,3313,1,374785400,374785400,4966,1655,3311,1655,0,1,1657,196170,0.19617
2055,4305,6665,28692825,2,16446,4113,1,409889400,409889400,6166,2055,4111,2055,0,1,2057,1689289,1.689289
2455,4305,6665,28692825,2,19646,4913,1,444993400,444993400,7366,2455,4911,2455,0,1,2457,265848,0.265848
2855,4305,6665,28692825,2,22846,5713,1,480097400,480097400,8566,2855,5711,2855,0,1,2857,3107969,3.107969
3255,4305,6665,28692825,2,26046,6513,1,515201400,515201400,9766,3255,6511,3255,0,1,3257,800709,0.800709
3655,4305,6665,28692825,2,29246,7313,1,550305400,550305400,10966,3655,7311,3655,0,1,3657,2073766,2.073766
4055,4305,6665,28692825,2,32446,8113,1,585409400,585409400,12166,4055,8111,4055,0,1,4057,194042,0.194042
4455,4305,6665,28692825,2,35646,8913,1,620513400,620513400,13366,4455,8911,4455,0,1,4457,181291,0.181291
4855,4305,6665,28692825,2,38846,9713,1,655617400,655617400,14566,4855,9711,4855,0,1,4857,2377602,2.377602
5255,4305,6665,28692825,2,42046,10513,1,690721400,690721400,15766,5255,10511,5255,0,1,5257,1490628,1.490628
5655,4305,6665,28692825,2,45246,11313,1,725825400,725825400,16966,5655,11311,5655,0,1,5657,653926,0.653926
6055,4305,6665,28692825,2,48446,12113,1,760929400,760929400,18166,6055,12111,6055,0,1,6057,2075024,2.075024
6455,4305,6665,28692825,2,51646,12913,1,796033400,796033400,19366,6455,12911,6455,0,1,6457,1956779,1.956779
6855,4305,6665,28692825,2,54846,13713,1,831137400,831137400,20566,6855,13711,6855,0,1,6857,3117107,3.117107
55,6305,4565,28782325,2,446,113,1,235041400,235041400,166,55,111,55,0,1,57,572346,0.572346
455,6305,4565,28782325,2,3646,913,1,269825400,269825400,1366,455,911,455,0,1,457,21331,0.021331
855,6305,4565,28782325,2,6846,1713,1,304609400,304609400,2566,855,1711,855,0,1,857,1633578,1.633578
1255,6305,4565,28782325,2,10046,2513,1,339393400,339393400,3766,1255,2511,1255,0,1,1257,4792337,4.792337
1655,6305,4565,28782325,2,13246,3313,1,374177400,374177400,4966,1655,3311,1655,0,1,1657,115709,0.115709
2055,6305,4565,28782325,2,16446,4113,1,408961400,408961400,6166,2055,4111,2055,0,1,2057,11375968,11.375968
2455,6305,4565,28782325,2,19646,4913,1,443745400,443745400,7366,2455,4911,2455,0,1,2457,12052607,12.052607
2855,6305,4565,28782325,2,22846,5713,1,478529400,478529400,8566,2855,5711,2855,0,1,2857,2778751,2.778751
3255,6305,4565,28782325,2,26046,6513,1,513313400,513313400,9766,3255,6511,3255,0,1,3257,1098990,1.09899
3655,6305,4565,28782325,2,29246,7313,1,548097400,548097400,10966,3655,7311,3655,0,1,3657,8591273,8.591273
4055,6305,4565,28782325,2,32446,8113,1,582881400,582881400,12166,4055,8111,4055,0,1,4057,3785636,3.785636
4455,6305,4565,28782325,2,35646,8913,1,617665400,617665400,13366,4455,8911,4455,0,1,4457,3558443,3.558443
4855,6305,4565,28782325,2,38846,9713,1,652449400,652449400,14566,4855,9711,4855,0,1,4857,2907131,2.907131
5255,6305,4565,28782325,2,42046,10513,1,687233400,687233400,15766,5255,10511,5255,0,1,5257,3358880,3.35888
5655,6305,4565,28782325,2,45246,11313,1,722017400,722017400,16966,5655,11311,5655,0,1,5657,11101144,11.101144
6055,6305,4565,28782325,2,48446,12113,1,756801400,756801400,18166,6055,12111,6055,0,1,6057,23754849,23.754849
6455,6305,4565,28782325,2,51646,12913,1,791585400,791585400,19366,6455,12911,6455,0,1,6457,4237143,4.237143
6855,6305,4565,28782325,2,54846,13713,1,826369400,826369400,20566,6855,13711,6855,0,1,6857,545680,0.54568
35,4400,6545,28798000,2,286,73,1,233448600,233448600,106,35,71,35,0,1,37,60033,0.060033
535,4400,6545,28798000,2,4286,1073,1,277228600,277228600,1606,535,1071,535,0,1,537,97446,0.097446
1035,4400,6545,28798000,2,8286,2073,1,321008600,321008600,3106,1035,2071,1035,0,1,1037,357484,0.357484
1535,4400,6545,28798000,2,12286,3073,1,364788600,364788600,4606,1535,3071,1535,0,1,1537,2301947,2.301947
2035,4400,6545,28798000,2,16286,4073,1,408568600,408568600,6106,2035,4071,2035,0,1,2037,1065598,1.065598
2535,4400,6545,28798000,2,20286,5073,1,452348600,452348600,7606,2535,5071,2535,0,1,2537,829063,0.829063
3035,4400,6545,28798000,2,24286,6073,1,496128600,496128600,9106,3035,6071,3035,0,1,3037,3143304,3.143304
3535,4400,6545,28798000,2,28286,7073,1,539908600,539908600,10606,3535,7071,3535,0,1,3537,1824675,1.824675
4035,4400,6545,28798000,2,32286,8073,1,583688600,583688600,12106,4035,8071,4035,0,1,4037,857168,0.857168
4535,4400,6545,28798000,2,36286,9073,1,627468600,627468600,13606,4535,9071,4535,0,1,4537,5777407,5.777407
5035,4400,6545,28798000,2,40286,10073,1,671248600,671248600,15106,5035,10071,5035,0,1,5037,755853,0.755853
5535,4400,6545,28798000,2,44286,11073,1,715028600,715028600,16606,5535,11071,5535,0,1,5537,896049,0.896049
6035,4400,6545,28798000,2,48286,12073,1,758808600,758808600,18106,6035,12071,6035,0,1,6037,1835901,1.835901
6535,4400,6545,28798000,2,52286,13073,1,802588600,802588600,19606,6535,13071,6535,0,1,6537,6330780,6.33078
7035,4400,6545,28798000,2,56286,14073,1,846368600,846368600,21106,7035,14071,7035,0,1,7037,5209226,5.209226
40,5300,5440,28832000,2,326,83,1,234092800,234092800,121,40,81,40,0,1,42,506360,0.50636
440,5300,5440,28832000,2,3526,883,1,268460800,268460800,1321,440,881,440,0,1,442,2602744,2.602744
840,5300,5440,28832000,2,6726,1683,1,302828800,302828800,2521,840,1681,840,0,1,842,253162,0.253162
1240,5300,5440,28832000,2,9926,2483,1,337196800,337196800,3721,1240,2481,1240,0,1,1242,362440,0.36244
1640,5300,5440,28832000,2,13126,3283,1,371564800,371564800,4921,1640,3281,1640,0,1,1642,4733871,4.733871
2040,5300,5440,28832000,2,16326,4083,1,405932800,405932800,6121,2040,4081,2040,0,1,2042,1992893,1.992893
2440,5300,5440,28832000,2,19526,4883,1,440300800,440300800,7321,2440,4881,2440,0,1,2442,301602,0.301602
2840,5300,5440,28832000,2,22726,5683,1,474668800,474668800,8521,2840,5681,2840,0,1,2842,384133,0.384133
3240,5300,5440,28832000,2,25926,6483,1,509036800,509036800,9721,3240,6481,3240,0,1,3242,1703969,1.703969
3640,5300,5440,28832000,2,29126,7283,1,543404800,543404800,10921,3640,7281,3640,0,1,3642,762419,0.762419
40,6800,4240,28832000,2,326,83,1,234188800,234188800,121,40,81,40,0,1,42,502825,0.502825
440,6800,4240,28832000,2,3526,883,1,269516800,269516800,1321,440,881,440,0,1,442,2097329,2.097329
840,6800,4240,28832000,2,6726,1683,1,304844800,304844800,2521,840,1681,840,0,1,842,1532478,1.532478
1240,6800,4240,28832000,2,9926,2483,1,340172800,340172800,3721,1240,2481,1240,0,1,1242,31305,0.031305
4040,5300,5440,28832000,2,32326,8083,1,577772800,577772800,12121,4040,8081,4040,0,1,4042,1311514,1.311514
1640,6800,4240,28832000,2,13126,3283,1,375500800,375500800,4921,1640,3281,1640,0,1,1642,95881,0.095881
2040,6800,4240,28832000,2,16326,4083,1,410828800,410828800,6121,2040,4081,2040,0,1,2042,2107532,2.107532
4440,5300,5440,28832000,2,35526,8883,1,612140800,612140800,13321,4440,8881,4440,0,1,4442,1885661,1.885661
2440,6800,4240,28832000,2,19526,4883,1,446156800,446156800,7321,2440,4881,2440,0,1,2442,2283486,2.283486
4840,5300,5440,28832000,2,38726,9683,1,646508800,646508800,14521,4840,9681,4840,0,1,4842,577694,0.577694
2840,6800,4240,28832000,2,22726,5683,1,481484800,481484800,8521,2840,5681,2840,0,1,2842,604005,0.604005
3240,6800,4240,28832000,2,25926,6483,1,516812800,516812800,9721,3240,6481,3240,0,1,3242,319496,0.319496
5240,5300,5440,28832000,2,41926,10483,1,680876800,680876800,15721,5240,10481,5240,0,1,5242,1323984,1.323984
3640,6800,4240,28832000,2,29126,7283,1,552140800,552140800,10921,3640,7281,3640,0,1,3642,306247,0.306247
5640,5300,5440,28832000,2,45126,11283,1,715244800,715244800,16921,5640,11281,5640,0,1,5642,1243542,1.243542
4040,6800,4240,28832000,2,32326,8083,1,587468800,587468800,12121,4040,8081,4040,0,1,4042,4782662,4.782662
6040,5300,5440,28832000,2,48326,12083,1,749612800,749612800,18121,6040,12081,6040,0,1,6042,10218501,10.218501
4440,6800,4240,28832000,2,35526,8883,1,622796800,622796800,13321,4440,8881,4440,0,1,4442,3259272,3.259272
6440,5300,5440,28832000,2,51526,12883,1,783980800,783980800,19321,6440,12881,6440,0,1,6442,739666,0.739666
4840,6800,4240,28832000,2,38726,9683,1,658124800,658124800,14521,4840,9681,4840,0,1,4842,1869139,1.869139
6840,5300,5440,28832000,2,54726,13683,1,818348800,818348800,20521,6840,13681,6840,0,1,6842,1902882,1.902882
5240,6800,4240,28832000,2,41926,10483,1,693452800,693452800,15721,5240,10481,5240,0,1,5242,421174,0.421174
5640,6800,4240,28832000,2,45126,11283,1,728780800,728780800,16921,5640,11281,5640,0,1,5642,3379172,3.379172
6040,6800,4240,28832000,2,48326,12083,1,764108800,764108800,18121,6040,12081,6040,0,1,6042,4622832,4.622832
6440,6800,4240,28832000,2,51526,12883,1,799436800,799436800,19321,6440,12881,6440,0,1,6442,2571273,2.571273
6840,6800,4240,28832000,2,54726,13683,1,834764800,834764800,20521,6840,13681,6840,0,1,6842,3193692,3.193692
40,4550,6340,28847000,2,326,83,1,234260800,234260800,121,40,81,40,0,1,42,524939,0.524939
440,4550,6340,28847000,2,3526,883,1,269108800,269108800,1321,440,881,440,0,1,442,2586914,2.586914
840,4550,6340,28847000,2,6726,1683,1,303956800,303956800,2521,840,1681,840,0,1,842,1147030,1.14703
1240,4550,6340,28847000,2,9926,2483,1,338804800,338804800,3721,1240,2481,1240,0,1,1242,1274430,1.27443
1640,4550,6340,28847000,2,13126,3283,1,373652800,373652800,4921,1640,3281,1640,0,1,1642,1315852,1.315852
2040,4550,6340,28847000,2,16326,4083,1,408500800,408500800,6121,2040,4081,2040,0,1,2042,19335,0.019335
2440,4550,6340,28847000,2,19526,4883,1,443348800,443348800,7321,2440,4881,2440,0,1,2442,716072,0.716072
2840,4550,6340,28847000,2,22726,5683,1,478196800,478196800,8521,2840,5681,2840,0,1,2842,4341742,4.341742
3240,4550,6340,28847000,2,25926,6483,1,513044800,513044800,9721,3240,6481,3240,0,1,3242,5037406,5.037406
3640,4550,6340,28847000,2,29126,7283,1,547892800,547892800,10921,3640,7281,3640,0,1,3642,629657,0.629657
4040,4550,6340,28847000,2,32326,8083,1,582740800,582740800,12121,4040,8081,4040,0,1,4042,12849536,12.849536
4440,4550,6340,28847000,2,35526,8883,1,617588800,617588800,13321,4440,8881,4440,0,1,4442,2470429,2.470429
4840,4550,6340,28847000,2,38726,9683,1,652436800,652436800,14521,4840,9681,4840,0,1,4842,1417834,1.417834
5240,4550,6340,28847000,2,41926,10483,1,687284800,687284800,15721,5240,10481,5240,0,1,5242,3001402,3.001402
5640,4550,6340,28847000,2,45126,11283,1,722132800,722132800,16921,5640,11281,5640,0,1,5642,1214912,1.214912
6040,4550,6340,28847000,2,48326,12083,1,756980800,756980800,18121,6040,12081,6040,0,1,6042,44047,0.044047
6440,4550,6340,28847000,2,51526,12883,1,791828800,791828800,19321,6440,12881,6440,0,1,6442,3245397,3.245397
6840,4550,6340,28847000,2,54726,13683,1,826676800,826676800,20521,6840,13681,6840,0,1,6842,5307915,5.307915
40,5050,5740,28987000,2,326,83,1,235348800,235348800,121,40,81,40,0,1,42,20625,0.020625
440,5050,5740,28987000,2,3526,883,1,269876800,269876800,1321,440,881,440,0,1,442,71919,0.071919
840,5050,5740,28987000,2,6726,1683,1,304404800,304404800,2521,840,1681,840,0,1,842,21256,0.021256
1240,5050,5740,28987000,2,9926,2483,1,338932800,338932800,3721,1240,2481,1240,0,1,1242,26647,0.026647
1640,5050,5740,28987000,2,13126,3283,1,373460800,373460800,4921,1640,3281,1640,0,1,1642,1024857,1.024857
2040,5050,5740,28987000,2,16326,4083,1,407988800,407988800,6121,2040,4081,2040,0,1,2042,1131008,1.131008
2440,5050,5740,28987000,2,19526,4883,1,442516800,442516800,7321,2440,4881,2440,0,1,2442,176127,0.176127
2840,5050,5740,28987000,2,22726,5683,1,477044800,477044800,8521,2840,5681,2840,0,1,2842,709746,0.709746
3240,5050,5740,28987000,2,25926,6483,1,511572800,511572800,9721,3240,6481,3240,0,1,3242,181179,0.181179
3640,5050,5740,28987000,2,29126,7283,1,546100800,546100800,10921,3640,7281,3640,0,1,3642,72100,0.0721
4040,5050,5740,28987000,2,32326,8083,1,580628800,580628800,12121,4040,8081,4040,0,1,4042,189465,0.189465
4440,5050,5740,28987000,2,35526,8883,1,615156800,615156800,13321,4440,8881,4440,0,1,4442,894251,0.894251
4840,5050,5740,28987000,2,38726,9683,1,649684800,649684800,14521,4840,9681,4840,0,1,4842,1706693,1.706693
5240,5050,5740,28987000,2,41926,10483,1,684212800,684212800,15721,5240,10481,5240,0,1,5242,1667415,1.667415
5640,5050,5740,28987000,2,45126,11283,1,718740800,718740800,16921,5640,11281,5640,0,1,5642,61624,0.061624
6040,5050,5740,28987000,2,48326,12083,1,753268800,753268800,18121,6040,12081,6040,0,1,6042,135742,0.135742
6440,5050,5740,28987000,2,51526,12883,1,787796800,787796800,19321,6440,12881,6440,0,1,6442,2418101,2.418101
6840,5050,5740,28987000,2,54726,13683,1,822324800,822324800,20521,6840,13681,6840,0,1,6842,2449894,2.449894
55,5305,5465,28991825,2,446,113,1,236673400,236673400,166,55,111,55,0,1,57,579669,0.579669
455,5305,5465,28991825,2,3646,913,1,271137400,271137400,1366,455,911,455,0,1,457,870795,0.870795
855,5305,5465,28991825,2,6846,1713,1,305601400,305601400,2566,855,1711,855,0,1,857,329669,0.329669
1255,5305,5465,28991825,2,10046,2513,1,340065400,340065400,3766,1255,2511,1255,0,1,1257,130455,0.130455
1655,5305,5465,28991825,2,13246,3313,1,374529400,374529400,4966,1655,3311,1655,0,1,1657,46296,0.046296
2055,5305,5465,28991825,2,16446,4113,1,408993400,408993400,6166,2055,4111,2055,0,1,2057,36370,0.03637
2455,5305,5465,28991825,2,19646,4913,1,443457400,443457400,7366,2455,4911,2455,0,1,2457,1729424,1.729424
2855,5305,5465,28991825,2,22846,5713,1,477921400,477921400,8566,2855,5711,2855,0,1,2857,1669485,1.669485
3255,5305,5465,28991825,2,26046,6513,1,512385400,512385400,9766,3255,6511,3255,0,1,3257,2724462,2.724462
3655,5305,5465,28991825,2,29246,7313,1,546849400,546849400,10966,3655,7311,3655,0,1,3657,1030750,1.03075
4055,5305,5465,28991825,2,32446,8113,1,581313400,581313400,12166,4055,8111,4055,0,1,4057,2610419,2.610419
4455,5305,5465,28991825,2,35646,8913,1,615777400,615777400,13366,4455,8911,4455,0,1,4457,1035640,1.03564
4855,5305,5465,28991825,2,38846,9713,1,650241400,650241400,14566,4855,9711,4855,0,1,4857,1919503,1.919503
5255,5305,5465,28991825,2,42046,10513,1,684705400,684705400,15766,5255,10511,5255,0,1,5257,568979,0.568979
5655,5305,5465,28991825,2,45246,11313,1,719169400,719169400,16966,5655,11311,5655,0,1,5657,1957447,1.957447
6055,5305,5465,28991825,2,48446,12113,1,753633400,753633400,18166,6055,12111,6055,0,1,6057,4448629,4.448629
6455,5305,5465,28991825,2,51646,12913,1,788097400,788097400,19366,6455,12911,6455,0,1,6457,4247760,4.24776
6855,5305,5465,28991825,2,54846,13713,1,822561400,822561400,20566,6855,13711,6855,0,1,6857,302065,0.302065
40,4800,6040,28992000,2,326,83,1,235404800,235404800,121,40,81,40,0,1,42,99339,0.099339
440,4800,6040,28992000,2,3526,883,1,270092800,270092800,1321,440,881,440,0,1,442,2578722,2.578722
840,4800,6040,28992000,2,6726,1683,1,304780800,304780800,2521,840,1681,840,0,1,842,155785,0.155785
1240,4800,6040,28992000,2,9926,2483,1,339468800,339468800,3721,1240,2481,1240,0,1,1242,214921,0.214921
1640,4800,6040,28992000,2,13126,3283,1,374156800,374156800,4921,1640,3281,1640,0,1,1642,2766322,2.766322
2040,4800,6040,28992000,2,16326,4083,1,408844800,408844800,6121,2040,4081,2040,0,1,2042,4622299,4.622299
2440,4800,6040,28992000,2,19526,4883,1,443532800,443532800,7321,2440,4881,2440,0,1,2442,8602527,8.602527
2840,4800,6040,28992000,2,22726,5683,1,478220800,478220800,8521,2840,5681,2840,0,1,2842,3436146,3.436146
3240,4800,6040,28992000,2,25926,6483,1,512908800,512908800,9721,3240,6481,3240,0,1,3242,3047924,3.047924
3640,4800,6040,28992000,2,29126,7283,1,547596800,547596800,10921,3640,7281,3640,0,1,3642,8468479,8.468479
4040,4800,6040,28992000,2,32326,8083,1,582284800,582284800,12121,4040,8081,4040,0,1,4042,6738070,6.73807
4440,4800,6040,28992000,2,35526,8883,1,616972800,616972800,13321,4440,8881,4440,0,1,4442,1122355,1.122355
4840,4800,6040,28992000,2,38726,9683,1,651660800,651660800,14521,4840,9681,4840,0,1,4842,7210760,7.21076
5240,4800,6040,28992000,2,41926,10483,1,686348800,686348800,15721,5240,10481,5240,0,1,5242,2259480,2.25948
5640,4800,6040,28992000,2,45126,11283,1,721036800,721036800,16921,5640,11281,5640,0,1,5642,3534699,3.534699
6040,4800,6040,28992000,2,48326,12083,1,755724800,755724800,18121,6040,12081,6040,0,1,6042,15754106,15.754106
6440,4800,6040,28992000,2,51526,12883,1,790412800,790412800,19321,6440,12881,6440,0,1,6442,1864737,1.864737
6840,4800,6040,28992000,2,54726,13683,1,825100800,825100800,20521,6840,13681,6840,0,1,6842,3045715,3.045715
55,4555,6365,28992575,2,446,113,1,236745400,236745400,166,55,111,55,0,1,57,35615,0.035615
455,4555,6365,28992575,2,3646,913,1,271689400,271689400,1366,455,911,455,0,1,457,1130336,1.130336
855,4555,6365,28992575,2,6846,1713,1,306633400,306633400,2566,855,1711,855,0,1,857,456392,0.456392
1255,4555,6365,28992575,2,10046,2513,1,341577400,341577400,3766,1255,2511,1255,0,1,1257,4960001,4.960001
1655,4555,6365,28992575,2,13246,3313,1,376521400,376521400,4966,1655,3311,1655,0,1,1657,3814306,3.814306
2055,4555,6365,28992575,2,16446,4113,1,411465400,411465400,6166,2055,4111,2055,0,1,2057,555558,0.555558
2455,4555,6365,28992575,2,19646,4913,1,446409400,446409400,7366,2455,4911,2455,0,1,2457,268673,0.268673
2855,4555,6365,28992575,2,22846,5713,1,481353400,481353400,8566,2855,5711,2855,0,1,2857,6847937,6.847937
3255,4555,6365,28992575,2,26046,6513,1,516297400,516297400,9766,3255,6511,3255,0,1,3257,514832,0.514832
3655,4555,6365,28992575,2,29246,7313,1,551241400,551241400,10966,3655,7311,3655,0,1,3657,6424814,6.424814
4055,4555,6365,28992575,2,32446,8113,1,586185400,586185400,12166,4055,8111,4055,0,1,4057,781859,0.781859
4455,4555,6365,28992575,2,35646,8913,1,621129400,621129400,13366,4455,8911,4455,0,1,4457,63618,0.063618
4855,4555,6365,28992575,2,38846,9713,1,656073400,656073400,14566,4855,9711,4855,0,1,4857,1939176,1.939176
5255,4555,6365,28992575,2,42046,10513,1,691017400,691017400,15766,5255,10511,5255,0,1,5257,309400,0.3094
5655,4555,6365,28992575,2,45246,11313,1,725961400,725961400,16966,5655,11311,5655,0,1,5657,2769630,2.76963
6055,4555,6365,28992575,2,48446,12113,1,760905400,760905400,18166,6055,12111,6055,0,1,6057,5808584,5.808584
6455,4555,6365,28992575,2,51646,12913,1,795849400,795849400,19366,6455,12911,6455,0,1,6457,3786841,3.786841
6855,4555,6365,28992575,2,54846,13713,1,830793400,830793400,20566,6855,13711,6855,0,1,6857,1747301,1.747301
55,6805,4265,29023325,2,446,113,1,237057400,237057400,166,55,111,55,0,1,57,586482,0.586482
455,6805,4265,29023325,2,3646,913,1,272481400,272481400,1366,455,911,455,0,1,457,47238,0.047238
855,6805,4265,29023325,2,6846,1713,1,307905400,307905400,2566,855,1711,855,0,1,857,2399418,2.399418
1255,6805,4265,29023325,2,10046,2513,1,343329400,343329400,3766,1255,2511,1255,0,1,1257,1118600,1.1186
1655,6805,4265,29023325,2,13246,3313,1,378753400,378753400,4966,1655,3311,1655,0,1,1657,187567,0.187567
2055,6805,4265,29023325,2,16446,4113,1,414177400,414177400,6166,2055,4111,2055,0,1,2057,2261650,2.26165
2455,6805,4265,29023325,2,19646,4913,1,449601400,449601400,7366,2455,4911,2455,0,1,2457,6677254,6.677254
2855,6805,4265,29023325,2,22846,5713,1,485025400,485025400,8566,2855,5711,2855,0,1,2857,264233,0.264233
3255,6805,4265,29023325,2,26046,6513,1,520449400,520449400,9766,3255,6511,3255,0,1,3257,5264335,5.264335
3655,6805,4265,29023325,2,29246,7313,1,555873400,555873400,10966,3655,7311,3655,0,1,3657,274110,0.27411
4055,6805,4265,29023325,2,32446,8113,1,591297400,591297400,12166,4055,8111,4055,0,1,4057,113225,0.113225
4455,6805,4265,29023325,2,35646,8913,1,626721400,626721400,13366,4455,8911,4455,0,1,4457,2066328,2.066328
4855,6805,4265,29023325,2,38846,9713,1,662145400,662145400,14566,4855,9711,4855,0,1,4857,2386120,2.38612
5255,6805,4265,29023325,2,42046,10513,1,697569400,697569400,15766,5255,10511,5255,0,1,5257,229789,0.229789
5655,6805,4265,29023325,2,45246,11313,1,732993400,732993400,16966,5655,11311,5655,0,1,5657,972167,0.972167
6055,6805,4265,29023325,2,48446,12113,1,768417400,768417400,18166,6055,12111,6055,0,1,6057,6511849,6.511849
6455,6805,4265,29023325,2,51646,12913,1,803841400,803841400,19366,6455,12911,6455,0,1,6457,3877571,3.877571
6855,6805,4265,29023325,2,54846,13713,1,839265400,839265400,20566,6855,13711,6855,0,1,6857,1444880,1.44488
35,4440,6545,29059800,2,286,73,1,235554200,235554200,106,35,71,35,0,1,37,517272,0.517272
535,4440,6545,29059800,2,4286,1073,1,279494200,279494200,1606,535,1071,535,0,1,537,3129726,3.129726
1035,4440,6545,29059800,2,8286,2073,1,323434200,323434200,3106,1035,2071,1035,0,1,1037,5844754,5.844754
1535,4440,6545,29059800,2,12286,3073,1,367374200,367374200,4606,1535,3071,1535,0,1,1537,8502863,8.502863
2035,4440,6545,29059800,2,16286,4073,1,411314200,411314200,6106,2035,4071,2035,0,1,2037,11204714,11.204714
39,4443,6541,29061663,2,318,81,1,235920312,235920312,118,39,79,39,0,1,41,40497,0.040497
539,4443,6541,29061663,2,4318,1081,1,279856312,279856312,1618,539,1079,539,0,1,541,106919,0.106919
1039,4443,6541,29061663,2,8318,2081,1,323792312,323792312,3118,1039,2079,1039,0,1,1041,323440,0.32344
1539,4443,6541,29061663,2,12318,3081,1,367728312,367728312,4618,1539,3079,1539,0,1,1541,485948,0.485948
2039,4443,6541,29061663,2,16318,4081,1,411664312,411664312,6118,2039,4079,2039,0,1,2041,885004,0.885004
2539,4443,6541,29061663,2,20318,5081,1,455600312,455600312,7618,2539,5079,2539,0,1,2541,221106,0.221106
3039,4443,6541,29061663,2,24318,6081,1,499536312,499536312,9118,3039,6079,3039,0,1,3041,1297335,1.297335
3539,4443,6541,29061663,2,28318,7081,1,543472312,543472312,10618,3539,7079,3539,0,1,3541,451796,0.451796
4039,4443,6541,29061663,2,32318,8081,1,587408312,587408312,12118,4039,8079,4039,0,1,4041,3032331,3.032331
4539,4443,6541,29061663,2,36318,9081,1,631344312,631344312,13618,4539,9079,4539,0,1,4541,1409977,1.409977
5039,4443,6541,29061663,2,40318,10081,1,675280312,675280312,15118,5039,10079,5039,0,1,5041,482253,0.482253
5539,4443,6541,29061663,2,44318,11081,1,719216312,719216312,16618,5539,11079,5539,0,1,5541,794016,0.794016
6039,4443,6541,29061663,2,48318,12081,1,763152312,763152312,18118,6039,12079,6039,0,1,6041,554721,0.554721
6539,4443,6541,29061663,2,52318,13081,1,807088312,807088312,19618,6539,13079,6539,0,1,6541,4343063,4.343063
7039,4443,6541,29061663,2,56318,14081,1,851024312,851024312,21118,7039,14079,7039,0,1,7041,4489027,4.489027
55,5055,5765,29142075,2,446,113,1,237897400,237897400,166,55,111,55,0,1,57,22170,0.02217
455,5055,5765,29142075,2,3646,913,1,272521400,272521400,1366,455,911,455,0,1,457,103802,0.103802
855,5055,5765,29142075,2,6846,1713,1,307145400,307145400,2566,855,1711,855,0,1,857,268612,0.268612
1255,5055,5765,29142075,2,10046,2513,1,341769400,341769400,3766,1255,2511,1255,0,1,1257,708824,0.708824
1655,5055,5765,29142075,2,13246,3313,1,376393400,376393400,4966,1655,3311,1655,0,1,1657,1921985,1.921985
2055,5055,5765,29142075,2,16446,4113,1,411017400,411017400,6166,2055,4111,2055,0,1,2057,377938,0.377938
2455,5055,5765,29142075,2,19646,4913,1,445641400,445641400,7366,2455,4911,2455,0,1,2457,289879,0.289879
2855,5055,5765,29142075,2,22846,5713,1,480265400,480265400,8566,2855,5711,2855,0,1,2857,669169,0.669169
3255,5055,5765,29142075,2,26046,6513,1,514889400,514889400,9766,3255,6511,3255,0,1,3257,159483,0.159483
3655,5055,5765,29142075,2,29246,7313,1,549513400,549513400,10966,3655,7311,3655,0,1,3657,497506,0.497506
4055,5055,5765,29142075,2,32446,8113,1,584137400,584137400,12166,4055,8111,4055,0,1,4057,625239,0.625239
4455,5055,5765,29142075,2,35646,8913,1,618761400,618761400,13366,4455,8911,4455,0,1,4457,1362352,1.362352
4855,5055,5765,29142075,2,38846,9713,1,653385400,653385400,14566,4855,9711,4855,0,1,4857,284463,0.284463
5255,5055,5765,29142075,2,42046,10513,1,688009400,688009400,15766,5255,10511,5255,0,1,5257,2244984,2.244984
5655,5055,5765,29142075,2,45246,11313,1,722633400,722633400,16966,5655,11311,5655,0,1,5657,396293,0.396293
6055,5055,5765,29142075,2,48446,12113,1,757257400,757257400,18166,6055,12111,6055,0,1,6057,2638848,2.638848
6455,5055,5765,29142075,2,51646,12913,1,791881400,791881400,19366,6455,12911,6455,0,1,6457,50709,0.050709
6855,5055,5765,29142075,2,54846,13713,1,826505400,826505400,20566,6855,13711,6855,0,1,6857,1414128,1.414128
55,4805,6065,29142325,2,446,113,1,237921400,237921400,166,55,111,55,0,1,57,576582,0.576582
455,4805,6065,29142325,2,3646,913,1,272705400,272705400,1366,455,911,455,0,1,457,601937,0.601937
855,4805,6065,29142325,2,6846,1713,1,307489400,307489400,2566,855,1711,855,0,1,857,4838398,4.838398
1255,4805,6065,29142325,2,10046,2513,1,342273400,342273400,3766,1255,2511,1255,0,1,1257,2027743,2.027743
1655,4805,6065,29142325,2,13246,3313,1,377057400,377057400,4966,1655,3311,1655,0,1,1657,4813788,4.813788
2055,4805,6065,29142325,2,16446,4113,1,411841400,411841400,6166,2055,4111,2055,0,1,2057,5820237,5.820237
2455,4805,6065,29142325,2,19646,4913,1,446625400,446625400,7366,2455,4911,2455,0,1,2457,3046507,3.046507
2855,4805,6065,29142325,2,22846,5713,1,481409400,481409400,8566,2855,5711,2855,0,1,2857,781953,0.781953
3255,4805,6065,29142325,2,26046,6513,1,516193400,516193400,9766,3255,6511,3255,0,1,3257,1372799,1.372799
3655,4805,6065,29142325,2,29246,7313,1,550977400,550977400,10966,3655,7311,3655,0,1,3657,788783,0.788783
4055,4805,6065,29142325,2,32446,8113,1,585761400,585761400,12166,4055,8111,4055,0,1,4057,513425,0.513425
4455,4805,6065,29142325,2,35646,8913,1,620545400,620545400,13366,4455,8911,4455,0,1,4457,2663916,2.663916
4855,4805,6065,29142325,2,38846,9713,1,655329400,655329400,14566,4855,9711,4855,0,1,4857,1745662,1.745662
5255,4805,6065,29142325,2,42046,10513,1,690113400,690113400,15766,5255,10511,5255,0,1,5257,5108957,5.108957
5655,4805,6065,29142325,2,45246,11313,1,724897400,724897400,16966,5655,11311,5655,0,1,5657,1697437,1.697437
6055,4805,6065,29142325,2,48446,12113,1,759681400,759681400,18166,6055,12111,6055,0,1,6057,12674295,12.674295
6455,4805,6065,29142325,2,51646,12913,1,794465400,794465400,19366,6455,12911,6455,0,1,6457,1799514,1.799514
6855,4805,6065,29142325,2,54846,13713,1,829249400,829249400,20566,6855,13711,6855,0,1,6857,114921,0.114921
44,4453,6555,29189415,2,358,91,1,237390136,237390136,133,44,89,44,0,1,46,87982,0.087982
544,4453,6555,29189415,2,4358,1091,1,281422136,281422136,1633,544,1089,544,0,1,546,325013,0.325013
1044,4453,6555,29189415,2,8358,2091,1,325454136,325454136,3133,1044,2089,1044,0,1,1046,42711,0.042711
1544,4453,6555,29189415,2,12358,3091,1,369486136,369486136,4633,1544,3089,1544,0,1,1546,68034,0.068034
2044,4453,6555,29189415,2,16358,4091,1,413518136,413518136,6133,2044,4089,2044,0,1,2046,94927,0.094927
2544,4453,6555,29189415,2,20358,5091,1,457550136,457550136,7633,2544,5089,2544,0,1,2546,1376309,1.376309
3044,4453,6555,29189415,2,24358,6091,1,501582136,501582136,9133,3044,6089,3044,0,1,3046,140462,0.140462
3544,4453,6555,29189415,2,28358,7091,1,545614136,545614136,10633,3544,7089,3544,0,1,3546,1010307,1.010307
4044,4453,6555,29189415,2,32358,8091,1,589646136,589646136,12133,4044,8089,4044,0,1,4046,159475,0.159475
4544,4453,6555,29189415,2,36358,9091,1,633678136,633678136,13633,4544,9089,4544,0,1,4546,153928,0.153928
5044,4453,6555,29189415,2,40358,10091,1,677710136,677710136,15133,5044,10089,5044,0,1,5046,1729170,1.72917
5544,4453,6555,29189415,2,44358,11091,1,721742136,721742136,16633,5544,11089,5544,0,1,5546,3785957,3.785957
6044,4453,6555,29189415,2,48358,12091,1,765774136,765774136,18133,6044,12089,6044,0,1,6046,106457,0.106457
6544,4453,6555,29189415,2,52358,13091,1,809806136,809806136,19633,6544,13089,6544,0,1,6546,3898028,3.898028
7044,4453,6555,29189415,2,56358,14091,1,853838136,853838136,21133,7044,14089,7044,0,1,7046,890200,0.8902
40,6050,4840,29282000,2,326,83,1,237740800,237740800,121,40,81,40,0,1,42,513888,0.513888
440,6050,4840,29282000,2,3526,883,1,272588800,272588800,1321,440,881,440,0,1,442,967362,0.967362
840,6050,4840,29282000,2,6726,1683,1,307436800,307436800,2521,840,1681,840,0,1,842,4713802,4.713802
1240,6050,4840,29282000,2,9926,2483,1,342284800,342284800,3721,1240,2481,1240,0,1,1242,2061393,2.061393
1640,6050,4840,29282000,2,13126,3283,1,377132800,377132800,4921,1640,3281,1640,0,1,1642,2682048,2.682048
2040,6050,4840,29282000,2,16326,4083,1,411980800,411980800,6121,2040,4081,2040,0,1,2042,3599826,3.599826
2440,6050,4840,29282000,2,19526,4883,1,446828800,446828800,7321,2440,4881,2440,0,1,2442,4808983,4.808983
2840,6050,4840,29282000,2,22726,5683,1,481676800,481676800,8521,2840,5681,2840,0,1,2842,3260724,3.260724
3240,6050,4840,29282000,2,25926,6483,1,516524800,516524800,9721,3240,6481,3240,0,1,3242,419199,0.419199
3640,6050,4840,29282000,2,29126,7283,1,551372800,551372800,10921,3640,7281,3640,0,1,3642,1612065,1.612065
4040,6050,4840,29282000,2,32326,8083,1,586220800,586220800,12121,4040,8081,4040,0,1,4042,1587470,1.58747
4440,6050,4840,29282000,2,35526,8883,1,621068800,621068800,13321,4440,8881,4440,0,1,4442,1754199,1.754199
4840,6050,4840,29282000,2,38726,9683,1,655916800,655916800,14521,4840,9681,4840,0,1,4842,316954,0.316954
5240,6050,4840,29282000,2,41926,10483,1,690764800,690764800,15721,5240,10481,5240,0,1,5242,1172762,1.172762
5640,6050,4840,29282000,2,45126,11283,1,725612800,725612800,16921,5640,11281,5640,0,1,5642,1421634,1.421634
6040,6050,4840,29282000,2,48326,12083,1,760460800,760460800,18121,6040,12081,6040,0,1,6042,935096,0.935096
6440,6050,4840,29282000,2,51526,12883,1,795308800,795308800,19321,6440,12881,6440,0,1,6442,840360,0.84036
6840,6050,4840,29282000,2,54726,13683,1,830156800,830156800,20521,6840,13681,6840,0,1,6842,475747,0.475747
55,6055,4865,29457575,2,446,113,1,240465400,240465400,166,55,111,55,0,1,57,589893,0.589893
455,6055,4865,29457575,2,3646,913,1,275409400,275409400,1366,455,911,455,0,1,457,2748909,2.748909
855,6055,4865,29457575,2,6846,1713,1,310353400,310353400,2566,855,1711,855,0,1,857,4159296,4.159296
1255,6055,4865,29457575,2,10046,2513,1,345297400,345297400,3766,1255,2511,1255,0,1,1257,75133,0.075133
1655,6055,4865,29457575,2,13246,3313,1,380241400,380241400,4966,1655,3311,1655,0,1,1657,2746663,2.746663
2055,6055,4865,29457575,2,16446,4113,1,415185400,415185400,6166,2055,4111,2055,0,1,2057,836304,0.836304
2455,6055,4865,29457575,2,19646,4913,1,450129400,450129400,7366,2455,4911,2455,0,1,2457,83917,0.083917
2855,6055,4865,29457575,2,22846,5713,1,485073400,485073400,8566,2855,5711,2855,0,1,2857,171283,0.171283
3255,6055,4865,29457575,2,26046,6513,1,520017400,520017400,9766,3255,6511,3255,0,1,3257,1181450,1.18145
3655,6055,4865,29457575,2,29246,7313,1,554961400,554961400,10966,3655,7311,3655,0,1,3657,451668,0.451668
4055,6055,4865,29457575,2,32446,8113,1,589905400,589905400,12166,4055,8111,4055,0,1,4057,695895,0.695895
4455,6055,4865,29457575,2,35646,8913,1,624849400,624849400,13366,4455,8911,4455,0,1,4457,1785368,1.785368
4855,6055,4865,29457575,2,38846,9713,1,659793400,659793400,14566,4855,9711,4855,0,1,4857,4582572,4.582572
5255,6055,4865,29457575,2,42046,10513,1,694737400,694737400,15766,5255,10511,5255,0,1,5257,1603342,1.603342
5655,6055,4865,29457575,2,45246,11313,1,729681400,729681400,16966,5655,11311,5655,0,1,5657,5239855,5.239855
6055,6055,4865,29457575,2,48446,12113,1,764625400,764625400,18166,6055,12111,6055,0,1,6057,3896513,3.896513
6455,6055,4865,29457575,2,51646,12913,1,799569400,799569400,19366,6455,12911,6455,0,1,6457,1492489,1.492489
6855,6055,4865,29457575,2,54846,13713,1,834513400,834513400,20566,6855,13711,6855,0,1,6857,2394228,2.394228
40,6550,4540,29737000,2,326,83,1,241444800,241444800,121,40,81,40,0,1,42,38404,0.038404
440,6550,4540,29737000,2,3526,883,1,276932800,276932800,1321,440,881,440,0,1,442,82241,0.082241
840,6550,4540,29737000,2,6726,1683,1,312420800,312420800,2521,840,1681,840,0,1,842,53356,0.053356
1240,6550,4540,29737000,2,9926,2483,1,347908800,347908800,3721,1240,2481,1240,0,1,1242,631103,0.631103
1640,6550,4540,29737000,2,13126,3283,1,383396800,383396800,4921,1640,3281,1640,0,1,1642,285332,0.285332
2040,6550,4540,29737000,2,16326,4083,1,418884800,418884800,6121,2040,4081,2040,0,1,2042,424364,0.424364
2440,6550,4540,29737000,2,19526,4883,1,454372800,454372800,7321,2440,4881,2440,0,1,2442,2740812,2.740812
2840,6550,4540,29737000,2,22726,5683,1,489860800,489860800,8521,2840,5681,2840,0,1,2842,182424,0.182424
3240,6550,4540,29737000,2,25926,6483,1,525348800,525348800,9721,3240,6481,3240,0,1,3242,997388,0.997388
3640,6550,4540,29737000,2,29126,7283,1,560836800,560836800,10921,3640,7281,3640,0,1,3642,1235292,1.235292
4040,6550,4540,29737000,2,32326,8083,1,596324800,596324800,12121,4040,8081,4040,0,1,4042,1844306,1.844306
4440,6550,4540,29737000,2,35526,8883,1,631812800,631812800,13321,4440,8881,4440,0,1,4442,1794490,1.79449
4840,6550,4540,29737000,2,38726,9683,1,667300800,667300800,14521,4840,9681,4840,0,1,4842,309226,0.309226
5240,6550,4540,29737000,2,41926,10483,1,702788800,702788800,15721,5240,10481,5240,0,1,5242,2016809,2.016809
5640,6550,4540,29737000,2,45126,11283,1,738276800,738276800,16921,5640,11281,5640,0,1,5642,1588462,1.588462
6040,6550,4540,29737000,2,48326,12083,1,773764800,773764800,18121,6040,12081,6040,0,1,6042,5255383,5.255383
6440,6550,4540,29737000,2,51526,12883,1,809252800,809252800,19321,6440,12881,6440,0,1,6442,5158667,5.158667
6840,6550,4540,29737000,2,54726,13683,1,844740800,844740800,20521,6840,13681,6840,0,1,6842,2580930,2.58093
40,5800,5140,29812000,2,326,83,1,241996800,241996800,121,40,81,40,0,1,42,25266,0.025266
440,5800,5140,29812000,2,3526,883,1,277004800,277004800,1321,440,881,440,0,1,442,77950,0.07795
840,5800,5140,29812000,2,6726,1683,1,312012800,312012800,2521,840,1681,840,0,1,842,79155,0.079155
1240,5800,5140,29812000,2,9926,2483,1,347020800,347020800,3721,1240,2481,1240,0,1,1242,1121745,1.121745
1640,5800,5140,29812000,2,13126,3283,1,382028800,382028800,4921,1640,3281,1640,0,1,1642,1489229,1.489229
2040,5800,5140,29812000,2,16326,4083,1,417036800,417036800,6121,2040,4081,2040,0,1,2042,833791,0.833791
2440,5800,5140,29812000,2,19526,4883,1,452044800,452044800,7321,2440,4881,2440,0,1,2442,48451,0.048451
2840,5800,5140,29812000,2,22726,5683,1,487052800,487052800,8521,2840,5681,2840,0,1,2842,438455,0.438455
3240,5800,5140,29812000,2,25926,6483,1,522060800,522060800,9721,3240,6481,3240,0,1,3242,180387,0.180387
3640,5800,5140,29812000,2,29126,7283,1,557068800,557068800,10921,3640,7281,3640,0,1,3642,898333,0.898333
4040,5800,5140,29812000,2,32326,8083,1,592076800,592076800,12121,4040,8081,4040,0,1,4042,1274555,1.274555
4440,5800,5140,29812000,2,35526,8883,1,627084800,627084800,13321,4440,8881,4440,0,1,4442,1188118,1.188118
4840,5800,5140,29812000,2,38726,9683,1,662092800,662092800,14521,4840,9681,4840,0,1,4842,287889,0.287889
5240,5800,5140,29812000,2,41926,10483,1,697100800,697100800,15721,5240,10481,5240,0,1,5242,2223154,2.223154
5640,5800,5140,29812000,2,45126,11283,1,732108800,732108800,16921,5640,11281,5640,0,1,5642,4232695,4.232695
6040,5800,5140,29812000,2,48326,12083,1,767116800,767116800,18121,6040,12081,6040,0,1,6042,1924623,1.924623
6440,5800,5140,29812000,2,51526,12883,1,802124800,802124800,19321,6440,12881,6440,0,1,6442,703250,0.70325
6840,5800,5140,29812000,2,54726,13683,1,837132800,837132800,20521,6840,13681,6840,0,1,6842,2121719,2.121719
40,4300,6940,29842000,2,326,83,1,242332800,242332800,121,40,81,40,0,1,42,548361,0.548361
440,4300,6940,29842000,2,3526,883,1,278300800,278300800,1321,440,881,440,0,1,442,42238,0.042238
840,4300,6940,29842000,2,6726,1683,1,314268800,314268800,2521,840,1681,840,0,1,842,59638,0.059638
1240,4300,6940,29842000,2,9926,2483,1,350236800,350236800,3721,1240,2481,1240,0,1,1242,851706,0.851706
1640,4300,6940,29842000,2,13126,3283,1,386204800,386204800,4921,1640,3281,1640,0,1,1642,1270828,1.270828
2040,4300,6940,29842000,2,16326,4083,1,422172800,422172800,6121,2040,4081,2040,0,1,2042,306681,0.306681
2440,4300,6940,29842000,2,19526,4883,1,458140800,458140800,7321,2440,4881,2440,0,1,2442,2526188,2.526188
2840,4300,6940,29842000,2,22726,5683,1,494108800,494108800,8521,2840,5681,2840,0,1,2842,1852748,1.852748
3240,4300,6940,29842000,2,25926,6483,1,530076800,530076800,9721,3240,6481,3240,0,1,3242,4135382,4.135382
3640,4300,6940,29842000,2,29126,7283,1,566044800,566044800,10921,3640,7281,3640,0,1,3642,3610950,3.61095
4040,4300,6940,29842000,2,32326,8083,1,602012800,602012800,12121,4040,8081,4040,0,1,4042,7517913,7.517913
4440,4300,6940,29842000,2,35526,8883,1,637980800,637980800,13321,4440,8881,4440,0,1,4442,2388125,2.388125
4840,4300,6940,29842000,2,38726,9683,1,673948800,673948800,14521,4840,9681,4840,0,1,4842,1402541,1.402541
5240,4300,6940,29842000,2,41926,10483,1,709916800,709916800,15721,5240,10481,5240,0,1,5242,1750173,1.750173
5640,4300,6940,29842000,2,45126,11283,1,745884800,745884800,16921,5640,11281,5640,0,1,5642,933310,0.93331
6040,4300,6940,29842000,2,48326,12083,1,781852800,781852800,18121,6040,12081,6040,0,1,6042,1586786,1.586786
6440,4300,6940,29842000,2,51526,12883,1,817820800,817820800,19321,6440,12881,6440,0,1,6442,3065323,3.065323
6840,4300,6940,29842000,2,54726,13683,1,853788800,853788800,20521,6840,13681,6840,0,1,6842,1180175,1.180175
40,7050,4240,29892000,2,326,83,1,242748800,242748800,121,40,81,40,0,1,42,512637,0.512637
440,7050,4240,29892000,2,3526,883,1,278876800,278876800,1321,440,881,440,0,1,442,884508,0.884508
840,7050,4240,29892000,2,6726,1683,1,315004800,315004800,2521,840,1681,840,0,1,842,4963309,4.963309
1240,7050,4240,29892000,2,9926,2483,1,351132800,351132800,3721,1240,2481,1240,0,1,1242,188482,0.188482
1640,7050,4240,29892000,2,13126,3283,1,387260800,387260800,4921,1640,3281,1640,0,1,1642,6377207,6.377207
2040,7050,4240,29892000,2,16326,4083,1,423388800,423388800,6121,2040,4081,2040,0,1,2042,2760180,2.76018
2440,7050,4240,29892000,2,19526,4883,1,459516800,459516800,7321,2440,4881,2440,0,1,2442,1392240,1.39224
2840,7050,4240,29892000,2,22726,5683,1,495644800,495644800,8521,2840,5681,2840,0,1,2842,2788100,2.7881
3240,7050,4240,29892000,2,25926,6483,1,531772800,531772800,9721,3240,6481,3240,0,1,3242,13796131,13.796131
3640,7050,4240,29892000,2,29126,7283,1,567900800,567900800,10921,3640,7281,3640,0,1,3642,3651519,3.651519
4040,7050,4240,29892000,2,32326,8083,1,604028800,604028800,12121,4040,8081,4040,0,1,4042,9375601,9.375601
4440,7050,4240,29892000,2,35526,8883,1,640156800,640156800,13321,4440,8881,4440,0,1,4442,3723167,3.723167
4840,7050,4240,29892000,2,38726,9683,1,676284800,676284800,14521,4840,9681,4840,0,1,4842,8792925,8.792925
5240,7050,4240,29892000,2,41926,10483,1,712412800,712412800,15721,5240,10481,5240,0,1,5242,4621624,4.621624
5640,7050,4240,29892000,2,45126,11283,1,748540800,748540800,16921,5640,11281,5640,0,1,5642,32115167,32.115167
6040,7050,4240,29892000,2,48326,12083,1,784668800,784668800,18121,6040,12081,6040,0,1,6042,34580918,34.580918
6440,7050,4240,29892000,2,51526,12883,1,820796800,820796800,19321,6440,12881,6440,0,1,6442,36748121,36.748121
6840,7050,4240,29892000,2,54726,13683,1,856924800,856924800,20521,6840,13681,6840,0,1,6842,38989892,38.989892
35,4950,6045,29922750,2,286,73,1,242460600,242460600,106,35,71,35,0,1,37,237059,0.237059
535,4950,6045,29922750,2,4286,1073,1,286440600,286440600,1606,535,1071,535,0,1,537,435281,0.435281
1035,4950,6045,29922750,2,8286,2073,1,330420600,330420600,3106,1035,2071,1035,0,1,1037,522111,0.522111
1535,4950,6045,29922750,2,12286,3073,1,374400600,374400600,4606,1535,3071,1535,0,1,1537,479214,0.479214
2035,4950,6045,29922750,2,16286,4073,1,418380600,418380600,6106,2035,4071,2035,0,1,2037,1542958,1.542958
2535,4950,6045,29922750,2,20286,5073,1,462360600,462360600,7606,2535,5071,2535,0,1,2537,1819701,1.819701
3035,4950,6045,29922750,2,24286,6073,1,506340600,506340600,9106,3035,6071,3035,0,1,3037,7527673,7.527673
3535,4950,6045,29922750,2,28286,7073,1,550320600,550320600,10606,3535,7071,3535,0,1,3537,243642,0.243642
4035,4950,6045,29922750,2,32286,8073,1,594300600,594300600,12106,4035,8071,4035,0,1,4037,6716052,6.716052
4535,4950,6045,29922750,2,36286,9073,1,638280600,638280600,13606,4535,9071,4535,0,1,4537,14907750,14.90775
5035,4950,6045,29922750,2,40286,10073,1,682260600,682260600,15106,5035,10071,5035,0,1,5037,2655072,2.655072
5535,4950,6045,29922750,2,44286,11073,1,726240600,726240600,16606,5535,11071,5535,0,1,5537,5740874,5.740874
6035,4950,6045,29922750,2,48286,12073,1,770220600,770220600,18106,6035,12071,6035,0,1,6037,11774891,11.774891
6535,4950,6045,29922750,2,52286,13073,1,814200600,814200600,19606,6535,13071,6535,0,1,6537,1142942,1.142942
7035,4950,6045,29922750,2,56286,14073,1,858180600,858180600,21106,7035,14071,7035,0,1,7037,1316725,1.316725
55,6555,4565,29923575,2,446,113,1,244281400,244281400,166,55,111,55,0,1,57,58677,0.058677
455,6555,4565,29923575,2,3646,913,1,279865400,279865400,1366,455,911,455,0,1,457,191058,0.191058
855,6555,4565,29923575,2,6846,1713,1,315449400,315449400,2566,855,1711,855,0,1,857,137144,0.137144
1255,6555,4565,29923575,2,10046,2513,1,351033400,351033400,3766,1255,2511,1255,0,1,1257,259243,0.259243
1655,6555,4565,29923575,2,13246,3313,1,386617400,386617400,4966,1655,3311,1655,0,1,1657,1804756,1.804756
2055,6555,4565,29923575,2,16446,4113,1,422201400,422201400,6166,2055,4111,2055,0,1,2057,154159,0.154159
2455,6555,4565,29923575,2,19646,4913,1,457785400,457785400,7366,2455,4911,2455,0,1,2457,877696,0.877696
2855,6555,4565,29923575,2,22846,5713,1,493369400,493369400,8566,2855,5711,2855,0,1,2857,249694,0.249694
3255,6555,4565,29923575,2,26046,6513,1,528953400,528953400,9766,3255,6511,3255,0,1,3257,167672,0.167672
3655,6555,4565,29923575,2,29246,7313,1,564537400,564537400,10966,3655,7311,3655,0,1,3657,687903,0.687903
4055,6555,4565,29923575,2,32446,8113,1,600121400,600121400,12166,4055,8111,4055,0,1,4057,66583,0.066583
4455,6555,4565,29923575,2,35646,8913,1,635705400,635705400,13366,4455,8911,4455,0,1,4457,941391,0.941391
4855,6555,4565,29923575,2,38846,9713,1,671289400,671289400,14566,4855,9711,4855,0,1,4857,412744,0.412744
5255,6555,4565,29923575,2,42046,10513,1,706873400,706873400,15766,5255,10511,5255,0,1,5257,1619374,1.619374
5655,6555,4565,29923575,2,45246,11313,1,742457400,742457400,16966,5655,11311,5655,0,1,5657,2525698,2.525698
6055,6555,4565,29923575,2,48446,12113,1,778041400,778041400,18166,6055,12111,6055,0,1,6057,1210729,1.210729
6455,6555,4565,29923575,2,51646,12913,1,813625400,813625400,19366,6455,12911,6455,0,1,6457,1724047,1.724047
6855,6555,4565,29923575,2,54846,13713,1,849209400,849209400,20566,6855,13711,6855,0,1,6857,191427,0.191427
55,5805,5165,29982825,2,446,113,1,244689400,244689400,166,55,111,55,0,1,57,34550,0.03455
455,5805,5165,29982825,2,3646,913,1,279793400,279793400,1366,455,911,455,0,1,457,46054,0.046054
855,5805,5165,29982825,2,6846,1713,1,314897400,314897400,2566,855,1711,855,0,1,857,45927,0.045927
1255,5805,5165,29982825,2,10046,2513,1,350001400,350001400,3766,1255,2511,1255,0,1,1257,120112,0.120112
1655,5805,5165,29982825,2,13246,3313,1,385105400,385105400,4966,1655,3311,1655,0,1,1657,940390,0.94039
2055,5805,5165,29982825,2,16446,4113,1,420209400,420209400,6166,2055,4111,2055,0,1,2057,360219,0.360219
2455,5805,5165,29982825,2,19646,4913,1,455313400,455313400,7366,2455,4911,2455,0,1,2457,540254,0.540254
2855,5805,5165,29982825,2,22846,5713,1,490417400,490417400,8566,2855,5711,2855,0,1,2857,953928,0.953928
3255,5805,5165,29982825,2,26046,6513,1,525521400,525521400,9766,3255,6511,3255,0,1,3257,63512,0.063512
3655,5805,5165,29982825,2,29246,7313,1,560625400,560625400,10966,3655,7311,3655,0,1,3657,838531,0.838531
4055,5805,5165,29982825,2,32446,8113,1,595729400,595729400,12166,4055,8111,4055,0,1,4057,1523007,1.523007
4455,5805,5165,29982825,2,35646,8913,1,630833400,630833400,13366,4455,8911,4455,0,1,4457,197062,0.197062
4855,5805,5165,29982825,2,38846,9713,1,665937400,665937400,14566,4855,9711,4855,0,1,4857,1164539,1.164539
5255,5805,5165,29982825,2,42046,10513,1,701041400,701041400,15766,5255,10511,5255,0,1,5257,206084,0.206084
5655,5805,5165,29982825,2,45246,11313,1,736145400,736145400,16966,5655,11311,5655,0,1,5657,2369248,2.369248
6055,5805,5165,29982825,2,48446,12113,1,771249400,771249400,18166,6055,12111,6055,0,1,6057,117558,0.117558
6455,5805,5165,29982825,2,51646,12913,1,806353400,806353400,19366,6455,12911,6455,0,1,6457,2908545,2.908545
6855,5805,5165,29982825,2,54846,13713,1,841457400,841457400,20566,6855,13711,6855,0,1,6857,1012249,1.012249
55,4305,6965,29984325,2,446,113,1,244833400,244833400,166,55,111,55,0,1,57,140260,0.14026
455,4305,6965,29984325,2,3646,913,1,280897400,280897400,1366,455,911,455,0,1,457,464176,0.464176
855,4305,6965,29984325,2,6846,1713,1,316961400,316961400,2566,855,1711,855,0,1,857,655357,0.655357
1255,4305,6965,29984325,2,10046,2513,1,353025400,353025400,3766,1255,2511,1255,0,1,1257,1312616,1.312616
1655,4305,6965,29984325,2,13246,3313,1,389089400,389089400,4966,1655,3311,1655,0,1,1657,455038,0.455038
2055,4305,6965,29984325,2,16446,4113,1,425153400,425153400,6166,2055,4111,2055,0,1,2057,1144124,1.144124
2455,4305,6965,29984325,2,19646,4913,1,461217400,461217400,7366,2455,4911,2455,0,1,2457,3536901,3.536901
2855,4305,6965,29984325,2,22846,5713,1,497281400,497281400,8566,2855,5711,2855,0,1,2857,2786350,2.78635
3255,4305,6965,29984325,2,26046,6513,1,533345400,533345400,9766,3255,6511,3255,0,1,3257,7139525,7.139525
3655,4305,6965,29984325,2,29246,7313,1,569409400,569409400,10966,3655,7311,3655,0,1,3657,990671,0.990671
4055,4305,6965,29984325,2,32446,8113,1,605473400,605473400,12166,4055,8111,4055,0,1,4057,1234599,1.234599
4455,4305,6965,29984325,2,35646,8913,1,641537400,641537400,13366,4455,8911,4455,0,1,4457,210484,0.210484
4855,4305,6965,29984325,2,38846,9713,1,677601400,677601400,14566,4855,9711,4855,0,1,4857,2342844,2.342844
5255,4305,6965,29984325,2,42046,10513,1,713665400,713665400,15766,5255,10511,5255,0,1,5257,2310183,2.310183
5655,4305,6965,29984325,2,45246,11313,1,749729400,749729400,16966,5655,11311,5655,0,1,5657,484890,0.48489
6055,4305,6965,29984325,2,48446,12113,1,785793400,785793400,18166,6055,12111,6055,0,1,6057,460119,0.460119
6455,4305,6965,29984325,2,51646,12913,1,821857400,821857400,19366,6455,12911,6455,0,1,6457,3259236,3.259236
6855,4305,6965,29984325,2,54846,13713,1,857921400,857921400,20566,6855,13711,6855,0,1,6857,1500719,1.500719
35,6600,4545,29997000,2,286,73,1,243096600,243096600,106,35,71,35,0,1,37,84715,0.084715
535,6600,4545,29997000,2,4286,1073,1,287676600,287676600,1606,535,1071,535,0,1,537,835384,0.835384
1035,6600,4545,29997000,2,8286,2073,1,332256600,332256600,3106,1035,2071,1035,0,1,1037,701657,0.701657
1535,6600,4545,29997000,2,12286,3073,1,376836600,376836600,4606,1535,3071,1535,0,1,1537,593941,0.593941
2035,6600,4545,29997000,2,16286,4073,1,421416600,421416600,6106,2035,4071,2035,0,1,2037,375356,0.375356
2535,6600,4545,29997000,2,20286,5073,1,465996600,465996600,7606,2535,5071,2535,0,1,2537,1486522,1.486522
3035,6600,4545,29997000,2,24286,6073,1,510576600,510576600,9106,3035,6071,3035,0,1,3037,1986249,1.986249
3535,6600,4545,29997000,2,28286,7073,1,555156600,555156600,10606,3535,7071,3535,0,1,3537,7782278,7.782278
4035,6600,4545,29997000,2,32286,8073,1,599736600,599736600,12106,4035,8071,4035,0,1,4037,192985,0.192985
4535,6600,4545,29997000,2,36286,9073,1,644316600,644316600,13606,4535,9071,4535,0,1,4537,8609243,8.609243
5035,6600,4545,29997000,2,40286,10073,1,688896600,688896600,15106,5035,10071,5035,0,1,5037,16104294,16.104294
5535,6600,4545,29997000,2,44286,11073,1,733476600,733476600,16606,5535,11071,5535,0,1,5537,22645052,22.645052
6035,6600,4545,29997000,2,48286,12073,1,778056600,778056600,18106,6035,12071,6035,0,1,6037,5223817,5.223817
6535,6600,4545,29997000,2,52286,13073,1,822636600,822636600,19606,6535,13071,6535,0,1,6537,19602288,19.602288
7035,6600,4545,29997000,2,56286,14073,1,867216600,867216600,21106,7035,14071,7035,0,1,7037,30534147,30.534147
55,7055,4265,30089575,2,446,113,1,245697400,245697400,166,55,111,55,0,1,57,606027,0.606027
455,7055,4265,30089575,2,3646,913,1,281921400,281921400,1366,455,911,455,0,1,457,616922,0.616922
855,7055,4265,30089575,2,6846,1713,1,318145400,318145400,2566,855,1711,855,0,1,857,754584,0.754584
1255,7055,4265,30089575,2,10046,2513,1,354369400,354369400,3766,1255,2511,1255,0,1,1257,2464963,2.464963
1655,7055,4265,30089575,2,13246,3313,1,390593400,390593400,4966,1655,3311,1655,0,1,1657,2524432,2.524432
2055,7055,4265,30089575,2,16446,4113,1,426817400,426817400,6166,2055,4111,2055,0,1,2057,1736038,1.736038
2455,7055,4265,30089575,2,19646,4913,1,463041400,463041400,7366,2455,4911,2455,0,1,2457,4969682,4.969682
2855,7055,4265,30089575,2,22846,5713,1,499265400,499265400,8566,2855,5711,2855,0,1,2857,5025498,5.025498
3255,7055,4265,30089575,2,26046,6513,1,535489400,535489400,9766,3255,6511,3255,0,1,3257,10305528,10.305528
3655,7055,4265,30089575,2,29246,7313,1,571713400,571713400,10966,3655,7311,3655,0,1,3657,3123408,3.123408
4055,7055,4265,30089575,2,32446,8113,1,607937400,607937400,12166,4055,8111,4055,0,1,4057,945837,0.945837
4455,7055,4265,30089575,2,35646,8913,1,644161400,644161400,13366,4455,8911,4455,0,1,4457,2290751,2.290751
4855,7055,4265,30089575,2,38846,9713,1,680385400,680385400,14566,4855,9711,4855,0,1,4857,3718439,3.718439
5255,7055,4265,30089575,2,42046,10513,1,716609400,716609400,15766,5255,10511,5255,0,1,5257,1454275,1.454275
5655,7055,4265,30089575,2,45246,11313,1,752833400,752833400,16966,5655,11311,5655,0,1,5657,33104185,33.104185
6055,7055,4265,30089575,2,48446,12113,1,789057400,789057400,18166,6055,12111,6055,0,1,6057,35726913,35.726913
6455,7055,4265,30089575,2,51646,12913,1,825281400,825281400,19366,6455,12911,6455,0,1,6457,38128753,38.128753
6855,7055,4265,30089575,2,54846,13713,1,861505400,861505400,20566,6855,13711,6855,0,1,6857,40556505,40.556505
39,4993,6041,30162713,2,318,81,1,244744312,244744312,118,39,79,39,0,1,41,530486,0.530486
539,4993,6041,30162713,2,4318,1081,1,288880312,288880312,1618,539,1079,539,0,1,541,100094,0.100094
1039,4993,6041,30162713,2,8318,2081,1,333016312,333016312,3118,1039,2079,1039,0,1,1041,211008,0.211008
1539,4993,6041,30162713,2,12318,3081,1,377152312,377152312,4618,1539,3079,1539,0,1,1541,5889156,5.889156
2039,4993,6041,30162713,2,16318,4081,1,421288312,421288312,6118,2039,4079,2039,0,1,2041,3533416,3.533416
2539,4993,6041,30162713,2,20318,5081,1,465424312,465424312,7618,2539,5079,2539,0,1,2541,11075065,11.075065
3039,4993,6041,30162713,2,24318,6081,1,509560312,509560312,9118,3039,6079,3039,0,1,3041,2636671,2.636671
3539,4993,6041,30162713,2,28318,7081,1,553696312,553696312,10618,3539,7079,3539,0,1,3541,1191763,1.191763
4039,4993,6041,30162713,2,32318,8081,1,597832312,597832312,12118,4039,8079,4039,0,1,4041,3659522,3.659522
4539,4993,6041,30162713,2,36318,9081,1,641968312,641968312,13618,4539,9079,4539,0,1,4541,1517724,1.517724
5039,4993,6041,30162713,2,40318,10081,1,686104312,686104312,15118,5039,10079,5039,0,1,5041,15121876,15.121876
5539,4993,6041,30162713,2,44318,11081,1,730240312,730240312,16618,5539,11079,5539,0,1,5541,371658,0.371658
6039,4993,6041,30162713,2,48318,12081,1,774376312,774376312,18118,6039,12079,6039,0,1,6041,34056807,34.056807
6539,4993,6041,30162713,2,52318,13081,1,818512312,818512312,19618,6539,13079,6539,0,1,6541,36935604,36.935604
7039,4993,6041,30162713,2,56318,14081,1,862648312,862648312,21118,7039,14079,7039,0,1,7041,39751424,39.751424
39,6643,4541,30165863,2,318,81,1,244816312,244816312,118,39,79,39,0,1,41,21926,0.021926
539,6643,4541,30165863,2,4318,1081,1,289552312,289552312,1618,539,1079,539,0,1,541,59043,0.059043
1039,6643,4541,30165863,2,8318,2081,1,334288312,334288312,3118,1039,2079,1039,0,1,1041,53894,0.053894
1539,6643,4541,30165863,2,12318,3081,1,379024312,379024312,4618,1539,3079,1539,0,1,1541,729125,0.729125
2039,6643,4541,30165863,2,16318,4081,1,423760312,423760312,6118,2039,4079,2039,0,1,2041,400657,0.400657
2539,6643,4541,30165863,2,20318,5081,1,468496312,468496312,7618,2539,5079,2539,0,1,2541,2823605,2.823605
3039,6643,4541,30165863,2,24318,6081,1,513232312,513232312,9118,3039,6079,3039,0,1,3041,122897,0.122897
3539,6643,4541,30165863,2,28318,7081,1,557968312,557968312,10618,3539,7079,3539,0,1,3541,560524,0.560524
4039,6643,4541,30165863,2,32318,8081,1,602704312,602704312,12118,4039,8079,4039,0,1,4041,4880839,4.880839
4539,6643,4541,30165863,2,36318,9081,1,647440312,647440312,13618,4539,9079,4539,0,1,4541,1366960,1.36696
5039,6643,4541,30165863,2,40318,10081,1,692176312,692176312,15118,5039,10079,5039,0,1,5041,2232830,2.23283
5539,6643,4541,30165863,2,44318,11081,1,736912312,736912312,16618,5539,11079,5539,0,1,5541,958929,0.958929
6039,6643,4541,30165863,2,48318,12081,1,781648312,781648312,18118,6039,12079,6039,0,1,6041,1556210,1.55621
6539,6643,4541,30165863,2,52318,13081,1,826384312,826384312,19618,6539,13079,6539,0,1,6541,3885130,3.88513
7039,6643,4541,30165863,2,56318,14081,1,871120312,871120312,21118,7039,14079,7039,0,1,7041,14308462,14.308462
40,5550,5440,30192000,2,326,83,1,245052800,245052800,121,40,81,40,0,1,42,543267,0.543267
440,5550,5440,30192000,2,3526,883,1,280220800,280220800,1321,440,881,440,0,1,442,1155226,1.155226
840,5550,5440,30192000,2,6726,1683,1,315388800,315388800,2521,840,1681,840,0,1,842,272852,0.272852
1240,5550,5440,30192000,2,9926,2483,1,350556800,350556800,3721,1240,2481,1240,0,1,1242,3202350,3.20235
1640,5550,5440,30192000,2,13126,3283,1,385724800,385724800,4921,1640,3281,1640,0,1,1642,5100611,5.100611
2040,5550,5440,30192000,2,16326,4083,1,420892800,420892800,6121,2040,4081,2040,0,1,2042,3521262,3.521262
2440,5550,5440,30192000,2,19526,4883,1,456060800,456060800,7321,2440,4881,2440,0,1,2442,2377837,2.377837
2840,5550,5440,30192000,2,22726,5683,1,491228800,491228800,8521,2840,5681,2840,0,1,2842,4464454,4.464454
3240,5550,5440,30192000,2,25926,6483,1,526396800,526396800,9721,3240,6481,3240,0,1,3242,4092823,4.092823
3640,5550,5440,30192000,2,29126,7283,1,561564800,561564800,10921,3640,7281,3640,0,1,3642,706515,0.706515
4040,5550,5440,30192000,2,32326,8083,1,596732800,596732800,12121,4040,8081,4040,0,1,4042,3116071,3.116071
4440,5550,5440,30192000,2,35526,8883,1,631900800,631900800,13321,4440,8881,4440,0,1,4442,1681676,1.681676
4840,5550,5440,30192000,2,38726,9683,1,667068800,667068800,14521,4840,9681,4840,0,1,4842,3148534,3.148534
5240,5550,5440,30192000,2,41926,10483,1,702236800,702236800,15721,5240,10481,5240,0,1,5242,1828622,1.828622
5640,5550,5440,30192000,2,45126,11283,1,737404800,737404800,16921,5640,11281,5640,0,1,5642,2297824,2.297824
6040,5550,5440,30192000,2,48326,12083,1,772572800,772572800,18121,6040,12081,6040,0,1,6042,599993,0.599993
6440,5550,5440,30192000,2,51526,12883,1,807740800,807740800,19321,6440,12881,6440,0,1,6442,1540168,1.540168
6840,5550,5440,30192000,2,54726,13683,1,842908800,842908800,20521,6840,13681,6840,0,1,6842,6564095,6.564095
40,4550,6640,30212000,2,326,83,1,245276800,245276800,121,40,81,40,0,1,42,219655,0.219655
440,4550,6640,30212000,2,3526,883,1,281084800,281084800,1321,440,881,440,0,1,442,2644687,2.644687
840,4550,6640,30212000,2,6726,1683,1,316892800,316892800,2521,840,1681,840,0,1,842,2148481,2.148481
1240,4550,6640,30212000,2,9926,2483,1,352700800,352700800,3721,1240,2481,1240,0,1,1242,1753467,1.753467
1640,4550,6640,30212000,2,13126,3283,1,388508800,388508800,4921,1640,3281,1640,0,1,1642,4025305,4.025305
2040,4550,6640,30212000,2,16326,4083,1,424316800,424316800,6121,2040,4081,2040,0,1,2042,5305624,5.305624
2440,4550,6640,30212000,2,19526,4883,1,460124800,460124800,7321,2440,4881,2440,0,1,2442,7486245,7.486245
2840,4550,6640,30212000,2,22726,5683,1,495932800,495932800,8521,2840,5681,2840,0,1,2842,4615119,4.615119
3240,4550,6640,30212000,2,25926,6483,1,531740800,531740800,9721,3240,6481,3240,0,1,3242,145698,0.145698
3640,4550,6640,30212000,2,29126,7283,1,567548800,567548800,10921,3640,7281,3640,0,1,3642,2371643,2.371643
4040,4550,6640,30212000,2,32326,8083,1,603356800,603356800,12121,4040,8081,4040,0,1,4042,1300679,1.300679
4440,4550,6640,30212000,2,35526,8883,1,639164800,639164800,13321,4440,8881,4440,0,1,4442,1260455,1.260455
4840,4550,6640,30212000,2,38726,9683,1,674972800,674972800,14521,4840,9681,4840,0,1,4842,4597818,4.597818
5240,4550,6640,30212000,2,41926,10483,1,710780800,710780800,15721,5240,10481,5240,0,1,5242,2722973,2.722973
5640,4550,6640,30212000,2,45126,11283,1,746588800,746588800,16921,5640,11281,5640,0,1,5642,3110015,3.110015
6040,4550,6640,30212000,2,48326,12083,1,782396800,782396800,18121,6040,12081,6040,0,1,6042,1081049,1.081049
6440,4550,6640,30212000,2,51526,12883,1,818204800,818204800,19321,6440,12881,6440,0,1,6442,2202360,2.20236
6840,4550,6640,30212000,2,54726,13683,1,854012800,854012800,20521,6840,13681,6840,0,1,6842,1580658,1.580658
44,5003,6055,30293165,2,358,91,1,246237736,246237736,133,44,89,44,0,1,46,566100,0.5661
544,5003,6055,30293165,2,4358,1091,1,290469736,290469736,1633,544,1089,544,0,1,546,3311755,3.311755
1044,5003,6055,30293165,2,8358,2091,1,334701736,334701736,3133,1044,2089,1044,0,1,1046,1834721,1.834721
1544,5003,6055,30293165,2,12358,3091,1,378933736,378933736,4633,1544,3089,1544,0,1,1546,1512735,1.512735
2044,5003,6055,30293165,2,16358,4091,1,423165736,423165736,6133,2044,4089,2044,0,1,2046,3068301,3.068301
2544,5003,6055,30293165,2,20358,5091,1,467397736,467397736,7633,2544,5089,2544,0,1,2546,748793,0.748793
3044,5003,6055,30293165,2,24358,6091,1,511629736,511629736,9133,3044,6089,3044,0,1,3046,7503461,7.503461
3544,5003,6055,30293165,2,28358,7091,1,555861736,555861736,10633,3544,7089,3544,0,1,3546,11832773,11.832773
4044,5003,6055,30293165,2,32358,8091,1,600093736,600093736,12133,4044,8089,4044,0,1,4046,7255903,7.255903
4544,5003,6055,30293165,2,36358,9091,1,644325736,644325736,13633,4544,9089,4544,0,1,4546,2744363,2.744363
5044,5003,6055,30293165,2,40358,10091,1,688557736,688557736,15133,5044,10089,5044,0,1,5046,28692285,28.692285
5544,5003,6055,30293165,2,44358,11091,1,732789736,732789736,16633,5544,11089,5544,0,1,5546,21744318,21.744318
6044,5003,6055,30293165,2,48358,12091,1,777021736,777021736,18133,6044,12089,6044,0,1,6046,34397907,34.397907
6544,5003,6055,30293165,2,52358,13091,1,821253736,821253736,19633,6544,13089,6544,0,1,6546,37167817,37.167817
7044,5003,6055,30293165,2,56358,14091,1,865485736,865485736,21133,7044,14089,7044,0,1,7046,39956948,39.956948
44,6653,4555,30304415,2,358,91,1,246380536,246380536,133,44,89,44,0,1,46,53460,0.05346
544,6653,4555,30304415,2,4358,1091,1,291212536,291212536,1633,544,1089,544,0,1,546,97401,0.097401
1044,6653,4555,30304415,2,8358,2091,1,336044536,336044536,3133,1044,2089,1044,0,1,1046,240459,0.240459
1544,6653,4555,30304415,2,12358,3091,1,380876536,380876536,4633,1544,3089,1544,0,1,1546,195741,0.195741
2044,6653,4555,30304415,2,16358,4091,1,425708536,425708536,6133,2044,4089,2044,0,1,2046,138561,0.138561
2544,6653,4555,30304415,2,20358,5091,1,470540536,470540536,7633,2544,5089,2544,0,1,2546,84039,0.084039
3044,6653,4555,30304415,2,24358,6091,1,515372536,515372536,9133,3044,6089,3044,0,1,3046,2031203,2.031203
3544,6653,4555,30304415,2,28358,7091,1,560204536,560204536,10633,3544,7089,3544,0,1,3546,2987002,2.987002
4044,6653,4555,30304415,2,32358,8091,1,605036536,605036536,12133,4044,8089,4044,0,1,4046,412353,0.412353
4544,6653,4555,30304415,2,36358,9091,1,649868536,649868536,13633,4544,9089,4544,0,1,4546,1607366,1.607366
5044,6653,4555,30304415,2,40358,10091,1,694700536,694700536,15133,5044,10089,5044,0,1,5046,4629623,4.629623
5544,6653,4555,30304415,2,44358,11091,1,739532536,739532536,16633,5544,11089,5544,0,1,5546,1006617,1.006617
6044,6653,4555,30304415,2,48358,12091,1,784364536,784364536,18133,6044,12089,6044,0,1,6046,997310,0.99731
6544,6653,4555,30304415,2,52358,13091,1,829196536,829196536,19633,6544,13089,6544,0,1,6546,1376581,1.376581
7044,6653,4555,30304415,2,56358,14091,1,874028536,874028536,21133,7044,14089,7044,0,1,7046,2396534,2.396534
55,5555,5465,30358075,2,446,113,1,247713400,247713400,166,55,111,55,0,1,57,628510,0.62851
455,5555,5465,30358075,2,3646,913,1,282977400,282977400,1366,455,911,455,0,1,457,2870228,2.870228
855,5555,5465,30358075,2,6846,1713,1,318241400,318241400,2566,855,1711,855,0,1,857,483200,0.4832
1255,5555,5465,30358075,2,10046,2513,1,353505400,353505400,3766,1255,2511,1255,0,1,1257,7447065,7.447065
1655,5555,5465,30358075,2,13246,3313,1,388769400,388769400,4966,1655,3311,1655,0,1,1657,9747685,9.747685
2055,5555,5465,30358075,2,16446,4113,1,424033400,424033400,6166,2055,4111,2055,0,1,2057,1704212,1.704212
2455,5555,5465,30358075,2,19646,4913,1,459297400,459297400,7366,2455,4911,2455,0,1,2457,9441243,9.441243
2855,5555,5465,30358075,2,22846,5713,1,494561400,494561400,8566,2855,5711,2855,0,1,2857,1837432,1.837432
3255,5555,5465,30358075,2,26046,6513,1,529825400,529825400,9766,3255,6511,3255,0,1,3257,2579049,2.579049
3655,5555,5465,30358075,2,29246,7313,1,565089400,565089400,10966,3655,7311,3655,0,1,3657,1823474,1.823474
4055,5555,5465,30358075,2,32446,8113,1,600353400,600353400,12166,4055,8111,4055,0,1,4057,7769051,7.769051
4455,5555,5465,30358075,2,35646,8913,1,635617400,635617400,13366,4455,8911,4455,0,1,4457,16216340,16.21634
4855,5555,5465,30358075,2,38846,9713,1,670881400,670881400,14566,4855,9711,4855,0,1,4857,1399403,1.399403
5255,5555,5465,30358075,2,42046,10513,1,706145400,706145400,15766,5255,10511,5255,0,1,5257,140937,0.140937
5655,5555,5465,30358075,2,45246,11313,1,741409400,741409400,16966,5655,11311,5655,0,1,5657,6453461,6.453461
6055,5555,5465,30358075,2,48446,12113,1,776673400,776673400,18166,6055,12111,6055,0,1,6057,6432360,6.43236
6455,5555,5465,30358075,2,51646,12913,1,811937400,811937400,19366,6455,12911,6455,0,1,6457,2210309,2.210309
6855,5555,5465,30358075,2,54846,13713,1,847201400,847201400,20566,6855,13711,6855,0,1,6857,3776047,3.776047
55,4555,6665,30359075,2,446,113,1,247809400,247809400,166,55,111,55,0,1,57,617695,0.617695
455,4555,6665,30359075,2,3646,913,1,283713400,283713400,1366,455,911,455,0,1,457,1029913,1.029913
855,4555,6665,30359075,2,6846,1713,1,319617400,319617400,2566,855,1711,855,0,1,857,5068999,5.068999
1255,4555,6665,30359075,2,10046,2513,1,355521400,355521400,3766,1255,2511,1255,0,1,1257,892021,0.892021
1655,4555,6665,30359075,2,13246,3313,1,391425400,391425400,4966,1655,3311,1655,0,1,1657,1525366,1.525366
2055,4555,6665,30359075,2,16446,4113,1,427329400,427329400,6166,2055,4111,2055,0,1,2057,1532512,1.532512
2455,4555,6665,30359075,2,19646,4913,1,463233400,463233400,7366,2455,4911,2455,0,1,2457,2667390,2.66739
2855,4555,6665,30359075,2,22846,5713,1,499137400,499137400,8566,2855,5711,2855,0,1,2857,6635475,6.635475
3255,4555,6665,30359075,2,26046,6513,1,535041400,535041400,9766,3255,6511,3255,0,1,3257,4218960,4.21896
3655,4555,6665,30359075,2,29246,7313,1,570945400,570945400,10966,3655,7311,3655,0,1,3657,3433672,3.433672
4055,4555,6665,30359075,2,32446,8113,1,606849400,606849400,12166,4055,8111,4055,0,1,4057,260834,0.260834
4455,4555,6665,30359075,2,35646,8913,1,642753400,642753400,13366,4455,8911,4455,0,1,4457,114256,0.114256
4855,4555,6665,30359075,2,38846,9713,1,678657400,678657400,14566,4855,9711,4855,0,1,4857,662885,0.662885
5255,4555,6665,30359075,2,42046,10513,1,714561400,714561400,15766,5255,10511,5255,0,1,5257,8014181,8.014181
5655,4555,6665,30359075,2,45246,11313,1,750465400,750465400,16966,5655,11311,5655,0,1,5657,1532933,1.532933
6055,4555,6665,30359075,2,48446,12113,1,786369400,786369400,18166,6055,12111,6055,0,1,6057,1394333,1.394333
6455,4555,6665,30359075,2,51646,12913,1,822273400,822273400,19366,6455,12911,6455,0,1,6457,1251711,1.251711
6855,4555,6665,30359075,2,54846,13713,1,858177400,858177400,20566,6855,13711,6855,0,1,6857,1162069,1.162069
40,5300,5740,30422000,2,326,83,1,246908800,246908800,121,40,81,40,0,1,42,557671,0.557671
440,5300,5740,30422000,2,3526,883,1,282236800,282236800,1321,440,881,440,0,1,442,1247540,1.24754
840,5300,5740,30422000,2,6726,1683,1,317564800,317564800,2521,840,1681,840,0,1,842,659672,0.659672
1240,5300,5740,30422000,2,9926,2483,1,352892800,352892800,3721,1240,2481,1240,0,1,1242,3418739,3.418739
1640,5300,5740,30422000,2,13126,3283,1,388220800,388220800,4921,1640,3281,1640,0,1,1642,2024287,2.024287
2040,5300,5740,30422000,2,16326,4083,1,423548800,423548800,6121,2040,4081,2040,0,1,2042,3138612,3.138612
2440,5300,5740,30422000,2,19526,4883,1,458876800,458876800,7321,2440,4881,2440,0,1,2442,628008,0.628008
2840,5300,5740,30422000,2,22726,5683,1,494204800,494204800,8521,2840,5681,2840,0,1,2842,4835444,4.835444
3240,5300,5740,30422000,2,25926,6483,1,529532800,529532800,9721,3240,6481,3240,0,1,3242,517732,0.517732
3640,5300,5740,30422000,2,29126,7283,1,564860800,564860800,10921,3640,7281,3640,0,1,3642,2610812,2.610812
4040,5300,5740,30422000,2,32326,8083,1,600188800,600188800,12121,4040,8081,4040,0,1,4042,983220,0.98322
4440,5300,5740,30422000,2,35526,8883,1,635516800,635516800,13321,4440,8881,4440,0,1,4442,584447,0.584447
4840,5300,5740,30422000,2,38726,9683,1,670844800,670844800,14521,4840,9681,4840,0,1,4842,711698,0.711698
5240,5300,5740,30422000,2,41926,10483,1,706172800,706172800,15721,5240,10481,5240,0,1,5242,2098801,2.098801
5640,5300,5740,30422000,2,45126,11283,1,741500800,741500800,16921,5640,11281,5640,0,1,5642,895488,0.895488
6040,5300,5740,30422000,2,48326,12083,1,776828800,776828800,18121,6040,12081,6040,0,1,6042,3740688,3.740688
6440,5300,5740,30422000,2,51526,12883,1,812156800,812156800,19321,6440,12881,6440,0,1,6442,2781888,2.781888
6840,5300,5740,30422000,2,54726,13683,1,847484800,847484800,20521,6840,13681,6840,0,1,6842,3399218,3.399218
40,4800,6340,30432000,2,326,83,1,247020800,247020800,121,40,81,40,0,1,42,553702,0.553702
440,4800,6340,30432000,2,3526,883,1,282668800,282668800,1321,440,881,440,0,1,442,1459522,1.459522
840,4800,6340,30432000,2,6726,1683,1,318316800,318316800,2521,840,1681,840,0,1,842,598908,0.598908
1240,4800,6340,30432000,2,9926,2483,1,353964800,353964800,3721,1240,2481,1240,0,1,1242,2449608,2.449608
1640,4800,6340,30432000,2,13126,3283,1,389612800,389612800,4921,1640,3281,1640,0,1,1642,7761243,7.761243
2040,4800,6340,30432000,2,16326,4083,1,425260800,425260800,6121,2040,4081,2040,0,1,2042,715001,0.715001
2440,4800,6340,30432000,2,19526,4883,1,460908800,460908800,7321,2440,4881,2440,0,1,2442,2036800,2.0368
2840,4800,6340,30432000,2,22726,5683,1,496556800,496556800,8521,2840,5681,2840,0,1,2842,6845050,6.84505
3240,4800,6340,30432000,2,25926,6483,1,532204800,532204800,9721,3240,6481,3240,0,1,3242,125744,0.125744
3640,4800,6340,30432000,2,29126,7283,1,567852800,567852800,10921,3640,7281,3640,0,1,3642,1279123,1.279123
4040,4800,6340,30432000,2,32326,8083,1,603500800,603500800,12121,4040,8081,4040,0,1,4042,149178,0.149178
4440,4800,6340,30432000,2,35526,8883,1,639148800,639148800,13321,4440,8881,4440,0,1,4442,10104483,10.104483
4840,4800,6340,30432000,2,38726,9683,1,674796800,674796800,14521,4840,9681,4840,0,1,4842,9190974,9.190974
5240,4800,6340,30432000,2,41926,10483,1,710444800,710444800,15721,5240,10481,5240,0,1,5242,1345031,1.345031
5640,4800,6340,30432000,2,45126,11283,1,746092800,746092800,16921,5640,11281,5640,0,1,5642,5237113,5.237113
6040,4800,6340,30432000,2,48326,12083,1,781740800,781740800,18121,6040,12081,6040,0,1,6042,12430108,12.430108
6440,4800,6340,30432000,2,51526,12883,1,817388800,817388800,19321,6440,12881,6440,0,1,6442,3069981,3.069981
6840,4800,6340,30432000,2,54726,13683,1,853036800,853036800,20521,6840,13681,6840,0,1,6842,1430749,1.430749
40,6300,4840,30492000,2,326,83,1,247500800,247500800,121,40,81,40,0,1,42,561296,0.561296
440,6300,4840,30492000,2,3526,883,1,283148800,283148800,1321,440,881,440,0,1,442,2182853,2.182853
840,6300,4840,30492000,2,6726,1683,1,318796800,318796800,2521,840,1681,840,0,1,842,2003873,2.003873
1240,6300,4840,30492000,2,9926,2483,1,354444800,354444800,3721,1240,2481,1240,0,1,1242,561182,0.561182
1640,6300,4840,30492000,2,13126,3283,1,390092800,390092800,4921,1640,3281,1640,0,1,1642,506664,0.506664
2040,6300,4840,30492000,2,16326,4083,1,425740800,425740800,6121,2040,4081,2040,0,1,2042,317943,0.317943
2440,6300,4840,30492000,2,19526,4883,1,461388800,461388800,7321,2440,4881,2440,0,1,2442,5385571,5.385571
2840,6300,4840,30492000,2,22726,5683,1,497036800,497036800,8521,2840,5681,2840,0,1,2842,5075234,5.075234
3240,6300,4840,30492000,2,25926,6483,1,532684800,532684800,9721,3240,6481,3240,0,1,3242,6116661,6.116661
3640,6300,4840,30492000,2,29126,7283,1,568332800,568332800,10921,3640,7281,3640,0,1,3642,8119975,8.119975
4040,6300,4840,30492000,2,32326,8083,1,603980800,603980800,12121,4040,8081,4040,0,1,4042,10625956,10.625956
4440,6300,4840,30492000,2,35526,8883,1,639628800,639628800,13321,4440,8881,4440,0,1,4442,1318654,1.318654
4840,6300,4840,30492000,2,38726,9683,1,675276800,675276800,14521,4840,9681,4840,0,1,4842,1092070,1.09207
5240,6300,4840,30492000,2,41926,10483,1,710924800,710924800,15721,5240,10481,5240,0,1,5242,5077168,5.077168
5640,6300,4840,30492000,2,45126,11283,1,746572800,746572800,16921,5640,11281,5640,0,1,5642,8543848,8.543848
6040,6300,4840,30492000,2,48326,12083,1,782220800,782220800,18121,6040,12081,6040,0,1,6042,2504062,2.504062
6440,6300,4840,30492000,2,51526,12883,1,817868800,817868800,19321,6440,12881,6440,0,1,6442,12514338,12.514338
6840,6300,4840,30492000,2,54726,13683,1,853516800,853516800,20521,6840,13681,6840,0,1,6842,38942553,38.942553
35,5500,5545,30497500,2,286,73,1,247072600,247072600,106,35,71,35,0,1,37,158436,0.158436
535,5500,5545,30497500,2,4286,1073,1,291252600,291252600,1606,535,1071,535,0,1,537,422974,0.422974
1035,5500,5545,30497500,2,8286,2073,1,335432600,335432600,3106,1035,2071,1035,0,1,1037,2736136,2.736136
1535,5500,5545,30497500,2,12286,3073,1,379612600,379612600,4606,1535,3071,1535,0,1,1537,883299,0.883299
2035,5500,5545,30497500,2,16286,4073,1,423792600,423792600,6106,2035,4071,2035,0,1,2037,1199947,1.199947
2535,5500,5545,30497500,2,20286,5073,1,467972600,467972600,7606,2535,5071,2535,0,1,2537,1588024,1.588024
3035,5500,5545,30497500,2,24286,6073,1,512152600,512152600,9106,3035,6071,3035,0,1,3037,5101682,5.101682
3535,5500,5545,30497500,2,28286,7073,1,556332600,556332600,10606,3535,7071,3535,0,1,3537,108604,0.108604
4035,5500,5545,30497500,2,32286,8073,1,600512600,600512600,12106,4035,8071,4035,0,1,4037,90902,0.090902
4535,5500,5545,30497500,2,36286,9073,1,644692600,644692600,13606,4535,9071,4535,0,1,4537,1259574,1.259574
5035,5500,5545,30497500,2,40286,10073,1,688872600,688872600,15106,5035,10071,5035,0,1,5037,25541696,25.541696
5535,5500,5545,30497500,2,44286,11073,1,733052600,733052600,16606,5535,11071,5535,0,1,5537,4474413,4.474413
6035,5500,5545,30497500,2,48286,12073,1,777232600,777232600,18106,6035,12071,6035,0,1,6037,3251668,3.251668
6535,5500,5545,30497500,2,52286,13073,1,821412600,821412600,19606,6535,13071,6535,0,1,6537,6134390,6.13439
7035,5500,5545,30497500,2,56286,14073,1,865592600,865592600,21106,7035,14071,7035,0,1,7037,5480743,5.480743
40,5050,6040,30502000,2,326,83,1,247564800,247564800,121,40,81,40,0,1,42,78790,0.07879
440,5050,6040,30502000,2,3526,883,1,283052800,283052800,1321,440,881,440,0,1,442,213099,0.213099
840,5050,6040,30502000,2,6726,1683,1,318540800,318540800,2521,840,1681,840,0,1,842,134953,0.134953
1240,5050,6040,30502000,2,9926,2483,1,354028800,354028800,3721,1240,2481,1240,0,1,1242,121138,0.121138
1640,5050,6040,30502000,2,13126,3283,1,389516800,389516800,4921,1640,3281,1640,0,1,1642,114566,0.114566
2040,5050,6040,30502000,2,16326,4083,1,425004800,425004800,6121,2040,4081,2040,0,1,2042,347846,0.347846
2440,5050,6040,30502000,2,19526,4883,1,460492800,460492800,7321,2440,4881,2440,0,1,2442,1038561,1.038561
2840,5050,6040,30502000,2,22726,5683,1,495980800,495980800,8521,2840,5681,2840,0,1,2842,1223720,1.22372
3240,5050,6040,30502000,2,25926,6483,1,531468800,531468800,9721,3240,6481,3240,0,1,3242,289842,0.289842
3640,5050,6040,30502000,2,29126,7283,1,566956800,566956800,10921,3640,7281,3640,0,1,3642,630076,0.630076
4040,5050,6040,30502000,2,32326,8083,1,602444800,602444800,12121,4040,8081,4040,0,1,4042,1281571,1.281571
4440,5050,6040,30502000,2,35526,8883,1,637932800,637932800,13321,4440,8881,4440,0,1,4442,1989796,1.989796
4840,5050,6040,30502000,2,38726,9683,1,673420800,673420800,14521,4840,9681,4840,0,1,4842,1766124,1.766124
5240,5050,6040,30502000,2,41926,10483,1,708908800,708908800,15721,5240,10481,5240,0,1,5242,475402,0.475402
5640,5050,6040,30502000,2,45126,11283,1,744396800,744396800,16921,5640,11281,5640,0,1,5642,299434,0.299434
6040,5050,6040,30502000,2,48326,12083,1,779884800,779884800,18121,6040,12081,6040,0,1,6042,4390987,4.390987
6440,5050,6040,30502000,2,51526,12883,1,815372800,815372800,19321,6440,12881,6440,0,1,6442,87942,0.087942
6840,5050,6040,30502000,2,54726,13683,1,850860800,850860800,20521,6840,13681,6840,0,1,6842,3064586,3.064586
35,6050,5045,30522250,2,286,73,1,247284600,247284600,106,35,71,35,0,1,37,34000,0.034
535,6050,5045,30522250,2,4286,1073,1,291664600,291664600,1606,535,1071,535,0,1,537,1233081,1.233081
1035,6050,5045,30522250,2,8286,2073,1,336044600,336044600,3106,1035,2071,1035,0,1,1037,2002744,2.002744
1535,6050,5045,30522250,2,12286,3073,1,380424600,380424600,4606,1535,3071,1535,0,1,1537,1047449,1.047449
2035,6050,5045,30522250,2,16286,4073,1,424804600,424804600,6106,2035,4071,2035,0,1,2037,4354133,4.354133
2535,6050,5045,30522250,2,20286,5073,1,469184600,469184600,7606,2535,5071,2535,0,1,2537,4116206,4.116206
3035,6050,5045,30522250,2,24286,6073,1,513564600,513564600,9106,3035,6071,3035,0,1,3037,3943102,3.943102
3535,6050,5045,30522250,2,28286,7073,1,557944600,557944600,10606,3535,7071,3535,0,1,3537,1160898,1.160898
4035,6050,5045,30522250,2,32286,8073,1,602324600,602324600,12106,4035,8071,4035,0,1,4037,3615150,3.61515
4535,6050,5045,30522250,2,36286,9073,1,646704600,646704600,13606,4535,9071,4535,0,1,4537,4383574,4.383574
5035,6050,5045,30522250,2,40286,10073,1,691084600,691084600,15106,5035,10071,5035,0,1,5037,7889314,7.889314
5535,6050,5045,30522250,2,44286,11073,1,735464600,735464600,16606,5535,11071,5535,0,1,5537,8752810,8.75281
6035,6050,5045,30522250,2,48286,12073,1,779844600,779844600,18106,6035,12071,6035,0,1,6037,1168790,1.16879
6535,6050,5045,30522250,2,52286,13073,1,824224600,824224600,19606,6535,13071,6535,0,1,6537,14430870,14.43087
7035,6050,5045,30522250,2,56286,14073,1,868604600,868604600,21106,7035,14071,7035,0,1,7037,4667030,4.66703
55,5305,5765,30583325,2,446,113,1,249537400,249537400,166,55,111,55,0,1,57,614602,0.614602
455,5305,5765,30583325,2,3646,913,1,284961400,284961400,1366,455,911,455,0,1,457,453864,0.453864
855,5305,5765,30583325,2,6846,1713,1,320385400,320385400,2566,855,1711,855,0,1,857,636164,0.636164
1255,5305,5765,30583325,2,10046,2513,1,355809400,355809400,3766,1255,2511,1255,0,1,1257,909243,0.909243
1655,5305,5765,30583325,2,13246,3313,1,391233400,391233400,4966,1655,3311,1655,0,1,1657,385177,0.385177
2055,5305,5765,30583325,2,16446,4113,1,426657400,426657400,6166,2055,4111,2055,0,1,2057,3599912,3.599912
2455,5305,5765,30583325,2,19646,4913,1,462081400,462081400,7366,2455,4911,2455,0,1,2457,847097,0.847097
2855,5305,5765,30583325,2,22846,5713,1,497505400,497505400,8566,2855,5711,2855,0,1,2857,1852874,1.852874
3255,5305,5765,30583325,2,26046,6513,1,532929400,532929400,9766,3255,6511,3255,0,1,3257,3629254,3.629254
3655,5305,5765,30583325,2,29246,7313,1,568353400,568353400,10966,3655,7311,3655,0,1,3657,436572,0.436572
4055,5305,5765,30583325,2,32446,8113,1,603777400,603777400,12166,4055,8111,4055,0,1,4057,1528768,1.528768
4455,5305,5765,30583325,2,35646,8913,1,639201400,639201400,13366,4455,8911,4455,0,1,4457,4584892,4.584892
4855,5305,5765,30583325,2,38846,9713,1,674625400,674625400,14566,4855,9711,4855,0,1,4857,2314188,2.314188
5255,5305,5765,30583325,2,42046,10513,1,710049400,710049400,15766,5255,10511,5255,0,1,5257,384905,0.384905
5655,5305,5765,30583325,2,45246,11313,1,745473400,745473400,16966,5655,11311,5655,0,1,5657,1552616,1.552616
6055,5305,5765,30583325,2,48446,12113,1,780897400,780897400,18166,6055,12111,6055,0,1,6057,3873824,3.873824
6455,5305,5765,30583325,2,51646,12913,1,816321400,816321400,19366,6455,12911,6455,0,1,6457,1507927,1.507927
6855,5305,5765,30583325,2,54846,13713,1,851745400,851745400,20566,6855,13711,6855,0,1,6857,2348547,2.348547
55,4805,6365,30583825,2,446,113,1,249585400,249585400,166,55,111,55,0,1,57,51134,0.051134
455,4805,6365,30583825,2,3646,913,1,285329400,285329400,1366,455,911,455,0,1,457,2842681,2.842681
855,4805,6365,30583825,2,6846,1713,1,321073400,321073400,2566,855,1711,855,0,1,857,16724,0.016724
1255,4805,6365,30583825,2,10046,2513,1,356817400,356817400,3766,1255,2511,1255,0,1,1257,1021489,1.021489
1655,4805,6365,30583825,2,13246,3313,1,392561400,392561400,4966,1655,3311,1655,0,1,1657,3357918,3.357918
2055,4805,6365,30583825,2,16446,4113,1,428305400,428305400,6166,2055,4111,2055,0,1,2057,2102498,2.102498
2455,4805,6365,30583825,2,19646,4913,1,464049400,464049400,7366,2455,4911,2455,0,1,2457,1115029,1.115029
2855,4805,6365,30583825,2,22846,5713,1,499793400,499793400,8566,2855,5711,2855,0,1,2857,9244333,9.244333
3255,4805,6365,30583825,2,26046,6513,1,535537400,535537400,9766,3255,6511,3255,0,1,3257,804152,0.804152
3655,4805,6365,30583825,2,29246,7313,1,571281400,571281400,10966,3655,7311,3655,0,1,3657,10879872,10.879872
4055,4805,6365,30583825,2,32446,8113,1,607025400,607025400,12166,4055,8111,4055,0,1,4057,137239,0.137239
4455,4805,6365,30583825,2,35646,8913,1,642769400,642769400,13366,4455,8911,4455,0,1,4457,541729,0.541729
4855,4805,6365,30583825,2,38846,9713,1,678513400,678513400,14566,4855,9711,4855,0,1,4857,2407447,2.407447
5255,4805,6365,30583825,2,42046,10513,1,714257400,714257400,15766,5255,10511,5255,0,1,5257,4103107,4.103107
5655,4805,6365,30583825,2,45246,11313,1,750001400,750001400,16966,5655,11311,5655,0,1,5657,6191287,6.191287
6055,4805,6365,30583825,2,48446,12113,1,785745400,785745400,18166,6055,12111,6055,0,1,6057,1601295,1.601295
6455,4805,6365,30583825,2,51646,12913,1,821489400,821489400,19366,6455,12911,6455,0,1,6457,6532089,6.532089
6855,4805,6365,30583825,2,54846,13713,1,857233400,857233400,20566,6855,13711,6855,0,1,6857,5124976,5.124976
55,5055,6065,30658575,2,446,113,1,250161400,250161400,166,55,111,55,0,1,57,43102,0.043102
455,5055,6065,30658575,2,3646,913,1,285745400,285745400,1366,455,911,455,0,1,457,144963,0.144963
855,5055,6065,30658575,2,6846,1713,1,321329400,321329400,2566,855,1711,855,0,1,857,665691,0.665691
1255,5055,6065,30658575,2,10046,2513,1,356913400,356913400,3766,1255,2511,1255,0,1,1257,324774,0.324774
1655,5055,6065,30658575,2,13246,3313,1,392497400,392497400,4966,1655,3311,1655,0,1,1657,280059,0.280059
2055,5055,6065,30658575,2,16446,4113,1,428081400,428081400,6166,2055,4111,2055,0,1,2057,728088,0.728088
2455,5055,6065,30658575,2,19646,4913,1,463665400,463665400,7366,2455,4911,2455,0,1,2457,99693,0.099693
2855,5055,6065,30658575,2,22846,5713,1,499249400,499249400,8566,2855,5711,2855,0,1,2857,519792,0.519792
3255,5055,6065,30658575,2,26046,6513,1,534833400,534833400,9766,3255,6511,3255,0,1,3257,150342,0.150342
3655,5055,6065,30658575,2,29246,7313,1,570417400,570417400,10966,3655,7311,3655,0,1,3657,686599,0.686599
4055,5055,6065,30658575,2,32446,8113,1,606001400,606001400,12166,4055,8111,4055,0,1,4057,448338,0.448338
4455,5055,6065,30658575,2,35646,8913,1,641585400,641585400,13366,4455,8911,4455,0,1,4457,1375457,1.375457
4855,5055,6065,30658575,2,38846,9713,1,677169400,677169400,14566,4855,9711,4855,0,1,4857,719777,0.719777
5255,5055,6065,30658575,2,42046,10513,1,712753400,712753400,15766,5255,10511,5255,0,1,5257,1294636,1.294636
5655,5055,6065,30658575,2,45246,11313,1,748337400,748337400,16966,5655,11311,5655,0,1,5657,2901117,2.901117
6055,5055,6065,30658575,2,48446,12113,1,783921400,783921400,18166,6055,12111,6055,0,1,6057,2173519,2.173519
6455,5055,6065,30658575,2,51646,12913,1,819505400,819505400,19366,6455,12911,6455,0,1,6457,756958,0.756958
6855,5055,6065,30658575,2,54846,13713,1,855089400,855089400,20566,6855,13711,6855,0,1,6857,1491528,1.491528
55,6305,4865,30673825,2,446,113,1,250305400,250305400,166,55,111,55,0,1,57,610619,0.610619
455,6305,4865,30673825,2,3646,913,1,286049400,286049400,1366,455,911,455,0,1,457,2883510,2.88351
855,6305,4865,30673825,2,6846,1713,1,321793400,321793400,2566,855,1711,855,0,1,857,1233803,1.233803
1255,6305,4865,30673825,2,10046,2513,1,357537400,357537400,3766,1255,2511,1255,0,1,1257,7475299,7.475299
1655,6305,4865,30673825,2,13246,3313,1,393281400,393281400,4966,1655,3311,1655,0,1,1657,2000876,2.000876
2055,6305,4865,30673825,2,16446,4113,1,429025400,429025400,6166,2055,4111,2055,0,1,2057,2564999,2.564999
2455,6305,4865,30673825,2,19646,4913,1,464769400,464769400,7366,2455,4911,2455,0,1,2457,6098579,6.098579
2855,6305,4865,30673825,2,22846,5713,1,500513400,500513400,8566,2855,5711,2855,0,1,2857,3179255,3.179255
3255,6305,4865,30673825,2,26046,6513,1,536257400,536257400,9766,3255,6511,3255,0,1,3257,635986,0.635986
3655,6305,4865,30673825,2,29246,7313,1,572001400,572001400,10966,3655,7311,3655,0,1,3657,2709115,2.709115
4055,6305,4865,30673825,2,32446,8113,1,607745400,607745400,12166,4055,8111,4055,0,1,4057,3058024,3.058024
4455,6305,4865,30673825,2,35646,8913,1,643489400,643489400,13366,4455,8911,4455,0,1,4457,3625399,3.625399
4855,6305,4865,30673825,2,38846,9713,1,679233400,679233400,14566,4855,9711,4855,0,1,4857,1080819,1.080819
5255,6305,4865,30673825,2,42046,10513,1,714977400,714977400,15766,5255,10511,5255,0,1,5257,10302517,10.302517
5655,6305,4865,30673825,2,45246,11313,1,750721400,750721400,16966,5655,11311,5655,0,1,5657,11687244,11.687244
6055,6305,4865,30673825,2,48446,12113,1,786465400,786465400,18166,6055,12111,6055,0,1,6057,4393420,4.39342
6455,6305,4865,30673825,2,51646,12913,1,822209400,822209400,19366,6455,12911,6455,0,1,6457,19425501,19.425501
6855,6305,4865,30673825,2,54846,13713,1,857953400,857953400,20566,6855,13711,6855,0,1,6857,40015894,40.015894
39,5543,5541,30713763,2,318,81,1,249168312,249168312,118,39,79,39,0,1,41,345,0.000345
539,5543,5541,30713763,2,4318,1081,1,293504312,293504312,1618,539,1079,539,0,1,541,177745,0.177745
1039,5543,5541,30713763,2,8318,2081,1,337840312,337840312,3118,1039,2079,1039,0,1,1041,513859,0.513859
1539,5543,5541,30713763,2,12318,3081,1,382176312,382176312,4618,1539,3079,1539,0,1,1541,612676,0.612676
2039,5543,5541,30713763,2,16318,4081,1,426512312,426512312,6118,2039,4079,2039,0,1,2041,1075899,1.075899
2539,5543,5541,30713763,2,20318,5081,1,470848312,470848312,7618,2539,5079,2539,0,1,2541,1587369,1.587369
3039,5543,5541,30713763,2,24318,6081,1,515184312,515184312,9118,3039,6079,3039,0,1,3041,400859,0.400859
3539,5543,5541,30713763,2,28318,7081,1,559520312,559520312,10618,3539,7079,3539,0,1,3541,340188,0.340188
4039,5543,5541,30713763,2,32318,8081,1,603856312,603856312,12118,4039,8079,4039,0,1,4041,317676,0.317676
4539,5543,5541,30713763,2,36318,9081,1,648192312,648192312,13618,4539,9079,4539,0,1,4541,340611,0.340611
5039,5543,5541,30713763,2,40318,10081,1,692528312,692528312,15118,5039,10079,5039,0,1,5041,1739307,1.739307
5539,5543,5541,30713763,2,44318,11081,1,736864312,736864312,16618,5539,11079,5539,0,1,5541,3890083,3.890083
6039,5543,5541,30713763,2,48318,12081,1,781200312,781200312,18118,6039,12079,6039,0,1,6041,9388492,9.388492
6539,5543,5541,30713763,2,52318,13081,1,825536312,825536312,19618,6539,13079,6539,0,1,6541,1147042,1.147042
7039,5543,5541,30713763,2,56318,14081,1,869872312,869872312,21118,7039,14079,7039,0,1,7041,640771,0.640771
39,6093,5041,30714813,2,318,81,1,249192312,249192312,118,39,79,39,0,1,41,53644,0.053644
539,6093,5041,30714813,2,4318,1081,1,293728312,293728312,1618,539,1079,539,0,1,541,22891,0.022891
1039,6093,5041,30714813,2,8318,2081,1,338264312,338264312,3118,1039,2079,1039,0,1,1041,111379,0.111379
1539,6093,5041,30714813,2,12318,3081,1,382800312,382800312,4618,1539,3079,1539,0,1,1541,345550,0.34555
2039,6093,5041,30714813,2,16318,4081,1,427336312,427336312,6118,2039,4079,2039,0,1,2041,1147971,1.147971
2539,6093,5041,30714813,2,20318,5081,1,471872312,471872312,7618,2539,5079,2539,0,1,2541,1098396,1.098396
3039,6093,5041,30714813,2,24318,6081,1,516408312,516408312,9118,3039,6079,3039,0,1,3041,4097191,4.097191
3539,6093,5041,30714813,2,28318,7081,1,560944312,560944312,10618,3539,7079,3539,0,1,3541,1042854,1.042854
4039,6093,5041,30714813,2,32318,8081,1,605480312,605480312,12118,4039,8079,4039,0,1,4041,5150394,5.150394
4539,6093,5041,30714813,2,36318,9081,1,650016312,650016312,13618,4539,9079,4539,0,1,4541,366486,0.366486
5039,6093,5041,30714813,2,40318,10081,1,694552312,694552312,15118,5039,10079,5039,0,1,5041,3800631,3.800631
5539,6093,5041,30714813,2,44318,11081,1,739088312,739088312,16618,5539,11079,5539,0,1,5541,1842184,1.842184
6039,6093,5041,30714813,2,48318,12081,1,783624312,783624312,18118,6039,12079,6039,0,1,6041,2963780,2.96378
6539,6093,5041,30714813,2,52318,13081,1,828160312,828160312,19618,6539,13079,6539,0,1,6541,2776873,2.776873
7039,6093,5041,30714813,2,56318,14081,1,872696312,872696312,21118,7039,14079,7039,0,1,7041,3888814,3.888814
35,5540,5545,30719300,2,286,73,1,248858200,248858200,106,35,71,35,0,1,37,277509,0.277509
535,5540,5545,30719300,2,4286,1073,1,293198200,293198200,1606,535,1071,535,0,1,537,431509,0.431509
1035,5540,5545,30719300,2,8286,2073,1,337538200,337538200,3106,1035,2071,1035,0,1,1037,3076407,3.076407
1535,5540,5545,30719300,2,12286,3073,1,381878200,381878200,4606,1535,3071,1535,0,1,1537,6876854,6.876854
35,6090,5045,30724050,2,286,73,1,248910200,248910200,106,35,71,35,0,1,37,273984,0.273984
535,6090,5045,30724050,2,4286,1073,1,293450200,293450200,1606,535,1071,535,0,1,537,2873195,2.873195
1035,6090,5045,30724050,2,8286,2073,1,337990200,337990200,3106,1035,2071,1035,0,1,1037,3354527,3.354527
1535,6090,5045,30724050,2,12286,3073,1,382530200,382530200,4606,1535,3071,1535,0,1,1537,1093455,1.093455
44,5553,5555,30846915,2,358,91,1,250685336,250685336,133,44,89,44,0,1,46,53359,0.053359
544,5553,5555,30846915,2,4358,1091,1,295117336,295117336,1633,544,1089,544,0,1,546,153730,0.15373
1044,5553,5555,30846915,2,8358,2091,1,339549336,339549336,3133,1044,2089,1044,0,1,1046,441878,0.441878
1544,5553,5555,30846915,2,12358,3091,1,383981336,383981336,4633,1544,3089,1544,0,1,1546,592801,0.592801
2044,5553,5555,30846915,2,16358,4091,1,428413336,428413336,6133,2044,4089,2044,0,1,2046,1575539,1.575539
2544,5553,5555,30846915,2,20358,5091,1,472845336,472845336,7633,2544,5089,2544,0,1,2546,188725,0.188725
3044,5553,5555,30846915,2,24358,6091,1,517277336,517277336,9133,3044,6089,3044,0,1,3046,96137,0.096137
3544,5553,5555,30846915,2,28358,7091,1,561709336,561709336,10633,3544,7089,3544,0,1,3546,990885,0.990885
4044,5553,5555,30846915,2,32358,8091,1,606141336,606141336,12133,4044,8089,4044,0,1,4046,772702,0.772702
4544,5553,5555,30846915,2,36358,9091,1,650573336,650573336,13633,4544,9089,4544,0,1,4546,224829,0.224829
5044,5553,5555,30846915,2,40358,10091,1,695005336,695005336,15133,5044,10089,5044,0,1,5046,7161865,7.161865
5544,5553,5555,30846915,2,44358,11091,1,739437336,739437336,16633,5544,11089,5544,0,1,5546,6037801,6.037801
6044,5553,5555,30846915,2,48358,12091,1,783869336,783869336,18133,6044,12089,6044,0,1,6046,6485458,6.485458
6544,5553,5555,30846915,2,52358,13091,1,828301336,828301336,19633,6544,13089,6544,0,1,6546,1720891,1.720891
7044,5553,5555,30846915,2,56358,14091,1,872733336,872733336,21133,7044,14089,7044,0,1,7046,6501582,6.501582
44,6103,5055,30850665,2,358,91,1,250732936,250732936,133,44,89,44,0,1,46,23534,0.023534
544,6103,5055,30850665,2,4358,1091,1,295364936,295364936,1633,544,1089,544,0,1,546,57823,0.057823
1044,6103,5055,30850665,2,8358,2091,1,339996936,339996936,3133,1044,2089,1044,0,1,1046,393260,0.39326
1544,6103,5055,30850665,2,12358,3091,1,384628936,384628936,4633,1544,3089,1544,0,1,1546,39798,0.039798
2044,6103,5055,30850665,2,16358,4091,1,429260936,429260936,6133,2044,4089,2044,0,1,2046,696164,0.696164
2544,6103,5055,30850665,2,20358,5091,1,473892936,473892936,7633,2544,5089,2544,0,1,2546,2222389,2.222389
3044,6103,5055,30850665,2,24358,6091,1,518524936,518524936,9133,3044,6089,3044,0,1,3046,5168194,5.168194
3544,6103,5055,30850665,2,28358,7091,1,563156936,563156936,10633,3544,7089,3544,0,1,3546,1619681,1.619681
4044,6103,5055,30850665,2,32358,8091,1,607788936,607788936,12133,4044,8089,4044,0,1,4046,274702,0.274702
4544,6103,5055,30850665,2,36358,9091,1,652420936,652420936,13633,4544,9089,4544,0,1,4546,3117187,3.117187
5044,6103,5055,30850665,2,40358,10091,1,697052936,697052936,15133,5044,10089,5044,0,1,5046,944801,0.944801
5544,6103,5055,30850665,2,44358,11091,1,741684936,741684936,16633,5544,11089,5544,0,1,5546,619474,0.619474
6044,6103,5055,30850665,2,48358,12091,1,786316936,786316936,18133,6044,12089,6044,0,1,6046,3111967,3.111967
6544,6103,5055,30850665,2,52358,13091,1,830948936,830948936,19633,6544,13089,6544,0,1,6546,1252395,1.252395
7044,6103,5055,30850665,2,56358,14091,1,875580936,875580936,21133,7044,14089,7044,0,1,7046,698071,0.698071
40,6800,4540,30872000,2,326,83,1,250604800,250604800,121,40,81,40,0,1,42,545917,0.545917
440,6800,4540,30872000,2,3526,883,1,286892800,286892800,1321,440,881,440,0,1,442,2550783,2.550783
840,6800,4540,30872000,2,6726,1683,1,323180800,323180800,2521,840,1681,840,0,1,842,754847,0.754847
1240,6800,4540,30872000,2,9926,2483,1,359468800,359468800,3721,1240,2481,1240,0,1,1242,3016960,3.01696
1640,6800,4540,30872000,2,13126,3283,1,395756800,395756800,4921,1640,3281,1640,0,1,1642,2240187,2.240187
2040,6800,4540,30872000,2,16326,4083,1,432044800,432044800,6121,2040,4081,2040,0,1,2042,5273778,5.273778
2440,6800,4540,30872000,2,19526,4883,1,468332800,468332800,7321,2440,4881,2440,0,1,2442,2557525,2.557525
2840,6800,4540,30872000,2,22726,5683,1,504620800,504620800,8521,2840,5681,2840,0,1,2842,885903,0.885903
3240,6800,4540,30872000,2,25926,6483,1,540908800,540908800,9721,3240,6481,3240,0,1,3242,1707951,1.707951
3640,6800,4540,30872000,2,29126,7283,1,577196800,577196800,10921,3640,7281,3640,0,1,3642,2066871,2.066871
4040,6800,4540,30872000,2,32326,8083,1,613484800,613484800,12121,4040,8081,4040,0,1,4042,803313,0.803313
4440,6800,4540,30872000,2,35526,8883,1,649772800,649772800,13321,4440,8881,4440,0,1,4442,2464799,2.464799
4840,6800,4540,30872000,2,38726,9683,1,686060800,686060800,14521,4840,9681,4840,0,1,4842,319858,0.319858
5240,6800,4540,30872000,2,41926,10483,1,722348800,722348800,15721,5240,10481,5240,0,1,5242,311192,0.311192
5640,6800,4540,30872000,2,45126,11283,1,758636800,758636800,16921,5640,11281,5640,0,1,5642,1374213,1.374213
6040,6800,4540,30872000,2,48326,12083,1,794924800,794924800,18121,6040,12081,6040,0,1,6042,590477,0.590477
6440,6800,4540,30872000,2,51526,12883,1,831212800,831212800,19321,6440,12881,6440,0,1,6442,1203973,1.203973
6840,6800,4540,30872000,2,54726,13683,1,867500800,867500800,20521,6840,13681,6840,0,1,6842,239504,0.239504
35,4400,7045,30998000,2,286,73,1,251188600,251188600,106,35,71,35,0,1,37,70459,0.070459
535,4400,7045,30998000,2,4286,1073,1,296968600,296968600,1606,535,1071,535,0,1,537,1021967,1.021967
1035,4400,7045,30998000,2,8286,2073,1,342748600,342748600,3106,1035,2071,1035,0,1,1037,308751,0.308751
1535,4400,7045,30998000,2,12286,3073,1,388528600,388528600,4606,1535,3071,1535,0,1,1537,4453375,4.453375
2035,4400,7045,30998000,2,16286,4073,1,434308600,434308600,6106,2035,4071,2035,0,1,2037,1470285,1.470285
2535,4400,7045,30998000,2,20286,5073,1,480088600,480088600,7606,2535,5071,2535,0,1,2537,1822820,1.82282
3035,4400,7045,30998000,2,24286,6073,1,525868600,525868600,9106,3035,6071,3035,0,1,3037,1542958,1.542958
3535,4400,7045,30998000,2,28286,7073,1,571648600,571648600,10606,3535,7071,3535,0,1,3537,6700545,6.700545
4035,4400,7045,30998000,2,32286,8073,1,617428600,617428600,12106,4035,8071,4035,0,1,4037,191855,0.191855
4535,4400,7045,30998000,2,36286,9073,1,663208600,663208600,13606,4535,9071,4535,0,1,4537,451430,0.45143
5035,4400,7045,30998000,2,40286,10073,1,708988600,708988600,15106,5035,10071,5035,0,1,5037,1035564,1.035564
5535,4400,7045,30998000,2,44286,11073,1,754768600,754768600,16606,5535,11071,5535,0,1,5537,3770711,3.770711
6035,4400,7045,30998000,2,48286,12073,1,800548600,800548600,18106,6035,12071,6035,0,1,6037,927452,0.927452
6535,4400,7045,30998000,2,52286,13073,1,846328600,846328600,19606,6535,13071,6535,0,1,6537,3014396,3.014396
7035,4400,7045,30998000,2,56286,14073,1,892108600,892108600,21106,7035,14071,7035,0,1,7037,5362503,5.362503
55,6805,4565,31064825,2,446,113,1,253521400,253521400,166,55,111,55,0,1,57,629508,0.629508
455,6805,4565,31064825,2,3646,913,1,289905400,289905400,1366,455,911,455,0,1,457,1514688,1.514688
855,6805,4565,31064825,2,6846,1713,1,326289400,326289400,2566,855,1711,855,0,1,857,1202967,1.202967
1255,6805,4565,31064825,2,10046,2513,1,362673400,362673400,3766,1255,2511,1255,0,1,1257,108546,0.108546
1655,6805,4565,31064825,2,13246,3313,1,399057400,399057400,4966,1655,3311,1655,0,1,1657,5208784,5.208784
2055,6805,4565,31064825,2,16446,4113,1,435441400,435441400,6166,2055,4111,2055,0,1,2057,1250184,1.250184
2455,6805,4565,31064825,2,19646,4913,1,471825400,471825400,7366,2455,4911,2455,0,1,2457,5107394,5.107394
2855,6805,4565,31064825,2,22846,5713,1,508209400,508209400,8566,2855,5711,2855,0,1,2857,396899,0.396899
3255,6805,4565,31064825,2,26046,6513,1,544593400,544593400,9766,3255,6511,3255,0,1,3257,12624266,12.624266
3655,6805,4565,31064825,2,29246,7313,1,580977400,580977400,10966,3655,7311,3655,0,1,3657,2011661,2.011661
4055,6805,4565,31064825,2,32446,8113,1,617361400,617361400,12166,4055,8111,4055,0,1,4057,207954,0.207954
4455,6805,4565,31064825,2,35646,8913,1,653745400,653745400,13366,4455,8911,4455,0,1,4457,4111299,4.111299
4855,6805,4565,31064825,2,38846,9713,1,690129400,690129400,14566,4855,9711,4855,0,1,4857,11652004,11.652004
5255,6805,4565,31064825,2,42046,10513,1,726513400,726513400,15766,5255,10511,5255,0,1,5257,1600424,1.600424
5655,6805,4565,31064825,2,45246,11313,1,762897400,762897400,16966,5655,11311,5655,0,1,5657,200389,0.200389
6055,6805,4565,31064825,2,48446,12113,1,799281400,799281400,18166,6055,12111,6055,0,1,6057,2146126,2.146126
6455,6805,4565,31064825,2,51646,12913,1,835665400,835665400,19366,6455,12911,6455,0,1,6457,417173,0.417173
6855,6805,4565,31064825,2,54846,13713,1,872049400,872049400,20566,6855,13711,6855,0,1,6857,305504,0.305504
40,6050,5140,31097000,2,326,83,1,252356800,252356800,121,40,81,40,0,1,42,549154,0.549154
440,6050,5140,31097000,2,3526,883,1,288164800,288164800,1321,440,881,440,0,1,442,628060,0.62806
840,6050,5140,31097000,2,6726,1683,1,323972800,323972800,2521,840,1681,840,0,1,842,2233560,2.23356
1240,6050,5140,31097000,2,9926,2483,1,359780800,359780800,3721,1240,2481,1240,0,1,1242,379355,0.379355
1640,6050,5140,31097000,2,13126,3283,1,395588800,395588800,4921,1640,3281,1640,0,1,1642,1954007,1.954007
2040,6050,5140,31097000,2,16326,4083,1,431396800,431396800,6121,2040,4081,2040,0,1,2042,1810995,1.810995
2440,6050,5140,31097000,2,19526,4883,1,467204800,467204800,7321,2440,4881,2440,0,1,2442,187785,0.187785
2840,6050,5140,31097000,2,22726,5683,1,503012800,503012800,8521,2840,5681,2840,0,1,2842,721967,0.721967
3240,6050,5140,31097000,2,25926,6483,1,538820800,538820800,9721,3240,6481,3240,0,1,3242,674199,0.674199
3640,6050,5140,31097000,2,29126,7283,1,574628800,574628800,10921,3640,7281,3640,0,1,3642,531212,0.531212
4040,6050,5140,31097000,2,32326,8083,1,610436800,610436800,12121,4040,8081,4040,0,1,4042,5795012,5.795012
4440,6050,5140,31097000,2,35526,8883,1,646244800,646244800,13321,4440,8881,4440,0,1,4442,327963,0.327963
4840,6050,5140,31097000,2,38726,9683,1,682052800,682052800,14521,4840,9681,4840,0,1,4842,2260529,2.260529
5240,6050,5140,31097000,2,41926,10483,1,717860800,717860800,15721,5240,10481,5240,0,1,5242,1916772,1.916772
5640,6050,5140,31097000,2,45126,11283,1,753668800,753668800,16921,5640,11281,5640,0,1,5642,1396686,1.396686
6040,6050,5140,31097000,2,48326,12083,1,789476800,789476800,18121,6040,12081,6040,0,1,6042,3066595,3.066595
6440,6050,5140,31097000,2,51526,12883,1,825284800,825284800,19321,6440,12881,6440,0,1,6442,3277968,3.277968
6840,6050,5140,31097000,2,54726,13683,1,861092800,861092800,20521,6840,13681,6840,0,1,6842,6863250,6.86325
55,6055,5165,31274075,2,446,113,1,255129400,255129400,166,55,111,55,0,1,57,477689,0.477689
455,6055,5165,31274075,2,3646,913,1,291033400,291033400,1366,455,911,455,0,1,457,1837894,1.837894
855,6055,5165,31274075,2,6846,1713,1,326937400,326937400,2566,855,1711,855,0,1,857,1408134,1.408134
1255,6055,5165,31274075,2,10046,2513,1,362841400,362841400,3766,1255,2511,1255,0,1,1257,7601309,7.601309
1655,6055,5165,31274075,2,13246,3313,1,398745400,398745400,4966,1655,3311,1655,0,1,1657,3501969,3.501969
2055,6055,5165,31274075,2,16446,4113,1,434649400,434649400,6166,2055,4111,2055,0,1,2057,112265,0.112265
2455,6055,5165,31274075,2,19646,4913,1,470553400,470553400,7366,2455,4911,2455,0,1,2457,1747234,1.747234
2855,6055,5165,31274075,2,22846,5713,1,506457400,506457400,8566,2855,5711,2855,0,1,2857,637175,0.637175
3255,6055,5165,31274075,2,26046,6513,1,542361400,542361400,9766,3255,6511,3255,0,1,3257,676891,0.676891
3655,6055,5165,31274075,2,29246,7313,1,578265400,578265400,10966,3655,7311,3655,0,1,3657,2361620,2.36162
4055,6055,5165,31274075,2,32446,8113,1,614169400,614169400,12166,4055,8111,4055,0,1,4057,3853207,3.853207
4455,6055,5165,31274075,2,35646,8913,1,650073400,650073400,13366,4455,8911,4455,0,1,4457,4667653,4.667653
4855,6055,5165,31274075,2,38846,9713,1,685977400,685977400,14566,4855,9711,4855,0,1,4857,922442,0.922442
5255,6055,5165,31274075,2,42046,10513,1,721881400,721881400,15766,5255,10511,5255,0,1,5257,3692900,3.6929
5655,6055,5165,31274075,2,45246,11313,1,757785400,757785400,16966,5655,11311,5655,0,1,5657,94202,0.094202
6055,6055,5165,31274075,2,48446,12113,1,793689400,793689400,18166,6055,12111,6055,0,1,6057,200802,0.200802
6455,6055,5165,31274075,2,51646,12913,1,829593400,829593400,19366,6455,12911,6455,0,1,6457,4964678,4.964678
6855,6055,5165,31274075,2,54846,13713,1,865497400,865497400,20566,6855,13711,6855,0,1,6857,1726911,1.726911
35,4440,7045,31279800,2,286,73,1,253454200,253454200,106,35,71,35,0,1,37,555948,0.555948
535,4440,7045,31279800,2,4286,1073,1,299394200,299394200,1606,535,1071,535,0,1,537,3381664,3.381664
1035,4440,7045,31279800,2,8286,2073,1,345334200,345334200,3106,1035,2071,1035,0,1,1037,6253347,6.253347
1535,4440,7045,31279800,2,12286,3073,1,391274200,391274200,4606,1535,3071,1535,0,1,1537,9150173,9.150173
2035,4440,7045,31279800,2,16286,4073,1,437214200,437214200,6106,2035,4071,2035,0,1,2037,12060221,12.060221
39,4443,7041,31283163,2,318,81,1,253848312,253848312,118,39,79,39,0,1,41,88303,0.088303
539,4443,7041,31283163,2,4318,1081,1,299784312,299784312,1618,539,1079,539,0,1,541,87242,0.087242
1039,4443,7041,31283163,2,8318,2081,1,345720312,345720312,3118,1039,2079,1039,0,1,1041,202593,0.202593
1539,4443,7041,31283163,2,12318,3081,1,391656312,391656312,4618,1539,3079,1539,0,1,1541,287008,0.287008
2039,4443,7041,31283163,2,16318,4081,1,437592312,437592312,6118,2039,4079,2039,0,1,2041,527356,0.527356
2539,4443,7041,31283163,2,20318,5081,1,483528312,483528312,7618,2539,5079,2539,0,1,2541,29079,0.029079
3039,4443,7041,31283163,2,24318,6081,1,529464312,529464312,9118,3039,6079,3039,0,1,3041,1183998,1.183998
3539,4443,7041,31283163,2,28318,7081,1,575400312,575400312,10618,3539,7079,3539,0,1,3541,200362,0.200362
4039,4443,7041,31283163,2,32318,8081,1,621336312,621336312,12118,4039,8079,4039,0,1,4041,612554,0.612554
4539,4443,7041,31283163,2,36318,9081,1,667272312,667272312,13618,4539,9079,4539,0,1,4541,627969,0.627969
5039,4443,7041,31283163,2,40318,10081,1,713208312,713208312,15118,5039,10079,5039,0,1,5041,26910,0.02691
5539,4443,7041,31283163,2,44318,11081,1,759144312,759144312,16618,5539,11079,5539,0,1,5541,8495495,8.495495
6039,4443,7041,31283163,2,48318,12081,1,805080312,805080312,18118,6039,12079,6039,0,1,6041,2695593,2.695593
6539,4443,7041,31283163,2,52318,13081,1,851016312,851016312,19618,6539,13079,6539,0,1,6541,351060,0.35106
7039,4443,7041,31283163,2,56318,14081,1,896952312,896952312,21118,7039,14079,7039,0,1,7041,390065,0.390065
44,4453,7055,31415915,2,358,91,1,255378136,255378136,133,44,89,44,0,1,46,22934,0.022934
544,4453,7055,31415915,2,4358,1091,1,301410136,301410136,1633,544,1089,544,0,1,546,171208,0.171208
1044,4453,7055,31415915,2,8358,2091,1,347442136,347442136,3133,1044,2089,1044,0,1,1046,207550,0.20755
1544,4453,7055,31415915,2,12358,3091,1,393474136,393474136,4633,1544,3089,1544,0,1,1546,1052901,1.052901
2044,4453,7055,31415915,2,16358,4091,1,439506136,439506136,6133,2044,4089,2044,0,1,2046,1163716,1.163716
2544,4453,7055,31415915,2,20358,5091,1,485538136,485538136,7633,2544,5089,2544,0,1,2546,693864,0.693864
3044,4453,7055,31415915,2,24358,6091,1,531570136,531570136,9133,3044,6089,3044,0,1,3046,258883,0.258883
3544,4453,7055,31415915,2,28358,7091,1,577602136,577602136,10633,3544,7089,3544,0,1,3546,722716,0.722716
4044,4453,7055,31415915,2,32358,8091,1,623634136,623634136,12133,4044,8089,4044,0,1,4046,122990,0.12299
4544,4453,7055,31415915,2,36358,9091,1,669666136,669666136,13633,4544,9089,4544,0,1,4546,1397840,1.39784
5044,4453,7055,31415915,2,40358,10091,1,715698136,715698136,15133,5044,10089,5044,0,1,5046,1194746,1.194746
5544,4453,7055,31415915,2,44358,11091,1,761730136,761730136,16633,5544,11089,5544,0,1,5546,818191,0.818191
6044,4453,7055,31415915,2,48358,12091,1,807762136,807762136,18133,6044,12089,6044,0,1,6046,8859407,8.859407
6544,4453,7055,31415915,2,52358,13091,1,853794136,853794136,19633,6544,13089,6544,0,1,6546,3758913,3.758913
7044,4453,7055,31415915,2,56358,14091,1,899826136,899826136,21133,7044,14089,7044,0,1,7046,5963663,5.963663
40,5800,5440,31552000,2,326,83,1,256012800,256012800,121,40,81,40,0,1,42,43460,0.04346
440,5800,5440,31552000,2,3526,883,1,291980800,291980800,1321,440,881,440,0,1,442,157891,0.157891
840,5800,5440,31552000,2,6726,1683,1,327948800,327948800,2521,840,1681,840,0,1,842,279256,0.279256
1240,5800,5440,31552000,2,9926,2483,1,363916800,363916800,3721,1240,2481,1240,0,1,1242,28946,0.028946
1640,5800,5440,31552000,2,13126,3283,1,399884800,399884800,4921,1640,3281,1640,0,1,1642,602204,0.602204
2040,5800,5440,31552000,2,16326,4083,1,435852800,435852800,6121,2040,4081,2040,0,1,2042,159603,0.159603
2440,5800,5440,31552000,2,19526,4883,1,471820800,471820800,7321,2440,4881,2440,0,1,2442,193193,0.193193
2840,5800,5440,31552000,2,22726,5683,1,507788800,507788800,8521,2840,5681,2840,0,1,2842,347849,0.347849
3240,5800,5440,31552000,2,25926,6483,1,543756800,543756800,9721,3240,6481,3240,0,1,3242,2898165,2.898165
3640,5800,5440,31552000,2,29126,7283,1,579724800,579724800,10921,3640,7281,3640,0,1,3642,1470766,1.470766
4040,5800,5440,31552000,2,32326,8083,1,615692800,615692800,12121,4040,8081,4040,0,1,4042,6286083,6.286083
4440,5800,5440,31552000,2,35526,8883,1,651660800,651660800,13321,4440,8881,4440,0,1,4442,867444,0.867444
4840,5800,5440,31552000,2,38726,9683,1,687628800,687628800,14521,4840,9681,4840,0,1,4842,75258,0.075258
5240,5800,5440,31552000,2,41926,10483,1,723596800,723596800,15721,5240,10481,5240,0,1,5242,892996,0.892996
5640,5800,5440,31552000,2,45126,11283,1,759564800,759564800,16921,5640,11281,5640,0,1,5642,616638,0.616638
6040,5800,5440,31552000,2,48326,12083,1,795532800,795532800,18121,6040,12081,6040,0,1,6042,308957,0.308957
6440,5800,5440,31552000,2,51526,12883,1,831500800,831500800,19321,6440,12881,6440,0,1,6442,895945,0.895945
6840,5800,5440,31552000,2,54726,13683,1,867468800,867468800,20521,6840,13681,6840,0,1,6842,347517,0.347517
40,4550,6940,31577000,2,326,83,1,256292800,256292800,121,40,81,40,0,1,42,573102,0.573102
440,4550,6940,31577000,2,3526,883,1,293060800,293060800,1321,440,881,440,0,1,442,1609904,1.609904
840,4550,6940,31577000,2,6726,1683,1,329828800,329828800,2521,840,1681,840,0,1,842,885785,0.885785
1240,4550,6940,31577000,2,9926,2483,1,366596800,366596800,3721,1240,2481,1240,0,1,1242,1266709,1.266709
1640,4550,6940,31577000,2,13126,3283,1,403364800,403364800,4921,1640,3281,1640,0,1,1642,8259231,8.259231
2040,4550,6940,31577000,2,16326,4083,1,440132800,440132800,6121,2040,4081,2040,0,1,2042,940347,0.940347
2440,4550,6940,31577000,2,19526,4883,1,476900800,476900800,7321,2440,4881,2440,0,1,2442,1746298,1.746298
2840,4550,6940,31577000,2,22726,5683,1,513668800,513668800,8521,2840,5681,2840,0,1,2842,12043783,12.043783
3240,4550,6940,31577000,2,25926,6483,1,550436800,550436800,9721,3240,6481,3240,0,1,3242,4545294,4.545294
3640,4550,6940,31577000,2,29126,7283,1,587204800,587204800,10921,3640,7281,3640,0,1,3642,4206156,4.206156
4040,4550,6940,31577000,2,32326,8083,1,623972800,623972800,12121,4040,8081,4040,0,1,4042,5024256,5.024256
4440,4550,6940,31577000,2,35526,8883,1,660740800,660740800,13321,4440,8881,4440,0,1,4442,222317,0.222317
4840,4550,6940,31577000,2,38726,9683,1,697508800,697508800,14521,4840,9681,4840,0,1,4842,732638,0.732638
5240,4550,6940,31577000,2,41926,10483,1,734276800,734276800,15721,5240,10481,5240,0,1,5242,2818728,2.818728
5640,4550,6940,31577000,2,45126,11283,1,771044800,771044800,16921,5640,11281,5640,0,1,5642,695948,0.695948
6040,4550,6940,31577000,2,48326,12083,1,807812800,807812800,18121,6040,12081,6040,0,1,6042,707460,0.70746
6440,4550,6940,31577000,2,51526,12883,1,844580800,844580800,19321,6440,12881,6440,0,1,6442,921740,0.92174
6840,4550,6940,31577000,2,54726,13683,1,881348800,881348800,20521,6840,13681,6840,0,1,6842,1926666,1.926666
40,6550,4840,31702000,2,326,83,1,257260800,257260800,121,40,81,40,0,1,42,531,0.000531
440,6550,4840,31702000,2,3526,883,1,293708800,293708800,1321,440,881,440,0,1,442,112622,0.112622
840,6550,4840,31702000,2,6726,1683,1,330156800,330156800,2521,840,1681,840,0,1,842,809158,0.809158
1240,6550,4840,31702000,2,9926,2483,1,366604800,366604800,3721,1240,2481,1240,0,1,1242,331428,0.331428
1640,6550,4840,31702000,2,13126,3283,1,403052800,403052800,4921,1640,3281,1640,0,1,1642,177040,0.17704
2040,6550,4840,31702000,2,16326,4083,1,439500800,439500800,6121,2040,4081,2040,0,1,2042,752906,0.752906
2440,6550,4840,31702000,2,19526,4883,1,475948800,475948800,7321,2440,4881,2440,0,1,2442,1543647,1.543647
2840,6550,4840,31702000,2,22726,5683,1,512396800,512396800,8521,2840,5681,2840,0,1,2842,332333,0.332333
3240,6550,4840,31702000,2,25926,6483,1,548844800,548844800,9721,3240,6481,3240,0,1,3242,909578,0.909578
3640,6550,4840,31702000,2,29126,7283,1,585292800,585292800,10921,3640,7281,3640,0,1,3642,1017363,1.017363
4040,6550,4840,31702000,2,32326,8083,1,621740800,621740800,12121,4040,8081,4040,0,1,4042,1187318,1.187318
4440,6550,4840,31702000,2,35526,8883,1,658188800,658188800,13321,4440,8881,4440,0,1,4442,781367,0.781367
4840,6550,4840,31702000,2,38726,9683,1,694636800,694636800,14521,4840,9681,4840,0,1,4842,730818,0.730818
5240,6550,4840,31702000,2,41926,10483,1,731084800,731084800,15721,5240,10481,5240,0,1,5242,1120293,1.120293
5640,6550,4840,31702000,2,45126,11283,1,767532800,767532800,16921,5640,11281,5640,0,1,5642,949788,0.949788
6040,6550,4840,31702000,2,48326,12083,1,803980800,803980800,18121,6040,12081,6040,0,1,6042,1122655,1.122655
6440,6550,4840,31702000,2,51526,12883,1,840428800,840428800,19321,6440,12881,6440,0,1,6442,889351,0.889351
6840,6550,4840,31702000,2,54726,13683,1,876876800,876876800,20521,6840,13681,6840,0,1,6842,900758,0.900758
55,5805,5465,31724325,2,446,113,1,258753400,258753400,166,55,111,55,0,1,57,1099,0.001099
455,5805,5465,31724325,2,3646,913,1,294817400,294817400,1366,455,911,455,0,1,457,42476,0.042476
855,5805,5465,31724325,2,6846,1713,1,330881400,330881400,2566,855,1711,855,0,1,857,93027,0.093027
1255,5805,5465,31724325,2,10046,2513,1,366945400,366945400,3766,1255,2511,1255,0,1,1257,83713,0.083713
1655,5805,5465,31724325,2,13246,3313,1,403009400,403009400,4966,1655,3311,1655,0,1,1657,2330389,2.330389
2055,5805,5465,31724325,2,16446,4113,1,439073400,439073400,6166,2055,4111,2055,0,1,2057,375310,0.37531
2455,5805,5465,31724325,2,19646,4913,1,475137400,475137400,7366,2455,4911,2455,0,1,2457,660239,0.660239
2855,5805,5465,31724325,2,22846,5713,1,511201400,511201400,8566,2855,5711,2855,0,1,2857,344976,0.344976
3255,5805,5465,31724325,2,26046,6513,1,547265400,547265400,9766,3255,6511,3255,0,1,3257,194665,0.194665
3655,5805,5465,31724325,2,29246,7313,1,583329400,583329400,10966,3655,7311,3655,0,1,3657,635727,0.635727
4055,5805,5465,31724325,2,32446,8113,1,619393400,619393400,12166,4055,8111,4055,0,1,4057,4424434,4.424434
4455,5805,5465,31724325,2,35646,8913,1,655457400,655457400,13366,4455,8911,4455,0,1,4457,2851059,2.851059
4855,5805,5465,31724325,2,38846,9713,1,691521400,691521400,14566,4855,9711,4855,0,1,4857,407007,0.407007
5255,5805,5465,31724325,2,42046,10513,1,727585400,727585400,15766,5255,10511,5255,0,1,5257,835718,0.835718
5655,5805,5465,31724325,2,45246,11313,1,763649400,763649400,16966,5655,11311,5655,0,1,5657,2783646,2.783646
6055,5805,5465,31724325,2,48446,12113,1,799713400,799713400,18166,6055,12111,6055,0,1,6057,1127291,1.127291
6455,5805,5465,31724325,2,51646,12913,1,835777400,835777400,19366,6455,12911,6455,0,1,6457,1118967,1.118967
6855,5805,5465,31724325,2,54846,13713,1,871841400,871841400,20566,6855,13711,6855,0,1,6857,2072423,2.072423
55,4555,6965,31725575,2,446,113,1,258873400,258873400,166,55,111,55,0,1,57,645336,0.645336
455,4555,6965,31725575,2,3646,913,1,295737400,295737400,1366,455,911,455,0,1,457,1791920,1.79192
855,4555,6965,31725575,2,6846,1713,1,332601400,332601400,2566,855,1711,855,0,1,857,101027,0.101027
1255,4555,6965,31725575,2,10046,2513,1,369465400,369465400,3766,1255,2511,1255,0,1,1257,479997,0.479997
1655,4555,6965,31725575,2,13246,3313,1,406329400,406329400,4966,1655,3311,1655,0,1,1657,6251207,6.251207
2055,4555,6965,31725575,2,16446,4113,1,443193400,443193400,6166,2055,4111,2055,0,1,2057,4758846,4.758846
2455,4555,6965,31725575,2,19646,4913,1,480057400,480057400,7366,2455,4911,2455,0,1,2457,10922080,10.92208
2855,4555,6965,31725575,2,22846,5713,1,516921400,516921400,8566,2855,5711,2855,0,1,2857,6539947,6.539947
3255,4555,6965,31725575,2,26046,6513,1,553785400,553785400,9766,3255,6511,3255,0,1,3257,931311,0.931311
3655,4555,6965,31725575,2,29246,7313,1,590649400,590649400,10966,3655,7311,3655,0,1,3657,305039,0.305039
4055,4555,6965,31725575,2,32446,8113,1,627513400,627513400,12166,4055,8111,4055,0,1,4057,707339,0.707339
4455,4555,6965,31725575,2,35646,8913,1,664377400,664377400,13366,4455,8911,4455,0,1,4457,849228,0.849228
4855,4555,6965,31725575,2,38846,9713,1,701241400,701241400,14566,4855,9711,4855,0,1,4857,3334063,3.334063
5255,4555,6965,31725575,2,42046,10513,1,738105400,738105400,15766,5255,10511,5255,0,1,5257,182608,0.182608
5655,4555,6965,31725575,2,45246,11313,1,774969400,774969400,16966,5655,11311,5655,0,1,5657,3568323,3.568323
6055,4555,6965,31725575,2,48446,12113,1,811833400,811833400,18166,6055,12111,6055,0,1,6057,14372072,14.372072
6455,4555,6965,31725575,2,51646,12913,1,848697400,848697400,19366,6455,12911,6455,0,1,6457,4115531,4.115531
6855,4555,6965,31725575,2,54846,13713,1,885561400,885561400,20566,6855,13711,6855,0,1,6857,5674110,5.67411
40,5550,5740,31857000,2,326,83,1,258468800,258468800,121,40,81,40,0,1,42,583944,0.583944
440,5550,5740,31857000,2,3526,883,1,294596800,294596800,1321,440,881,440,0,1,442,2932913,2.932913
840,5550,5740,31857000,2,6726,1683,1,330724800,330724800,2521,840,1681,840,0,1,842,3114532,3.114532
1240,5550,5740,31857000,2,9926,2483,1,366852800,366852800,3721,1240,2481,1240,0,1,1242,1546663,1.546663
1640,5550,5740,31857000,2,13126,3283,1,402980800,402980800,4921,1640,3281,1640,0,1,1642,693176,0.693176
2040,5550,5740,31857000,2,16326,4083,1,439108800,439108800,6121,2040,4081,2040,0,1,2042,8743705,8.743705
2440,5550,5740,31857000,2,19526,4883,1,475236800,475236800,7321,2440,4881,2440,0,1,2442,8377219,8.377219
2840,5550,5740,31857000,2,22726,5683,1,511364800,511364800,8521,2840,5681,2840,0,1,2842,12321496,12.321496
3240,5550,5740,31857000,2,25926,6483,1,547492800,547492800,9721,3240,6481,3240,0,1,3242,2356243,2.356243
3640,5550,5740,31857000,2,29126,7283,1,583620800,583620800,10921,3640,7281,3640,0,1,3642,1044824,1.044824
4040,5550,5740,31857000,2,32326,8083,1,619748800,619748800,12121,4040,8081,4040,0,1,4042,320196,0.320196
4440,5550,5740,31857000,2,35526,8883,1,655876800,655876800,13321,4440,8881,4440,0,1,4442,371443,0.371443
4840,5550,5740,31857000,2,38726,9683,1,692004800,692004800,14521,4840,9681,4840,0,1,4842,1041697,1.041697
5240,5550,5740,31857000,2,41926,10483,1,728132800,728132800,15721,5240,10481,5240,0,1,5242,2054484,2.054484
5640,5550,5740,31857000,2,45126,11283,1,764260800,764260800,16921,5640,11281,5640,0,1,5642,7899502,7.899502
6040,5550,5740,31857000,2,48326,12083,1,800388800,800388800,18121,6040,12081,6040,0,1,6042,547097,0.547097
6440,5550,5740,31857000,2,51526,12883,1,836516800,836516800,19321,6440,12881,6440,0,1,6442,6686892,6.686892
6840,5550,5740,31857000,2,54726,13683,1,872644800,872644800,20521,6840,13681,6840,0,1,6842,4100493,4.100493
40,4800,6640,31872000,2,326,83,1,258636800,258636800,121,40,81,40,0,1,42,569842,0.569842
440,4800,6640,31872000,2,3526,883,1,295244800,295244800,1321,440,881,440,0,1,442,2796115,2.796115
840,4800,6640,31872000,2,6726,1683,1,331852800,331852800,2521,840,1681,840,0,1,842,5028685,5.028685
1240,4800,6640,31872000,2,9926,2483,1,368460800,368460800,3721,1240,2481,1240,0,1,1242,4354691,4.354691
1640,4800,6640,31872000,2,13126,3283,1,405068800,405068800,4921,1640,3281,1640,0,1,1642,2312318,2.312318
2040,4800,6640,31872000,2,16326,4083,1,441676800,441676800,6121,2040,4081,2040,0,1,2042,155189,0.155189
2440,4800,6640,31872000,2,19526,4883,1,478284800,478284800,7321,2440,4881,2440,0,1,2442,12728869,12.728869
2840,4800,6640,31872000,2,22726,5683,1,514892800,514892800,8521,2840,5681,2840,0,1,2842,3434006,3.434006
3240,4800,6640,31872000,2,25926,6483,1,551500800,551500800,9721,3240,6481,3240,0,1,3242,1439706,1.439706
3640,4800,6640,31872000,2,29126,7283,1,588108800,588108800,10921,3640,7281,3640,0,1,3642,808762,0.808762
4040,4800,6640,31872000,2,32326,8083,1,624716800,624716800,12121,4040,8081,4040,0,1,4042,5407029,5.407029
4440,4800,6640,31872000,2,35526,8883,1,661324800,661324800,13321,4440,8881,4440,0,1,4442,575286,0.575286
4840,4800,6640,31872000,2,38726,9683,1,697932800,697932800,14521,4840,9681,4840,0,1,4842,2821836,2.821836
5240,4800,6640,31872000,2,41926,10483,1,734540800,734540800,15721,5240,10481,5240,0,1,5242,251088,0.251088
5640,4800,6640,31872000,2,45126,11283,1,771148800,771148800,16921,5640,11281,5640,0,1,5642,5797969,5.797969
6040,4800,6640,31872000,2,48326,12083,1,807756800,807756800,18121,6040,12081,6040,0,1,6042,6566370,6.56637
6440,4800,6640,31872000,2,51526,12883,1,844364800,844364800,19321,6440,12881,6440,0,1,6442,3386267,3.386267
6840,4800,6640,31872000,2,54726,13683,1,880972800,880972800,20521,6840,13681,6840,0,1,6842,2477678,2.477678
55,6555,4865,31890075,2,446,113,1,260145400,260145400,166,55,111,55,0,1,57,23612,0.023612
455,6555,4865,31890075,2,3646,913,1,296689400,296689400,1366,455,911,455,0,1,457,24564,0.024564
855,6555,4865,31890075,2,6846,1713,1,333233400,333233400,2566,855,1711,855,0,1,857,122353,0.122353
1255,6555,4865,31890075,2,10046,2513,1,369777400,369777400,3766,1255,2511,1255,0,1,1257,213604,0.213604
1655,6555,4865,31890075,2,13246,3313,1,406321400,406321400,4966,1655,3311,1655,0,1,1657,69107,0.069107
2055,6555,4865,31890075,2,16446,4113,1,442865400,442865400,6166,2055,4111,2055,0,1,2057,301995,0.301995
2455,6555,4865,31890075,2,19646,4913,1,479409400,479409400,7366,2455,4911,2455,0,1,2457,3325723,3.325723
2855,6555,4865,31890075,2,22846,5713,1,515953400,515953400,8566,2855,5711,2855,0,1,2857,277543,0.277543
3255,6555,4865,31890075,2,26046,6513,1,552497400,552497400,9766,3255,6511,3255,0,1,3257,677534,0.677534
3655,6555,4865,31890075,2,29246,7313,1,589041400,589041400,10966,3655,7311,3655,0,1,3657,1566977,1.566977
4055,6555,4865,31890075,2,32446,8113,1,625585400,625585400,12166,4055,8111,4055,0,1,4057,93319,0.093319
4455,6555,4865,31890075,2,35646,8913,1,662129400,662129400,13366,4455,8911,4455,0,1,4457,930872,0.930872
4855,6555,4865,31890075,2,38846,9713,1,698673400,698673400,14566,4855,9711,4855,0,1,4857,761439,0.761439
5255,6555,4865,31890075,2,42046,10513,1,735217400,735217400,15766,5255,10511,5255,0,1,5257,3187625,3.187625
5655,6555,4865,31890075,2,45246,11313,1,771761400,771761400,16966,5655,11311,5655,0,1,5657,554264,0.554264
6055,6555,4865,31890075,2,48446,12113,1,808305400,808305400,18166,6055,12111,6055,0,1,6057,2374011,2.374011
6455,6555,4865,31890075,2,51646,12913,1,844849400,844849400,19366,6455,12911,6455,0,1,6457,1045969,1.045969
6855,6555,4865,31890075,2,54846,13713,1,881393400,881393400,20566,6855,13711,6855,0,1,6857,3022116,3.022116
40,7050,4540,32007000,2,326,83,1,259764800,259764800,121,40,81,40,0,1,42,563451,0.563451
440,7050,4540,32007000,2,3526,883,1,296852800,296852800,1321,440,881,440,0,1,442,2967195,2.967195
840,7050,4540,32007000,2,6726,1683,1,333940800,333940800,2521,840,1681,840,0,1,842,3477708,3.477708
1240,7050,4540,32007000,2,9926,2483,1,371028800,371028800,3721,1240,2481,1240,0,1,1242,586450,0.58645
1640,7050,4540,32007000,2,13126,3283,1,408116800,408116800,4921,1640,3281,1640,0,1,1642,10319865,10.319865
2040,7050,4540,32007000,2,16326,4083,1,445204800,445204800,6121,2040,4081,2040,0,1,2042,5387616,5.387616
2440,7050,4540,32007000,2,19526,4883,1,482292800,482292800,7321,2440,4881,2440,0,1,2442,5909215,5.909215
2840,7050,4540,32007000,2,22726,5683,1,519380800,519380800,8521,2840,5681,2840,0,1,2842,1176342,1.176342
3240,7050,4540,32007000,2,25926,6483,1,556468800,556468800,9721,3240,6481,3240,0,1,3242,70064,0.070064
3640,7050,4540,32007000,2,29126,7283,1,593556800,593556800,10921,3640,7281,3640,0,1,3642,2287047,2.287047
4040,7050,4540,32007000,2,32326,8083,1,630644800,630644800,12121,4040,8081,4040,0,1,4042,8132475,8.132475
4440,7050,4540,32007000,2,35526,8883,1,667732800,667732800,13321,4440,8881,4440,0,1,4442,2046032,2.046032
4840,7050,4540,32007000,2,38726,9683,1,704820800,704820800,14521,4840,9681,4840,0,1,4842,3044957,3.044957
5240,7050,4540,32007000,2,41926,10483,1,741908800,741908800,15721,5240,10481,5240,0,1,5242,32658109,32.658109
5640,7050,4540,32007000,2,45126,11283,1,778996800,778996800,16921,5640,11281,5640,0,1,5642,35191727,35.191727
6040,7050,4540,32007000,2,48326,12083,1,816084800,816084800,18121,6040,12081,6040,0,1,6042,37830245,37.830245
6440,7050,4540,32007000,2,51526,12883,1,853172800,853172800,19321,6440,12881,6440,0,1,6442,40318779,40.318779
6840,7050,4540,32007000,2,54726,13683,1,890260800,890260800,20521,6840,13681,6840,0,1,6842,42734573,42.734573
40,5300,6040,32012000,2,326,83,1,259724800,259724800,121,40,81,40,0,1,42,596262,0.596262
440,5300,6040,32012000,2,3526,883,1,296012800,296012800,1321,440,881,440,0,1,442,2016090,2.01609
840,5300,6040,32012000,2,6726,1683,1,332300800,332300800,2521,840,1681,840,0,1,842,967213,0.967213
1240,5300,6040,32012000,2,9926,2483,1,368588800,368588800,3721,1240,2481,1240,0,1,1242,5009577,5.009577
1640,5300,6040,32012000,2,13126,3283,1,404876800,404876800,4921,1640,3281,1640,0,1,1642,3560895,3.560895
2040,5300,6040,32012000,2,16326,4083,1,441164800,441164800,6121,2040,4081,2040,0,1,2042,3630620,3.63062
2440,5300,6040,32012000,2,19526,4883,1,477452800,477452800,7321,2440,4881,2440,0,1,2442,906738,0.906738
2840,5300,6040,32012000,2,22726,5683,1,513740800,513740800,8521,2840,5681,2840,0,1,2842,3014254,3.014254
3240,5300,6040,32012000,2,25926,6483,1,550028800,550028800,9721,3240,6481,3240,0,1,3242,3258366,3.258366
3640,5300,6040,32012000,2,29126,7283,1,586316800,586316800,10921,3640,7281,3640,0,1,3642,1525740,1.52574
4040,5300,6040,32012000,2,32326,8083,1,622604800,622604800,12121,4040,8081,4040,0,1,4042,870079,0.870079
4440,5300,6040,32012000,2,35526,8883,1,658892800,658892800,13321,4440,8881,4440,0,1,4442,106084,0.106084
4840,5300,6040,32012000,2,38726,9683,1,695180800,695180800,14521,4840,9681,4840,0,1,4842,7762493,7.762493
5240,5300,6040,32012000,2,41926,10483,1,731468800,731468800,15721,5240,10481,5240,0,1,5242,314929,0.314929
5640,5300,6040,32012000,2,45126,11283,1,767756800,767756800,16921,5640,11281,5640,0,1,5642,4025803,4.025803
6040,5300,6040,32012000,2,48326,12083,1,804044800,804044800,18121,6040,12081,6040,0,1,6042,1588516,1.588516
6440,5300,6040,32012000,2,51526,12883,1,840332800,840332800,19321,6440,12881,6440,0,1,6442,1160491,1.160491
6840,5300,6040,32012000,2,54726,13683,1,876620800,876620800,20521,6840,13681,6840,0,1,6842,359161,0.359161
40,5050,6340,32017000,2,326,83,1,259780800,259780800,121,40,81,40,0,1,42,93116,0.093116
440,5050,6340,32017000,2,3526,883,1,296228800,296228800,1321,440,881,440,0,1,442,178908,0.178908
840,5050,6340,32017000,2,6726,1683,1,332676800,332676800,2521,840,1681,840,0,1,842,97647,0.097647
1240,5050,6340,32017000,2,9926,2483,1,369124800,369124800,3721,1240,2481,1240,0,1,1242,240962,0.240962
1640,5050,6340,32017000,2,13126,3283,1,405572800,405572800,4921,1640,3281,1640,0,1,1642,30296,0.030296
2040,5050,6340,32017000,2,16326,4083,1,442020800,442020800,6121,2040,4081,2040,0,1,2042,183686,0.183686
2440,5050,6340,32017000,2,19526,4883,1,478468800,478468800,7321,2440,4881,2440,0,1,2442,312238,0.312238
2840,5050,6340,32017000,2,22726,5683,1,514916800,514916800,8521,2840,5681,2840,0,1,2842,34582,0.034582
3240,5050,6340,32017000,2,25926,6483,1,551364800,551364800,9721,3240,6481,3240,0,1,3242,291321,0.291321
3640,5050,6340,32017000,2,29126,7283,1,587812800,587812800,10921,3640,7281,3640,0,1,3642,742652,0.742652
4040,5050,6340,32017000,2,32326,8083,1,624260800,624260800,12121,4040,8081,4040,0,1,4042,3229958,3.229958
4440,5050,6340,32017000,2,35526,8883,1,660708800,660708800,13321,4440,8881,4440,0,1,4442,1347449,1.347449
4840,5050,6340,32017000,2,38726,9683,1,697156800,697156800,14521,4840,9681,4840,0,1,4842,941899,0.941899
5240,5050,6340,32017000,2,41926,10483,1,733604800,733604800,15721,5240,10481,5240,0,1,5242,1342045,1.342045
5640,5050,6340,32017000,2,45126,11283,1,770052800,770052800,16921,5640,11281,5640,0,1,5642,304191,0.304191
6040,5050,6340,32017000,2,48326,12083,1,806500800,806500800,18121,6040,12081,6040,0,1,6042,65404,0.065404
6440,5050,6340,32017000,2,51526,12883,1,842948800,842948800,19321,6440,12881,6440,0,1,6442,1777863,1.777863
6840,5050,6340,32017000,2,54726,13683,1,879396800,879396800,20521,6840,13681,6840,0,1,6842,2031885,2.031885
55,5555,5765,32024575,2,446,113,1,261177400,261177400,166,55,111,55,0,1,57,660748,0.660748
455,5555,5765,32024575,2,3646,913,1,297401400,297401400,1366,455,911,455,0,1,457,3023379,3.023379
855,5555,5765,32024575,2,6846,1713,1,333625400,333625400,2566,855,1711,855,0,1,857,2614607,2.614607
1255,5555,5765,32024575,2,10046,2513,1,369849400,369849400,3766,1255,2511,1255,0,1,1257,3160728,3.160728
1655,5555,5765,32024575,2,13246,3313,1,406073400,406073400,4966,1655,3311,1655,0,1,1657,8791717,8.791717
2055,5555,5765,32024575,2,16446,4113,1,442297400,442297400,6166,2055,4111,2055,0,1,2057,219530,0.21953
2455,5555,5765,32024575,2,19646,4913,1,478521400,478521400,7366,2455,4911,2455,0,1,2457,10849428,10.849428
2855,5555,5765,32024575,2,22846,5713,1,514745400,514745400,8566,2855,5711,2855,0,1,2857,5669936,5.669936
3255,5555,5765,32024575,2,26046,6513,1,550969400,550969400,9766,3255,6511,3255,0,1,3257,5598939,5.598939
3655,5555,5765,32024575,2,29246,7313,1,587193400,587193400,10966,3655,7311,3655,0,1,3657,3536666,3.536666
4055,5555,5765,32024575,2,32446,8113,1,623417400,623417400,12166,4055,8111,4055,0,1,4057,697732,0.697732
4455,5555,5765,32024575,2,35646,8913,1,659641400,659641400,13366,4455,8911,4455,0,1,4457,763743,0.763743
4855,5555,5765,32024575,2,38846,9713,1,695865400,695865400,14566,4855,9711,4855,0,1,4857,484427,0.484427
5255,5555,5765,32024575,2,42046,10513,1,732089400,732089400,15766,5255,10511,5255,0,1,5257,255818,0.255818
5655,5555,5765,32024575,2,45246,11313,1,768313400,768313400,16966,5655,11311,5655,0,1,5657,11366528,11.366528
6055,5555,5765,32024575,2,48446,12113,1,804537400,804537400,18166,6055,12111,6055,0,1,6057,466974,0.466974
6455,5555,5765,32024575,2,51646,12913,1,840761400,840761400,19366,6455,12911,6455,0,1,6457,192897,0.192897
6855,5555,5765,32024575,2,54846,13713,1,876985400,876985400,20566,6855,13711,6855,0,1,6857,4359350,4.35935
55,4805,6665,32025325,2,446,113,1,261249400,261249400,166,55,111,55,0,1,57,591522,0.591522
455,4805,6665,32025325,2,3646,913,1,297953400,297953400,1366,455,911,455,0,1,457,2809364,2.809364
855,4805,6665,32025325,2,6846,1713,1,334657400,334657400,2566,855,1711,855,0,1,857,5355124,5.355124
1255,4805,6665,32025325,2,10046,2513,1,371361400,371361400,3766,1255,2511,1255,0,1,1257,6045409,6.045409
1655,4805,6665,32025325,2,13246,3313,1,408065400,408065400,4966,1655,3311,1655,0,1,1657,855366,0.855366
2055,4805,6665,32025325,2,16446,4113,1,444769400,444769400,6166,2055,4111,2055,0,1,2057,3451158,3.451158
2455,4805,6665,32025325,2,19646,4913,1,481473400,481473400,7366,2455,4911,2455,0,1,2457,3255402,3.255402
2855,4805,6665,32025325,2,22846,5713,1,518177400,518177400,8566,2855,5711,2855,0,1,2857,2024099,2.024099
3255,4805,6665,32025325,2,26046,6513,1,554881400,554881400,9766,3255,6511,3255,0,1,3257,1624285,1.624285
3655,4805,6665,32025325,2,29246,7313,1,591585400,591585400,10966,3655,7311,3655,0,1,3657,1168215,1.168215
4055,4805,6665,32025325,2,32446,8113,1,628289400,628289400,12166,4055,8111,4055,0,1,4057,827557,0.827557
4455,4805,6665,32025325,2,35646,8913,1,664993400,664993400,13366,4455,8911,4455,0,1,4457,726983,0.726983
4855,4805,6665,32025325,2,38846,9713,1,701697400,701697400,14566,4855,9711,4855,0,1,4857,9137569,9.137569
5255,4805,6665,32025325,2,42046,10513,1,738401400,738401400,15766,5255,10511,5255,0,1,5257,6036343,6.036343
5655,4805,6665,32025325,2,45246,11313,1,775105400,775105400,16966,5655,11311,5655,0,1,5657,2185572,2.185572
6055,4805,6665,32025325,2,48446,12113,1,811809400,811809400,18166,6055,12111,6055,0,1,6057,6738225,6.738225
6455,4805,6665,32025325,2,51646,12913,1,848513400,848513400,19366,6455,12911,6455,0,1,6457,2244989,2.244989
6855,4805,6665,32025325,2,54846,13713,1,885217400,885217400,20566,6855,13711,6855,0,1,6857,12673510,12.67351
55,5305,6065,32174825,2,446,113,1,262401400,262401400,166,55,111,55,0,1,57,644704,0.644704
455,5305,6065,32174825,2,3646,913,1,298785400,298785400,1366,455,911,455,0,1,457,947530,0.94753
855,5305,6065,32174825,2,6846,1713,1,335169400,335169400,2566,855,1711,855,0,1,857,315404,0.315404
1255,5305,6065,32174825,2,10046,2513,1,371553400,371553400,3766,1255,2511,1255,0,1,1257,1760595,1.760595
1655,5305,6065,32174825,2,13246,3313,1,407937400,407937400,4966,1655,3311,1655,0,1,1657,2920760,2.92076
2055,5305,6065,32174825,2,16446,4113,1,444321400,444321400,6166,2055,4111,2055,0,1,2057,1473822,1.473822
2455,5305,6065,32174825,2,19646,4913,1,480705400,480705400,7366,2455,4911,2455,0,1,2457,205930,0.20593
2855,5305,6065,32174825,2,22846,5713,1,517089400,517089400,8566,2855,5711,2855,0,1,2857,2015467,2.015467
3255,5305,6065,32174825,2,26046,6513,1,553473400,553473400,9766,3255,6511,3255,0,1,3257,2675150,2.67515
3655,5305,6065,32174825,2,29246,7313,1,589857400,589857400,10966,3655,7311,3655,0,1,3657,1534866,1.534866
4055,5305,6065,32174825,2,32446,8113,1,626241400,626241400,12166,4055,8111,4055,0,1,4057,2115995,2.115995
4455,5305,6065,32174825,2,35646,8913,1,662625400,662625400,13366,4455,8911,4455,0,1,4457,2504645,2.504645
4855,5305,6065,32174825,2,38846,9713,1,699009400,699009400,14566,4855,9711,4855,0,1,4857,857886,0.857886
5255,5305,6065,32174825,2,42046,10513,1,735393400,735393400,15766,5255,10511,5255,0,1,5257,362119,0.362119
5655,5305,6065,32174825,2,45246,11313,1,771777400,771777400,16966,5655,11311,5655,0,1,5657,4576052,4.576052
6055,5305,6065,32174825,2,48446,12113,1,808161400,808161400,18166,6055,12111,6055,0,1,6057,5398625,5.398625
6455,5305,6065,32174825,2,51646,12913,1,844545400,844545400,19366,6455,12911,6455,0,1,6457,48868,0.048868
6855,5305,6065,32174825,2,54846,13713,1,880929400,880929400,20566,6855,13711,6855,0,1,6857,1576078,1.576078
55,5055,6365,32175075,2,446,113,1,262425400,262425400,166,55,111,55,0,1,57,53567,0.053567
455,5055,6365,32175075,2,3646,913,1,298969400,298969400,1366,455,911,455,0,1,457,44446,0.044446
855,5055,6365,32175075,2,6846,1713,1,335513400,335513400,2566,855,1711,855,0,1,857,320179,0.320179
1255,5055,6365,32175075,2,10046,2513,1,372057400,372057400,3766,1255,2511,1255,0,1,1257,137022,0.137022
1655,5055,6365,32175075,2,13246,3313,1,408601400,408601400,4966,1655,3311,1655,0,1,1657,303484,0.303484
2055,5055,6365,32175075,2,16446,4113,1,445145400,445145400,6166,2055,4111,2055,0,1,2057,721762,0.721762
2455,5055,6365,32175075,2,19646,4913,1,481689400,481689400,7366,2455,4911,2455,0,1,2457,411132,0.411132
2855,5055,6365,32175075,2,22846,5713,1,518233400,518233400,8566,2855,5711,2855,0,1,2857,1916385,1.916385
3255,5055,6365,32175075,2,26046,6513,1,554777400,554777400,9766,3255,6511,3255,0,1,3257,679949,0.679949
3655,5055,6365,32175075,2,29246,7313,1,591321400,591321400,10966,3655,7311,3655,0,1,3657,38064,0.038064
4055,5055,6365,32175075,2,32446,8113,1,627865400,627865400,12166,4055,8111,4055,0,1,4057,1400697,1.400697
4455,5055,6365,32175075,2,35646,8913,1,664409400,664409400,13366,4455,8911,4455,0,1,4457,1672718,1.672718
4855,5055,6365,32175075,2,38846,9713,1,700953400,700953400,14566,4855,9711,4855,0,1,4857,187483,0.187483
5255,5055,6365,32175075,2,42046,10513,1,737497400,737497400,15766,5255,10511,5255,0,1,5257,87584,0.087584
5655,5055,6365,32175075,2,45246,11313,1,774041400,774041400,16966,5655,11311,5655,0,1,5657,389204,0.389204
6055,5055,6365,32175075,2,48446,12113,1,810585400,810585400,18166,6055,12111,6055,0,1,6057,3388590,3.38859
6455,5055,6365,32175075,2,51646,12913,1,847129400,847129400,19366,6455,12911,6455,0,1,6457,1109208,1.109208
6855,5055,6365,32175075,2,54846,13713,1,883673400,883673400,20566,6855,13711,6855,0,1,6857,2220124,2.220124
55,7055,4565,32206075,2,446,113,1,262761400,262761400,166,55,111,55,0,1,57,647050,0.64705
455,7055,4565,32206075,2,3646,913,1,299945400,299945400,1366,455,911,455,0,1,457,3097268,3.097268
855,7055,4565,32206075,2,6846,1713,1,337129400,337129400,2566,855,1711,855,0,1,857,1106590,1.10659
1255,7055,4565,32206075,2,10046,2513,1,374313400,374313400,3766,1255,2511,1255,0,1,1257,8027113,8.027113
1655,7055,4565,32206075,2,13246,3313,1,411497400,411497400,4966,1655,3311,1655,0,1,1657,4196640,4.19664
2055,7055,4565,32206075,2,16446,4113,1,448681400,448681400,6166,2055,4111,2055,0,1,2057,2364276,2.364276
2455,7055,4565,32206075,2,19646,4913,1,485865400,485865400,7366,2455,4911,2455,0,1,2457,1287015,1.287015
2855,7055,4565,32206075,2,22846,5713,1,523049400,523049400,8566,2855,5711,2855,0,1,2857,17889994,17.889994
3255,7055,4565,32206075,2,26046,6513,1,560233400,560233400,9766,3255,6511,3255,0,1,3257,99149,0.099149
3655,7055,4565,32206075,2,29246,7313,1,597417400,597417400,10966,3655,7311,3655,0,1,3657,8596107,8.596107
4055,7055,4565,32206075,2,32446,8113,1,634601400,634601400,12166,4055,8111,4055,0,1,4057,18699414,18.699414
4455,7055,4565,32206075,2,35646,8913,1,671785400,671785400,13366,4455,8911,4455,0,1,4457,6639818,6.639818
4855,7055,4565,32206075,2,38846,9713,1,708969400,708969400,14566,4855,9711,4855,0,1,4857,3366794,3.366794
5255,7055,4565,32206075,2,42046,10513,1,746153400,746153400,15766,5255,10511,5255,0,1,5257,9112371,9.112371
5655,7055,4565,32206075,2,45246,11313,1,783337400,783337400,16966,5655,11311,5655,0,1,5657,35490811,35.490811
6055,7055,4565,32206075,2,48446,12113,1,820521400,820521400,18166,6055,12111,6055,0,1,6057,38246949,38.246949
6455,7055,4565,32206075,2,51646,12913,1,857705400,857705400,19366,6455,12911,6455,0,1,6457,40894557,40.894557
6855,7055,4565,32206075,2,54846,13713,1,894889400,894889400,20566,6855,13711,6855,0,1,6857,43370082,43.370082
40,6300,5140,32382000,2,326,83,1,262716800,262716800,121,40,81,40,0,1,42,600852,0.600852
440,6300,5140,32382000,2,3526,883,1,299324800,299324800,1321,440,881,440,0,1,442,600145,0.600145
840,6300,5140,32382000,2,6726,1683,1,335932800,335932800,2521,840,1681,840,0,1,842,2890347,2.890347
1240,6300,5140,32382000,2,9926,2483,1,372540800,372540800,3721,1240,2481,1240,0,1,1242,7706733,7.706733
1640,6300,5140,32382000,2,13126,3283,1,409148800,409148800,4921,1640,3281,1640,0,1,1642,2718772,2.718772
2040,6300,5140,32382000,2,16326,4083,1,445756800,445756800,6121,2040,4081,2040,0,1,2042,2410940,2.41094
2440,6300,5140,32382000,2,19526,4883,1,482364800,482364800,7321,2440,4881,2440,0,1,2442,4853573,4.853573
2840,6300,5140,32382000,2,22726,5683,1,518972800,518972800,8521,2840,5681,2840,0,1,2842,354910,0.35491
3240,6300,5140,32382000,2,25926,6483,1,555580800,555580800,9721,3240,6481,3240,0,1,3242,7264363,7.264363
3640,6300,5140,32382000,2,29126,7283,1,592188800,592188800,10921,3640,7281,3640,0,1,3642,2346221,2.346221
4040,6300,5140,32382000,2,32326,8083,1,628796800,628796800,12121,4040,8081,4040,0,1,4042,5857770,5.85777
4440,6300,5140,32382000,2,35526,8883,1,665404800,665404800,13321,4440,8881,4440,0,1,4442,5347004,5.347004
4840,6300,5140,32382000,2,38726,9683,1,702012800,702012800,14521,4840,9681,4840,0,1,4842,2533336,2.533336
5240,6300,5140,32382000,2,41926,10483,1,738620800,738620800,15721,5240,10481,5240,0,1,5242,154719,0.154719
5640,6300,5140,32382000,2,45126,11283,1,775228800,775228800,16921,5640,11281,5640,0,1,5642,5123984,5.123984
6040,6300,5140,32382000,2,48326,12083,1,811836800,811836800,18121,6040,12081,6040,0,1,6042,9272495,9.272495
6440,6300,5140,32382000,2,51526,12883,1,848444800,848444800,19321,6440,12881,6440,0,1,6442,5077297,5.077297
6840,6300,5140,32382000,2,54726,13683,1,885052800,885052800,20521,6840,13681,6840,0,1,6842,1413756,1.413756
35,4950,6545,32397750,2,286,73,1,262400600,262400600,106,35,71,35,0,1,37,158372,0.158372
535,4950,6545,32397750,2,4286,1073,1,308380600,308380600,1606,535,1071,535,0,1,537,125781,0.125781
1035,4950,6545,32397750,2,8286,2073,1,354360600,354360600,3106,1035,2071,1035,0,1,1037,137116,0.137116
1535,4950,6545,32397750,2,12286,3073,1,400340600,400340600,4606,1535,3071,1535,0,1,1537,2252420,2.25242
2035,4950,6545,32397750,2,16286,4073,1,446320600,446320600,6106,2035,4071,2035,0,1,2037,4577595,4.577595
2535,4950,6545,32397750,2,20286,5073,1,492300600,492300600,7606,2535,5071,2535,0,1,2537,141716,0.141716
3035,4950,6545,32397750,2,24286,6073,1,538280600,538280600,9106,3035,6071,3035,0,1,3037,1530469,1.530469
3535,4950,6545,32397750,2,28286,7073,1,584260600,584260600,10606,3535,7071,3535,0,1,3537,499459,0.499459
4035,4950,6545,32397750,2,32286,8073,1,630240600,630240600,12106,4035,8071,4035,0,1,4037,7049187,7.049187
4535,4950,6545,32397750,2,36286,9073,1,676220600,676220600,13606,4535,9071,4535,0,1,4537,3081500,3.0815
5035,4950,6545,32397750,2,40286,10073,1,722200600,722200600,15106,5035,10071,5035,0,1,5037,20827112,20.827112
5535,4950,6545,32397750,2,44286,11073,1,768180600,768180600,16606,5535,11071,5535,0,1,5537,7447121,7.447121
6035,4950,6545,32397750,2,48286,12073,1,814160600,814160600,18106,6035,12071,6035,0,1,6037,3369152,3.369152
6535,4950,6545,32397750,2,52286,13073,1,860140600,860140600,19606,6535,13071,6535,0,1,6537,18257177,18.257177
7035,4950,6545,32397750,2,56286,14073,1,906120600,906120600,21106,7035,14071,7035,0,1,7037,13644935,13.644935
55,6305,5165,32565325,2,446,113,1,265569400,265569400,166,55,111,55,0,1,57,495664,0.495664
455,6305,5165,32565325,2,3646,913,1,302273400,302273400,1366,455,911,455,0,1,457,871288,0.871288
855,6305,5165,32565325,2,6846,1713,1,338977400,338977400,2566,855,1711,855,0,1,857,3106363,3.106363
1255,6305,5165,32565325,2,10046,2513,1,375681400,375681400,3766,1255,2511,1255,0,1,1257,2874055,2.874055
1655,6305,5165,32565325,2,13246,3313,1,412385400,412385400,4966,1655,3311,1655,0,1,1657,4743774,4.743774
2055,6305,5165,32565325,2,16446,4113,1,449089400,449089400,6166,2055,4111,2055,0,1,2057,12842798,12.842798
2455,6305,5165,32565325,2,19646,4913,1,485793400,485793400,7366,2455,4911,2455,0,1,2457,6497453,6.497453
2855,6305,5165,32565325,2,22846,5713,1,522497400,522497400,8566,2855,5711,2855,0,1,2857,5149078,5.149078
3255,6305,5165,32565325,2,26046,6513,1,559201400,559201400,9766,3255,6511,3255,0,1,3257,7371394,7.371394
3655,6305,5165,32565325,2,29246,7313,1,595905400,595905400,10966,3655,7311,3655,0,1,3657,52217,0.052217
4055,6305,5165,32565325,2,32446,8113,1,632609400,632609400,12166,4055,8111,4055,0,1,4057,499442,0.499442
4455,6305,5165,32565325,2,35646,8913,1,669313400,669313400,13366,4455,8911,4455,0,1,4457,1804762,1.804762
4855,6305,5165,32565325,2,38846,9713,1,706017400,706017400,14566,4855,9711,4855,0,1,4857,559076,0.559076
5255,6305,5165,32565325,2,42046,10513,1,742721400,742721400,15766,5255,10511,5255,0,1,5257,931194,0.931194
5655,6305,5165,32565325,2,45246,11313,1,779425400,779425400,16966,5655,11311,5655,0,1,5657,3949904,3.949904
6055,6305,5165,32565325,2,48446,12113,1,816129400,816129400,18166,6055,12111,6055,0,1,6057,9425251,9.425251
6455,6305,5165,32565325,2,51646,12913,1,852833400,852833400,19366,6455,12911,6455,0,1,6457,1414232,1.414232
6855,6305,5165,32565325,2,54846,13713,1,889537400,889537400,20566,6855,13711,6855,0,1,6857,39348369,39.348369
39,4993,6541,32659213,2,318,81,1,264872312,264872312,118,39,79,39,0,1,41,573441,0.573441
539,4993,6541,32659213,2,4318,1081,1,311008312,311008312,1618,539,1079,539,0,1,541,3523631,3.523631
1039,4993,6541,32659213,2,8318,2081,1,357144312,357144312,3118,1039,2079,1039,0,1,1041,923622,0.923622
1539,4993,6541,32659213,2,12318,3081,1,403280312,403280312,4618,1539,3079,1539,0,1,1541,1064799,1.064799
2039,4993,6541,32659213,2,16318,4081,1,449416312,449416312,6118,2039,4079,2039,0,1,2041,1566656,1.566656
2539,4993,6541,32659213,2,20318,5081,1,495552312,495552312,7618,2539,5079,2539,0,1,2541,3473700,3.4737
3039,4993,6541,32659213,2,24318,6081,1,541688312,541688312,9118,3039,6079,3039,0,1,3041,3211635,3.211635
3539,4993,6541,32659213,2,28318,7081,1,587824312,587824312,10618,3539,7079,3539,0,1,3541,1984811,1.984811
4039,4993,6541,32659213,2,32318,8081,1,633960312,633960312,12118,4039,8079,4039,0,1,4041,2571331,2.571331
4539,4993,6541,32659213,2,36318,9081,1,680096312,680096312,13618,4539,9079,4539,0,1,4541,3175624,3.175624
5039,4993,6541,32659213,2,40318,10081,1,726232312,726232312,15118,5039,10079,5039,0,1,5041,1760029,1.760029
5539,4993,6541,32659213,2,44318,11081,1,772368312,772368312,16618,5539,11079,5539,0,1,5541,33814353,33.814353
6039,4993,6541,32659213,2,48318,12081,1,818504312,818504312,18118,6039,12079,6039,0,1,6041,36863661,36.863661
6539,4993,6541,32659213,2,52318,13081,1,864640312,864640312,19618,6539,13079,6539,0,1,6541,39986230,39.98623
7039,4993,6541,32659213,2,56318,14081,1,910776312,910776312,21118,7039,14079,7039,0,1,7041,43038898,43.038898
44,5003,6555,32794665,2,358,91,1,266425736,266425736,133,44,89,44,0,1,46,163686,0.163686
544,5003,6555,32794665,2,4358,1091,1,312657736,312657736,1633,544,1089,544,0,1,546,2313647,2.313647
1044,5003,6555,32794665,2,8358,2091,1,358889736,358889736,3133,1044,2089,1044,0,1,1046,5849896,5.849896
1544,5003,6555,32794665,2,12358,3091,1,405121736,405121736,4633,1544,3089,1544,0,1,1546,2350874,2.350874
2044,5003,6555,32794665,2,16358,4091,1,451353736,451353736,6133,2044,4089,2044,0,1,2046,3222726,3.222726
2544,5003,6555,32794665,2,20358,5091,1,497585736,497585736,7633,2544,5089,2544,0,1,2546,7456536,7.456536
3044,5003,6555,32794665,2,24358,6091,1,543817736,543817736,9133,3044,6089,3044,0,1,3046,5529004,5.529004
3544,5003,6555,32794665,2,28358,7091,1,590049736,590049736,10633,3544,7089,3544,0,1,3546,10078148,10.078148
4044,5003,6555,32794665,2,32358,8091,1,636281736,636281736,12133,4044,8089,4044,0,1,4046,1608327,1.608327
4544,5003,6555,32794665,2,36358,9091,1,682513736,682513736,13633,4544,9089,4544,0,1,4546,7636319,7.636319
5044,5003,6555,32794665,2,40358,10091,1,728745736,728745736,15133,5044,10089,5044,0,1,5046,2074704,2.074704
5544,5003,6555,32794665,2,44358,11091,1,774977736,774977736,16633,5544,11089,5544,0,1,5546,34104079,34.104079
6044,5003,6555,32794665,2,48358,12091,1,821209736,821209736,18133,6044,12089,6044,0,1,6046,37171969,37.171969
6544,5003,6555,32794665,2,52358,13091,1,867441736,867441736,19633,6544,13089,6544,0,1,6546,40135855,40.135855
7044,5003,6555,32794665,2,56358,14091,1,913673736,913673736,21133,7044,14089,7044,0,1,7046,43305435,43.305435
40,6050,5440,32912000,2,326,83,1,266972800,266972800,121,40,81,40,0,1,42,569360,0.56936
440,6050,5440,32912000,2,3526,883,1,303740800,303740800,1321,440,881,440,0,1,442,207455,0.207455
840,6050,5440,32912000,2,6726,1683,1,340508800,340508800,2521,840,1681,840,0,1,842,1132412,1.132412
1240,6050,5440,32912000,2,9926,2483,1,377276800,377276800,3721,1240,2481,1240,0,1,1242,7527437,7.527437
1640,6050,5440,32912000,2,13126,3283,1,414044800,414044800,4921,1640,3281,1640,0,1,1642,7224907,7.224907
2040,6050,5440,32912000,2,16326,4083,1,450812800,450812800,6121,2040,4081,2040,0,1,2042,1381814,1.381814
2440,6050,5440,32912000,2,19526,4883,1,487580800,487580800,7321,2440,4881,2440,0,1,2442,503075,0.503075
2840,6050,5440,32912000,2,22726,5683,1,524348800,524348800,8521,2840,5681,2840,0,1,2842,2712004,2.712004
40,6800,4840,32912000,2,326,83,1,267020800,267020800,121,40,81,40,0,1,42,577748,0.577748
440,6800,4840,32912000,2,3526,883,1,304268800,304268800,1321,440,881,440,0,1,442,3031998,3.031998
840,6800,4840,32912000,2,6726,1683,1,341516800,341516800,2521,840,1681,840,0,1,842,1563856,1.563856
1240,6800,4840,32912000,2,9926,2483,1,378764800,378764800,3721,1240,2481,1240,0,1,1242,2857406,2.857406
3240,6050,5440,32912000,2,25926,6483,1,561116800,561116800,9721,3240,6481,3240,0,1,3242,1412291,1.412291
1640,6800,4840,32912000,2,13126,3283,1,416012800,416012800,4921,1640,3281,1640,0,1,1642,381575,0.381575
3640,6050,5440,32912000,2,29126,7283,1,597884800,597884800,10921,3640,7281,3640,0,1,3642,4056317,4.056317
2040,6800,4840,32912000,2,16326,4083,1,453260800,453260800,6121,2040,4081,2040,0,1,2042,3596491,3.596491
2440,6800,4840,32912000,2,19526,4883,1,490508800,490508800,7321,2440,4881,2440,0,1,2442,790646,0.790646
4040,6050,5440,32912000,2,32326,8083,1,634652800,634652800,12121,4040,8081,4040,0,1,4042,499677,0.499677
2840,6800,4840,32912000,2,22726,5683,1,527756800,527756800,8521,2840,5681,2840,0,1,2842,485861,0.485861
4440,6050,5440,32912000,2,35526,8883,1,671420800,671420800,13321,4440,8881,4440,0,1,4442,38758,0.038758
3240,6800,4840,32912000,2,25926,6483,1,565004800,565004800,9721,3240,6481,3240,0,1,3242,654484,0.654484
4840,6050,5440,32912000,2,38726,9683,1,708188800,708188800,14521,4840,9681,4840,0,1,4842,1860086,1.860086
3640,6800,4840,32912000,2,29126,7283,1,602252800,602252800,10921,3640,7281,3640,0,1,3642,4226854,4.226854
5240,6050,5440,32912000,2,41926,10483,1,744956800,744956800,15721,5240,10481,5240,0,1,5242,3760169,3.760169
4040,6800,4840,32912000,2,32326,8083,1,639500800,639500800,12121,4040,8081,4040,0,1,4042,1370508,1.370508
4440,6800,4840,32912000,2,35526,8883,1,676748800,676748800,13321,4440,8881,4440,0,1,4442,1840514,1.840514
5640,6050,5440,32912000,2,45126,11283,1,781724800,781724800,16921,5640,11281,5640,0,1,5642,4223973,4.223973
4840,6800,4840,32912000,2,38726,9683,1,713996800,713996800,14521,4840,9681,4840,0,1,4842,817999,0.817999
6040,6050,5440,32912000,2,48326,12083,1,818492800,818492800,18121,6040,12081,6040,0,1,6042,439756,0.439756
5240,6800,4840,32912000,2,41926,10483,1,751244800,751244800,15721,5240,10481,5240,0,1,5242,1884774,1.884774
6440,6050,5440,32912000,2,51526,12883,1,855260800,855260800,19321,6440,12881,6440,0,1,6442,4643076,4.643076
5640,6800,4840,32912000,2,45126,11283,1,788492800,788492800,16921,5640,11281,5640,0,1,5642,6481866,6.481866
6840,6050,5440,32912000,2,54726,13683,1,892028800,892028800,20521,6840,13681,6840,0,1,6842,4484985,4.484985
6040,6800,4840,32912000,2,48326,12083,1,825740800,825740800,18121,6040,12081,6040,0,1,6042,2696275,2.696275
6440,6800,4840,32912000,2,51526,12883,1,862988800,862988800,19321,6440,12881,6440,0,1,6442,5705704,5.705704
6840,6800,4840,32912000,2,54726,13683,1,900236800,900236800,20521,6840,13681,6840,0,1,6842,3433143,3.433143
55,6055,5465,33090575,2,446,113,1,269793400,269793400,166,55,111,55,0,1,57,657756,0.657756
455,6055,5465,33090575,2,3646,913,1,306657400,306657400,1366,455,911,455,0,1,457,3081952,3.081952
855,6055,5465,33090575,2,6846,1713,1,343521400,343521400,2566,855,1711,855,0,1,857,1814858,1.814858
1255,6055,5465,33090575,2,10046,2513,1,380385400,380385400,3766,1255,2511,1255,0,1,1257,2920925,2.920925
1655,6055,5465,33090575,2,13246,3313,1,417249400,417249400,4966,1655,3311,1655,0,1,1657,3845242,3.845242
2055,6055,5465,33090575,2,16446,4113,1,454113400,454113400,6166,2055,4111,2055,0,1,2057,2693348,2.693348
2455,6055,5465,33090575,2,19646,4913,1,490977400,490977400,7366,2455,4911,2455,0,1,2457,370237,0.370237
2855,6055,5465,33090575,2,22846,5713,1,527841400,527841400,8566,2855,5711,2855,0,1,2857,585096,0.585096
3255,6055,5465,33090575,2,26046,6513,1,564705400,564705400,9766,3255,6511,3255,0,1,3257,470333,0.470333
3655,6055,5465,33090575,2,29246,7313,1,601569400,601569400,10966,3655,7311,3655,0,1,3657,311133,0.311133
4055,6055,5465,33090575,2,32446,8113,1,638433400,638433400,12166,4055,8111,4055,0,1,4057,780299,0.780299
4455,6055,5465,33090575,2,35646,8913,1,675297400,675297400,13366,4455,8911,4455,0,1,4457,513238,0.513238
4855,6055,5465,33090575,2,38846,9713,1,712161400,712161400,14566,4855,9711,4855,0,1,4857,624222,0.624222
5255,6055,5465,33090575,2,42046,10513,1,749025400,749025400,15766,5255,10511,5255,0,1,5257,6339846,6.339846
5655,6055,5465,33090575,2,45246,11313,1,785889400,785889400,16966,5655,11311,5655,0,1,5657,2715817,2.715817
6055,6055,5465,33090575,2,48446,12113,1,822753400,822753400,18166,6055,12111,6055,0,1,6057,1961044,1.961044
6455,6055,5465,33090575,2,51646,12913,1,859617400,859617400,19366,6455,12911,6455,0,1,6457,7949287,7.949287
6855,6055,5465,33090575,2,54846,13713,1,896481400,896481400,20566,6855,13711,6855,0,1,6857,4000001,4.000001
55,6805,4865,33106325,2,446,113,1,269985400,269985400,166,55,111,55,0,1,57,685793,0.685793
455,6805,4865,33106325,2,3646,913,1,307329400,307329400,1366,455,911,455,0,1,457,3162301,3.162301
855,6805,4865,33106325,2,6846,1713,1,344673400,344673400,2566,855,1711,855,0,1,857,95282,0.095282
1255,6805,4865,33106325,2,10046,2513,1,382017400,382017400,3766,1255,2511,1255,0,1,1257,708688,0.708688
1655,6805,4865,33106325,2,13246,3313,1,419361400,419361400,4966,1655,3311,1655,0,1,1657,178479,0.178479
2055,6805,4865,33106325,2,16446,4113,1,456705400,456705400,6166,2055,4111,2055,0,1,2057,1372403,1.372403
2455,6805,4865,33106325,2,19646,4913,1,494049400,494049400,7366,2455,4911,2455,0,1,2457,3567974,3.567974
2855,6805,4865,33106325,2,22846,5713,1,531393400,531393400,8566,2855,5711,2855,0,1,2857,498242,0.498242
3255,6805,4865,33106325,2,26046,6513,1,568737400,568737400,9766,3255,6511,3255,0,1,3257,3558378,3.558378
3655,6805,4865,33106325,2,29246,7313,1,606081400,606081400,10966,3655,7311,3655,0,1,3657,42445,0.042445
4055,6805,4865,33106325,2,32446,8113,1,643425400,643425400,12166,4055,8111,4055,0,1,4057,474229,0.474229
4455,6805,4865,33106325,2,35646,8913,1,680769400,680769400,13366,4455,8911,4455,0,1,4457,4358430,4.35843
4855,6805,4865,33106325,2,38846,9713,1,718113400,718113400,14566,4855,9711,4855,0,1,4857,1023753,1.023753
5255,6805,4865,33106325,2,42046,10513,1,755457400,755457400,15766,5255,10511,5255,0,1,5257,4092508,4.092508
5655,6805,4865,33106325,2,45246,11313,1,792801400,792801400,16966,5655,11311,5655,0,1,5657,1936660,1.93666
6055,6805,4865,33106325,2,48446,12113,1,830145400,830145400,18166,6055,12111,6055,0,1,6057,3417480,3.41748
6455,6805,4865,33106325,2,51646,12913,1,867489400,867489400,19366,6455,12911,6455,0,1,6457,1970796,1.970796
6855,6805,4865,33106325,2,54846,13713,1,904833400,904833400,20566,6855,13711,6855,0,1,6857,245776,0.245776
35,5500,6045,33247500,2,286,73,1,269212600,269212600,106,35,71,35,0,1,37,182416,0.182416
535,5500,6045,33247500,2,4286,1073,1,315392600,315392600,1606,535,1071,535,0,1,537,247501,0.247501
1035,5500,6045,33247500,2,8286,2073,1,361572600,361572600,3106,1035,2071,1035,0,1,1037,898291,0.898291
1535,5500,6045,33247500,2,12286,3073,1,407752600,407752600,4606,1535,3071,1535,0,1,1537,127410,0.12741
2035,5500,6045,33247500,2,16286,4073,1,453932600,453932600,6106,2035,4071,2035,0,1,2037,446201,0.446201
2535,5500,6045,33247500,2,20286,5073,1,500112600,500112600,7606,2535,5071,2535,0,1,2537,7416728,7.416728
3035,5500,6045,33247500,2,24286,6073,1,546292600,546292600,9106,3035,6071,3035,0,1,3037,511727,0.511727
3535,5500,6045,33247500,2,28286,7073,1,592472600,592472600,10606,3535,7071,3535,0,1,3537,1983630,1.98363
4035,5500,6045,33247500,2,32286,8073,1,638652600,638652600,12106,4035,8071,4035,0,1,4037,333601,0.333601
4535,5500,6045,33247500,2,36286,9073,1,684832600,684832600,13606,4535,9071,4535,0,1,4537,3472881,3.472881
5035,5500,6045,33247500,2,40286,10073,1,731012600,731012600,15106,5035,10071,5035,0,1,5037,864616,0.864616
5535,5500,6045,33247500,2,44286,11073,1,777192600,777192600,16606,5535,11071,5535,0,1,5537,3008310,3.00831
6035,5500,6045,33247500,2,48286,12073,1,823372600,823372600,18106,6035,12071,6035,0,1,6037,2738516,2.738516
6535,5500,6045,33247500,2,52286,13073,1,869552600,869552600,19606,6535,13071,6535,0,1,6537,200214,0.200214
7035,5500,6045,33247500,2,56286,14073,1,915732600,915732600,21106,7035,14071,7035,0,1,7037,12482591,12.482591
40,5800,5740,33292000,2,326,83,1,270028800,270028800,121,40,81,40,0,1,42,80286,0.080286
440,5800,5740,33292000,2,3526,883,1,306956800,306956800,1321,440,881,440,0,1,442,114097,0.114097
840,5800,5740,33292000,2,6726,1683,1,343884800,343884800,2521,840,1681,840,0,1,842,26061,0.026061
1240,5800,5740,33292000,2,9926,2483,1,380812800,380812800,3721,1240,2481,1240,0,1,1242,722548,0.722548
1640,5800,5740,33292000,2,13126,3283,1,417740800,417740800,4921,1640,3281,1640,0,1,1642,612344,0.612344
2040,5800,5740,33292000,2,16326,4083,1,454668800,454668800,6121,2040,4081,2040,0,1,2042,79159,0.079159
2440,5800,5740,33292000,2,19526,4883,1,491596800,491596800,7321,2440,4881,2440,0,1,2442,64401,0.064401
2840,5800,5740,33292000,2,22726,5683,1,528524800,528524800,8521,2840,5681,2840,0,1,2842,913967,0.913967
3240,5800,5740,33292000,2,25926,6483,1,565452800,565452800,9721,3240,6481,3240,0,1,3242,670763,0.670763
3640,5800,5740,33292000,2,29126,7283,1,602380800,602380800,10921,3640,7281,3640,0,1,3642,495137,0.495137
4040,5800,5740,33292000,2,32326,8083,1,639308800,639308800,12121,4040,8081,4040,0,1,4042,1401648,1.401648
4440,5800,5740,33292000,2,35526,8883,1,676236800,676236800,13321,4440,8881,4440,0,1,4442,1190921,1.190921
4840,5800,5740,33292000,2,38726,9683,1,713164800,713164800,14521,4840,9681,4840,0,1,4842,294782,0.294782
5240,5800,5740,33292000,2,41926,10483,1,750092800,750092800,15721,5240,10481,5240,0,1,5242,473885,0.473885
5640,5800,5740,33292000,2,45126,11283,1,787020800,787020800,16921,5640,11281,5640,0,1,5642,4933732,4.933732
6040,5800,5740,33292000,2,48326,12083,1,823948800,823948800,18121,6040,12081,6040,0,1,6042,1124288,1.124288
6440,5800,5740,33292000,2,51526,12883,1,860876800,860876800,19321,6440,12881,6440,0,1,6442,2209021,2.209021
6840,5800,5740,33292000,2,54726,13683,1,897804800,897804800,20521,6840,13681,6840,0,1,6842,1544054,1.544054
35,6600,5045,33297000,2,286,73,1,269636600,269636600,106,35,71,35,0,1,37,60162,0.060162
535,6600,5045,33297000,2,4286,1073,1,316216600,316216600,1606,535,1071,535,0,1,537,1122120,1.12212
1035,6600,5045,33297000,2,8286,2073,1,362796600,362796600,3106,1035,2071,1035,0,1,1037,708442,0.708442
1535,6600,5045,33297000,2,12286,3073,1,409376600,409376600,4606,1535,3071,1535,0,1,1537,2973244,2.973244
2035,6600,5045,33297000,2,16286,4073,1,455956600,455956600,6106,2035,4071,2035,0,1,2037,817459,0.817459
2535,6600,5045,33297000,2,20286,5073,1,502536600,502536600,7606,2535,5071,2535,0,1,2537,3102844,3.102844
3035,6600,5045,33297000,2,24286,6073,1,549116600,549116600,9106,3035,6071,3035,0,1,3037,1685602,1.685602
3535,6600,5045,33297000,2,28286,7073,1,595696600,595696600,10606,3535,7071,3535,0,1,3537,6671121,6.671121
4035,6600,5045,33297000,2,32286,8073,1,642276600,642276600,12106,4035,8071,4035,0,1,4037,1303017,1.303017
4535,6600,5045,33297000,2,36286,9073,1,688856600,688856600,13606,4535,9071,4535,0,1,4537,7719604,7.719604
5035,6600,5045,33297000,2,40286,10073,1,735436600,735436600,15106,5035,10071,5035,0,1,5037,12720880,12.72088
5535,6600,5045,33297000,2,44286,11073,1,782016600,782016600,16606,5535,11071,5535,0,1,5537,5977972,5.977972
6035,6600,5045,33297000,2,48286,12073,1,828596600,828596600,18106,6035,12071,6035,0,1,6037,11877883,11.877883
6535,6600,5045,33297000,2,52286,13073,1,875176600,875176600,19606,6535,13071,6535,0,1,6537,10344464,10.344464
7035,6600,5045,33297000,2,56286,14073,1,921756600,921756600,21106,7035,14071,7035,0,1,7037,19550595,19.550595
40,4800,6940,33312000,2,326,83,1,270252800,270252800,121,40,81,40,0,1,42,607566,0.607566
440,4800,6940,33312000,2,3526,883,1,307820800,307820800,1321,440,881,440,0,1,442,137989,0.137989
840,4800,6940,33312000,2,6726,1683,1,345388800,345388800,2521,840,1681,840,0,1,842,3310712,3.310712
1240,4800,6940,33312000,2,9926,2483,1,382956800,382956800,3721,1240,2481,1240,0,1,1242,987004,0.987004
1640,4800,6940,33312000,2,13126,3283,1,420524800,420524800,4921,1640,3281,1640,0,1,1642,973585,0.973585
2040,4800,6940,33312000,2,16326,4083,1,458092800,458092800,6121,2040,4081,2040,0,1,2042,5096334,5.096334
2440,4800,6940,33312000,2,19526,4883,1,495660800,495660800,7321,2440,4881,2440,0,1,2442,3085715,3.085715
2840,4800,6940,33312000,2,22726,5683,1,533228800,533228800,8521,2840,5681,2840,0,1,2842,8810884,8.810884
3240,4800,6940,33312000,2,25926,6483,1,570796800,570796800,9721,3240,6481,3240,0,1,3242,1892885,1.892885
3640,4800,6940,33312000,2,29126,7283,1,608364800,608364800,10921,3640,7281,3640,0,1,3642,12007152,12.007152
4040,4800,6940,33312000,2,32326,8083,1,645932800,645932800,12121,4040,8081,4040,0,1,4042,5995388,5.995388
4440,4800,6940,33312000,2,35526,8883,1,683500800,683500800,13321,4440,8881,4440,0,1,4442,8826566,8.826566
4840,4800,6940,33312000,2,38726,9683,1,721068800,721068800,14521,4840,9681,4840,0,1,4842,1923651,1.923651
5240,4800,6940,33312000,2,41926,10483,1,758636800,758636800,15721,5240,10481,5240,0,1,5242,3631612,3.631612
5640,4800,6940,33312000,2,45126,11283,1,796204800,796204800,16921,5640,11281,5640,0,1,5642,576193,0.576193
6040,4800,6940,33312000,2,48326,12083,1,833772800,833772800,18121,6040,12081,6040,0,1,6042,1502880,1.50288
6440,4800,6940,33312000,2,51526,12883,1,871340800,871340800,19321,6440,12881,6440,0,1,6442,4224895,4.224895
6840,4800,6940,33312000,2,54726,13683,1,908908800,908908800,20521,6840,13681,6840,0,1,6842,4780788,4.780788
55,5805,5765,33465825,2,446,113,1,272817400,272817400,166,55,111,55,0,1,57,96813,0.096813
455,5805,5765,33465825,2,3646,913,1,309841400,309841400,1366,455,911,455,0,1,457,225945,0.225945
855,5805,5765,33465825,2,6846,1713,1,346865400,346865400,2566,855,1711,855,0,1,857,41034,0.041034
1255,5805,5765,33465825,2,10046,2513,1,383889400,383889400,3766,1255,2511,1255,0,1,1257,379179,0.379179
1655,5805,5765,33465825,2,13246,3313,1,420913400,420913400,4966,1655,3311,1655,0,1,1657,169911,0.169911
2055,5805,5765,33465825,2,16446,4113,1,457937400,457937400,6166,2055,4111,2055,0,1,2057,883411,0.883411
2455,5805,5765,33465825,2,19646,4913,1,494961400,494961400,7366,2455,4911,2455,0,1,2457,112758,0.112758
2855,5805,5765,33465825,2,22846,5713,1,531985400,531985400,8566,2855,5711,2855,0,1,2857,471884,0.471884
3255,5805,5765,33465825,2,26046,6513,1,569009400,569009400,9766,3255,6511,3255,0,1,3257,1928423,1.928423
3655,5805,5765,33465825,2,29246,7313,1,606033400,606033400,10966,3655,7311,3655,0,1,3657,907372,0.907372
4055,5805,5765,33465825,2,32446,8113,1,643057400,643057400,12166,4055,8111,4055,0,1,4057,461756,0.461756
4455,5805,5765,33465825,2,35646,8913,1,680081400,680081400,13366,4455,8911,4455,0,1,4457,2034729,2.034729
4855,5805,5765,33465825,2,38846,9713,1,717105400,717105400,14566,4855,9711,4855,0,1,4857,2339683,2.339683
5255,5805,5765,33465825,2,42046,10513,1,754129400,754129400,15766,5255,10511,5255,0,1,5257,127310,0.12731
5655,5805,5765,33465825,2,45246,11313,1,791153400,791153400,16966,5655,11311,5655,0,1,5657,194947,0.194947
6055,5805,5765,33465825,2,48446,12113,1,828177400,828177400,18166,6055,12111,6055,0,1,6057,325663,0.325663
6455,5805,5765,33465825,2,51646,12913,1,865201400,865201400,19366,6455,12911,6455,0,1,6457,2088826,2.088826
6855,5805,5765,33465825,2,54846,13713,1,902225400,902225400,20566,6855,13711,6855,0,1,6857,1667573,1.667573
55,4805,6965,33466825,2,446,113,1,272913400,272913400,166,55,111,55,0,1,57,671215,0.671215
455,4805,6965,33466825,2,3646,913,1,310577400,310577400,1366,455,911,455,0,1,457,1067910,1.06791
855,4805,6965,33466825,2,6846,1713,1,348241400,348241400,2566,855,1711,855,0,1,857,5582554,5.582554
1255,4805,6965,33466825,2,10046,2513,1,385905400,385905400,3766,1255,2511,1255,0,1,1257,2384962,2.384962
1655,4805,6965,33466825,2,13246,3313,1,423569400,423569400,4966,1655,3311,1655,0,1,1657,8091575,8.091575
2055,4805,6965,33466825,2,16446,4113,1,461233400,461233400,6166,2055,4111,2055,0,1,2057,11987306,11.987306
2455,4805,6965,33466825,2,19646,4913,1,498897400,498897400,7366,2455,4911,2455,0,1,2457,3343764,3.343764
2855,4805,6965,33466825,2,22846,5713,1,536561400,536561400,8566,2855,5711,2855,0,1,2857,369103,0.369103
3255,4805,6965,33466825,2,26046,6513,1,574225400,574225400,9766,3255,6511,3255,0,1,3257,1091325,1.091325
3655,4805,6965,33466825,2,29246,7313,1,611889400,611889400,10966,3655,7311,3655,0,1,3657,1778192,1.778192
4055,4805,6965,33466825,2,32446,8113,1,649553400,649553400,12166,4055,8111,4055,0,1,4057,709599,0.709599
4455,4805,6965,33466825,2,35646,8913,1,687217400,687217400,13366,4455,8911,4455,0,1,4457,2088413,2.088413
4855,4805,6965,33466825,2,38846,9713,1,724881400,724881400,14566,4855,9711,4855,0,1,4857,905122,0.905122
5255,4805,6965,33466825,2,42046,10513,1,762545400,762545400,15766,5255,10511,5255,0,1,5257,89336,0.089336
5655,4805,6965,33466825,2,45246,11313,1,800209400,800209400,16966,5655,11311,5655,0,1,5657,12413276,12.413276
6055,4805,6965,33466825,2,48446,12113,1,837873400,837873400,18166,6055,12111,6055,0,1,6057,9033842,9.033842
6455,4805,6965,33466825,2,51646,12913,1,875537400,875537400,19366,6455,12911,6455,0,1,6457,18300530,18.30053
6855,4805,6965,33466825,2,54846,13713,1,913201400,913201400,20566,6855,13711,6855,0,1,6857,4486885,4.486885
39,5543,6041,33485263,2,318,81,1,271496312,271496312,118,39,79,39,0,1,41,47856,0.047856
539,5543,6041,33485263,2,4318,1081,1,317832312,317832312,1618,539,1079,539,0,1,541,130875,0.130875
1039,5543,6041,33485263,2,8318,2081,1,364168312,364168312,3118,1039,2079,1039,0,1,1041,181849,0.181849
1539,5543,6041,33485263,2,12318,3081,1,410504312,410504312,4618,1539,3079,1539,0,1,1541,781545,0.781545
2039,5543,6041,33485263,2,16318,4081,1,456840312,456840312,6118,2039,4079,2039,0,1,2041,1001962,1.001962
2539,5543,6041,33485263,2,20318,5081,1,503176312,503176312,7618,2539,5079,2539,0,1,2541,959945,0.959945
3039,5543,6041,33485263,2,24318,6081,1,549512312,549512312,9118,3039,6079,3039,0,1,3041,358521,0.358521
3539,5543,6041,33485263,2,28318,7081,1,595848312,595848312,10618,3539,7079,3539,0,1,3541,322498,0.322498
4039,5543,6041,33485263,2,32318,8081,1,642184312,642184312,12118,4039,8079,4039,0,1,4041,1319307,1.319307
4539,5543,6041,33485263,2,36318,9081,1,688520312,688520312,13618,4539,9079,4539,0,1,4541,72443,0.072443
5039,5543,6041,33485263,2,40318,10081,1,734856312,734856312,15118,5039,10079,5039,0,1,5041,3042760,3.04276
5539,5543,6041,33485263,2,44318,11081,1,781192312,781192312,16618,5539,11079,5539,0,1,5541,229711,0.229711
6039,5543,6041,33485263,2,48318,12081,1,827528312,827528312,18118,6039,12079,6039,0,1,6041,3034186,3.034186
6539,5543,6041,33485263,2,52318,13081,1,873864312,873864312,19618,6539,13079,6539,0,1,6541,2413955,2.413955
7039,5543,6041,33485263,2,56318,14081,1,920200312,920200312,21118,7039,14079,7039,0,1,7041,282611,0.282611
39,6643,5041,33487363,2,318,81,1,271544312,271544312,118,39,79,39,0,1,41,24213,0.024213
539,6643,5041,33487363,2,4318,1081,1,318280312,318280312,1618,539,1079,539,0,1,541,96144,0.096144
1039,6643,5041,33487363,2,8318,2081,1,365016312,365016312,3118,1039,2079,1039,0,1,1041,1246490,1.24649
1539,6643,5041,33487363,2,12318,3081,1,411752312,411752312,4618,1539,3079,1539,0,1,1541,95005,0.095005
2039,6643,5041,33487363,2,16318,4081,1,458488312,458488312,6118,2039,4079,2039,0,1,2041,535258,0.535258
2539,6643,5041,33487363,2,20318,5081,1,505224312,505224312,7618,2539,5079,2539,0,1,2541,279578,0.279578
3039,6643,5041,33487363,2,24318,6081,1,551960312,551960312,9118,3039,6079,3039,0,1,3041,735430,0.73543
3539,6643,5041,33487363,2,28318,7081,1,598696312,598696312,10618,3539,7079,3539,0,1,3541,3751359,3.751359
4039,6643,5041,33487363,2,32318,8081,1,645432312,645432312,12118,4039,8079,4039,0,1,4041,3371435,3.371435
4539,6643,5041,33487363,2,36318,9081,1,692168312,692168312,13618,4539,9079,4539,0,1,4541,1528649,1.528649
5039,6643,5041,33487363,2,40318,10081,1,738904312,738904312,15118,5039,10079,5039,0,1,5041,2682807,2.682807
5539,6643,5041,33487363,2,44318,11081,1,785640312,785640312,16618,5539,11079,5539,0,1,5541,1154112,1.154112
6039,6643,5041,33487363,2,48318,12081,1,832376312,832376312,18118,6039,12079,6039,0,1,6041,751753,0.751753
6539,6643,5041,33487363,2,52318,13081,1,879112312,879112312,19618,6539,13079,6539,0,1,6541,2639219,2.639219
7039,6643,5041,33487363,2,56318,14081,1,925848312,925848312,21118,7039,14079,7039,0,1,7041,5320089,5.320089
35,5540,6045,33489300,2,286,73,1,271158200,271158200,106,35,71,35,0,1,37,265142,0.265142
535,5540,6045,33489300,2,4286,1073,1,317498200,317498200,1606,535,1071,535,0,1,537,284256,0.284256
1035,5540,6045,33489300,2,8286,2073,1,363838200,363838200,3106,1035,2071,1035,0,1,1037,3350483,3.350483
1535,5540,6045,33489300,2,12286,3073,1,410178200,410178200,4606,1535,3071,1535,0,1,1537,8315016,8.315016
40,5550,6040,33522000,2,326,83,1,271884800,271884800,121,40,81,40,0,1,42,597644,0.597644
440,5550,6040,33522000,2,3526,883,1,308972800,308972800,1321,440,881,440,0,1,442,1388152,1.388152
840,5550,6040,33522000,2,6726,1683,1,346060800,346060800,2521,840,1681,840,0,1,842,2659274,2.659274
1240,5550,6040,33522000,2,9926,2483,1,383148800,383148800,3721,1240,2481,1240,0,1,1242,3909895,3.909895
1640,5550,6040,33522000,2,13126,3283,1,420236800,420236800,4921,1640,3281,1640,0,1,1642,1412583,1.412583
2040,5550,6040,33522000,2,16326,4083,1,457324800,457324800,6121,2040,4081,2040,0,1,2042,6736144,6.736144
2440,5550,6040,33522000,2,19526,4883,1,494412800,494412800,7321,2440,4881,2440,0,1,2442,878692,0.878692
2840,5550,6040,33522000,2,22726,5683,1,531500800,531500800,8521,2840,5681,2840,0,1,2842,123135,0.123135
3240,5550,6040,33522000,2,25926,6483,1,568588800,568588800,9721,3240,6481,3240,0,1,3242,6671957,6.671957
3640,5550,6040,33522000,2,29126,7283,1,605676800,605676800,10921,3640,7281,3640,0,1,3642,6081900,6.0819
4040,5550,6040,33522000,2,32326,8083,1,642764800,642764800,12121,4040,8081,4040,0,1,4042,6396852,6.396852
4440,5550,6040,33522000,2,35526,8883,1,679852800,679852800,13321,4440,8881,4440,0,1,4442,6378827,6.378827
4840,5550,6040,33522000,2,38726,9683,1,716940800,716940800,14521,4840,9681,4840,0,1,4842,6127344,6.127344
5240,5550,6040,33522000,2,41926,10483,1,754028800,754028800,15721,5240,10481,5240,0,1,5242,1666993,1.666993
5640,5550,6040,33522000,2,45126,11283,1,791116800,791116800,16921,5640,11281,5640,0,1,5642,1477555,1.477555
6040,5550,6040,33522000,2,48326,12083,1,828204800,828204800,18121,6040,12081,6040,0,1,6042,2808095,2.808095
6440,5550,6040,33522000,2,51526,12883,1,865292800,865292800,19321,6440,12881,6440,0,1,6442,334763,0.334763
6840,5550,6040,33522000,2,54726,13683,1,902380800,902380800,20521,6840,13681,6840,0,1,6842,6074754,6.074754
40,5050,6640,33532000,2,326,83,1,271996800,271996800,121,40,81,40,0,1,42,105610,0.10561
440,5050,6640,33532000,2,3526,883,1,309404800,309404800,1321,440,881,440,0,1,442,208049,0.208049
840,5050,6640,33532000,2,6726,1683,1,346812800,346812800,2521,840,1681,840,0,1,842,412581,0.412581
1240,5050,6640,33532000,2,9926,2483,1,384220800,384220800,3721,1240,2481,1240,0,1,1242,223353,0.223353
1640,5050,6640,33532000,2,13126,3283,1,421628800,421628800,4921,1640,3281,1640,0,1,1642,467061,0.467061
2040,5050,6640,33532000,2,16326,4083,1,459036800,459036800,6121,2040,4081,2040,0,1,2042,524725,0.524725
2440,5050,6640,33532000,2,19526,4883,1,496444800,496444800,7321,2440,4881,2440,0,1,2442,273136,0.273136
2840,5050,6640,33532000,2,22726,5683,1,533852800,533852800,8521,2840,5681,2840,0,1,2842,63323,0.063323
3240,5050,6640,33532000,2,25926,6483,1,571260800,571260800,9721,3240,6481,3240,0,1,3242,122279,0.122279
3640,5050,6640,33532000,2,29126,7283,1,608668800,608668800,10921,3640,7281,3640,0,1,3642,626464,0.626464
4040,5050,6640,33532000,2,32326,8083,1,646076800,646076800,12121,4040,8081,4040,0,1,4042,666876,0.666876
4440,5050,6640,33532000,2,35526,8883,1,683484800,683484800,13321,4440,8881,4440,0,1,4442,1615590,1.61559
4840,5050,6640,33532000,2,38726,9683,1,720892800,720892800,14521,4840,9681,4840,0,1,4842,2259270,2.25927
5240,5050,6640,33532000,2,41926,10483,1,758300800,758300800,15721,5240,10481,5240,0,1,5242,2424584,2.424584
5640,5050,6640,33532000,2,45126,11283,1,795708800,795708800,16921,5640,11281,5640,0,1,5642,659563,0.659563
6040,5050,6640,33532000,2,48326,12083,1,833116800,833116800,18121,6040,12081,6040,0,1,6042,424149,0.424149
6440,5050,6640,33532000,2,51526,12883,1,870524800,870524800,19321,6440,12881,6440,0,1,6442,4061972,4.061972
6840,5050,6640,33532000,2,54726,13683,1,907932800,907932800,20521,6840,13681,6840,0,1,6842,77654,0.077654
35,6050,5545,33547250,2,286,73,1,271624600,271624600,106,35,71,35,0,1,37,23461,0.023461
535,6050,5545,33547250,2,4286,1073,1,318004600,318004600,1606,535,1071,535,0,1,537,1640421,1.640421
1035,6050,5545,33547250,2,8286,2073,1,364384600,364384600,3106,1035,2071,1035,0,1,1037,2236798,2.236798
1535,6050,5545,33547250,2,12286,3073,1,410764600,410764600,4606,1535,3071,1535,0,1,1537,152893,0.152893
2035,6050,5545,33547250,2,16286,4073,1,457144600,457144600,6106,2035,4071,2035,0,1,2037,292304,0.292304
2535,6050,5545,33547250,2,20286,5073,1,503524600,503524600,7606,2535,5071,2535,0,1,2537,368984,0.368984
3035,6050,5545,33547250,2,24286,6073,1,549904600,549904600,9106,3035,6071,3035,0,1,3037,2913696,2.913696
3535,6050,5545,33547250,2,28286,7073,1,596284600,596284600,10606,3535,7071,3535,0,1,3537,1361559,1.361559
4035,6050,5545,33547250,2,32286,8073,1,642664600,642664600,12106,4035,8071,4035,0,1,4037,127750,0.12775
4535,6050,5545,33547250,2,36286,9073,1,689044600,689044600,13606,4535,9071,4535,0,1,4537,11356473,11.356473
5035,6050,5545,33547250,2,40286,10073,1,735424600,735424600,15106,5035,10071,5035,0,1,5037,3952156,3.952156
5535,6050,5545,33547250,2,44286,11073,1,781804600,781804600,16606,5535,11071,5535,0,1,5537,19652966,19.652966
6035,6050,5545,33547250,2,48286,12073,1,828184600,828184600,18106,6035,12071,6035,0,1,6037,8708837,8.708837
6535,6050,5545,33547250,2,52286,13073,1,874564600,874564600,19606,6535,13071,6535,0,1,6537,3543993,3.543993
7035,6050,5545,33547250,2,56286,14073,1,920944600,920944600,21106,7035,14071,7035,0,1,7037,24601979,24.601979
40,5300,6340,33602000,2,326,83,1,272540800,272540800,121,40,81,40,0,1,42,538726,0.538726
440,5300,6340,33602000,2,3526,883,1,309788800,309788800,1321,440,881,440,0,1,442,156027,0.156027
840,5300,6340,33602000,2,6726,1683,1,347036800,347036800,2521,840,1681,840,0,1,842,1957612,1.957612
1240,5300,6340,33602000,2,9926,2483,1,384284800,384284800,3721,1240,2481,1240,0,1,1242,1017382,1.017382
1640,5300,6340,33602000,2,13126,3283,1,421532800,421532800,4921,1640,3281,1640,0,1,1642,387134,0.387134
2040,5300,6340,33602000,2,16326,4083,1,458780800,458780800,6121,2040,4081,2040,0,1,2042,4638096,4.638096
2440,5300,6340,33602000,2,19526,4883,1,496028800,496028800,7321,2440,4881,2440,0,1,2442,1719198,1.719198
2840,5300,6340,33602000,2,22726,5683,1,533276800,533276800,8521,2840,5681,2840,0,1,2842,3216743,3.216743
3240,5300,6340,33602000,2,25926,6483,1,570524800,570524800,9721,3240,6481,3240,0,1,3242,1469620,1.46962
3640,5300,6340,33602000,2,29126,7283,1,607772800,607772800,10921,3640,7281,3640,0,1,3642,214711,0.214711
4040,5300,6340,33602000,2,32326,8083,1,645020800,645020800,12121,4040,8081,4040,0,1,4042,1961393,1.961393
4440,5300,6340,33602000,2,35526,8883,1,682268800,682268800,13321,4440,8881,4440,0,1,4442,1118841,1.118841
4840,5300,6340,33602000,2,38726,9683,1,719516800,719516800,14521,4840,9681,4840,0,1,4842,26378,0.026378
5240,5300,6340,33602000,2,41926,10483,1,756764800,756764800,15721,5240,10481,5240,0,1,5242,44535,0.044535
5640,5300,6340,33602000,2,45126,11283,1,794012800,794012800,16921,5640,11281,5640,0,1,5642,270272,0.270272
6040,5300,6340,33602000,2,48326,12083,1,831260800,831260800,18121,6040,12081,6040,0,1,6042,4993110,4.99311
6440,5300,6340,33602000,2,51526,12883,1,868508800,868508800,19321,6440,12881,6440,0,1,6442,5155844,5.155844
6840,5300,6340,33602000,2,54726,13683,1,905756800,905756800,20521,6840,13681,6840,0,1,6842,2110587,2.110587
44,5553,6055,33623415,2,358,91,1,273073336,273073336,133,44,89,44,0,1,46,32801,0.032801
544,5553,6055,33623415,2,4358,1091,1,319505336,319505336,1633,544,1089,544,0,1,546,242549,0.242549
1044,5553,6055,33623415,2,8358,2091,1,365937336,365937336,3133,1044,2089,1044,0,1,1046,1050522,1.050522
1544,5553,6055,33623415,2,12358,3091,1,412369336,412369336,4633,1544,3089,1544,0,1,1546,134447,0.134447
2044,5553,6055,33623415,2,16358,4091,1,458801336,458801336,6133,2044,4089,2044,0,1,2046,102199,0.102199
2544,5553,6055,33623415,2,20358,5091,1,505233336,505233336,7633,2544,5089,2544,0,1,2546,66135,0.066135
3044,5553,6055,33623415,2,24358,6091,1,551665336,551665336,9133,3044,6089,3044,0,1,3046,206582,0.206582
3544,5553,6055,33623415,2,28358,7091,1,598097336,598097336,10633,3544,7089,3544,0,1,3546,1329206,1.329206
4044,5553,6055,33623415,2,32358,8091,1,644529336,644529336,12133,4044,8089,4044,0,1,4046,3978008,3.978008
4544,5553,6055,33623415,2,36358,9091,1,690961336,690961336,13633,4544,9089,4544,0,1,4546,1284559,1.284559
5044,5553,6055,33623415,2,40358,10091,1,737393336,737393336,15133,5044,10089,5044,0,1,5046,1836602,1.836602
5544,5553,6055,33623415,2,44358,11091,1,783825336,783825336,16633,5544,11089,5544,0,1,5546,3990211,3.990211
6044,5553,6055,33623415,2,48358,12091,1,830257336,830257336,18133,6044,12089,6044,0,1,6046,2233423,2.233423
6544,5553,6055,33623415,2,52358,13091,1,876689336,876689336,19633,6544,13089,6544,0,1,6546,6704588,6.704588
7044,5553,6055,33623415,2,56358,14091,1,923121336,923121336,21133,7044,14089,7044,0,1,7046,11602829,11.602829
44,6653,5055,33630915,2,358,91,1,273168536,273168536,133,44,89,44,0,1,46,24551,0.024551
544,6653,5055,33630915,2,4358,1091,1,320000536,320000536,1633,544,1089,544,0,1,546,56372,0.056372
1044,6653,5055,33630915,2,8358,2091,1,366832536,366832536,3133,1044,2089,1044,0,1,1046,343858,0.343858
1544,6653,5055,33630915,2,12358,3091,1,413664536,413664536,4633,1544,3089,1544,0,1,1546,66447,0.066447
2044,6653,5055,33630915,2,16358,4091,1,460496536,460496536,6133,2044,4089,2044,0,1,2046,586350,0.58635
2544,6653,5055,33630915,2,20358,5091,1,507328536,507328536,7633,2544,5089,2544,0,1,2546,1082777,1.082777
3044,6653,5055,33630915,2,24358,6091,1,554160536,554160536,9133,3044,6089,3044,0,1,3046,1027436,1.027436
3544,6653,5055,33630915,2,28358,7091,1,600992536,600992536,10633,3544,7089,3544,0,1,3546,1811918,1.811918
4044,6653,5055,33630915,2,32358,8091,1,647824536,647824536,12133,4044,8089,4044,0,1,4046,2609862,2.609862
4544,6653,5055,33630915,2,36358,9091,1,694656536,694656536,13633,4544,9089,4544,0,1,4546,141251,0.141251
5044,6653,5055,33630915,2,40358,10091,1,741488536,741488536,15133,5044,10089,5044,0,1,5046,2473958,2.473958
5544,6653,5055,33630915,2,44358,11091,1,788320536,788320536,16633,5544,11089,5544,0,1,5546,458421,0.458421
6044,6653,5055,33630915,2,48358,12091,1,835152536,835152536,18133,6044,12089,6044,0,1,6046,418445,0.418445
6544,6653,5055,33630915,2,52358,13091,1,881984536,881984536,19633,6544,13089,6544,0,1,6546,1464693,1.464693
7044,6653,5055,33630915,2,56358,14091,1,928816536,928816536,21133,7044,14089,7044,0,1,7046,16224703,16.224703
40,6550,5140,33667000,2,326,83,1,273076800,273076800,121,40,81,40,0,1,42,25991,0.025991
440,6550,5140,33667000,2,3526,883,1,310484800,310484800,1321,440,881,440,0,1,442,305571,0.305571
840,6550,5140,33667000,2,6726,1683,1,347892800,347892800,2521,840,1681,840,0,1,842,172953,0.172953
1240,6550,5140,33667000,2,9926,2483,1,385300800,385300800,3721,1240,2481,1240,0,1,1242,380067,0.380067
1640,6550,5140,33667000,2,13126,3283,1,422708800,422708800,4921,1640,3281,1640,0,1,1642,122557,0.122557
2040,6550,5140,33667000,2,16326,4083,1,460116800,460116800,6121,2040,4081,2040,0,1,2042,174797,0.174797
2440,6550,5140,33667000,2,19526,4883,1,497524800,497524800,7321,2440,4881,2440,0,1,2442,758577,0.758577
2840,6550,5140,33667000,2,22726,5683,1,534932800,534932800,8521,2840,5681,2840,0,1,2842,378761,0.378761
3240,6550,5140,33667000,2,25926,6483,1,572340800,572340800,9721,3240,6481,3240,0,1,3242,713620,0.71362
3640,6550,5140,33667000,2,29126,7283,1,609748800,609748800,10921,3640,7281,3640,0,1,3642,227250,0.22725
4040,6550,5140,33667000,2,32326,8083,1,647156800,647156800,12121,4040,8081,4040,0,1,4042,861051,0.861051
4440,6550,5140,33667000,2,35526,8883,1,684564800,684564800,13321,4440,8881,4440,0,1,4442,473814,0.473814
4840,6550,5140,33667000,2,38726,9683,1,721972800,721972800,14521,4840,9681,4840,0,1,4842,79008,0.079008
5240,6550,5140,33667000,2,41926,10483,1,759380800,759380800,15721,5240,10481,5240,0,1,5242,1821142,1.821142
5640,6550,5140,33667000,2,45126,11283,1,796788800,796788800,16921,5640,11281,5640,0,1,5642,1171382,1.171382
6040,6550,5140,33667000,2,48326,12083,1,834196800,834196800,18121,6040,12081,6040,0,1,6042,935917,0.935917
6440,6550,5140,33667000,2,51526,12883,1,871604800,871604800,19321,6440,12881,6440,0,1,6442,258815,0.258815
6840,6550,5140,33667000,2,54726,13683,1,909012800,909012800,20521,6840,13681,6840,0,1,6842,3008152,3.008152
55,5555,6065,33691075,2,446,113,1,274641400,274641400,166,55,111,55,0,1,57,694492,0.694492
455,5555,6065,33691075,2,3646,913,1,311825400,311825400,1366,455,911,455,0,1,457,2085337,2.085337
855,5555,6065,33691075,2,6846,1713,1,349009400,349009400,2566,855,1711,855,0,1,857,3853377,3.853377
1255,5555,6065,33691075,2,10046,2513,1,386193400,386193400,3766,1255,2511,1255,0,1,1257,2540198,2.540198
1655,5555,6065,33691075,2,13246,3313,1,423377400,423377400,4966,1655,3311,1655,0,1,1657,1504570,1.50457
2055,5555,6065,33691075,2,16446,4113,1,460561400,460561400,6166,2055,4111,2055,0,1,2057,5517882,5.517882
2455,5555,6065,33691075,2,19646,4913,1,497745400,497745400,7366,2455,4911,2455,0,1,2457,1638152,1.638152
2855,5555,6065,33691075,2,22846,5713,1,534929400,534929400,8566,2855,5711,2855,0,1,2857,8600031,8.600031
3255,5555,6065,33691075,2,26046,6513,1,572113400,572113400,9766,3255,6511,3255,0,1,3257,2899329,2.899329
3655,5555,6065,33691075,2,29246,7313,1,609297400,609297400,10966,3655,7311,3655,0,1,3657,1301438,1.301438
4055,5555,6065,33691075,2,32446,8113,1,646481400,646481400,12166,4055,8111,4055,0,1,4057,311258,0.311258
4455,5555,6065,33691075,2,35646,8913,1,683665400,683665400,13366,4455,8911,4455,0,1,4457,183986,0.183986
4855,5555,6065,33691075,2,38846,9713,1,720849400,720849400,14566,4855,9711,4855,0,1,4857,6656984,6.656984
5255,5555,6065,33691075,2,42046,10513,1,758033400,758033400,15766,5255,10511,5255,0,1,5257,469990,0.46999
5655,5555,6065,33691075,2,45246,11313,1,795217400,795217400,16966,5655,11311,5655,0,1,5657,545719,0.545719
6055,5555,6065,33691075,2,48446,12113,1,832401400,832401400,18166,6055,12111,6055,0,1,6057,8660636,8.660636
6455,5555,6065,33691075,2,51646,12913,1,869585400,869585400,19366,6455,12911,6455,0,1,6457,14333054,14.333054
6855,5555,6065,33691075,2,54846,13713,1,906769400,906769400,20566,6855,13711,6855,0,1,6857,6930531,6.930531
55,5055,6665,33691575,2,446,113,1,274689400,274689400,166,55,111,55,0,1,57,26691,0.026691
455,5055,6665,33691575,2,3646,913,1,312193400,312193400,1366,455,911,455,0,1,457,86940,0.08694
855,5055,6665,33691575,2,6846,1713,1,349697400,349697400,2566,855,1711,855,0,1,857,472266,0.472266
1255,5055,6665,33691575,2,10046,2513,1,387201400,387201400,3766,1255,2511,1255,0,1,1257,77160,0.07716
1655,5055,6665,33691575,2,13246,3313,1,424705400,424705400,4966,1655,3311,1655,0,1,1657,36880,0.03688
2055,5055,6665,33691575,2,16446,4113,1,462209400,462209400,6166,2055,4111,2055,0,1,2057,339632,0.339632
2455,5055,6665,33691575,2,19646,4913,1,499713400,499713400,7366,2455,4911,2455,0,1,2457,2901965,2.901965
2855,5055,6665,33691575,2,22846,5713,1,537217400,537217400,8566,2855,5711,2855,0,1,2857,967032,0.967032
3255,5055,6665,33691575,2,26046,6513,1,574721400,574721400,9766,3255,6511,3255,0,1,3257,551590,0.55159
3655,5055,6665,33691575,2,29246,7313,1,612225400,612225400,10966,3655,7311,3655,0,1,3657,1946677,1.946677
4055,5055,6665,33691575,2,32446,8113,1,649729400,649729400,12166,4055,8111,4055,0,1,4057,192566,0.192566
4455,5055,6665,33691575,2,35646,8913,1,687233400,687233400,13366,4455,8911,4455,0,1,4457,1306012,1.306012
4855,5055,6665,33691575,2,38846,9713,1,724737400,724737400,14566,4855,9711,4855,0,1,4857,680765,0.680765
5255,5055,6665,33691575,2,42046,10513,1,762241400,762241400,15766,5255,10511,5255,0,1,5257,682617,0.682617
5655,5055,6665,33691575,2,45246,11313,1,799745400,799745400,16966,5655,11311,5655,0,1,5657,547083,0.547083
6055,5055,6665,33691575,2,48446,12113,1,837249400,837249400,18166,6055,12111,6055,0,1,6057,2111553,2.111553
6455,5055,6665,33691575,2,51646,12913,1,874753400,874753400,19366,6455,12911,6455,0,1,6457,609525,0.609525
6855,5055,6665,33691575,2,54846,13713,1,912257400,912257400,20566,6855,13711,6855,0,1,6857,753497,0.753497
39,6093,5541,33761313,2,318,81,1,273720312,273720312,118,39,79,39,0,1,41,32219,0.032219
539,6093,5541,33761313,2,4318,1081,1,320256312,320256312,1618,539,1079,539,0,1,541,155016,0.155016
1039,6093,5541,33761313,2,8318,2081,1,366792312,366792312,3118,1039,2079,1039,0,1,1041,363084,0.363084
1539,6093,5541,33761313,2,12318,3081,1,413328312,413328312,4618,1539,3079,1539,0,1,1541,157899,0.157899
2039,6093,5541,33761313,2,16318,4081,1,459864312,459864312,6118,2039,4079,2039,0,1,2041,878482,0.878482
2539,6093,5541,33761313,2,20318,5081,1,506400312,506400312,7618,2539,5079,2539,0,1,2541,418584,0.418584
3039,6093,5541,33761313,2,24318,6081,1,552936312,552936312,9118,3039,6079,3039,0,1,3041,3873011,3.873011
3539,6093,5541,33761313,2,28318,7081,1,599472312,599472312,10618,3539,7079,3539,0,1,3541,3063873,3.063873
4039,6093,5541,33761313,2,32318,8081,1,646008312,646008312,12118,4039,8079,4039,0,1,4041,457821,0.457821
4539,6093,5541,33761313,2,36318,9081,1,692544312,692544312,13618,4539,9079,4539,0,1,4541,561226,0.561226
5039,6093,5541,33761313,2,40318,10081,1,739080312,739080312,15118,5039,10079,5039,0,1,5041,126189,0.126189
5539,6093,5541,33761313,2,44318,11081,1,785616312,785616312,16618,5539,11079,5539,0,1,5541,489259,0.489259
6039,6093,5541,33761313,2,48318,12081,1,832152312,832152312,18118,6039,12079,6039,0,1,6041,1633620,1.63362
6539,6093,5541,33761313,2,52318,13081,1,878688312,878688312,19618,6539,13079,6539,0,1,6541,4918775,4.918775
7039,6093,5541,33761313,2,56318,14081,1,925224312,925224312,21118,7039,14079,7039,0,1,7041,5787932,5.787932
55,5305,6365,33766325,2,446,113,1,275265400,275265400,166,55,111,55,0,1,57,675843,0.675843
455,5305,6365,33766325,2,3646,913,1,312609400,312609400,1366,455,911,455,0,1,457,1003317,1.003317
855,5305,6365,33766325,2,6846,1713,1,349953400,349953400,2566,855,1711,855,0,1,857,4983274,4.983274
1255,5305,6365,33766325,2,10046,2513,1,387297400,387297400,3766,1255,2511,1255,0,1,1257,2352858,2.352858
1655,5305,6365,33766325,2,13246,3313,1,424641400,424641400,4966,1655,3311,1655,0,1,1657,1402174,1.402174
2055,5305,6365,33766325,2,16446,4113,1,461985400,461985400,6166,2055,4111,2055,0,1,2057,2416074,2.416074
2455,5305,6365,33766325,2,19646,4913,1,499329400,499329400,7366,2455,4911,2455,0,1,2457,1079783,1.079783
2855,5305,6365,33766325,2,22846,5713,1,536673400,536673400,8566,2855,5711,2855,0,1,2857,332686,0.332686
3255,5305,6365,33766325,2,26046,6513,1,574017400,574017400,9766,3255,6511,3255,0,1,3257,10247064,10.247064
3655,5305,6365,33766325,2,29246,7313,1,611361400,611361400,10966,3655,7311,3655,0,1,3657,212386,0.212386
4055,5305,6365,33766325,2,32446,8113,1,648705400,648705400,12166,4055,8111,4055,0,1,4057,471824,0.471824
4455,5305,6365,33766325,2,35646,8913,1,686049400,686049400,13366,4455,8911,4455,0,1,4457,1704295,1.704295
4855,5305,6365,33766325,2,38846,9713,1,723393400,723393400,14566,4855,9711,4855,0,1,4857,6970954,6.970954
5255,5305,6365,33766325,2,42046,10513,1,760737400,760737400,15766,5255,10511,5255,0,1,5257,4883679,4.883679
5655,5305,6365,33766325,2,45246,11313,1,798081400,798081400,16966,5655,11311,5655,0,1,5657,1296944,1.296944
6055,5305,6365,33766325,2,48446,12113,1,835425400,835425400,18166,6055,12111,6055,0,1,6057,1883743,1.883743
6455,5305,6365,33766325,2,51646,12913,1,872769400,872769400,19366,6455,12911,6455,0,1,6457,2088184,2.088184
6855,5305,6365,33766325,2,54846,13713,1,910113400,910113400,20566,6855,13711,6855,0,1,6857,2417080,2.41708
35,6090,5545,33769050,2,286,73,1,273410200,273410200,106,35,71,35,0,1,37,313173,0.313173
535,6090,5545,33769050,2,4286,1073,1,319950200,319950200,1606,535,1071,535,0,1,537,3318137,3.318137
1035,6090,5545,33769050,2,8286,2073,1,366490200,366490200,3106,1035,2071,1035,0,1,1037,3729628,3.729628
1535,6090,5545,33769050,2,12286,3073,1,413030200,413030200,4606,1535,3071,1535,0,1,1537,753250,0.75325
55,6555,5165,33856575,2,446,113,1,276009400,276009400,166,55,111,55,0,1,57,50347,0.050347
455,6555,5165,33856575,2,3646,913,1,313513400,313513400,1366,455,911,455,0,1,457,344642,0.344642
855,6555,5165,33856575,2,6846,1713,1,351017400,351017400,2566,855,1711,855,0,1,857,37537,0.037537
1255,6555,5165,33856575,2,10046,2513,1,388521400,388521400,3766,1255,2511,1255,0,1,1257,322174,0.322174
1655,6555,5165,33856575,2,13246,3313,1,426025400,426025400,4966,1655,3311,1655,0,1,1657,74219,0.074219
2055,6555,5165,33856575,2,16446,4113,1,463529400,463529400,6166,2055,4111,2055,0,1,2057,46225,0.046225
2455,6555,5165,33856575,2,19646,4913,1,501033400,501033400,7366,2455,4911,2455,0,1,2457,1440008,1.440008
2855,6555,5165,33856575,2,22846,5713,1,538537400,538537400,8566,2855,5711,2855,0,1,2857,639830,0.63983
3255,6555,5165,33856575,2,26046,6513,1,576041400,576041400,9766,3255,6511,3255,0,1,3257,340148,0.340148
3655,6555,5165,33856575,2,29246,7313,1,613545400,613545400,10966,3655,7311,3655,0,1,3657,341037,0.341037
4055,6555,5165,33856575,2,32446,8113,1,651049400,651049400,12166,4055,8111,4055,0,1,4057,2367637,2.367637
4455,6555,5165,33856575,2,35646,8913,1,688553400,688553400,13366,4455,8911,4455,0,1,4457,1765524,1.765524
4855,6555,5165,33856575,2,38846,9713,1,726057400,726057400,14566,4855,9711,4855,0,1,4857,525605,0.525605
5255,6555,5165,33856575,2,42046,10513,1,763561400,763561400,15766,5255,10511,5255,0,1,5257,619162,0.619162
5655,6555,5165,33856575,2,45246,11313,1,801065400,801065400,16966,5655,11311,5655,0,1,5657,937295,0.937295
6055,6555,5165,33856575,2,48446,12113,1,838569400,838569400,18166,6055,12111,6055,0,1,6057,1174528,1.174528
6455,6555,5165,33856575,2,51646,12913,1,876073400,876073400,19366,6455,12911,6455,0,1,6457,330172,0.330172
6855,6555,5165,33856575,2,54846,13713,1,913577400,913577400,20566,6855,13711,6855,0,1,6857,467235,0.467235
44,6103,5555,33902165,2,358,91,1,275320936,275320936,133,44,89,44,0,1,46,103095,0.103095
544,6103,5555,33902165,2,4358,1091,1,321952936,321952936,1633,544,1089,544,0,1,546,461303,0.461303
1044,6103,5555,33902165,2,8358,2091,1,368584936,368584936,3133,1044,2089,1044,0,1,1046,233621,0.233621
1544,6103,5555,33902165,2,12358,3091,1,415216936,415216936,4633,1544,3089,1544,0,1,1546,509793,0.509793
2044,6103,5555,33902165,2,16358,4091,1,461848936,461848936,6133,2044,4089,2044,0,1,2046,920118,0.920118
2544,6103,5555,33902165,2,20358,5091,1,508480936,508480936,7633,2544,5089,2544,0,1,2546,395134,0.395134
3044,6103,5555,33902165,2,24358,6091,1,555112936,555112936,9133,3044,6089,3044,0,1,3046,34626,0.034626
3544,6103,5555,33902165,2,28358,7091,1,601744936,601744936,10633,3544,7089,3544,0,1,3546,1204725,1.204725
4044,6103,5555,33902165,2,32358,8091,1,648376936,648376936,12133,4044,8089,4044,0,1,4046,1549838,1.549838
4544,6103,5555,33902165,2,36358,9091,1,695008936,695008936,13633,4544,9089,4544,0,1,4546,307543,0.307543
5044,6103,5555,33902165,2,40358,10091,1,741640936,741640936,15133,5044,10089,5044,0,1,5046,1015808,1.015808
5544,6103,5555,33902165,2,44358,11091,1,788272936,788272936,16633,5544,11089,5544,0,1,5546,1702142,1.702142
6044,6103,5555,33902165,2,48358,12091,1,834904936,834904936,18133,6044,12089,6044,0,1,6046,2410820,2.41082
6544,6103,5555,33902165,2,52358,13091,1,881536936,881536936,19633,6544,13089,6544,0,1,6546,5769922,5.769922
7044,6103,5555,33902165,2,56358,14091,1,928168936,928168936,21133,7044,14089,7044,0,1,7046,3517820,3.51782
40,7050,4840,34122000,2,326,83,1,276780800,276780800,121,40,81,40,0,1,42,635161,0.635161
440,7050,4840,34122000,2,3526,883,1,314828800,314828800,1321,440,881,440,0,1,442,3041322,3.041322
840,7050,4840,34122000,2,6726,1683,1,352876800,352876800,2521,840,1681,840,0,1,842,5738184,5.738184
1240,7050,4840,34122000,2,9926,2483,1,390924800,390924800,3721,1240,2481,1240,0,1,1242,3243841,3.243841
1640,7050,4840,34122000,2,13126,3283,1,428972800,428972800,4921,1640,3281,1640,0,1,1642,2776980,2.77698
2040,7050,4840,34122000,2,16326,4083,1,467020800,467020800,6121,2040,4081,2040,0,1,2042,3407793,3.407793
2440,7050,4840,34122000,2,19526,4883,1,505068800,505068800,7321,2440,4881,2440,0,1,2442,9537653,9.537653
2840,7050,4840,34122000,2,22726,5683,1,543116800,543116800,8521,2840,5681,2840,0,1,2842,15073120,15.07312
3240,7050,4840,34122000,2,25926,6483,1,581164800,581164800,9721,3240,6481,3240,0,1,3242,11887616,11.887616
3640,7050,4840,34122000,2,29126,7283,1,619212800,619212800,10921,3640,7281,3640,0,1,3642,478821,0.478821
4040,7050,4840,34122000,2,32326,8083,1,657260800,657260800,12121,4040,8081,4040,0,1,4042,2796473,2.796473
4440,7050,4840,34122000,2,35526,8883,1,695308800,695308800,13321,4440,8881,4440,0,1,4442,1176452,1.176452
4840,7050,4840,34122000,2,38726,9683,1,733356800,733356800,14521,4840,9681,4840,0,1,4842,3918303,3.918303
5240,7050,4840,34122000,2,41926,10483,1,771404800,771404800,15721,5240,10481,5240,0,1,5242,19716616,19.716616
5640,7050,4840,34122000,2,45126,11283,1,809452800,809452800,16921,5640,11281,5640,0,1,5642,37215477,37.215477
6040,7050,4840,34122000,2,48326,12083,1,847500800,847500800,18121,6040,12081,6040,0,1,6042,39979721,39.979721
6440,7050,4840,34122000,2,51526,12883,1,885548800,885548800,19321,6440,12881,6440,0,1,6442,42545652,42.545652
6840,7050,4840,34122000,2,54726,13683,1,923596800,923596800,20521,6840,13681,6840,0,1,6842,45181729,45.181729
40,6300,5440,34272000,2,326,83,1,277932800,277932800,121,40,81,40,0,1,42,640326,0.640326
440,6300,5440,34272000,2,3526,883,1,315500800,315500800,1321,440,881,440,0,1,442,713039,0.713039
840,6300,5440,34272000,2,6726,1683,1,353068800,353068800,2521,840,1681,840,0,1,842,311376,0.311376
1240,6300,5440,34272000,2,9926,2483,1,390636800,390636800,3721,1240,2481,1240,0,1,1242,178376,0.178376
1640,6300,5440,34272000,2,13126,3283,1,428204800,428204800,4921,1640,3281,1640,0,1,1642,7402505,7.402505
2040,6300,5440,34272000,2,16326,4083,1,465772800,465772800,6121,2040,4081,2040,0,1,2042,1861473,1.861473
2440,6300,5440,34272000,2,19526,4883,1,503340800,503340800,7321,2440,4881,2440,0,1,2442,1619014,1.619014
2840,6300,5440,34272000,2,22726,5683,1,540908800,540908800,8521,2840,5681,2840,0,1,2842,32192,0.032192
3240,6300,5440,34272000,2,25926,6483,1,578476800,578476800,9721,3240,6481,3240,0,1,3242,1573386,1.573386
3640,6300,5440,34272000,2,29126,7283,1,616044800,616044800,10921,3640,7281,3640,0,1,3642,927391,0.927391
4040,6300,5440,34272000,2,32326,8083,1,653612800,653612800,12121,4040,8081,4040,0,1,4042,7397311,7.397311
4440,6300,5440,34272000,2,35526,8883,1,691180800,691180800,13321,4440,8881,4440,0,1,4442,1333832,1.333832
4840,6300,5440,34272000,2,38726,9683,1,728748800,728748800,14521,4840,9681,4840,0,1,4842,9432938,9.432938
5240,6300,5440,34272000,2,41926,10483,1,766316800,766316800,15721,5240,10481,5240,0,1,5242,1842558,1.842558
5640,6300,5440,34272000,2,45126,11283,1,803884800,803884800,16921,5640,11281,5640,0,1,5642,2546923,2.546923
6040,6300,5440,34272000,2,48326,12083,1,841452800,841452800,18121,6040,12081,6040,0,1,6042,14671117,14.671117
6440,6300,5440,34272000,2,51526,12883,1,879020800,879020800,19321,6440,12881,6440,0,1,6442,11200711,11.200711
6840,6300,5440,34272000,2,54726,13683,1,916588800,916588800,20521,6840,13681,6840,0,1,6842,15496948,15.496948
55,7055,4865,34322575,2,446,113,1,279825400,279825400,166,55,111,55,0,1,57,689037,0.689037
455,7055,4865,34322575,2,3646,913,1,317969400,317969400,1366,455,911,455,0,1,457,576569,0.576569
855,7055,4865,34322575,2,6846,1713,1,356113400,356113400,2566,855,1711,855,0,1,857,2233326,2.233326
1255,7055,4865,34322575,2,10046,2513,1,394257400,394257400,3766,1255,2511,1255,0,1,1257,2837323,2.837323
1655,7055,4865,34322575,2,13246,3313,1,432401400,432401400,4966,1655,3311,1655,0,1,1657,6176747,6.176747
2055,7055,4865,34322575,2,16446,4113,1,470545400,470545400,6166,2055,4111,2055,0,1,2057,2743150,2.74315
2455,7055,4865,34322575,2,19646,4913,1,508689400,508689400,7366,2455,4911,2455,0,1,2457,8974382,8.974382
2855,7055,4865,34322575,2,22846,5713,1,546833400,546833400,8566,2855,5711,2855,0,1,2857,4829680,4.82968
3255,7055,4865,34322575,2,26046,6513,1,584977400,584977400,9766,3255,6511,3255,0,1,3257,5732839,5.732839
3655,7055,4865,34322575,2,29246,7313,1,623121400,623121400,10966,3655,7311,3655,0,1,3657,8401412,8.401412
4055,7055,4865,34322575,2,32446,8113,1,661265400,661265400,12166,4055,8111,4055,0,1,4057,2948124,2.948124
4455,7055,4865,34322575,2,35646,8913,1,699409400,699409400,13366,4455,8911,4455,0,1,4457,9043254,9.043254
4855,7055,4865,34322575,2,38846,9713,1,737553400,737553400,14566,4855,9711,4855,0,1,4857,2711395,2.711395
5255,7055,4865,34322575,2,42046,10513,1,775697400,775697400,15766,5255,10511,5255,0,1,5257,16533711,16.533711
5655,7055,4865,34322575,2,45246,11313,1,813841400,813841400,16966,5655,11311,5655,0,1,5657,38079952,38.079952
6055,7055,4865,34322575,2,48446,12113,1,851985400,851985400,18166,6055,12111,6055,0,1,6057,40712847,40.712847
6455,7055,4865,34322575,2,51646,12913,1,890129400,890129400,19366,6455,12911,6455,0,1,6457,43650799,43.650799
6855,7055,4865,34322575,2,54846,13713,1,928273400,928273400,20566,6855,13711,6855,0,1,6857,46155330,46.15533
55,6305,5465,34456825,2,446,113,1,280833400,280833400,166,55,111,55,0,1,57,686248,0.686248
455,6305,5465,34456825,2,3646,913,1,318497400,318497400,1366,455,911,455,0,1,457,3005703,3.005703
855,6305,5465,34456825,2,6846,1713,1,356161400,356161400,2566,855,1711,855,0,1,857,5802796,5.802796
1255,6305,5465,34456825,2,10046,2513,1,393825400,393825400,3766,1255,2511,1255,0,1,1257,6015447,6.015447
1655,6305,5465,34456825,2,13246,3313,1,431489400,431489400,4966,1655,3311,1655,0,1,1657,1549449,1.549449
2055,6305,5465,34456825,2,16446,4113,1,469153400,469153400,6166,2055,4111,2055,0,1,2057,1477883,1.477883
2455,6305,5465,34456825,2,19646,4913,1,506817400,506817400,7366,2455,4911,2455,0,1,2457,1002231,1.002231
2855,6305,5465,34456825,2,22846,5713,1,544481400,544481400,8566,2855,5711,2855,0,1,2857,968402,0.968402
3255,6305,5465,34456825,2,26046,6513,1,582145400,582145400,9766,3255,6511,3255,0,1,3257,260302,0.260302
3655,6305,5465,34456825,2,29246,7313,1,619809400,619809400,10966,3655,7311,3655,0,1,3657,6361022,6.361022
4055,6305,5465,34456825,2,32446,8113,1,657473400,657473400,12166,4055,8111,4055,0,1,4057,4526278,4.526278
4455,6305,5465,34456825,2,35646,8913,1,695137400,695137400,13366,4455,8911,4455,0,1,4457,890412,0.890412
4855,6305,5465,34456825,2,38846,9713,1,732801400,732801400,14566,4855,9711,4855,0,1,4857,3889354,3.889354
5255,6305,5465,34456825,2,42046,10513,1,770465400,770465400,15766,5255,10511,5255,0,1,5257,290023,0.290023
5655,6305,5465,34456825,2,45246,11313,1,808129400,808129400,16966,5655,11311,5655,0,1,5657,22758007,22.758007
6055,6305,5465,34456825,2,48446,12113,1,845793400,845793400,18166,6055,12111,6055,0,1,6057,1075100,1.0751
6455,6305,5465,34456825,2,51646,12913,1,883457400,883457400,19366,6455,12911,6455,0,1,6457,3392683,3.392683
6855,6305,5465,34456825,2,54846,13713,1,921121400,921121400,20566,6855,13711,6855,0,1,6857,38472732,38.472732
40,6050,5740,34727000,2,326,83,1,281588800,281588800,121,40,81,40,0,1,42,614571,0.614571
440,6050,5740,34727000,2,3526,883,1,319316800,319316800,1321,440,881,440,0,1,442,1001569,1.001569
840,6050,5740,34727000,2,6726,1683,1,357044800,357044800,2521,840,1681,840,0,1,842,4520670,4.52067
1240,6050,5740,34727000,2,9926,2483,1,394772800,394772800,3721,1240,2481,1240,0,1,1242,39009,0.039009
1640,6050,5740,34727000,2,13126,3283,1,432500800,432500800,4921,1640,3281,1640,0,1,1642,3598269,3.598269
2040,6050,5740,34727000,2,16326,4083,1,470228800,470228800,6121,2040,4081,2040,0,1,2042,4593115,4.593115
2440,6050,5740,34727000,2,19526,4883,1,507956800,507956800,7321,2440,4881,2440,0,1,2442,482033,0.482033
2840,6050,5740,34727000,2,22726,5683,1,545684800,545684800,8521,2840,5681,2840,0,1,2842,1723693,1.723693
3240,6050,5740,34727000,2,25926,6483,1,583412800,583412800,9721,3240,6481,3240,0,1,3242,1471818,1.471818
3640,6050,5740,34727000,2,29126,7283,1,621140800,621140800,10921,3640,7281,3640,0,1,3642,879350,0.87935
4040,6050,5740,34727000,2,32326,8083,1,658868800,658868800,12121,4040,8081,4040,0,1,4042,483041,0.483041
4440,6050,5740,34727000,2,35526,8883,1,696596800,696596800,13321,4440,8881,4440,0,1,4442,6970062,6.970062
4840,6050,5740,34727000,2,38726,9683,1,734324800,734324800,14521,4840,9681,4840,0,1,4842,4417566,4.417566
5240,6050,5740,34727000,2,41926,10483,1,772052800,772052800,15721,5240,10481,5240,0,1,5242,4421481,4.421481
5640,6050,5740,34727000,2,45126,11283,1,809780800,809780800,16921,5640,11281,5640,0,1,5642,855561,0.855561
6040,6050,5740,34727000,2,48326,12083,1,847508800,847508800,18121,6040,12081,6040,0,1,6042,2576891,2.576891
6440,6050,5740,34727000,2,51526,12883,1,885236800,885236800,19321,6440,12881,6440,0,1,6442,513389,0.513389
6840,6050,5740,34727000,2,54726,13683,1,922964800,922964800,20521,6840,13681,6840,0,1,6842,3241276,3.241276
35,4950,7045,34872750,2,286,73,1,282340600,282340600,106,35,71,35,0,1,37,79744,0.079744
535,4950,7045,34872750,2,4286,1073,1,330320600,330320600,1606,535,1071,535,0,1,537,1663988,1.663988
1035,4950,7045,34872750,2,8286,2073,1,378300600,378300600,3106,1035,2071,1035,0,1,1037,415902,0.415902
1535,4950,7045,34872750,2,12286,3073,1,426280600,426280600,4606,1535,3071,1535,0,1,1537,179241,0.179241
2035,4950,7045,34872750,2,16286,4073,1,474260600,474260600,6106,2035,4071,2035,0,1,2037,33128,0.033128
2535,4950,7045,34872750,2,20286,5073,1,522240600,522240600,7606,2535,5071,2535,0,1,2537,870625,0.870625
3035,4950,7045,34872750,2,24286,6073,1,570220600,570220600,9106,3035,6071,3035,0,1,3037,64580,0.06458
3535,4950,7045,34872750,2,28286,7073,1,618200600,618200600,10606,3535,7071,3535,0,1,3537,702297,0.702297
4035,4950,7045,34872750,2,32286,8073,1,666180600,666180600,12106,4035,8071,4035,0,1,4037,5165411,5.165411
4535,4950,7045,34872750,2,36286,9073,1,714160600,714160600,13606,4535,9071,4535,0,1,4537,4737922,4.737922
5035,4950,7045,34872750,2,40286,10073,1,762140600,762140600,15106,5035,10071,5035,0,1,5037,1234327,1.234327
5535,4950,7045,34872750,2,44286,11073,1,810120600,810120600,16606,5535,11071,5535,0,1,5537,6179621,6.179621
6035,4950,7045,34872750,2,48286,12073,1,858100600,858100600,18106,6035,12071,6035,0,1,6037,8366505,8.366505
6535,4950,7045,34872750,2,52286,13073,1,906080600,906080600,19606,6535,13071,6535,0,1,6537,3994966,3.994966
7035,4950,7045,34872750,2,56286,14073,1,954060600,954060600,21106,7035,14071,7035,0,1,7037,18736254,18.736254
55,6055,5765,34907075,2,446,113,1,284457400,284457400,166,55,111,55,0,1,57,694212,0.694212
455,6055,5765,34907075,2,3646,913,1,322281400,322281400,1366,455,911,455,0,1,457,321756,0.321756
855,6055,5765,34907075,2,6846,1713,1,360105400,360105400,2566,855,1711,855,0,1,857,1927136,1.927136
1255,6055,5765,34907075,2,10046,2513,1,397929400,397929400,3766,1255,2511,1255,0,1,1257,2039222,2.039222
1655,6055,5765,34907075,2,13246,3313,1,435753400,435753400,4966,1655,3311,1655,0,1,1657,3775181,3.775181
2055,6055,5765,34907075,2,16446,4113,1,473577400,473577400,6166,2055,4111,2055,0,1,2057,380511,0.380511
2455,6055,5765,34907075,2,19646,4913,1,511401400,511401400,7366,2455,4911,2455,0,1,2457,238913,0.238913
2855,6055,5765,34907075,2,22846,5713,1,549225400,549225400,8566,2855,5711,2855,0,1,2857,575413,0.575413
3255,6055,5765,34907075,2,26046,6513,1,587049400,587049400,9766,3255,6511,3255,0,1,3257,348074,0.348074
3655,6055,5765,34907075,2,29246,7313,1,624873400,624873400,10966,3655,7311,3655,0,1,3657,4444646,4.444646
4055,6055,5765,34907075,2,32446,8113,1,662697400,662697400,12166,4055,8111,4055,0,1,4057,2121182,2.121182
4455,6055,5765,34907075,2,35646,8913,1,700521400,700521400,13366,4455,8911,4455,0,1,4457,1655775,1.655775
4855,6055,5765,34907075,2,38846,9713,1,738345400,738345400,14566,4855,9711,4855,0,1,4857,6795180,6.79518
5255,6055,5765,34907075,2,42046,10513,1,776169400,776169400,15766,5255,10511,5255,0,1,5257,1589540,1.58954
5655,6055,5765,34907075,2,45246,11313,1,813993400,813993400,16966,5655,11311,5655,0,1,5657,490414,0.490414
6055,6055,5765,34907075,2,48446,12113,1,851817400,851817400,18166,6055,12111,6055,0,1,6057,2601015,2.601015
6455,6055,5765,34907075,2,51646,12913,1,889641400,889641400,19366,6455,12911,6455,0,1,6457,5051327,5.051327
6855,6055,5765,34907075,2,54846,13713,1,927465400,927465400,20566,6855,13711,6855,0,1,6857,8357510,8.35751
40,6800,5140,34952000,2,326,83,1,283436800,283436800,121,40,81,40,0,1,42,100255,0.100255
440,6800,5140,34952000,2,3526,883,1,321644800,321644800,1321,440,881,440,0,1,442,403990,0.40399
840,6800,5140,34952000,2,6726,1683,1,359852800,359852800,2521,840,1681,840,0,1,842,27207,0.027207
1240,6800,5140,34952000,2,9926,2483,1,398060800,398060800,3721,1240,2481,1240,0,1,1242,790679,0.790679
1640,6800,5140,34952000,2,13126,3283,1,436268800,436268800,4921,1640,3281,1640,0,1,1642,1014578,1.014578
2040,6800,5140,34952000,2,16326,4083,1,474476800,474476800,6121,2040,4081,2040,0,1,2042,1218610,1.21861
2440,6800,5140,34952000,2,19526,4883,1,512684800,512684800,7321,2440,4881,2440,0,1,2442,4931615,4.931615
2840,6800,5140,34952000,2,22726,5683,1,550892800,550892800,8521,2840,5681,2840,0,1,2842,4804914,4.804914
3240,6800,5140,34952000,2,25926,6483,1,589100800,589100800,9721,3240,6481,3240,0,1,3242,613190,0.61319
3640,6800,5140,34952000,2,29126,7283,1,627308800,627308800,10921,3640,7281,3640,0,1,3642,7167934,7.167934
4040,6800,5140,34952000,2,32326,8083,1,665516800,665516800,12121,4040,8081,4040,0,1,4042,1057998,1.057998
4440,6800,5140,34952000,2,35526,8883,1,703724800,703724800,13321,4440,8881,4440,0,1,4442,2731526,2.731526
4840,6800,5140,34952000,2,38726,9683,1,741932800,741932800,14521,4840,9681,4840,0,1,4842,151068,0.151068
5240,6800,5140,34952000,2,41926,10483,1,780140800,780140800,15721,5240,10481,5240,0,1,5242,2238714,2.238714
5640,6800,5140,34952000,2,45126,11283,1,818348800,818348800,16921,5640,11281,5640,0,1,5642,2739084,2.739084
6040,6800,5140,34952000,2,48326,12083,1,856556800,856556800,18121,6040,12081,6040,0,1,6042,1132264,1.132264
6440,6800,5140,34952000,2,51526,12883,1,894764800,894764800,19321,6440,12881,6440,0,1,6442,172663,0.172663
6840,6800,5140,34952000,2,54726,13683,1,932972800,932972800,20521,6840,13681,6840,0,1,6842,7920411,7.920411
40,5800,6040,35032000,2,326,83,1,284044800,284044800,121,40,81,40,0,1,42,60042,0.060042
440,5800,6040,35032000,2,3526,883,1,321932800,321932800,1321,440,881,440,0,1,442,75563,0.075563
840,5800,6040,35032000,2,6726,1683,1,359820800,359820800,2521,840,1681,840,0,1,842,47990,0.04799
1240,5800,6040,35032000,2,9926,2483,1,397708800,397708800,3721,1240,2481,1240,0,1,1242,298793,0.298793
1640,5800,6040,35032000,2,13126,3283,1,435596800,435596800,4921,1640,3281,1640,0,1,1642,30755,0.030755
2040,5800,6040,35032000,2,16326,4083,1,473484800,473484800,6121,2040,4081,2040,0,1,2042,657909,0.657909
2440,5800,6040,35032000,2,19526,4883,1,511372800,511372800,7321,2440,4881,2440,0,1,2442,635910,0.63591
2840,5800,6040,35032000,2,22726,5683,1,549260800,549260800,8521,2840,5681,2840,0,1,2842,729208,0.729208
3240,5800,6040,35032000,2,25926,6483,1,587148800,587148800,9721,3240,6481,3240,0,1,3242,203150,0.20315
3640,5800,6040,35032000,2,29126,7283,1,625036800,625036800,10921,3640,7281,3640,0,1,3642,481820,0.48182
4040,5800,6040,35032000,2,32326,8083,1,662924800,662924800,12121,4040,8081,4040,0,1,4042,661389,0.661389
4440,5800,6040,35032000,2,35526,8883,1,700812800,700812800,13321,4440,8881,4440,0,1,4442,1361073,1.361073
4840,5800,6040,35032000,2,38726,9683,1,738700800,738700800,14521,4840,9681,4840,0,1,4842,1074187,1.074187
5240,5800,6040,35032000,2,41926,10483,1,776588800,776588800,15721,5240,10481,5240,0,1,5242,3545013,3.545013
5640,5800,6040,35032000,2,45126,11283,1,814476800,814476800,16921,5640,11281,5640,0,1,5642,365607,0.365607
6040,5800,6040,35032000,2,48326,12083,1,852364800,852364800,18121,6040,12081,6040,0,1,6042,896712,0.896712
6440,5800,6040,35032000,2,51526,12883,1,890252800,890252800,19321,6440,12881,6440,0,1,6442,853338,0.853338
6840,5800,6040,35032000,2,54726,13683,1,928140800,928140800,20521,6840,13681,6840,0,1,6842,570689,0.570689
40,5050,6940,35047000,2,326,83,1,284212800,284212800,121,40,81,40,0,1,42,35419,0.035419
440,5050,6940,35047000,2,3526,883,1,322580800,322580800,1321,440,881,440,0,1,442,92077,0.092077
840,5050,6940,35047000,2,6726,1683,1,360948800,360948800,2521,840,1681,840,0,1,842,29384,0.029384
1240,5050,6940,35047000,2,9926,2483,1,399316800,399316800,3721,1240,2481,1240,0,1,1242,185371,0.185371
1640,5050,6940,35047000,2,13126,3283,1,437684800,437684800,4921,1640,3281,1640,0,1,1642,92744,0.092744
2040,5050,6940,35047000,2,16326,4083,1,476052800,476052800,6121,2040,4081,2040,0,1,2042,1146815,1.146815
2440,5050,6940,35047000,2,19526,4883,1,514420800,514420800,7321,2440,4881,2440,0,1,2442,60389,0.060389
2840,5050,6940,35047000,2,22726,5683,1,552788800,552788800,8521,2840,5681,2840,0,1,2842,486892,0.486892
3240,5050,6940,35047000,2,25926,6483,1,591156800,591156800,9721,3240,6481,3240,0,1,3242,381746,0.381746
3640,5050,6940,35047000,2,29126,7283,1,629524800,629524800,10921,3640,7281,3640,0,1,3642,298943,0.298943
4040,5050,6940,35047000,2,32326,8083,1,667892800,667892800,12121,4040,8081,4040,0,1,4042,196397,0.196397
4440,5050,6940,35047000,2,35526,8883,1,706260800,706260800,13321,4440,8881,4440,0,1,4442,1150911,1.150911
4840,5050,6940,35047000,2,38726,9683,1,744628800,744628800,14521,4840,9681,4840,0,1,4842,457097,0.457097
5240,5050,6940,35047000,2,41926,10483,1,782996800,782996800,15721,5240,10481,5240,0,1,5242,3912284,3.912284
5640,5050,6940,35047000,2,45126,11283,1,821364800,821364800,16921,5640,11281,5640,0,1,5642,296901,0.296901
6040,5050,6940,35047000,2,48326,12083,1,859732800,859732800,18121,6040,12081,6040,0,1,6042,764086,0.764086
6440,5050,6940,35047000,2,51526,12883,1,898100800,898100800,19321,6440,12881,6440,0,1,6442,464853,0.464853
6840,5050,6940,35047000,2,54726,13683,1,936468800,936468800,20521,6840,13681,6840,0,1,6842,75148,0.075148
55,6805,5165,35147825,2,446,113,1,286449400,286449400,166,55,111,55,0,1,57,106446,0.106446
455,6805,5165,35147825,2,3646,913,1,324753400,324753400,1366,455,911,455,0,1,457,2199004,2.199004
855,6805,5165,35147825,2,6846,1713,1,363057400,363057400,2566,855,1711,855,0,1,857,378394,0.378394
1255,6805,5165,35147825,2,10046,2513,1,401361400,401361400,3766,1255,2511,1255,0,1,1257,1735883,1.735883
1655,6805,5165,35147825,2,13246,3313,1,439665400,439665400,4966,1655,3311,1655,0,1,1657,1125228,1.125228
2055,6805,5165,35147825,2,16446,4113,1,477969400,477969400,6166,2055,4111,2055,0,1,2057,44133,0.044133
2455,6805,5165,35147825,2,19646,4913,1,516273400,516273400,7366,2455,4911,2455,0,1,2457,3152016,3.152016
2855,6805,5165,35147825,2,22846,5713,1,554577400,554577400,8566,2855,5711,2855,0,1,2857,2469536,2.469536
3255,6805,5165,35147825,2,26046,6513,1,592881400,592881400,9766,3255,6511,3255,0,1,3257,9189215,9.189215
3655,6805,5165,35147825,2,29246,7313,1,631185400,631185400,10966,3655,7311,3655,0,1,3657,641285,0.641285
4055,6805,5165,35147825,2,32446,8113,1,669489400,669489400,12166,4055,8111,4055,0,1,4057,2169182,2.169182
4455,6805,5165,35147825,2,35646,8913,1,707793400,707793400,13366,4455,8911,4455,0,1,4457,1467239,1.467239
4855,6805,5165,35147825,2,38846,9713,1,746097400,746097400,14566,4855,9711,4855,0,1,4857,2614281,2.614281
5255,6805,5165,35147825,2,42046,10513,1,784401400,784401400,15766,5255,10511,5255,0,1,5257,1469367,1.469367
5655,6805,5165,35147825,2,45246,11313,1,822705400,822705400,16966,5655,11311,5655,0,1,5657,966935,0.966935
6055,6805,5165,35147825,2,48446,12113,1,861009400,861009400,18166,6055,12111,6055,0,1,6057,598068,0.598068
6455,6805,5165,35147825,2,51646,12913,1,899313400,899313400,19366,6455,12911,6455,0,1,6457,3213226,3.213226
6855,6805,5165,35147825,2,54846,13713,1,937617400,937617400,20566,6855,13711,6855,0,1,6857,365392,0.365392
39,4993,7041,35155713,2,318,81,1,285000312,285000312,118,39,79,39,0,1,41,618070,0.61807
539,4993,7041,35155713,2,4318,1081,1,333136312,333136312,1618,539,1079,539,0,1,541,1896845,1.896845
1039,4993,7041,35155713,2,8318,2081,1,381272312,381272312,3118,1039,2079,1039,0,1,1041,1587766,1.587766
1539,4993,7041,35155713,2,12318,3081,1,429408312,429408312,4618,1539,3079,1539,0,1,1541,5541335,5.541335
2039,4993,7041,35155713,2,16318,4081,1,477544312,477544312,6118,2039,4079,2039,0,1,2041,8445881,8.445881
2539,4993,7041,35155713,2,20318,5081,1,525680312,525680312,7618,2539,5079,2539,0,1,2541,3290733,3.290733
3039,4993,7041,35155713,2,24318,6081,1,573816312,573816312,9118,3039,6079,3039,0,1,3041,2025354,2.025354
3539,4993,7041,35155713,2,28318,7081,1,621952312,621952312,10618,3539,7079,3539,0,1,3541,6182395,6.182395
4039,4993,7041,35155713,2,32318,8081,1,670088312,670088312,12118,4039,8079,4039,0,1,4041,6822495,6.822495
4539,4993,7041,35155713,2,36318,9081,1,718224312,718224312,13618,4539,9079,4539,0,1,4541,5095585,5.095585
5039,4993,7041,35155713,2,40318,10081,1,766360312,766360312,15118,5039,10079,5039,0,1,5041,1828824,1.828824
5539,4993,7041,35155713,2,44318,11081,1,814496312,814496312,16618,5539,11079,5539,0,1,5541,36426603,36.426603
6039,4993,7041,35155713,2,48318,12081,1,862632312,862632312,18118,6039,12079,6039,0,1,6041,39687307,39.687307
6539,4993,7041,35155713,2,52318,13081,1,910768312,910768312,19618,6539,13079,6539,0,1,6541,43034754,43.034754
7039,4993,7041,35155713,2,56318,14081,1,958904312,958904312,21118,7039,14079,7039,0,1,7041,46328732,46.328732
40,5550,6340,35187000,2,326,83,1,285300800,285300800,121,40,81,40,0,1,42,642157,0.642157
440,5550,6340,35187000,2,3526,883,1,323348800,323348800,1321,440,881,440,0,1,442,2180494,2.180494
840,5550,6340,35187000,2,6726,1683,1,361396800,361396800,2521,840,1681,840,0,1,842,5909482,5.909482
1240,5550,6340,35187000,2,9926,2483,1,399444800,399444800,3721,1240,2481,1240,0,1,1242,5975683,5.975683
1640,5550,6340,35187000,2,13126,3283,1,437492800,437492800,4921,1640,3281,1640,0,1,1642,3289709,3.289709
2040,5550,6340,35187000,2,16326,4083,1,475540800,475540800,6121,2040,4081,2040,0,1,2042,7731630,7.73163
2440,5550,6340,35187000,2,19526,4883,1,513588800,513588800,7321,2440,4881,2440,0,1,2442,3628611,3.628611
2840,5550,6340,35187000,2,22726,5683,1,551636800,551636800,8521,2840,5681,2840,0,1,2842,100412,0.100412
3240,5550,6340,35187000,2,25926,6483,1,589684800,589684800,9721,3240,6481,3240,0,1,3242,547092,0.547092
3640,5550,6340,35187000,2,29126,7283,1,627732800,627732800,10921,3640,7281,3640,0,1,3642,9141817,9.141817
4040,5550,6340,35187000,2,32326,8083,1,665780800,665780800,12121,4040,8081,4040,0,1,4042,1921073,1.921073
4440,5550,6340,35187000,2,35526,8883,1,703828800,703828800,13321,4440,8881,4440,0,1,4442,210085,0.210085
4840,5550,6340,35187000,2,38726,9683,1,741876800,741876800,14521,4840,9681,4840,0,1,4842,989856,0.989856
5240,5550,6340,35187000,2,41926,10483,1,779924800,779924800,15721,5240,10481,5240,0,1,5242,2375432,2.375432
5640,5550,6340,35187000,2,45126,11283,1,817972800,817972800,16921,5640,11281,5640,0,1,5642,2014644,2.014644
6040,5550,6340,35187000,2,48326,12083,1,856020800,856020800,18121,6040,12081,6040,0,1,6042,1458582,1.458582
6440,5550,6340,35187000,2,51526,12883,1,894068800,894068800,19321,6440,12881,6440,0,1,6442,2378467,2.378467
6840,5550,6340,35187000,2,54726,13683,1,932116800,932116800,20521,6840,13681,6840,0,1,6842,4325216,4.325216
40,5300,6640,35192000,2,326,83,1,285356800,285356800,121,40,81,40,0,1,42,630761,0.630761
440,5300,6640,35192000,2,3526,883,1,323564800,323564800,1321,440,881,440,0,1,442,3208169,3.208169
840,5300,6640,35192000,2,6726,1683,1,361772800,361772800,2521,840,1681,840,0,1,842,1606069,1.606069
1240,5300,6640,35192000,2,9926,2483,1,399980800,399980800,3721,1240,2481,1240,0,1,1242,99817,0.099817
1640,5300,6640,35192000,2,13126,3283,1,438188800,438188800,4921,1640,3281,1640,0,1,1642,142451,0.142451
2040,5300,6640,35192000,2,16326,4083,1,476396800,476396800,6121,2040,4081,2040,0,1,2042,522980,0.52298
2440,5300,6640,35192000,2,19526,4883,1,514604800,514604800,7321,2440,4881,2440,0,1,2442,37941,0.037941
2840,5300,6640,35192000,2,22726,5683,1,552812800,552812800,8521,2840,5681,2840,0,1,2842,899489,0.899489
3240,5300,6640,35192000,2,25926,6483,1,591020800,591020800,9721,3240,6481,3240,0,1,3242,234261,0.234261
3640,5300,6640,35192000,2,29126,7283,1,629228800,629228800,10921,3640,7281,3640,0,1,3642,131885,0.131885
4040,5300,6640,35192000,2,32326,8083,1,667436800,667436800,12121,4040,8081,4040,0,1,4042,3198159,3.198159
4440,5300,6640,35192000,2,35526,8883,1,705644800,705644800,13321,4440,8881,4440,0,1,4442,416722,0.416722
4840,5300,6640,35192000,2,38726,9683,1,743852800,743852800,14521,4840,9681,4840,0,1,4842,1169212,1.169212
5240,5300,6640,35192000,2,41926,10483,1,782060800,782060800,15721,5240,10481,5240,0,1,5242,1211600,1.2116
5640,5300,6640,35192000,2,45126,11283,1,820268800,820268800,16921,5640,11281,5640,0,1,5642,1355714,1.355714
6040,5300,6640,35192000,2,48326,12083,1,858476800,858476800,18121,6040,12081,6040,0,1,6042,5889810,5.88981
6440,5300,6640,35192000,2,51526,12883,1,896684800,896684800,19321,6440,12881,6440,0,1,6442,5246308,5.246308
6840,5300,6640,35192000,2,54726,13683,1,934892800,934892800,20521,6840,13681,6840,0,1,6842,2980086,2.980086
55,5805,6065,35207325,2,446,113,1,286881400,286881400,166,55,111,55,0,1,57,47742,0.047742
455,5805,6065,35207325,2,3646,913,1,324865400,324865400,1366,455,911,455,0,1,457,25982,0.025982
855,5805,6065,35207325,2,6846,1713,1,362849400,362849400,2566,855,1711,855,0,1,857,166748,0.166748
1255,5805,6065,35207325,2,10046,2513,1,400833400,400833400,3766,1255,2511,1255,0,1,1257,411146,0.411146
1655,5805,6065,35207325,2,13246,3313,1,438817400,438817400,4966,1655,3311,1655,0,1,1657,107553,0.107553
2055,5805,6065,35207325,2,16446,4113,1,476801400,476801400,6166,2055,4111,2055,0,1,2057,49164,0.049164
2455,5805,6065,35207325,2,19646,4913,1,514785400,514785400,7366,2455,4911,2455,0,1,2457,272799,0.272799
2855,5805,6065,35207325,2,22846,5713,1,552769400,552769400,8566,2855,5711,2855,0,1,2857,1569089,1.569089
3255,5805,6065,35207325,2,26046,6513,1,590753400,590753400,9766,3255,6511,3255,0,1,3257,37482,0.037482
3655,5805,6065,35207325,2,29246,7313,1,628737400,628737400,10966,3655,7311,3655,0,1,3657,174012,0.174012
4055,5805,6065,35207325,2,32446,8113,1,666721400,666721400,12166,4055,8111,4055,0,1,4057,188090,0.18809
4455,5805,6065,35207325,2,35646,8913,1,704705400,704705400,13366,4455,8911,4455,0,1,4457,56466,0.056466
4855,5805,6065,35207325,2,38846,9713,1,742689400,742689400,14566,4855,9711,4855,0,1,4857,1414768,1.414768
5255,5805,6065,35207325,2,42046,10513,1,780673400,780673400,15766,5255,10511,5255,0,1,5257,2184471,2.184471
5655,5805,6065,35207325,2,45246,11313,1,818657400,818657400,16966,5655,11311,5655,0,1,5657,219189,0.219189
6055,5805,6065,35207325,2,48446,12113,1,856641400,856641400,18166,6055,12111,6055,0,1,6057,307871,0.307871
6455,5805,6065,35207325,2,51646,12913,1,894625400,894625400,19366,6455,12911,6455,0,1,6457,4213317,4.213317
6855,5805,6065,35207325,2,54846,13713,1,932609400,932609400,20566,6855,13711,6855,0,1,6857,52406,0.052406
55,5055,6965,35208075,2,446,113,1,286953400,286953400,166,55,111,55,0,1,57,48338,0.048338
455,5055,6965,35208075,2,3646,913,1,325417400,325417400,1366,455,911,455,0,1,457,48274,0.048274
855,5055,6965,35208075,2,6846,1713,1,363881400,363881400,2566,855,1711,855,0,1,857,175301,0.175301
1255,5055,6965,35208075,2,10046,2513,1,402345400,402345400,3766,1255,2511,1255,0,1,1257,217048,0.217048
1655,5055,6965,35208075,2,13246,3313,1,440809400,440809400,4966,1655,3311,1655,0,1,1657,58185,0.058185
2055,5055,6965,35208075,2,16446,4113,1,479273400,479273400,6166,2055,4111,2055,0,1,2057,138901,0.138901
2455,5055,6965,35208075,2,19646,4913,1,517737400,517737400,7366,2455,4911,2455,0,1,2457,386049,0.386049
2855,5055,6965,35208075,2,22846,5713,1,556201400,556201400,8566,2855,5711,2855,0,1,2857,224692,0.224692
3255,5055,6965,35208075,2,26046,6513,1,594665400,594665400,9766,3255,6511,3255,0,1,3257,749480,0.74948
3655,5055,6965,35208075,2,29246,7313,1,633129400,633129400,10966,3655,7311,3655,0,1,3657,457222,0.457222
4055,5055,6965,35208075,2,32446,8113,1,671593400,671593400,12166,4055,8111,4055,0,1,4057,7062477,7.062477
4455,5055,6965,35208075,2,35646,8913,1,710057400,710057400,13366,4455,8911,4455,0,1,4457,3988312,3.988312
4855,5055,6965,35208075,2,38846,9713,1,748521400,748521400,14566,4855,9711,4855,0,1,4857,1342726,1.342726
5255,5055,6965,35208075,2,42046,10513,1,786985400,786985400,15766,5255,10511,5255,0,1,5257,726872,0.726872
5655,5055,6965,35208075,2,45246,11313,1,825449400,825449400,16966,5655,11311,5655,0,1,5657,1933627,1.933627
6055,5055,6965,35208075,2,48446,12113,1,863913400,863913400,18166,6055,12111,6055,0,1,6057,78149,0.078149
6455,5055,6965,35208075,2,51646,12913,1,902377400,902377400,19366,6455,12911,6455,0,1,6457,83975,0.083975
6855,5055,6965,35208075,2,54846,13713,1,940841400,940841400,20566,6855,13711,6855,0,1,6857,132121,0.132121
44,5003,7055,35296165,2,358,91,1,286613736,286613736,133,44,89,44,0,1,46,662559,0.662559
544,5003,7055,35296165,2,4358,1091,1,334845736,334845736,1633,544,1089,544,0,1,546,3863478,3.863478
1044,5003,7055,35296165,2,8358,2091,1,383077736,383077736,3133,1044,2089,1044,0,1,1046,559698,0.559698
1544,5003,7055,35296165,2,12358,3091,1,431309736,431309736,4633,1544,3089,1544,0,1,1546,4097696,4.097696
2044,5003,7055,35296165,2,16358,4091,1,479541736,479541736,6133,2044,4089,2044,0,1,2046,9001628,9.001628
2544,5003,7055,35296165,2,20358,5091,1,527773736,527773736,7633,2544,5089,2544,0,1,2546,10528016,10.528016
3044,5003,7055,35296165,2,24358,6091,1,576005736,576005736,9133,3044,6089,3044,0,1,3046,865189,0.865189
3544,5003,7055,35296165,2,28358,7091,1,624237736,624237736,10633,3544,7089,3544,0,1,3546,20709924,20.709924
4044,5003,7055,35296165,2,32358,8091,1,672469736,672469736,12133,4044,8089,4044,0,1,4046,9628703,9.628703
4544,5003,7055,35296165,2,36358,9091,1,720701736,720701736,13633,4544,9089,4544,0,1,4546,4673684,4.673684
5044,5003,7055,35296165,2,40358,10091,1,768933736,768933736,15133,5044,10089,5044,0,1,5046,5162852,5.162852
5544,5003,7055,35296165,2,44358,11091,1,817165736,817165736,16633,5544,11089,5544,0,1,5546,36738375,36.738375
6044,5003,7055,35296165,2,48358,12091,1,865397736,865397736,18133,6044,12089,6044,0,1,6046,40109008,40.109008
6544,5003,7055,35296165,2,52358,13091,1,913629736,913629736,19633,6544,13089,6544,0,1,6546,43307002,43.307002
7044,5003,7055,35296165,2,56358,14091,1,961861736,961861736,21133,7044,14089,7044,0,1,7046,46653047,46.653047
55,5555,6365,35357575,2,446,113,1,288105400,288105400,166,55,111,55,0,1,57,731962,0.731962
455,5555,6365,35357575,2,3646,913,1,326249400,326249400,1366,455,911,455,0,1,457,3350225,3.350225
855,5555,6365,35357575,2,6846,1713,1,364393400,364393400,2566,855,1711,855,0,1,857,507524,0.507524
1255,5555,6365,35357575,2,10046,2513,1,402537400,402537400,3766,1255,2511,1255,0,1,1257,4159080,4.15908
1655,5555,6365,35357575,2,13246,3313,1,440681400,440681400,4966,1655,3311,1655,0,1,1657,6414147,6.414147
2055,5555,6365,35357575,2,16446,4113,1,478825400,478825400,6166,2055,4111,2055,0,1,2057,391946,0.391946
2455,5555,6365,35357575,2,19646,4913,1,516969400,516969400,7366,2455,4911,2455,0,1,2457,3595683,3.595683
2855,5555,6365,35357575,2,22846,5713,1,555113400,555113400,8566,2855,5711,2855,0,1,2857,11664671,11.664671
3255,5555,6365,35357575,2,26046,6513,1,593257400,593257400,9766,3255,6511,3255,0,1,3257,4201800,4.2018
3655,5555,6365,35357575,2,29246,7313,1,631401400,631401400,10966,3655,7311,3655,0,1,3657,5066529,5.066529
4055,5555,6365,35357575,2,32446,8113,1,669545400,669545400,12166,4055,8111,4055,0,1,4057,3879310,3.87931
4455,5555,6365,35357575,2,35646,8913,1,707689400,707689400,13366,4455,8911,4455,0,1,4457,1563755,1.563755
4855,5555,6365,35357575,2,38846,9713,1,745833400,745833400,14566,4855,9711,4855,0,1,4857,451031,0.451031
5255,5555,6365,35357575,2,42046,10513,1,783977400,783977400,15766,5255,10511,5255,0,1,5257,73820,0.07382
5655,5555,6365,35357575,2,45246,11313,1,822121400,822121400,16966,5655,11311,5655,0,1,5657,1103288,1.103288
6055,5555,6365,35357575,2,48446,12113,1,860265400,860265400,18166,6055,12111,6055,0,1,6057,3792177,3.792177
6455,5555,6365,35357575,2,51646,12913,1,898409400,898409400,19366,6455,12911,6455,0,1,6457,2715026,2.715026
6855,5555,6365,35357575,2,54846,13713,1,936553400,936553400,20566,6855,13711,6855,0,1,6857,3729541,3.729541
55,5305,6665,35357825,2,446,113,1,288129400,288129400,166,55,111,55,0,1,57,305489,0.305489
455,5305,6665,35357825,2,3646,913,1,326433400,326433400,1366,455,911,455,0,1,457,170869,0.170869
855,5305,6665,35357825,2,6846,1713,1,364737400,364737400,2566,855,1711,855,0,1,857,1353579,1.353579
1255,5305,6665,35357825,2,10046,2513,1,403041400,403041400,3766,1255,2511,1255,0,1,1257,2236597,2.236597
1655,5305,6665,35357825,2,13246,3313,1,441345400,441345400,4966,1655,3311,1655,0,1,1657,3142443,3.142443
2055,5305,6665,35357825,2,16446,4113,1,479649400,479649400,6166,2055,4111,2055,0,1,2057,226860,0.22686
2455,5305,6665,35357825,2,19646,4913,1,517953400,517953400,7366,2455,4911,2455,0,1,2457,1084476,1.084476
2855,5305,6665,35357825,2,22846,5713,1,556257400,556257400,8566,2855,5711,2855,0,1,2857,2511436,2.511436
3255,5305,6665,35357825,2,26046,6513,1,594561400,594561400,9766,3255,6511,3255,0,1,3257,8816407,8.816407
3655,5305,6665,35357825,2,29246,7313,1,632865400,632865400,10966,3655,7311,3655,0,1,3657,1064694,1.064694
4055,5305,6665,35357825,2,32446,8113,1,671169400,671169400,12166,4055,8111,4055,0,1,4057,819424,0.819424
4455,5305,6665,35357825,2,35646,8913,1,709473400,709473400,13366,4455,8911,4455,0,1,4457,2712590,2.71259
4855,5305,6665,35357825,2,38846,9713,1,747777400,747777400,14566,4855,9711,4855,0,1,4857,3828035,3.828035
5255,5305,6665,35357825,2,42046,10513,1,786081400,786081400,15766,5255,10511,5255,0,1,5257,76245,0.076245
5655,5305,6665,35357825,2,45246,11313,1,824385400,824385400,16966,5655,11311,5655,0,1,5657,2653857,2.653857
6055,5305,6665,35357825,2,48446,12113,1,862689400,862689400,18166,6055,12111,6055,0,1,6057,2596175,2.596175
6455,5305,6665,35357825,2,51646,12913,1,900993400,900993400,19366,6455,12911,6455,0,1,6457,2481554,2.481554
6855,5305,6665,35357825,2,54846,13713,1,939297400,939297400,20566,6855,13711,6855,0,1,6857,2651492,2.651492
40,6550,5440,35632000,2,326,83,1,288892800,288892800,121,40,81,40,0,1,42,50098,0.050098
440,6550,5440,35632000,2,3526,883,1,327260800,327260800,1321,440,881,440,0,1,442,108137,0.108137
840,6550,5440,35632000,2,6726,1683,1,365628800,365628800,2521,840,1681,840,0,1,842,28726,0.028726
1240,6550,5440,35632000,2,9926,2483,1,403996800,403996800,3721,1240,2481,1240,0,1,1242,158476,0.158476
1640,6550,5440,35632000,2,13126,3283,1,442364800,442364800,4921,1640,3281,1640,0,1,1642,226309,0.226309
2040,6550,5440,35632000,2,16326,4083,1,480732800,480732800,6121,2040,4081,2040,0,1,2042,259789,0.259789
2440,6550,5440,35632000,2,19526,4883,1,519100800,519100800,7321,2440,4881,2440,0,1,2442,1012079,1.012079
2840,6550,5440,35632000,2,22726,5683,1,557468800,557468800,8521,2840,5681,2840,0,1,2842,575366,0.575366
3240,6550,5440,35632000,2,25926,6483,1,595836800,595836800,9721,3240,6481,3240,0,1,3242,538708,0.538708
3640,6550,5440,35632000,2,29126,7283,1,634204800,634204800,10921,3640,7281,3640,0,1,3642,39603,0.039603
4040,6550,5440,35632000,2,32326,8083,1,672572800,672572800,12121,4040,8081,4040,0,1,4042,951157,0.951157
4440,6550,5440,35632000,2,35526,8883,1,710940800,710940800,13321,4440,8881,4440,0,1,4442,451424,0.451424
4840,6550,5440,35632000,2,38726,9683,1,749308800,749308800,14521,4840,9681,4840,0,1,4842,1406194,1.406194
5240,6550,5440,35632000,2,41926,10483,1,787676800,787676800,15721,5240,10481,5240,0,1,5242,3302106,3.302106
5640,6550,5440,35632000,2,45126,11283,1,826044800,826044800,16921,5640,11281,5640,0,1,5642,418348,0.418348
6040,6550,5440,35632000,2,48326,12083,1,864412800,864412800,18121,6040,12081,6040,0,1,6042,77498,0.077498
6440,6550,5440,35632000,2,51526,12883,1,902780800,902780800,19321,6440,12881,6440,0,1,6442,144483,0.144483
6840,6550,5440,35632000,2,54726,13683,1,941148800,941148800,20521,6840,13681,6840,0,1,6842,998161,0.998161
55,6555,5465,35823075,2,446,113,1,291873400,291873400,166,55,111,55,0,1,57,28831,0.028831
455,6555,5465,35823075,2,3646,913,1,330337400,330337400,1366,455,911,455,0,1,457,215628,0.215628
855,6555,5465,35823075,2,6846,1713,1,368801400,368801400,2566,855,1711,855,0,1,857,210097,0.210097
1255,6555,5465,35823075,2,10046,2513,1,407265400,407265400,3766,1255,2511,1255,0,1,1257,165382,0.165382
1655,6555,5465,35823075,2,13246,3313,1,445729400,445729400,4966,1655,3311,1655,0,1,1657,98891,0.098891
2055,6555,5465,35823075,2,16446,4113,1,484193400,484193400,6166,2055,4111,2055,0,1,2057,371814,0.371814
2455,6555,5465,35823075,2,19646,4913,1,522657400,522657400,7366,2455,4911,2455,0,1,2457,878786,0.878786
2855,6555,5465,35823075,2,22846,5713,1,561121400,561121400,8566,2855,5711,2855,0,1,2857,836444,0.836444
3255,6555,5465,35823075,2,26046,6513,1,599585400,599585400,9766,3255,6511,3255,0,1,3257,623150,0.62315
3655,6555,5465,35823075,2,29246,7313,1,638049400,638049400,10966,3655,7311,3655,0,1,3657,174067,0.174067
4055,6555,5465,35823075,2,32446,8113,1,676513400,676513400,12166,4055,8111,4055,0,1,4057,1286797,1.286797
4455,6555,5465,35823075,2,35646,8913,1,714977400,714977400,13366,4455,8911,4455,0,1,4457,224432,0.224432
4855,6555,5465,35823075,2,38846,9713,1,753441400,753441400,14566,4855,9711,4855,0,1,4857,673554,0.673554
5255,6555,5465,35823075,2,42046,10513,1,791905400,791905400,15766,5255,10511,5255,0,1,5257,1883008,1.883008
5655,6555,5465,35823075,2,45246,11313,1,830369400,830369400,16966,5655,11311,5655,0,1,5657,910336,0.910336
6055,6555,5465,35823075,2,48446,12113,1,868833400,868833400,18166,6055,12111,6055,0,1,6057,989945,0.989945
6455,6555,5465,35823075,2,51646,12913,1,907297400,907297400,19366,6455,12911,6455,0,1,6457,142840,0.14284
6855,6555,5465,35823075,2,54846,13713,1,945761400,945761400,20566,6855,13711,6855,0,1,6857,2957575,2.957575
35,5500,6545,35997500,2,286,73,1,291352600,291352600,106,35,71,35,0,1,37,136085,0.136085
535,5500,6545,35997500,2,4286,1073,1,339532600,339532600,1606,535,1071,535,0,1,537,26569,0.026569
1035,5500,6545,35997500,2,8286,2073,1,387712600,387712600,3106,1035,2071,1035,0,1,1037,79598,0.079598
1535,5500,6545,35997500,2,12286,3073,1,435892600,435892600,4606,1535,3071,1535,0,1,1537,545304,0.545304
2035,5500,6545,35997500,2,16286,4073,1,484072600,484072600,6106,2035,4071,2035,0,1,2037,374231,0.374231
2535,5500,6545,35997500,2,20286,5073,1,532252600,532252600,7606,2535,5071,2535,0,1,2537,605495,0.605495
3035,5500,6545,35997500,2,24286,6073,1,580432600,580432600,9106,3035,6071,3035,0,1,3037,1056011,1.056011
3535,5500,6545,35997500,2,28286,7073,1,628612600,628612600,10606,3535,7071,3535,0,1,3537,5406193,5.406193
4035,5500,6545,35997500,2,32286,8073,1,676792600,676792600,12106,4035,8071,4035,0,1,4037,2588901,2.588901
4535,5500,6545,35997500,2,36286,9073,1,724972600,724972600,13606,4535,9071,4535,0,1,4537,4494773,4.494773
5035,5500,6545,35997500,2,40286,10073,1,773152600,773152600,15106,5035,10071,5035,0,1,5037,1705489,1.705489
5535,5500,6545,35997500,2,44286,11073,1,821332600,821332600,16606,5535,11071,5535,0,1,5537,3430371,3.430371
6035,5500,6545,35997500,2,48286,12073,1,869512600,869512600,18106,6035,12071,6035,0,1,6037,1980382,1.980382
6535,5500,6545,35997500,2,52286,13073,1,917692600,917692600,19606,6535,13071,6535,0,1,6537,1385485,1.385485
7035,5500,6545,35997500,2,56286,14073,1,965872600,965872600,21106,7035,14071,7035,0,1,7037,18916808,18.916808
40,6300,5740,36162000,2,326,83,1,293148800,293148800,121,40,81,40,0,1,42,340425,0.340425
440,6300,5740,36162000,2,3526,883,1,331676800,331676800,1321,440,881,440,0,1,442,3278446,3.278446
840,6300,5740,36162000,2,6726,1683,1,370204800,370204800,2521,840,1681,840,0,1,842,2350993,2.350993
1240,6300,5740,36162000,2,9926,2483,1,408732800,408732800,3721,1240,2481,1240,0,1,1242,3271349,3.271349
1640,6300,5740,36162000,2,13126,3283,1,447260800,447260800,4921,1640,3281,1640,0,1,1642,9765646,9.765646
2040,6300,5740,36162000,2,16326,4083,1,485788800,485788800,6121,2040,4081,2040,0,1,2042,2394101,2.394101
2440,6300,5740,36162000,2,19526,4883,1,524316800,524316800,7321,2440,4881,2440,0,1,2442,4153992,4.153992
2840,6300,5740,36162000,2,22726,5683,1,562844800,562844800,8521,2840,5681,2840,0,1,2842,1237933,1.237933
3240,6300,5740,36162000,2,25926,6483,1,601372800,601372800,9721,3240,6481,3240,0,1,3242,1989247,1.989247
3640,6300,5740,36162000,2,29126,7283,1,639900800,639900800,10921,3640,7281,3640,0,1,3642,2218867,2.218867
4040,6300,5740,36162000,2,32326,8083,1,678428800,678428800,12121,4040,8081,4040,0,1,4042,251532,0.251532
4440,6300,5740,36162000,2,35526,8883,1,716956800,716956800,13321,4440,8881,4440,0,1,4442,2087535,2.087535
4840,6300,5740,36162000,2,38726,9683,1,755484800,755484800,14521,4840,9681,4840,0,1,4842,716542,0.716542
5240,6300,5740,36162000,2,41926,10483,1,794012800,794012800,15721,5240,10481,5240,0,1,5242,7378659,7.378659
5640,6300,5740,36162000,2,45126,11283,1,832540800,832540800,16921,5640,11281,5640,0,1,5642,2573557,2.573557
6040,6300,5740,36162000,2,48326,12083,1,871068800,871068800,18121,6040,12081,6040,0,1,6042,21872630,21.87263
6440,6300,5740,36162000,2,51526,12883,1,909596800,909596800,19321,6440,12881,6440,0,1,6442,3659028,3.659028
6840,6300,5740,36162000,2,54726,13683,1,948124800,948124800,20521,6840,13681,6840,0,1,6842,3553547,3.553547
40,7050,5140,36237000,2,326,83,1,293796800,293796800,121,40,81,40,0,1,42,655295,0.655295
440,7050,5140,36237000,2,3526,883,1,332804800,332804800,1321,440,881,440,0,1,442,131162,0.131162
840,7050,5140,36237000,2,6726,1683,1,371812800,371812800,2521,840,1681,840,0,1,842,3630231,3.630231
1240,7050,5140,36237000,2,9926,2483,1,410820800,410820800,3721,1240,2481,1240,0,1,1242,30598,0.030598
1640,7050,5140,36237000,2,13126,3283,1,449828800,449828800,4921,1640,3281,1640,0,1,1642,5836750,5.83675
2040,7050,5140,36237000,2,16326,4083,1,488836800,488836800,6121,2040,4081,2040,0,1,2042,1116926,1.116926
2440,7050,5140,36237000,2,19526,4883,1,527844800,527844800,7321,2440,4881,2440,0,1,2442,1334285,1.334285
2840,7050,5140,36237000,2,22726,5683,1,566852800,566852800,8521,2840,5681,2840,0,1,2842,11831223,11.831223
3240,7050,5140,36237000,2,25926,6483,1,605860800,605860800,9721,3240,6481,3240,0,1,3242,1073431,1.073431
3640,7050,5140,36237000,2,29126,7283,1,644868800,644868800,10921,3640,7281,3640,0,1,3642,15344492,15.344492
4040,7050,5140,36237000,2,32326,8083,1,683876800,683876800,12121,4040,8081,4040,0,1,4042,3442127,3.442127
4440,7050,5140,36237000,2,35526,8883,1,722884800,722884800,13321,4440,8881,4440,0,1,4442,10784480,10.78448
4840,7050,5140,36237000,2,38726,9683,1,761892800,761892800,14521,4840,9681,4840,0,1,4842,1727061,1.727061
5240,7050,5140,36237000,2,41926,10483,1,800900800,800900800,15721,5240,10481,5240,0,1,5242,36987117,36.987117
5640,7050,5140,36237000,2,45126,11283,1,839908800,839908800,16921,5640,11281,5640,0,1,5642,39833814,39.833814
6040,7050,5140,36237000,2,48326,12083,1,878916800,878916800,18121,6040,12081,6040,0,1,6042,42727491,42.727491
6440,7050,5140,36237000,2,51526,12883,1,917924800,917924800,19321,6440,12881,6440,0,1,6442,45550653,45.550653
6840,7050,5140,36237000,2,54726,13683,1,956932800,956932800,20521,6840,13681,6840,0,1,6842,48403340,48.40334
39,5543,6541,36256763,2,318,81,1,293824312,293824312,118,39,79,39,0,1,41,60349,0.060349
539,5543,6541,36256763,2,4318,1081,1,342160312,342160312,1618,539,1079,539,0,1,541,179866,0.179866
1039,5543,6541,36256763,2,8318,2081,1,390496312,390496312,3118,1039,2079,1039,0,1,1041,129985,0.129985
1539,5543,6541,36256763,2,12318,3081,1,438832312,438832312,4618,1539,3079,1539,0,1,1541,220636,0.220636
2039,5543,6541,36256763,2,16318,4081,1,487168312,487168312,6118,2039,4079,2039,0,1,2041,735068,0.735068
2539,5543,6541,36256763,2,20318,5081,1,535504312,535504312,7618,2539,5079,2539,0,1,2541,1120375,1.120375
3039,5543,6541,36256763,2,24318,6081,1,583840312,583840312,9118,3039,6079,3039,0,1,3041,1761686,1.761686
3539,5543,6541,36256763,2,28318,7081,1,632176312,632176312,10618,3539,7079,3539,0,1,3541,2505372,2.505372
4039,5543,6541,36256763,2,32318,8081,1,680512312,680512312,12118,4039,8079,4039,0,1,4041,545760,0.54576
4539,5543,6541,36256763,2,36318,9081,1,728848312,728848312,13618,4539,9079,4539,0,1,4541,128139,0.128139
5039,5543,6541,36256763,2,40318,10081,1,777184312,777184312,15118,5039,10079,5039,0,1,5041,1806968,1.806968
5539,5543,6541,36256763,2,44318,11081,1,825520312,825520312,16618,5539,11079,5539,0,1,5541,2174774,2.174774
6039,5543,6541,36256763,2,48318,12081,1,873856312,873856312,18118,6039,12079,6039,0,1,6041,1441256,1.441256
6539,5543,6541,36256763,2,52318,13081,1,922192312,922192312,19618,6539,13079,6539,0,1,6541,213727,0.213727
7039,5543,6541,36256763,2,56318,14081,1,970528312,970528312,21118,7039,14079,7039,0,1,7041,1071661,1.071661
35,5540,6545,36259300,2,286,73,1,293458200,293458200,106,35,71,35,0,1,37,263210,0.26321
535,5540,6545,36259300,2,4286,1073,1,341798200,341798200,1606,535,1071,535,0,1,537,88393,0.088393
1035,5540,6545,36259300,2,8286,2073,1,390138200,390138200,3106,1035,2071,1035,0,1,1037,3561390,3.56139
1535,5540,6545,36259300,2,12286,3073,1,438478200,438478200,4606,1535,3071,1535,0,1,1537,9593707,9.593707
55,6305,5765,36348325,2,446,113,1,296097400,296097400,166,55,111,55,0,1,57,725013,0.725013
455,6305,5765,36348325,2,3646,913,1,334721400,334721400,1366,455,911,455,0,1,457,420411,0.420411
855,6305,5765,36348325,2,6846,1713,1,373345400,373345400,2566,855,1711,855,0,1,857,647092,0.647092
1255,6305,5765,36348325,2,10046,2513,1,411969400,411969400,3766,1255,2511,1255,0,1,1257,7288403,7.288403
1655,6305,5765,36348325,2,13246,3313,1,450593400,450593400,4966,1655,3311,1655,0,1,1657,1921187,1.921187
2055,6305,5765,36348325,2,16446,4113,1,489217400,489217400,6166,2055,4111,2055,0,1,2057,10472281,10.472281
2455,6305,5765,36348325,2,19646,4913,1,527841400,527841400,7366,2455,4911,2455,0,1,2457,8372161,8.372161
2855,6305,5765,36348325,2,22846,5713,1,566465400,566465400,8566,2855,5711,2855,0,1,2857,1104118,1.104118
3255,6305,5765,36348325,2,26046,6513,1,605089400,605089400,9766,3255,6511,3255,0,1,3257,1949276,1.949276
3655,6305,5765,36348325,2,29246,7313,1,643713400,643713400,10966,3655,7311,3655,0,1,3657,3946458,3.946458
4055,6305,5765,36348325,2,32446,8113,1,682337400,682337400,12166,4055,8111,4055,0,1,4057,7261769,7.261769
4455,6305,5765,36348325,2,35646,8913,1,720961400,720961400,13366,4455,8911,4455,0,1,4457,7274654,7.274654
4855,6305,5765,36348325,2,38846,9713,1,759585400,759585400,14566,4855,9711,4855,0,1,4857,1282977,1.282977
5255,6305,5765,36348325,2,42046,10513,1,798209400,798209400,15766,5255,10511,5255,0,1,5257,674695,0.674695
5655,6305,5765,36348325,2,45246,11313,1,836833400,836833400,16966,5655,11311,5655,0,1,5657,433132,0.433132
6055,6305,5765,36348325,2,48446,12113,1,875457400,875457400,18166,6055,12111,6055,0,1,6057,2318119,2.318119
6455,6305,5765,36348325,2,51646,12913,1,914081400,914081400,19366,6455,12911,6455,0,1,6457,5674373,5.674373
6855,6305,5765,36348325,2,54846,13713,1,952705400,952705400,20566,6855,13711,6855,0,1,6857,37879528,37.879528
44,5553,6555,36399915,2,358,91,1,295461336,295461336,133,44,89,44,0,1,46,124095,0.124095
544,5553,6555,36399915,2,4358,1091,1,343893336,343893336,1633,544,1089,544,0,1,546,308177,0.308177
1044,5553,6555,36399915,2,8358,2091,1,392325336,392325336,3133,1044,2089,1044,0,1,1046,263461,0.263461
1544,5553,6555,36399915,2,12358,3091,1,440757336,440757336,4633,1544,3089,1544,0,1,1546,954503,0.954503
2044,5553,6555,36399915,2,16358,4091,1,489189336,489189336,6133,2044,4089,2044,0,1,2046,62016,0.062016
2544,5553,6555,36399915,2,20358,5091,1,537621336,537621336,7633,2544,5089,2544,0,1,2546,2207865,2.207865
3044,5553,6555,36399915,2,24358,6091,1,586053336,586053336,9133,3044,6089,3044,0,1,3046,6708223,6.708223
3544,5553,6555,36399915,2,28358,7091,1,634485336,634485336,10633,3544,7089,3544,0,1,3546,1641826,1.641826
4044,5553,6555,36399915,2,32358,8091,1,682917336,682917336,12133,4044,8089,4044,0,1,4046,1425805,1.425805
4544,5553,6555,36399915,2,36358,9091,1,731349336,731349336,13633,4544,9089,4544,0,1,4546,1279361,1.279361
5044,5553,6555,36399915,2,40358,10091,1,779781336,779781336,15133,5044,10089,5044,0,1,5046,874307,0.874307
5544,5553,6555,36399915,2,44358,11091,1,828213336,828213336,16633,5544,11089,5544,0,1,5546,1140952,1.140952
6044,5553,6555,36399915,2,48358,12091,1,876645336,876645336,18133,6044,12089,6044,0,1,6046,5172561,5.172561
6544,5553,6555,36399915,2,52358,13091,1,925077336,925077336,19633,6544,13089,6544,0,1,6546,128734,0.128734
7044,5553,6555,36399915,2,56358,14091,1,973509336,973509336,21133,7044,14089,7044,0,1,7046,8200396,8.200396
55,7055,5165,36439075,2,446,113,1,296889400,296889400,166,55,111,55,0,1,57,732086,0.732086
455,7055,5165,36439075,2,3646,913,1,335993400,335993400,1366,455,911,455,0,1,457,3468699,3.468699
855,7055,5165,36439075,2,6846,1713,1,375097400,375097400,2566,855,1711,855,0,1,857,2245018,2.245018
1255,7055,5165,36439075,2,10046,2513,1,414201400,414201400,3766,1255,2511,1255,0,1,1257,8843746,8.843746
1655,7055,5165,36439075,2,13246,3313,1,453305400,453305400,4966,1655,3311,1655,0,1,1657,6484047,6.484047
2055,7055,5165,36439075,2,16446,4113,1,492409400,492409400,6166,2055,4111,2055,0,1,2057,2891241,2.891241
2455,7055,5165,36439075,2,19646,4913,1,531513400,531513400,7366,2455,4911,2455,0,1,2457,5317645,5.317645
2855,7055,5165,36439075,2,22846,5713,1,570617400,570617400,8566,2855,5711,2855,0,1,2857,4408085,4.408085
3255,7055,5165,36439075,2,26046,6513,1,609721400,609721400,9766,3255,6511,3255,0,1,3257,6150291,6.150291
3655,7055,5165,36439075,2,29246,7313,1,648825400,648825400,10966,3655,7311,3655,0,1,3657,306981,0.306981
4055,7055,5165,36439075,2,32446,8113,1,687929400,687929400,12166,4055,8111,4055,0,1,4057,1726047,1.726047
4455,7055,5165,36439075,2,35646,8913,1,727033400,727033400,13366,4455,8911,4455,0,1,4457,13724649,13.724649
4855,7055,5165,36439075,2,38846,9713,1,766137400,766137400,14566,4855,9711,4855,0,1,4857,1688219,1.688219
5255,7055,5165,36439075,2,42046,10513,1,805241400,805241400,15766,5255,10511,5255,0,1,5257,23600967,23.600967
5655,7055,5165,36439075,2,45246,11313,1,844345400,844345400,16966,5655,11311,5655,0,1,5657,40531286,40.531286
6055,7055,5165,36439075,2,48446,12113,1,883449400,883449400,18166,6055,12111,6055,0,1,6057,43303442,43.303442
6455,7055,5165,36439075,2,51646,12913,1,922553400,922553400,19366,6455,12911,6455,0,1,6457,46243889,46.243889
6855,7055,5165,36439075,2,54846,13713,1,961657400,961657400,20566,6855,13711,6855,0,1,6857,49119946,49.119946
40,6050,6040,36542000,2,326,83,1,296204800,296204800,121,40,81,40,0,1,42,648434,0.648434
440,6050,6040,36542000,2,3526,883,1,334892800,334892800,1321,440,881,440,0,1,442,1375209,1.375209
840,6050,6040,36542000,2,6726,1683,1,373580800,373580800,2521,840,1681,840,0,1,842,3281201,3.281201
1240,6050,6040,36542000,2,9926,2483,1,412268800,412268800,3721,1240,2481,1240,0,1,1242,4177777,4.177777
1640,6050,6040,36542000,2,13126,3283,1,450956800,450956800,4921,1640,3281,1640,0,1,1642,842439,0.842439
2040,6050,6040,36542000,2,16326,4083,1,489644800,489644800,6121,2040,4081,2040,0,1,2042,1073427,1.073427
2440,6050,6040,36542000,2,19526,4883,1,528332800,528332800,7321,2440,4881,2440,0,1,2442,1054219,1.054219
2840,6050,6040,36542000,2,22726,5683,1,567020800,567020800,8521,2840,5681,2840,0,1,2842,642959,0.642959
3240,6050,6040,36542000,2,25926,6483,1,605708800,605708800,9721,3240,6481,3240,0,1,3242,1037869,1.037869
3640,6050,6040,36542000,2,29126,7283,1,644396800,644396800,10921,3640,7281,3640,0,1,3642,1833196,1.833196
4040,6050,6040,36542000,2,32326,8083,1,683084800,683084800,12121,4040,8081,4040,0,1,4042,537482,0.537482
4440,6050,6040,36542000,2,35526,8883,1,721772800,721772800,13321,4440,8881,4440,0,1,4442,2533133,2.533133
4840,6050,6040,36542000,2,38726,9683,1,760460800,760460800,14521,4840,9681,4840,0,1,4842,1983806,1.983806
5240,6050,6040,36542000,2,41926,10483,1,799148800,799148800,15721,5240,10481,5240,0,1,5242,171322,0.171322
5640,6050,6040,36542000,2,45126,11283,1,837836800,837836800,16921,5640,11281,5640,0,1,5642,2638288,2.638288
6040,6050,6040,36542000,2,48326,12083,1,876524800,876524800,18121,6040,12081,6040,0,1,6042,144787,0.144787
6440,6050,6040,36542000,2,51526,12883,1,915212800,915212800,19321,6440,12881,6440,0,1,6442,89381,0.089381
6840,6050,6040,36542000,2,54726,13683,1,953900800,953900800,20521,6840,13681,6840,0,1,6842,267913,0.267913
35,6050,6045,36572250,2,286,73,1,295964600,295964600,106,35,71,35,0,1,37,59757,0.059757
535,6050,6045,36572250,2,4286,1073,1,344344600,344344600,1606,535,1071,535,0,1,537,1330773,1.330773
1035,6050,6045,36572250,2,8286,2073,1,392724600,392724600,3106,1035,2071,1035,0,1,1037,75190,0.07519
1535,6050,6045,36572250,2,12286,3073,1,441104600,441104600,4606,1535,3071,1535,0,1,1537,322543,0.322543
2035,6050,6045,36572250,2,16286,4073,1,489484600,489484600,6106,2035,4071,2035,0,1,2037,1034392,1.034392
2535,6050,6045,36572250,2,20286,5073,1,537864600,537864600,7606,2535,5071,2535,0,1,2537,3843061,3.843061
3035,6050,6045,36572250,2,24286,6073,1,586244600,586244600,9106,3035,6071,3035,0,1,3037,7754795,7.754795
3535,6050,6045,36572250,2,28286,7073,1,634624600,634624600,10606,3535,7071,3535,0,1,3537,3430349,3.430349
4035,6050,6045,36572250,2,32286,8073,1,683004600,683004600,12106,4035,8071,4035,0,1,4037,4827719,4.827719
4535,6050,6045,36572250,2,36286,9073,1,731384600,731384600,13606,4535,9071,4535,0,1,4537,9893398,9.893398
5035,6050,6045,36572250,2,40286,10073,1,779764600,779764600,15106,5035,10071,5035,0,1,5037,7016736,7.016736
5535,6050,6045,36572250,2,44286,11073,1,828144600,828144600,16606,5535,11071,5535,0,1,5537,2854724,2.854724
6035,6050,6045,36572250,2,48286,12073,1,876524600,876524600,18106,6035,12071,6035,0,1,6037,8267783,8.267783
6535,6050,6045,36572250,2,52286,13073,1,924904600,924904600,19606,6535,13071,6535,0,1,6537,11690079,11.690079
7035,6050,6045,36572250,2,56286,14073,1,973284600,973284600,21106,7035,14071,7035,0,1,7037,9107781,9.107781
35,6600,5545,36597000,2,286,73,1,296176600,296176600,106,35,71,35,0,1,37,152481,0.152481
535,6600,5545,36597000,2,4286,1073,1,344756600,344756600,1606,535,1071,535,0,1,537,392661,0.392661
1035,6600,5545,36597000,2,8286,2073,1,393336600,393336600,3106,1035,2071,1035,0,1,1037,825276,0.825276
1535,6600,5545,36597000,2,12286,3073,1,441916600,441916600,4606,1535,3071,1535,0,1,1537,73708,0.073708
2035,6600,5545,36597000,2,16286,4073,1,490496600,490496600,6106,2035,4071,2035,0,1,2037,872791,0.872791
2535,6600,5545,36597000,2,20286,5073,1,539076600,539076600,7606,2535,5071,2535,0,1,2537,214527,0.214527
3035,6600,5545,36597000,2,24286,6073,1,587656600,587656600,9106,3035,6071,3035,0,1,3037,1509951,1.509951
3535,6600,5545,36597000,2,28286,7073,1,636236600,636236600,10606,3535,7071,3535,0,1,3537,2051718,2.051718
4035,6600,5545,36597000,2,32286,8073,1,684816600,684816600,12106,4035,8071,4035,0,1,4037,2034363,2.034363
4535,6600,5545,36597000,2,36286,9073,1,733396600,733396600,13606,4535,9071,4535,0,1,4537,2372605,2.372605
5035,6600,5545,36597000,2,40286,10073,1,781976600,781976600,15106,5035,10071,5035,0,1,5037,125436,0.125436
5535,6600,5545,36597000,2,44286,11073,1,830556600,830556600,16606,5535,11071,5535,0,1,5537,5179562,5.179562
6035,6600,5545,36597000,2,48286,12073,1,879136600,879136600,18106,6035,12071,6035,0,1,6037,8785079,8.785079
6535,6600,5545,36597000,2,52286,13073,1,927716600,927716600,19606,6535,13071,6535,0,1,6537,739948,0.739948
7035,6600,5545,36597000,2,56286,14073,1,976296600,976296600,21106,7035,14071,7035,0,1,7037,48515808,48.515808
55,6055,6065,36723575,2,446,113,1,299121400,299121400,166,55,111,55,0,1,57,728989,0.728989
455,6055,6065,36723575,2,3646,913,1,337905400,337905400,1366,455,911,455,0,1,457,69717,0.069717
855,6055,6065,36723575,2,6846,1713,1,376689400,376689400,2566,855,1711,855,0,1,857,886415,0.886415
1255,6055,6065,36723575,2,10046,2513,1,415473400,415473400,3766,1255,2511,1255,0,1,1257,1395348,1.395348
1655,6055,6065,36723575,2,13246,3313,1,454257400,454257400,4966,1655,3311,1655,0,1,1657,622601,0.622601
2055,6055,6065,36723575,2,16446,4113,1,493041400,493041400,6166,2055,4111,2055,0,1,2057,733062,0.733062
2455,6055,6065,36723575,2,19646,4913,1,531825400,531825400,7366,2455,4911,2455,0,1,2457,2151590,2.15159
2855,6055,6065,36723575,2,22846,5713,1,570609400,570609400,8566,2855,5711,2855,0,1,2857,2069961,2.069961
3255,6055,6065,36723575,2,26046,6513,1,609393400,609393400,9766,3255,6511,3255,0,1,3257,452517,0.452517
3655,6055,6065,36723575,2,29246,7313,1,648177400,648177400,10966,3655,7311,3655,0,1,3657,679520,0.67952
4055,6055,6065,36723575,2,32446,8113,1,686961400,686961400,12166,4055,8111,4055,0,1,4057,4720126,4.720126
4455,6055,6065,36723575,2,35646,8913,1,725745400,725745400,13366,4455,8911,4455,0,1,4457,1496262,1.496262
4855,6055,6065,36723575,2,38846,9713,1,764529400,764529400,14566,4855,9711,4855,0,1,4857,2436350,2.43635
5255,6055,6065,36723575,2,42046,10513,1,803313400,803313400,15766,5255,10511,5255,0,1,5257,2641596,2.641596
5655,6055,6065,36723575,2,45246,11313,1,842097400,842097400,16966,5655,11311,5655,0,1,5657,3599307,3.599307
6055,6055,6065,36723575,2,48446,12113,1,880881400,880881400,18166,6055,12111,6055,0,1,6057,2526387,2.526387
6455,6055,6065,36723575,2,51646,12913,1,919665400,919665400,19366,6455,12911,6455,0,1,6457,613938,0.613938
6855,6055,6065,36723575,2,54846,13713,1,958449400,958449400,20566,6855,13711,6855,0,1,6857,3461768,3.461768
40,5800,6340,36772000,2,326,83,1,298060800,298060800,121,40,81,40,0,1,42,118638,0.118638
440,5800,6340,36772000,2,3526,883,1,336908800,336908800,1321,440,881,440,0,1,442,142000,0.142
840,5800,6340,36772000,2,6726,1683,1,375756800,375756800,2521,840,1681,840,0,1,842,50432,0.050432
1240,5800,6340,36772000,2,9926,2483,1,414604800,414604800,3721,1240,2481,1240,0,1,1242,189139,0.189139
1640,5800,6340,36772000,2,13126,3283,1,453452800,453452800,4921,1640,3281,1640,0,1,1642,84672,0.084672
2040,5800,6340,36772000,2,16326,4083,1,492300800,492300800,6121,2040,4081,2040,0,1,2042,1481211,1.481211
2440,5800,6340,36772000,2,19526,4883,1,531148800,531148800,7321,2440,4881,2440,0,1,2442,1442641,1.442641
2840,5800,6340,36772000,2,22726,5683,1,569996800,569996800,8521,2840,5681,2840,0,1,2842,658903,0.658903
3240,5800,6340,36772000,2,25926,6483,1,608844800,608844800,9721,3240,6481,3240,0,1,3242,50433,0.050433
3640,5800,6340,36772000,2,29126,7283,1,647692800,647692800,10921,3640,7281,3640,0,1,3642,302468,0.302468
4040,5800,6340,36772000,2,32326,8083,1,686540800,686540800,12121,4040,8081,4040,0,1,4042,1359721,1.359721
4440,5800,6340,36772000,2,35526,8883,1,725388800,725388800,13321,4440,8881,4440,0,1,4442,54023,0.054023
4840,5800,6340,36772000,2,38726,9683,1,764236800,764236800,14521,4840,9681,4840,0,1,4842,639511,0.639511
5240,5800,6340,36772000,2,41926,10483,1,803084800,803084800,15721,5240,10481,5240,0,1,5242,1170916,1.170916
5640,5800,6340,36772000,2,45126,11283,1,841932800,841932800,16921,5640,11281,5640,0,1,5642,821078,0.821078
6040,5800,6340,36772000,2,48326,12083,1,880780800,880780800,18121,6040,12081,6040,0,1,6042,70926,0.070926
6440,5800,6340,36772000,2,51526,12883,1,919628800,919628800,19321,6440,12881,6440,0,1,6442,616255,0.616255
6840,5800,6340,36772000,2,54726,13683,1,958476800,958476800,20521,6840,13681,6840,0,1,6842,1215191,1.215191
40,5300,6940,36782000,2,326,83,1,298172800,298172800,121,40,81,40,0,1,42,662509,0.662509
440,5300,6940,36782000,2,3526,883,1,337340800,337340800,1321,440,881,440,0,1,442,3452144,3.452144
840,5300,6940,36782000,2,6726,1683,1,376508800,376508800,2521,840,1681,840,0,1,842,989734,0.989734
1240,5300,6940,36782000,2,9926,2483,1,415676800,415676800,3721,1240,2481,1240,0,1,1242,376334,0.376334
1640,5300,6940,36782000,2,13126,3283,1,454844800,454844800,4921,1640,3281,1640,0,1,1642,46873,0.046873
2040,5300,6940,36782000,2,16326,4083,1,494012800,494012800,6121,2040,4081,2040,0,1,2042,1289338,1.289338
2440,5300,6940,36782000,2,19526,4883,1,533180800,533180800,7321,2440,4881,2440,0,1,2442,1893331,1.893331
2840,5300,6940,36782000,2,22726,5683,1,572348800,572348800,8521,2840,5681,2840,0,1,2842,798618,0.798618
3240,5300,6940,36782000,2,25926,6483,1,611516800,611516800,9721,3240,6481,3240,0,1,3242,129977,0.129977
3640,5300,6940,36782000,2,29126,7283,1,650684800,650684800,10921,3640,7281,3640,0,1,3642,2254796,2.254796
4040,5300,6940,36782000,2,32326,8083,1,689852800,689852800,12121,4040,8081,4040,0,1,4042,547284,0.547284
4440,5300,6940,36782000,2,35526,8883,1,729020800,729020800,13321,4440,8881,4440,0,1,4442,2253974,2.253974
4840,5300,6940,36782000,2,38726,9683,1,768188800,768188800,14521,4840,9681,4840,0,1,4842,180688,0.180688
5240,5300,6940,36782000,2,41926,10483,1,807356800,807356800,15721,5240,10481,5240,0,1,5242,341406,0.341406
5640,5300,6940,36782000,2,45126,11283,1,846524800,846524800,16921,5640,11281,5640,0,1,5642,549106,0.549106
6040,5300,6940,36782000,2,48326,12083,1,885692800,885692800,18121,6040,12081,6040,0,1,6042,7542274,7.542274
6440,5300,6940,36782000,2,51526,12883,1,924860800,924860800,19321,6440,12881,6440,0,1,6442,54752,0.054752
6840,5300,6940,36782000,2,54726,13683,1,964028800,964028800,20521,6840,13681,6840,0,1,6842,1559809,1.559809
39,6093,6041,36807813,2,318,81,1,298248312,298248312,118,39,79,39,0,1,41,105382,0.105382
539,6093,6041,36807813,2,4318,1081,1,346784312,346784312,1618,539,1079,539,0,1,541,158941,0.158941
1039,6093,6041,36807813,2,8318,2081,1,395320312,395320312,3118,1039,2079,1039,0,1,1041,649996,0.649996
1539,6093,6041,36807813,2,12318,3081,1,443856312,443856312,4618,1539,3079,1539,0,1,1541,24307,0.024307
2039,6093,6041,36807813,2,16318,4081,1,492392312,492392312,6118,2039,4079,2039,0,1,2041,1303116,1.303116
2539,6093,6041,36807813,2,20318,5081,1,540928312,540928312,7618,2539,5079,2539,0,1,2541,2006878,2.006878
3039,6093,6041,36807813,2,24318,6081,1,589464312,589464312,9118,3039,6079,3039,0,1,3041,1302929,1.302929
3539,6093,6041,36807813,2,28318,7081,1,638000312,638000312,10618,3539,7079,3539,0,1,3541,783699,0.783699
4039,6093,6041,36807813,2,32318,8081,1,686536312,686536312,12118,4039,8079,4039,0,1,4041,1925362,1.925362
4539,6093,6041,36807813,2,36318,9081,1,735072312,735072312,13618,4539,9079,4539,0,1,4541,973738,0.973738
5039,6093,6041,36807813,2,40318,10081,1,783608312,783608312,15118,5039,10079,5039,0,1,5041,1370110,1.37011
5539,6093,6041,36807813,2,44318,11081,1,832144312,832144312,16618,5539,11079,5539,0,1,5541,396470,0.39647
6039,6093,6041,36807813,2,48318,12081,1,880680312,880680312,18118,6039,12079,6039,0,1,6041,2874878,2.874878
6539,6093,6041,36807813,2,52318,13081,1,929216312,929216312,19618,6539,13079,6539,0,1,6541,4330635,4.330635
7039,6093,6041,36807813,2,56318,14081,1,977752312,977752312,21118,7039,14079,7039,0,1,7041,5394337,5.394337
39,6643,5541,36808863,2,318,81,1,298272312,298272312,118,39,79,39,0,1,41,87466,0.087466
539,6643,5541,36808863,2,4318,1081,1,347008312,347008312,1618,539,1079,539,0,1,541,200301,0.200301
1039,6643,5541,36808863,2,8318,2081,1,395744312,395744312,3118,1039,2079,1039,0,1,1041,1036829,1.036829
1539,6643,5541,36808863,2,12318,3081,1,444480312,444480312,4618,1539,3079,1539,0,1,1541,192324,0.192324
2039,6643,5541,36808863,2,16318,4081,1,493216312,493216312,6118,2039,4079,2039,0,1,2041,547496,0.547496
2539,6643,5541,36808863,2,20318,5081,1,541952312,541952312,7618,2539,5079,2539,0,1,2541,1361698,1.361698
3039,6643,5541,36808863,2,24318,6081,1,590688312,590688312,9118,3039,6079,3039,0,1,3041,501060,0.50106
3539,6643,5541,36808863,2,28318,7081,1,639424312,639424312,10618,3539,7079,3539,0,1,3541,542896,0.542896
4039,6643,5541,36808863,2,32318,8081,1,688160312,688160312,12118,4039,8079,4039,0,1,4041,1748058,1.748058
4539,6643,5541,36808863,2,36318,9081,1,736896312,736896312,13618,4539,9079,4539,0,1,4541,4447024,4.447024
5039,6643,5541,36808863,2,40318,10081,1,785632312,785632312,15118,5039,10079,5039,0,1,5041,2804183,2.804183
5539,6643,5541,36808863,2,44318,11081,1,834368312,834368312,16618,5539,11079,5539,0,1,5541,220026,0.220026
6039,6643,5541,36808863,2,48318,12081,1,883104312,883104312,18118,6039,12079,6039,0,1,6041,652273,0.652273
6539,6643,5541,36808863,2,52318,13081,1,931840312,931840312,19618,6539,13079,6539,0,1,6541,11166903,11.166903
7039,6643,5541,36808863,2,56318,14081,1,980576312,980576312,21118,7039,14079,7039,0,1,7041,2594908,2.594908
35,6090,6045,36814050,2,286,73,1,297910200,297910200,106,35,71,35,0,1,37,375976,0.375976
535,6090,6045,36814050,2,4286,1073,1,346450200,346450200,1606,535,1071,535,0,1,537,3816996,3.816996
1035,6090,6045,36814050,2,8286,2073,1,394990200,394990200,3106,1035,2071,1035,0,1,1037,4163531,4.163531
1535,6090,6045,36814050,2,12286,3073,1,443530200,443530200,4606,1535,3071,1535,0,1,1537,11288839,11.288839
40,5550,6640,36852000,2,326,83,1,298716800,298716800,121,40,81,40,0,1,42,661806,0.661806
440,5550,6640,36852000,2,3526,883,1,337724800,337724800,1321,440,881,440,0,1,442,1783490,1.78349
840,5550,6640,36852000,2,6726,1683,1,376732800,376732800,2521,840,1681,840,0,1,842,3613833,3.613833
1240,5550,6640,36852000,2,9926,2483,1,415740800,415740800,3721,1240,2481,1240,0,1,1242,4770658,4.770658
1640,5550,6640,36852000,2,13126,3283,1,454748800,454748800,4921,1640,3281,1640,0,1,1642,7628442,7.628442
2040,5550,6640,36852000,2,16326,4083,1,493756800,493756800,6121,2040,4081,2040,0,1,2042,5994145,5.994145
2440,5550,6640,36852000,2,19526,4883,1,532764800,532764800,7321,2440,4881,2440,0,1,2442,5484082,5.484082
2840,5550,6640,36852000,2,22726,5683,1,571772800,571772800,8521,2840,5681,2840,0,1,2842,5433444,5.433444
3240,5550,6640,36852000,2,25926,6483,1,610780800,610780800,9721,3240,6481,3240,0,1,3242,3270242,3.270242
3640,5550,6640,36852000,2,29126,7283,1,649788800,649788800,10921,3640,7281,3640,0,1,3642,4884135,4.884135
4040,5550,6640,36852000,2,32326,8083,1,688796800,688796800,12121,4040,8081,4040,0,1,4042,316962,0.316962
4440,5550,6640,36852000,2,35526,8883,1,727804800,727804800,13321,4440,8881,4440,0,1,4442,245878,0.245878
4840,5550,6640,36852000,2,38726,9683,1,766812800,766812800,14521,4840,9681,4840,0,1,4842,2357798,2.357798
5240,5550,6640,36852000,2,41926,10483,1,805820800,805820800,15721,5240,10481,5240,0,1,5242,860499,0.860499
5640,5550,6640,36852000,2,45126,11283,1,844828800,844828800,16921,5640,11281,5640,0,1,5642,5016310,5.01631
6040,5550,6640,36852000,2,48326,12083,1,883836800,883836800,18121,6040,12081,6040,0,1,6042,138388,0.138388
6440,5550,6640,36852000,2,51526,12883,1,922844800,922844800,19321,6440,12881,6440,0,1,6442,6424238,6.424238
6840,5550,6640,36852000,2,54726,13683,1,961852800,961852800,20521,6840,13681,6840,0,1,6842,4832938,4.832938
55,5805,6365,36948825,2,446,113,1,300945400,300945400,166,55,111,55,0,1,57,58531,0.058531
455,5805,6365,36948825,2,3646,913,1,339889400,339889400,1366,455,911,455,0,1,457,129055,0.129055
855,5805,6365,36948825,2,6846,1713,1,378833400,378833400,2566,855,1711,855,0,1,857,233125,0.233125
1255,5805,6365,36948825,2,10046,2513,1,417777400,417777400,3766,1255,2511,1255,0,1,1257,574501,0.574501
1655,5805,6365,36948825,2,13246,3313,1,456721400,456721400,4966,1655,3311,1655,0,1,1657,509995,0.509995
2055,5805,6365,36948825,2,16446,4113,1,495665400,495665400,6166,2055,4111,2055,0,1,2057,317609,0.317609
2455,5805,6365,36948825,2,19646,4913,1,534609400,534609400,7366,2455,4911,2455,0,1,2457,788557,0.788557
2855,5805,6365,36948825,2,22846,5713,1,573553400,573553400,8566,2855,5711,2855,0,1,2857,701087,0.701087
3255,5805,6365,36948825,2,26046,6513,1,612497400,612497400,9766,3255,6511,3255,0,1,3257,1106760,1.10676
3655,5805,6365,36948825,2,29246,7313,1,651441400,651441400,10966,3655,7311,3655,0,1,3657,794047,0.794047
4055,5805,6365,36948825,2,32446,8113,1,690385400,690385400,12166,4055,8111,4055,0,1,4057,1318723,1.318723
4455,5805,6365,36948825,2,35646,8913,1,729329400,729329400,13366,4455,8911,4455,0,1,4457,426366,0.426366
4855,5805,6365,36948825,2,38846,9713,1,768273400,768273400,14566,4855,9711,4855,0,1,4857,448780,0.44878
5255,5805,6365,36948825,2,42046,10513,1,807217400,807217400,15766,5255,10511,5255,0,1,5257,1032321,1.032321
5655,5805,6365,36948825,2,45246,11313,1,846161400,846161400,16966,5655,11311,5655,0,1,5657,1766862,1.766862
6055,5805,6365,36948825,2,48446,12113,1,885105400,885105400,18166,6055,12111,6055,0,1,6057,214865,0.214865
6455,5805,6365,36948825,2,51646,12913,1,924049400,924049400,19366,6455,12911,6455,0,1,6457,1127545,1.127545
6855,5805,6365,36948825,2,54846,13713,1,962993400,962993400,20566,6855,13711,6855,0,1,6857,2357082,2.357082
55,5305,6965,36949325,2,446,113,1,300993400,300993400,166,55,111,55,0,1,57,599837,0.599837
455,5305,6965,36949325,2,3646,913,1,340257400,340257400,1366,455,911,455,0,1,457,1173902,1.173902
855,5305,6965,36949325,2,6846,1713,1,379521400,379521400,2566,855,1711,855,0,1,857,3310828,3.310828
1255,5305,6965,36949325,2,10046,2513,1,418785400,418785400,3766,1255,2511,1255,0,1,1257,251559,0.251559
1655,5305,6965,36949325,2,13246,3313,1,458049400,458049400,4966,1655,3311,1655,0,1,1657,198462,0.198462
2055,5305,6965,36949325,2,16446,4113,1,497313400,497313400,6166,2055,4111,2055,0,1,2057,2028963,2.028963
2455,5305,6965,36949325,2,19646,4913,1,536577400,536577400,7366,2455,4911,2455,0,1,2457,425815,0.425815
2855,5305,6965,36949325,2,22846,5713,1,575841400,575841400,8566,2855,5711,2855,0,1,2857,252099,0.252099
3255,5305,6965,36949325,2,26046,6513,1,615105400,615105400,9766,3255,6511,3255,0,1,3257,3912472,3.912472
3655,5305,6965,36949325,2,29246,7313,1,654369400,654369400,10966,3655,7311,3655,0,1,3657,88663,0.088663
4055,5305,6965,36949325,2,32446,8113,1,693633400,693633400,12166,4055,8111,4055,0,1,4057,230891,0.230891
4455,5305,6965,36949325,2,35646,8913,1,732897400,732897400,13366,4455,8911,4455,0,1,4457,2311483,2.311483
4855,5305,6965,36949325,2,38846,9713,1,772161400,772161400,14566,4855,9711,4855,0,1,4857,5561047,5.561047
5255,5305,6965,36949325,2,42046,10513,1,811425400,811425400,15766,5255,10511,5255,0,1,5257,1359007,1.359007
5655,5305,6965,36949325,2,45246,11313,1,850689400,850689400,16966,5655,11311,5655,0,1,5657,2503130,2.50313
6055,5305,6965,36949325,2,48446,12113,1,889953400,889953400,18166,6055,12111,6055,0,1,6057,7880332,7.880332
6455,5305,6965,36949325,2,51646,12913,1,929217400,929217400,19366,6455,12911,6455,0,1,6457,8799498,8.799498
6855,5305,6965,36949325,2,54846,13713,1,968481400,968481400,20566,6855,13711,6855,0,1,6857,1723660,1.72366
44,6103,6055,36953665,2,358,91,1,299908936,299908936,133,44,89,44,0,1,46,90100,0.0901
544,6103,6055,36953665,2,4358,1091,1,348540936,348540936,1633,544,1089,544,0,1,546,41690,0.04169
1044,6103,6055,36953665,2,8358,2091,1,397172936,397172936,3133,1044,2089,1044,0,1,1046,565824,0.565824
1544,6103,6055,36953665,2,12358,3091,1,445804936,445804936,4633,1544,3089,1544,0,1,1546,681150,0.68115
2044,6103,6055,36953665,2,16358,4091,1,494436936,494436936,6133,2044,4089,2044,0,1,2046,70466,0.070466
2544,6103,6055,36953665,2,20358,5091,1,543068936,543068936,7633,2544,5089,2544,0,1,2546,594200,0.5942
3044,6103,6055,36953665,2,24358,6091,1,591700936,591700936,9133,3044,6089,3044,0,1,3046,508495,0.508495
3544,6103,6055,36953665,2,28358,7091,1,640332936,640332936,10633,3544,7089,3544,0,1,3546,314860,0.31486
4044,6103,6055,36953665,2,32358,8091,1,688964936,688964936,12133,4044,8089,4044,0,1,4046,1928974,1.928974
4544,6103,6055,36953665,2,36358,9091,1,737596936,737596936,13633,4544,9089,4544,0,1,4546,1760742,1.760742
5044,6103,6055,36953665,2,40358,10091,1,786228936,786228936,15133,5044,10089,5044,0,1,5046,2810929,2.810929
5544,6103,6055,36953665,2,44358,11091,1,834860936,834860936,16633,5544,11089,5544,0,1,5546,2462270,2.46227
6044,6103,6055,36953665,2,48358,12091,1,883492936,883492936,18133,6044,12089,6044,0,1,6046,6146125,6.146125
6544,6103,6055,36953665,2,52358,13091,1,932124936,932124936,19633,6544,13089,6544,0,1,6546,1718793,1.718793
7044,6103,6055,36953665,2,56358,14091,1,980756936,980756936,21133,7044,14089,7044,0,1,7046,164375,0.164375
44,6653,5555,36957415,2,358,91,1,299956536,299956536,133,44,89,44,0,1,46,707,0.000707
544,6653,5555,36957415,2,4358,1091,1,348788536,348788536,1633,544,1089,544,0,1,546,246430,0.24643
1044,6653,5555,36957415,2,8358,2091,1,397620536,397620536,3133,1044,2089,1044,0,1,1046,670640,0.67064
1544,6653,5555,36957415,2,12358,3091,1,446452536,446452536,4633,1544,3089,1544,0,1,1546,285615,0.285615
2044,6653,5555,36957415,2,16358,4091,1,495284536,495284536,6133,2044,4089,2044,0,1,2046,1329452,1.329452
2544,6653,5555,36957415,2,20358,5091,1,544116536,544116536,7633,2544,5089,2544,0,1,2546,967743,0.967743
3044,6653,5555,36957415,2,24358,6091,1,592948536,592948536,9133,3044,6089,3044,0,1,3046,1118088,1.118088
3544,6653,5555,36957415,2,28358,7091,1,641780536,641780536,10633,3544,7089,3544,0,1,3546,2091085,2.091085
4044,6653,5555,36957415,2,32358,8091,1,690612536,690612536,12133,4044,8089,4044,0,1,4046,117267,0.117267
4544,6653,5555,36957415,2,36358,9091,1,739444536,739444536,13633,4544,9089,4544,0,1,4546,1818261,1.818261
5044,6653,5555,36957415,2,40358,10091,1,788276536,788276536,15133,5044,10089,5044,0,1,5046,9944348,9.944348
5544,6653,5555,36957415,2,44358,11091,1,837108536,837108536,16633,5544,11089,5544,0,1,5546,2128686,2.128686
6044,6653,5555,36957415,2,48358,12091,1,885940536,885940536,18133,6044,12089,6044,0,1,6046,3233715,3.233715
6544,6653,5555,36957415,2,52358,13091,1,934772536,934772536,19633,6544,13089,6544,0,1,6546,410444,0.410444
7044,6653,5555,36957415,2,56358,14091,1,983604536,983604536,21133,7044,14089,7044,0,1,7046,9728850,9.72885
40,6800,5440,36992000,2,326,83,1,299852800,299852800,121,40,81,40,0,1,42,639832,0.639832
440,6800,5440,36992000,2,3526,883,1,339020800,339020800,1321,440,881,440,0,1,442,2301068,2.301068
840,6800,5440,36992000,2,6726,1683,1,378188800,378188800,2521,840,1681,840,0,1,842,140676,0.140676
1240,6800,5440,36992000,2,9926,2483,1,417356800,417356800,3721,1240,2481,1240,0,1,1242,1694424,1.694424
1640,6800,5440,36992000,2,13126,3283,1,456524800,456524800,4921,1640,3281,1640,0,1,1642,867882,0.867882
2040,6800,5440,36992000,2,16326,4083,1,495692800,495692800,6121,2040,4081,2040,0,1,2042,3889743,3.889743
2440,6800,5440,36992000,2,19526,4883,1,534860800,534860800,7321,2440,4881,2440,0,1,2442,6188772,6.188772
2840,6800,5440,36992000,2,22726,5683,1,574028800,574028800,8521,2840,5681,2840,0,1,2842,1145730,1.14573
3240,6800,5440,36992000,2,25926,6483,1,613196800,613196800,9721,3240,6481,3240,0,1,3242,603471,0.603471
3640,6800,5440,36992000,2,29126,7283,1,652364800,652364800,10921,3640,7281,3640,0,1,3642,1712443,1.712443
4040,6800,5440,36992000,2,32326,8083,1,691532800,691532800,12121,4040,8081,4040,0,1,4042,3662608,3.662608
4440,6800,5440,36992000,2,35526,8883,1,730700800,730700800,13321,4440,8881,4440,0,1,4442,3081992,3.081992
4840,6800,5440,36992000,2,38726,9683,1,769868800,769868800,14521,4840,9681,4840,0,1,4842,2112238,2.112238
5240,6800,5440,36992000,2,41926,10483,1,809036800,809036800,15721,5240,10481,5240,0,1,5242,689687,0.689687
5640,6800,5440,36992000,2,45126,11283,1,848204800,848204800,16921,5640,11281,5640,0,1,5642,1568846,1.568846
6040,6800,5440,36992000,2,48326,12083,1,887372800,887372800,18121,6040,12081,6040,0,1,6042,1924663,1.924663
6440,6800,5440,36992000,2,51526,12883,1,926540800,926540800,19321,6440,12881,6440,0,1,6442,306468,0.306468
6840,6800,5440,36992000,2,54726,13683,1,965708800,965708800,20521,6840,13681,6840,0,1,6842,8793311,8.793311
55,5555,6665,37024075,2,446,113,1,301569400,301569400,166,55,111,55,0,1,57,774837,0.774837
455,5555,6665,37024075,2,3646,913,1,340673400,340673400,1366,455,911,455,0,1,457,129161,0.129161
855,5555,6665,37024075,2,6846,1713,1,379777400,379777400,2566,855,1711,855,0,1,857,3417453,3.417453
1255,5555,6665,37024075,2,10046,2513,1,418881400,418881400,3766,1255,2511,1255,0,1,1257,5444639,5.444639
1655,5555,6665,37024075,2,13246,3313,1,457985400,457985400,4966,1655,3311,1655,0,1,1657,6833063,6.833063
2055,5555,6665,37024075,2,16446,4113,1,497089400,497089400,6166,2055,4111,2055,0,1,2057,1131918,1.131918
2455,5555,6665,37024075,2,19646,4913,1,536193400,536193400,7366,2455,4911,2455,0,1,2457,2165730,2.16573
2855,5555,6665,37024075,2,22846,5713,1,575297400,575297400,8566,2855,5711,2855,0,1,2857,2973967,2.973967
3255,5555,6665,37024075,2,26046,6513,1,614401400,614401400,9766,3255,6511,3255,0,1,3257,13640687,13.640687
3655,5555,6665,37024075,2,29246,7313,1,653505400,653505400,10966,3655,7311,3655,0,1,3657,5874277,5.874277
4055,5555,6665,37024075,2,32446,8113,1,692609400,692609400,12166,4055,8111,4055,0,1,4057,916594,0.916594
4455,5555,6665,37024075,2,35646,8913,1,731713400,731713400,13366,4455,8911,4455,0,1,4457,4255054,4.255054
4855,5555,6665,37024075,2,38846,9713,1,770817400,770817400,14566,4855,9711,4855,0,1,4857,1279969,1.279969
5255,5555,6665,37024075,2,42046,10513,1,809921400,809921400,15766,5255,10511,5255,0,1,5257,3244145,3.244145
5655,5555,6665,37024075,2,45246,11313,1,849025400,849025400,16966,5655,11311,5655,0,1,5657,5258250,5.25825
6055,5555,6665,37024075,2,48446,12113,1,888129400,888129400,18166,6055,12111,6055,0,1,6057,64625,0.064625
6455,5555,6665,37024075,2,51646,12913,1,927233400,927233400,19366,6455,12911,6455,0,1,6457,10148578,10.148578
6855,5555,6665,37024075,2,54846,13713,1,966337400,966337400,20566,6855,13711,6855,0,1,6857,4477444,4.477444
55,6805,5465,37189325,2,446,113,1,302913400,302913400,166,55,111,55,0,1,57,386926,0.386926
455,6805,5465,37189325,2,3646,913,1,342177400,342177400,1366,455,911,455,0,1,457,1087272,1.087272
855,6805,5465,37189325,2,6846,1713,1,381441400,381441400,2566,855,1711,855,0,1,857,867819,0.867819
1255,6805,5465,37189325,2,10046,2513,1,420705400,420705400,3766,1255,2511,1255,0,1,1257,248011,0.248011
1655,6805,5465,37189325,2,13246,3313,1,459969400,459969400,4966,1655,3311,1655,0,1,1657,78298,0.078298
2055,6805,5465,37189325,2,16446,4113,1,499233400,499233400,6166,2055,4111,2055,0,1,2057,899380,0.89938
2455,6805,5465,37189325,2,19646,4913,1,538497400,538497400,7366,2455,4911,2455,0,1,2457,786774,0.786774
2855,6805,5465,37189325,2,22846,5713,1,577761400,577761400,8566,2855,5711,2855,0,1,2857,1794745,1.794745
3255,6805,5465,37189325,2,26046,6513,1,617025400,617025400,9766,3255,6511,3255,0,1,3257,1265036,1.265036
3655,6805,5465,37189325,2,29246,7313,1,656289400,656289400,10966,3655,7311,3655,0,1,3657,254329,0.254329
4055,6805,5465,37189325,2,32446,8113,1,695553400,695553400,12166,4055,8111,4055,0,1,4057,1350591,1.350591
4455,6805,5465,37189325,2,35646,8913,1,734817400,734817400,13366,4455,8911,4455,0,1,4457,232645,0.232645
4855,6805,5465,37189325,2,38846,9713,1,774081400,774081400,14566,4855,9711,4855,0,1,4857,5121299,5.121299
5255,6805,5465,37189325,2,42046,10513,1,813345400,813345400,15766,5255,10511,5255,0,1,5257,2894881,2.894881
5655,6805,5465,37189325,2,45246,11313,1,852609400,852609400,16966,5655,11311,5655,0,1,5657,214338,0.214338
6055,6805,5465,37189325,2,48446,12113,1,891873400,891873400,18166,6055,12111,6055,0,1,6057,2862568,2.862568
6455,6805,5465,37189325,2,51646,12913,1,931137400,931137400,19366,6455,12911,6455,0,1,6457,1896308,1.896308
6855,6805,5465,37189325,2,54846,13713,1,970401400,970401400,20566,6855,13711,6855,0,1,6857,364491,0.364491
40,6550,5740,37597000,2,326,83,1,304708800,304708800,121,40,81,40,0,1,42,92387,0.092387
440,6550,5740,37597000,2,3526,883,1,344036800,344036800,1321,440,881,440,0,1,442,106537,0.106537
840,6550,5740,37597000,2,6726,1683,1,383364800,383364800,2521,840,1681,840,0,1,842,388081,0.388081
1240,6550,5740,37597000,2,9926,2483,1,422692800,422692800,3721,1240,2481,1240,0,1,1242,572300,0.5723
1640,6550,5740,37597000,2,13126,3283,1,462020800,462020800,4921,1640,3281,1640,0,1,1642,79061,0.079061
2040,6550,5740,37597000,2,16326,4083,1,501348800,501348800,6121,2040,4081,2040,0,1,2042,246547,0.246547
2440,6550,5740,37597000,2,19526,4883,1,540676800,540676800,7321,2440,4881,2440,0,1,2442,51626,0.051626
2840,6550,5740,37597000,2,22726,5683,1,580004800,580004800,8521,2840,5681,2840,0,1,2842,377768,0.377768
3240,6550,5740,37597000,2,25926,6483,1,619332800,619332800,9721,3240,6481,3240,0,1,3242,430159,0.430159
3640,6550,5740,37597000,2,29126,7283,1,658660800,658660800,10921,3640,7281,3640,0,1,3642,1499122,1.499122
4040,6550,5740,37597000,2,32326,8083,1,697988800,697988800,12121,4040,8081,4040,0,1,4042,2071751,2.071751
4440,6550,5740,37597000,2,35526,8883,1,737316800,737316800,13321,4440,8881,4440,0,1,4442,375812,0.375812
4840,6550,5740,37597000,2,38726,9683,1,776644800,776644800,14521,4840,9681,4840,0,1,4842,1767326,1.767326
5240,6550,5740,37597000,2,41926,10483,1,815972800,815972800,15721,5240,10481,5240,0,1,5242,562824,0.562824
5640,6550,5740,37597000,2,45126,11283,1,855300800,855300800,16921,5640,11281,5640,0,1,5642,411828,0.411828
6040,6550,5740,37597000,2,48326,12083,1,894628800,894628800,18121,6040,12081,6040,0,1,6042,87169,0.087169
6440,6550,5740,37597000,2,51526,12883,1,933956800,933956800,19321,6440,12881,6440,0,1,6442,3119193,3.119193
6840,6550,5740,37597000,2,54726,13683,1,973284800,973284800,20521,6840,13681,6840,0,1,6842,1268533,1.268533
55,6555,5765,37789575,2,446,113,1,307737400,307737400,166,55,111,55,0,1,57,85734,0.085734
455,6555,5765,37789575,2,3646,913,1,347161400,347161400,1366,455,911,455,0,1,457,194605,0.194605
855,6555,5765,37789575,2,6846,1713,1,386585400,386585400,2566,855,1711,855,0,1,857,649592,0.649592
1255,6555,5765,37789575,2,10046,2513,1,426009400,426009400,3766,1255,2511,1255,0,1,1257,32316,0.032316
1655,6555,5765,37789575,2,13246,3313,1,465433400,465433400,4966,1655,3311,1655,0,1,1657,411967,0.411967
2055,6555,5765,37789575,2,16446,4113,1,504857400,504857400,6166,2055,4111,2055,0,1,2057,304081,0.304081
2455,6555,5765,37789575,2,19646,4913,1,544281400,544281400,7366,2455,4911,2455,0,1,2457,2105826,2.105826
2855,6555,5765,37789575,2,22846,5713,1,583705400,583705400,8566,2855,5711,2855,0,1,2857,1309792,1.309792
3255,6555,5765,37789575,2,26046,6513,1,623129400,623129400,9766,3255,6511,3255,0,1,3257,116727,0.116727
3655,6555,5765,37789575,2,29246,7313,1,662553400,662553400,10966,3655,7311,3655,0,1,3657,164322,0.164322
4055,6555,5765,37789575,2,32446,8113,1,701977400,701977400,12166,4055,8111,4055,0,1,4057,4220142,4.220142
4455,6555,5765,37789575,2,35646,8913,1,741401400,741401400,13366,4455,8911,4455,0,1,4457,580171,0.580171
4855,6555,5765,37789575,2,38846,9713,1,780825400,780825400,14566,4855,9711,4855,0,1,4857,700769,0.700769
5255,6555,5765,37789575,2,42046,10513,1,820249400,820249400,15766,5255,10511,5255,0,1,5257,4518533,4.518533
5655,6555,5765,37789575,2,45246,11313,1,859673400,859673400,16966,5655,11311,5655,0,1,5657,632096,0.632096
6055,6555,5765,37789575,2,48446,12113,1,899097400,899097400,18166,6055,12111,6055,0,1,6057,25954,0.025954
6455,6555,5765,37789575,2,51646,12913,1,938521400,938521400,19366,6455,12911,6455,0,1,6457,589735,0.589735
6855,6555,5765,37789575,2,54846,13713,1,977945400,977945400,20566,6855,13711,6855,0,1,6857,669676,0.669676
40,6300,6040,38052000,2,326,83,1,308364800,308364800,121,40,81,40,0,1,42,697538,0.697538
440,6300,6040,38052000,2,3526,883,1,347852800,347852800,1321,440,881,440,0,1,442,989667,0.989667
840,6300,6040,38052000,2,6726,1683,1,387340800,387340800,2521,840,1681,840,0,1,842,708951,0.708951
1240,6300,6040,38052000,2,9926,2483,1,426828800,426828800,3721,1240,2481,1240,0,1,1242,650442,0.650442
1640,6300,6040,38052000,2,13126,3283,1,466316800,466316800,4921,1640,3281,1640,0,1,1642,1497579,1.497579
2040,6300,6040,38052000,2,16326,4083,1,505804800,505804800,6121,2040,4081,2040,0,1,2042,4298577,4.298577
2440,6300,6040,38052000,2,19526,4883,1,545292800,545292800,7321,2440,4881,2440,0,1,2442,2672203,2.672203
2840,6300,6040,38052000,2,22726,5683,1,584780800,584780800,8521,2840,5681,2840,0,1,2842,3147518,3.147518
3240,6300,6040,38052000,2,25926,6483,1,624268800,624268800,9721,3240,6481,3240,0,1,3242,388508,0.388508
3640,6300,6040,38052000,2,29126,7283,1,663756800,663756800,10921,3640,7281,3640,0,1,3642,2514267,2.514267
4040,6300,6040,38052000,2,32326,8083,1,703244800,703244800,12121,4040,8081,4040,0,1,4042,103248,0.103248
4440,6300,6040,38052000,2,35526,8883,1,742732800,742732800,13321,4440,8881,4440,0,1,4442,202992,0.202992
4840,6300,6040,38052000,2,38726,9683,1,782220800,782220800,14521,4840,9681,4840,0,1,4842,2338390,2.33839
5240,6300,6040,38052000,2,41926,10483,1,821708800,821708800,15721,5240,10481,5240,0,1,5242,8123130,8.12313
5640,6300,6040,38052000,2,45126,11283,1,861196800,861196800,16921,5640,11281,5640,0,1,5642,20236704,20.236704
6040,6300,6040,38052000,2,48326,12083,1,900684800,900684800,18121,6040,12081,6040,0,1,6042,28919732,28.919732
6440,6300,6040,38052000,2,51526,12883,1,940172800,940172800,19321,6440,12881,6440,0,1,6442,4344615,4.344615
6840,6300,6040,38052000,2,54726,13683,1,979660800,979660800,20521,6840,13681,6840,0,1,6842,2093199,2.093199
55,6305,6065,38239825,2,446,113,1,311361400,311361400,166,55,111,55,0,1,57,173779,0.173779
455,6305,6065,38239825,2,3646,913,1,350945400,350945400,1366,455,911,455,0,1,457,3589353,3.589353
855,6305,6065,38239825,2,6846,1713,1,390529400,390529400,2566,855,1711,855,0,1,857,1358949,1.358949
1255,6305,6065,38239825,2,10046,2513,1,430113400,430113400,3766,1255,2511,1255,0,1,1257,313766,0.313766
1655,6305,6065,38239825,2,13246,3313,1,469697400,469697400,4966,1655,3311,1655,0,1,1657,547690,0.54769
2055,6305,6065,38239825,2,16446,4113,1,509281400,509281400,6166,2055,4111,2055,0,1,2057,2072057,2.072057
2455,6305,6065,38239825,2,19646,4913,1,548865400,548865400,7366,2455,4911,2455,0,1,2457,4033226,4.033226
2855,6305,6065,38239825,2,22846,5713,1,588449400,588449400,8566,2855,5711,2855,0,1,2857,1973663,1.973663
3255,6305,6065,38239825,2,26046,6513,1,628033400,628033400,9766,3255,6511,3255,0,1,3257,1803415,1.803415
3655,6305,6065,38239825,2,29246,7313,1,667617400,667617400,10966,3655,7311,3655,0,1,3657,301956,0.301956
4055,6305,6065,38239825,2,32446,8113,1,707201400,707201400,12166,4055,8111,4055,0,1,4057,3692705,3.692705
4455,6305,6065,38239825,2,35646,8913,1,746785400,746785400,13366,4455,8911,4455,0,1,4457,514542,0.514542
4855,6305,6065,38239825,2,38846,9713,1,786369400,786369400,14566,4855,9711,4855,0,1,4857,3426899,3.426899
5255,6305,6065,38239825,2,42046,10513,1,825953400,825953400,15766,5255,10511,5255,0,1,5257,4163987,4.163987
5655,6305,6065,38239825,2,45246,11313,1,865537400,865537400,16966,5655,11311,5655,0,1,5657,4140959,4.140959
6055,6305,6065,38239825,2,48446,12113,1,905121400,905121400,18166,6055,12111,6055,0,1,6057,1603881,1.603881
6455,6305,6065,38239825,2,51646,12913,1,944705400,944705400,19366,6455,12911,6455,0,1,6457,8177343,8.177343
6855,6305,6065,38239825,2,54846,13713,1,984289400,984289400,20566,6855,13711,6855,0,1,6857,11091359,11.091359
40,7050,5440,38352000,2,326,83,1,310812800,310812800,121,40,81,40,0,1,42,411777,0.411777
440,7050,5440,38352000,2,3526,883,1,350780800,350780800,1321,440,881,440,0,1,442,1550257,1.550257
840,7050,5440,38352000,2,6726,1683,1,390748800,390748800,2521,840,1681,840,0,1,842,6355556,6.355556
1240,7050,5440,38352000,2,9926,2483,1,430716800,430716800,3721,1240,2481,1240,0,1,1242,2672371,2.672371
1640,7050,5440,38352000,2,13126,3283,1,470684800,470684800,4921,1640,3281,1640,0,1,1642,1016493,1.016493
2040,7050,5440,38352000,2,16326,4083,1,510652800,510652800,6121,2040,4081,2040,0,1,2042,2581542,2.581542
2440,7050,5440,38352000,2,19526,4883,1,550620800,550620800,7321,2440,4881,2440,0,1,2442,17899667,17.899667
2840,7050,5440,38352000,2,22726,5683,1,590588800,590588800,8521,2840,5681,2840,0,1,2842,6724218,6.724218
3240,7050,5440,38352000,2,25926,6483,1,630556800,630556800,9721,3240,6481,3240,0,1,3242,2080511,2.080511
3640,7050,5440,38352000,2,29126,7283,1,670524800,670524800,10921,3640,7281,3640,0,1,3642,2564007,2.564007
4040,7050,5440,38352000,2,32326,8083,1,710492800,710492800,12121,4040,8081,4040,0,1,4042,7025434,7.025434
4440,7050,5440,38352000,2,35526,8883,1,750460800,750460800,13321,4440,8881,4440,0,1,4442,13611359,13.611359
4840,7050,5440,38352000,2,38726,9683,1,790428800,790428800,14521,4840,9681,4840,0,1,4842,17780242,17.780242
5240,7050,5440,38352000,2,41926,10483,1,830396800,830396800,15721,5240,10481,5240,0,1,5242,38100957,38.100957
5640,7050,5440,38352000,2,45126,11283,1,870364800,870364800,16921,5640,11281,5640,0,1,5642,41233611,41.233611
6040,7050,5440,38352000,2,48326,12083,1,910332800,910332800,18121,6040,12081,6040,0,1,6042,44123920,44.12392
6440,7050,5440,38352000,2,51526,12883,1,950300800,950300800,19321,6440,12881,6440,0,1,6442,47019007,47.019007
6840,7050,5440,38352000,2,54726,13683,1,990268800,990268800,20521,6840,13681,6840,0,1,6842,49957452,49.957452
40,6050,6340,38357000,2,326,83,1,310820800,310820800,121,40,81,40,0,1,42,283785,0.283785
440,6050,6340,38357000,2,3526,883,1,350468800,350468800,1321,440,881,440,0,1,442,3450541,3.450541
840,6050,6340,38357000,2,6726,1683,1,390116800,390116800,2521,840,1681,840,0,1,842,1105712,1.105712
1240,6050,6340,38357000,2,9926,2483,1,429764800,429764800,3721,1240,2481,1240,0,1,1242,147235,0.147235
1640,6050,6340,38357000,2,13126,3283,1,469412800,469412800,4921,1640,3281,1640,0,1,1642,3388846,3.388846
2040,6050,6340,38357000,2,16326,4083,1,509060800,509060800,6121,2040,4081,2040,0,1,2042,409481,0.409481
2440,6050,6340,38357000,2,19526,4883,1,548708800,548708800,7321,2440,4881,2440,0,1,2442,650033,0.650033
2840,6050,6340,38357000,2,22726,5683,1,588356800,588356800,8521,2840,5681,2840,0,1,2842,344118,0.344118
3240,6050,6340,38357000,2,25926,6483,1,628004800,628004800,9721,3240,6481,3240,0,1,3242,702929,0.702929
3640,6050,6340,38357000,2,29126,7283,1,667652800,667652800,10921,3640,7281,3640,0,1,3642,2382642,2.382642
4040,6050,6340,38357000,2,32326,8083,1,707300800,707300800,12121,4040,8081,4040,0,1,4042,1040545,1.040545
4440,6050,6340,38357000,2,35526,8883,1,746948800,746948800,13321,4440,8881,4440,0,1,4442,312753,0.312753
4840,6050,6340,38357000,2,38726,9683,1,786596800,786596800,14521,4840,9681,4840,0,1,4842,1347541,1.347541
5240,6050,6340,38357000,2,41926,10483,1,826244800,826244800,15721,5240,10481,5240,0,1,5242,9370466,9.370466
5640,6050,6340,38357000,2,45126,11283,1,865892800,865892800,16921,5640,11281,5640,0,1,5642,459059,0.459059
6040,6050,6340,38357000,2,48326,12083,1,905540800,905540800,18121,6040,12081,6040,0,1,6042,4814137,4.814137
6440,6050,6340,38357000,2,51526,12883,1,945188800,945188800,19321,6440,12881,6440,0,1,6442,1538721,1.538721
6840,6050,6340,38357000,2,54726,13683,1,984836800,984836800,20521,6840,13681,6840,0,1,6842,3035573,3.035573
40,5800,6640,38512000,2,326,83,1,312076800,312076800,121,40,81,40,0,1,42,30975,0.030975
440,5800,6640,38512000,2,3526,883,1,351884800,351884800,1321,440,881,440,0,1,442,224307,0.224307
840,5800,6640,38512000,2,6726,1683,1,391692800,391692800,2521,840,1681,840,0,1,842,276453,0.276453
1240,5800,6640,38512000,2,9926,2483,1,431500800,431500800,3721,1240,2481,1240,0,1,1242,443060,0.44306
1640,5800,6640,38512000,2,13126,3283,1,471308800,471308800,4921,1640,3281,1640,0,1,1642,42730,0.04273
2040,5800,6640,38512000,2,16326,4083,1,511116800,511116800,6121,2040,4081,2040,0,1,2042,896996,0.896996
2440,5800,6640,38512000,2,19526,4883,1,550924800,550924800,7321,2440,4881,2440,0,1,2442,1851596,1.851596
2840,5800,6640,38512000,2,22726,5683,1,590732800,590732800,8521,2840,5681,2840,0,1,2842,708429,0.708429
3240,5800,6640,38512000,2,25926,6483,1,630540800,630540800,9721,3240,6481,3240,0,1,3242,1013473,1.013473
3640,5800,6640,38512000,2,29126,7283,1,670348800,670348800,10921,3640,7281,3640,0,1,3642,796205,0.796205
4040,5800,6640,38512000,2,32326,8083,1,710156800,710156800,12121,4040,8081,4040,0,1,4042,121381,0.121381
4440,5800,6640,38512000,2,35526,8883,1,749964800,749964800,13321,4440,8881,4440,0,1,4442,166727,0.166727
4840,5800,6640,38512000,2,38726,9683,1,789772800,789772800,14521,4840,9681,4840,0,1,4842,1063871,1.063871
5240,5800,6640,38512000,2,41926,10483,1,829580800,829580800,15721,5240,10481,5240,0,1,5242,461626,0.461626
5640,5800,6640,38512000,2,45126,11283,1,869388800,869388800,16921,5640,11281,5640,0,1,5642,2138085,2.138085
6040,5800,6640,38512000,2,48326,12083,1,909196800,909196800,18121,6040,12081,6040,0,1,6042,1174913,1.174913
6440,5800,6640,38512000,2,51526,12883,1,949004800,949004800,19321,6440,12881,6440,0,1,6442,4667512,4.667512
6840,5800,6640,38512000,2,54726,13683,1,988812800,988812800,20521,6840,13681,6840,0,1,6842,1153381,1.153381
40,5550,6940,38517000,2,326,83,1,312132800,312132800,121,40,81,40,0,1,42,710550,0.71055
440,5550,6940,38517000,2,3526,883,1,352100800,352100800,1321,440,881,440,0,1,442,3541773,3.541773
840,5550,6940,38517000,2,6726,1683,1,392068800,392068800,2521,840,1681,840,0,1,842,1178282,1.178282
1240,5550,6940,38517000,2,9926,2483,1,432036800,432036800,3721,1240,2481,1240,0,1,1242,671454,0.671454
1640,5550,6940,38517000,2,13126,3283,1,472004800,472004800,4921,1640,3281,1640,0,1,1642,1949087,1.949087
2040,5550,6940,38517000,2,16326,4083,1,511972800,511972800,6121,2040,4081,2040,0,1,2042,4275003,4.275003
2440,5550,6940,38517000,2,19526,4883,1,551940800,551940800,7321,2440,4881,2440,0,1,2442,2163880,2.16388
2840,5550,6940,38517000,2,22726,5683,1,591908800,591908800,8521,2840,5681,2840,0,1,2842,845519,0.845519
3240,5550,6940,38517000,2,25926,6483,1,631876800,631876800,9721,3240,6481,3240,0,1,3242,3620989,3.620989
3640,5550,6940,38517000,2,29126,7283,1,671844800,671844800,10921,3640,7281,3640,0,1,3642,4568748,4.568748
4040,5550,6940,38517000,2,32326,8083,1,711812800,711812800,12121,4040,8081,4040,0,1,4042,1479788,1.479788
4440,5550,6940,38517000,2,35526,8883,1,751780800,751780800,13321,4440,8881,4440,0,1,4442,1738053,1.738053
4840,5550,6940,38517000,2,38726,9683,1,791748800,791748800,14521,4840,9681,4840,0,1,4842,258428,0.258428
5240,5550,6940,38517000,2,41926,10483,1,831716800,831716800,15721,5240,10481,5240,0,1,5242,660464,0.660464
5640,5550,6940,38517000,2,45126,11283,1,871684800,871684800,16921,5640,11281,5640,0,1,5642,7850743,7.850743
6040,5550,6940,38517000,2,48326,12083,1,911652800,911652800,18121,6040,12081,6040,0,1,6042,8653443,8.653443
6440,5550,6940,38517000,2,51526,12883,1,951620800,951620800,19321,6440,12881,6440,0,1,6442,2442173,2.442173
6840,5550,6940,38517000,2,54726,13683,1,991588800,991588800,20521,6840,13681,6840,0,1,6842,8707595,8.707595
55,6055,6365,38540075,2,446,113,1,313785400,313785400,166,55,111,55,0,1,57,766376,0.766376
455,6055,6365,38540075,2,3646,913,1,353529400,353529400,1366,455,911,455,0,1,457,3602894,3.602894
855,6055,6365,38540075,2,6846,1713,1,393273400,393273400,2566,855,1711,855,0,1,857,2505727,2.505727
1255,6055,6365,38540075,2,10046,2513,1,433017400,433017400,3766,1255,2511,1255,0,1,1257,3250923,3.250923
1655,6055,6365,38540075,2,13246,3313,1,472761400,472761400,4966,1655,3311,1655,0,1,1657,2378465,2.378465
2055,6055,6365,38540075,2,16446,4113,1,512505400,512505400,6166,2055,4111,2055,0,1,2057,870236,0.870236
2455,6055,6365,38540075,2,19646,4913,1,552249400,552249400,7366,2455,4911,2455,0,1,2457,1453711,1.453711
2855,6055,6365,38540075,2,22846,5713,1,591993400,591993400,8566,2855,5711,2855,0,1,2857,915799,0.915799
3255,6055,6365,38540075,2,26046,6513,1,631737400,631737400,9766,3255,6511,3255,0,1,3257,68142,0.068142
3655,6055,6365,38540075,2,29246,7313,1,671481400,671481400,10966,3655,7311,3655,0,1,3657,5817332,5.817332
4055,6055,6365,38540075,2,32446,8113,1,711225400,711225400,12166,4055,8111,4055,0,1,4057,435745,0.435745
4455,6055,6365,38540075,2,35646,8913,1,750969400,750969400,13366,4455,8911,4455,0,1,4457,56888,0.056888
4855,6055,6365,38540075,2,38846,9713,1,790713400,790713400,14566,4855,9711,4855,0,1,4857,1824684,1.824684
5255,6055,6365,38540075,2,42046,10513,1,830457400,830457400,15766,5255,10511,5255,0,1,5257,7643939,7.643939
5655,6055,6365,38540075,2,45246,11313,1,870201400,870201400,16966,5655,11311,5655,0,1,5657,8127213,8.127213
6055,6055,6365,38540075,2,48446,12113,1,909945400,909945400,18166,6055,12111,6055,0,1,6057,167310,0.16731
6455,6055,6365,38540075,2,51646,12913,1,949689400,949689400,19366,6455,12911,6455,0,1,6457,2184560,2.18456
6855,6055,6365,38540075,2,54846,13713,1,989433400,989433400,20566,6855,13711,6855,0,1,6857,1129659,1.129659
55,7055,5465,38555575,2,446,113,1,313953400,313953400,166,55,111,55,0,1,57,779594,0.779594
455,7055,5465,38555575,2,3646,913,1,354017400,354017400,1366,455,911,455,0,1,457,448236,0.448236
855,7055,5465,38555575,2,6846,1713,1,394081400,394081400,2566,855,1711,855,0,1,857,824703,0.824703
1255,7055,5465,38555575,2,10046,2513,1,434145400,434145400,3766,1255,2511,1255,0,1,1257,374591,0.374591
1655,7055,5465,38555575,2,13246,3313,1,474209400,474209400,4966,1655,3311,1655,0,1,1657,4635941,4.635941
2055,7055,5465,38555575,2,16446,4113,1,514273400,514273400,6166,2055,4111,2055,0,1,2057,2803549,2.803549
2455,7055,5465,38555575,2,19646,4913,1,554337400,554337400,7366,2455,4911,2455,0,1,2457,11414337,11.414337
2855,7055,5465,38555575,2,22846,5713,1,594401400,594401400,8566,2855,5711,2855,0,1,2857,5496200,5.4962
3255,7055,5465,38555575,2,26046,6513,1,634465400,634465400,9766,3255,6511,3255,0,1,3257,3919888,3.919888
3655,7055,5465,38555575,2,29246,7313,1,674529400,674529400,10966,3655,7311,3655,0,1,3657,3439983,3.439983
4055,7055,5465,38555575,2,32446,8113,1,714593400,714593400,12166,4055,8111,4055,0,1,4057,10966196,10.966196
4455,7055,5465,38555575,2,35646,8913,1,754657400,754657400,13366,4455,8911,4455,0,1,4457,12238778,12.238778
4855,7055,5465,38555575,2,38846,9713,1,794721400,794721400,14566,4855,9711,4855,0,1,4857,279117,0.279117
5255,7055,5465,38555575,2,42046,10513,1,834785400,834785400,15766,5255,10511,5255,0,1,5257,30413350,30.41335
5655,7055,5465,38555575,2,45246,11313,1,874849400,874849400,16966,5655,11311,5655,0,1,5657,42912861,42.912861
6055,7055,5465,38555575,2,48446,12113,1,914913400,914913400,18166,6055,12111,6055,0,1,6057,45915093,45.915093
6455,7055,5465,38555575,2,51646,12913,1,954977400,954977400,19366,6455,12911,6455,0,1,6457,48967005,48.967005
6855,7055,5465,38555575,2,54846,13713,1,995041400,995041400,20566,6855,13711,6855,0,1,6857,51973205,51.973205
55,5805,6665,38690325,2,446,113,1,315009400,315009400,166,55,111,55,0,1,57,44377,0.044377
455,5805,6665,38690325,2,3646,913,1,354913400,354913400,1366,455,911,455,0,1,457,173009,0.173009
855,5805,6665,38690325,2,6846,1713,1,394817400,394817400,2566,855,1711,855,0,1,857,656845,0.656845
1255,5805,6665,38690325,2,10046,2513,1,434721400,434721400,3766,1255,2511,1255,0,1,1257,356841,0.356841
1655,5805,6665,38690325,2,13246,3313,1,474625400,474625400,4966,1655,3311,1655,0,1,1657,363731,0.363731
2055,5805,6665,38690325,2,16446,4113,1,514529400,514529400,6166,2055,4111,2055,0,1,2057,1608027,1.608027
2455,5805,6665,38690325,2,19646,4913,1,554433400,554433400,7366,2455,4911,2455,0,1,2457,474175,0.474175
2855,5805,6665,38690325,2,22846,5713,1,594337400,594337400,8566,2855,5711,2855,0,1,2857,980140,0.98014
3255,5805,6665,38690325,2,26046,6513,1,634241400,634241400,9766,3255,6511,3255,0,1,3257,104522,0.104522
3655,5805,6665,38690325,2,29246,7313,1,674145400,674145400,10966,3655,7311,3655,0,1,3657,787026,0.787026
4055,5805,6665,38690325,2,32446,8113,1,714049400,714049400,12166,4055,8111,4055,0,1,4057,1747516,1.747516
4455,5805,6665,38690325,2,35646,8913,1,753953400,753953400,13366,4455,8911,4455,0,1,4457,28079,0.028079
4855,5805,6665,38690325,2,38846,9713,1,793857400,793857400,14566,4855,9711,4855,0,1,4857,598565,0.598565
5255,5805,6665,38690325,2,42046,10513,1,833761400,833761400,15766,5255,10511,5255,0,1,5257,1276866,1.276866
5655,5805,6665,38690325,2,45246,11313,1,873665400,873665400,16966,5655,11311,5655,0,1,5657,1639782,1.639782
6055,5805,6665,38690325,2,48446,12113,1,913569400,913569400,18166,6055,12111,6055,0,1,6057,686358,0.686358
6455,5805,6665,38690325,2,51646,12913,1,953473400,953473400,19366,6455,12911,6455,0,1,6457,421432,0.421432
6855,5805,6665,38690325,2,54846,13713,1,993377400,993377400,20566,6855,13711,6855,0,1,6857,1570859,1.570859
55,5555,6965,38690575,2,446,113,1,315033400,315033400,166,55,111,55,0,1,57,802825,0.802825
455,5555,6965,38690575,2,3646,913,1,355097400,355097400,1366,455,911,455,0,1,457,3657053,3.657053
855,5555,6965,38690575,2,6846,1713,1,395161400,395161400,2566,855,1711,855,0,1,857,1240684,1.240684
1255,5555,6965,38690575,2,10046,2513,1,435225400,435225400,3766,1255,2511,1255,0,1,1257,519997,0.519997
1655,5555,6965,38690575,2,13246,3313,1,475289400,475289400,4966,1655,3311,1655,0,1,1657,3212832,3.212832
2055,5555,6965,38690575,2,16446,4113,1,515353400,515353400,6166,2055,4111,2055,0,1,2057,5051473,5.051473
2455,5555,6965,38690575,2,19646,4913,1,555417400,555417400,7366,2455,4911,2455,0,1,2457,5626438,5.626438
2855,5555,6965,38690575,2,22846,5713,1,595481400,595481400,8566,2855,5711,2855,0,1,2857,2884457,2.884457
3255,5555,6965,38690575,2,26046,6513,1,635545400,635545400,9766,3255,6511,3255,0,1,3257,1341765,1.341765
3655,5555,6965,38690575,2,29246,7313,1,675609400,675609400,10966,3655,7311,3655,0,1,3657,3632667,3.632667
4055,5555,6965,38690575,2,32446,8113,1,715673400,715673400,12166,4055,8111,4055,0,1,4057,7172618,7.172618
4455,5555,6965,38690575,2,35646,8913,1,755737400,755737400,13366,4455,8911,4455,0,1,4457,1173139,1.173139
4855,5555,6965,38690575,2,38846,9713,1,795801400,795801400,14566,4855,9711,4855,0,1,4857,3357155,3.357155
5255,5555,6965,38690575,2,42046,10513,1,835865400,835865400,15766,5255,10511,5255,0,1,5257,1407393,1.407393
5655,5555,6965,38690575,2,45246,11313,1,875929400,875929400,16966,5655,11311,5655,0,1,5657,3276061,3.276061
6055,5555,6965,38690575,2,48446,12113,1,915993400,915993400,18166,6055,12111,6055,0,1,6057,247759,0.247759
6455,5555,6965,38690575,2,51646,12913,1,956057400,956057400,19366,6455,12911,6455,0,1,6457,10630857,10.630857
6855,5555,6965,38690575,2,54846,13713,1,996121400,996121400,20566,6855,13711,6855,0,1,6857,1116673,1.116673
35,5500,7045,38747500,2,286,73,1,313492600,313492600,106,35,71,35,0,1,37,112519,0.112519
535,5500,7045,38747500,2,4286,1073,1,363672600,363672600,1606,535,1071,535,0,1,537,755735,0.755735
1035,5500,7045,38747500,2,8286,2073,1,413852600,413852600,3106,1035,2071,1035,0,1,1037,1631051,1.631051
1535,5500,7045,38747500,2,12286,3073,1,464032600,464032600,4606,1535,3071,1535,0,1,1537,1448887,1.448887
2035,5500,7045,38747500,2,16286,4073,1,514212600,514212600,6106,2035,4071,2035,0,1,2037,157694,0.157694
2535,5500,7045,38747500,2,20286,5073,1,564392600,564392600,7606,2535,5071,2535,0,1,2537,5518867,5.518867
3035,5500,7045,38747500,2,24286,6073,1,614572600,614572600,9106,3035,6071,3035,0,1,3037,2172967,2.172967
3535,5500,7045,38747500,2,28286,7073,1,664752600,664752600,10606,3535,7071,3535,0,1,3537,7962057,7.962057
4035,5500,7045,38747500,2,32286,8073,1,714932600,714932600,12106,4035,8071,4035,0,1,4037,3111828,3.111828
4535,5500,7045,38747500,2,36286,9073,1,765112600,765112600,13606,4535,9071,4535,0,1,4537,2192051,2.192051
5035,5500,7045,38747500,2,40286,10073,1,815292600,815292600,15106,5035,10071,5035,0,1,5037,1832770,1.83277
5535,5500,7045,38747500,2,44286,11073,1,865472600,865472600,16606,5535,11071,5535,0,1,5537,12621164,12.621164
6035,5500,7045,38747500,2,48286,12073,1,915652600,915652600,18106,6035,12071,6035,0,1,6037,891703,0.891703
6535,5500,7045,38747500,2,52286,13073,1,965832600,965832600,19606,6535,13071,6535,0,1,6537,8586204,8.586204
7035,5500,7045,38747500,2,56286,14073,1,1016012600,1016012600,21106,7035,14071,7035,0,1,7037,12323676,12.323676
39,5543,7041,39028263,2,318,81,1,316152312,316152312,118,39,79,39,0,1,41,28993,0.028993
539,5543,7041,39028263,2,4318,1081,1,366488312,366488312,1618,539,1079,539,0,1,541,30499,0.030499
1039,5543,7041,39028263,2,8318,2081,1,416824312,416824312,3118,1039,2079,1039,0,1,1041,376037,0.376037
1539,5543,7041,39028263,2,12318,3081,1,467160312,467160312,4618,1539,3079,1539,0,1,1541,62251,0.062251
2039,5543,7041,39028263,2,16318,4081,1,517496312,517496312,6118,2039,4079,2039,0,1,2041,2994557,2.994557
2539,5543,7041,39028263,2,20318,5081,1,567832312,567832312,7618,2539,5079,2539,0,1,2541,1747796,1.747796
3039,5543,7041,39028263,2,24318,6081,1,618168312,618168312,9118,3039,6079,3039,0,1,3041,859552,0.859552
3539,5543,7041,39028263,2,28318,7081,1,668504312,668504312,10618,3539,7079,3539,0,1,3541,283434,0.283434
4039,5543,7041,39028263,2,32318,8081,1,718840312,718840312,12118,4039,8079,4039,0,1,4041,1469194,1.469194
4539,5543,7041,39028263,2,36318,9081,1,769176312,769176312,13618,4539,9079,4539,0,1,4541,1138102,1.138102
5039,5543,7041,39028263,2,40318,10081,1,819512312,819512312,15118,5039,10079,5039,0,1,5041,2301657,2.301657
5539,5543,7041,39028263,2,44318,11081,1,869848312,869848312,16618,5539,11079,5539,0,1,5541,919498,0.919498
6039,5543,7041,39028263,2,48318,12081,1,920184312,920184312,18118,6039,12079,6039,0,1,6041,5586559,5.586559
6539,5543,7041,39028263,2,52318,13081,1,970520312,970520312,19618,6539,13079,6539,0,1,6541,5359301,5.359301
7039,5543,7041,39028263,2,56318,14081,1,1020856312,1020856312,21118,7039,14079,7039,0,1,7041,16097078,16.097078
35,5540,7045,39029300,2,286,73,1,315758200,315758200,106,35,71,35,0,1,37,235410,0.23541
535,5540,7045,39029300,2,4286,1073,1,366098200,366098200,1606,535,1071,535,0,1,537,4188484,4.188484
1035,5540,7045,39029300,2,8286,2073,1,416438200,416438200,3106,1035,2071,1035,0,1,1037,3681411,3.681411
1535,5540,7045,39029300,2,12286,3073,1,466778200,466778200,4606,1535,3071,1535,0,1,1537,10758324,10.758324
40,6800,5740,39032000,2,326,83,1,316268800,316268800,121,40,81,40,0,1,42,688367,0.688367
440,6800,5740,39032000,2,3526,883,1,356396800,356396800,1321,440,881,440,0,1,442,969359,0.969359
840,6800,5740,39032000,2,6726,1683,1,396524800,396524800,2521,840,1681,840,0,1,842,386116,0.386116
1240,6800,5740,39032000,2,9926,2483,1,436652800,436652800,3721,1240,2481,1240,0,1,1242,149636,0.149636
1640,6800,5740,39032000,2,13126,3283,1,476780800,476780800,4921,1640,3281,1640,0,1,1642,1675108,1.675108
2040,6800,5740,39032000,2,16326,4083,1,516908800,516908800,6121,2040,4081,2040,0,1,2042,51775,0.051775
2440,6800,5740,39032000,2,19526,4883,1,557036800,557036800,7321,2440,4881,2440,0,1,2442,2319102,2.319102
2840,6800,5740,39032000,2,22726,5683,1,597164800,597164800,8521,2840,5681,2840,0,1,2842,284071,0.284071
3240,6800,5740,39032000,2,25926,6483,1,637292800,637292800,9721,3240,6481,3240,0,1,3242,1663088,1.663088
3640,6800,5740,39032000,2,29126,7283,1,677420800,677420800,10921,3640,7281,3640,0,1,3642,2938094,2.938094
4040,6800,5740,39032000,2,32326,8083,1,717548800,717548800,12121,4040,8081,4040,0,1,4042,3813860,3.81386
4440,6800,5740,39032000,2,35526,8883,1,757676800,757676800,13321,4440,8881,4440,0,1,4442,1471030,1.47103
4840,6800,5740,39032000,2,38726,9683,1,797804800,797804800,14521,4840,9681,4840,0,1,4842,1271106,1.271106
5240,6800,5740,39032000,2,41926,10483,1,837932800,837932800,15721,5240,10481,5240,0,1,5242,2704589,2.704589
5640,6800,5740,39032000,2,45126,11283,1,878060800,878060800,16921,5640,11281,5640,0,1,5642,9703075,9.703075
6040,6800,5740,39032000,2,48326,12083,1,918188800,918188800,18121,6040,12081,6040,0,1,6042,2017708,2.017708
6440,6800,5740,39032000,2,51526,12883,1,958316800,958316800,19321,6440,12881,6440,0,1,6442,547399,0.547399
6840,6800,5740,39032000,2,54726,13683,1,998444800,998444800,20521,6840,13681,6840,0,1,6842,346590,0.34659
44,5553,7055,39176415,2,358,91,1,317849336,317849336,133,44,89,44,0,1,46,194211,0.194211
544,5553,7055,39176415,2,4358,1091,1,368281336,368281336,1633,544,1089,544,0,1,546,82905,0.082905
1044,5553,7055,39176415,2,8358,2091,1,418713336,418713336,3133,1044,2089,1044,0,1,1046,185153,0.185153
1544,5553,7055,39176415,2,12358,3091,1,469145336,469145336,4633,1544,3089,1544,0,1,1546,238353,0.238353
2044,5553,7055,39176415,2,16358,4091,1,519577336,519577336,6133,2044,4089,2044,0,1,2046,380464,0.380464
2544,5553,7055,39176415,2,20358,5091,1,570009336,570009336,7633,2544,5089,2544,0,1,2546,3227452,3.227452
3044,5553,7055,39176415,2,24358,6091,1,620441336,620441336,9133,3044,6089,3044,0,1,3046,3071255,3.071255
3544,5553,7055,39176415,2,28358,7091,1,670873336,670873336,10633,3544,7089,3544,0,1,3546,1337287,1.337287
4044,5553,7055,39176415,2,32358,8091,1,721305336,721305336,12133,4044,8089,4044,0,1,4046,131200,0.1312
4544,5553,7055,39176415,2,36358,9091,1,771737336,771737336,13633,4544,9089,4544,0,1,4546,1222775,1.222775
5044,5553,7055,39176415,2,40358,10091,1,822169336,822169336,15133,5044,10089,5044,0,1,5046,388290,0.38829
5544,5553,7055,39176415,2,44358,11091,1,872601336,872601336,16633,5544,11089,5544,0,1,5546,1706996,1.706996
6044,5553,7055,39176415,2,48358,12091,1,923033336,923033336,18133,6044,12089,6044,0,1,6046,6202849,6.202849
6544,5553,7055,39176415,2,52358,13091,1,973465336,973465336,19633,6544,13089,6544,0,1,6546,4487945,4.487945
7044,5553,7055,39176415,2,56358,14091,1,1023897336,1023897336,21133,7044,14089,7044,0,1,7046,63385,0.063385
55,6805,5765,39230825,2,446,113,1,319377400,319377400,166,55,111,55,0,1,57,77451,0.077451
455,6805,5765,39230825,2,3646,913,1,359601400,359601400,1366,455,911,455,0,1,457,1839056,1.839056
855,6805,5765,39230825,2,6846,1713,1,399825400,399825400,2566,855,1711,855,0,1,857,1478125,1.478125
1255,6805,5765,39230825,2,10046,2513,1,440049400,440049400,3766,1255,2511,1255,0,1,1257,2683017,2.683017
1655,6805,5765,39230825,2,13246,3313,1,480273400,480273400,4966,1655,3311,1655,0,1,1657,1453092,1.453092
2055,6805,5765,39230825,2,16446,4113,1,520497400,520497400,6166,2055,4111,2055,0,1,2057,607246,0.607246
2455,6805,5765,39230825,2,19646,4913,1,560721400,560721400,7366,2455,4911,2455,0,1,2457,450208,0.450208
2855,6805,5765,39230825,2,22846,5713,1,600945400,600945400,8566,2855,5711,2855,0,1,2857,3704522,3.704522
3255,6805,5765,39230825,2,26046,6513,1,641169400,641169400,9766,3255,6511,3255,0,1,3257,412852,0.412852
3655,6805,5765,39230825,2,29246,7313,1,681393400,681393400,10966,3655,7311,3655,0,1,3657,5051085,5.051085
4055,6805,5765,39230825,2,32446,8113,1,721617400,721617400,12166,4055,8111,4055,0,1,4057,1558028,1.558028
4455,6805,5765,39230825,2,35646,8913,1,761841400,761841400,13366,4455,8911,4455,0,1,4457,2162213,2.162213
4855,6805,5765,39230825,2,38846,9713,1,802065400,802065400,14566,4855,9711,4855,0,1,4857,1559393,1.559393
5255,6805,5765,39230825,2,42046,10513,1,842289400,842289400,15766,5255,10511,5255,0,1,5257,2725469,2.725469
5655,6805,5765,39230825,2,45246,11313,1,882513400,882513400,16966,5655,11311,5655,0,1,5657,8177007,8.177007
6055,6805,5765,39230825,2,48446,12113,1,922737400,922737400,18166,6055,12111,6055,0,1,6057,2553391,2.553391
6455,6805,5765,39230825,2,51646,12913,1,962961400,962961400,19366,6455,12911,6455,0,1,6457,5341951,5.341951
6855,6805,5765,39230825,2,54846,13713,1,1003185400,1003185400,20566,6855,13711,6855,0,1,6857,533329,0.533329
40,6550,6040,39562000,2,326,83,1,320524800,320524800,121,40,81,40,0,1,42,77058,0.077058
440,6550,6040,39562000,2,3526,883,1,360812800,360812800,1321,440,881,440,0,1,442,88919,0.088919
840,6550,6040,39562000,2,6726,1683,1,401100800,401100800,2521,840,1681,840,0,1,842,248985,0.248985
1240,6550,6040,39562000,2,9926,2483,1,441388800,441388800,3721,1240,2481,1240,0,1,1242,46711,0.046711
1640,6550,6040,39562000,2,13126,3283,1,481676800,481676800,4921,1640,3281,1640,0,1,1642,454586,0.454586
2040,6550,6040,39562000,2,16326,4083,1,521964800,521964800,6121,2040,4081,2040,0,1,2042,1090284,1.090284
2440,6550,6040,39562000,2,19526,4883,1,562252800,562252800,7321,2440,4881,2440,0,1,2442,41272,0.041272
2840,6550,6040,39562000,2,22726,5683,1,602540800,602540800,8521,2840,5681,2840,0,1,2842,63327,0.063327
3240,6550,6040,39562000,2,25926,6483,1,642828800,642828800,9721,3240,6481,3240,0,1,3242,273526,0.273526
3640,6550,6040,39562000,2,29126,7283,1,683116800,683116800,10921,3640,7281,3640,0,1,3642,44089,0.044089
4040,6550,6040,39562000,2,32326,8083,1,723404800,723404800,12121,4040,8081,4040,0,1,4042,2668353,2.668353
4440,6550,6040,39562000,2,35526,8883,1,763692800,763692800,13321,4440,8881,4440,0,1,4442,509967,0.509967
4840,6550,6040,39562000,2,38726,9683,1,803980800,803980800,14521,4840,9681,4840,0,1,4842,315667,0.315667
5240,6550,6040,39562000,2,41926,10483,1,844268800,844268800,15721,5240,10481,5240,0,1,5242,2770084,2.770084
5640,6550,6040,39562000,2,45126,11283,1,884556800,884556800,16921,5640,11281,5640,0,1,5642,376726,0.376726
6040,6550,6040,39562000,2,48326,12083,1,924844800,924844800,18121,6040,12081,6040,0,1,6042,466324,0.466324
6440,6550,6040,39562000,2,51526,12883,1,965132800,965132800,19321,6440,12881,6440,0,1,6442,757340,0.75734
6840,6550,6040,39562000,2,54726,13683,1,1005420800,1005420800,20521,6840,13681,6840,0,1,6842,982748,0.982748
35,6050,6545,39597250,2,286,73,1,320304600,320304600,106,35,71,35,0,1,37,181340,0.18134
535,6050,6545,39597250,2,4286,1073,1,370684600,370684600,1606,535,1071,535,0,1,537,190015,0.190015
1035,6050,6545,39597250,2,8286,2073,1,421064600,421064600,3106,1035,2071,1035,0,1,1037,1623351,1.623351
1535,6050,6545,39597250,2,12286,3073,1,471444600,471444600,4606,1535,3071,1535,0,1,1537,1216211,1.216211
2035,6050,6545,39597250,2,16286,4073,1,521824600,521824600,6106,2035,4071,2035,0,1,2037,3547807,3.547807
2535,6050,6545,39597250,2,20286,5073,1,572204600,572204600,7606,2535,5071,2535,0,1,2537,1082690,1.08269
3035,6050,6545,39597250,2,24286,6073,1,622584600,622584600,9106,3035,6071,3035,0,1,3037,2446645,2.446645
3535,6050,6545,39597250,2,28286,7073,1,672964600,672964600,10606,3535,7071,3535,0,1,3537,4489603,4.489603
4035,6050,6545,39597250,2,32286,8073,1,723344600,723344600,12106,4035,8071,4035,0,1,4037,1165920,1.16592
4535,6050,6545,39597250,2,36286,9073,1,773724600,773724600,13606,4535,9071,4535,0,1,4537,523040,0.52304
5035,6050,6545,39597250,2,40286,10073,1,824104600,824104600,15106,5035,10071,5035,0,1,5037,15179167,15.179167
5535,6050,6545,39597250,2,44286,11073,1,874484600,874484600,16606,5535,11071,5535,0,1,5537,6971372,6.971372
6035,6050,6545,39597250,2,48286,12073,1,924864600,924864600,18106,6035,12071,6035,0,1,6037,1137199,1.137199
6535,6050,6545,39597250,2,52286,13073,1,975244600,975244600,19606,6535,13071,6535,0,1,6537,18098677,18.098677
7035,6050,6545,39597250,2,56286,14073,1,1025624600,1025624600,21106,7035,14071,7035,0,1,7037,24508704,24.508704
55,6555,6065,39756075,2,446,113,1,323601400,323601400,166,55,111,55,0,1,57,33018,0.033018
455,6555,6065,39756075,2,3646,913,1,363985400,363985400,1366,455,911,455,0,1,457,43914,0.043914
855,6555,6065,39756075,2,6846,1713,1,404369400,404369400,2566,855,1711,855,0,1,857,144726,0.144726
1255,6555,6065,39756075,2,10046,2513,1,444753400,444753400,3766,1255,2511,1255,0,1,1257,86220,0.08622
1655,6555,6065,39756075,2,13246,3313,1,485137400,485137400,4966,1655,3311,1655,0,1,1657,378174,0.378174
2055,6555,6065,39756075,2,16446,4113,1,525521400,525521400,6166,2055,4111,2055,0,1,2057,292401,0.292401
2455,6555,6065,39756075,2,19646,4913,1,565905400,565905400,7366,2455,4911,2455,0,1,2457,760763,0.760763
2855,6555,6065,39756075,2,22846,5713,1,606289400,606289400,8566,2855,5711,2855,0,1,2857,458280,0.45828
3255,6555,6065,39756075,2,26046,6513,1,646673400,646673400,9766,3255,6511,3255,0,1,3257,1882951,1.882951
3655,6555,6065,39756075,2,29246,7313,1,687057400,687057400,10966,3655,7311,3655,0,1,3657,1291745,1.291745
4055,6555,6065,39756075,2,32446,8113,1,727441400,727441400,12166,4055,8111,4055,0,1,4057,741592,0.741592
4455,6555,6065,39756075,2,35646,8913,1,767825400,767825400,13366,4455,8911,4455,0,1,4457,452551,0.452551
4855,6555,6065,39756075,2,38846,9713,1,808209400,808209400,14566,4855,9711,4855,0,1,4857,946043,0.946043
5255,6555,6065,39756075,2,42046,10513,1,848593400,848593400,15766,5255,10511,5255,0,1,5257,2418771,2.418771
5655,6555,6065,39756075,2,45246,11313,1,888977400,888977400,16966,5655,11311,5655,0,1,5657,732737,0.732737
6055,6555,6065,39756075,2,48446,12113,1,929361400,929361400,18166,6055,12111,6055,0,1,6057,1434280,1.43428
6455,6555,6065,39756075,2,51646,12913,1,969745400,969745400,19366,6455,12911,6455,0,1,6457,1589887,1.589887
6855,6555,6065,39756075,2,54846,13713,1,1010129400,1010129400,20566,6855,13711,6855,0,1,6857,562367,0.562367
39,6093,6541,39854313,2,318,81,1,322776312,322776312,118,39,79,39,0,1,41,63988,0.063988
539,6093,6541,39854313,2,4318,1081,1,373312312,373312312,1618,539,1079,539,0,1,541,139117,0.139117
1039,6093,6541,39854313,2,8318,2081,1,423848312,423848312,3118,1039,2079,1039,0,1,1041,77400,0.0774
1539,6093,6541,39854313,2,12318,3081,1,474384312,474384312,4618,1539,3079,1539,0,1,1541,371399,0.371399
2039,6093,6541,39854313,2,16318,4081,1,524920312,524920312,6118,2039,4079,2039,0,1,2041,431772,0.431772
2539,6093,6541,39854313,2,20318,5081,1,575456312,575456312,7618,2539,5079,2539,0,1,2541,4893974,4.893974
3039,6093,6541,39854313,2,24318,6081,1,625992312,625992312,9118,3039,6079,3039,0,1,3041,374917,0.374917
3539,6093,6541,39854313,2,28318,7081,1,676528312,676528312,10618,3539,7079,3539,0,1,3541,2464848,2.464848
4039,6093,6541,39854313,2,32318,8081,1,727064312,727064312,12118,4039,8079,4039,0,1,4041,723520,0.72352
4539,6093,6541,39854313,2,36318,9081,1,777600312,777600312,13618,4539,9079,4539,0,1,4541,996019,0.996019
5039,6093,6541,39854313,2,40318,10081,1,828136312,828136312,15118,5039,10079,5039,0,1,5041,5999877,5.999877
5539,6093,6541,39854313,2,44318,11081,1,878672312,878672312,16618,5539,11079,5539,0,1,5541,3852956,3.852956
6039,6093,6541,39854313,2,48318,12081,1,929208312,929208312,18118,6039,12079,6039,0,1,6041,287154,0.287154
6539,6093,6541,39854313,2,52318,13081,1,979744312,979744312,19618,6539,13079,6539,0,1,6541,450952,0.450952
7039,6093,6541,39854313,2,56318,14081,1,1030280312,1030280312,21118,7039,14079,7039,0,1,7041,1245127,1.245127
35,6090,6545,39859050,2,286,73,1,322410200,322410200,106,35,71,35,0,1,37,430060,0.43006
535,6090,6545,39859050,2,4286,1073,1,372950200,372950200,1606,535,1071,535,0,1,537,111482,0.111482
1035,6090,6545,39859050,2,8286,2073,1,423490200,423490200,3106,1035,2071,1035,0,1,1037,1944858,1.944858
1535,6090,6545,39859050,2,12286,3073,1,474030200,474030200,4606,1535,3071,1535,0,1,1537,12093493,12.093493
35,6600,6045,39897000,2,286,73,1,322716600,322716600,106,35,71,35,0,1,37,188457,0.188457
535,6600,6045,39897000,2,4286,1073,1,373296600,373296600,1606,535,1071,535,0,1,537,121010,0.12101
1035,6600,6045,39897000,2,8286,2073,1,423876600,423876600,3106,1035,2071,1035,0,1,1037,62735,0.062735
1535,6600,6045,39897000,2,12286,3073,1,474456600,474456600,4606,1535,3071,1535,0,1,1537,663530,0.66353
2035,6600,6045,39897000,2,16286,4073,1,525036600,525036600,6106,2035,4071,2035,0,1,2037,624154,0.624154
2535,6600,6045,39897000,2,20286,5073,1,575616600,575616600,7606,2535,5071,2535,0,1,2537,4891330,4.89133
3035,6600,6045,39897000,2,24286,6073,1,626196600,626196600,9106,3035,6071,3035,0,1,3037,3604976,3.604976
3535,6600,6045,39897000,2,28286,7073,1,676776600,676776600,10606,3535,7071,3535,0,1,3537,315162,0.315162
4035,6600,6045,39897000,2,32286,8073,1,727356600,727356600,12106,4035,8071,4035,0,1,4037,4369667,4.369667
4535,6600,6045,39897000,2,36286,9073,1,777936600,777936600,13606,4535,9071,4535,0,1,4537,2787219,2.787219
5035,6600,6045,39897000,2,40286,10073,1,828516600,828516600,15106,5035,10071,5035,0,1,5037,263741,0.263741
5535,6600,6045,39897000,2,44286,11073,1,879096600,879096600,16606,5535,11071,5535,0,1,5537,121246,0.121246
6035,6600,6045,39897000,2,48286,12073,1,929676600,929676600,18106,6035,12071,6035,0,1,6037,10936712,10.936712
6535,6600,6045,39897000,2,52286,13073,1,980256600,980256600,19606,6535,13071,6535,0,1,6537,6554191,6.554191
7035,6600,6045,39897000,2,56286,14073,1,1030836600,1030836600,21106,7035,14071,7035,0,1,7037,52760458,52.760458
40,6300,6340,39942000,2,326,83,1,323580800,323580800,121,40,81,40,0,1,42,733806,0.733806
440,6300,6340,39942000,2,3526,883,1,364028800,364028800,1321,440,881,440,0,1,442,2696836,2.696836
840,6300,6340,39942000,2,6726,1683,1,404476800,404476800,2521,840,1681,840,0,1,842,3220581,3.220581
1240,6300,6340,39942000,2,9926,2483,1,444924800,444924800,3721,1240,2481,1240,0,1,1242,8917267,8.917267
1640,6300,6340,39942000,2,13126,3283,1,485372800,485372800,4921,1640,3281,1640,0,1,1642,5330809,5.330809
2040,6300,6340,39942000,2,16326,4083,1,525820800,525820800,6121,2040,4081,2040,0,1,2042,5484985,5.484985
2440,6300,6340,39942000,2,19526,4883,1,566268800,566268800,7321,2440,4881,2440,0,1,2442,3427133,3.427133
2840,6300,6340,39942000,2,22726,5683,1,606716800,606716800,8521,2840,5681,2840,0,1,2842,4387101,4.387101
3240,6300,6340,39942000,2,25926,6483,1,647164800,647164800,9721,3240,6481,3240,0,1,3242,428388,0.428388
3640,6300,6340,39942000,2,29126,7283,1,687612800,687612800,10921,3640,7281,3640,0,1,3642,7194115,7.194115
4040,6300,6340,39942000,2,32326,8083,1,728060800,728060800,12121,4040,8081,4040,0,1,4042,1561553,1.561553
4440,6300,6340,39942000,2,35526,8883,1,768508800,768508800,13321,4440,8881,4440,0,1,4442,1912110,1.91211
4840,6300,6340,39942000,2,38726,9683,1,808956800,808956800,14521,4840,9681,4840,0,1,4842,4122986,4.122986
5240,6300,6340,39942000,2,41926,10483,1,849404800,849404800,15721,5240,10481,5240,0,1,5242,16344157,16.344157
5640,6300,6340,39942000,2,45126,11283,1,889852800,889852800,16921,5640,11281,5640,0,1,5642,6913170,6.91317
6040,6300,6340,39942000,2,48326,12083,1,930300800,930300800,18121,6040,12081,6040,0,1,6042,5440707,5.440707
6440,6300,6340,39942000,2,51526,12883,1,970748800,970748800,19321,6440,12881,6440,0,1,6442,18423717,18.423717
6840,6300,6340,39942000,2,54726,13683,1,1011196800,1011196800,20521,6840,13681,6840,0,1,6842,25213466,25.213466
44,6103,6555,40005165,2,358,91,1,324496936,324496936,133,44,89,44,0,1,46,105146,0.105146
544,6103,6555,40005165,2,4358,1091,1,375128936,375128936,1633,544,1089,544,0,1,546,100375,0.100375
1044,6103,6555,40005165,2,8358,2091,1,425760936,425760936,3133,1044,2089,1044,0,1,1046,561764,0.561764
1544,6103,6555,40005165,2,12358,3091,1,476392936,476392936,4633,1544,3089,1544,0,1,1546,420675,0.420675
2044,6103,6555,40005165,2,16358,4091,1,527024936,527024936,6133,2044,4089,2044,0,1,2046,414188,0.414188
2544,6103,6555,40005165,2,20358,5091,1,577656936,577656936,7633,2544,5089,2544,0,1,2546,2205841,2.205841
3044,6103,6555,40005165,2,24358,6091,1,628288936,628288936,9133,3044,6089,3044,0,1,3046,268043,0.268043
3544,6103,6555,40005165,2,28358,7091,1,678920936,678920936,10633,3544,7089,3544,0,1,3546,43555,0.043555
4044,6103,6555,40005165,2,32358,8091,1,729552936,729552936,12133,4044,8089,4044,0,1,4046,367539,0.367539
4544,6103,6555,40005165,2,36358,9091,1,780184936,780184936,13633,4544,9089,4544,0,1,4546,156816,0.156816
5044,6103,6555,40005165,2,40358,10091,1,830816936,830816936,15133,5044,10089,5044,0,1,5046,3121829,3.121829
5544,6103,6555,40005165,2,44358,11091,1,881448936,881448936,16633,5544,11089,5544,0,1,5546,1182073,1.182073
6044,6103,6555,40005165,2,48358,12091,1,932080936,932080936,18133,6044,12089,6044,0,1,6046,543403,0.543403
6544,6103,6555,40005165,2,52358,13091,1,982712936,982712936,19633,6544,13089,6544,0,1,6546,766347,0.766347
7044,6103,6555,40005165,2,56358,14091,1,1033344936,1033344936,21133,7044,14089,7044,0,1,7046,1010055,1.010055
39,6643,6041,40130363,2,318,81,1,325000312,325000312,118,39,79,39,0,1,41,65210,0.06521
539,6643,6041,40130363,2,4318,1081,1,375736312,375736312,1618,539,1079,539,0,1,541,51161,0.051161
1039,6643,6041,40130363,2,8318,2081,1,426472312,426472312,3118,1039,2079,1039,0,1,1041,327576,0.327576
1539,6643,6041,40130363,2,12318,3081,1,477208312,477208312,4618,1539,3079,1539,0,1,1541,158534,0.158534
2039,6643,6041,40130363,2,16318,4081,1,527944312,527944312,6118,2039,4079,2039,0,1,2041,538992,0.538992
2539,6643,6041,40130363,2,20318,5081,1,578680312,578680312,7618,2539,5079,2539,0,1,2541,943069,0.943069
3039,6643,6041,40130363,2,24318,6081,1,629416312,629416312,9118,3039,6079,3039,0,1,3041,1569582,1.569582
3539,6643,6041,40130363,2,28318,7081,1,680152312,680152312,10618,3539,7079,3539,0,1,3541,2137173,2.137173
4039,6643,6041,40130363,2,32318,8081,1,730888312,730888312,12118,4039,8079,4039,0,1,4041,225125,0.225125
4539,6643,6041,40130363,2,36318,9081,1,781624312,781624312,13618,4539,9079,4539,0,1,4541,1960604,1.960604
5039,6643,6041,40130363,2,40318,10081,1,832360312,832360312,15118,5039,10079,5039,0,1,5041,352540,0.35254
5539,6643,6041,40130363,2,44318,11081,1,883096312,883096312,16618,5539,11079,5539,0,1,5541,2734420,2.73442
6039,6643,6041,40130363,2,48318,12081,1,933832312,933832312,18118,6039,12079,6039,0,1,6041,792991,0.792991
6539,6643,6041,40130363,2,52318,13081,1,984568312,984568312,19618,6539,13079,6539,0,1,6541,3125659,3.125659
7039,6643,6041,40130363,2,56318,14081,1,1035304312,1035304312,21118,7039,14079,7039,0,1,7041,5748119,5.748119
55,6305,6365,40131325,2,446,113,1,326625400,326625400,166,55,111,55,0,1,57,800520,0.80052
455,6305,6365,40131325,2,3646,913,1,367169400,367169400,1366,455,911,455,0,1,457,905851,0.905851
855,6305,6365,40131325,2,6846,1713,1,407713400,407713400,2566,855,1711,855,0,1,857,6753918,6.753918
1255,6305,6365,40131325,2,10046,2513,1,448257400,448257400,3766,1255,2511,1255,0,1,1257,8429698,8.429698
1655,6305,6365,40131325,2,13246,3313,1,488801400,488801400,4966,1655,3311,1655,0,1,1657,1366464,1.366464
2055,6305,6365,40131325,2,16446,4113,1,529345400,529345400,6166,2055,4111,2055,0,1,2057,2372813,2.372813
2455,6305,6365,40131325,2,19646,4913,1,569889400,569889400,7366,2455,4911,2455,0,1,2457,6126561,6.126561
2855,6305,6365,40131325,2,22846,5713,1,610433400,610433400,8566,2855,5711,2855,0,1,2857,620305,0.620305
3255,6305,6365,40131325,2,26046,6513,1,650977400,650977400,9766,3255,6511,3255,0,1,3257,250921,0.250921
3655,6305,6365,40131325,2,29246,7313,1,691521400,691521400,10966,3655,7311,3655,0,1,3657,68592,0.068592
4055,6305,6365,40131325,2,32446,8113,1,732065400,732065400,12166,4055,8111,4055,0,1,4057,11382992,11.382992
4455,6305,6365,40131325,2,35646,8913,1,772609400,772609400,13366,4455,8911,4455,0,1,4457,1805989,1.805989
4855,6305,6365,40131325,2,38846,9713,1,813153400,813153400,14566,4855,9711,4855,0,1,4857,3662642,3.662642
5255,6305,6365,40131325,2,42046,10513,1,853697400,853697400,15766,5255,10511,5255,0,1,5257,11073078,11.073078
5655,6305,6365,40131325,2,45246,11313,1,894241400,894241400,16966,5655,11311,5655,0,1,5657,6903296,6.903296
6055,6305,6365,40131325,2,48446,12113,1,934785400,934785400,18166,6055,12111,6055,0,1,6057,9031852,9.031852
6455,6305,6365,40131325,2,51646,12913,1,975329400,975329400,19366,6455,12911,6455,0,1,6457,2900164,2.900164
6855,6305,6365,40131325,2,54846,13713,1,1015873400,1015873400,20566,6855,13711,6855,0,1,6857,735018,0.735018
40,6050,6640,40172000,2,326,83,1,325436800,325436800,121,40,81,40,0,1,42,735012,0.735012
440,6050,6640,40172000,2,3526,883,1,366044800,366044800,1321,440,881,440,0,1,442,2135591,2.135591
840,6050,6640,40172000,2,6726,1683,1,406652800,406652800,2521,840,1681,840,0,1,842,3147743,3.147743
1240,6050,6640,40172000,2,9926,2483,1,447260800,447260800,3721,1240,2481,1240,0,1,1242,955636,0.955636
1640,6050,6640,40172000,2,13126,3283,1,487868800,487868800,4921,1640,3281,1640,0,1,1642,990143,0.990143
2040,6050,6640,40172000,2,16326,4083,1,528476800,528476800,6121,2040,4081,2040,0,1,2042,1553703,1.553703
2440,6050,6640,40172000,2,19526,4883,1,569084800,569084800,7321,2440,4881,2440,0,1,2442,630066,0.630066
2840,6050,6640,40172000,2,22726,5683,1,609692800,609692800,8521,2840,5681,2840,0,1,2842,1696543,1.696543
3240,6050,6640,40172000,2,25926,6483,1,650300800,650300800,9721,3240,6481,3240,0,1,3242,3087435,3.087435
3640,6050,6640,40172000,2,29126,7283,1,690908800,690908800,10921,3640,7281,3640,0,1,3642,1861561,1.861561
4040,6050,6640,40172000,2,32326,8083,1,731516800,731516800,12121,4040,8081,4040,0,1,4042,6541615,6.541615
4440,6050,6640,40172000,2,35526,8883,1,772124800,772124800,13321,4440,8881,4440,0,1,4442,115333,0.115333
4840,6050,6640,40172000,2,38726,9683,1,812732800,812732800,14521,4840,9681,4840,0,1,4842,3323475,3.323475
5240,6050,6640,40172000,2,41926,10483,1,853340800,853340800,15721,5240,10481,5240,0,1,5242,1341128,1.341128
5640,6050,6640,40172000,2,45126,11283,1,893948800,893948800,16921,5640,11281,5640,0,1,5642,5225476,5.225476
6040,6050,6640,40172000,2,48326,12083,1,934556800,934556800,18121,6040,12081,6040,0,1,6042,304492,0.304492
6440,6050,6640,40172000,2,51526,12883,1,975164800,975164800,19321,6440,12881,6440,0,1,6442,3103823,3.103823
6840,6050,6640,40172000,2,54726,13683,1,1015772800,1015772800,20521,6840,13681,6840,0,1,6842,308350,0.30835
40,5800,6940,40252000,2,326,83,1,326092800,326092800,121,40,81,40,0,1,42,40496,0.040496
440,5800,6940,40252000,2,3526,883,1,366860800,366860800,1321,440,881,440,0,1,442,42057,0.042057
840,5800,6940,40252000,2,6726,1683,1,407628800,407628800,2521,840,1681,840,0,1,842,502229,0.502229
1240,5800,6940,40252000,2,9926,2483,1,448396800,448396800,3721,1240,2481,1240,0,1,1242,1514015,1.514015
1640,5800,6940,40252000,2,13126,3283,1,489164800,489164800,4921,1640,3281,1640,0,1,1642,232689,0.232689
2040,5800,6940,40252000,2,16326,4083,1,529932800,529932800,6121,2040,4081,2040,0,1,2042,708687,0.708687
2440,5800,6940,40252000,2,19526,4883,1,570700800,570700800,7321,2440,4881,2440,0,1,2442,249882,0.249882
2840,5800,6940,40252000,2,22726,5683,1,611468800,611468800,8521,2840,5681,2840,0,1,2842,541717,0.541717
3240,5800,6940,40252000,2,25926,6483,1,652236800,652236800,9721,3240,6481,3240,0,1,3242,630721,0.630721
3640,5800,6940,40252000,2,29126,7283,1,693004800,693004800,10921,3640,7281,3640,0,1,3642,563900,0.5639
4040,5800,6940,40252000,2,32326,8083,1,733772800,733772800,12121,4040,8081,4040,0,1,4042,715981,0.715981
4440,5800,6940,40252000,2,35526,8883,1,774540800,774540800,13321,4440,8881,4440,0,1,4442,276365,0.276365
4840,5800,6940,40252000,2,38726,9683,1,815308800,815308800,14521,4840,9681,4840,0,1,4842,826951,0.826951
5240,5800,6940,40252000,2,41926,10483,1,856076800,856076800,15721,5240,10481,5240,0,1,5242,206411,0.206411
5640,5800,6940,40252000,2,45126,11283,1,896844800,896844800,16921,5640,11281,5640,0,1,5642,4660792,4.660792
6040,5800,6940,40252000,2,48326,12083,1,937612800,937612800,18121,6040,12081,6040,0,1,6042,1096594,1.096594
6440,5800,6940,40252000,2,51526,12883,1,978380800,978380800,19321,6440,12881,6440,0,1,6442,521938,0.521938
6840,5800,6940,40252000,2,54726,13683,1,1019148800,1019148800,20521,6840,13681,6840,0,1,6842,2423202,2.423202
44,6653,6055,40283915,2,358,91,1,326744536,326744536,133,44,89,44,0,1,46,35590,0.03559
544,6653,6055,40283915,2,4358,1091,1,377576536,377576536,1633,544,1089,544,0,1,546,28000,0.028
1044,6653,6055,40283915,2,8358,2091,1,428408536,428408536,3133,1044,2089,1044,0,1,1046,368530,0.36853
1544,6653,6055,40283915,2,12358,3091,1,479240536,479240536,4633,1544,3089,1544,0,1,1546,152901,0.152901
2044,6653,6055,40283915,2,16358,4091,1,530072536,530072536,6133,2044,4089,2044,0,1,2046,1369360,1.36936
2544,6653,6055,40283915,2,20358,5091,1,580904536,580904536,7633,2544,5089,2544,0,1,2546,1853874,1.853874
3044,6653,6055,40283915,2,24358,6091,1,631736536,631736536,9133,3044,6089,3044,0,1,3046,816577,0.816577
3544,6653,6055,40283915,2,28358,7091,1,682568536,682568536,10633,3544,7089,3544,0,1,3546,2926946,2.926946
4044,6653,6055,40283915,2,32358,8091,1,733400536,733400536,12133,4044,8089,4044,0,1,4046,52272,0.052272
4544,6653,6055,40283915,2,36358,9091,1,784232536,784232536,13633,4544,9089,4544,0,1,4546,106773,0.106773
5044,6653,6055,40283915,2,40358,10091,1,835064536,835064536,15133,5044,10089,5044,0,1,5046,89679,0.089679
5544,6653,6055,40283915,2,44358,11091,1,885896536,885896536,16633,5544,11089,5544,0,1,5546,10155609,10.155609
6044,6653,6055,40283915,2,48358,12091,1,936728536,936728536,18133,6044,12089,6044,0,1,6046,147482,0.147482
6544,6653,6055,40283915,2,52358,13091,1,987560536,987560536,19633,6544,13089,6544,0,1,6546,5726360,5.72636
7044,6653,6055,40283915,2,56358,14091,1,1038392536,1038392536,21133,7044,14089,7044,0,1,7046,6142780,6.14278
55,6055,6665,40356575,2,446,113,1,328449400,328449400,166,55,111,55,0,1,57,803038,0.803038
455,6055,6665,40356575,2,3646,913,1,369153400,369153400,1366,455,911,455,0,1,457,2007893,2.007893
855,6055,6665,40356575,2,6846,1713,1,409857400,409857400,2566,855,1711,855,0,1,857,3462104,3.462104
1255,6055,6665,40356575,2,10046,2513,1,450561400,450561400,3766,1255,2511,1255,0,1,1257,179458,0.179458
1655,6055,6665,40356575,2,13246,3313,1,491265400,491265400,4966,1655,3311,1655,0,1,1657,1043174,1.043174
2055,6055,6665,40356575,2,16446,4113,1,531969400,531969400,6166,2055,4111,2055,0,1,2057,37240,0.03724
2455,6055,6665,40356575,2,19646,4913,1,572673400,572673400,7366,2455,4911,2455,0,1,2457,248475,0.248475
2855,6055,6665,40356575,2,22846,5713,1,613377400,613377400,8566,2855,5711,2855,0,1,2857,2361130,2.36113
3255,6055,6665,40356575,2,26046,6513,1,654081400,654081400,9766,3255,6511,3255,0,1,3257,58173,0.058173
3655,6055,6665,40356575,2,29246,7313,1,694785400,694785400,10966,3655,7311,3655,0,1,3657,174573,0.174573
4055,6055,6665,40356575,2,32446,8113,1,735489400,735489400,12166,4055,8111,4055,0,1,4057,1951664,1.951664
4455,6055,6665,40356575,2,35646,8913,1,776193400,776193400,13366,4455,8911,4455,0,1,4457,176159,0.176159
4855,6055,6665,40356575,2,38846,9713,1,816897400,816897400,14566,4855,9711,4855,0,1,4857,808870,0.80887
5255,6055,6665,40356575,2,42046,10513,1,857601400,857601400,15766,5255,10511,5255,0,1,5257,2671676,2.671676
5655,6055,6665,40356575,2,45246,11313,1,898305400,898305400,16966,5655,11311,5655,0,1,5657,1174412,1.174412
6055,6055,6665,40356575,2,48446,12113,1,939009400,939009400,18166,6055,12111,6055,0,1,6057,1419882,1.419882
6455,6055,6665,40356575,2,51646,12913,1,979713400,979713400,19366,6455,12911,6455,0,1,6457,79168,0.079168
6855,6055,6665,40356575,2,54846,13713,1,1020417400,1020417400,20566,6855,13711,6855,0,1,6857,330323,0.330323
55,5805,6965,40431825,2,446,113,1,329073400,329073400,166,55,111,55,0,1,57,166360,0.16636
455,5805,6965,40431825,2,3646,913,1,369937400,369937400,1366,455,911,455,0,1,457,296210,0.29621
855,5805,6965,40431825,2,6846,1713,1,410801400,410801400,2566,855,1711,855,0,1,857,657551,0.657551
1255,5805,6965,40431825,2,10046,2513,1,451665400,451665400,3766,1255,2511,1255,0,1,1257,237970,0.23797
1655,5805,6965,40431825,2,13246,3313,1,492529400,492529400,4966,1655,3311,1655,0,1,1657,37817,0.037817
2055,5805,6965,40431825,2,16446,4113,1,533393400,533393400,6166,2055,4111,2055,0,1,2057,447735,0.447735
2455,5805,6965,40431825,2,19646,4913,1,574257400,574257400,7366,2455,4911,2455,0,1,2457,3512321,3.512321
2855,5805,6965,40431825,2,22846,5713,1,615121400,615121400,8566,2855,5711,2855,0,1,2857,123355,0.123355
3255,5805,6965,40431825,2,26046,6513,1,655985400,655985400,9766,3255,6511,3255,0,1,3257,25865,0.025865
3655,5805,6965,40431825,2,29246,7313,1,696849400,696849400,10966,3655,7311,3655,0,1,3657,1434912,1.434912
4055,5805,6965,40431825,2,32446,8113,1,737713400,737713400,12166,4055,8111,4055,0,1,4057,678477,0.678477
4455,5805,6965,40431825,2,35646,8913,1,778577400,778577400,13366,4455,8911,4455,0,1,4457,663040,0.66304
4855,5805,6965,40431825,2,38846,9713,1,819441400,819441400,14566,4855,9711,4855,0,1,4857,335977,0.335977
5255,5805,6965,40431825,2,42046,10513,1,860305400,860305400,15766,5255,10511,5255,0,1,5257,420098,0.420098
5655,5805,6965,40431825,2,45246,11313,1,901169400,901169400,16966,5655,11311,5655,0,1,5657,5967267,5.967267
6055,5805,6965,40431825,2,48446,12113,1,942033400,942033400,18166,6055,12111,6055,0,1,6057,785014,0.785014
6455,5805,6965,40431825,2,51646,12913,1,982897400,982897400,19366,6455,12911,6455,0,1,6457,1180435,1.180435
6855,5805,6965,40431825,2,54846,13713,1,1023761400,1023761400,20566,6855,13711,6855,0,1,6857,929798,0.929798
40,7050,5740,40467000,2,326,83,1,327828800,327828800,121,40,81,40,0,1,42,709847,0.709847
440,7050,5740,40467000,2,3526,883,1,368756800,368756800,1321,440,881,440,0,1,442,2202446,2.202446
840,7050,5740,40467000,2,6726,1683,1,409684800,409684800,2521,840,1681,840,0,1,842,408744,0.408744
1240,7050,5740,40467000,2,9926,2483,1,450612800,450612800,3721,1240,2481,1240,0,1,1242,3802865,3.802865
1640,7050,5740,40467000,2,13126,3283,1,491540800,491540800,4921,1640,3281,1640,0,1,1642,12249102,12.249102
2040,7050,5740,40467000,2,16326,4083,1,532468800,532468800,6121,2040,4081,2040,0,1,2042,6670228,6.670228
2440,7050,5740,40467000,2,19526,4883,1,573396800,573396800,7321,2440,4881,2440,0,1,2442,9399826,9.399826
2840,7050,5740,40467000,2,22726,5683,1,614324800,614324800,8521,2840,5681,2840,0,1,2842,1737100,1.7371
3240,7050,5740,40467000,2,25926,6483,1,655252800,655252800,9721,3240,6481,3240,0,1,3242,4639756,4.639756
3640,7050,5740,40467000,2,29126,7283,1,696180800,696180800,10921,3640,7281,3640,0,1,3642,554120,0.55412
4040,7050,5740,40467000,2,32326,8083,1,737108800,737108800,12121,4040,8081,4040,0,1,4042,6879629,6.879629
4440,7050,5740,40467000,2,35526,8883,1,778036800,778036800,13321,4440,8881,4440,0,1,4442,17626934,17.626934
4840,7050,5740,40467000,2,38726,9683,1,818964800,818964800,14521,4840,9681,4840,0,1,4842,5016478,5.016478
5240,7050,5740,40467000,2,41926,10483,1,859892800,859892800,15721,5240,10481,5240,0,1,5242,41343361,41.343361
5640,7050,5740,40467000,2,45126,11283,1,900820800,900820800,16921,5640,11281,5640,0,1,5642,44497947,44.497947
6040,7050,5740,40467000,2,48326,12083,1,941748800,941748800,18121,6040,12081,6040,0,1,6042,47770205,47.770205
6440,7050,5740,40467000,2,51526,12883,1,982676800,982676800,19321,6440,12881,6440,0,1,6442,50899155,50.899155
6840,7050,5740,40467000,2,54726,13683,1,1023604800,1023604800,20521,6840,13681,6840,0,1,6842,54050573,54.050573
55,7055,5765,40672075,2,446,113,1,331017400,331017400,166,55,111,55,0,1,57,817549,0.817549
455,7055,5765,40672075,2,3646,913,1,372041400,372041400,1366,455,911,455,0,1,457,2983235,2.983235
855,7055,5765,40672075,2,6846,1713,1,413065400,413065400,2566,855,1711,855,0,1,857,2657990,2.65799
1255,7055,5765,40672075,2,10046,2513,1,454089400,454089400,3766,1255,2511,1255,0,1,1257,789641,0.789641
1655,7055,5765,40672075,2,13246,3313,1,495113400,495113400,4966,1655,3311,1655,0,1,1657,1228260,1.22826
2055,7055,5765,40672075,2,16446,4113,1,536137400,536137400,6166,2055,4111,2055,0,1,2057,2453599,2.453599
2455,7055,5765,40672075,2,19646,4913,1,577161400,577161400,7366,2455,4911,2455,0,1,2457,2629749,2.629749
2855,7055,5765,40672075,2,22846,5713,1,618185400,618185400,8566,2855,5711,2855,0,1,2857,2534206,2.534206
3255,7055,5765,40672075,2,26046,6513,1,659209400,659209400,9766,3255,6511,3255,0,1,3257,4885233,4.885233
3655,7055,5765,40672075,2,29246,7313,1,700233400,700233400,10966,3655,7311,3655,0,1,3657,140829,0.140829
4055,7055,5765,40672075,2,32446,8113,1,741257400,741257400,12166,4055,8111,4055,0,1,4057,11192162,11.192162
4455,7055,5765,40672075,2,35646,8913,1,782281400,782281400,13366,4455,8911,4455,0,1,4457,5508673,5.508673
4855,7055,5765,40672075,2,38846,9713,1,823305400,823305400,14566,4855,9711,4855,0,1,4857,7416756,7.416756
5255,7055,5765,40672075,2,42046,10513,1,864329400,864329400,15766,5255,10511,5255,0,1,5257,36991575,36.991575
5655,7055,5765,40672075,2,45246,11313,1,905353400,905353400,16966,5655,11311,5655,0,1,5657,45186474,45.186474
6055,7055,5765,40672075,2,48446,12113,1,946377400,946377400,18166,6055,12111,6055,0,1,6057,48377050,48.37705
6455,7055,5765,40672075,2,51646,12913,1,987401400,987401400,19366,6455,12911,6455,0,1,6457,51597420,51.59742
6855,7055,5765,40672075,2,54846,13713,1,1028425400,1028425400,20566,6855,13711,6855,0,1,6857,54738754,54.738754
40,6800,6040,41072000,2,326,83,1,332684800,332684800,121,40,81,40,0,1,42,78589,0.078589
440,6800,6040,41072000,2,3526,883,1,373772800,373772800,1321,440,881,440,0,1,442,1438685,1.438685
840,6800,6040,41072000,2,6726,1683,1,414860800,414860800,2521,840,1681,840,0,1,842,507970,0.50797
1240,6800,6040,41072000,2,9926,2483,1,455948800,455948800,3721,1240,2481,1240,0,1,1242,342855,0.342855
1640,6800,6040,41072000,2,13126,3283,1,497036800,497036800,4921,1640,3281,1640,0,1,1642,3384435,3.384435
2040,6800,6040,41072000,2,16326,4083,1,538124800,538124800,6121,2040,4081,2040,0,1,2042,1627829,1.627829
2440,6800,6040,41072000,2,19526,4883,1,579212800,579212800,7321,2440,4881,2440,0,1,2442,2560625,2.560625
2840,6800,6040,41072000,2,22726,5683,1,620300800,620300800,8521,2840,5681,2840,0,1,2842,1955303,1.955303
3240,6800,6040,41072000,2,25926,6483,1,661388800,661388800,9721,3240,6481,3240,0,1,3242,333200,0.3332
3640,6800,6040,41072000,2,29126,7283,1,702476800,702476800,10921,3640,7281,3640,0,1,3642,5213756,5.213756
4040,6800,6040,41072000,2,32326,8083,1,743564800,743564800,12121,4040,8081,4040,0,1,4042,3401764,3.401764
4440,6800,6040,41072000,2,35526,8883,1,784652800,784652800,13321,4440,8881,4440,0,1,4442,460229,0.460229
4840,6800,6040,41072000,2,38726,9683,1,825740800,825740800,14521,4840,9681,4840,0,1,4842,1326768,1.326768
5240,6800,6040,41072000,2,41926,10483,1,866828800,866828800,15721,5240,10481,5240,0,1,5242,2470896,2.470896
5640,6800,6040,41072000,2,45126,11283,1,907916800,907916800,16921,5640,11281,5640,0,1,5642,3468840,3.46884
6040,6800,6040,41072000,2,48326,12083,1,949004800,949004800,18121,6040,12081,6040,0,1,6042,370013,0.370013
6440,6800,6040,41072000,2,51526,12883,1,990092800,990092800,19321,6440,12881,6440,0,1,6442,3549161,3.549161
6840,6800,6040,41072000,2,54726,13683,1,1031180800,1031180800,20521,6840,13681,6840,0,1,6842,2130972,2.130972
55,6805,6065,41272325,2,446,113,1,335841400,335841400,166,55,111,55,0,1,57,831410,0.83141
455,6805,6065,41272325,2,3646,913,1,377025400,377025400,1366,455,911,455,0,1,457,157633,0.157633
855,6805,6065,41272325,2,6846,1713,1,418209400,418209400,2566,855,1711,855,0,1,857,878170,0.87817
1255,6805,6065,41272325,2,10046,2513,1,459393400,459393400,3766,1255,2511,1255,0,1,1257,171993,0.171993
1655,6805,6065,41272325,2,13246,3313,1,500577400,500577400,4966,1655,3311,1655,0,1,1657,2881078,2.881078
2055,6805,6065,41272325,2,16446,4113,1,541761400,541761400,6166,2055,4111,2055,0,1,2057,1425409,1.425409
2455,6805,6065,41272325,2,19646,4913,1,582945400,582945400,7366,2455,4911,2455,0,1,2457,181483,0.181483
2855,6805,6065,41272325,2,22846,5713,1,624129400,624129400,8566,2855,5711,2855,0,1,2857,1848738,1.848738
3255,6805,6065,41272325,2,26046,6513,1,665313400,665313400,9766,3255,6511,3255,0,1,3257,83626,0.083626
3655,6805,6065,41272325,2,29246,7313,1,706497400,706497400,10966,3655,7311,3655,0,1,3657,653005,0.653005
4055,6805,6065,41272325,2,32446,8113,1,747681400,747681400,12166,4055,8111,4055,0,1,4057,3173907,3.173907
4455,6805,6065,41272325,2,35646,8913,1,788865400,788865400,13366,4455,8911,4455,0,1,4457,2000114,2.000114
4855,6805,6065,41272325,2,38846,9713,1,830049400,830049400,14566,4855,9711,4855,0,1,4857,1196244,1.196244
5255,6805,6065,41272325,2,42046,10513,1,871233400,871233400,15766,5255,10511,5255,0,1,5257,1730594,1.730594
5655,6805,6065,41272325,2,45246,11313,1,912417400,912417400,16966,5655,11311,5655,0,1,5657,2093713,2.093713
6055,6805,6065,41272325,2,48446,12113,1,953601400,953601400,18166,6055,12111,6055,0,1,6057,3436035,3.436035
6455,6805,6065,41272325,2,51646,12913,1,994785400,994785400,19366,6455,12911,6455,0,1,6457,6188267,6.188267
6855,6805,6065,41272325,2,54846,13713,1,1035969400,1035969400,20566,6855,13711,6855,0,1,6857,335452,0.335452
40,6550,6340,41527000,2,326,83,1,336340800,336340800,121,40,81,40,0,1,42,100361,0.100361
440,6550,6340,41527000,2,3526,883,1,377588800,377588800,1321,440,881,440,0,1,442,169405,0.169405
840,6550,6340,41527000,2,6726,1683,1,418836800,418836800,2521,840,1681,840,0,1,842,209991,0.209991
1240,6550,6340,41527000,2,9926,2483,1,460084800,460084800,3721,1240,2481,1240,0,1,1242,138940,0.13894
1640,6550,6340,41527000,2,13126,3283,1,501332800,501332800,4921,1640,3281,1640,0,1,1642,146725,0.146725
2040,6550,6340,41527000,2,16326,4083,1,542580800,542580800,6121,2040,4081,2040,0,1,2042,819372,0.819372
2440,6550,6340,41527000,2,19526,4883,1,583828800,583828800,7321,2440,4881,2440,0,1,2442,399635,0.399635
2840,6550,6340,41527000,2,22726,5683,1,625076800,625076800,8521,2840,5681,2840,0,1,2842,358778,0.358778
3240,6550,6340,41527000,2,25926,6483,1,666324800,666324800,9721,3240,6481,3240,0,1,3242,110232,0.110232
3640,6550,6340,41527000,2,29126,7283,1,707572800,707572800,10921,3640,7281,3640,0,1,3642,764664,0.764664
4040,6550,6340,41527000,2,32326,8083,1,748820800,748820800,12121,4040,8081,4040,0,1,4042,259206,0.259206
4440,6550,6340,41527000,2,35526,8883,1,790068800,790068800,13321,4440,8881,4440,0,1,4442,1547527,1.547527
4840,6550,6340,41527000,2,38726,9683,1,831316800,831316800,14521,4840,9681,4840,0,1,4842,2967242,2.967242
5240,6550,6340,41527000,2,41926,10483,1,872564800,872564800,15721,5240,10481,5240,0,1,5242,1064550,1.06455
5640,6550,6340,41527000,2,45126,11283,1,913812800,913812800,16921,5640,11281,5640,0,1,5642,1179320,1.17932
6040,6550,6340,41527000,2,48326,12083,1,955060800,955060800,18121,6040,12081,6040,0,1,6042,81959,0.081959
6440,6550,6340,41527000,2,51526,12883,1,996308800,996308800,19321,6440,12881,6440,0,1,6442,2438730,2.43873
6840,6550,6340,41527000,2,54726,13683,1,1037556800,1037556800,20521,6840,13681,6840,0,1,6842,595412,0.595412
55,6555,6365,41722575,2,446,113,1,339465400,339465400,166,55,111,55,0,1,57,66313,0.066313
455,6555,6365,41722575,2,3646,913,1,380809400,380809400,1366,455,911,455,0,1,457,44039,0.044039
855,6555,6365,41722575,2,6846,1713,1,422153400,422153400,2566,855,1711,855,0,1,857,245829,0.245829
1255,6555,6365,41722575,2,10046,2513,1,463497400,463497400,3766,1255,2511,1255,0,1,1257,200888,0.200888
1655,6555,6365,41722575,2,13246,3313,1,504841400,504841400,4966,1655,3311,1655,0,1,1657,286625,0.286625
2055,6555,6365,41722575,2,16446,4113,1,546185400,546185400,6166,2055,4111,2055,0,1,2057,490745,0.490745
2455,6555,6365,41722575,2,19646,4913,1,587529400,587529400,7366,2455,4911,2455,0,1,2457,42532,0.042532
2855,6555,6365,41722575,2,22846,5713,1,628873400,628873400,8566,2855,5711,2855,0,1,2857,779915,0.779915
3255,6555,6365,41722575,2,26046,6513,1,670217400,670217400,9766,3255,6511,3255,0,1,3257,1517325,1.517325
3655,6555,6365,41722575,2,29246,7313,1,711561400,711561400,10966,3655,7311,3655,0,1,3657,293747,0.293747
4055,6555,6365,41722575,2,32446,8113,1,752905400,752905400,12166,4055,8111,4055,0,1,4057,333952,0.333952
4455,6555,6365,41722575,2,35646,8913,1,794249400,794249400,13366,4455,8911,4455,0,1,4457,896828,0.896828
4855,6555,6365,41722575,2,38846,9713,1,835593400,835593400,14566,4855,9711,4855,0,1,4857,949068,0.949068
5255,6555,6365,41722575,2,42046,10513,1,876937400,876937400,15766,5255,10511,5255,0,1,5257,5359764,5.359764
5655,6555,6365,41722575,2,45246,11313,1,918281400,918281400,16966,5655,11311,5655,0,1,5657,2208558,2.208558
6055,6555,6365,41722575,2,48446,12113,1,959625400,959625400,18166,6055,12111,6055,0,1,6057,204130,0.20413
6455,6555,6365,41722575,2,51646,12913,1,1000969400,1000969400,19366,6455,12911,6455,0,1,6457,1700439,1.700439
6855,6555,6365,41722575,2,54846,13713,1,1042313400,1042313400,20566,6855,13711,6855,0,1,6857,788224,0.788224
40,6300,6640,41832000,2,326,83,1,338796800,338796800,121,40,81,40,0,1,42,756698,0.756698
440,6300,6640,41832000,2,3526,883,1,380204800,380204800,1321,440,881,440,0,1,442,3680402,3.680402
840,6300,6640,41832000,2,6726,1683,1,421612800,421612800,2521,840,1681,840,0,1,842,725828,0.725828
1240,6300,6640,41832000,2,9926,2483,1,463020800,463020800,3721,1240,2481,1240,0,1,1242,1548218,1.548218
1640,6300,6640,41832000,2,13126,3283,1,504428800,504428800,4921,1640,3281,1640,0,1,1642,3702246,3.702246
2040,6300,6640,41832000,2,16326,4083,1,545836800,545836800,6121,2040,4081,2040,0,1,2042,5103432,5.103432
2440,6300,6640,41832000,2,19526,4883,1,587244800,587244800,7321,2440,4881,2440,0,1,2442,9542889,9.542889
2840,6300,6640,41832000,2,22726,5683,1,628652800,628652800,8521,2840,5681,2840,0,1,2842,524517,0.524517
3240,6300,6640,41832000,2,25926,6483,1,670060800,670060800,9721,3240,6481,3240,0,1,3242,1581343,1.581343
3640,6300,6640,41832000,2,29126,7283,1,711468800,711468800,10921,3640,7281,3640,0,1,3642,1991197,1.991197
4040,6300,6640,41832000,2,32326,8083,1,752876800,752876800,12121,4040,8081,4040,0,1,4042,775474,0.775474
4440,6300,6640,41832000,2,35526,8883,1,794284800,794284800,13321,4440,8881,4440,0,1,4442,3711155,3.711155
4840,6300,6640,41832000,2,38726,9683,1,835692800,835692800,14521,4840,9681,4840,0,1,4842,371502,0.371502
5240,6300,6640,41832000,2,41926,10483,1,877100800,877100800,15721,5240,10481,5240,0,1,5242,2596230,2.59623
5640,6300,6640,41832000,2,45126,11283,1,918508800,918508800,16921,5640,11281,5640,0,1,5642,17803122,17.803122
6040,6300,6640,41832000,2,48326,12083,1,959916800,959916800,18121,6040,12081,6040,0,1,6042,4298142,4.298142
6440,6300,6640,41832000,2,51526,12883,1,1001324800,1001324800,19321,6440,12881,6440,0,1,6442,1536247,1.536247
6840,6300,6640,41832000,2,54726,13683,1,1042732800,1042732800,20521,6840,13681,6840,0,1,6842,14837293,14.837293
40,6050,6940,41987000,2,326,83,1,340052800,340052800,121,40,81,40,0,1,42,206651,0.206651
440,6050,6940,41987000,2,3526,883,1,381620800,381620800,1321,440,881,440,0,1,442,520915,0.520915
840,6050,6940,41987000,2,6726,1683,1,423188800,423188800,2521,840,1681,840,0,1,842,1368773,1.368773
1240,6050,6940,41987000,2,9926,2483,1,464756800,464756800,3721,1240,2481,1240,0,1,1242,91001,0.091001
1640,6050,6940,41987000,2,13126,3283,1,506324800,506324800,4921,1640,3281,1640,0,1,1642,4750355,4.750355
2040,6050,6940,41987000,2,16326,4083,1,547892800,547892800,6121,2040,4081,2040,0,1,2042,2508343,2.508343
2440,6050,6940,41987000,2,19526,4883,1,589460800,589460800,7321,2440,4881,2440,0,1,2442,282891,0.282891
2840,6050,6940,41987000,2,22726,5683,1,631028800,631028800,8521,2840,5681,2840,0,1,2842,777243,0.777243
3240,6050,6940,41987000,2,25926,6483,1,672596800,672596800,9721,3240,6481,3240,0,1,3242,3450940,3.45094
3640,6050,6940,41987000,2,29126,7283,1,714164800,714164800,10921,3640,7281,3640,0,1,3642,418428,0.418428
4040,6050,6940,41987000,2,32326,8083,1,755732800,755732800,12121,4040,8081,4040,0,1,4042,257518,0.257518
4440,6050,6940,41987000,2,35526,8883,1,797300800,797300800,13321,4440,8881,4440,0,1,4442,453444,0.453444
4840,6050,6940,41987000,2,38726,9683,1,838868800,838868800,14521,4840,9681,4840,0,1,4842,2751789,2.751789
5240,6050,6940,41987000,2,41926,10483,1,880436800,880436800,15721,5240,10481,5240,0,1,5242,1971945,1.971945
5640,6050,6940,41987000,2,45126,11283,1,922004800,922004800,16921,5640,11281,5640,0,1,5642,1414963,1.414963
6040,6050,6940,41987000,2,48326,12083,1,963572800,963572800,18121,6040,12081,6040,0,1,6042,2017764,2.017764
6440,6050,6940,41987000,2,51526,12883,1,1005140800,1005140800,19321,6440,12881,6440,0,1,6442,1501514,1.501514
6840,6050,6940,41987000,2,54726,13683,1,1046708800,1046708800,20521,6840,13681,6840,0,1,6842,1201296,1.201296
55,6305,6665,42022825,2,446,113,1,341889400,341889400,166,55,111,55,0,1,57,836173,0.836173
455,6305,6665,42022825,2,3646,913,1,383393400,383393400,1366,455,911,455,0,1,457,196813,0.196813
855,6305,6665,42022825,2,6846,1713,1,424897400,424897400,2566,855,1711,855,0,1,857,2828799,2.828799
1255,6305,6665,42022825,2,10046,2513,1,466401400,466401400,3766,1255,2511,1255,0,1,1257,4809494,4.809494
1655,6305,6665,42022825,2,13246,3313,1,507905400,507905400,4966,1655,3311,1655,0,1,1657,2104609,2.104609
2055,6305,6665,42022825,2,16446,4113,1,549409400,549409400,6166,2055,4111,2055,0,1,2057,2123864,2.123864
2455,6305,6665,42022825,2,19646,4913,1,590913400,590913400,7366,2455,4911,2455,0,1,2457,1011000,1.011
2855,6305,6665,42022825,2,22846,5713,1,632417400,632417400,8566,2855,5711,2855,0,1,2857,4199982,4.199982
3255,6305,6665,42022825,2,26046,6513,1,673921400,673921400,9766,3255,6511,3255,0,1,3257,7262091,7.262091
3655,6305,6665,42022825,2,29246,7313,1,715425400,715425400,10966,3655,7311,3655,0,1,3657,1836722,1.836722
4055,6305,6665,42022825,2,32446,8113,1,756929400,756929400,12166,4055,8111,4055,0,1,4057,2745904,2.745904
4455,6305,6665,42022825,2,35646,8913,1,798433400,798433400,13366,4455,8911,4455,0,1,4457,373469,0.373469
4855,6305,6665,42022825,2,38846,9713,1,839937400,839937400,14566,4855,9711,4855,0,1,4857,473691,0.473691
5255,6305,6665,42022825,2,42046,10513,1,881441400,881441400,15766,5255,10511,5255,0,1,5257,5967247,5.967247
5655,6305,6665,42022825,2,45246,11313,1,922945400,922945400,16966,5655,11311,5655,0,1,5657,17109336,17.109336
6055,6305,6665,42022825,2,48446,12113,1,964449400,964449400,18166,6055,12111,6055,0,1,6057,9177080,9.17708
6455,6305,6665,42022825,2,51646,12913,1,1005953400,1005953400,19366,6455,12911,6455,0,1,6457,8147545,8.147545
6855,6305,6665,42022825,2,54846,13713,1,1047457400,1047457400,20566,6855,13711,6855,0,1,6857,10323981,10.323981
55,6055,6965,42173075,2,446,113,1,343113400,343113400,166,55,111,55,0,1,57,52183,0.052183
455,6055,6965,42173075,2,3646,913,1,384777400,384777400,1366,455,911,455,0,1,457,181063,0.181063
855,6055,6965,42173075,2,6846,1713,1,426441400,426441400,2566,855,1711,855,0,1,857,3112710,3.11271
1255,6055,6965,42173075,2,10046,2513,1,468105400,468105400,3766,1255,2511,1255,0,1,1257,1820668,1.820668
1655,6055,6965,42173075,2,13246,3313,1,509769400,509769400,4966,1655,3311,1655,0,1,1657,1062825,1.062825
2055,6055,6965,42173075,2,16446,4113,1,551433400,551433400,6166,2055,4111,2055,0,1,2057,492333,0.492333
2455,6055,6965,42173075,2,19646,4913,1,593097400,593097400,7366,2455,4911,2455,0,1,2457,643682,0.643682
2855,6055,6965,42173075,2,22846,5713,1,634761400,634761400,8566,2855,5711,2855,0,1,2857,1881200,1.8812
3255,6055,6965,42173075,2,26046,6513,1,676425400,676425400,9766,3255,6511,3255,0,1,3257,2794511,2.794511
3655,6055,6965,42173075,2,29246,7313,1,718089400,718089400,10966,3655,7311,3655,0,1,3657,3242632,3.242632
4055,6055,6965,42173075,2,32446,8113,1,759753400,759753400,12166,4055,8111,4055,0,1,4057,1451342,1.451342
4455,6055,6965,42173075,2,35646,8913,1,801417400,801417400,13366,4455,8911,4455,0,1,4457,88473,0.088473
4855,6055,6965,42173075,2,38846,9713,1,843081400,843081400,14566,4855,9711,4855,0,1,4857,2354386,2.354386
5255,6055,6965,42173075,2,42046,10513,1,884745400,884745400,15766,5255,10511,5255,0,1,5257,249478,0.249478
5655,6055,6965,42173075,2,45246,11313,1,926409400,926409400,16966,5655,11311,5655,0,1,5657,215282,0.215282
6055,6055,6965,42173075,2,48446,12113,1,968073400,968073400,18166,6055,12111,6055,0,1,6057,199155,0.199155
6455,6055,6965,42173075,2,51646,12913,1,1009737400,1009737400,19366,6455,12911,6455,0,1,6457,8375717,8.375717
6855,6055,6965,42173075,2,54846,13713,1,1051401400,1051401400,20566,6855,13711,6855,0,1,6857,510584,0.510584
40,7050,6040,42582000,2,326,83,1,344844800,344844800,121,40,81,40,0,1,42,743366,0.743366
440,7050,6040,42582000,2,3526,883,1,386732800,386732800,1321,440,881,440,0,1,442,2091936,2.091936
840,7050,6040,42582000,2,6726,1683,1,428620800,428620800,2521,840,1681,840,0,1,842,2608543,2.608543
1240,7050,6040,42582000,2,9926,2483,1,470508800,470508800,3721,1240,2481,1240,0,1,1242,2601610,2.60161
1640,7050,6040,42582000,2,13126,3283,1,512396800,512396800,4921,1640,3281,1640,0,1,1642,13534375,13.534375
2040,7050,6040,42582000,2,16326,4083,1,554284800,554284800,6121,2040,4081,2040,0,1,2042,3674517,3.674517
2440,7050,6040,42582000,2,19526,4883,1,596172800,596172800,7321,2440,4881,2440,0,1,2442,2515488,2.515488
2840,7050,6040,42582000,2,22726,5683,1,638060800,638060800,8521,2840,5681,2840,0,1,2842,922976,0.922976
3240,7050,6040,42582000,2,25926,6483,1,679948800,679948800,9721,3240,6481,3240,0,1,3242,1744802,1.744802
3640,7050,6040,42582000,2,29126,7283,1,721836800,721836800,10921,3640,7281,3640,0,1,3642,1672549,1.672549
4040,7050,6040,42582000,2,32326,8083,1,763724800,763724800,12121,4040,8081,4040,0,1,4042,6205768,6.205768
4440,7050,6040,42582000,2,35526,8883,1,805612800,805612800,13321,4440,8881,4440,0,1,4442,20112945,20.112945
4840,7050,6040,42582000,2,38726,9683,1,847500800,847500800,14521,4840,9681,4840,0,1,4842,15557100,15.5571
5240,7050,6040,42582000,2,41926,10483,1,889388800,889388800,15721,5240,10481,5240,0,1,5242,43224713,43.224713
5640,7050,6040,42582000,2,45126,11283,1,931276800,931276800,16921,5640,11281,5640,0,1,5642,46432394,46.432394
6040,7050,6040,42582000,2,48326,12083,1,973164800,973164800,18121,6040,12081,6040,0,1,6042,49798869,49.798869
6440,7050,6040,42582000,2,51526,12883,1,1015052800,1015052800,19321,6440,12881,6440,0,1,6442,53075094,53.075094
6840,7050,6040,42582000,2,54726,13683,1,1056940800,1056940800,20521,6840,13681,6840,0,1,6842,56401893,56.401893
35,6050,7045,42622250,2,286,73,1,344644600,344644600,106,35,71,35,0,1,37,32856,0.032856
535,6050,7045,42622250,2,4286,1073,1,397024600,397024600,1606,535,1071,535,0,1,537,1479298,1.479298
1035,6050,7045,42622250,2,8286,2073,1,449404600,449404600,3106,1035,2071,1035,0,1,1037,544993,0.544993
1535,6050,7045,42622250,2,12286,3073,1,501784600,501784600,4606,1535,3071,1535,0,1,1537,813056,0.813056
2035,6050,7045,42622250,2,16286,4073,1,554164600,554164600,6106,2035,4071,2035,0,1,2037,3230048,3.230048
2535,6050,7045,42622250,2,20286,5073,1,606544600,606544600,7606,2535,5071,2535,0,1,2537,859953,0.859953
3035,6050,7045,42622250,2,24286,6073,1,658924600,658924600,9106,3035,6071,3035,0,1,3037,1081773,1.081773
3535,6050,7045,42622250,2,28286,7073,1,711304600,711304600,10606,3535,7071,3535,0,1,3537,9689362,9.689362
4035,6050,7045,42622250,2,32286,8073,1,763684600,763684600,12106,4035,8071,4035,0,1,4037,4329060,4.32906
4535,6050,7045,42622250,2,36286,9073,1,816064600,816064600,13606,4535,9071,4535,0,1,4537,658152,0.658152
5035,6050,7045,42622250,2,40286,10073,1,868444600,868444600,15106,5035,10071,5035,0,1,5037,4837844,4.837844
5535,6050,7045,42622250,2,44286,11073,1,920824600,920824600,16606,5535,11071,5535,0,1,5537,4747300,4.7473
6035,6050,7045,42622250,2,48286,12073,1,973204600,973204600,18106,6035,12071,6035,0,1,6037,9530763,9.530763
6535,6050,7045,42622250,2,52286,13073,1,1025584600,1025584600,19606,6535,13071,6535,0,1,6537,24771334,24.771334
7035,6050,7045,42622250,2,56286,14073,1,1077964600,1077964600,21106,7035,14071,7035,0,1,7037,39586538,39.586538
55,7055,6065,42788575,2,446,113,1,348081400,348081400,166,55,111,55,0,1,57,886721,0.886721
455,7055,6065,42788575,2,3646,913,1,390065400,390065400,1366,455,911,455,0,1,457,262174,0.262174
855,7055,6065,42788575,2,6846,1713,1,432049400,432049400,2566,855,1711,855,0,1,857,6378226,6.378226
1255,7055,6065,42788575,2,10046,2513,1,474033400,474033400,3766,1255,2511,1255,0,1,1257,68377,0.068377
1655,7055,6065,42788575,2,13246,3313,1,516017400,516017400,4966,1655,3311,1655,0,1,1657,12737730,12.73773
2055,7055,6065,42788575,2,16446,4113,1,558001400,558001400,6166,2055,4111,2055,0,1,2057,1871430,1.87143
2455,7055,6065,42788575,2,19646,4913,1,599985400,599985400,7366,2455,4911,2455,0,1,2457,76855,0.076855
2855,7055,6065,42788575,2,22846,5713,1,641969400,641969400,8566,2855,5711,2855,0,1,2857,992512,0.992512
3255,7055,6065,42788575,2,26046,6513,1,683953400,683953400,9766,3255,6511,3255,0,1,3257,1568035,1.568035
3655,7055,6065,42788575,2,29246,7313,1,725937400,725937400,10966,3655,7311,3655,0,1,3657,6653775,6.653775
4055,7055,6065,42788575,2,32446,8113,1,767921400,767921400,12166,4055,8111,4055,0,1,4057,6628697,6.628697
4455,7055,6065,42788575,2,35646,8913,1,809905400,809905400,13366,4455,8911,4455,0,1,4457,21922461,21.922461
4855,7055,6065,42788575,2,38846,9713,1,851889400,851889400,14566,4855,9711,4855,0,1,4857,19693618,19.693618
5255,7055,6065,42788575,2,42046,10513,1,893873400,893873400,15766,5255,10511,5255,0,1,5257,3175037,3.175037
5655,7055,6065,42788575,2,45246,11313,1,935857400,935857400,16966,5655,11311,5655,0,1,5657,47538116,47.538116
6055,7055,6065,42788575,2,48446,12113,1,977841400,977841400,18166,6055,12111,6055,0,1,6057,50963483,50.963483
6455,7055,6065,42788575,2,51646,12913,1,1019825400,1019825400,19366,6455,12911,6455,0,1,6457,54340242,54.340242
6855,7055,6065,42788575,2,54846,13713,1,1061809400,1061809400,20566,6855,13711,6855,0,1,6857,57652935,57.652935
39,6093,7041,42900813,2,318,81,1,347304312,347304312,118,39,79,39,0,1,41,93732,0.093732
539,6093,7041,42900813,2,4318,1081,1,399840312,399840312,1618,539,1079,539,0,1,541,276349,0.276349
1039,6093,7041,42900813,2,8318,2081,1,452376312,452376312,3118,1039,2079,1039,0,1,1041,1005642,1.005642
1539,6093,7041,42900813,2,12318,3081,1,504912312,504912312,4618,1539,3079,1539,0,1,1541,797491,0.797491
2039,6093,7041,42900813,2,16318,4081,1,557448312,557448312,6118,2039,4079,2039,0,1,2041,3072196,3.072196
2539,6093,7041,42900813,2,20318,5081,1,609984312,609984312,7618,2539,5079,2539,0,1,2541,153004,0.153004
3039,6093,7041,42900813,2,24318,6081,1,662520312,662520312,9118,3039,6079,3039,0,1,3041,308951,0.308951
3539,6093,7041,42900813,2,28318,7081,1,715056312,715056312,10618,3539,7079,3539,0,1,3541,434595,0.434595
4039,6093,7041,42900813,2,32318,8081,1,767592312,767592312,12118,4039,8079,4039,0,1,4041,1378396,1.378396
4539,6093,7041,42900813,2,36318,9081,1,820128312,820128312,13618,4539,9079,4539,0,1,4541,3828781,3.828781
5039,6093,7041,42900813,2,40318,10081,1,872664312,872664312,15118,5039,10079,5039,0,1,5041,1545639,1.545639
5539,6093,7041,42900813,2,44318,11081,1,925200312,925200312,16618,5539,11079,5539,0,1,5541,662112,0.662112
6039,6093,7041,42900813,2,48318,12081,1,977736312,977736312,18118,6039,12079,6039,0,1,6041,2494668,2.494668
6539,6093,7041,42900813,2,52318,13081,1,1030272312,1030272312,19618,6539,13079,6539,0,1,6541,959758,0.959758
7039,6093,7041,42900813,2,56318,14081,1,1082808312,1082808312,21118,7039,14079,7039,0,1,7041,12091132,12.091132
35,6090,7045,42904050,2,286,73,1,346910200,346910200,106,35,71,35,0,1,37,155994,0.155994
535,6090,7045,42904050,2,4286,1073,1,399450200,399450200,1606,535,1071,535,0,1,537,1389927,1.389927
1035,6090,7045,42904050,2,8286,2073,1,451990200,451990200,3106,1035,2071,1035,0,1,1037,872598,0.872598
1535,6090,7045,42904050,2,12286,3073,1,504530200,504530200,4606,1535,3071,1535,0,1,1537,13039479,13.039479
44,6103,7055,43056665,2,358,91,1,349084936,349084936,133,44,89,44,0,1,46,89600,0.0896
544,6103,7055,43056665,2,4358,1091,1,401716936,401716936,1633,544,1089,544,0,1,546,270395,0.270395
1044,6103,7055,43056665,2,8358,2091,1,454348936,454348936,3133,1044,2089,1044,0,1,1046,412688,0.412688
1544,6103,7055,43056665,2,12358,3091,1,506980936,506980936,4633,1544,3089,1544,0,1,1546,379887,0.379887
2044,6103,7055,43056665,2,16358,4091,1,559612936,559612936,6133,2044,4089,2044,0,1,2046,1198589,1.198589
2544,6103,7055,43056665,2,20358,5091,1,612244936,612244936,7633,2544,5089,2544,0,1,2546,186659,0.186659
3044,6103,7055,43056665,2,24358,6091,1,664876936,664876936,9133,3044,6089,3044,0,1,3046,335621,0.335621
3544,6103,7055,43056665,2,28358,7091,1,717508936,717508936,10633,3544,7089,3544,0,1,3546,1469960,1.46996
4044,6103,7055,43056665,2,32358,8091,1,770140936,770140936,12133,4044,8089,4044,0,1,4046,150703,0.150703
4544,6103,7055,43056665,2,36358,9091,1,822772936,822772936,13633,4544,9089,4544,0,1,4546,915335,0.915335
5044,6103,7055,43056665,2,40358,10091,1,875404936,875404936,15133,5044,10089,5044,0,1,5046,1204338,1.204338
5544,6103,7055,43056665,2,44358,11091,1,928036936,928036936,16633,5544,11089,5544,0,1,5546,2015908,2.015908
6044,6103,7055,43056665,2,48358,12091,1,980668936,980668936,18133,6044,12089,6044,0,1,6046,459134,0.459134
6544,6103,7055,43056665,2,52358,13091,1,1033300936,1033300936,19633,6544,13089,6544,0,1,6546,1772232,1.772232
7044,6103,7055,43056665,2,56358,14091,1,1085932936,1085932936,21133,7044,14089,7044,0,1,7046,8355955,8.355955
40,6800,6340,43112000,2,326,83,1,349100800,349100800,121,40,81,40,0,1,42,769184,0.769184
440,6800,6340,43112000,2,3526,883,1,391148800,391148800,1321,440,881,440,0,1,442,2000974,2.000974
840,6800,6340,43112000,2,6726,1683,1,433196800,433196800,2521,840,1681,840,0,1,842,644540,0.64454
1240,6800,6340,43112000,2,9926,2483,1,475244800,475244800,3721,1240,2481,1240,0,1,1242,1183370,1.18337
1640,6800,6340,43112000,2,13126,3283,1,517292800,517292800,4921,1640,3281,1640,0,1,1642,1769070,1.76907
2040,6800,6340,43112000,2,16326,4083,1,559340800,559340800,6121,2040,4081,2040,0,1,2042,1913925,1.913925
2440,6800,6340,43112000,2,19526,4883,1,601388800,601388800,7321,2440,4881,2440,0,1,2442,150166,0.150166
2840,6800,6340,43112000,2,22726,5683,1,643436800,643436800,8521,2840,5681,2840,0,1,2842,98351,0.098351
3240,6800,6340,43112000,2,25926,6483,1,685484800,685484800,9721,3240,6481,3240,0,1,3242,922110,0.92211
3640,6800,6340,43112000,2,29126,7283,1,727532800,727532800,10921,3640,7281,3640,0,1,3642,1246978,1.246978
4040,6800,6340,43112000,2,32326,8083,1,769580800,769580800,12121,4040,8081,4040,0,1,4042,5212833,5.212833
4440,6800,6340,43112000,2,35526,8883,1,811628800,811628800,13321,4440,8881,4440,0,1,4442,2248320,2.24832
4840,6800,6340,43112000,2,38726,9683,1,853676800,853676800,14521,4840,9681,4840,0,1,4842,6224938,6.224938
5240,6800,6340,43112000,2,41926,10483,1,895724800,895724800,15721,5240,10481,5240,0,1,5242,1170627,1.170627
5640,6800,6340,43112000,2,45126,11283,1,937772800,937772800,16921,5640,11281,5640,0,1,5642,170814,0.170814
6040,6800,6340,43112000,2,48326,12083,1,979820800,979820800,18121,6040,12081,6040,0,1,6042,8909693,8.909693
6440,6800,6340,43112000,2,51526,12883,1,1021868800,1021868800,19321,6440,12881,6440,0,1,6442,242338,0.242338
6840,6800,6340,43112000,2,54726,13683,1,1063916800,1063916800,20521,6840,13681,6840,0,1,6842,4511109,4.511109
35,6600,6545,43197000,2,286,73,1,349256600,349256600,106,35,71,35,0,1,37,283357,0.283357
535,6600,6545,43197000,2,4286,1073,1,401836600,401836600,1606,535,1071,535,0,1,537,502239,0.502239
1035,6600,6545,43197000,2,8286,2073,1,454416600,454416600,3106,1035,2071,1035,0,1,1037,1189313,1.189313
1535,6600,6545,43197000,2,12286,3073,1,506996600,506996600,4606,1535,3071,1535,0,1,1537,6217913,6.217913
2035,6600,6545,43197000,2,16286,4073,1,559576600,559576600,6106,2035,4071,2035,0,1,2037,95299,0.095299
2535,6600,6545,43197000,2,20286,5073,1,612156600,612156600,7606,2535,5071,2535,0,1,2537,713720,0.71372
3035,6600,6545,43197000,2,24286,6073,1,664736600,664736600,9106,3035,6071,3035,0,1,3037,368031,0.368031
3535,6600,6545,43197000,2,28286,7073,1,717316600,717316600,10606,3535,7071,3535,0,1,3537,3320082,3.320082
4035,6600,6545,43197000,2,32286,8073,1,769896600,769896600,12106,4035,8071,4035,0,1,4037,208973,0.208973
4535,6600,6545,43197000,2,36286,9073,1,822476600,822476600,13606,4535,9071,4535,0,1,4537,2080804,2.080804
5035,6600,6545,43197000,2,40286,10073,1,875056600,875056600,15106,5035,10071,5035,0,1,5037,1936047,1.936047
5535,6600,6545,43197000,2,44286,11073,1,927636600,927636600,16606,5535,11071,5535,0,1,5537,1722945,1.722945
6035,6600,6545,43197000,2,48286,12073,1,980216600,980216600,18106,6035,12071,6035,0,1,6037,1250334,1.250334
6535,6600,6545,43197000,2,52286,13073,1,1032796600,1032796600,19606,6535,13071,6535,0,1,6537,13475537,13.475537
7035,6600,6545,43197000,2,56286,14073,1,1085376600,1085376600,21106,7035,14071,7035,0,1,7037,57137728,57.137728
55,6805,6365,43313825,2,446,113,1,352305400,352305400,166,55,111,55,0,1,57,874853,0.874853
455,6805,6365,43313825,2,3646,913,1,394449400,394449400,1366,455,911,455,0,1,457,296295,0.296295
855,6805,6365,43313825,2,6846,1713,1,436593400,436593400,2566,855,1711,855,0,1,857,595382,0.595382
1255,6805,6365,43313825,2,10046,2513,1,478737400,478737400,3766,1255,2511,1255,0,1,1257,1069650,1.06965
1655,6805,6365,43313825,2,13246,3313,1,520881400,520881400,4966,1655,3311,1655,0,1,1657,374346,0.374346
2055,6805,6365,43313825,2,16446,4113,1,563025400,563025400,6166,2055,4111,2055,0,1,2057,2757313,2.757313
2455,6805,6365,43313825,2,19646,4913,1,605169400,605169400,7366,2455,4911,2455,0,1,2457,1380064,1.380064
2855,6805,6365,43313825,2,22846,5713,1,647313400,647313400,8566,2855,5711,2855,0,1,2857,5014038,5.014038
3255,6805,6365,43313825,2,26046,6513,1,689457400,689457400,9766,3255,6511,3255,0,1,3257,700275,0.700275
3655,6805,6365,43313825,2,29246,7313,1,731601400,731601400,10966,3655,7311,3655,0,1,3657,2452191,2.452191
4055,6805,6365,43313825,2,32446,8113,1,773745400,773745400,12166,4055,8111,4055,0,1,4057,2827705,2.827705
4455,6805,6365,43313825,2,35646,8913,1,815889400,815889400,13366,4455,8911,4455,0,1,4457,1035393,1.035393
4855,6805,6365,43313825,2,38846,9713,1,858033400,858033400,14566,4855,9711,4855,0,1,4857,1260902,1.260902
5255,6805,6365,43313825,2,42046,10513,1,900177400,900177400,15766,5255,10511,5255,0,1,5257,5014551,5.014551
5655,6805,6365,43313825,2,45246,11313,1,942321400,942321400,16966,5655,11311,5655,0,1,5657,3703225,3.703225
6055,6805,6365,43313825,2,48446,12113,1,984465400,984465400,18166,6055,12111,6055,0,1,6057,2200267,2.200267
6455,6805,6365,43313825,2,51646,12913,1,1026609400,1026609400,19366,6455,12911,6455,0,1,6457,588282,0.588282
6855,6805,6365,43313825,2,54846,13713,1,1068753400,1068753400,20566,6855,13711,6855,0,1,6857,8193351,8.193351
39,6643,6541,43451863,2,318,81,1,351728312,351728312,118,39,79,39,0,1,41,51979,0.051979
539,6643,6541,43451863,2,4318,1081,1,404464312,404464312,1618,539,1079,539,0,1,541,88780,0.08878
1039,6643,6541,43451863,2,8318,2081,1,457200312,457200312,3118,1039,2079,1039,0,1,1041,332608,0.332608
1539,6643,6541,43451863,2,12318,3081,1,509936312,509936312,4618,1539,3079,1539,0,1,1541,1024355,1.024355
2039,6643,6541,43451863,2,16318,4081,1,562672312,562672312,6118,2039,4079,2039,0,1,2041,60033,0.060033
2539,6643,6541,43451863,2,20318,5081,1,615408312,615408312,7618,2539,5079,2539,0,1,2541,165145,0.165145
3039,6643,6541,43451863,2,24318,6081,1,668144312,668144312,9118,3039,6079,3039,0,1,3041,540247,0.540247
3539,6643,6541,43451863,2,28318,7081,1,720880312,720880312,10618,3539,7079,3539,0,1,3541,113931,0.113931
4039,6643,6541,43451863,2,32318,8081,1,773616312,773616312,12118,4039,8079,4039,0,1,4041,1874447,1.874447
4539,6643,6541,43451863,2,36318,9081,1,826352312,826352312,13618,4539,9079,4539,0,1,4541,7188629,7.188629
5039,6643,6541,43451863,2,40318,10081,1,879088312,879088312,15118,5039,10079,5039,0,1,5041,951564,0.951564
5539,6643,6541,43451863,2,44318,11081,1,931824312,931824312,16618,5539,11079,5539,0,1,5541,30816,0.030816
6039,6643,6541,43451863,2,48318,12081,1,984560312,984560312,18118,6039,12079,6039,0,1,6041,2540203,2.540203
6539,6643,6541,43451863,2,52318,13081,1,1037296312,1037296312,19618,6539,13079,6539,0,1,6541,6929478,6.929478
7039,6643,6541,43451863,2,56318,14081,1,1090032312,1090032312,21118,7039,14079,7039,0,1,7041,13257219,13.257219
40,6550,6640,43492000,2,326,83,1,352156800,352156800,121,40,81,40,0,1,42,104346,0.104346
440,6550,6640,43492000,2,3526,883,1,394364800,394364800,1321,440,881,440,0,1,442,302267,0.302267
840,6550,6640,43492000,2,6726,1683,1,436572800,436572800,2521,840,1681,840,0,1,842,38899,0.038899
1240,6550,6640,43492000,2,9926,2483,1,478780800,478780800,3721,1240,2481,1240,0,1,1242,324064,0.324064
1640,6550,6640,43492000,2,13126,3283,1,520988800,520988800,4921,1640,3281,1640,0,1,1642,387036,0.387036
2040,6550,6640,43492000,2,16326,4083,1,563196800,563196800,6121,2040,4081,2040,0,1,2042,1142296,1.142296
2440,6550,6640,43492000,2,19526,4883,1,605404800,605404800,7321,2440,4881,2440,0,1,2442,115663,0.115663
2840,6550,6640,43492000,2,22726,5683,1,647612800,647612800,8521,2840,5681,2840,0,1,2842,484744,0.484744
3240,6550,6640,43492000,2,25926,6483,1,689820800,689820800,9721,3240,6481,3240,0,1,3242,252551,0.252551
3640,6550,6640,43492000,2,29126,7283,1,732028800,732028800,10921,3640,7281,3640,0,1,3642,823747,0.823747
4040,6550,6640,43492000,2,32326,8083,1,774236800,774236800,12121,4040,8081,4040,0,1,4042,499736,0.499736
4440,6550,6640,43492000,2,35526,8883,1,816444800,816444800,13321,4440,8881,4440,0,1,4442,105620,0.10562
4840,6550,6640,43492000,2,38726,9683,1,858652800,858652800,14521,4840,9681,4840,0,1,4842,110437,0.110437
5240,6550,6640,43492000,2,41926,10483,1,900860800,900860800,15721,5240,10481,5240,0,1,5242,310247,0.310247
5640,6550,6640,43492000,2,45126,11283,1,943068800,943068800,16921,5640,11281,5640,0,1,5642,589103,0.589103
6040,6550,6640,43492000,2,48326,12083,1,985276800,985276800,18121,6040,12081,6040,0,1,6042,229673,0.229673
6440,6550,6640,43492000,2,51526,12883,1,1027484800,1027484800,19321,6440,12881,6440,0,1,6442,2617379,2.617379
6840,6550,6640,43492000,2,54726,13683,1,1069692800,1069692800,20521,6840,13681,6840,0,1,6842,2823556,2.823556
44,6653,6555,43610415,2,358,91,1,353532536,353532536,133,44,89,44,0,1,46,174036,0.174036
544,6653,6555,43610415,2,4358,1091,1,406364536,406364536,1633,544,1089,544,0,1,546,103760,0.10376
1044,6653,6555,43610415,2,8358,2091,1,459196536,459196536,3133,1044,2089,1044,0,1,1046,353728,0.353728
1544,6653,6555,43610415,2,12358,3091,1,512028536,512028536,4633,1544,3089,1544,0,1,1546,94505,0.094505
2044,6653,6555,43610415,2,16358,4091,1,564860536,564860536,6133,2044,4089,2044,0,1,2046,2718260,2.71826
2544,6653,6555,43610415,2,20358,5091,1,617692536,617692536,7633,2544,5089,2544,0,1,2546,593910,0.59391
3044,6653,6555,43610415,2,24358,6091,1,670524536,670524536,9133,3044,6089,3044,0,1,3046,546646,0.546646
3544,6653,6555,43610415,2,28358,7091,1,723356536,723356536,10633,3544,7089,3544,0,1,3546,8544504,8.544504
4044,6653,6555,43610415,2,32358,8091,1,776188536,776188536,12133,4044,8089,4044,0,1,4046,1366039,1.366039
4544,6653,6555,43610415,2,36358,9091,1,829020536,829020536,13633,4544,9089,4544,0,1,4546,1521398,1.521398
5044,6653,6555,43610415,2,40358,10091,1,881852536,881852536,15133,5044,10089,5044,0,1,5046,336580,0.33658
5544,6653,6555,43610415,2,44358,11091,1,934684536,934684536,16633,5544,11089,5544,0,1,5546,4013830,4.01383
6044,6653,6555,43610415,2,48358,12091,1,987516536,987516536,18133,6044,12089,6044,0,1,6046,2577693,2.577693
6544,6653,6555,43610415,2,52358,13091,1,1040348536,1040348536,19633,6544,13089,6544,0,1,6546,1926318,1.926318
7044,6653,6555,43610415,2,56358,14091,1,1093180536,1093180536,21133,7044,14089,7044,0,1,7046,5027981,5.027981
55,6555,6665,43689075,2,446,113,1,355329400,355329400,166,55,111,55,0,1,57,46029,0.046029
455,6555,6665,43689075,2,3646,913,1,397633400,397633400,1366,455,911,455,0,1,457,52969,0.052969
855,6555,6665,43689075,2,6846,1713,1,439937400,439937400,2566,855,1711,855,0,1,857,601838,0.601838
1255,6555,6665,43689075,2,10046,2513,1,482241400,482241400,3766,1255,2511,1255,0,1,1257,162161,0.162161
1655,6555,6665,43689075,2,13246,3313,1,524545400,524545400,4966,1655,3311,1655,0,1,1657,282925,0.282925
2055,6555,6665,43689075,2,16446,4113,1,566849400,566849400,6166,2055,4111,2055,0,1,2057,116613,0.116613
2455,6555,6665,43689075,2,19646,4913,1,609153400,609153400,7366,2455,4911,2455,0,1,2457,98878,0.098878
2855,6555,6665,43689075,2,22846,5713,1,651457400,651457400,8566,2855,5711,2855,0,1,2857,483342,0.483342
3255,6555,6665,43689075,2,26046,6513,1,693761400,693761400,9766,3255,6511,3255,0,1,3257,163159,0.163159
3655,6555,6665,43689075,2,29246,7313,1,736065400,736065400,10966,3655,7311,3655,0,1,3657,1940798,1.940798
4055,6555,6665,43689075,2,32446,8113,1,778369400,778369400,12166,4055,8111,4055,0,1,4057,4220761,4.220761
4455,6555,6665,43689075,2,35646,8913,1,820673400,820673400,13366,4455,8911,4455,0,1,4457,1298790,1.29879
4855,6555,6665,43689075,2,38846,9713,1,862977400,862977400,14566,4855,9711,4855,0,1,4857,325813,0.325813
5255,6555,6665,43689075,2,42046,10513,1,905281400,905281400,15766,5255,10511,5255,0,1,5257,904122,0.904122
5655,6555,6665,43689075,2,45246,11313,1,947585400,947585400,16966,5655,11311,5655,0,1,5657,1139363,1.139363
6055,6555,6665,43689075,2,48446,12113,1,989889400,989889400,18166,6055,12111,6055,0,1,6057,482227,0.482227
6455,6555,6665,43689075,2,51646,12913,1,1032193400,1032193400,19366,6455,12911,6455,0,1,6457,731416,0.731416
6855,6555,6665,43689075,2,54846,13713,1,1074497400,1074497400,20566,6855,13711,6855,0,1,6857,2387967,2.387967
40,6300,6940,43722000,2,326,83,1,354012800,354012800,121,40,81,40,0,1,42,802917,0.802917
440,6300,6940,43722000,2,3526,883,1,396380800,396380800,1321,440,881,440,0,1,442,3792491,3.792491
840,6300,6940,43722000,2,6726,1683,1,438748800,438748800,2521,840,1681,840,0,1,842,1220077,1.220077
1240,6300,6940,43722000,2,9926,2483,1,481116800,481116800,3721,1240,2481,1240,0,1,1242,9852961,9.852961
1640,6300,6940,43722000,2,13126,3283,1,523484800,523484800,4921,1640,3281,1640,0,1,1642,852479,0.852479
2040,6300,6940,43722000,2,16326,4083,1,565852800,565852800,6121,2040,4081,2040,0,1,2042,141983,0.141983
2440,6300,6940,43722000,2,19526,4883,1,608220800,608220800,7321,2440,4881,2440,0,1,2442,8519431,8.519431
2840,6300,6940,43722000,2,22726,5683,1,650588800,650588800,8521,2840,5681,2840,0,1,2842,2061540,2.06154
3240,6300,6940,43722000,2,25926,6483,1,692956800,692956800,9721,3240,6481,3240,0,1,3242,1002974,1.002974
3640,6300,6940,43722000,2,29126,7283,1,735324800,735324800,10921,3640,7281,3640,0,1,3642,684148,0.684148
4040,6300,6940,43722000,2,32326,8083,1,777692800,777692800,12121,4040,8081,4040,0,1,4042,983301,0.983301
4440,6300,6940,43722000,2,35526,8883,1,820060800,820060800,13321,4440,8881,4440,0,1,4442,3392559,3.392559
4840,6300,6940,43722000,2,38726,9683,1,862428800,862428800,14521,4840,9681,4840,0,1,4842,4003659,4.003659
5240,6300,6940,43722000,2,41926,10483,1,904796800,904796800,15721,5240,10481,5240,0,1,5242,8698809,8.698809
5640,6300,6940,43722000,2,45126,11283,1,947164800,947164800,16921,5640,11281,5640,0,1,5642,4470697,4.470697
6040,6300,6940,43722000,2,48326,12083,1,989532800,989532800,18121,6040,12081,6040,0,1,6042,1770965,1.770965
6440,6300,6940,43722000,2,51526,12883,1,1031900800,1031900800,19321,6440,12881,6440,0,1,6442,813565,0.813565
6840,6300,6940,43722000,2,54726,13683,1,1074268800,1074268800,20521,6840,13681,6840,0,1,6842,36603837,36.603837
55,6305,6965,43914325,2,446,113,1,357153400,357153400,166,55,111,55,0,1,57,875115,0.875115
455,6305,6965,43914325,2,3646,913,1,399617400,399617400,1366,455,911,455,0,1,457,2614960,2.61496
855,6305,6965,43914325,2,6846,1713,1,442081400,442081400,2566,855,1711,855,0,1,857,1291999,1.291999
1255,6305,6965,43914325,2,10046,2513,1,484545400,484545400,3766,1255,2511,1255,0,1,1257,1593579,1.593579
1655,6305,6965,43914325,2,13246,3313,1,527009400,527009400,4966,1655,3311,1655,0,1,1657,1073726,1.073726
2055,6305,6965,43914325,2,16446,4113,1,569473400,569473400,6166,2055,4111,2055,0,1,2057,4783764,4.783764
2455,6305,6965,43914325,2,19646,4913,1,611937400,611937400,7366,2455,4911,2455,0,1,2457,337244,0.337244
2855,6305,6965,43914325,2,22846,5713,1,654401400,654401400,8566,2855,5711,2855,0,1,2857,4698414,4.698414
3255,6305,6965,43914325,2,26046,6513,1,696865400,696865400,9766,3255,6511,3255,0,1,3257,2966869,2.966869
3655,6305,6965,43914325,2,29246,7313,1,739329400,739329400,10966,3655,7311,3655,0,1,3657,4032671,4.032671
4055,6305,6965,43914325,2,32446,8113,1,781793400,781793400,12166,4055,8111,4055,0,1,4057,1073528,1.073528
4455,6305,6965,43914325,2,35646,8913,1,824257400,824257400,13366,4455,8911,4455,0,1,4457,6957104,6.957104
4855,6305,6965,43914325,2,38846,9713,1,866721400,866721400,14566,4855,9711,4855,0,1,4857,14885307,14.885307
5255,6305,6965,43914325,2,42046,10513,1,909185400,909185400,15766,5255,10511,5255,0,1,5257,330174,0.330174
5655,6305,6965,43914325,2,45246,11313,1,951649400,951649400,16966,5655,11311,5655,0,1,5657,2537235,2.537235
6055,6305,6965,43914325,2,48446,12113,1,994113400,994113400,18166,6055,12111,6055,0,1,6057,2023947,2.023947
6455,6305,6965,43914325,2,51646,12913,1,1036577400,1036577400,19366,6455,12911,6455,0,1,6457,13668299,13.668299
6855,6305,6965,43914325,2,54846,13713,1,1079041400,1079041400,20566,6855,13711,6855,0,1,6857,13065414,13.065414
40,7050,6340,44697000,2,326,83,1,361860800,361860800,121,40,81,40,0,1,42,784041,0.784041
440,7050,6340,44697000,2,3526,883,1,404708800,404708800,1321,440,881,440,0,1,442,1199317,1.199317
840,7050,6340,44697000,2,6726,1683,1,447556800,447556800,2521,840,1681,840,0,1,842,3731125,3.731125
1240,7050,6340,44697000,2,9926,2483,1,490404800,490404800,3721,1240,2481,1240,0,1,1242,10569384,10.569384
1640,7050,6340,44697000,2,13126,3283,1,533252800,533252800,4921,1640,3281,1640,0,1,1642,10748122,10.748122
2040,7050,6340,44697000,2,16326,4083,1,576100800,576100800,6121,2040,4081,2040,0,1,2042,2331254,2.331254
2440,7050,6340,44697000,2,19526,4883,1,618948800,618948800,7321,2440,4881,2440,0,1,2442,4159905,4.159905
2840,7050,6340,44697000,2,22726,5683,1,661796800,661796800,8521,2840,5681,2840,0,1,2842,1262734,1.262734
3240,7050,6340,44697000,2,25926,6483,1,704644800,704644800,9721,3240,6481,3240,0,1,3242,6312684,6.312684
3640,7050,6340,44697000,2,29126,7283,1,747492800,747492800,10921,3640,7281,3640,0,1,3642,3106083,3.106083
4040,7050,6340,44697000,2,32326,8083,1,790340800,790340800,12121,4040,8081,4040,0,1,4042,6778768,6.778768
4440,7050,6340,44697000,2,35526,8883,1,833188800,833188800,13321,4440,8881,4440,0,1,4442,22887061,22.887061
4840,7050,6340,44697000,2,38726,9683,1,876036800,876036800,14521,4840,9681,4840,0,1,4842,25750670,25.75067
5240,7050,6340,44697000,2,41926,10483,1,918884800,918884800,15721,5240,10481,5240,0,1,5242,45718532,45.718532
5640,7050,6340,44697000,2,45126,11283,1,961732800,961732800,16921,5640,11281,5640,0,1,5642,49147558,49.147558
6040,7050,6340,44697000,2,48326,12083,1,1004580800,1004580800,18121,6040,12081,6040,0,1,6042,52731120,52.73112
6440,7050,6340,44697000,2,51526,12883,1,1047428800,1047428800,19321,6440,12881,6440,0,1,6442,56191897,56.191897
6840,7050,6340,44697000,2,54726,13683,1,1090276800,1090276800,20521,6840,13681,6840,0,1,6842,59752270,59.75227
55,7055,6365,44905075,2,446,113,1,365145400,365145400,166,55,111,55,0,1,57,929578,0.929578
455,7055,6365,44905075,2,3646,913,1,408089400,408089400,1366,455,911,455,0,1,457,4280916,4.280916
855,7055,6365,44905075,2,6846,1713,1,451033400,451033400,2566,855,1711,855,0,1,857,2561333,2.561333
1255,7055,6365,44905075,2,10046,2513,1,493977400,493977400,3766,1255,2511,1255,0,1,1257,4014273,4.014273
1655,7055,6365,44905075,2,13246,3313,1,536921400,536921400,4966,1655,3311,1655,0,1,1657,7337283,7.337283
2055,7055,6365,44905075,2,16446,4113,1,579865400,579865400,6166,2055,4111,2055,0,1,2057,997888,0.997888
2455,7055,6365,44905075,2,19646,4913,1,622809400,622809400,7366,2455,4911,2455,0,1,2457,1871658,1.871658
2855,7055,6365,44905075,2,22846,5713,1,665753400,665753400,8566,2855,5711,2855,0,1,2857,3296482,3.296482
3255,7055,6365,44905075,2,26046,6513,1,708697400,708697400,9766,3255,6511,3255,0,1,3257,12650791,12.650791
3655,7055,6365,44905075,2,29246,7313,1,751641400,751641400,10966,3655,7311,3655,0,1,3657,3043220,3.04322
4055,7055,6365,44905075,2,32446,8113,1,794585400,794585400,12166,4055,8111,4055,0,1,4057,20425258,20.425258
4455,7055,6365,44905075,2,35646,8913,1,837529400,837529400,13366,4455,8911,4455,0,1,4457,9738360,9.73836
4855,7055,6365,44905075,2,38846,9713,1,880473400,880473400,14566,4855,9711,4855,0,1,4857,335201,0.335201
5255,7055,6365,44905075,2,42046,10513,1,923417400,923417400,15766,5255,10511,5255,0,1,5257,6543451,6.543451
5655,7055,6365,44905075,2,45246,11313,1,966361400,966361400,16966,5655,11311,5655,0,1,5657,49879740,49.87974
6055,7055,6365,44905075,2,48446,12113,1,1009305400,1009305400,18166,6055,12111,6055,0,1,6057,53501607,53.501607
6455,7055,6365,44905075,2,51646,12913,1,1052249400,1052249400,19366,6455,12911,6455,0,1,6457,57169552,57.169552
6855,7055,6365,44905075,2,54846,13713,1,1095193400,1095193400,20566,6855,13711,6855,0,1,6857,60574074,60.574074
40,6800,6640,45152000,2,326,83,1,365516800,365516800,121,40,81,40,0,1,42,782475,0.782475
440,6800,6640,45152000,2,3526,883,1,408524800,408524800,1321,440,881,440,0,1,442,3789510,3.78951
840,6800,6640,45152000,2,6726,1683,1,451532800,451532800,2521,840,1681,840,0,1,842,241630,0.24163
1240,6800,6640,45152000,2,9926,2483,1,494540800,494540800,3721,1240,2481,1240,0,1,1242,2431323,2.431323
1640,6800,6640,45152000,2,13126,3283,1,537548800,537548800,4921,1640,3281,1640,0,1,1642,2632518,2.632518
2040,6800,6640,45152000,2,16326,4083,1,580556800,580556800,6121,2040,4081,2040,0,1,2042,2706695,2.706695
2440,6800,6640,45152000,2,19526,4883,1,623564800,623564800,7321,2440,4881,2440,0,1,2442,1681057,1.681057
2840,6800,6640,45152000,2,22726,5683,1,666572800,666572800,8521,2840,5681,2840,0,1,2842,1744227,1.744227
3240,6800,6640,45152000,2,25926,6483,1,709580800,709580800,9721,3240,6481,3240,0,1,3242,88218,0.088218
3640,6800,6640,45152000,2,29126,7283,1,752588800,752588800,10921,3640,7281,3640,0,1,3642,2246562,2.246562
4040,6800,6640,45152000,2,32326,8083,1,795596800,795596800,12121,4040,8081,4040,0,1,4042,5007263,5.007263
4440,6800,6640,45152000,2,35526,8883,1,838604800,838604800,13321,4440,8881,4440,0,1,4442,431747,0.431747
4840,6800,6640,45152000,2,38726,9683,1,881612800,881612800,14521,4840,9681,4840,0,1,4842,3802747,3.802747
5240,6800,6640,45152000,2,41926,10483,1,924620800,924620800,15721,5240,10481,5240,0,1,5242,4119109,4.119109
5640,6800,6640,45152000,2,45126,11283,1,967628800,967628800,16921,5640,11281,5640,0,1,5642,7126327,7.126327
6040,6800,6640,45152000,2,48326,12083,1,1010636800,1010636800,18121,6040,12081,6040,0,1,6042,2469819,2.469819
6440,6800,6640,45152000,2,51526,12883,1,1053644800,1053644800,19321,6440,12881,6440,0,1,6442,1315690,1.31569
6840,6800,6640,45152000,2,54726,13683,1,1096652800,1096652800,20521,6840,13681,6840,0,1,6842,4094800,4.0948
55,6805,6665,45355325,2,446,113,1,368769400,368769400,166,55,111,55,0,1,57,912902,0.912902
455,6805,6665,45355325,2,3646,913,1,411873400,411873400,1366,455,911,455,0,1,457,1437594,1.437594
855,6805,6665,45355325,2,6846,1713,1,454977400,454977400,2566,855,1711,855,0,1,857,141564,0.141564
1255,6805,6665,45355325,2,10046,2513,1,498081400,498081400,3766,1255,2511,1255,0,1,1257,1433316,1.433316
1655,6805,6665,45355325,2,13246,3313,1,541185400,541185400,4966,1655,3311,1655,0,1,1657,5473890,5.47389
2055,6805,6665,45355325,2,16446,4113,1,584289400,584289400,6166,2055,4111,2055,0,1,2057,519131,0.519131
2455,6805,6665,45355325,2,19646,4913,1,627393400,627393400,7366,2455,4911,2455,0,1,2457,759517,0.759517
2855,6805,6665,45355325,2,22846,5713,1,670497400,670497400,8566,2855,5711,2855,0,1,2857,5587846,5.587846
3255,6805,6665,45355325,2,26046,6513,1,713601400,713601400,9766,3255,6511,3255,0,1,3257,716410,0.71641
3655,6805,6665,45355325,2,29246,7313,1,756705400,756705400,10966,3655,7311,3655,0,1,3657,2819948,2.819948
4055,6805,6665,45355325,2,32446,8113,1,799809400,799809400,12166,4055,8111,4055,0,1,4057,5297846,5.297846
4455,6805,6665,45355325,2,35646,8913,1,842913400,842913400,13366,4455,8911,4455,0,1,4457,6858147,6.858147
4855,6805,6665,45355325,2,38846,9713,1,886017400,886017400,14566,4855,9711,4855,0,1,4857,657824,0.657824
5255,6805,6665,45355325,2,42046,10513,1,929121400,929121400,15766,5255,10511,5255,0,1,5257,2553114,2.553114
5655,6805,6665,45355325,2,45246,11313,1,972225400,972225400,16966,5655,11311,5655,0,1,5657,7717013,7.717013
6055,6805,6665,45355325,2,48446,12113,1,1015329400,1015329400,18166,6055,12111,6055,0,1,6057,1347409,1.347409
6455,6805,6665,45355325,2,51646,12913,1,1058433400,1058433400,19366,6455,12911,6455,0,1,6457,1206905,1.206905
6855,6805,6665,45355325,2,54846,13713,1,1101537400,1101537400,20566,6855,13711,6855,0,1,6857,5890835,5.890835
40,6550,6940,45457000,2,326,83,1,367972800,367972800,121,40,81,40,0,1,42,120564,0.120564
440,6550,6940,45457000,2,3526,883,1,411140800,411140800,1321,440,881,440,0,1,442,185686,0.185686
840,6550,6940,45457000,2,6726,1683,1,454308800,454308800,2521,840,1681,840,0,1,842,70929,0.070929
1240,6550,6940,45457000,2,9926,2483,1,497476800,497476800,3721,1240,2481,1240,0,1,1242,156190,0.15619
1640,6550,6940,45457000,2,13126,3283,1,540644800,540644800,4921,1640,3281,1640,0,1,1642,339531,0.339531
2040,6550,6940,45457000,2,16326,4083,1,583812800,583812800,6121,2040,4081,2040,0,1,2042,77252,0.077252
2440,6550,6940,45457000,2,19526,4883,1,626980800,626980800,7321,2440,4881,2440,0,1,2442,119724,0.119724
2840,6550,6940,45457000,2,22726,5683,1,670148800,670148800,8521,2840,5681,2840,0,1,2842,114705,0.114705
3240,6550,6940,45457000,2,25926,6483,1,713316800,713316800,9721,3240,6481,3240,0,1,3242,3714910,3.71491
3640,6550,6940,45457000,2,29126,7283,1,756484800,756484800,10921,3640,7281,3640,0,1,3642,65545,0.065545
4040,6550,6940,45457000,2,32326,8083,1,799652800,799652800,12121,4040,8081,4040,0,1,4042,195446,0.195446
4440,6550,6940,45457000,2,35526,8883,1,842820800,842820800,13321,4440,8881,4440,0,1,4442,3162388,3.162388
4840,6550,6940,45457000,2,38726,9683,1,885988800,885988800,14521,4840,9681,4840,0,1,4842,2498271,2.498271
5240,6550,6940,45457000,2,41926,10483,1,929156800,929156800,15721,5240,10481,5240,0,1,5242,90635,0.090635
5640,6550,6940,45457000,2,45126,11283,1,972324800,972324800,16921,5640,11281,5640,0,1,5642,2009078,2.009078
6040,6550,6940,45457000,2,48326,12083,1,1015492800,1015492800,18121,6040,12081,6040,0,1,6042,2704640,2.70464
6440,6550,6940,45457000,2,51526,12883,1,1058660800,1058660800,19321,6440,12881,6440,0,1,6442,1708823,1.708823
6840,6550,6940,45457000,2,54726,13683,1,1101828800,1101828800,20521,6840,13681,6840,0,1,6842,1193507,1.193507
55,6555,6965,45655575,2,446,113,1,371193400,371193400,166,55,111,55,0,1,57,50937,0.050937
455,6555,6965,45655575,2,3646,913,1,414457400,414457400,1366,455,911,455,0,1,457,73726,0.073726
855,6555,6965,45655575,2,6846,1713,1,457721400,457721400,2566,855,1711,855,0,1,857,363947,0.363947
1255,6555,6965,45655575,2,10046,2513,1,500985400,500985400,3766,1255,2511,1255,0,1,1257,441521,0.441521
1655,6555,6965,45655575,2,13246,3313,1,544249400,544249400,4966,1655,3311,1655,0,1,1657,309445,0.309445
2055,6555,6965,45655575,2,16446,4113,1,587513400,587513400,6166,2055,4111,2055,0,1,2057,1806331,1.806331
2455,6555,6965,45655575,2,19646,4913,1,630777400,630777400,7366,2455,4911,2455,0,1,2457,543666,0.543666
2855,6555,6965,45655575,2,22846,5713,1,674041400,674041400,8566,2855,5711,2855,0,1,2857,952289,0.952289
3255,6555,6965,45655575,2,26046,6513,1,717305400,717305400,9766,3255,6511,3255,0,1,3257,664968,0.664968
3655,6555,6965,45655575,2,29246,7313,1,760569400,760569400,10966,3655,7311,3655,0,1,3657,857815,0.857815
4055,6555,6965,45655575,2,32446,8113,1,803833400,803833400,12166,4055,8111,4055,0,1,4057,729576,0.729576
4455,6555,6965,45655575,2,35646,8913,1,847097400,847097400,13366,4455,8911,4455,0,1,4457,2707616,2.707616
4855,6555,6965,45655575,2,38846,9713,1,890361400,890361400,14566,4855,9711,4855,0,1,4857,1031350,1.03135
5255,6555,6965,45655575,2,42046,10513,1,933625400,933625400,15766,5255,10511,5255,0,1,5257,454902,0.454902
5655,6555,6965,45655575,2,45246,11313,1,976889400,976889400,16966,5655,11311,5655,0,1,5657,612915,0.612915
6055,6555,6965,45655575,2,48446,12113,1,1020153400,1020153400,18166,6055,12111,6055,0,1,6057,3617624,3.617624
6455,6555,6965,45655575,2,51646,12913,1,1063417400,1063417400,19366,6455,12911,6455,0,1,6457,1436382,1.436382
6855,6555,6965,45655575,2,54846,13713,1,1106681400,1106681400,20566,6855,13711,6855,0,1,6857,2068422,2.068422
35,6600,7045,46497000,2,286,73,1,375796600,375796600,106,35,71,35,0,1,37,118960,0.11896
535,6600,7045,46497000,2,4286,1073,1,430376600,430376600,1606,535,1071,535,0,1,537,174833,0.174833
1035,6600,7045,46497000,2,8286,2073,1,484956600,484956600,3106,1035,2071,1035,0,1,1037,349390,0.34939
1535,6600,7045,46497000,2,12286,3073,1,539536600,539536600,4606,1535,3071,1535,0,1,1537,1987936,1.987936
2035,6600,7045,46497000,2,16286,4073,1,594116600,594116600,6106,2035,4071,2035,0,1,2037,325393,0.325393
2535,6600,7045,46497000,2,20286,5073,1,648696600,648696600,7606,2535,5071,2535,0,1,2537,206194,0.206194
3035,6600,7045,46497000,2,24286,6073,1,703276600,703276600,9106,3035,6071,3035,0,1,3037,4069892,4.069892
3535,6600,7045,46497000,2,28286,7073,1,757856600,757856600,10606,3535,7071,3535,0,1,3537,1711504,1.711504
4035,6600,7045,46497000,2,32286,8073,1,812436600,812436600,12106,4035,8071,4035,0,1,4037,3730940,3.73094
4535,6600,7045,46497000,2,36286,9073,1,867016600,867016600,13606,4535,9071,4535,0,1,4537,5288475,5.288475
5035,6600,7045,46497000,2,40286,10073,1,921596600,921596600,15106,5035,10071,5035,0,1,5037,2216979,2.216979
5535,6600,7045,46497000,2,44286,11073,1,976176600,976176600,16606,5535,11071,5535,0,1,5537,11809373,11.809373
6035,6600,7045,46497000,2,48286,12073,1,1030756600,1030756600,18106,6035,12071,6035,0,1,6037,9387388,9.387388
6535,6600,7045,46497000,2,52286,13073,1,1085336600,1085336600,19606,6535,13071,6535,0,1,6537,7325297,7.325297
7035,6600,7045,46497000,2,56286,14073,1,1139916600,1139916600,21106,7035,14071,7035,0,1,7037,61525318,61.525318
39,6643,7041,46773363,2,318,81,1,378456312,378456312,118,39,79,39,0,1,41,70791,0.070791
539,6643,7041,46773363,2,4318,1081,1,433192312,433192312,1618,539,1079,539,0,1,541,35867,0.035867
1039,6643,7041,46773363,2,8318,2081,1,487928312,487928312,3118,1039,2079,1039,0,1,1041,304628,0.304628
1539,6643,7041,46773363,2,12318,3081,1,542664312,542664312,4618,1539,3079,1539,0,1,1541,32314,0.032314
2039,6643,7041,46773363,2,16318,4081,1,597400312,597400312,6118,2039,4079,2039,0,1,2041,130373,0.130373
2539,6643,7041,46773363,2,20318,5081,1,652136312,652136312,7618,2539,5079,2539,0,1,2541,1501772,1.501772
3039,6643,7041,46773363,2,24318,6081,1,706872312,706872312,9118,3039,6079,3039,0,1,3041,2517832,2.517832
3539,6643,7041,46773363,2,28318,7081,1,761608312,761608312,10618,3539,7079,3539,0,1,3541,174943,0.174943
4039,6643,7041,46773363,2,32318,8081,1,816344312,816344312,12118,4039,8079,4039,0,1,4041,185001,0.185001
4539,6643,7041,46773363,2,36318,9081,1,871080312,871080312,13618,4539,9079,4539,0,1,4541,9229983,9.229983
5039,6643,7041,46773363,2,40318,10081,1,925816312,925816312,15118,5039,10079,5039,0,1,5041,1951631,1.951631
5539,6643,7041,46773363,2,44318,11081,1,980552312,980552312,16618,5539,11079,5539,0,1,5541,1523751,1.523751
6039,6643,7041,46773363,2,48318,12081,1,1035288312,1035288312,18118,6039,12079,6039,0,1,6041,12125899,12.125899
6539,6643,7041,46773363,2,52318,13081,1,1090024312,1090024312,19618,6539,13079,6539,0,1,6541,271901,0.271901
7039,6643,7041,46773363,2,56318,14081,1,1144760312,1144760312,21118,7039,14079,7039,0,1,7041,312034,0.312034
40,7050,6640,46812000,2,326,83,1,378876800,378876800,121,40,81,40,0,1,42,804462,0.804462
440,7050,6640,46812000,2,3526,883,1,422684800,422684800,1321,440,881,440,0,1,442,4250992,4.250992
840,7050,6640,46812000,2,6726,1683,1,466492800,466492800,2521,840,1681,840,0,1,842,3417197,3.417197
1240,7050,6640,46812000,2,9926,2483,1,510300800,510300800,3721,1240,2481,1240,0,1,1242,3450422,3.450422
1640,7050,6640,46812000,2,13126,3283,1,554108800,554108800,4921,1640,3281,1640,0,1,1642,7105768,7.105768
2040,7050,6640,46812000,2,16326,4083,1,597916800,597916800,6121,2040,4081,2040,0,1,2042,2103084,2.103084
2440,7050,6640,46812000,2,19526,4883,1,641724800,641724800,7321,2440,4881,2440,0,1,2442,6295759,6.295759
2840,7050,6640,46812000,2,22726,5683,1,685532800,685532800,8521,2840,5681,2840,0,1,2842,2210379,2.210379
3240,7050,6640,46812000,2,25926,6483,1,729340800,729340800,9721,3240,6481,3240,0,1,3242,22265316,22.265316
3640,7050,6640,46812000,2,29126,7283,1,773148800,773148800,10921,3640,7281,3640,0,1,3642,2337409,2.337409
4040,7050,6640,46812000,2,32326,8083,1,816956800,816956800,12121,4040,8081,4040,0,1,4042,3310961,3.310961
4440,7050,6640,46812000,2,35526,8883,1,860764800,860764800,13321,4440,8881,4440,0,1,4442,6206600,6.2066
4840,7050,6640,46812000,2,38726,9683,1,904572800,904572800,14521,4840,9681,4840,0,1,4842,35549350,35.54935
5240,7050,6640,46812000,2,41926,10483,1,948380800,948380800,15721,5240,10481,5240,0,1,5242,46782416,46.782416
5640,7050,6640,46812000,2,45126,11283,1,992188800,992188800,16921,5640,11281,5640,0,1,5642,50305955,50.305955
6040,7050,6640,46812000,2,48326,12083,1,1035996800,1035996800,18121,6040,12081,6040,0,1,6042,53935358,53.935358
6440,7050,6640,46812000,2,51526,12883,1,1079804800,1079804800,19321,6440,12881,6440,0,1,6442,57482749,57.482749
6840,7050,6640,46812000,2,54726,13683,1,1123612800,1123612800,20521,6840,13681,6840,0,1,6842,61096235,61.096235
44,6653,7055,46936915,2,358,91,1,380320536,380320536,133,44,89,44,0,1,46,57157,0.057157
544,6653,7055,46936915,2,4358,1091,1,435152536,435152536,1633,544,1089,544,0,1,546,537756,0.537756
1044,6653,7055,46936915,2,8358,2091,1,489984536,489984536,3133,1044,2089,1044,0,1,1046,678774,0.678774
1544,6653,7055,46936915,2,12358,3091,1,544816536,544816536,4633,1544,3089,1544,0,1,1546,385654,0.385654
2044,6653,7055,46936915,2,16358,4091,1,599648536,599648536,6133,2044,4089,2044,0,1,2046,2527432,2.527432
2544,6653,7055,46936915,2,20358,5091,1,654480536,654480536,7633,2544,5089,2544,0,1,2546,1248538,1.248538
3044,6653,7055,46936915,2,24358,6091,1,709312536,709312536,9133,3044,6089,3044,0,1,3046,631922,0.631922
3544,6653,7055,46936915,2,28358,7091,1,764144536,764144536,10633,3544,7089,3544,0,1,3546,2214766,2.214766
4044,6653,7055,46936915,2,32358,8091,1,818976536,818976536,12133,4044,8089,4044,0,1,4046,1585093,1.585093
4544,6653,7055,46936915,2,36358,9091,1,873808536,873808536,13633,4544,9089,4544,0,1,4546,11073045,11.073045
5044,6653,7055,46936915,2,40358,10091,1,928640536,928640536,15133,5044,10089,5044,0,1,5046,829895,0.829895
5544,6653,7055,46936915,2,44358,11091,1,983472536,983472536,16633,5544,11089,5544,0,1,5546,983999,0.983999
6044,6653,7055,46936915,2,48358,12091,1,1038304536,1038304536,18133,6044,12089,6044,0,1,6046,424901,0.424901
6544,6653,7055,46936915,2,52358,13091,1,1093136536,1093136536,19633,6544,13089,6544,0,1,6546,4525296,4.525296
7044,6653,7055,46936915,2,56358,14091,1,1147968536,1147968536,21133,7044,14089,7044,0,1,7046,4526286,4.526286
55,7055,6665,47021575,2,446,113,1,382209400,382209400,166,55,111,55,0,1,57,695729,0.695729
455,7055,6665,47021575,2,3646,913,1,426113400,426113400,1366,455,911,455,0,1,457,4480070,4.48007
855,7055,6665,47021575,2,6846,1713,1,470017400,470017400,2566,855,1711,855,0,1,857,3946854,3.946854
1255,7055,6665,47021575,2,10046,2513,1,513921400,513921400,3766,1255,2511,1255,0,1,1257,4092875,4.092875
1655,7055,6665,47021575,2,13246,3313,1,557825400,557825400,4966,1655,3311,1655,0,1,1657,1648472,1.648472
2055,7055,6665,47021575,2,16446,4113,1,601729400,601729400,6166,2055,4111,2055,0,1,2057,8899864,8.899864
2455,7055,6665,47021575,2,19646,4913,1,645633400,645633400,7366,2455,4911,2455,0,1,2457,4271509,4.271509
2855,7055,6665,47021575,2,22846,5713,1,689537400,689537400,8566,2855,5711,2855,0,1,2857,10877246,10.877246
3255,7055,6665,47021575,2,26046,6513,1,733441400,733441400,9766,3255,6511,3255,0,1,3257,3481706,3.481706
3655,7055,6665,47021575,2,29246,7313,1,777345400,777345400,10966,3655,7311,3655,0,1,3657,1754172,1.754172
4055,7055,6665,47021575,2,32446,8113,1,821249400,821249400,12166,4055,8111,4055,0,1,4057,9554290,9.55429
4455,7055,6665,47021575,2,35646,8913,1,865153400,865153400,13366,4455,8911,4455,0,1,4457,22365903,22.365903
4855,7055,6665,47021575,2,38846,9713,1,909057400,909057400,14566,4855,9711,4855,0,1,4857,11086189,11.086189
5255,7055,6665,47021575,2,42046,10513,1,952961400,952961400,15766,5255,10511,5255,0,1,5257,9579250,9.57925
5655,7055,6665,47021575,2,45246,11313,1,996865400,996865400,16966,5655,11311,5655,0,1,5657,52021230,52.02123
6055,7055,6665,47021575,2,48446,12113,1,1040769400,1040769400,18166,6055,12111,6055,0,1,6057,55838318,55.838318
6455,7055,6665,47021575,2,51646,12913,1,1084673400,1084673400,19366,6455,12911,6455,0,1,6457,59705200,59.7052
6855,7055,6665,47021575,2,54846,13713,1,1128577400,1128577400,20566,6855,13711,6855,0,1,6857,63288768,63.288768
40,6800,6940,47192000,2,326,83,1,381932800,381932800,121,40,81,40,0,1,42,836359,0.836359
440,6800,6940,47192000,2,3526,883,1,425900800,425900800,1321,440,881,440,0,1,442,4058830,4.05883
840,6800,6940,47192000,2,6726,1683,1,469868800,469868800,2521,840,1681,840,0,1,842,673142,0.673142
1240,6800,6940,47192000,2,9926,2483,1,513836800,513836800,3721,1240,2481,1240,0,1,1242,3284062,3.284062
1640,6800,6940,47192000,2,13126,3283,1,557804800,557804800,4921,1640,3281,1640,0,1,1642,2756379,2.756379
2040,6800,6940,47192000,2,16326,4083,1,601772800,601772800,6121,2040,4081,2040,0,1,2042,2280850,2.28085
2440,6800,6940,47192000,2,19526,4883,1,645740800,645740800,7321,2440,4881,2440,0,1,2442,2739239,2.739239
2840,6800,6940,47192000,2,22726,5683,1,689708800,689708800,8521,2840,5681,2840,0,1,2842,3518488,3.518488
3240,6800,6940,47192000,2,25926,6483,1,733676800,733676800,9721,3240,6481,3240,0,1,3242,2101732,2.101732
3640,6800,6940,47192000,2,29126,7283,1,777644800,777644800,10921,3640,7281,3640,0,1,3642,338758,0.338758
4040,6800,6940,47192000,2,32326,8083,1,821612800,821612800,12121,4040,8081,4040,0,1,4042,2932957,2.932957
4440,6800,6940,47192000,2,35526,8883,1,865580800,865580800,13321,4440,8881,4440,0,1,4442,5512553,5.512553
4840,6800,6940,47192000,2,38726,9683,1,909548800,909548800,14521,4840,9681,4840,0,1,4842,5340485,5.340485
5240,6800,6940,47192000,2,41926,10483,1,953516800,953516800,15721,5240,10481,5240,0,1,5242,185055,0.185055
5640,6800,6940,47192000,2,45126,11283,1,997484800,997484800,16921,5640,11281,5640,0,1,5642,3035310,3.03531
6040,6800,6940,47192000,2,48326,12083,1,1041452800,1041452800,18121,6040,12081,6040,0,1,6042,245540,0.24554
6440,6800,6940,47192000,2,51526,12883,1,1085420800,1085420800,19321,6440,12881,6440,0,1,6442,1841549,1.841549
6840,6800,6940,47192000,2,54726,13683,1,1129388800,1129388800,20521,6840,13681,6840,0,1,6842,6490623,6.490623
55,6805,6965,47396825,2,446,113,1,385233400,385233400,166,55,111,55,0,1,57,852272,0.852272
455,6805,6965,47396825,2,3646,913,1,429297400,429297400,1366,455,911,455,0,1,457,989351,0.989351
855,6805,6965,47396825,2,6846,1713,1,473361400,473361400,2566,855,1711,855,0,1,857,1284260,1.28426
1255,6805,6965,47396825,2,10046,2513,1,517425400,517425400,3766,1255,2511,1255,0,1,1257,739704,0.739704
1655,6805,6965,47396825,2,13246,3313,1,561489400,561489400,4966,1655,3311,1655,0,1,1657,2874896,2.874896
2055,6805,6965,47396825,2,16446,4113,1,605553400,605553400,6166,2055,4111,2055,0,1,2057,1473631,1.473631
2455,6805,6965,47396825,2,19646,4913,1,649617400,649617400,7366,2455,4911,2455,0,1,2457,52428,0.052428
2855,6805,6965,47396825,2,22846,5713,1,693681400,693681400,8566,2855,5711,2855,0,1,2857,140947,0.140947
3255,6805,6965,47396825,2,26046,6513,1,737745400,737745400,9766,3255,6511,3255,0,1,3257,912814,0.912814
3655,6805,6965,47396825,2,29246,7313,1,781809400,781809400,10966,3655,7311,3655,0,1,3657,1725169,1.725169
4055,6805,6965,47396825,2,32446,8113,1,825873400,825873400,12166,4055,8111,4055,0,1,4057,607484,0.607484
4455,6805,6965,47396825,2,35646,8913,1,869937400,869937400,13366,4455,8911,4455,0,1,4457,2540422,2.540422
4855,6805,6965,47396825,2,38846,9713,1,914001400,914001400,14566,4855,9711,4855,0,1,4857,2547142,2.547142
5255,6805,6965,47396825,2,42046,10513,1,958065400,958065400,15766,5255,10511,5255,0,1,5257,204605,0.204605
5655,6805,6965,47396825,2,45246,11313,1,1002129400,1002129400,16966,5655,11311,5655,0,1,5657,1492262,1.492262
6055,6805,6965,47396825,2,48446,12113,1,1046193400,1046193400,18166,6055,12111,6055,0,1,6057,3384240,3.38424
6455,6805,6965,47396825,2,51646,12913,1,1090257400,1090257400,19366,6455,12911,6455,0,1,6457,1703858,1.703858
6855,6805,6965,47396825,2,54846,13713,1,1134321400,1134321400,20566,6855,13711,6855,0,1,6857,4855284,4.855284
40,7050,6940,48927000,2,326,83,1,395892800,395892800,121,40,81,40,0,1,42,862483,0.862483
440,7050,6940,48927000,2,3526,883,1,440660800,440660800,1321,440,881,440,0,1,442,510283,0.510283
840,7050,6940,48927000,2,6726,1683,1,485428800,485428800,2521,840,1681,840,0,1,842,2328927,2.328927
1240,7050,6940,48927000,2,9926,2483,1,530196800,530196800,3721,1240,2481,1240,0,1,1242,52112,0.052112
1640,7050,6940,48927000,2,13126,3283,1,574964800,574964800,4921,1640,3281,1640,0,1,1642,3847479,3.847479
2040,7050,6940,48927000,2,16326,4083,1,619732800,619732800,6121,2040,4081,2040,0,1,2042,357894,0.357894
2440,7050,6940,48927000,2,19526,4883,1,664500800,664500800,7321,2440,4881,2440,0,1,2442,4764261,4.764261
2840,7050,6940,48927000,2,22726,5683,1,709268800,709268800,8521,2840,5681,2840,0,1,2842,3531543,3.531543
3240,7050,6940,48927000,2,25926,6483,1,754036800,754036800,9721,3240,6481,3240,0,1,3242,3110158,3.110158
3640,7050,6940,48927000,2,29126,7283,1,798804800,798804800,10921,3640,7281,3640,0,1,3642,1208874,1.208874
4040,7050,6940,48927000,2,32326,8083,1,843572800,843572800,12121,4040,8081,4040,0,1,4042,1040699,1.040699
4440,7050,6940,48927000,2,35526,8883,1,888340800,888340800,13321,4440,8881,4440,0,1,4442,9928822,9.928822
4840,7050,6940,48927000,2,38726,9683,1,933108800,933108800,14521,4840,9681,4840,0,1,4842,5852588,5.852588
5240,7050,6940,48927000,2,41926,10483,1,977876800,977876800,15721,5240,10481,5240,0,1,5242,49982612,49.982612
5640,7050,6940,48927000,2,45126,11283,1,1022644800,1022644800,16921,5640,11281,5640,0,1,5642,53829447,53.829447
6040,7050,6940,48927000,2,48326,12083,1,1067412800,1067412800,18121,6040,12081,6040,0,1,6042,57691772,57.691772
6440,7050,6940,48927000,2,51526,12883,1,1112180800,1112180800,19321,6440,12881,6440,0,1,6442,61496362,61.496362
6840,7050,6940,48927000,2,54726,13683,1,1156948800,1156948800,20521,6840,13681,6840,0,1,6842,65347164,65.347164
55,7055,6965,49138075,2,446,113,1,399273400,399273400,166,55,111,55,0,1,57,991619,0.991619
455,7055,6965,49138075,2,3646,913,1,444137400,444137400,1366,455,911,455,0,1,457,1905223,1.905223
855,7055,6965,49138075,2,6846,1713,1,489001400,489001400,2566,855,1711,855,0,1,857,2352897,2.352897
1255,7055,6965,49138075,2,10046,2513,1,533865400,533865400,3766,1255,2511,1255,0,1,1257,439141,0.439141
1655,7055,6965,49138075,2,13246,3313,1,578729400,578729400,4966,1655,3311,1655,0,1,1657,4584272,4.584272
2055,7055,6965,49138075,2,16446,4113,1,623593400,623593400,6166,2055,4111,2055,0,1,2057,9046862,9.046862
2455,7055,6965,49138075,2,19646,4913,1,668457400,668457400,7366,2455,4911,2455,0,1,2457,674072,0.674072
2855,7055,6965,49138075,2,22846,5713,1,713321400,713321400,8566,2855,5711,2855,0,1,2857,16188754,16.188754
3255,7055,6965,49138075,2,26046,6513,1,758185400,758185400,9766,3255,6511,3255,0,1,3257,2887854,2.887854
3655,7055,6965,49138075,2,29246,7313,1,803049400,803049400,10966,3655,7311,3655,0,1,3657,11788139,11.788139
4055,7055,6965,49138075,2,32446,8113,1,847913400,847913400,12166,4055,8111,4055,0,1,4057,7670759,7.670759
4455,7055,6965,49138075,2,35646,8913,1,892777400,892777400,13366,4455,8911,4455,0,1,4457,3499676,3.499676
4855,7055,6965,49138075,2,38846,9713,1,937641400,937641400,14566,4855,9711,4855,0,1,4857,21996012,21.996012
5255,7055,6965,49138075,2,42046,10513,1,982505400,982505400,15766,5255,10511,5255,0,1,5257,12379279,12.379279
5655,7055,6965,49138075,2,45246,11313,1,1027369400,1027369400,16966,5655,11311,5655,0,1,5657,54492175,54.492175
6055,7055,6965,49138075,2,48446,12113,1,1072233400,1072233400,18166,6055,12111,6055,0,1,6057,58643083,58.643083
6455,7055,6965,49138075,2,51646,12913,1,1117097400,1117097400,19366,6455,12911,6455,0,1,6457,62430271,62.430271
6855,7055,6965,49138075,2,54846,13713,1,1161961400,1161961400,20566,6855,13711,6855,0,1,6857,66299116,66.299116
