N,O,M,Iter,VarDecl,refExpr,intLiteral,floatLiteral,mem_to,mem_from,add_sub_int,add_sub_double,mul_int,mul_double,div_double,assign_int,assign_double,runtime1,runtime
7100,7100,500,50410000,2,4006,1003,1,460080000,460080000,1501,500,1001,500,0,1,502,5256127,5.256127
7100,7100,500,50410000,2,4006,1003,1,460080000,460080000,1501,500,1001,500,0,1,502,5293332,5.293332
7100,7100,500,50410000,2,4006,1003,1,460080000,460080000,1501,500,1001,500,0,1,502,5256499,5.256499
7100,7100,500,50410000,2,4006,1003,1,460080000,460080000,1501,500,1001,500,0,1,502,5360473,5.360473
7100,7100,500,50410000,2,4006,1003,1,460080000,460080000,1501,500,1001,500,0,1,502,5255730,5.25573
7100,7100,500,50410000,2,4006,1003,1,460080000,460080000,1501,500,1001,500,0,1,502,5219991,5.219991
7100,7100,500,50410000,2,4006,1003,1,460080000,460080000,1501,500,1001,500,0,1,502,5291119,5.291119
7100,7100,900,50410000,2,7206,1803,1,505520000,505520000,2701,900,1801,900,0,1,902,8814136,8.814136
7100,7100,900,50410000,2,7206,1803,1,505520000,505520000,2701,900,1801,900,0,1,902,9145517,9.145517
7100,7100,900,50410000,2,7206,1803,1,505520000,505520000,2701,900,1801,900,0,1,902,8847971,8.847971
7100,7100,900,50410000,2,7206,1803,1,505520000,505520000,2701,900,1801,900,0,1,902,9185777,9.185777
7100,7100,900,50410000,2,7206,1803,1,505520000,505520000,2701,900,1801,900,0,1,902,8633594,8.633594
7100,7100,900,50410000,2,7206,1803,1,505520000,505520000,2701,900,1801,900,0,1,902,8671563,8.671563
7100,7100,900,50410000,2,7206,1803,1,505520000,505520000,2701,900,1801,900,0,1,902,8965490,8.96549
7100,7100,1300,50410000,2,10406,2603,1,550960000,550960000,3901,1300,2601,1300,0,1,1302,12316097,12.316097
7100,7100,1300,50410000,2,10406,2603,1,550960000,550960000,3901,1300,2601,1300,0,1,1302,12872327,12.872327
7100,7100,1300,50410000,2,10406,2603,1,550960000,550960000,3901,1300,2601,1300,0,1,1302,12369723,12.369723
7100,7100,1300,50410000,2,10406,2603,1,550960000,550960000,3901,1300,2601,1300,0,1,1302,12971290,12.97129
7100,7100,1300,50410000,2,10406,2603,1,550960000,550960000,3901,1300,2601,1300,0,1,1302,12440669,12.440669
7100,7100,1300,50410000,2,10406,2603,1,550960000,550960000,3901,1300,2601,1300,0,1,1302,12505893,12.505893
7100,7100,1300,50410000,2,10406,2603,1,550960000,550960000,3901,1300,2601,1300,0,1,1302,12907352,12.907352
7100,7100,1700,50410000,2,13606,3403,1,596400000,596400000,5101,1700,3401,1700,0,1,1702,16106022,16.106022
7100,7100,1700,50410000,2,13606,3403,1,596400000,596400000,5101,1700,3401,1700,0,1,1702,16875096,16.875096
7100,7100,1700,50410000,2,13606,3403,1,596400000,596400000,5101,1700,3401,1700,0,1,1702,16205601,16.205601
7100,7100,1700,50410000,2,13606,3403,1,596400000,596400000,5101,1700,3401,1700,0,1,1702,16928065,16.928065
7100,7100,1700,50410000,2,13606,3403,1,596400000,596400000,5101,1700,3401,1700,0,1,1702,16238404,16.238404
7100,7100,1700,50410000,2,13606,3403,1,596400000,596400000,5101,1700,3401,1700,0,1,1702,16161844,16.161844
7100,7100,1700,50410000,2,13606,3403,1,596400000,596400000,5101,1700,3401,1700,0,1,1702,16665361,16.665361
7100,7100,2100,50410000,2,16806,4203,1,641840000,641840000,6301,2100,4201,2100,0,1,2102,19801089,19.801089
7100,7100,2100,50410000,2,16806,4203,1,641840000,641840000,6301,2100,4201,2100,0,1,2102,20689936,20.689936
7100,7100,2100,50410000,2,16806,4203,1,641840000,641840000,6301,2100,4201,2100,0,1,2102,19924446,19.924446
7100,7100,2100,50410000,2,16806,4203,1,641840000,641840000,6301,2100,4201,2100,0,1,2102,20817679,20.817679
7100,7100,2100,50410000,2,16806,4203,1,641840000,641840000,6301,2100,4201,2100,0,1,2102,19959180,19.95918
7100,7100,2100,50410000,2,16806,4203,1,641840000,641840000,6301,2100,4201,2100,0,1,2102,19890510,19.89051
7100,7100,2100,50410000,2,16806,4203,1,641840000,641840000,6301,2100,4201,2100,0,1,2102,20547574,20.547574
7100,7100,2500,50410000,2,20006,5003,1,687280000,687280000,7501,2500,5001,2500,0,1,2502,23419946,23.419946
7100,7100,2500,50410000,2,20006,5003,1,687280000,687280000,7501,2500,5001,2500,0,1,2502,24515286,24.515286
7100,7100,2500,50410000,2,20006,5003,1,687280000,687280000,7501,2500,5001,2500,0,1,2502,23520009,23.520009
7100,7100,2500,50410000,2,20006,5003,1,687280000,687280000,7501,2500,5001,2500,0,1,2502,24675544,24.675544
7100,7100,2500,50410000,2,20006,5003,1,687280000,687280000,7501,2500,5001,2500,0,1,2502,23643713,23.643713
7100,7100,2500,50410000,2,20006,5003,1,687280000,687280000,7501,2500,5001,2500,0,1,2502,23608764,23.608764
7100,7100,2500,50410000,2,20006,5003,1,687280000,687280000,7501,2500,5001,2500,0,1,2502,24328993,24.328993
7100,7100,2900,50410000,2,23206,5803,1,732720000,732720000,8701,2900,5801,2900,0,1,2902,27077934,27.077934
7100,7100,2900,50410000,2,23206,5803,1,732720000,732720000,8701,2900,5801,2900,0,1,2902,28423329,28.423329
7100,7100,2900,50410000,2,23206,5803,1,732720000,732720000,8701,2900,5801,2900,0,1,2902,27212337,27.212337
7100,7100,2900,50410000,2,23206,5803,1,732720000,732720000,8701,2900,5801,2900,0,1,2902,28534808,28.534808
7100,7100,2900,50410000,2,23206,5803,1,732720000,732720000,8701,2900,5801,2900,0,1,2902,27342724,27.342724
7100,7100,2900,50410000,2,23206,5803,1,732720000,732720000,8701,2900,5801,2900,0,1,2902,27307996,27.307996
7100,7100,2900,50410000,2,23206,5803,1,732720000,732720000,8701,2900,5801,2900,0,1,2902,28174742,28.174742
7100,7100,3300,50410000,2,26406,6603,1,778160000,778160000,9901,3300,6601,3300,0,1,3302,30772641,30.772641
7100,7100,3300,50410000,2,26406,6603,1,778160000,778160000,9901,3300,6601,3300,0,1,3302,32318177,32.318177
7100,7100,3300,50410000,2,26406,6603,1,778160000,778160000,9901,3300,6601,3300,0,1,3302,30893413,30.893413
7100,7100,3300,50410000,2,26406,6603,1,778160000,778160000,9901,3300,6601,3300,0,1,3302,32436529,32.436529
7100,7100,3300,50410000,2,26406,6603,1,778160000,778160000,9901,3300,6601,3300,0,1,3302,31058232,31.058232
7100,7100,3300,50410000,2,26406,6603,1,778160000,778160000,9901,3300,6601,3300,0,1,3302,31022862,31.022862
7100,7100,3300,50410000,2,26406,6603,1,778160000,778160000,9901,3300,6601,3300,0,1,3302,31997005,31.997005
7100,7100,3700,50410000,2,29606,7403,1,823600000,823600000,11101,3700,7401,3700,0,1,3702,34488705,34.488705
7100,7100,3700,50410000,2,29606,7403,1,823600000,823600000,11101,3700,7401,3700,0,1,3702,36338746,36.338746
7100,7100,3700,50410000,2,29606,7403,1,823600000,823600000,11101,3700,7401,3700,0,1,3702,34620691,34.620691
7100,7100,3700,50410000,2,29606,7403,1,823600000,823600000,11101,3700,7401,3700,0,1,3702,36393027,36.393027
7100,7100,3700,50410000,2,29606,7403,1,823600000,823600000,11101,3700,7401,3700,0,1,3702,34792509,34.792509
7100,7100,3700,50410000,2,29606,7403,1,823600000,823600000,11101,3700,7401,3700,0,1,3702,34757708,34.757708
7100,7100,3700,50410000,2,29606,7403,1,823600000,823600000,11101,3700,7401,3700,0,1,3702,35855285,35.855285
7100,7100,4100,50410000,2,32806,8203,1,869040000,869040000,12301,4100,8201,4100,0,1,4102,38227356,38.227356
7100,7100,4100,50410000,2,32806,8203,1,869040000,869040000,12301,4100,8201,4100,0,1,4102,39989847,39.989847
7100,7100,4100,50410000,2,32806,8203,1,869040000,869040000,12301,4100,8201,4100,0,1,4102,38260988,38.260988
7100,7100,4100,50410000,2,32806,8203,1,869040000,869040000,12301,4100,8201,4100,0,1,4102,40184845,40.184845
7100,7100,4100,50410000,2,32806,8203,1,869040000,869040000,12301,4100,8201,4100,0,1,4102,38320967,38.320967
7100,7100,4100,50410000,2,32806,8203,1,869040000,869040000,12301,4100,8201,4100,0,1,4102,38375043,38.375043
7100,7100,4100,50410000,2,32806,8203,1,869040000,869040000,12301,4100,8201,4100,0,1,4102,39577290,39.57729
7100,7100,4500,50410000,2,36006,9003,1,914480000,914480000,13501,4500,9001,4500,0,1,4502,41789900,41.7899
7100,7100,4500,50410000,2,36006,9003,1,914480000,914480000,13501,4500,9001,4500,0,1,4502,44016265,44.016265
7100,7100,4500,50410000,2,36006,9003,1,914480000,914480000,13501,4500,9001,4500,0,1,4502,41996866,41.996866
7100,7100,4500,50410000,2,36006,9003,1,914480000,914480000,13501,4500,9001,4500,0,1,4502,44272093,44.272093
7100,7100,4500,50410000,2,36006,9003,1,914480000,914480000,13501,4500,9001,4500,0,1,4502,42032291,42.032291
7100,7100,4500,50410000,2,36006,9003,1,914480000,914480000,13501,4500,9001,4500,0,1,4502,41941340,41.94134
7100,7100,4500,50410000,2,36006,9003,1,914480000,914480000,13501,4500,9001,4500,0,1,4502,43423332,43.423332
7100,7100,4900,50410000,2,39206,9803,1,959920000,959920000,14701,4900,9801,4900,0,1,4902,45610862,45.610862
7100,7100,4900,50410000,2,39206,9803,1,959920000,959920000,14701,4900,9801,4900,0,1,4902,47801079,47.801079
7100,7100,4900,50410000,2,39206,9803,1,959920000,959920000,14701,4900,9801,4900,0,1,4902,45802595,45.802595
7100,7100,4900,50410000,2,39206,9803,1,959920000,959920000,14701,4900,9801,4900,0,1,4902,48104766,48.104766
7100,7100,4900,50410000,2,39206,9803,1,959920000,959920000,14701,4900,9801,4900,0,1,4902,45768626,45.768626
7100,7100,4900,50410000,2,39206,9803,1,959920000,959920000,14701,4900,9801,4900,0,1,4902,45669751,45.669751
7100,7100,4900,50410000,2,39206,9803,1,959920000,959920000,14701,4900,9801,4900,0,1,4902,47307340,47.30734
7100,7100,5300,50410000,2,42406,10603,1,1005360000,1005360000,15901,5300,10601,5300,0,1,5302,49354518,49.354518
7100,7100,5300,50410000,2,42406,10603,1,1005360000,1005360000,15901,5300,10601,5300,0,1,5302,51909956,51.909956
7100,7100,5300,50410000,2,42406,10603,1,1005360000,1005360000,15901,5300,10601,5300,0,1,5302,49667480,49.66748
7100,7100,5300,50410000,2,42406,10603,1,1005360000,1005360000,15901,5300,10601,5300,0,1,5302,52100168,52.100168
7100,7100,5300,50410000,2,42406,10603,1,1005360000,1005360000,15901,5300,10601,5300,0,1,5302,49461794,49.461794
7100,7100,5300,50410000,2,42406,10603,1,1005360000,1005360000,15901,5300,10601,5300,0,1,5302,49496130,49.49613
7100,7100,5300,50410000,2,42406,10603,1,1005360000,1005360000,15901,5300,10601,5300,0,1,5302,51242419,51.242419
7100,7100,5700,50410000,2,45606,11403,1,1050800000,1050800000,17101,5700,11401,5700,0,1,5702,52973544,52.973544
7100,7100,5700,50410000,2,45606,11403,1,1050800000,1050800000,17101,5700,11401,5700,0,1,5702,55932846,55.932846
7100,7100,5700,50410000,2,45606,11403,1,1050800000,1050800000,17101,5700,11401,5700,0,1,5702,53316924,53.316924
7100,7100,5700,50410000,2,45606,11403,1,1050800000,1050800000,17101,5700,11401,5700,0,1,5702,55929533,55.929533
7100,7100,5700,50410000,2,45606,11403,1,1050800000,1050800000,17101,5700,11401,5700,0,1,5702,53160055,53.160055
7100,7100,5700,50410000,2,45606,11403,1,1050800000,1050800000,17101,5700,11401,5700,0,1,5702,53221772,53.221772
7100,7100,5700,50410000,2,45606,11403,1,1050800000,1050800000,17101,5700,11401,5700,0,1,5702,55111823,55.111823
7100,7100,6100,50410000,2,48806,12203,1,1096240000,1096240000,18301,6100,12201,6100,0,1,6102,56695957,56.695957
7100,7100,6100,50410000,2,48806,12203,1,1096240000,1096240000,18301,6100,12201,6100,0,1,6102,59845713,59.845713
7100,7100,6100,50410000,2,48806,12203,1,1096240000,1096240000,18301,6100,12201,6100,0,1,6102,57068970,57.06897
7100,7100,6100,50410000,2,48806,12203,1,1096240000,1096240000,18301,6100,12201,6100,0,1,6102,59782292,59.782292
7100,7100,6100,50410000,2,48806,12203,1,1096240000,1096240000,18301,6100,12201,6100,0,1,6102,56968316,56.968316
7100,7100,6100,50410000,2,48806,12203,1,1096240000,1096240000,18301,6100,12201,6100,0,1,6102,56904183,56.904183
7100,7100,6100,50410000,2,48806,12203,1,1096240000,1096240000,18301,6100,12201,6100,0,1,6102,58866576,58.866576
7100,7100,6500,50410000,2,52006,13003,1,1141680000,1141680000,19501,6500,13001,6500,0,1,6502,60711898,60.711898
7100,7100,6500,50410000,2,52006,13003,1,1141680000,1141680000,19501,6500,13001,6500,0,1,6502,63754810,63.75481
7100,7100,6500,50410000,2,52006,13003,1,1141680000,1141680000,19501,6500,13001,6500,0,1,6502,60809967,60.809967
7100,7100,6500,50410000,2,52006,13003,1,1141680000,1141680000,19501,6500,13001,6500,0,1,6502,63683771,63.683771
7100,7100,6500,50410000,2,52006,13003,1,1141680000,1141680000,19501,6500,13001,6500,0,1,6502,60674253,60.674253
7100,7100,6500,50410000,2,52006,13003,1,1141680000,1141680000,19501,6500,13001,6500,0,1,6502,60709554,60.709554
7100,7100,6500,50410000,2,52006,13003,1,1141680000,1141680000,19501,6500,13001,6500,0,1,6502,62835317,62.835317
7100,7100,6900,50410000,2,55206,13803,1,1187120000,1187120000,20701,6900,13801,6900,0,1,6902,64186912,64.186912
7100,7100,6900,50410000,2,55206,13803,1,1187120000,1187120000,20701,6900,13801,6900,0,1,6902,67860396,67.860396
7100,7100,6900,50410000,2,55206,13803,1,1187120000,1187120000,20701,6900,13801,6900,0,1,6902,64534417,64.534417
7100,7100,6900,50410000,2,55206,13803,1,1187120000,1187120000,20701,6900,13801,6900,0,1,6902,67736717,67.736717
7100,7100,6900,50410000,2,55206,13803,1,1187120000,1187120000,20701,6900,13801,6900,0,1,6902,64331140,64.33114
7100,7100,6900,50410000,2,55206,13803,1,1187120000,1187120000,20701,6900,13801,6900,0,1,6902,64222322,64.222322
7100,7100,6900,50410000,2,55206,13803,1,1187120000,1187120000,20701,6900,13801,6900,0,1,6902,66605086,66.605086
7100,6700,500,47570000,2,4006,1003,1,435760000,435760000,1501,500,1001,500,0,1,502,4898819,4.898819
7100,6700,500,47570000,2,4006,1003,1,435760000,435760000,1501,500,1001,500,0,1,502,5153110,5.15311
7100,6700,500,47570000,2,4006,1003,1,435760000,435760000,1501,500,1001,500,0,1,502,4865425,4.865425
7100,6700,500,47570000,2,4006,1003,1,435760000,435760000,1501,500,1001,500,0,1,502,5186988,5.186988
7100,6700,500,47570000,2,4006,1003,1,435760000,435760000,1501,500,1001,500,0,1,502,4897630,4.89763
7100,6700,500,47570000,2,4006,1003,1,435760000,435760000,1501,500,1001,500,0,1,502,4934051,4.934051
7100,6700,500,47570000,2,4006,1003,1,435760000,435760000,1501,500,1001,500,0,1,502,5068397,5.068397
7100,6700,900,47570000,2,7206,1803,1,479920000,479920000,2701,900,1801,900,0,1,902,8380295,8.380295
7100,6700,900,47570000,2,7206,1803,1,479920000,479920000,2701,900,1801,900,0,1,902,8675917,8.675917
7100,6700,900,47570000,2,7206,1803,1,479920000,479920000,2701,900,1801,900,0,1,902,8309570,8.30957
7100,6700,900,47570000,2,7206,1803,1,479920000,479920000,2701,900,1801,900,0,1,902,8769905,8.769905
7100,6700,900,47570000,2,7206,1803,1,479920000,479920000,2701,900,1801,900,0,1,902,8348336,8.348336
7100,6700,900,47570000,2,7206,1803,1,479920000,479920000,2701,900,1801,900,0,1,902,8380954,8.380954
7100,6700,900,47570000,2,7206,1803,1,479920000,479920000,2701,900,1801,900,0,1,902,8627278,8.627278
7100,6700,1300,47570000,2,10406,2603,1,524080000,524080000,3901,1300,2601,1300,0,1,1302,11621426,11.621426
7100,6700,1300,47570000,2,10406,2603,1,524080000,524080000,3901,1300,2601,1300,0,1,1302,12209150,12.20915
7100,6700,1300,47570000,2,10406,2603,1,524080000,524080000,3901,1300,2601,1300,0,1,1302,11653405,11.653405
7100,6700,1300,47570000,2,10406,2603,1,524080000,524080000,3901,1300,2601,1300,0,1,1302,12307873,12.307873
7100,6700,1300,47570000,2,10406,2603,1,524080000,524080000,3901,1300,2601,1300,0,1,1302,11723633,11.723633
7100,6700,1300,47570000,2,10406,2603,1,524080000,524080000,3901,1300,2601,1300,0,1,1302,11685326,11.685326
7100,6700,1300,47570000,2,10406,2603,1,524080000,524080000,3901,1300,2601,1300,0,1,1302,12075621,12.075621
7100,6700,1700,47570000,2,13606,3403,1,568240000,568240000,5101,1700,3401,1700,0,1,1702,15215551,15.215551
7100,6700,1700,47570000,2,13606,3403,1,568240000,568240000,5101,1700,3401,1700,0,1,1702,15944095,15.944095
7100,6700,1700,47570000,2,13606,3403,1,568240000,568240000,5101,1700,3401,1700,0,1,1702,15175106,15.175106
7100,6700,1700,47570000,2,13606,3403,1,568240000,568240000,5101,1700,3401,1700,0,1,1702,15983429,15.983429
7100,6700,1700,47570000,2,13606,3403,1,568240000,568240000,5101,1700,3401,1700,0,1,1702,15296258,15.296258
7100,6700,1700,47570000,2,13606,3403,1,568240000,568240000,5101,1700,3401,1700,0,1,1702,15247438,15.247438
7100,6700,1700,47570000,2,13606,3403,1,568240000,568240000,5101,1700,3401,1700,0,1,1702,15753055,15.753055
7100,6700,2100,47570000,2,16806,4203,1,612400000,612400000,6301,2100,4201,2100,0,1,2102,18703317,18.703317
7100,6700,2100,47570000,2,16806,4203,1,612400000,612400000,6301,2100,4201,2100,0,1,2102,19553529,19.553529
7100,6700,2100,47570000,2,16806,4203,1,612400000,612400000,6301,2100,4201,2100,0,1,2102,18669706,18.669706
7100,6700,2100,47570000,2,16806,4203,1,612400000,612400000,6301,2100,4201,2100,0,1,2102,19628064,19.628064
7100,6700,2100,47570000,2,16806,4203,1,612400000,612400000,6301,2100,4201,2100,0,1,2102,18737496,18.737496
7100,6700,2100,47570000,2,16806,4203,1,612400000,612400000,6301,2100,4201,2100,0,1,2102,18704792,18.704792
7100,6700,2100,47570000,2,16806,4203,1,612400000,612400000,6301,2100,4201,2100,0,1,2102,19356305,19.356305
7100,6700,2500,47570000,2,20006,5003,1,656560000,656560000,7501,2500,5001,2500,0,1,2502,22119500,22.1195
7100,6700,2500,47570000,2,20006,5003,1,656560000,656560000,7501,2500,5001,2500,0,1,2502,23212185,23.212185
7100,6700,2500,47570000,2,20006,5003,1,656560000,656560000,7501,2500,5001,2500,0,1,2502,22152204,22.152204
7100,6700,2500,47570000,2,20006,5003,1,656560000,656560000,7501,2500,5001,2500,0,1,2502,23266955,23.266955
7100,6700,2500,47570000,2,20006,5003,1,656560000,656560000,7501,2500,5001,2500,0,1,2502,22186665,22.186665
7100,6700,2500,47570000,2,20006,5003,1,656560000,656560000,7501,2500,5001,2500,0,1,2502,22184199,22.184199
7100,6700,2500,47570000,2,20006,5003,1,656560000,656560000,7501,2500,5001,2500,0,1,2502,22890398,22.890398
7100,6700,2900,47570000,2,23206,5803,1,700720000,700720000,8701,2900,5801,2900,0,1,2902,25558980,25.55898
7100,6700,2900,47570000,2,23206,5803,1,700720000,700720000,8701,2900,5801,2900,0,1,2902,26916615,26.916615
7100,6700,2900,47570000,2,23206,5803,1,700720000,700720000,8701,2900,5801,2900,0,1,2902,25607920,25.60792
7100,6700,2900,47570000,2,23206,5803,1,700720000,700720000,8701,2900,5801,2900,0,1,2902,26950887,26.950887
7100,6700,2900,47570000,2,23206,5803,1,700720000,700720000,8701,2900,5801,2900,0,1,2902,25673496,25.673496
7100,6700,2900,47570000,2,23206,5803,1,700720000,700720000,8701,2900,5801,2900,0,1,2902,25639914,25.639914
7100,6700,2900,47570000,2,23206,5803,1,700720000,700720000,8701,2900,5801,2900,0,1,2902,26487259,26.487259
7100,6700,3300,47570000,2,26406,6603,1,744880000,744880000,9901,3300,6601,3300,0,1,3302,29050960,29.05096
7100,6700,3300,47570000,2,26406,6603,1,744880000,744880000,9901,3300,6601,3300,0,1,3302,30565734,30.565734
7100,6700,3300,47570000,2,26406,6603,1,744880000,744880000,9901,3300,6601,3300,0,1,3302,29101027,29.101027
7100,6700,3300,47570000,2,26406,6603,1,744880000,744880000,9901,3300,6601,3300,0,1,3302,30684901,30.684901
7100,6700,3300,47570000,2,26406,6603,1,744880000,744880000,9901,3300,6601,3300,0,1,3302,29135235,29.135235
7100,6700,3300,47570000,2,26406,6603,1,744880000,744880000,9901,3300,6601,3300,0,1,3302,29133273,29.133273
7100,6700,3300,47570000,2,26406,6603,1,744880000,744880000,9901,3300,6601,3300,0,1,3302,30109429,30.109429
7100,6700,3700,47570000,2,29606,7403,1,789040000,789040000,11101,3700,7401,3700,0,1,3702,32530888,32.530888
7100,6700,3700,47570000,2,29606,7403,1,789040000,789040000,11101,3700,7401,3700,0,1,3702,34256757,34.256757
7100,6700,3700,47570000,2,29606,7403,1,789040000,789040000,11101,3700,7401,3700,0,1,3702,32563054,32.563054
7100,6700,3700,47570000,2,29606,7403,1,789040000,789040000,11101,3700,7401,3700,0,1,3702,34384185,34.384185
7100,6700,3700,47570000,2,29606,7403,1,789040000,789040000,11101,3700,7401,3700,0,1,3702,32652419,32.652419
7100,6700,3700,47570000,2,29606,7403,1,789040000,789040000,11101,3700,7401,3700,0,1,3702,32685396,32.685396
7100,6700,3700,47570000,2,29606,7403,1,789040000,789040000,11101,3700,7401,3700,0,1,3702,33753525,33.753525
7100,6700,4100,47570000,2,32806,8203,1,833200000,833200000,12301,4100,8201,4100,0,1,4102,36018468,36.018468
7100,6700,4100,47570000,2,32806,8203,1,833200000,833200000,12301,4100,8201,4100,0,1,4102,37837938,37.837938
7100,6700,4100,47570000,2,32806,8203,1,833200000,833200000,12301,4100,8201,4100,0,1,4102,36217657,36.217657
7100,6700,4100,47570000,2,32806,8203,1,833200000,833200000,12301,4100,8201,4100,0,1,4102,38015709,38.015709
7100,6700,4100,47570000,2,32806,8203,1,833200000,833200000,12301,4100,8201,4100,0,1,4102,36068676,36.068676
7100,6700,4100,47570000,2,32806,8203,1,833200000,833200000,12301,4100,8201,4100,0,1,4102,36131610,36.13161
7100,6700,4100,47570000,2,32806,8203,1,833200000,833200000,12301,4100,8201,4100,0,1,4102,37363674,37.363674
7100,6700,4500,47570000,2,36006,9003,1,877360000,877360000,13501,4500,9001,4500,0,1,4502,39638727,39.638727
7100,6700,4500,47570000,2,36006,9003,1,877360000,877360000,13501,4500,9001,4500,0,1,4502,41390006,41.390006
7100,6700,4500,47570000,2,36006,9003,1,877360000,877360000,13501,4500,9001,4500,0,1,4502,39580788,39.580788
7100,6700,4500,47570000,2,36006,9003,1,877360000,877360000,13501,4500,9001,4500,0,1,4502,41614383,41.614383
7100,6700,4500,47570000,2,36006,9003,1,877360000,877360000,13501,4500,9001,4500,0,1,4502,39579364,39.579364
7100,6700,4500,47570000,2,36006,9003,1,877360000,877360000,13501,4500,9001,4500,0,1,4502,39546615,39.546615
7100,6700,4500,47570000,2,36006,9003,1,877360000,877360000,13501,4500,9001,4500,0,1,4502,40966441,40.966441
7100,6700,4900,47570000,2,39206,9803,1,921520000,921520000,14701,4900,9801,4900,0,1,4902,43077699,43.077699
7100,6700,4900,47570000,2,39206,9803,1,921520000,921520000,14701,4900,9801,4900,0,1,4902,45156486,45.156486
7100,6700,4900,47570000,2,39206,9803,1,921520000,921520000,14701,4900,9801,4900,0,1,4902,43079391,43.079391
7100,6700,4900,47570000,2,39206,9803,1,921520000,921520000,14701,4900,9801,4900,0,1,4902,45375972,45.375972
7100,6700,4900,47570000,2,39206,9803,1,921520000,921520000,14701,4900,9801,4900,0,1,4902,43134044,43.134044
7100,6700,4900,47570000,2,39206,9803,1,921520000,921520000,14701,4900,9801,4900,0,1,4902,43045540,43.04554
7100,6700,4900,47570000,2,39206,9803,1,921520000,921520000,14701,4900,9801,4900,0,1,4902,44558361,44.558361
7100,6700,5300,47570000,2,42406,10603,1,965680000,965680000,15901,5300,10601,5300,0,1,5302,46546710,46.54671
7100,6700,5300,47570000,2,42406,10603,1,965680000,965680000,15901,5300,10601,5300,0,1,5302,48908394,48.908394
7100,6700,5300,47570000,2,42406,10603,1,965680000,965680000,15901,5300,10601,5300,0,1,5302,46717405,46.717405
7100,6700,5300,47570000,2,42406,10603,1,965680000,965680000,15901,5300,10601,5300,0,1,5302,49084160,49.08416
7100,6700,5300,47570000,2,42406,10603,1,965680000,965680000,15901,5300,10601,5300,0,1,5302,46613619,46.613619
7100,6700,5300,47570000,2,42406,10603,1,965680000,965680000,15901,5300,10601,5300,0,1,5302,46580779,46.580779
7100,6700,5300,47570000,2,42406,10603,1,965680000,965680000,15901,5300,10601,5300,0,1,5302,48292734,48.292734
7100,6700,5700,47570000,2,45606,11403,1,1009840000,1009840000,17101,5700,11401,5700,0,1,5702,50100618,50.100618
7100,6700,5700,47570000,2,45606,11403,1,1009840000,1009840000,17101,5700,11401,5700,0,1,5702,52549813,52.549813
7100,6700,5700,47570000,2,45606,11403,1,1009840000,1009840000,17101,5700,11401,5700,0,1,5702,50206509,50.206509
7100,6700,5700,47570000,2,45606,11403,1,1009840000,1009840000,17101,5700,11401,5700,0,1,5702,52807692,52.807692
7100,6700,5700,47570000,2,45606,11403,1,1009840000,1009840000,17101,5700,11401,5700,0,1,5702,50174708,50.174708
7100,6700,5700,47570000,2,45606,11403,1,1009840000,1009840000,17101,5700,11401,5700,0,1,5702,50103005,50.103005
7100,6700,5700,47570000,2,45606,11403,1,1009840000,1009840000,17101,5700,11401,5700,0,1,5702,51938219,51.938219
7100,6700,6100,47570000,2,48806,12203,1,1054000000,1054000000,18301,6100,12201,6100,0,1,6102,53516497,53.516497
7100,6700,6100,47570000,2,48806,12203,1,1054000000,1054000000,18301,6100,12201,6100,0,1,6102,56471438,56.471438
7100,6700,6100,47570000,2,48806,12203,1,1054000000,1054000000,18301,6100,12201,6100,0,1,6102,53956209,53.956209
7100,6700,6100,47570000,2,48806,12203,1,1054000000,1054000000,18301,6100,12201,6100,0,1,6102,56411467,56.411467
7100,6700,6100,47570000,2,48806,12203,1,1054000000,1054000000,18301,6100,12201,6100,0,1,6102,53679670,53.67967
7100,6700,6100,47570000,2,48806,12203,1,1054000000,1054000000,18301,6100,12201,6100,0,1,6102,53519199,53.519199
7100,6700,6100,47570000,2,48806,12203,1,1054000000,1054000000,18301,6100,12201,6100,0,1,6102,55564921,55.564921
7100,6700,6500,47570000,2,52006,13003,1,1098160000,1098160000,19501,6500,13001,6500,0,1,6502,56976299,56.976299
7100,6700,6500,47570000,2,52006,13003,1,1098160000,1098160000,19501,6500,13001,6500,0,1,6502,60084673,60.084673
7100,6700,6500,47570000,2,52006,13003,1,1098160000,1098160000,19501,6500,13001,6500,0,1,6502,57292158,57.292158
7100,6700,6500,47570000,2,52006,13003,1,1098160000,1098160000,19501,6500,13001,6500,0,1,6502,60115570,60.11557
7100,6700,6500,47570000,2,52006,13003,1,1098160000,1098160000,19501,6500,13001,6500,0,1,6502,57045307,57.045307
7100,6700,6500,47570000,2,52006,13003,1,1098160000,1098160000,19501,6500,13001,6500,0,1,6502,57078978,57.078978
7100,6700,6500,47570000,2,52006,13003,1,1098160000,1098160000,19501,6500,13001,6500,0,1,6502,59132063,59.132063
7100,6700,6900,47570000,2,55206,13803,1,1142320000,1142320000,20701,6900,13801,6900,0,1,6902,60688043,60.688043
7100,6700,6900,47570000,2,55206,13803,1,1142320000,1142320000,20701,6900,13801,6900,0,1,6902,63801637,63.801637
7100,6700,6900,47570000,2,55206,13803,1,1142320000,1142320000,20701,6900,13801,6900,0,1,6902,60859213,60.859213
7100,6700,6900,47570000,2,55206,13803,1,1142320000,1142320000,20701,6900,13801,6900,0,1,6902,63871787,63.871787
7100,6700,6900,47570000,2,55206,13803,1,1142320000,1142320000,20701,6900,13801,6900,0,1,6902,60762997,60.762997
7100,6700,6900,47570000,2,55206,13803,1,1142320000,1142320000,20701,6900,13801,6900,0,1,6902,60654839,60.654839
7100,6700,6900,47570000,2,55206,13803,1,1142320000,1142320000,20701,6900,13801,6900,0,1,6902,62797019,62.797019
7100,6300,500,44730000,2,4006,1003,1,411440000,411440000,1501,500,1001,500,0,1,502,4706576,4.706576
7100,6300,500,44730000,2,4006,1003,1,411440000,411440000,1501,500,1001,500,0,1,502,4769084,4.769084
7100,6300,500,44730000,2,4006,1003,1,411440000,411440000,1501,500,1001,500,0,1,502,4583548,4.583548
7100,6300,500,44730000,2,4006,1003,1,411440000,411440000,1501,500,1001,500,0,1,502,4859491,4.859491
7100,6300,500,44730000,2,4006,1003,1,411440000,411440000,1501,500,1001,500,0,1,502,4614064,4.614064
7100,6300,500,44730000,2,4006,1003,1,411440000,411440000,1501,500,1001,500,0,1,502,4659228,4.659228
7100,6300,500,44730000,2,4006,1003,1,411440000,411440000,1501,500,1001,500,0,1,502,4736959,4.736959
7100,6300,900,44730000,2,7206,1803,1,454320000,454320000,2701,900,1801,900,0,1,902,7907556,7.907556
7100,6300,900,44730000,2,7206,1803,1,454320000,454320000,2701,900,1801,900,0,1,902,8020931,8.020931
7100,6300,900,44730000,2,7206,1803,1,454320000,454320000,2701,900,1801,900,0,1,902,7843866,7.843866
7100,6300,900,44730000,2,7206,1803,1,454320000,454320000,2701,900,1801,900,0,1,902,8235071,8.235071
7100,6300,900,44730000,2,7206,1803,1,454320000,454320000,2701,900,1801,900,0,1,902,7938965,7.938965
7100,6300,900,44730000,2,7206,1803,1,454320000,454320000,2701,900,1801,900,0,1,902,7970472,7.970472
7100,6300,900,44730000,2,7206,1803,1,454320000,454320000,2701,900,1801,900,0,1,902,8115384,8.115384
7100,6300,1300,44730000,2,10406,2603,1,497200000,497200000,3901,1300,2601,1300,0,1,1302,10992481,10.992481
7100,6300,1300,44730000,2,10406,2603,1,497200000,497200000,3901,1300,2601,1300,0,1,1302,11632400,11.6324
7100,6300,1300,44730000,2,10406,2603,1,497200000,497200000,3901,1300,2601,1300,0,1,1302,10956248,10.956248
7100,6300,1300,44730000,2,10406,2603,1,497200000,497200000,3901,1300,2601,1300,0,1,1302,11599452,11.599452
7100,6300,1300,44730000,2,10406,2603,1,497200000,497200000,3901,1300,2601,1300,0,1,1302,11057994,11.057994
7100,6300,1300,44730000,2,10406,2603,1,497200000,497200000,3901,1300,2601,1300,0,1,1302,11022230,11.02223
7100,6300,1300,44730000,2,10406,2603,1,497200000,497200000,3901,1300,2601,1300,0,1,1302,11380003,11.380003
7100,6300,1700,44730000,2,13606,3403,1,540080000,540080000,5101,1700,3401,1700,0,1,1702,14391712,14.391712
7100,6300,1700,44730000,2,13606,3403,1,540080000,540080000,5101,1700,3401,1700,0,1,1702,14938547,14.938547
7100,6300,1700,44730000,2,13606,3403,1,540080000,540080000,5101,1700,3401,1700,0,1,1702,14313949,14.313949
7100,6300,1700,44730000,2,13606,3403,1,540080000,540080000,5101,1700,3401,1700,0,1,1702,15095389,15.095389
7100,6300,1700,44730000,2,13606,3403,1,540080000,540080000,5101,1700,3401,1700,0,1,1702,14459225,14.459225
7100,6300,1700,44730000,2,13606,3403,1,540080000,540080000,5101,1700,3401,1700,0,1,1702,14421994,14.421994
7100,6300,1700,44730000,2,13606,3403,1,540080000,540080000,5101,1700,3401,1700,0,1,1702,14814620,14.81462
7100,6300,2100,44730000,2,16806,4203,1,582960000,582960000,6301,2100,4201,2100,0,1,2102,17676060,17.67606
7100,6300,2100,44730000,2,16806,4203,1,582960000,582960000,6301,2100,4201,2100,0,1,2102,18320979,18.320979
7100,6300,2100,44730000,2,16806,4203,1,582960000,582960000,6301,2100,4201,2100,0,1,2102,17635220,17.63522
7100,6300,2100,44730000,2,16806,4203,1,582960000,582960000,6301,2100,4201,2100,0,1,2102,18529131,18.529131
7100,6300,2100,44730000,2,16806,4203,1,582960000,582960000,6301,2100,4201,2100,0,1,2102,17666771,17.666771
7100,6300,2100,44730000,2,16806,4203,1,582960000,582960000,6301,2100,4201,2100,0,1,2102,17596277,17.596277
7100,6300,2100,44730000,2,16806,4203,1,582960000,582960000,6301,2100,4201,2100,0,1,2102,18208628,18.208628
7100,6300,2500,44730000,2,20006,5003,1,625840000,625840000,7501,2500,5001,2500,0,1,2502,20915329,20.915329
7100,6300,2500,44730000,2,20006,5003,1,625840000,625840000,7501,2500,5001,2500,0,1,2502,21787664,21.787664
7100,6300,2500,44730000,2,20006,5003,1,625840000,625840000,7501,2500,5001,2500,0,1,2502,20844399,20.844399
7100,6300,2500,44730000,2,20006,5003,1,625840000,625840000,7501,2500,5001,2500,0,1,2502,21950187,21.950187
7100,6300,2500,44730000,2,20006,5003,1,625840000,625840000,7501,2500,5001,2500,0,1,2502,20814363,20.814363
7100,6300,2500,44730000,2,20006,5003,1,625840000,625840000,7501,2500,5001,2500,0,1,2502,20885115,20.885115
7100,6300,2500,44730000,2,20006,5003,1,625840000,625840000,7501,2500,5001,2500,0,1,2502,21545876,21.545876
7100,6300,2900,44730000,2,23206,5803,1,668720000,668720000,8701,2900,5801,2900,0,1,2902,24105384,24.105384
7100,6300,2900,44730000,2,23206,5803,1,668720000,668720000,8701,2900,5801,2900,0,1,2902,25254839,25.254839
7100,6300,2900,44730000,2,23206,5803,1,668720000,668720000,8701,2900,5801,2900,0,1,2902,24136858,24.136858
7100,6300,2900,44730000,2,23206,5803,1,668720000,668720000,8701,2900,5801,2900,0,1,2902,25356234,25.356234
7100,6300,2900,44730000,2,23206,5803,1,668720000,668720000,8701,2900,5801,2900,0,1,2902,24198398,24.198398
7100,6300,2900,44730000,2,23206,5803,1,668720000,668720000,8701,2900,5801,2900,0,1,2902,24166802,24.166802
7100,6300,2900,44730000,2,23206,5803,1,668720000,668720000,8701,2900,5801,2900,0,1,2902,24962541,24.962541
7100,6300,3300,44730000,2,26406,6603,1,711600000,711600000,9901,3300,6601,3300,0,1,3302,27419111,27.419111
7100,6300,3300,44730000,2,26406,6603,1,711600000,711600000,9901,3300,6601,3300,0,1,3302,28631049,28.631049
7100,6300,3300,44730000,2,26406,6603,1,711600000,711600000,9901,3300,6601,3300,0,1,3302,27387659,27.387659
7100,6300,3300,44730000,2,26406,6603,1,711600000,711600000,9901,3300,6601,3300,0,1,3302,28826056,28.826056
7100,6300,3300,44730000,2,26406,6603,1,711600000,711600000,9901,3300,6601,3300,0,1,3302,27463263,27.463263
7100,6300,3300,44730000,2,26406,6603,1,711600000,711600000,9901,3300,6601,3300,0,1,3302,27464768,27.464768
7100,6300,3300,44730000,2,26406,6603,1,711600000,711600000,9901,3300,6601,3300,0,1,3302,28337628,28.337628
7100,6300,3700,44730000,2,29606,7403,1,754480000,754480000,11101,3700,7401,3700,0,1,3702,30700539,30.700539
7100,6300,3700,44730000,2,29606,7403,1,754480000,754480000,11101,3700,7401,3700,0,1,3702,32158562,32.158562
7100,6300,3700,44730000,2,29606,7403,1,754480000,754480000,11101,3700,7401,3700,0,1,3702,30670456,30.670456
7100,6300,3700,44730000,2,29606,7403,1,754480000,754480000,11101,3700,7401,3700,0,1,3702,32295545,32.295545
7100,6300,3700,44730000,2,29606,7403,1,754480000,754480000,11101,3700,7401,3700,0,1,3702,30749432,30.749432
7100,6300,3700,44730000,2,29606,7403,1,754480000,754480000,11101,3700,7401,3700,0,1,3702,30642604,30.642604
7100,6300,3700,44730000,2,29606,7403,1,754480000,754480000,11101,3700,7401,3700,0,1,3702,31742475,31.742475
7100,6300,4100,44730000,2,32806,8203,1,797360000,797360000,12301,4100,8201,4100,0,1,4102,33983297,33.983297
7100,6300,4100,44730000,2,32806,8203,1,797360000,797360000,12301,4100,8201,4100,0,1,4102,35409524,35.409524
7100,6300,4100,44730000,2,32806,8203,1,797360000,797360000,12301,4100,8201,4100,0,1,4102,33952214,33.952214
7100,6300,4100,44730000,2,32806,8203,1,797360000,797360000,12301,4100,8201,4100,0,1,4102,35733453,35.733453
7100,6300,4100,44730000,2,32806,8203,1,797360000,797360000,12301,4100,8201,4100,0,1,4102,33952875,33.952875
7100,6300,4100,44730000,2,32806,8203,1,797360000,797360000,12301,4100,8201,4100,0,1,4102,33921121,33.921121
7100,6300,4100,44730000,2,32806,8203,1,797360000,797360000,12301,4100,8201,4100,0,1,4102,35172501,35.172501
7100,6300,4500,44730000,2,36006,9003,1,840240000,840240000,13501,4500,9001,4500,0,1,4502,37229504,37.229504
7100,6300,4500,44730000,2,36006,9003,1,840240000,840240000,13501,4500,9001,4500,0,1,4502,38982487,38.982487
7100,6300,4500,44730000,2,36006,9003,1,840240000,840240000,13501,4500,9001,4500,0,1,4502,37259923,37.259923
7100,6300,4500,44730000,2,36006,9003,1,840240000,840240000,13501,4500,9001,4500,0,1,4502,39197408,39.197408
7100,6300,4500,44730000,2,36006,9003,1,840240000,840240000,13501,4500,9001,4500,0,1,4502,37292710,37.29271
7100,6300,4500,44730000,2,36006,9003,1,840240000,840240000,13501,4500,9001,4500,0,1,4502,37260961,37.260961
7100,6300,4500,44730000,2,36006,9003,1,840240000,840240000,13501,4500,9001,4500,0,1,4502,38491231,38.491231
7100,6300,4900,44730000,2,39206,9803,1,883120000,883120000,14701,4900,9801,4900,0,1,4902,40548263,40.548263
7100,6300,4900,44730000,2,39206,9803,1,883120000,883120000,14701,4900,9801,4900,0,1,4902,42562467,42.562467
7100,6300,4900,44730000,2,39206,9803,1,883120000,883120000,14701,4900,9801,4900,0,1,4902,40624714,40.624714
7100,6300,4900,44730000,2,39206,9803,1,883120000,883120000,14701,4900,9801,4900,0,1,4902,42669054,42.669054
7100,6300,4900,44730000,2,39206,9803,1,883120000,883120000,14701,4900,9801,4900,0,1,4902,40657705,40.657705
7100,6300,4900,44730000,2,39206,9803,1,883120000,883120000,14701,4900,9801,4900,0,1,4902,40659049,40.659049
7100,6300,4900,44730000,2,39206,9803,1,883120000,883120000,14701,4900,9801,4900,0,1,4902,41952174,41.952174
7100,6300,5300,44730000,2,42406,10603,1,926000000,926000000,15901,5300,10601,5300,0,1,5302,43894006,43.894006
7100,6300,5300,44730000,2,42406,10603,1,926000000,926000000,15901,5300,10601,5300,0,1,5302,46036387,46.036387
7100,6300,5300,44730000,2,42406,10603,1,926000000,926000000,15901,5300,10601,5300,0,1,5302,44044991,44.044991
7100,6300,5300,44730000,2,42406,10603,1,926000000,926000000,15901,5300,10601,5300,0,1,5302,46185977,46.185977
7100,6300,5300,44730000,2,42406,10603,1,926000000,926000000,15901,5300,10601,5300,0,1,5302,43863830,43.86383
7100,6300,5300,44730000,2,42406,10603,1,926000000,926000000,15901,5300,10601,5300,0,1,5302,43766701,43.766701
7100,6300,5300,44730000,2,42406,10603,1,926000000,926000000,15901,5300,10601,5300,0,1,5302,45395984,45.395984
7100,6300,5700,44730000,2,45606,11403,1,968880000,968880000,17101,5700,11401,5700,0,1,5702,47075394,47.075394
7100,6300,5700,44730000,2,45606,11403,1,968880000,968880000,17101,5700,11401,5700,0,1,5702,49482481,49.482481
7100,6300,5700,44730000,2,45606,11403,1,968880000,968880000,17101,5700,11401,5700,0,1,5702,47318767,47.318767
7100,6300,5700,44730000,2,45606,11403,1,968880000,968880000,17101,5700,11401,5700,0,1,5702,49597545,49.597545
7100,6300,5700,44730000,2,45606,11403,1,968880000,968880000,17101,5700,11401,5700,0,1,5702,47197158,47.197158
7100,6300,5700,44730000,2,45606,11403,1,968880000,968880000,17101,5700,11401,5700,0,1,5702,47045194,47.045194
7100,6300,5700,44730000,2,45606,11403,1,968880000,968880000,17101,5700,11401,5700,0,1,5702,48773277,48.773277
7100,6300,6100,44730000,2,48806,12203,1,1011760000,1011760000,18301,6100,12201,6100,0,1,6102,50487441,50.487441
7100,6300,6100,44730000,2,48806,12203,1,1011760000,1011760000,18301,6100,12201,6100,0,1,6102,53264308,53.264308
7100,6300,6100,44730000,2,48806,12203,1,1011760000,1011760000,18301,6100,12201,6100,0,1,6102,50769699,50.769699
7100,6300,6100,44730000,2,48806,12203,1,1011760000,1011760000,18301,6100,12201,6100,0,1,6102,53229047,53.229047
7100,6300,6100,44730000,2,48806,12203,1,1011760000,1011760000,18301,6100,12201,6100,0,1,6102,50543907,50.543907
7100,6300,6100,44730000,2,48806,12203,1,1011760000,1011760000,18301,6100,12201,6100,0,1,6102,50456216,50.456216
7100,6300,6100,44730000,2,48806,12203,1,1011760000,1011760000,18301,6100,12201,6100,0,1,6102,52346980,52.34698
7100,6300,6500,44730000,2,52006,13003,1,1054640000,1054640000,19501,6500,13001,6500,0,1,6502,53759620,53.75962
7100,6300,6500,44730000,2,52006,13003,1,1054640000,1054640000,19501,6500,13001,6500,0,1,6502,56546937,56.546937
7100,6300,6500,44730000,2,52006,13003,1,1054640000,1054640000,19501,6500,13001,6500,0,1,6502,53981269,53.981269
7100,6300,6500,44730000,2,52006,13003,1,1054640000,1054640000,19501,6500,13001,6500,0,1,6502,56512233,56.512233
7100,6300,6500,44730000,2,52006,13003,1,1054640000,1054640000,19501,6500,13001,6500,0,1,6502,53728268,53.728268
7100,6300,6500,44730000,2,52006,13003,1,1054640000,1054640000,19501,6500,13001,6500,0,1,6502,53625280,53.62528
7100,6300,6500,44730000,2,52006,13003,1,1054640000,1054640000,19501,6500,13001,6500,0,1,6502,55626312,55.626312
7100,6300,6900,44730000,2,55206,13803,1,1097520000,1097520000,20701,6900,13801,6900,0,1,6902,57144507,57.144507
7100,6300,6900,44730000,2,55206,13803,1,1097520000,1097520000,20701,6900,13801,6900,0,1,6902,60240848,60.240848
7100,6300,6900,44730000,2,55206,13803,1,1097520000,1097520000,20701,6900,13801,6900,0,1,6902,57411032,57.411032
7100,6300,6900,44730000,2,55206,13803,1,1097520000,1097520000,20701,6900,13801,6900,0,1,6902,60137158,60.137158
7100,6300,6900,44730000,2,55206,13803,1,1097520000,1097520000,20701,6900,13801,6900,0,1,6902,57085252,57.085252
7100,6300,6900,44730000,2,55206,13803,1,1097520000,1097520000,20701,6900,13801,6900,0,1,6902,57025351,57.025351
7100,6300,6900,44730000,2,55206,13803,1,1097520000,1097520000,20701,6900,13801,6900,0,1,6902,59091258,59.091258
7100,5900,500,41890000,2,4006,1003,1,387120000,387120000,1501,500,1001,500,0,1,502,4444692,4.444692
7100,5900,500,41890000,2,4006,1003,1,387120000,387120000,1501,500,1001,500,0,1,502,4475862,4.475862
7100,5900,500,41890000,2,4006,1003,1,387120000,387120000,1501,500,1001,500,0,1,502,4415823,4.415823
7100,5900,500,41890000,2,4006,1003,1,387120000,387120000,1501,500,1001,500,0,1,502,4506870,4.50687
7100,5900,500,41890000,2,4006,1003,1,387120000,387120000,1501,500,1001,500,0,1,502,4359107,4.359107
7100,5900,500,41890000,2,4006,1003,1,387120000,387120000,1501,500,1001,500,0,1,502,4387636,4.387636
7100,5900,500,41890000,2,4006,1003,1,387120000,387120000,1501,500,1001,500,0,1,502,4473982,4.473982
7100,5900,900,41890000,2,7206,1803,1,428720000,428720000,2701,900,1801,900,0,1,902,7229488,7.229488
7100,5900,900,41890000,2,7206,1803,1,428720000,428720000,2701,900,1801,900,0,1,902,7608047,7.608047
7100,5900,900,41890000,2,7206,1803,1,428720000,428720000,2701,900,1801,900,0,1,902,7261835,7.261835
7100,5900,900,41890000,2,7206,1803,1,428720000,428720000,2701,900,1801,900,0,1,902,7578521,7.578521
7100,5900,900,41890000,2,7206,1803,1,428720000,428720000,2701,900,1801,900,0,1,902,7407147,7.407147
7100,5900,900,41890000,2,7206,1803,1,428720000,428720000,2701,900,1801,900,0,1,902,7435254,7.435254
7100,5900,900,41890000,2,7206,1803,1,428720000,428720000,2701,900,1801,900,0,1,902,7489496,7.489496
7100,5900,1300,41890000,2,10406,2603,1,470320000,470320000,3901,1300,2601,1300,0,1,1302,10611681,10.611681
7100,5900,1300,41890000,2,10406,2603,1,470320000,470320000,3901,1300,2601,1300,0,1,1302,11009771,11.009771
7100,5900,1300,41890000,2,10406,2603,1,470320000,470320000,3901,1300,2601,1300,0,1,1302,10639878,10.639878
7100,5900,1300,41890000,2,10406,2603,1,470320000,470320000,3901,1300,2601,1300,0,1,1302,11040609,11.040609
7100,5900,1300,41890000,2,10406,2603,1,470320000,470320000,3901,1300,2601,1300,0,1,1302,10461028,10.461028
7100,5900,1300,41890000,2,10406,2603,1,470320000,470320000,3901,1300,2601,1300,0,1,1302,10423973,10.423973
7100,5900,1300,41890000,2,10406,2603,1,470320000,470320000,3901,1300,2601,1300,0,1,1302,10879831,10.879831
7100,5900,1700,41890000,2,13606,3403,1,511920000,511920000,5101,1700,3401,1700,0,1,1702,13535349,13.535349
7100,5900,1700,41890000,2,13606,3403,1,511920000,511920000,5101,1700,3401,1700,0,1,1702,14074876,14.074876
7100,5900,1700,41890000,2,13606,3403,1,511920000,511920000,5101,1700,3401,1700,0,1,1702,13563651,13.563651
7100,5900,1700,41890000,2,13606,3403,1,511920000,511920000,5101,1700,3401,1700,0,1,1702,14113677,14.113677
7100,5900,1700,41890000,2,13606,3403,1,511920000,511920000,5101,1700,3401,1700,0,1,1702,13566061,13.566061
7100,5900,1700,41890000,2,13606,3403,1,511920000,511920000,5101,1700,3401,1700,0,1,1702,13499848,13.499848
7100,5900,1700,41890000,2,13606,3403,1,511920000,511920000,5101,1700,3401,1700,0,1,1702,13904607,13.904607
7100,5900,2100,41890000,2,16806,4203,1,553520000,553520000,6301,2100,4201,2100,0,1,2102,16633811,16.633811
7100,5900,2100,41890000,2,16806,4203,1,553520000,553520000,6301,2100,4201,2100,0,1,2102,17280413,17.280413
7100,5900,2100,41890000,2,16806,4203,1,553520000,553520000,6301,2100,4201,2100,0,1,2102,16596679,16.596679
7100,5900,2100,41890000,2,16806,4203,1,553520000,553520000,6301,2100,4201,2100,0,1,2102,17319939,17.319939
7100,5900,2100,41890000,2,16806,4203,1,553520000,553520000,6301,2100,4201,2100,0,1,2102,16567331,16.567331
7100,5900,2100,41890000,2,16806,4203,1,553520000,553520000,6301,2100,4201,2100,0,1,2102,16597238,16.597238
7100,5900,2100,41890000,2,16806,4203,1,553520000,553520000,6301,2100,4201,2100,0,1,2102,17124531,17.124531
7100,5900,2500,41890000,2,20006,5003,1,595120000,595120000,7501,2500,5001,2500,0,1,2502,19662350,19.66235
7100,5900,2500,41890000,2,20006,5003,1,595120000,595120000,7501,2500,5001,2500,0,1,2502,20453486,20.453486
7100,5900,2500,41890000,2,20006,5003,1,595120000,595120000,7501,2500,5001,2500,0,1,2502,19662898,19.662898
7100,5900,2500,41890000,2,20006,5003,1,595120000,595120000,7501,2500,5001,2500,0,1,2502,20514455,20.514455
7100,5900,2500,41890000,2,20006,5003,1,595120000,595120000,7501,2500,5001,2500,0,1,2502,19664456,19.664456
7100,5900,2500,41890000,2,20006,5003,1,595120000,595120000,7501,2500,5001,2500,0,1,2502,19633039,19.633039
7100,5900,2500,41890000,2,20006,5003,1,595120000,595120000,7501,2500,5001,2500,0,1,2502,20240235,20.240235
7100,5900,2900,41890000,2,23206,5803,1,636720000,636720000,8701,2900,5801,2900,0,1,2902,22686483,22.686483
7100,5900,2900,41890000,2,23206,5803,1,636720000,636720000,8701,2900,5801,2900,0,1,2902,23682538,23.682538
7100,5900,2900,41890000,2,23206,5803,1,636720000,636720000,8701,2900,5801,2900,0,1,2902,22743615,22.743615
7100,5900,2900,41890000,2,23206,5803,1,636720000,636720000,8701,2900,5801,2900,0,1,2902,23750732,23.750732
7100,5900,2900,41890000,2,23206,5803,1,636720000,636720000,8701,2900,5801,2900,0,1,2902,22715260,22.71526
7100,5900,2900,41890000,2,23206,5803,1,636720000,636720000,8701,2900,5801,2900,0,1,2902,22633311,22.633311
7100,5900,2900,41890000,2,23206,5803,1,636720000,636720000,8701,2900,5801,2900,0,1,2902,23447908,23.447908
7100,5900,3300,41890000,2,26406,6603,1,678320000,678320000,9901,3300,6601,3300,0,1,3302,25656124,25.656124
7100,5900,3300,41890000,2,26406,6603,1,678320000,678320000,9901,3300,6601,3300,0,1,3302,26909981,26.909981
7100,5900,3300,41890000,2,26406,6603,1,678320000,678320000,9901,3300,6601,3300,0,1,3302,25698778,25.698778
7100,5900,3300,41890000,2,26406,6603,1,678320000,678320000,9901,3300,6601,3300,0,1,3302,26940211,26.940211
7100,5900,3300,41890000,2,26406,6603,1,678320000,678320000,9901,3300,6601,3300,0,1,3302,25740702,25.740702
7100,5900,3300,41890000,2,26406,6603,1,678320000,678320000,9901,3300,6601,3300,0,1,3302,25657525,25.657525
7100,5900,3300,41890000,2,26406,6603,1,678320000,678320000,9901,3300,6601,3300,0,1,3302,26545770,26.54577
7100,5900,3700,41890000,2,29606,7403,1,719920000,719920000,11101,3700,7401,3700,0,1,3702,28659369,28.659369
7100,5900,3700,41890000,2,29606,7403,1,719920000,719920000,11101,3700,7401,3700,0,1,3702,30129879,30.129879
7100,5900,3700,41890000,2,29606,7403,1,719920000,719920000,11101,3700,7401,3700,0,1,3702,28774063,28.774063
7100,5900,3700,41890000,2,29606,7403,1,719920000,719920000,11101,3700,7401,3700,0,1,3702,30193890,30.19389
7100,5900,3700,41890000,2,29606,7403,1,719920000,719920000,11101,3700,7401,3700,0,1,3702,28830940,28.83094
7100,5900,3700,41890000,2,29606,7403,1,719920000,719920000,11101,3700,7401,3700,0,1,3702,28802598,28.802598
7100,5900,3700,41890000,2,29606,7403,1,719920000,719920000,11101,3700,7401,3700,0,1,3702,29701748,29.701748
7100,5900,4100,41890000,2,32806,8203,1,761520000,761520000,12301,4100,8201,4100,0,1,4102,31904937,31.904937
7100,5900,4100,41890000,2,32806,8203,1,761520000,761520000,12301,4100,8201,4100,0,1,4102,33261051,33.261051
7100,5900,4100,41890000,2,32806,8203,1,761520000,761520000,12301,4100,8201,4100,0,1,4102,31860425,31.860425
7100,5900,4100,41890000,2,32806,8203,1,761520000,761520000,12301,4100,8201,4100,0,1,4102,33398764,33.398764
7100,5900,4100,41890000,2,32806,8203,1,761520000,761520000,12301,4100,8201,4100,0,1,4102,31787698,31.787698
7100,5900,4100,41890000,2,32806,8203,1,761520000,761520000,12301,4100,8201,4100,0,1,4102,31815895,31.815895
7100,5900,4100,41890000,2,32806,8203,1,761520000,761520000,12301,4100,8201,4100,0,1,4102,32879278,32.879278
7100,5900,4500,41890000,2,36006,9003,1,803120000,803120000,13501,4500,9001,4500,0,1,4502,34814783,34.814783
7100,5900,4500,41890000,2,36006,9003,1,803120000,803120000,13501,4500,9001,4500,0,1,4502,36628778,36.628778
7100,5900,4500,41890000,2,36006,9003,1,803120000,803120000,13501,4500,9001,4500,0,1,4502,35003956,35.003956
7100,5900,4500,41890000,2,36006,9003,1,803120000,803120000,13501,4500,9001,4500,0,1,4502,36680455,36.680455
7100,5900,4500,41890000,2,36006,9003,1,803120000,803120000,13501,4500,9001,4500,0,1,4502,34842718,34.842718
7100,5900,4500,41890000,2,36006,9003,1,803120000,803120000,13501,4500,9001,4500,0,1,4502,34871311,34.871311
7100,5900,4500,41890000,2,36006,9003,1,803120000,803120000,13501,4500,9001,4500,0,1,4502,36128097,36.128097
7100,5900,4900,41890000,2,39206,9803,1,844720000,844720000,14701,4900,9801,4900,0,1,4902,37994932,37.994932
7100,5900,4900,41890000,2,39206,9803,1,844720000,844720000,14701,4900,9801,4900,0,1,4902,39866229,39.866229
7100,5900,4900,41890000,2,39206,9803,1,844720000,844720000,14701,4900,9801,4900,0,1,4902,38094585,38.094585
7100,5900,4900,41890000,2,39206,9803,1,844720000,844720000,14701,4900,9801,4900,0,1,4902,39897402,39.897402
7100,5900,4900,41890000,2,39206,9803,1,844720000,844720000,14701,4900,9801,4900,0,1,4902,37918931,37.918931
7100,5900,4900,41890000,2,39206,9803,1,844720000,844720000,14701,4900,9801,4900,0,1,4902,37947344,37.947344
7100,5900,4900,41890000,2,39206,9803,1,844720000,844720000,14701,4900,9801,4900,0,1,4902,39344329,39.344329
7100,5900,5300,41890000,2,42406,10603,1,886320000,886320000,15901,5300,10601,5300,0,1,5302,40956101,40.956101
7100,5900,5300,41890000,2,42406,10603,1,886320000,886320000,15901,5300,10601,5300,0,1,5302,43248576,43.248576
7100,5900,5300,41890000,2,42406,10603,1,886320000,886320000,15901,5300,10601,5300,0,1,5302,41204490,41.20449
7100,5900,5300,41890000,2,42406,10603,1,886320000,886320000,15901,5300,10601,5300,0,1,5302,43087086,43.087086
7100,5900,5300,41890000,2,42406,10603,1,886320000,886320000,15901,5300,10601,5300,0,1,5302,41061585,41.061585
7100,5900,5300,41890000,2,42406,10603,1,886320000,886320000,15901,5300,10601,5300,0,1,5302,41005295,41.005295
7100,5900,5300,41890000,2,42406,10603,1,886320000,886320000,15901,5300,10601,5300,0,1,5302,42469943,42.469943
7100,5900,5700,41890000,2,45606,11403,1,927920000,927920000,17101,5700,11401,5700,0,1,5702,44088553,44.088553
7100,5900,5700,41890000,2,45606,11403,1,927920000,927920000,17101,5700,11401,5700,0,1,5702,46258449,46.258449
7100,5900,5700,41890000,2,45606,11403,1,927920000,927920000,17101,5700,11401,5700,0,1,5702,44306581,44.306581
7100,5900,5700,41890000,2,45606,11403,1,927920000,927920000,17101,5700,11401,5700,0,1,5702,46378144,46.378144
7100,5900,5700,41890000,2,45606,11403,1,927920000,927920000,17101,5700,11401,5700,0,1,5702,44059331,44.059331
7100,5900,5700,41890000,2,45606,11403,1,927920000,927920000,17101,5700,11401,5700,0,1,5702,44116732,44.116732
7100,5900,5700,41890000,2,45606,11403,1,927920000,927920000,17101,5700,11401,5700,0,1,5702,45716938,45.716938
7100,5900,6100,41890000,2,48806,12203,1,969520000,969520000,18301,6100,12201,6100,0,1,6102,47177535,47.177535
7100,5900,6100,41890000,2,48806,12203,1,969520000,969520000,18301,6100,12201,6100,0,1,6102,49654964,49.654964
7100,5900,6100,41890000,2,48806,12203,1,969520000,969520000,18301,6100,12201,6100,0,1,6102,47481102,47.481102
7100,5900,6100,41890000,2,48806,12203,1,969520000,969520000,18301,6100,12201,6100,0,1,6102,49687025,49.687025
7100,5900,6100,41890000,2,48806,12203,1,969520000,969520000,18301,6100,12201,6100,0,1,6102,47287728,47.287728
7100,5900,6100,41890000,2,48806,12203,1,969520000,969520000,18301,6100,12201,6100,0,1,6102,47205874,47.205874
7100,5900,6100,41890000,2,48806,12203,1,969520000,969520000,18301,6100,12201,6100,0,1,6102,48929564,48.929564
7100,5900,6500,41890000,2,52006,13003,1,1011120000,1011120000,19501,6500,13001,6500,0,1,6502,50426206,50.426206
7100,5900,6500,41890000,2,52006,13003,1,1011120000,1011120000,19501,6500,13001,6500,0,1,6502,53012726,53.012726
7100,5900,6500,41890000,2,52006,13003,1,1011120000,1011120000,19501,6500,13001,6500,0,1,6502,50633054,50.633054
7100,5900,6500,41890000,2,52006,13003,1,1011120000,1011120000,19501,6500,13001,6500,0,1,6502,52936584,52.936584
7100,5900,6500,41890000,2,52006,13003,1,1011120000,1011120000,19501,6500,13001,6500,0,1,6502,50394597,50.394597
7100,5900,6500,41890000,2,52006,13003,1,1011120000,1011120000,19501,6500,13001,6500,0,1,6502,50425247,50.425247
7100,5900,6500,41890000,2,52006,13003,1,1011120000,1011120000,19501,6500,13001,6500,0,1,6502,52187497,52.187497
7100,5900,6900,41890000,2,55206,13803,1,1052720000,1052720000,20701,6900,13801,6900,0,1,6902,53458970,53.45897
7100,5900,6900,41890000,2,55206,13803,1,1052720000,1052720000,20701,6900,13801,6900,0,1,6902,56261405,56.261405
7100,5900,6900,41890000,2,55206,13803,1,1052720000,1052720000,20701,6900,13801,6900,0,1,6902,53748421,53.748421
7100,5900,6900,41890000,2,55206,13803,1,1052720000,1052720000,20701,6900,13801,6900,0,1,6902,56232930,56.23293
7100,5900,6900,41890000,2,55206,13803,1,1052720000,1052720000,20701,6900,13801,6900,0,1,6902,53487953,53.487953
7100,5900,6900,41890000,2,55206,13803,1,1052720000,1052720000,20701,6900,13801,6900,0,1,6902,53403621,53.403621
7100,5900,6900,41890000,2,55206,13803,1,1052720000,1052720000,20701,6900,13801,6900,0,1,6902,55412557,55.412557
7100,5500,500,39050000,2,4006,1003,1,362800000,362800000,1501,500,1001,500,0,1,502,4178007,4.178007
7100,5500,500,39050000,2,4006,1003,1,362800000,362800000,1501,500,1001,500,0,1,502,4233723,4.233723
7100,5500,500,39050000,2,4006,1003,1,362800000,362800000,1501,500,1001,500,0,1,502,4149996,4.149996
7100,5500,500,39050000,2,4006,1003,1,362800000,362800000,1501,500,1001,500,0,1,502,4180589,4.180589
7100,5500,500,39050000,2,4006,1003,1,362800000,362800000,1501,500,1001,500,0,1,502,4072660,4.07266
7100,5500,500,39050000,2,4006,1003,1,362800000,362800000,1501,500,1001,500,0,1,502,4104067,4.104067
7100,5500,500,39050000,2,4006,1003,1,362800000,362800000,1501,500,1001,500,0,1,502,4177167,4.177167
7100,5500,900,39050000,2,7206,1803,1,403120000,403120000,2701,900,1801,900,0,1,902,6840270,6.84027
7100,5500,900,39050000,2,7206,1803,1,403120000,403120000,2701,900,1801,900,0,1,902,7078259,7.078259
7100,5500,900,39050000,2,7206,1803,1,403120000,403120000,2701,900,1801,900,0,1,902,6840907,6.840907
7100,5500,900,39050000,2,7206,1803,1,403120000,403120000,2701,900,1801,900,0,1,902,7052242,7.052242
7100,5500,900,39050000,2,7206,1803,1,403120000,403120000,2701,900,1801,900,0,1,902,6813861,6.813861
7100,5500,900,39050000,2,7206,1803,1,403120000,403120000,2701,900,1801,900,0,1,902,6770817,6.770817
7100,5500,900,39050000,2,7206,1803,1,403120000,403120000,2701,900,1801,900,0,1,902,6988846,6.988846
7100,5500,1300,39050000,2,10406,2603,1,443440000,443440000,3901,1300,2601,1300,0,1,1302,9819239,9.819239
7100,5500,1300,39050000,2,10406,2603,1,443440000,443440000,3901,1300,2601,1300,0,1,1302,10128421,10.128421
7100,5500,1300,39050000,2,10406,2603,1,443440000,443440000,3901,1300,2601,1300,0,1,1302,9845670,9.84567
7100,5500,1300,39050000,2,10406,2603,1,443440000,443440000,3901,1300,2601,1300,0,1,1302,10165457,10.165457
7100,5500,1300,39050000,2,10406,2603,1,443440000,443440000,3901,1300,2601,1300,0,1,1302,9778126,9.778126
7100,5500,1300,39050000,2,10406,2603,1,443440000,443440000,3901,1300,2601,1300,0,1,1302,9751437,9.751437
7100,5500,1300,39050000,2,10406,2603,1,443440000,443440000,3901,1300,2601,1300,0,1,1302,10063872,10.063872
7100,5500,1700,39050000,2,13606,3403,1,483760000,483760000,5101,1700,3401,1700,0,1,1702,12697926,12.697926
7100,5500,1700,39050000,2,13606,3403,1,483760000,483760000,5101,1700,3401,1700,0,1,1702,13125115,13.125115
7100,5500,1700,39050000,2,13606,3403,1,483760000,483760000,5101,1700,3401,1700,0,1,1702,12698565,12.698565
7100,5500,1700,39050000,2,13606,3403,1,483760000,483760000,5101,1700,3401,1700,0,1,1702,13219506,13.219506
7100,5500,1700,39050000,2,13606,3403,1,483760000,483760000,5101,1700,3401,1700,0,1,1702,12671478,12.671478
7100,5500,1700,39050000,2,13606,3403,1,483760000,483760000,5101,1700,3401,1700,0,1,1702,12605948,12.605948
7100,5500,1700,39050000,2,13606,3403,1,483760000,483760000,5101,1700,3401,1700,0,1,1702,12975418,12.975418
7100,5500,2100,39050000,2,16806,4203,1,524080000,524080000,6301,2100,4201,2100,0,1,2102,15507382,15.507382
7100,5500,2100,39050000,2,16806,4203,1,524080000,524080000,6301,2100,4201,2100,0,1,2102,16023237,16.023237
7100,5500,2100,39050000,2,16806,4203,1,524080000,524080000,6301,2100,4201,2100,0,1,2102,15507960,15.50796
7100,5500,2100,39050000,2,16806,4203,1,524080000,524080000,6301,2100,4201,2100,0,1,2102,16191896,16.191896
7100,5500,2100,39050000,2,16806,4203,1,524080000,524080000,6301,2100,4201,2100,0,1,2102,15480691,15.480691
7100,5500,2100,39050000,2,16806,4203,1,524080000,524080000,6301,2100,4201,2100,0,1,2102,15404648,15.404648
7100,5500,2100,39050000,2,16806,4203,1,524080000,524080000,6301,2100,4201,2100,0,1,2102,15937548,15.937548
7100,5500,2500,39050000,2,20006,5003,1,564400000,564400000,7501,2500,5001,2500,0,1,2502,18346619,18.346619
7100,5500,2500,39050000,2,20006,5003,1,564400000,564400000,7501,2500,5001,2500,0,1,2502,19065237,19.065237
7100,5500,2500,39050000,2,20006,5003,1,564400000,564400000,7501,2500,5001,2500,0,1,2502,18320444,18.320444
7100,5500,2500,39050000,2,20006,5003,1,564400000,564400000,7501,2500,5001,2500,0,1,2502,19140475,19.140475
7100,5500,2500,39050000,2,20006,5003,1,564400000,564400000,7501,2500,5001,2500,0,1,2502,18292975,18.292975
7100,5500,2500,39050000,2,20006,5003,1,564400000,564400000,7501,2500,5001,2500,0,1,2502,18319493,18.319493
7100,5500,2500,39050000,2,20006,5003,1,564400000,564400000,7501,2500,5001,2500,0,1,2502,18875899,18.875899
7100,5500,2900,39050000,2,23206,5803,1,604720000,604720000,8701,2900,5801,2900,0,1,2902,21155396,21.155396
7100,5500,2900,39050000,2,23206,5803,1,604720000,604720000,8701,2900,5801,2900,0,1,2902,22048337,22.048337
7100,5500,2900,39050000,2,23206,5803,1,604720000,604720000,8701,2900,5801,2900,0,1,2902,21210082,21.210082
7100,5500,2900,39050000,2,23206,5803,1,604720000,604720000,8701,2900,5801,2900,0,1,2902,22125616,22.125616
7100,5500,2900,39050000,2,23206,5803,1,604720000,604720000,8701,2900,5801,2900,0,1,2902,21182366,21.182366
7100,5500,2900,39050000,2,23206,5803,1,604720000,604720000,8701,2900,5801,2900,0,1,2902,21101622,21.101622
7100,5500,2900,39050000,2,23206,5803,1,604720000,604720000,8701,2900,5801,2900,0,1,2902,21779698,21.779698
7100,5500,3300,39050000,2,26406,6603,1,645040000,645040000,9901,3300,6601,3300,0,1,3302,23972638,23.972638
7100,5500,3300,39050000,2,26406,6603,1,645040000,645040000,9901,3300,6601,3300,0,1,3302,25084945,25.084945
7100,5500,3300,39050000,2,26406,6603,1,645040000,645040000,9901,3300,6601,3300,0,1,3302,23945510,23.94551
7100,5500,3300,39050000,2,26406,6603,1,645040000,645040000,9901,3300,6601,3300,0,1,3302,25160550,25.16055
7100,5500,3300,39050000,2,26406,6603,1,645040000,645040000,9901,3300,6601,3300,0,1,3302,23974186,23.974186
7100,5500,3300,39050000,2,26406,6603,1,645040000,645040000,9901,3300,6601,3300,0,1,3302,23971972,23.971972
7100,5500,3300,39050000,2,26406,6603,1,645040000,645040000,9901,3300,6601,3300,0,1,3302,24766032,24.766032
7100,5500,3700,39050000,2,29606,7403,1,685360000,685360000,11101,3700,7401,3700,0,1,3702,26757478,26.757478
7100,5500,3700,39050000,2,29606,7403,1,685360000,685360000,11101,3700,7401,3700,0,1,3702,28104587,28.104587
7100,5500,3700,39050000,2,29606,7403,1,685360000,685360000,11101,3700,7401,3700,0,1,3702,26837071,26.837071
7100,5500,3700,39050000,2,29606,7403,1,685360000,685360000,11101,3700,7401,3700,0,1,3702,28135089,28.135089
7100,5500,3700,39050000,2,29606,7403,1,685360000,685360000,11101,3700,7401,3700,0,1,3702,26784218,26.784218
7100,5500,3700,39050000,2,29606,7403,1,685360000,685360000,11101,3700,7401,3700,0,1,3702,26810343,26.810343
7100,5500,3700,39050000,2,29606,7403,1,685360000,685360000,11101,3700,7401,3700,0,1,3702,27721323,27.721323
7100,5500,4100,39050000,2,32806,8203,1,725680000,725680000,12301,4100,8201,4100,0,1,4102,29708998,29.708998
7100,5500,4100,39050000,2,32806,8203,1,725680000,725680000,12301,4100,8201,4100,0,1,4102,31018494,31.018494
7100,5500,4100,39050000,2,32806,8203,1,725680000,725680000,12301,4100,8201,4100,0,1,4102,29682606,29.682606
7100,5500,4100,39050000,2,32806,8203,1,725680000,725680000,12301,4100,8201,4100,0,1,4102,31213897,31.213897
7100,5500,4100,39050000,2,32806,8203,1,725680000,725680000,12301,4100,8201,4100,0,1,4102,29634254,29.634254
7100,5500,4100,39050000,2,32806,8203,1,725680000,725680000,12301,4100,8201,4100,0,1,4102,29735537,29.735537
7100,5500,4100,39050000,2,32806,8203,1,725680000,725680000,12301,4100,8201,4100,0,1,4102,30784314,30.784314
7100,5500,4500,39050000,2,36006,9003,1,766000000,766000000,13501,4500,9001,4500,0,1,4502,32509570,32.50957
7100,5500,4500,39050000,2,36006,9003,1,766000000,766000000,13501,4500,9001,4500,0,1,4502,34153935,34.153935
7100,5500,4500,39050000,2,36006,9003,1,766000000,766000000,13501,4500,9001,4500,0,1,4502,32536858,32.536858
7100,5500,4500,39050000,2,36006,9003,1,766000000,766000000,13501,4500,9001,4500,0,1,4502,34286244,34.286244
7100,5500,4500,39050000,2,36006,9003,1,766000000,766000000,13501,4500,9001,4500,0,1,4502,32580346,32.580346
7100,5500,4500,39050000,2,36006,9003,1,766000000,766000000,13501,4500,9001,4500,0,1,4502,32552602,32.552602
7100,5500,4500,39050000,2,36006,9003,1,766000000,766000000,13501,4500,9001,4500,0,1,4502,33702305,33.702305
7100,5500,4900,39050000,2,39206,9803,1,806320000,806320000,14701,4900,9801,4900,0,1,4902,35338061,35.338061
7100,5500,4900,39050000,2,39206,9803,1,806320000,806320000,14701,4900,9801,4900,0,1,4902,37110578,37.110578
7100,5500,4900,39050000,2,39206,9803,1,806320000,806320000,14701,4900,9801,4900,0,1,4902,35435950,35.43595
7100,5500,4900,39050000,2,39206,9803,1,806320000,806320000,14701,4900,9801,4900,0,1,4902,37211154,37.211154
7100,5500,4900,39050000,2,39206,9803,1,806320000,806320000,14701,4900,9801,4900,0,1,4902,35409646,35.409646
7100,5500,4900,39050000,2,39206,9803,1,806320000,806320000,14701,4900,9801,4900,0,1,4902,35364541,35.364541
7100,5500,4900,39050000,2,39206,9803,1,806320000,806320000,14701,4900,9801,4900,0,1,4902,36660483,36.660483
7100,5500,5300,39050000,2,42406,10603,1,846640000,846640000,15901,5300,10601,5300,0,1,5302,38270080,38.27008
7100,5500,5300,39050000,2,42406,10603,1,846640000,846640000,15901,5300,10601,5300,0,1,5302,40168569,40.168569
7100,5500,5300,39050000,2,42406,10603,1,846640000,846640000,15901,5300,10601,5300,0,1,5302,38297945,38.297945
7100,5500,5300,39050000,2,42406,10603,1,846640000,846640000,15901,5300,10601,5300,0,1,5302,40236601,40.236601
7100,5500,5300,39050000,2,42406,10603,1,846640000,846640000,15901,5300,10601,5300,0,1,5302,38297211,38.297211
7100,5500,5300,39050000,2,42406,10603,1,846640000,846640000,15901,5300,10601,5300,0,1,5302,38192086,38.192086
7100,5500,5300,39050000,2,42406,10603,1,846640000,846640000,15901,5300,10601,5300,0,1,5302,39665199,39.665199
7100,5500,5700,39050000,2,45606,11403,1,886960000,886960000,17101,5700,11401,5700,0,1,5702,41119459,41.119459
7100,5500,5700,39050000,2,45606,11403,1,886960000,886960000,17101,5700,11401,5700,0,1,5702,43144838,43.144838
7100,5500,5700,39050000,2,45606,11403,1,886960000,886960000,17101,5700,11401,5700,0,1,5702,41262272,41.262272
7100,5500,5700,39050000,2,45606,11403,1,886960000,886960000,17101,5700,11401,5700,0,1,5702,43302104,43.302104
7100,5500,5700,39050000,2,45606,11403,1,886960000,886960000,17101,5700,11401,5700,0,1,5702,41290953,41.290953
7100,5500,5700,39050000,2,45606,11403,1,886960000,886960000,17101,5700,11401,5700,0,1,5702,41183413,41.183413
7100,5500,5700,39050000,2,45606,11403,1,886960000,886960000,17101,5700,11401,5700,0,1,5702,42691780,42.69178
7100,5500,6100,39050000,2,48806,12203,1,927280000,927280000,18301,6100,12201,6100,0,1,6102,43972438,43.972438
7100,5500,6100,39050000,2,48806,12203,1,927280000,927280000,18301,6100,12201,6100,0,1,6102,46229216,46.229216
7100,5500,6100,39050000,2,48806,12203,1,927280000,927280000,18301,6100,12201,6100,0,1,6102,44190399,44.190399
7100,5500,6100,39050000,2,48806,12203,1,927280000,927280000,18301,6100,12201,6100,0,1,6102,46389461,46.389461
7100,5500,6100,39050000,2,48806,12203,1,927280000,927280000,18301,6100,12201,6100,0,1,6102,44021308,44.021308
7100,5500,6100,39050000,2,48806,12203,1,927280000,927280000,18301,6100,12201,6100,0,1,6102,43920652,43.920652
7100,5500,6100,39050000,2,48806,12203,1,927280000,927280000,18301,6100,12201,6100,0,1,6102,45654255,45.654255
7100,5500,6500,39050000,2,52006,13003,1,967600000,967600000,19501,6500,13001,6500,0,1,6502,46913144,46.913144
7100,5500,6500,39050000,2,52006,13003,1,967600000,967600000,19501,6500,13001,6500,0,1,6502,49360969,49.360969
7100,5500,6500,39050000,2,52006,13003,1,967600000,967600000,19501,6500,13001,6500,0,1,6502,47033987,47.033987
7100,5500,6500,39050000,2,52006,13003,1,967600000,967600000,19501,6500,13001,6500,0,1,6502,49334274,49.334274
7100,5500,6500,39050000,2,52006,13003,1,967600000,967600000,19501,6500,13001,6500,0,1,6502,46968661,46.968661
7100,5500,6500,39050000,2,52006,13003,1,967600000,967600000,19501,6500,13001,6500,0,1,6502,46862642,46.862642
7100,5500,6500,39050000,2,52006,13003,1,967600000,967600000,19501,6500,13001,6500,0,1,6502,48637828,48.637828
7100,5500,6900,39050000,2,55206,13803,1,1007920000,1007920000,20701,6900,13801,6900,0,1,6902,49797076,49.797076
7100,5500,6900,39050000,2,55206,13803,1,1007920000,1007920000,20701,6900,13801,6900,0,1,6902,52425971,52.425971
7100,5500,6900,39050000,2,55206,13803,1,1007920000,1007920000,20701,6900,13801,6900,0,1,6902,50091249,50.091249
7100,5500,6900,39050000,2,55206,13803,1,1007920000,1007920000,20701,6900,13801,6900,0,1,6902,52479756,52.479756
7100,5500,6900,39050000,2,55206,13803,1,1007920000,1007920000,20701,6900,13801,6900,0,1,6902,49977155,49.977155
7100,5500,6900,39050000,2,55206,13803,1,1007920000,1007920000,20701,6900,13801,6900,0,1,6902,49713159,49.713159
7100,5500,6900,39050000,2,55206,13803,1,1007920000,1007920000,20701,6900,13801,6900,0,1,6902,51665946,51.665946
7100,5100,500,36210000,2,4006,1003,1,338480000,338480000,1501,500,1001,500,0,1,502,3843419,3.843419
7100,5100,500,36210000,2,4006,1003,1,338480000,338480000,1501,500,1001,500,0,1,502,3922815,3.922815
7100,5100,500,36210000,2,4006,1003,1,338480000,338480000,1501,500,1001,500,0,1,502,3842839,3.842839
7100,5100,500,36210000,2,4006,1003,1,338480000,338480000,1501,500,1001,500,0,1,502,3948904,3.948904
7100,5100,500,36210000,2,4006,1003,1,338480000,338480000,1501,500,1001,500,0,1,502,3818234,3.818234
7100,5100,500,36210000,2,4006,1003,1,338480000,338480000,1501,500,1001,500,0,1,502,3793818,3.793818
7100,5100,500,36210000,2,4006,1003,1,338480000,338480000,1501,500,1001,500,0,1,502,3949500,3.9495
7100,5100,900,36210000,2,7206,1803,1,377520000,377520000,2701,900,1801,900,0,1,902,6261914,6.261914
7100,5100,900,36210000,2,7206,1803,1,377520000,377520000,2701,900,1801,900,0,1,902,6523621,6.523621
7100,5100,900,36210000,2,7206,1803,1,377520000,377520000,2701,900,1801,900,0,1,902,6286418,6.286418
7100,5100,900,36210000,2,7206,1803,1,377520000,377520000,2701,900,1801,900,0,1,902,6585645,6.585645
7100,5100,900,36210000,2,7206,1803,1,377520000,377520000,2701,900,1801,900,0,1,902,6330629,6.330629
7100,5100,900,36210000,2,7206,1803,1,377520000,377520000,2701,900,1801,900,0,1,902,6237512,6.237512
7100,5100,900,36210000,2,7206,1803,1,377520000,377520000,2701,900,1801,900,0,1,902,6488302,6.488302
7100,5100,1300,36210000,2,10406,2603,1,416560000,416560000,3901,1300,2601,1300,0,1,1302,9072295,9.072295
7100,5100,1300,36210000,2,10406,2603,1,416560000,416560000,3901,1300,2601,1300,0,1,1302,9400776,9.400776
7100,5100,1300,36210000,2,10406,2603,1,416560000,416560000,3901,1300,2601,1300,0,1,1302,8999184,8.999184
7100,5100,1300,36210000,2,10406,2603,1,416560000,416560000,3901,1300,2601,1300,0,1,1302,9447224,9.447224
7100,5100,1300,36210000,2,10406,2603,1,416560000,416560000,3901,1300,2601,1300,0,1,1302,9113085,9.113085
7100,5100,1300,36210000,2,10406,2603,1,416560000,416560000,3901,1300,2601,1300,0,1,1302,9047925,9.047925
7100,5100,1300,36210000,2,10406,2603,1,416560000,416560000,3901,1300,2601,1300,0,1,1302,9298785,9.298785
7100,5100,1700,36210000,2,13606,3403,1,455600000,455600000,5101,1700,3401,1700,0,1,1702,11692002,11.692002
7100,5100,1700,36210000,2,13606,3403,1,455600000,455600000,5101,1700,3401,1700,0,1,1702,12149301,12.149301
7100,5100,1700,36210000,2,13606,3403,1,455600000,455600000,5101,1700,3401,1700,0,1,1702,11716582,11.716582
7100,5100,1700,36210000,2,13606,3403,1,455600000,455600000,5101,1700,3401,1700,0,1,1702,12196366,12.196366
7100,5100,1700,36210000,2,13606,3403,1,455600000,455600000,5101,1700,3401,1700,0,1,1702,11749697,11.749697
7100,5100,1700,36210000,2,13606,3403,1,455600000,455600000,5101,1700,3401,1700,0,1,1702,11667503,11.667503
7100,5100,1700,36210000,2,13606,3403,1,455600000,455600000,5101,1700,3401,1700,0,1,1702,12032456,12.032456
7100,5100,2100,36210000,2,16806,4203,1,494640000,494640000,6301,2100,4201,2100,0,1,2102,14264479,14.264479
7100,5100,2100,36210000,2,16806,4203,1,494640000,494640000,6301,2100,4201,2100,0,1,2102,14869211,14.869211
7100,5100,2100,36210000,2,16806,4203,1,494640000,494640000,6301,2100,4201,2100,0,1,2102,14175045,14.175045
7100,5100,2100,36210000,2,16806,4203,1,494640000,494640000,6301,2100,4201,2100,0,1,2102,15004137,15.004137
7100,5100,2100,36210000,2,16806,4203,1,494640000,494640000,6301,2100,4201,2100,0,1,2102,14362274,14.362274
7100,5100,2100,36210000,2,16806,4203,1,494640000,494640000,6301,2100,4201,2100,0,1,2102,14289065,14.289065
7100,5100,2100,36210000,2,16806,4203,1,494640000,494640000,6301,2100,4201,2100,0,1,2102,14753646,14.753646
7100,5100,2500,36210000,2,20006,5003,1,533680000,533680000,7501,2500,5001,2500,0,1,2502,16912043,16.912043
7100,5100,2500,36210000,2,20006,5003,1,533680000,533680000,7501,2500,5001,2500,0,1,2502,17660884,17.660884
7100,5100,2500,36210000,2,20006,5003,1,533680000,533680000,7501,2500,5001,2500,0,1,2502,16971130,16.97113
7100,5100,2500,36210000,2,20006,5003,1,533680000,533680000,7501,2500,5001,2500,0,1,2502,17743522,17.743522
7100,5100,2500,36210000,2,20006,5003,1,533680000,533680000,7501,2500,5001,2500,0,1,2502,17022067,17.022067
7100,5100,2500,36210000,2,20006,5003,1,533680000,533680000,7501,2500,5001,2500,0,1,2502,16936530,16.93653
7100,5100,2500,36210000,2,20006,5003,1,533680000,533680000,7501,2500,5001,2500,0,1,2502,17495118,17.495118
7100,5100,2900,36210000,2,23206,5803,1,572720000,572720000,8701,2900,5801,2900,0,1,2902,19545711,19.545711
7100,5100,2900,36210000,2,23206,5803,1,572720000,572720000,8701,2900,5801,2900,0,1,2902,20420049,20.420049
7100,5100,2900,36210000,2,23206,5803,1,572720000,572720000,8701,2900,5801,2900,0,1,2902,19570319,19.570319
7100,5100,2900,36210000,2,23206,5803,1,572720000,572720000,8701,2900,5801,2900,0,1,2902,20543930,20.54393
7100,5100,2900,36210000,2,23206,5803,1,572720000,572720000,8701,2900,5801,2900,0,1,2902,19672750,19.67275
7100,5100,2900,36210000,2,23206,5803,1,572720000,572720000,8701,2900,5801,2900,0,1,2902,19573448,19.573448
7100,5100,2900,36210000,2,23206,5803,1,572720000,572720000,8701,2900,5801,2900,0,1,2902,20241075,20.241075
7100,5100,3300,36210000,2,26406,6603,1,611760000,611760000,9901,3300,6601,3300,0,1,3302,22162236,22.162236
7100,5100,3300,36210000,2,26406,6603,1,611760000,611760000,9901,3300,6601,3300,0,1,3302,23221073,23.221073
7100,5100,3300,36210000,2,26406,6603,1,611760000,611760000,9901,3300,6601,3300,0,1,3302,22243319,22.243319
7100,5100,3300,36210000,2,26406,6603,1,611760000,611760000,9901,3300,6601,3300,0,1,3302,23296619,23.296619
7100,5100,3300,36210000,2,26406,6603,1,611760000,611760000,9901,3300,6601,3300,0,1,3302,22269727,22.269727
7100,5100,3300,36210000,2,26406,6603,1,611760000,611760000,9901,3300,6601,3300,0,1,3302,22161042,22.161042
7100,5100,3300,36210000,2,26406,6603,1,611760000,611760000,9901,3300,6601,3300,0,1,3302,22944986,22.944986
7100,5100,3700,36210000,2,29606,7403,1,650800000,650800000,11101,3700,7401,3700,0,1,3702,24858047,24.858047
7100,5100,3700,36210000,2,29606,7403,1,650800000,650800000,11101,3700,7401,3700,0,1,3702,25979482,25.979482
7100,5100,3700,36210000,2,29606,7403,1,650800000,650800000,11101,3700,7401,3700,0,1,3702,24882764,24.882764
7100,5100,3700,36210000,2,29606,7403,1,650800000,650800000,11101,3700,7401,3700,0,1,3702,26116933,26.116933
7100,5100,3700,36210000,2,29606,7403,1,650800000,650800000,11101,3700,7401,3700,0,1,3702,24907387,24.907387
7100,5100,3700,36210000,2,29606,7403,1,650800000,650800000,11101,3700,7401,3700,0,1,3702,24817932,24.817932
7100,5100,3700,36210000,2,29606,7403,1,650800000,650800000,11101,3700,7401,3700,0,1,3702,25668434,25.668434
7100,5100,4100,36210000,2,32806,8203,1,689840000,689840000,12301,4100,8201,4100,0,1,4102,27452196,27.452196
7100,5100,4100,36210000,2,32806,8203,1,689840000,689840000,12301,4100,8201,4100,0,1,4102,28713080,28.71308
7100,5100,4100,36210000,2,32806,8203,1,689840000,689840000,12301,4100,8201,4100,0,1,4102,27515427,27.515427
7100,5100,4100,36210000,2,32806,8203,1,689840000,689840000,12301,4100,8201,4100,0,1,4102,28908567,28.908567
7100,5100,4100,36210000,2,32806,8203,1,689840000,689840000,12301,4100,8201,4100,0,1,4102,27490820,27.49082
7100,5100,4100,36210000,2,32806,8203,1,689840000,689840000,12301,4100,8201,4100,0,1,4102,27427595,27.427595
7100,5100,4100,36210000,2,32806,8203,1,689840000,689840000,12301,4100,8201,4100,0,1,4102,28444238,28.444238
7100,5100,4500,36210000,2,36006,9003,1,728880000,728880000,13501,4500,9001,4500,0,1,4502,30094562,30.094562
7100,5100,4500,36210000,2,36006,9003,1,728880000,728880000,13501,4500,9001,4500,0,1,4502,31573433,31.573433
7100,5100,4500,36210000,2,36006,9003,1,728880000,728880000,13501,4500,9001,4500,0,1,4502,30203726,30.203726
7100,5100,4500,36210000,2,36006,9003,1,728880000,728880000,13501,4500,9001,4500,0,1,4502,31664626,31.664626
7100,5100,4500,36210000,2,36006,9003,1,728880000,728880000,13501,4500,9001,4500,0,1,4502,30179039,30.179039
7100,5100,4500,36210000,2,36006,9003,1,728880000,728880000,13501,4500,9001,4500,0,1,4502,30069982,30.069982
7100,5100,4500,36210000,2,36006,9003,1,728880000,728880000,13501,4500,9001,4500,0,1,4502,31194988,31.194988
7100,5100,4900,36210000,2,39206,9803,1,767920000,767920000,14701,4900,9801,4900,0,1,4902,32780143,32.780143
7100,5100,4900,36210000,2,39206,9803,1,767920000,767920000,14701,4900,9801,4900,0,1,4902,34350796,34.350796
7100,5100,4900,36210000,2,39206,9803,1,767920000,767920000,14701,4900,9801,4900,0,1,4902,32892167,32.892167
7100,5100,4900,36210000,2,39206,9803,1,767920000,767920000,14701,4900,9801,4900,0,1,4902,34496792,34.496792
7100,5100,4900,36210000,2,39206,9803,1,767920000,767920000,14701,4900,9801,4900,0,1,4902,32866681,32.866681
7100,5100,4900,36210000,2,39206,9803,1,767920000,767920000,14701,4900,9801,4900,0,1,4902,32753338,32.753338
7100,5100,4900,36210000,2,39206,9803,1,767920000,767920000,14701,4900,9801,4900,0,1,4902,33964895,33.964895
7100,5100,5300,36210000,2,42406,10603,1,806960000,806960000,15901,5300,10601,5300,0,1,5302,35454722,35.454722
7100,5100,5300,36210000,2,42406,10603,1,806960000,806960000,15901,5300,10601,5300,0,1,5302,37267862,37.267862
7100,5100,5300,36210000,2,42406,10603,1,806960000,806960000,15901,5300,10601,5300,0,1,5302,35612746,35.612746
7100,5100,5300,36210000,2,42406,10603,1,806960000,806960000,15901,5300,10601,5300,0,1,5302,37423963,37.423963
7100,5100,5300,36210000,2,42406,10603,1,806960000,806960000,15901,5300,10601,5300,0,1,5302,35536734,35.536734
7100,5100,5300,36210000,2,42406,10603,1,806960000,806960000,15901,5300,10601,5300,0,1,5302,35412233,35.412233
7100,5100,5300,36210000,2,42406,10603,1,806960000,806960000,15901,5300,10601,5300,0,1,5302,36693984,36.693984
7100,5100,5700,36210000,2,45606,11403,1,846000000,846000000,17101,5700,11401,5700,0,1,5702,38252809,38.252809
7100,5100,5700,36210000,2,45606,11403,1,846000000,846000000,17101,5700,11401,5700,0,1,5702,40088029,40.088029
7100,5100,5700,36210000,2,45606,11403,1,846000000,846000000,17101,5700,11401,5700,0,1,5702,38207098,38.207098
7100,5100,5700,36210000,2,45606,11403,1,846000000,846000000,17101,5700,11401,5700,0,1,5702,40202137,40.202137
7100,5100,5700,36210000,2,45606,11403,1,846000000,846000000,17101,5700,11401,5700,0,1,5702,38327321,38.327321
7100,5100,5700,36210000,2,45606,11403,1,846000000,846000000,17101,5700,11401,5700,0,1,5702,38096779,38.096779
7100,5100,5700,36210000,2,45606,11403,1,846000000,846000000,17101,5700,11401,5700,0,1,5702,39432691,39.432691
7100,5100,6100,36210000,2,48806,12203,1,885040000,885040000,18301,6100,12201,6100,0,1,6102,40759926,40.759926
7100,5100,6100,36210000,2,48806,12203,1,885040000,885040000,18301,6100,12201,6100,0,1,6102,42963038,42.963038
7100,5100,6100,36210000,2,48806,12203,1,885040000,885040000,18301,6100,12201,6100,0,1,6102,40859622,40.859622
7100,5100,6100,36210000,2,48806,12203,1,885040000,885040000,18301,6100,12201,6100,0,1,6102,42938226,42.938226
7100,5100,6100,36210000,2,48806,12203,1,885040000,885040000,18301,6100,12201,6100,0,1,6102,41005357,41.005357
7100,5100,6100,36210000,2,48806,12203,1,885040000,885040000,18301,6100,12201,6100,0,1,6102,40735347,40.735347
7100,5100,6100,36210000,2,48806,12203,1,885040000,885040000,18301,6100,12201,6100,0,1,6102,42259796,42.259796
7100,5100,6500,36210000,2,52006,13003,1,924080000,924080000,19501,6500,13001,6500,0,1,6502,43469667,43.469667
7100,5100,6500,36210000,2,52006,13003,1,924080000,924080000,19501,6500,13001,6500,0,1,6502,45605749,45.605749
7100,5100,6500,36210000,2,52006,13003,1,924080000,924080000,19501,6500,13001,6500,0,1,6502,43598814,43.598814
7100,5100,6500,36210000,2,52006,13003,1,924080000,924080000,19501,6500,13001,6500,0,1,6502,45761869,45.761869
7100,5100,6500,36210000,2,52006,13003,1,924080000,924080000,19501,6500,13001,6500,0,1,6502,43552129,43.552129
7100,5100,6500,36210000,2,52006,13003,1,924080000,924080000,19501,6500,13001,6500,0,1,6502,43445064,43.445064
7100,5100,6500,36210000,2,52006,13003,1,924080000,924080000,19501,6500,13001,6500,0,1,6502,45004163,45.004163
7100,5100,6900,36210000,2,55206,13803,1,963120000,963120000,20701,6900,13801,6900,0,1,6902,46120431,46.120431
7100,5100,6900,36210000,2,55206,13803,1,963120000,963120000,20701,6900,13801,6900,0,1,6902,48529853,48.529853
7100,5100,6900,36210000,2,55206,13803,1,963120000,963120000,20701,6900,13801,6900,0,1,6902,46350615,46.350615
7100,5100,6900,36210000,2,55206,13803,1,963120000,963120000,20701,6900,13801,6900,0,1,6902,48577833,48.577833
7100,5100,6900,36210000,2,55206,13803,1,963120000,963120000,20701,6900,13801,6900,0,1,6902,46216559,46.216559
7100,5100,6900,36210000,2,55206,13803,1,963120000,963120000,20701,6900,13801,6900,0,1,6902,46168446,46.168446
7100,5100,6900,36210000,2,55206,13803,1,963120000,963120000,20701,6900,13801,6900,0,1,6902,47845194,47.845194
7100,4700,500,33370000,2,4006,1003,1,314160000,314160000,1501,500,1001,500,0,1,502,3533239,3.533239
7100,4700,500,33370000,2,4006,1003,1,314160000,314160000,1501,500,1001,500,0,1,502,3590911,3.590911
7100,4700,500,33370000,2,4006,1003,1,314160000,314160000,1501,500,1001,500,0,1,502,3532403,3.532403
7100,4700,500,33370000,2,4006,1003,1,314160000,314160000,1501,500,1001,500,0,1,502,3614863,3.614863
7100,4700,500,33370000,2,4006,1003,1,314160000,314160000,1501,500,1001,500,0,1,502,3510082,3.510082
7100,4700,500,33370000,2,4006,1003,1,314160000,314160000,1501,500,1001,500,0,1,502,3556157,3.556157
7100,4700,500,33370000,2,4006,1003,1,314160000,314160000,1501,500,1001,500,0,1,502,3557574,3.557574
7100,4700,900,33370000,2,7206,1803,1,351920000,351920000,2701,900,1801,900,0,1,902,5754797,5.754797
7100,4700,900,33370000,2,7206,1803,1,351920000,351920000,2701,900,1801,900,0,1,902,6034342,6.034342
7100,4700,900,33370000,2,7206,1803,1,351920000,351920000,2701,900,1801,900,0,1,902,5780190,5.78019
7100,4700,900,33370000,2,7206,1803,1,351920000,351920000,2701,900,1801,900,0,1,902,6058258,6.058258
7100,4700,900,33370000,2,7206,1803,1,351920000,351920000,2701,900,1801,900,0,1,902,5806431,5.806431
7100,4700,900,33370000,2,7206,1803,1,351920000,351920000,2701,900,1801,900,0,1,902,5777609,5.777609
7100,4700,900,33370000,2,7206,1803,1,351920000,351920000,2701,900,1801,900,0,1,902,5951121,5.951121
7100,4700,1300,33370000,2,10406,2603,1,389680000,389680000,3901,1300,2601,1300,0,1,1302,8369689,8.369689
7100,4700,1300,33370000,2,10406,2603,1,389680000,389680000,3901,1300,2601,1300,0,1,1302,8623257,8.623257
7100,4700,1300,33370000,2,10406,2603,1,389680000,389680000,3901,1300,2601,1300,0,1,1302,8347108,8.347108
7100,4700,1300,33370000,2,10406,2603,1,389680000,389680000,3901,1300,2601,1300,0,1,1302,8693865,8.693865
7100,4700,1300,33370000,2,10406,2603,1,389680000,389680000,3901,1300,2601,1300,0,1,1302,8393210,8.39321
7100,4700,1300,33370000,2,10406,2603,1,389680000,389680000,3901,1300,2601,1300,0,1,1302,8370428,8.370428
7100,4700,1300,33370000,2,10406,2603,1,389680000,389680000,3901,1300,2601,1300,0,1,1302,8599502,8.599502
7100,4700,1700,33370000,2,13606,3403,1,427440000,427440000,5101,1700,3401,1700,0,1,1702,10638649,10.638649
7100,4700,1700,33370000,2,13606,3403,1,427440000,427440000,5101,1700,3401,1700,0,1,1702,11073579,11.073579
7100,4700,1700,33370000,2,13606,3403,1,427440000,427440000,5101,1700,3401,1700,0,1,1702,10661326,10.661326
7100,4700,1700,33370000,2,13606,3403,1,427440000,427440000,5101,1700,3401,1700,0,1,1702,11180940,11.18094
7100,4700,1700,33370000,2,13606,3403,1,427440000,427440000,5101,1700,3401,1700,0,1,1702,10697011,10.697011
7100,4700,1700,33370000,2,13606,3403,1,427440000,427440000,5101,1700,3401,1700,0,1,1702,10610687,10.610687
7100,4700,1700,33370000,2,13606,3403,1,427440000,427440000,5101,1700,3401,1700,0,1,1702,10999980,10.99998
7100,4700,2100,33370000,2,16806,4203,1,465200000,465200000,6301,2100,4201,2100,0,1,2102,13219622,13.219622
7100,4700,2100,33370000,2,16806,4203,1,465200000,465200000,6301,2100,4201,2100,0,1,2102,13707132,13.707132
7100,4700,2100,33370000,2,16806,4203,1,465200000,465200000,6301,2100,4201,2100,0,1,2102,13197003,13.197003
7100,4700,2100,33370000,2,16806,4203,1,465200000,465200000,6301,2100,4201,2100,0,1,2102,13826270,13.82627
7100,4700,2100,33370000,2,16806,4203,1,465200000,465200000,6301,2100,4201,2100,0,1,2102,13221646,13.221646
7100,4700,2100,33370000,2,16806,4203,1,465200000,465200000,6301,2100,4201,2100,0,1,2102,13220307,13.220307
7100,4700,2100,33370000,2,16806,4203,1,465200000,465200000,6301,2100,4201,2100,0,1,2102,13595809,13.595809
7100,4700,2500,33370000,2,20006,5003,1,502960000,502960000,7501,2500,5001,2500,0,1,2502,15614467,15.614467
7100,4700,2500,33370000,2,20006,5003,1,502960000,502960000,7501,2500,5001,2500,0,1,2502,16272189,16.272189
7100,4700,2500,33370000,2,20006,5003,1,502960000,502960000,7501,2500,5001,2500,0,1,2502,15568112,15.568112
7100,4700,2500,33370000,2,20006,5003,1,502960000,502960000,7501,2500,5001,2500,0,1,2502,16392789,16.392789
7100,4700,2500,33370000,2,20006,5003,1,502960000,502960000,7501,2500,5001,2500,0,1,2502,15613821,15.613821
7100,4700,2500,33370000,2,20006,5003,1,502960000,502960000,7501,2500,5001,2500,0,1,2502,15590731,15.590731
7100,4700,2500,33370000,2,20006,5003,1,502960000,502960000,7501,2500,5001,2500,0,1,2502,16125132,16.125132
7100,4700,2900,33370000,2,23206,5803,1,540720000,540720000,8701,2900,5801,2900,0,1,2902,18061398,18.061398
7100,4700,2900,33370000,2,23206,5803,1,540720000,540720000,8701,2900,5801,2900,0,1,2902,18853457,18.853457
7100,4700,2900,33370000,2,23206,5803,1,540720000,540720000,8701,2900,5801,2900,0,1,2902,18029605,18.029605
7100,4700,2900,33370000,2,23206,5803,1,540720000,540720000,8701,2900,5801,2900,0,1,2902,18973680,18.97368
7100,4700,2900,33370000,2,23206,5803,1,540720000,540720000,8701,2900,5801,2900,0,1,2902,17997129,17.997129
7100,4700,2900,33370000,2,23206,5803,1,540720000,540720000,8701,2900,5801,2900,0,1,2902,18028971,18.028971
7100,4700,2900,33370000,2,23206,5803,1,540720000,540720000,8701,2900,5801,2900,0,1,2902,18645240,18.64524
7100,4700,3300,33370000,2,26406,6603,1,578480000,578480000,9901,3300,6601,3300,0,1,3302,20474469,20.474469
7100,4700,3300,33370000,2,26406,6603,1,578480000,578480000,9901,3300,6601,3300,0,1,3302,21427855,21.427855
7100,4700,3300,33370000,2,26406,6603,1,578480000,578480000,9901,3300,6601,3300,0,1,3302,20497791,20.497791
7100,4700,3300,33370000,2,26406,6603,1,578480000,578480000,9901,3300,6601,3300,0,1,3302,21504005,21.504005
7100,4700,3300,33370000,2,26406,6603,1,578480000,578480000,9901,3300,6601,3300,0,1,3302,20451996,20.451996
7100,4700,3300,33370000,2,26406,6603,1,578480000,578480000,9901,3300,6601,3300,0,1,3302,20475351,20.475351
7100,4700,3300,33370000,2,26406,6603,1,578480000,578480000,9901,3300,6601,3300,0,1,3302,21193142,21.193142
7100,4700,3700,33370000,2,29606,7403,1,616240000,616240000,11101,3700,7401,3700,0,1,3702,22872597,22.872597
7100,4700,3700,33370000,2,29606,7403,1,616240000,616240000,11101,3700,7401,3700,0,1,3702,23903840,23.90384
7100,4700,3700,33370000,2,29606,7403,1,616240000,616240000,11101,3700,7401,3700,0,1,3702,22918403,22.918403
7100,4700,3700,33370000,2,29606,7403,1,616240000,616240000,11101,3700,7401,3700,0,1,3702,24041234,24.041234
7100,4700,3700,33370000,2,29606,7403,1,616240000,616240000,11101,3700,7401,3700,0,1,3702,22895740,22.89574
7100,4700,3700,33370000,2,29606,7403,1,616240000,616240000,11101,3700,7401,3700,0,1,3702,22919174,22.919174
7100,4700,3700,33370000,2,29606,7403,1,616240000,616240000,11101,3700,7401,3700,0,1,3702,23708326,23.708326
7100,4700,4100,33370000,2,32806,8203,1,654000000,654000000,12301,4100,8201,4100,0,1,4102,25323712,25.323712
7100,4700,4100,33370000,2,32806,8203,1,654000000,654000000,12301,4100,8201,4100,0,1,4102,26473010,26.47301
7100,4700,4100,33370000,2,32806,8203,1,654000000,654000000,12301,4100,8201,4100,0,1,4102,25347607,25.347607
7100,4700,4100,33370000,2,32806,8203,1,654000000,654000000,12301,4100,8201,4100,0,1,4102,26655439,26.655439
7100,4700,4100,33370000,2,32806,8203,1,654000000,654000000,12301,4100,8201,4100,0,1,4102,25233664,25.233664
7100,4700,4100,33370000,2,32806,8203,1,654000000,654000000,12301,4100,8201,4100,0,1,4102,25300902,25.300902
7100,4700,4100,33370000,2,32806,8203,1,654000000,654000000,12301,4100,8201,4100,0,1,4102,26221216,26.221216
7100,4700,4500,33370000,2,36006,9003,1,691760000,691760000,13501,4500,9001,4500,0,1,4502,27804837,27.804837
7100,4700,4500,33370000,2,36006,9003,1,691760000,691760000,13501,4500,9001,4500,0,1,4502,29070784,29.070784
7100,4700,4500,33370000,2,36006,9003,1,691760000,691760000,13501,4500,9001,4500,0,1,4502,27843160,27.84316
7100,4700,4500,33370000,2,36006,9003,1,691760000,691760000,13501,4500,9001,4500,0,1,4502,29242650,29.24265
7100,4700,4500,33370000,2,36006,9003,1,691760000,691760000,13501,4500,9001,4500,0,1,4502,27782234,27.782234
7100,4700,4500,33370000,2,36006,9003,1,691760000,691760000,13501,4500,9001,4500,0,1,4502,27806298,27.806298
7100,4700,4500,33370000,2,36006,9003,1,691760000,691760000,13501,4500,9001,4500,0,1,4502,28744679,28.744679
7100,4700,4900,33370000,2,39206,9803,1,729520000,729520000,14701,4900,9801,4900,0,1,4902,30261892,30.261892
7100,4700,4900,33370000,2,39206,9803,1,729520000,729520000,14701,4900,9801,4900,0,1,4902,31675843,31.675843
7100,4700,4900,33370000,2,39206,9803,1,729520000,729520000,14701,4900,9801,4900,0,1,4902,30338511,30.338511
7100,4700,4900,33370000,2,39206,9803,1,729520000,729520000,14701,4900,9801,4900,0,1,4902,31816415,31.816415
7100,4700,4900,33370000,2,39206,9803,1,729520000,729520000,14701,4900,9801,4900,0,1,4902,30300451,30.300451
7100,4700,4900,33370000,2,39206,9803,1,729520000,729520000,14701,4900,9801,4900,0,1,4902,30198685,30.198685
7100,4700,4900,33370000,2,39206,9803,1,729520000,729520000,14701,4900,9801,4900,0,1,4902,31287946,31.287946
7100,4700,5300,33370000,2,42406,10603,1,767280000,767280000,15901,5300,10601,5300,0,1,5302,32664922,32.664922
7100,4700,5300,33370000,2,42406,10603,1,767280000,767280000,15901,5300,10601,5300,0,1,5302,34281932,34.281932
7100,4700,5300,33370000,2,42406,10603,1,767280000,767280000,15901,5300,10601,5300,0,1,5302,32732404,32.732404
7100,4700,5300,33370000,2,42406,10603,1,767280000,767280000,15901,5300,10601,5300,0,1,5302,34397444,34.397444
7100,4700,5300,33370000,2,42406,10603,1,767280000,767280000,15901,5300,10601,5300,0,1,5302,32625659,32.625659
7100,4700,5300,33370000,2,42406,10603,1,767280000,767280000,15901,5300,10601,5300,0,1,5302,32687833,32.687833
7100,4700,5300,33370000,2,42406,10603,1,767280000,767280000,15901,5300,10601,5300,0,1,5302,33821497,33.821497
7100,4700,5700,33370000,2,45606,11403,1,805040000,805040000,17101,5700,11401,5700,0,1,5702,35062863,35.062863
7100,4700,5700,33370000,2,45606,11403,1,805040000,805040000,17101,5700,11401,5700,0,1,5702,36834926,36.834926
7100,4700,5700,33370000,2,45606,11403,1,805040000,805040000,17101,5700,11401,5700,0,1,5702,35264208,35.264208
7100,4700,5700,33370000,2,45606,11403,1,805040000,805040000,17101,5700,11401,5700,0,1,5702,37029511,37.029511
7100,4700,5700,33370000,2,45606,11403,1,805040000,805040000,17101,5700,11401,5700,0,1,5702,35200916,35.200916
7100,4700,5700,33370000,2,45606,11403,1,805040000,805040000,17101,5700,11401,5700,0,1,5702,35241623,35.241623
7100,4700,5700,33370000,2,45606,11403,1,805040000,805040000,17101,5700,11401,5700,0,1,5702,36456535,36.456535
7100,4700,6100,33370000,2,48806,12203,1,842800000,842800000,18301,6100,12201,6100,0,1,6102,37686617,37.686617
7100,4700,6100,33370000,2,48806,12203,1,842800000,842800000,18301,6100,12201,6100,0,1,6102,39470129,39.470129
7100,4700,6100,33370000,2,48806,12203,1,842800000,842800000,18301,6100,12201,6100,0,1,6102,37708794,37.708794
7100,4700,6100,33370000,2,48806,12203,1,842800000,842800000,18301,6100,12201,6100,0,1,6102,39560158,39.560158
7100,4700,6100,33370000,2,48806,12203,1,842800000,842800000,18301,6100,12201,6100,0,1,6102,37643243,37.643243
7100,4700,6100,33370000,2,48806,12203,1,842800000,842800000,18301,6100,12201,6100,0,1,6102,37600756,37.600756
7100,4700,6100,33370000,2,48806,12203,1,842800000,842800000,18301,6100,12201,6100,0,1,6102,38925067,38.925067
7100,4700,6500,33370000,2,52006,13003,1,880560000,880560000,19501,6500,13001,6500,0,1,6502,40126036,40.126036
7100,4700,6500,33370000,2,52006,13003,1,880560000,880560000,19501,6500,13001,6500,0,1,6502,42001841,42.001841
7100,4700,6500,33370000,2,52006,13003,1,880560000,880560000,19501,6500,13001,6500,0,1,6502,40200828,40.200828
7100,4700,6500,33370000,2,52006,13003,1,880560000,880560000,19501,6500,13001,6500,0,1,6502,42226421,42.226421
7100,4700,6500,33370000,2,52006,13003,1,880560000,880560000,19501,6500,13001,6500,0,1,6502,40038096,40.038096
7100,4700,6500,33370000,2,52006,13003,1,880560000,880560000,19501,6500,13001,6500,0,1,6502,40103356,40.103356
7100,4700,6500,33370000,2,52006,13003,1,880560000,880560000,19501,6500,13001,6500,0,1,6502,41584993,41.584993
7100,4700,6900,33370000,2,55206,13803,1,918320000,918320000,20701,6900,13801,6900,0,1,6902,42511938,42.511938
7100,4700,6900,33370000,2,55206,13803,1,918320000,918320000,20701,6900,13801,6900,0,1,6902,44591232,44.591232
7100,4700,6900,33370000,2,55206,13803,1,918320000,918320000,20701,6900,13801,6900,0,1,6902,42659985,42.659985
7100,4700,6900,33370000,2,55206,13803,1,918320000,918320000,20701,6900,13801,6900,0,1,6902,44758809,44.758809
7100,4700,6900,33370000,2,55206,13803,1,918320000,918320000,20701,6900,13801,6900,0,1,6902,42536383,42.536383
7100,4700,6900,33370000,2,55206,13803,1,918320000,918320000,20701,6900,13801,6900,0,1,6902,42489141,42.489141
7100,4700,6900,33370000,2,55206,13803,1,918320000,918320000,20701,6900,13801,6900,0,1,6902,44027682,44.027682
7100,4300,500,30530000,2,4006,1003,1,289840000,289840000,1501,500,1001,500,0,1,502,3234060,3.23406
7100,4300,500,30530000,2,4006,1003,1,289840000,289840000,1501,500,1001,500,0,1,502,3319419,3.319419
7100,4300,500,30530000,2,4006,1003,1,289840000,289840000,1501,500,1001,500,0,1,502,3275606,3.275606
7100,4300,500,30530000,2,4006,1003,1,289840000,289840000,1501,500,1001,500,0,1,502,3319995,3.319995
7100,4300,500,30530000,2,4006,1003,1,289840000,289840000,1501,500,1001,500,0,1,502,3213083,3.213083
7100,4300,500,30530000,2,4006,1003,1,289840000,289840000,1501,500,1001,500,0,1,502,3254819,3.254819
7100,4300,500,30530000,2,4006,1003,1,289840000,289840000,1501,500,1001,500,0,1,502,3297544,3.297544
7100,4300,900,30530000,2,7206,1803,1,326320000,326320000,2701,900,1801,900,0,1,902,5262928,5.262928
7100,4300,900,30530000,2,7206,1803,1,326320000,326320000,2701,900,1801,900,0,1,902,5486836,5.486836
7100,4300,900,30530000,2,7206,1803,1,326320000,326320000,2701,900,1801,900,0,1,902,5310073,5.310073
7100,4300,900,30530000,2,7206,1803,1,326320000,326320000,2701,900,1801,900,0,1,902,5524827,5.524827
7100,4300,900,30530000,2,7206,1803,1,326320000,326320000,2701,900,1801,900,0,1,902,5309520,5.30952
7100,4300,900,30530000,2,7206,1803,1,326320000,326320000,2701,900,1801,900,0,1,902,5288353,5.288353
7100,4300,900,30530000,2,7206,1803,1,326320000,326320000,2701,900,1801,900,0,1,902,5453822,5.453822
7100,4300,1300,30530000,2,10406,2603,1,362800000,362800000,3901,1300,2601,1300,0,1,1302,7631884,7.631884
7100,4300,1300,30530000,2,10406,2603,1,362800000,362800000,3901,1300,2601,1300,0,1,1302,7925350,7.92535
7100,4300,1300,30530000,2,10406,2603,1,362800000,362800000,3901,1300,2601,1300,0,1,1302,7656337,7.656337
7100,4300,1300,30530000,2,10406,2603,1,362800000,362800000,3901,1300,2601,1300,0,1,1302,7988855,7.988855
7100,4300,1300,30530000,2,10406,2603,1,362800000,362800000,3901,1300,2601,1300,0,1,1302,7677753,7.677753
7100,4300,1300,30530000,2,10406,2603,1,362800000,362800000,3901,1300,2601,1300,0,1,1302,7678305,7.678305
7100,4300,1300,30530000,2,10406,2603,1,362800000,362800000,3901,1300,2601,1300,0,1,1302,7869013,7.869013
7100,4300,1700,30530000,2,13606,3403,1,399280000,399280000,5101,1700,3401,1700,0,1,1702,9762848,9.762848
7100,4300,1700,30530000,2,13606,3403,1,399280000,399280000,5101,1700,3401,1700,0,1,1702,10146312,10.146312
7100,4300,1700,30530000,2,13606,3403,1,399280000,399280000,5101,1700,3401,1700,0,1,1702,9761442,9.761442
7100,4300,1700,30530000,2,13606,3403,1,399280000,399280000,5101,1700,3401,1700,0,1,1702,10210029,10.210029
7100,4300,1700,30530000,2,13606,3403,1,399280000,399280000,5101,1700,3401,1700,0,1,1702,9783575,9.783575
7100,4300,1700,30530000,2,13606,3403,1,399280000,399280000,5101,1700,3401,1700,0,1,1702,9740683,9.740683
7100,4300,1700,30530000,2,13606,3403,1,399280000,399280000,5101,1700,3401,1700,0,1,1702,10055561,10.055561
7100,4300,2100,30530000,2,16806,4203,1,435760000,435760000,6301,2100,4201,2100,0,1,2102,12168358,12.168358
7100,4300,2100,30530000,2,16806,4203,1,435760000,435760000,6301,2100,4201,2100,0,1,2102,12649390,12.64939
7100,4300,2100,30530000,2,16806,4203,1,435760000,435760000,6301,2100,4201,2100,0,1,2102,12141486,12.141486
7100,4300,2100,30530000,2,16806,4203,1,435760000,435760000,6301,2100,4201,2100,0,1,2102,12627158,12.627158
7100,4300,2100,30530000,2,16806,4203,1,435760000,435760000,6301,2100,4201,2100,0,1,2102,12120165,12.120165
7100,4300,2100,30530000,2,16806,4203,1,435760000,435760000,6301,2100,4201,2100,0,1,2102,12140804,12.140804
7100,4300,2100,30530000,2,16806,4203,1,435760000,435760000,6301,2100,4201,2100,0,1,2102,12503677,12.503677
7100,4300,2500,30530000,2,20006,5003,1,472240000,472240000,7501,2500,5001,2500,0,1,2502,14350112,14.350112
7100,4300,2500,30530000,2,20006,5003,1,472240000,472240000,7501,2500,5001,2500,0,1,2502,14917831,14.917831
7100,4300,2500,30530000,2,20006,5003,1,472240000,472240000,7501,2500,5001,2500,0,1,2502,14307728,14.307728
7100,4300,2500,30530000,2,20006,5003,1,472240000,472240000,7501,2500,5001,2500,0,1,2502,14996401,14.996401
7100,4300,2500,30530000,2,20006,5003,1,472240000,472240000,7501,2500,5001,2500,0,1,2502,14328991,14.328991
7100,4300,2500,30530000,2,20006,5003,1,472240000,472240000,7501,2500,5001,2500,0,1,2502,14371099,14.371099
7100,4300,2500,30530000,2,20006,5003,1,472240000,472240000,7501,2500,5001,2500,0,1,2502,14760654,14.760654
7100,4300,2900,30530000,2,23206,5803,1,508720000,508720000,8701,2900,5801,2900,0,1,2902,16602757,16.602757
7100,4300,2900,30530000,2,23206,5803,1,508720000,508720000,8701,2900,5801,2900,0,1,2902,17227857,17.227857
7100,4300,2900,30530000,2,23206,5803,1,508720000,508720000,8701,2900,5801,2900,0,1,2902,16530588,16.530588
7100,4300,2900,30530000,2,23206,5803,1,508720000,508720000,8701,2900,5801,2900,0,1,2902,17353489,17.353489
7100,4300,2900,30530000,2,23206,5803,1,508720000,508720000,8701,2900,5801,2900,0,1,2902,16551779,16.551779
7100,4300,2900,30530000,2,23206,5803,1,508720000,508720000,8701,2900,5801,2900,0,1,2902,16573604,16.573604
7100,4300,2900,30530000,2,23206,5803,1,508720000,508720000,8701,2900,5801,2900,0,1,2902,17103080,17.10308
7100,4300,3300,30530000,2,26406,6603,1,545200000,545200000,9901,3300,6601,3300,0,1,3302,18810238,18.810238
7100,4300,3300,30530000,2,26406,6603,1,545200000,545200000,9901,3300,6601,3300,0,1,3302,19581789,19.581789
7100,4300,3300,30530000,2,26406,6603,1,545200000,545200000,9901,3300,6601,3300,0,1,3302,18727735,18.727735
7100,4300,3300,30530000,2,26406,6603,1,545200000,545200000,9901,3300,6601,3300,0,1,3302,19673906,19.673906
7100,4300,3300,30530000,2,26406,6603,1,545200000,545200000,9901,3300,6601,3300,0,1,3302,18696317,18.696317
7100,4300,3300,30530000,2,26406,6603,1,545200000,545200000,9901,3300,6601,3300,0,1,3302,18779841,18.779841
7100,4300,3300,30530000,2,26406,6603,1,545200000,545200000,9901,3300,6601,3300,0,1,3302,19403385,19.403385
7100,4300,3700,30530000,2,29606,7403,1,581680000,581680000,11101,3700,7401,3700,0,1,3702,21033441,21.033441
7100,4300,3700,30530000,2,29606,7403,1,581680000,581680000,11101,3700,7401,3700,0,1,3702,21978787,21.978787
7100,4300,3700,30530000,2,29606,7403,1,581680000,581680000,11101,3700,7401,3700,0,1,3702,21000816,21.000816
7100,4300,3700,30530000,2,29606,7403,1,581680000,581680000,11101,3700,7401,3700,0,1,3702,22053587,22.053587
7100,4300,3700,30530000,2,29606,7403,1,581680000,581680000,11101,3700,7401,3700,0,1,3702,21001948,21.001948
7100,4300,3700,30530000,2,29606,7403,1,581680000,581680000,11101,3700,7401,3700,0,1,3702,20980065,20.980065
7100,4300,3700,30530000,2,29606,7403,1,581680000,581680000,11101,3700,7401,3700,0,1,3702,21704991,21.704991
7100,4300,4100,30530000,2,32806,8203,1,618160000,618160000,12301,4100,8201,4100,0,1,4102,23244886,23.244886
7100,4300,4100,30530000,2,32806,8203,1,618160000,618160000,12301,4100,8201,4100,0,1,4102,24268068,24.268068
7100,4300,4100,30530000,2,32806,8203,1,618160000,618160000,12301,4100,8201,4100,0,1,4102,23202916,23.202916
7100,4300,4100,30530000,2,32806,8203,1,618160000,618160000,12301,4100,8201,4100,0,1,4102,24351816,24.351816
7100,4300,4100,30530000,2,32806,8203,1,618160000,618160000,12301,4100,8201,4100,0,1,4102,23142125,23.142125
7100,4300,4100,30530000,2,32806,8203,1,618160000,618160000,12301,4100,8201,4100,0,1,4102,23277619,23.277619
7100,4300,4100,30530000,2,32806,8203,1,618160000,618160000,12301,4100,8201,4100,0,1,4102,24035632,24.035632
7100,4300,4500,30530000,2,36006,9003,1,654640000,654640000,13501,4500,9001,4500,0,1,4502,25505081,25.505081
7100,4300,4500,30530000,2,36006,9003,1,654640000,654640000,13501,4500,9001,4500,0,1,4502,26655182,26.655182
7100,4300,4500,30530000,2,36006,9003,1,654640000,654640000,13501,4500,9001,4500,0,1,4502,25471160,25.47116
7100,4300,4500,30530000,2,36006,9003,1,654640000,654640000,13501,4500,9001,4500,0,1,4502,26762897,26.762897
7100,4300,4500,30530000,2,36006,9003,1,654640000,654640000,13501,4500,9001,4500,0,1,4502,25437457,25.437457
7100,4300,4500,30530000,2,36006,9003,1,654640000,654640000,13501,4500,9001,4500,0,1,4502,25527254,25.527254
7100,4300,4500,30530000,2,36006,9003,1,654640000,654640000,13501,4500,9001,4500,0,1,4502,26340458,26.340458
7100,4300,4900,30530000,2,39206,9803,1,691120000,691120000,14701,4900,9801,4900,0,1,4902,27751567,27.751567
7100,4300,4900,30530000,2,39206,9803,1,691120000,691120000,14701,4900,9801,4900,0,1,4902,29018126,29.018126
7100,4300,4900,30530000,2,39206,9803,1,691120000,691120000,14701,4900,9801,4900,0,1,4902,27773127,27.773127
7100,4300,4900,30530000,2,39206,9803,1,691120000,691120000,14701,4900,9801,4900,0,1,4902,29094173,29.094173
7100,4300,4900,30530000,2,39206,9803,1,691120000,691120000,14701,4900,9801,4900,0,1,4902,27730606,27.730606
7100,4300,4900,30530000,2,39206,9803,1,691120000,691120000,14701,4900,9801,4900,0,1,4902,27752459,27.752459
7100,4300,4900,30530000,2,39206,9803,1,691120000,691120000,14701,4900,9801,4900,0,1,4902,28693092,28.693092
7100,4300,5300,30530000,2,42406,10603,1,727600000,727600000,15901,5300,10601,5300,0,1,5302,29949250,29.94925
7100,4300,5300,30530000,2,42406,10603,1,727600000,727600000,15901,5300,10601,5300,0,1,5302,31312884,31.312884
7100,4300,5300,30530000,2,42406,10603,1,727600000,727600000,15901,5300,10601,5300,0,1,5302,29928264,29.928264
7100,4300,5300,30530000,2,42406,10603,1,727600000,727600000,15901,5300,10601,5300,0,1,5302,31463709,31.463709
7100,4300,5300,30530000,2,42406,10603,1,727600000,727600000,15901,5300,10601,5300,0,1,5302,29875739,29.875739
7100,4300,5300,30530000,2,42406,10603,1,727600000,727600000,15901,5300,10601,5300,0,1,5302,29970168,29.970168
7100,4300,5300,30530000,2,42406,10603,1,727600000,727600000,15901,5300,10601,5300,0,1,5302,31057499,31.057499
7100,4300,5700,30530000,2,45606,11403,1,764080000,764080000,17101,5700,11401,5700,0,1,5702,32244002,32.244002
7100,4300,5700,30530000,2,45606,11403,1,764080000,764080000,17101,5700,11401,5700,0,1,5702,33754127,33.754127
7100,4300,5700,30530000,2,45606,11403,1,764080000,764080000,17101,5700,11401,5700,0,1,5702,32170478,32.170478
7100,4300,5700,30530000,2,45606,11403,1,764080000,764080000,17101,5700,11401,5700,0,1,5702,33819341,33.819341
7100,4300,5700,30530000,2,45606,11403,1,764080000,764080000,17101,5700,11401,5700,0,1,5702,32133205,32.133205
7100,4300,5700,30530000,2,45606,11403,1,764080000,764080000,17101,5700,11401,5700,0,1,5702,32192596,32.192596
7100,4300,5700,30530000,2,45606,11403,1,764080000,764080000,17101,5700,11401,5700,0,1,5702,33343137,33.343137
7100,4300,6100,30530000,2,48806,12203,1,800560000,800560000,18301,6100,12201,6100,0,1,6102,34516065,34.516065
7100,4300,6100,30530000,2,48806,12203,1,800560000,800560000,18301,6100,12201,6100,0,1,6102,36101061,36.101061
7100,4300,6100,30530000,2,48806,12203,1,800560000,800560000,18301,6100,12201,6100,0,1,6102,34616568,34.616568
7100,4300,6100,30530000,2,48806,12203,1,800560000,800560000,18301,6100,12201,6100,0,1,6102,36375341,36.375341
7100,4300,6100,30530000,2,48806,12203,1,800560000,800560000,18301,6100,12201,6100,0,1,6102,34578163,34.578163
7100,4300,6100,30530000,2,48806,12203,1,800560000,800560000,18301,6100,12201,6100,0,1,6102,34494796,34.494796
7100,4300,6100,30530000,2,48806,12203,1,800560000,800560000,18301,6100,12201,6100,0,1,6102,35710649,35.710649
7100,4300,6500,30530000,2,52006,13003,1,837040000,837040000,19501,6500,13001,6500,0,1,6502,36789405,36.789405
7100,4300,6500,30530000,2,52006,13003,1,837040000,837040000,19501,6500,13001,6500,0,1,6502,38575808,38.575808
7100,4300,6500,30530000,2,52006,13003,1,837040000,837040000,19501,6500,13001,6500,0,1,6502,36768316,36.768316
7100,4300,6500,30530000,2,52006,13003,1,837040000,837040000,19501,6500,13001,6500,0,1,6502,38652184,38.652184
7100,4300,6500,30530000,2,52006,13003,1,837040000,837040000,19501,6500,13001,6500,0,1,6502,36706584,36.706584
7100,4300,6500,30530000,2,52006,13003,1,837040000,837040000,19501,6500,13001,6500,0,1,6502,36641250,36.64125
7100,4300,6500,30530000,2,52006,13003,1,837040000,837040000,19501,6500,13001,6500,0,1,6502,37951665,37.951665
7100,4300,6900,30530000,2,55206,13803,1,873520000,873520000,20701,6900,13801,6900,0,1,6902,38885631,38.885631
7100,4300,6900,30530000,2,55206,13803,1,873520000,873520000,20701,6900,13801,6900,0,1,6902,40847792,40.847792
7100,4300,6900,30530000,2,55206,13803,1,873520000,873520000,20701,6900,13801,6900,0,1,6902,38983112,38.983112
7100,4300,6900,30530000,2,55206,13803,1,873520000,873520000,20701,6900,13801,6900,0,1,6902,40944361,40.944361
7100,4300,6900,30530000,2,55206,13803,1,873520000,873520000,20701,6900,13801,6900,0,1,6902,39004529,39.004529
7100,4300,6900,30530000,2,55206,13803,1,873520000,873520000,20701,6900,13801,6900,0,1,6902,38864737,38.864737
7100,4300,6900,30530000,2,55206,13803,1,873520000,873520000,20701,6900,13801,6900,0,1,6902,40272519,40.272519
7100,3900,500,27690000,2,4006,1003,1,265520000,265520000,1501,500,1001,500,0,1,502,2981414,2.981414
7100,3900,500,27690000,2,4006,1003,1,265520000,265520000,1501,500,1001,500,0,1,502,3024345,3.024345
7100,3900,500,27690000,2,4006,1003,1,265520000,265520000,1501,500,1001,500,0,1,502,2961798,2.961798
7100,3900,500,27690000,2,4006,1003,1,265520000,265520000,1501,500,1001,500,0,1,502,3044362,3.044362
7100,3900,500,27690000,2,4006,1003,1,265520000,265520000,1501,500,1001,500,0,1,502,2942908,2.942908
7100,3900,500,27690000,2,4006,1003,1,265520000,265520000,1501,500,1001,500,0,1,502,2980735,2.980735
7100,3900,500,27690000,2,4006,1003,1,265520000,265520000,1501,500,1001,500,0,1,502,3000970,3.00097
7100,3900,900,27690000,2,7206,1803,1,300720000,300720000,2701,900,1801,900,0,1,902,4804593,4.804593
7100,3900,900,27690000,2,7206,1803,1,300720000,300720000,2701,900,1801,900,0,1,902,5001811,5.001811
7100,3900,900,27690000,2,7206,1803,1,300720000,300720000,2701,900,1801,900,0,1,902,4805095,4.805095
7100,3900,900,27690000,2,7206,1803,1,300720000,300720000,2701,900,1801,900,0,1,902,5021672,5.021672
7100,3900,900,27690000,2,7206,1803,1,300720000,300720000,2701,900,1801,900,0,1,902,4827416,4.827416
7100,3900,900,27690000,2,7206,1803,1,300720000,300720000,2701,900,1801,900,0,1,902,4785717,4.785717
7100,3900,900,27690000,2,7206,1803,1,300720000,300720000,2701,900,1801,900,0,1,902,4944766,4.944766
7100,3900,1300,27690000,2,10406,2603,1,335920000,335920000,3901,1300,2601,1300,0,1,1302,6993474,6.993474
7100,3900,1300,27690000,2,10406,2603,1,335920000,335920000,3901,1300,2601,1300,0,1,1302,7112188,7.112188
7100,3900,1300,27690000,2,10406,2603,1,335920000,335920000,3901,1300,2601,1300,0,1,1302,6803175,6.803175
7100,3900,1300,27690000,2,10406,2603,1,335920000,335920000,3901,1300,2601,1300,0,1,1302,7151720,7.15172
7100,3900,1300,27690000,2,10406,2603,1,335920000,335920000,3901,1300,2601,1300,0,1,1302,7012216,7.012216
7100,3900,1300,27690000,2,10406,2603,1,335920000,335920000,3901,1300,2601,1300,0,1,1302,6906880,6.90688
7100,3900,1300,27690000,2,10406,2603,1,335920000,335920000,3901,1300,2601,1300,0,1,1302,7132462,7.132462
7100,3900,1700,27690000,2,13606,3403,1,371120000,371120000,5101,1700,3401,1700,0,1,1702,8799589,8.799589
7100,3900,1700,27690000,2,13606,3403,1,371120000,371120000,5101,1700,3401,1700,0,1,1702,9300097,9.300097
7100,3900,1700,27690000,2,13606,3403,1,371120000,371120000,5101,1700,3401,1700,0,1,1702,8985726,8.985726
7100,3900,1700,27690000,2,13606,3403,1,371120000,371120000,5101,1700,3401,1700,0,1,1702,9327355,9.327355
7100,3900,1700,27690000,2,13606,3403,1,371120000,371120000,5101,1700,3401,1700,0,1,1702,8883497,8.883497
7100,3900,1700,27690000,2,13606,3403,1,371120000,371120000,5101,1700,3401,1700,0,1,1702,8818362,8.818362
7100,3900,1700,27690000,2,13606,3403,1,371120000,371120000,5101,1700,3401,1700,0,1,1702,9131071,9.131071
7100,3900,2100,27690000,2,16806,4203,1,406320000,406320000,6301,2100,4201,2100,0,1,2102,11004500,11.0045
7100,3900,2100,27690000,2,16806,4203,1,406320000,406320000,6301,2100,4201,2100,0,1,2102,11452023,11.452023
7100,3900,2100,27690000,2,16806,4203,1,406320000,406320000,6301,2100,4201,2100,0,1,2102,10985615,10.985615
7100,3900,2100,27690000,2,16806,4203,1,406320000,406320000,6301,2100,4201,2100,0,1,2102,11507322,11.507322
7100,3900,2100,27690000,2,16806,4203,1,406320000,406320000,6301,2100,4201,2100,0,1,2102,11050496,11.050496
7100,3900,2100,27690000,2,16806,4203,1,406320000,406320000,6301,2100,4201,2100,0,1,2102,11005084,11.005084
7100,3900,2100,27690000,2,16806,4203,1,406320000,406320000,6301,2100,4201,2100,0,1,2102,11338897,11.338897
7100,3900,2500,27690000,2,20006,5003,1,441520000,441520000,7501,2500,5001,2500,0,1,2502,13003723,13.003723
7100,3900,2500,27690000,2,20006,5003,1,441520000,441520000,7501,2500,5001,2500,0,1,2502,13553573,13.553573
7100,3900,2500,27690000,2,20006,5003,1,441520000,441520000,7501,2500,5001,2500,0,1,2502,13023373,13.023373
7100,3900,2500,27690000,2,20006,5003,1,441520000,441520000,7501,2500,5001,2500,0,1,2502,13660539,13.660539
7100,3900,2500,27690000,2,20006,5003,1,441520000,441520000,7501,2500,5001,2500,0,1,2502,13067622,13.067622
7100,3900,2500,27690000,2,20006,5003,1,441520000,441520000,7501,2500,5001,2500,0,1,2502,13022721,13.022721
7100,3900,2500,27690000,2,20006,5003,1,441520000,441520000,7501,2500,5001,2500,0,1,2502,13436893,13.436893
7100,3900,2900,27690000,2,23206,5803,1,476720000,476720000,8701,2900,5801,2900,0,1,2902,15051033,15.051033
7100,3900,2900,27690000,2,23206,5803,1,476720000,476720000,8701,2900,5801,2900,0,1,2902,15666382,15.666382
7100,3900,2900,27690000,2,23206,5803,1,476720000,476720000,8701,2900,5801,2900,0,1,2902,15031908,15.031908
7100,3900,2900,27690000,2,23206,5803,1,476720000,476720000,8701,2900,5801,2900,0,1,2902,15776544,15.776544
7100,3900,2900,27690000,2,23206,5803,1,476720000,476720000,8701,2900,5801,2900,0,1,2902,15051755,15.051755
7100,3900,2900,27690000,2,23206,5803,1,476720000,476720000,8701,2900,5801,2900,0,1,2902,15004797,15.004797
7100,3900,2900,27690000,2,23206,5803,1,476720000,476720000,8701,2900,5801,2900,0,1,2902,15547289,15.547289
7100,3900,3300,27690000,2,26406,6603,1,511920000,511920000,9901,3300,6601,3300,0,1,3302,17083206,17.083206
7100,3900,3300,27690000,2,26406,6603,1,511920000,511920000,9901,3300,6601,3300,0,1,3302,17768772,17.768772
7100,3900,3300,27690000,2,26406,6603,1,511920000,511920000,9901,3300,6601,3300,0,1,3302,17064003,17.064003
7100,3900,3300,27690000,2,26406,6603,1,511920000,511920000,9901,3300,6601,3300,0,1,3302,17856745,17.856745
7100,3900,3300,27690000,2,26406,6603,1,511920000,511920000,9901,3300,6601,3300,0,1,3302,17083947,17.083947
7100,3900,3300,27690000,2,26406,6603,1,511920000,511920000,9901,3300,6601,3300,0,1,3302,16986373,16.986373
7100,3900,3300,27690000,2,26406,6603,1,511920000,511920000,9901,3300,6601,3300,0,1,3302,17617927,17.617927
7100,3900,3700,27690000,2,29606,7403,1,547120000,547120000,11101,3700,7401,3700,0,1,3702,19064534,19.064534
7100,3900,3700,27690000,2,29606,7403,1,547120000,547120000,11101,3700,7401,3700,0,1,3702,19907914,19.907914
7100,3900,3700,27690000,2,29606,7403,1,547120000,547120000,11101,3700,7401,3700,0,1,3702,19063821,19.063821
7100,3900,3700,27690000,2,29606,7403,1,547120000,547120000,11101,3700,7401,3700,0,1,3702,20040633,20.040633
7100,3900,3700,27690000,2,29606,7403,1,547120000,547120000,11101,3700,7401,3700,0,1,3702,19065258,19.065258
7100,3900,3700,27690000,2,29606,7403,1,547120000,547120000,11101,3700,7401,3700,0,1,3702,19044861,19.044861
7100,3900,3700,27690000,2,29606,7403,1,547120000,547120000,11101,3700,7401,3700,0,1,3702,19734211,19.734211
7100,3900,4100,27690000,2,32806,8203,1,582320000,582320000,12301,4100,8201,4100,0,1,4102,21111105,21.111105
7100,3900,4100,27690000,2,32806,8203,1,582320000,582320000,12301,4100,8201,4100,0,1,4102,22010561,22.010561
7100,3900,4100,27690000,2,32806,8203,1,582320000,582320000,12301,4100,8201,4100,0,1,4102,21092051,21.092051
7100,3900,4100,27690000,2,32806,8203,1,582320000,582320000,12301,4100,8201,4100,0,1,4102,22153786,22.153786
7100,3900,4100,27690000,2,32806,8203,1,582320000,582320000,12301,4100,8201,4100,0,1,4102,21000872,21.000872
7100,3900,4100,27690000,2,32806,8203,1,582320000,582320000,12301,4100,8201,4100,0,1,4102,21073204,21.073204
7100,3900,4100,27690000,2,32806,8203,1,582320000,582320000,12301,4100,8201,4100,0,1,4102,21810849,21.810849
7100,3900,4500,27690000,2,36006,9003,1,617520000,617520000,13501,4500,9001,4500,0,1,4502,23081963,23.081963
7100,3900,4500,27690000,2,36006,9003,1,617520000,617520000,13501,4500,9001,4500,0,1,4502,24135586,24.135586
7100,3900,4500,27690000,2,36006,9003,1,617520000,617520000,13501,4500,9001,4500,0,1,4502,23119990,23.11999
7100,3900,4500,27690000,2,36006,9003,1,617520000,617520000,13501,4500,9001,4500,0,1,4502,24296496,24.296496
7100,3900,4500,27690000,2,36006,9003,1,617520000,617520000,13501,4500,9001,4500,0,1,4502,23051336,23.051336
7100,3900,4500,27690000,2,36006,9003,1,617520000,617520000,13501,4500,9001,4500,0,1,4502,23100975,23.100975
7100,3900,4500,27690000,2,36006,9003,1,617520000,617520000,13501,4500,9001,4500,0,1,4502,23903653,23.903653
7100,3900,4900,27690000,2,39206,9803,1,652720000,652720000,14701,4900,9801,4900,0,1,4902,25133037,25.133037
7100,3900,4900,27690000,2,39206,9803,1,652720000,652720000,14701,4900,9801,4900,0,1,4902,26266102,26.266102
7100,3900,4900,27690000,2,39206,9803,1,652720000,652720000,14701,4900,9801,4900,0,1,4902,25113964,25.113964
7100,3900,4900,27690000,2,39206,9803,1,652720000,652720000,14701,4900,9801,4900,0,1,4902,26415700,26.4157
7100,3900,4900,27690000,2,39206,9803,1,652720000,652720000,14701,4900,9801,4900,0,1,4902,24998198,24.998198
7100,3900,4900,27690000,2,39206,9803,1,652720000,652720000,14701,4900,9801,4900,0,1,4902,25095100,25.0951
7100,3900,4900,27690000,2,39206,9803,1,652720000,652720000,14701,4900,9801,4900,0,1,4902,25986795,25.986795
7100,3900,5300,27690000,2,42406,10603,1,687920000,687920000,15901,5300,10601,5300,0,1,5302,27195200,27.1952
7100,3900,5300,27690000,2,42406,10603,1,687920000,687920000,15901,5300,10601,5300,0,1,5302,28407938,28.407938
7100,3900,5300,27690000,2,42406,10603,1,687920000,687920000,15901,5300,10601,5300,0,1,5302,27162326,27.162326
7100,3900,5300,27690000,2,42406,10603,1,687920000,687920000,15901,5300,10601,5300,0,1,5302,28557165,28.557165
7100,3900,5300,27690000,2,42406,10603,1,687920000,687920000,15901,5300,10601,5300,0,1,5302,27051552,27.051552
7100,3900,5300,27690000,2,42406,10603,1,687920000,687920000,15901,5300,10601,5300,0,1,5302,27129561,27.129561
7100,3900,5300,27690000,2,42406,10603,1,687920000,687920000,15901,5300,10601,5300,0,1,5302,28169854,28.169854
7100,3900,5700,27690000,2,45606,11403,1,723120000,723120000,17101,5700,11401,5700,0,1,5702,29210402,29.210402
7100,3900,5700,27690000,2,45606,11403,1,723120000,723120000,17101,5700,11401,5700,0,1,5702,30600370,30.60037
7100,3900,5700,27690000,2,45606,11403,1,723120000,723120000,17101,5700,11401,5700,0,1,5702,29209533,29.209533
7100,3900,5700,27690000,2,45606,11403,1,723120000,723120000,17101,5700,11401,5700,0,1,5702,30708187,30.708187
7100,3900,5700,27690000,2,45606,11403,1,723120000,723120000,17101,5700,11401,5700,0,1,5702,29128237,29.128237
7100,3900,5700,27690000,2,45606,11403,1,723120000,723120000,17101,5700,11401,5700,0,1,5702,29190566,29.190566
7100,3900,5700,27690000,2,45606,11403,1,723120000,723120000,17101,5700,11401,5700,0,1,5702,30261371,30.261371
7100,3900,6100,27690000,2,48806,12203,1,758320000,758320000,18301,6100,12201,6100,0,1,6102,31276911,31.276911
7100,3900,6100,27690000,2,48806,12203,1,758320000,758320000,18301,6100,12201,6100,0,1,6102,32733730,32.73373
7100,3900,6100,27690000,2,48806,12203,1,758320000,758320000,18301,6100,12201,6100,0,1,6102,31349521,31.349521
7100,3900,6100,27690000,2,48806,12203,1,758320000,758320000,18301,6100,12201,6100,0,1,6102,32905138,32.905138
7100,3900,6100,27690000,2,48806,12203,1,758320000,758320000,18301,6100,12201,6100,0,1,6102,31209604,31.209604
7100,3900,6100,27690000,2,48806,12203,1,758320000,758320000,18301,6100,12201,6100,0,1,6102,31164334,31.164334
7100,3900,6100,27690000,2,48806,12203,1,758320000,758320000,18301,6100,12201,6100,0,1,6102,32301779,32.301779
7100,3900,6500,27690000,2,52006,13003,1,793520000,793520000,19501,6500,13001,6500,0,1,6502,33336869,33.336869
7100,3900,6500,27690000,2,52006,13003,1,793520000,793520000,19501,6500,13001,6500,0,1,6502,34885488,34.885488
7100,3900,6500,27690000,2,52006,13003,1,793520000,793520000,19501,6500,13001,6500,0,1,6502,33401566,33.401566
7100,3900,6500,27690000,2,52006,13003,1,793520000,793520000,19501,6500,13001,6500,0,1,6502,35020655,35.020655
7100,3900,6500,27690000,2,52006,13003,1,793520000,793520000,19501,6500,13001,6500,0,1,6502,33318008,33.318008
7100,3900,6500,27690000,2,52006,13003,1,793520000,793520000,19501,6500,13001,6500,0,1,6502,33227332,33.227332
7100,3900,6500,27690000,2,52006,13003,1,793520000,793520000,19501,6500,13001,6500,0,1,6502,34443427,34.443427
7100,3900,6900,27690000,2,55206,13803,1,828720000,828720000,20701,6900,13801,6900,0,1,6902,35359770,35.35977
7100,3900,6900,27690000,2,55206,13803,1,828720000,828720000,20701,6900,13801,6900,0,1,6902,36975986,36.975986
7100,3900,6900,27690000,2,55206,13803,1,828720000,828720000,20701,6900,13801,6900,0,1,6902,35443068,35.443068
7100,3900,6900,27690000,2,55206,13803,1,828720000,828720000,20701,6900,13801,6900,0,1,6902,37140944,37.140944
7100,3900,6900,27690000,2,55206,13803,1,828720000,828720000,20701,6900,13801,6900,0,1,6902,35396862,35.396862
7100,3900,6900,27690000,2,55206,13803,1,828720000,828720000,20701,6900,13801,6900,0,1,6902,35243770,35.24377
7100,3900,6900,27690000,2,55206,13803,1,828720000,828720000,20701,6900,13801,6900,0,1,6902,36559828,36.559828
7100,3500,500,24850000,2,4006,1003,1,241200000,241200000,1501,500,1001,500,0,1,502,2680936,2.680936
7100,3500,500,24850000,2,4006,1003,1,241200000,241200000,1501,500,1001,500,0,1,502,2726795,2.726795
7100,3500,500,24850000,2,4006,1003,1,241200000,241200000,1501,500,1001,500,0,1,502,2637637,2.637637
7100,3500,500,24850000,2,4006,1003,1,241200000,241200000,1501,500,1001,500,0,1,502,2746428,2.746428
7100,3500,500,24850000,2,4006,1003,1,241200000,241200000,1501,500,1001,500,0,1,502,2620389,2.620389
7100,3500,500,24850000,2,4006,1003,1,241200000,241200000,1501,500,1001,500,0,1,502,2663976,2.663976
7100,3500,500,24850000,2,4006,1003,1,241200000,241200000,1501,500,1001,500,0,1,502,2698717,2.698717
7100,3500,900,24850000,2,7206,1803,1,275120000,275120000,2701,900,1801,900,0,1,902,4324323,4.324323
7100,3500,900,24850000,2,7206,1803,1,275120000,275120000,2701,900,1801,900,0,1,902,4475892,4.475892
7100,3500,900,24850000,2,7206,1803,1,275120000,275120000,2701,900,1801,900,0,1,902,4323839,4.323839
7100,3500,900,24850000,2,7206,1803,1,275120000,275120000,2701,900,1801,900,0,1,902,4513103,4.513103
7100,3500,900,24850000,2,7206,1803,1,275120000,275120000,2701,900,1801,900,0,1,902,4341979,4.341979
7100,3500,900,24850000,2,7206,1803,1,275120000,275120000,2701,900,1801,900,0,1,902,4306760,4.30676
7100,3500,900,24850000,2,7206,1803,1,275120000,275120000,2701,900,1801,900,0,1,902,4457958,4.457958
7100,3500,1300,24850000,2,10406,2603,1,309040000,309040000,3901,1300,2601,1300,0,1,1302,6115961,6.115961
7100,3500,1300,24850000,2,10406,2603,1,309040000,309040000,3901,1300,2601,1300,0,1,1302,6363737,6.363737
7100,3500,1300,24850000,2,10406,2603,1,309040000,309040000,3901,1300,2601,1300,0,1,1302,6133011,6.133011
7100,3500,1300,24850000,2,10406,2603,1,309040000,309040000,3901,1300,2601,1300,0,1,1302,6415817,6.415817
7100,3500,1300,24850000,2,10406,2603,1,309040000,309040000,3901,1300,2601,1300,0,1,1302,6160688,6.160688
7100,3500,1300,24850000,2,10406,2603,1,309040000,309040000,3901,1300,2601,1300,0,1,1302,6133571,6.133571
7100,3500,1300,24850000,2,10406,2603,1,309040000,309040000,3901,1300,2601,1300,0,1,1302,6311785,6.311785
7100,3500,1700,24850000,2,13606,3403,1,342960000,342960000,5101,1700,3401,1700,0,1,1702,8094542,8.094542
7100,3500,1700,24850000,2,13606,3403,1,342960000,342960000,5101,1700,3401,1700,0,1,1702,8354927,8.354927
7100,3500,1700,24850000,2,13606,3403,1,342960000,342960000,5101,1700,3401,1700,0,1,1702,8090835,8.090835
7100,3500,1700,24850000,2,13606,3403,1,342960000,342960000,5101,1700,3401,1700,0,1,1702,8418771,8.418771
7100,3500,1700,24850000,2,13606,3403,1,342960000,342960000,5101,1700,3401,1700,0,1,1702,8122800,8.1228
7100,3500,1700,24850000,2,13606,3403,1,342960000,342960000,5101,1700,3401,1700,0,1,1702,8073562,8.073562
7100,3500,1700,24850000,2,13606,3403,1,342960000,342960000,5101,1700,3401,1700,0,1,1702,8291462,8.291462
7100,3500,2100,24850000,2,16806,4203,1,376880000,376880000,6301,2100,4201,2100,0,1,2102,9739620,9.73962
7100,3500,2100,24850000,2,16806,4203,1,376880000,376880000,6301,2100,4201,2100,0,1,2102,10171653,10.171653
7100,3500,2100,24850000,2,16806,4203,1,376880000,376880000,6301,2100,4201,2100,0,1,2102,9738978,9.738978
7100,3500,2100,24850000,2,16806,4203,1,376880000,376880000,6301,2100,4201,2100,0,1,2102,10242939,10.242939
7100,3500,2100,24850000,2,16806,4203,1,376880000,376880000,6301,2100,4201,2100,0,1,2102,9805041,9.805041
7100,3500,2100,24850000,2,16806,4203,1,376880000,376880000,6301,2100,4201,2100,0,1,2102,9721946,9.721946
7100,3500,2100,24850000,2,16806,4203,1,376880000,376880000,6301,2100,4201,2100,0,1,2102,10056723,10.056723
7100,3500,2500,24850000,2,20006,5003,1,410800000,410800000,7501,2500,5001,2500,0,1,2502,11724074,11.724074
7100,3500,2500,24850000,2,20006,5003,1,410800000,410800000,7501,2500,5001,2500,0,1,2502,12141030,12.14103
7100,3500,2500,24850000,2,20006,5003,1,410800000,410800000,7501,2500,5001,2500,0,1,2502,11707099,11.707099
7100,3500,2500,24850000,2,20006,5003,1,410800000,410800000,7501,2500,5001,2500,0,1,2502,12243799,12.243799
7100,3500,2500,24850000,2,20006,5003,1,410800000,410800000,7501,2500,5001,2500,0,1,2502,11747298,11.747298
7100,3500,2500,24850000,2,20006,5003,1,410800000,410800000,7501,2500,5001,2500,0,1,2502,11706447,11.706447
7100,3500,2500,24850000,2,20006,5003,1,410800000,410800000,7501,2500,5001,2500,0,1,2502,12043590,12.04359
7100,3500,2900,24850000,2,23206,5803,1,444720000,444720000,8701,2900,5801,2900,0,1,2902,13532839,13.532839
7100,3500,2900,24850000,2,23206,5803,1,444720000,444720000,8701,2900,5801,2900,0,1,2902,14060454,14.060454
7100,3500,2900,24850000,2,23206,5803,1,444720000,444720000,8701,2900,5801,2900,0,1,2902,13532106,13.532106
7100,3500,2900,24850000,2,23206,5803,1,444720000,444720000,8701,2900,5801,2900,0,1,2902,14104042,14.104042
7100,3500,2900,24850000,2,23206,5803,1,444720000,444720000,8701,2900,5801,2900,0,1,2902,13549931,13.549931
7100,3500,2900,24850000,2,23206,5803,1,444720000,444720000,8701,2900,5801,2900,0,1,2902,13515084,13.515084
7100,3500,2900,24850000,2,23206,5803,1,444720000,444720000,8701,2900,5801,2900,0,1,2902,13919540,13.91954
7100,3500,3300,24850000,2,26406,6603,1,478640000,478640000,9901,3300,6601,3300,0,1,3302,15358902,15.358902
7100,3500,3300,24850000,2,26406,6603,1,478640000,478640000,9901,3300,6601,3300,0,1,3302,15985132,15.985132
7100,3500,3300,24850000,2,26406,6603,1,478640000,478640000,9901,3300,6601,3300,0,1,3302,15324231,15.324231
7100,3500,3300,24850000,2,26406,6603,1,478640000,478640000,9901,3300,6601,3300,0,1,3302,16048835,16.048835
7100,3500,3300,24850000,2,26406,6603,1,478640000,478640000,9901,3300,6601,3300,0,1,3302,15281982,15.281982
7100,3500,3300,24850000,2,26406,6603,1,478640000,478640000,9901,3300,6601,3300,0,1,3302,15342195,15.342195
7100,3500,3300,24850000,2,26406,6603,1,478640000,478640000,9901,3300,6601,3300,0,1,3302,15792583,15.792583
7100,3500,3700,24850000,2,29606,7403,1,512560000,512560000,11101,3700,7401,3700,0,1,3702,17156472,17.156472
7100,3500,3700,24850000,2,29606,7403,1,512560000,512560000,11101,3700,7401,3700,0,1,3702,17850413,17.850413
7100,3500,3700,24850000,2,29606,7403,1,512560000,512560000,11101,3700,7401,3700,0,1,3702,17155947,17.155947
7100,3500,3700,24850000,2,29606,7403,1,512560000,512560000,11101,3700,7401,3700,0,1,3702,18000669,18.000669
7100,3500,3700,24850000,2,29606,7403,1,512560000,512560000,11101,3700,7401,3700,0,1,3702,17137106,17.137106
7100,3500,3700,24850000,2,29606,7403,1,512560000,512560000,11101,3700,7401,3700,0,1,3702,17110741,17.110741
7100,3500,3700,24850000,2,29606,7403,1,512560000,512560000,11101,3700,7401,3700,0,1,3702,17670141,17.670141
7100,3500,4100,24850000,2,32806,8203,1,546480000,546480000,12301,4100,8201,4100,0,1,4102,18961222,18.961222
7100,3500,4100,24850000,2,32806,8203,1,546480000,546480000,12301,4100,8201,4100,0,1,4102,19764412,19.764412
7100,3500,4100,24850000,2,32806,8203,1,546480000,546480000,12301,4100,8201,4100,0,1,4102,18978277,18.978277
7100,3500,4100,24850000,2,32806,8203,1,546480000,546480000,12301,4100,8201,4100,0,1,4102,19897223,19.897223
7100,3500,4100,24850000,2,32806,8203,1,546480000,546480000,12301,4100,8201,4100,0,1,4102,18934296,18.934296
7100,3500,4100,24850000,2,32806,8203,1,546480000,546480000,12301,4100,8201,4100,0,1,4102,18907669,18.907669
7100,3500,4100,24850000,2,32806,8203,1,546480000,546480000,12301,4100,8201,4100,0,1,4102,19576024,19.576024
7100,3500,4500,24850000,2,36006,9003,1,580400000,580400000,13501,4500,9001,4500,0,1,4502,20796658,20.796658
7100,3500,4500,24850000,2,36006,9003,1,580400000,580400000,13501,4500,9001,4500,0,1,4502,21690881,21.690881
7100,3500,4500,24850000,2,36006,9003,1,580400000,580400000,13501,4500,9001,4500,0,1,4502,20745469,20.745469
7100,3500,4500,24850000,2,36006,9003,1,580400000,580400000,13501,4500,9001,4500,0,1,4502,21817986,21.817986
7100,3500,4500,24850000,2,36006,9003,1,580400000,580400000,13501,4500,9001,4500,0,1,4502,20779655,20.779655
7100,3500,4500,24850000,2,36006,9003,1,580400000,580400000,13501,4500,9001,4500,0,1,4502,20762488,20.762488
7100,3500,4500,24850000,2,36006,9003,1,580400000,580400000,13501,4500,9001,4500,0,1,4502,21469229,21.469229
7100,3500,4900,24850000,2,39206,9803,1,614320000,614320000,14701,4900,9801,4900,0,1,4902,22641944,22.641944
7100,3500,4900,24850000,2,39206,9803,1,614320000,614320000,14701,4900,9801,4900,0,1,4902,23585862,23.585862
7100,3500,4900,24850000,2,39206,9803,1,614320000,614320000,14701,4900,9801,4900,0,1,4902,22670684,22.670684
7100,3500,4900,24850000,2,39206,9803,1,614320000,614320000,14701,4900,9801,4900,0,1,4902,23771860,23.77186
7100,3500,4900,24850000,2,39206,9803,1,614320000,614320000,14701,4900,9801,4900,0,1,4902,22559384,22.559384
7100,3500,4900,24850000,2,39206,9803,1,614320000,614320000,14701,4900,9801,4900,0,1,4902,22613261,22.613261
7100,3500,4900,24850000,2,39206,9803,1,614320000,614320000,14701,4900,9801,4900,0,1,4902,23405062,23.405062
7100,3500,5300,24850000,2,42406,10603,1,648240000,648240000,15901,5300,10601,5300,0,1,5302,24448163,24.448163
7100,3500,5300,24850000,2,42406,10603,1,648240000,648240000,15901,5300,10601,5300,0,1,5302,25513446,25.513446
7100,3500,5300,24850000,2,42406,10603,1,648240000,648240000,15901,5300,10601,5300,0,1,5302,24499048,24.499048
7100,3500,5300,24850000,2,42406,10603,1,648240000,648240000,15901,5300,10601,5300,0,1,5302,25673199,25.673199
7100,3500,5300,24850000,2,42406,10603,1,648240000,648240000,15901,5300,10601,5300,0,1,5302,24464756,24.464756
7100,3500,5300,24850000,2,42406,10603,1,648240000,648240000,15901,5300,10601,5300,0,1,5302,24482078,24.482078
7100,3500,5300,24850000,2,42406,10603,1,648240000,648240000,15901,5300,10601,5300,0,1,5302,25199270,25.19927
7100,3500,5700,24850000,2,45606,11403,1,682160000,682160000,17101,5700,11401,5700,0,1,5702,26240265,26.240265
7100,3500,5700,24850000,2,45606,11403,1,682160000,682160000,17101,5700,11401,5700,0,1,5702,27417325,27.417325
7100,3500,5700,24850000,2,45606,11403,1,682160000,682160000,17101,5700,11401,5700,0,1,5702,26333160,26.33316
7100,3500,5700,24850000,2,45606,11403,1,682160000,682160000,17101,5700,11401,5700,0,1,5702,27578863,27.578863
7100,3500,5700,24850000,2,45606,11403,1,682160000,682160000,17101,5700,11401,5700,0,1,5702,26257353,26.257353
7100,3500,5700,24850000,2,45606,11403,1,682160000,682160000,17101,5700,11401,5700,0,1,5702,26287756,26.287756
7100,3500,5700,24850000,2,45606,11403,1,682160000,682160000,17101,5700,11401,5700,0,1,5702,27167252,27.167252
7100,3500,6100,24850000,2,48806,12203,1,716080000,716080000,18301,6100,12201,6100,0,1,6102,28106901,28.106901
7100,3500,6100,24850000,2,48806,12203,1,716080000,716080000,18301,6100,12201,6100,0,1,6102,29336144,29.336144
7100,3500,6100,24850000,2,48806,12203,1,716080000,716080000,18301,6100,12201,6100,0,1,6102,28075415,28.075415
7100,3500,6100,24850000,2,48806,12203,1,716080000,716080000,18301,6100,12201,6100,0,1,6102,29469924,29.469924
7100,3500,6100,24850000,2,48806,12203,1,716080000,716080000,18301,6100,12201,6100,0,1,6102,28074647,28.074647
7100,3500,6100,24850000,2,48806,12203,1,716080000,716080000,18301,6100,12201,6100,0,1,6102,28057499,28.057499
7100,3500,6100,24850000,2,48806,12203,1,716080000,716080000,18301,6100,12201,6100,0,1,6102,29011376,29.011376
7100,3500,6500,24850000,2,52006,13003,1,750000000,750000000,19501,6500,13001,6500,0,1,6502,29937543,29.937543
7100,3500,6500,24850000,2,52006,13003,1,750000000,750000000,19501,6500,13001,6500,0,1,6502,31284368,31.284368
7100,3500,6500,24850000,2,52006,13003,1,750000000,750000000,19501,6500,13001,6500,0,1,6502,29920397,29.920397
7100,3500,6500,24850000,2,52006,13003,1,750000000,750000000,19501,6500,13001,6500,0,1,6502,31450351,31.450351
7100,3500,6500,24850000,2,52006,13003,1,750000000,750000000,19501,6500,13001,6500,0,1,6502,29871147,29.871147
7100,3500,6500,24850000,2,52006,13003,1,750000000,750000000,19501,6500,13001,6500,0,1,6502,29887999,29.887999
7100,3500,6500,24850000,2,52006,13003,1,750000000,750000000,19501,6500,13001,6500,0,1,6502,30919392,30.919392
7100,3500,6900,24850000,2,55206,13803,1,783920000,783920000,20701,6900,13801,6900,0,1,6902,31791741,31.791741
7100,3500,6900,24850000,2,55206,13803,1,783920000,783920000,20701,6900,13801,6900,0,1,6902,33215702,33.215702
7100,3500,6900,24850000,2,55206,13803,1,783920000,783920000,20701,6900,13801,6900,0,1,6902,31833036,31.833036
7100,3500,6900,24850000,2,55206,13803,1,783920000,783920000,20701,6900,13801,6900,0,1,6902,33344051,33.344051
7100,3500,6900,24850000,2,55206,13803,1,783920000,783920000,20701,6900,13801,6900,0,1,6902,31790968,31.790968
7100,3500,6900,24850000,2,55206,13803,1,783920000,783920000,20701,6900,13801,6900,0,1,6902,31757576,31.757576
7100,3500,6900,24850000,2,55206,13803,1,783920000,783920000,20701,6900,13801,6900,0,1,6902,32827731,32.827731
7100,3100,500,22010000,2,4006,1003,1,216880000,216880000,1501,500,1001,500,0,1,502,2394676,2.394676
7100,3100,500,22010000,2,4006,1003,1,216880000,216880000,1501,500,1001,500,0,1,502,2459386,2.459386
7100,3100,500,22010000,2,4006,1003,1,216880000,216880000,1501,500,1001,500,0,1,502,2410470,2.41047
7100,3100,500,22010000,2,4006,1003,1,216880000,216880000,1501,500,1001,500,0,1,502,2411124,2.411124
7100,3100,500,22010000,2,4006,1003,1,216880000,216880000,1501,500,1001,500,0,1,502,2362507,2.362507
7100,3100,500,22010000,2,4006,1003,1,216880000,216880000,1501,500,1001,500,0,1,502,2443585,2.443585
7100,3100,500,22010000,2,4006,1003,1,216880000,216880000,1501,500,1001,500,0,1,502,2428051,2.428051
7100,3100,900,22010000,2,7206,1803,1,249520000,249520000,2701,900,1801,900,0,1,902,3804390,3.80439
7100,3100,900,22010000,2,7206,1803,1,249520000,249520000,2701,900,1801,900,0,1,902,3998006,3.998006
7100,3100,900,22010000,2,7206,1803,1,249520000,249520000,2701,900,1801,900,0,1,902,3836923,3.836923
7100,3100,900,22010000,2,7206,1803,1,249520000,249520000,2701,900,1801,900,0,1,902,3982022,3.982022
7100,3100,900,22010000,2,7206,1803,1,249520000,249520000,2701,900,1801,900,0,1,902,3821389,3.821389
7100,3100,900,22010000,2,7206,1803,1,249520000,249520000,2701,900,1801,900,0,1,902,3836486,3.836486
7100,3100,900,22010000,2,7206,1803,1,249520000,249520000,2701,900,1801,900,0,1,902,3936896,3.936896
7100,3100,1300,22010000,2,10406,2603,1,282160000,282160000,3901,1300,2601,1300,0,1,1302,5398469,5.398469
7100,3100,1300,22010000,2,10406,2603,1,282160000,282160000,3901,1300,2601,1300,0,1,1302,5640910,5.64091
7100,3100,1300,22010000,2,10406,2603,1,282160000,282160000,3901,1300,2601,1300,0,1,1302,5453369,5.453369
7100,3100,1300,22010000,2,10406,2603,1,282160000,282160000,3901,1300,2601,1300,0,1,1302,5674435,5.674435
7100,3100,1300,22010000,2,10406,2603,1,282160000,282160000,3901,1300,2601,1300,0,1,1302,5438246,5.438246
7100,3100,1300,22010000,2,10406,2603,1,282160000,282160000,3901,1300,2601,1300,0,1,1302,5422886,5.422886
7100,3100,1300,22010000,2,10406,2603,1,282160000,282160000,3901,1300,2601,1300,0,1,1302,5597362,5.597362
7100,3100,1700,22010000,2,13606,3403,1,314800000,314800000,5101,1700,3401,1700,0,1,1702,7187785,7.187785
7100,3100,1700,22010000,2,13606,3403,1,314800000,314800000,5101,1700,3401,1700,0,1,1702,7421325,7.421325
7100,3100,1700,22010000,2,13606,3403,1,314800000,314800000,5101,1700,3401,1700,0,1,1702,7203651,7.203651
7100,3100,1700,22010000,2,13606,3403,1,314800000,314800000,5101,1700,3401,1700,0,1,1702,7460563,7.460563
7100,3100,1700,22010000,2,13606,3403,1,314800000,314800000,5101,1700,3401,1700,0,1,1702,7203103,7.203103
7100,3100,1700,22010000,2,13606,3403,1,314800000,314800000,5101,1700,3401,1700,0,1,1702,7218512,7.218512
7100,3100,1700,22010000,2,13606,3403,1,314800000,314800000,5101,1700,3401,1700,0,1,1702,7377725,7.377725
7100,3100,2100,22010000,2,16806,4203,1,347440000,347440000,6301,2100,4201,2100,0,1,2102,8630097,8.630097
7100,3100,2100,22010000,2,16806,4203,1,347440000,347440000,6301,2100,4201,2100,0,1,2102,8998335,8.998335
7100,3100,2100,22010000,2,16806,4203,1,347440000,347440000,6301,2100,4201,2100,0,1,2102,8614446,8.614446
7100,3100,2100,22010000,2,16806,4203,1,347440000,347440000,6301,2100,4201,2100,0,1,2102,9058115,9.058115
7100,3100,2100,22010000,2,16806,4203,1,347440000,347440000,6301,2100,4201,2100,0,1,2102,8681407,8.681407
7100,3100,2100,22010000,2,16806,4203,1,347440000,347440000,6301,2100,4201,2100,0,1,2102,8629630,8.62963
7100,3100,2100,22010000,2,16806,4203,1,347440000,347440000,6301,2100,4201,2100,0,1,2102,8918356,8.918356
7100,3100,2500,22010000,2,20006,5003,1,380080000,380080000,7501,2500,5001,2500,0,1,2502,10392342,10.392342
7100,3100,2500,22010000,2,20006,5003,1,380080000,380080000,7501,2500,5001,2500,0,1,2502,10792293,10.792293
7100,3100,2500,22010000,2,20006,5003,1,380080000,380080000,7501,2500,5001,2500,0,1,2502,10419458,10.419458
7100,3100,2500,22010000,2,20006,5003,1,380080000,380080000,7501,2500,5001,2500,0,1,2502,10861235,10.861235
7100,3100,2500,22010000,2,20006,5003,1,380080000,380080000,7501,2500,5001,2500,0,1,2502,10443681,10.443681
7100,3100,2500,22010000,2,20006,5003,1,380080000,380080000,7501,2500,5001,2500,0,1,2502,10377307,10.377307
7100,3100,2500,22010000,2,20006,5003,1,380080000,380080000,7501,2500,5001,2500,0,1,2502,10713080,10.71308
7100,3100,2900,22010000,2,23206,5803,1,412720000,412720000,8701,2900,5801,2900,0,1,2902,11973641,11.973641
7100,3100,2900,22010000,2,23206,5803,1,412720000,412720000,8701,2900,5801,2900,0,1,2902,12481704,12.481704
7100,3100,2900,22010000,2,23206,5803,1,412720000,412720000,8701,2900,5801,2900,0,1,2902,11989616,11.989616
7100,3100,2900,22010000,2,23206,5803,1,412720000,412720000,8701,2900,5801,2900,0,1,2902,12558953,12.558953
7100,3100,2900,22010000,2,23206,5803,1,412720000,412720000,8701,2900,5801,2900,0,1,2902,12032947,12.032947
7100,3100,2900,22010000,2,23206,5803,1,412720000,412720000,8701,2900,5801,2900,0,1,2902,11989045,11.989045
7100,3100,2900,22010000,2,23206,5803,1,412720000,412720000,8701,2900,5801,2900,0,1,2902,12349206,12.349206
7100,3100,3300,22010000,2,26406,6603,1,445360000,445360000,9901,3300,6601,3300,0,1,3302,13600881,13.600881
7100,3100,3300,22010000,2,26406,6603,1,445360000,445360000,9901,3300,6601,3300,0,1,3302,14143174,14.143174
7100,3100,3300,22010000,2,26406,6603,1,445360000,445360000,9901,3300,6601,3300,0,1,3302,13626011,13.626011
7100,3100,3300,22010000,2,26406,6603,1,445360000,445360000,9901,3300,6601,3300,0,1,3302,14239168,14.239168
7100,3100,3300,22010000,2,26406,6603,1,445360000,445360000,9901,3300,6601,3300,0,1,3302,13673719,13.673719
7100,3100,3300,22010000,2,26406,6603,1,445360000,445360000,9901,3300,6601,3300,0,1,3302,13641115,13.641115
7100,3100,3300,22010000,2,26406,6603,1,445360000,445360000,9901,3300,6601,3300,0,1,3302,14035358,14.035358
7100,3100,3700,22010000,2,29606,7403,1,478000000,478000000,11101,3700,7401,3700,0,1,3702,15174011,15.174011
7100,3100,3700,22010000,2,29606,7403,1,478000000,478000000,11101,3700,7401,3700,0,1,3702,15806577,15.806577
7100,3100,3700,22010000,2,29606,7403,1,478000000,478000000,11101,3700,7401,3700,0,1,3702,15234003,15.234003
7100,3100,3700,22010000,2,29606,7403,1,478000000,478000000,11101,3700,7401,3700,0,1,3702,15956911,15.956911
7100,3100,3700,22010000,2,29606,7403,1,478000000,478000000,11101,3700,7401,3700,0,1,3702,15262545,15.262545
7100,3100,3700,22010000,2,29606,7403,1,478000000,478000000,11101,3700,7401,3700,0,1,3702,15210221,15.210221
7100,3100,3700,22010000,2,29606,7403,1,478000000,478000000,11101,3700,7401,3700,0,1,3702,15690036,15.690036
7100,3100,4100,22010000,2,32806,8203,1,510640000,510640000,12301,4100,8201,4100,0,1,4102,16799249,16.799249
7100,3100,4100,22010000,2,32806,8203,1,510640000,510640000,12301,4100,8201,4100,0,1,4102,17493196,17.493196
7100,3100,4100,22010000,2,32806,8203,1,510640000,510640000,12301,4100,8201,4100,0,1,4102,16848952,16.848952
7100,3100,4100,22010000,2,32806,8203,1,510640000,510640000,12301,4100,8201,4100,0,1,4102,17661311,17.661311
7100,3100,4100,22010000,2,32806,8203,1,510640000,510640000,12301,4100,8201,4100,0,1,4102,16814708,16.814708
7100,3100,4100,22010000,2,32806,8203,1,510640000,510640000,12301,4100,8201,4100,0,1,4102,16815283,16.815283
7100,3100,4100,22010000,2,32806,8203,1,510640000,510640000,12301,4100,8201,4100,0,1,4102,17349405,17.349405
7100,3100,4500,22010000,2,36006,9003,1,543280000,543280000,13501,4500,9001,4500,0,1,4502,18426920,18.42692
7100,3100,4500,22010000,2,36006,9003,1,543280000,543280000,13501,4500,9001,4500,0,1,4502,19232815,19.232815
7100,3100,4500,22010000,2,36006,9003,1,543280000,543280000,13501,4500,9001,4500,0,1,4502,18493158,18.493158
7100,3100,4500,22010000,2,36006,9003,1,543280000,543280000,13501,4500,9001,4500,0,1,4502,19422943,19.422943
7100,3100,4500,22010000,2,36006,9003,1,543280000,543280000,13501,4500,9001,4500,0,1,4502,18442428,18.442428
7100,3100,4500,22010000,2,36006,9003,1,543280000,543280000,13501,4500,9001,4500,0,1,4502,18394320,18.39432
7100,3100,4500,22010000,2,36006,9003,1,543280000,543280000,13501,4500,9001,4500,0,1,4502,19044245,19.044245
7100,3100,4900,22010000,2,39206,9803,1,575920000,575920000,14701,4900,9801,4900,0,1,4902,20016938,20.016938
7100,3100,4900,22010000,2,39206,9803,1,575920000,575920000,14701,4900,9801,4900,0,1,4902,20882037,20.882037
7100,3100,4900,22010000,2,39206,9803,1,575920000,575920000,14701,4900,9801,4900,0,1,4902,20073074,20.073074
7100,3100,4900,22010000,2,39206,9803,1,575920000,575920000,14701,4900,9801,4900,0,1,4902,21057514,21.057514
7100,3100,4900,22010000,2,39206,9803,1,575920000,575920000,14701,4900,9801,4900,0,1,4902,20047652,20.047652
7100,3100,4900,22010000,2,39206,9803,1,575920000,575920000,14701,4900,9801,4900,0,1,4902,20032101,20.032101
7100,3100,4900,22010000,2,39206,9803,1,575920000,575920000,14701,4900,9801,4900,0,1,4902,20676474,20.676474
7100,3100,5300,22010000,2,42406,10603,1,608560000,608560000,15901,5300,10601,5300,0,1,5302,21665357,21.665357
7100,3100,5300,22010000,2,42406,10603,1,608560000,608560000,15901,5300,10601,5300,0,1,5302,22597006,22.597006
7100,3100,5300,22010000,2,42406,10603,1,608560000,608560000,15901,5300,10601,5300,0,1,5302,21692869,21.692869
7100,3100,5300,22010000,2,42406,10603,1,608560000,608560000,15901,5300,10601,5300,0,1,5302,22730558,22.730558
7100,3100,5300,22010000,2,42406,10603,1,608560000,608560000,15901,5300,10601,5300,0,1,5302,21639204,21.639204
7100,3100,5300,22010000,2,42406,10603,1,608560000,608560000,15901,5300,10601,5300,0,1,5302,21624071,21.624071
7100,3100,5300,22010000,2,42406,10603,1,608560000,608560000,15901,5300,10601,5300,0,1,5302,22398519,22.398519
7100,3100,5700,22010000,2,45606,11403,1,641200000,641200000,17101,5700,11401,5700,0,1,5702,23242799,23.242799
7100,3100,5700,22010000,2,45606,11403,1,641200000,641200000,17101,5700,11401,5700,0,1,5702,24252115,24.252115
7100,3100,5700,22010000,2,45606,11403,1,641200000,641200000,17101,5700,11401,5700,0,1,5702,23281834,23.281834
7100,3100,5700,22010000,2,45606,11403,1,641200000,641200000,17101,5700,11401,5700,0,1,5702,24437709,24.437709
7100,3100,5700,22010000,2,45606,11403,1,641200000,641200000,17101,5700,11401,5700,0,1,5702,23160302,23.160302
7100,3100,5700,22010000,2,45606,11403,1,641200000,641200000,17101,5700,11401,5700,0,1,5702,23282561,23.282561
7100,3100,5700,22010000,2,45606,11403,1,641200000,641200000,17101,5700,11401,5700,0,1,5702,24042819,24.042819
7100,3100,6100,22010000,2,48806,12203,1,673840000,673840000,18301,6100,12201,6100,0,1,6102,24884458,24.884458
7100,3100,6100,22010000,2,48806,12203,1,673840000,673840000,18301,6100,12201,6100,0,1,6102,26028924,26.028924
7100,3100,6100,22010000,2,48806,12203,1,673840000,673840000,18301,6100,12201,6100,0,1,6102,24971650,24.97165
7100,3100,6100,22010000,2,48806,12203,1,673840000,673840000,18301,6100,12201,6100,0,1,6102,26172069,26.172069
7100,3100,6100,22010000,2,48806,12203,1,673840000,673840000,18301,6100,12201,6100,0,1,6102,24931607,24.931607
7100,3100,6100,22010000,2,48806,12203,1,673840000,673840000,18301,6100,12201,6100,0,1,6102,24899610,24.89961
7100,3100,6100,22010000,2,48806,12203,1,673840000,673840000,18301,6100,12201,6100,0,1,6102,25712703,25.712703
7100,3100,6500,22010000,2,52006,13003,1,706480000,706480000,19501,6500,13001,6500,0,1,6502,26467976,26.467976
7100,3100,6500,22010000,2,52006,13003,1,706480000,706480000,19501,6500,13001,6500,0,1,6502,27661337,27.661337
7100,3100,6500,22010000,2,52006,13003,1,706480000,706480000,19501,6500,13001,6500,0,1,6502,26589963,26.589963
7100,3100,6500,22010000,2,52006,13003,1,706480000,706480000,19501,6500,13001,6500,0,1,6502,27817926,27.817926
7100,3100,6500,22010000,2,52006,13003,1,706480000,706480000,19501,6500,13001,6500,0,1,6502,26484701,26.484701
7100,3100,6500,22010000,2,52006,13003,1,706480000,706480000,19501,6500,13001,6500,0,1,6502,26499238,26.499238
7100,3100,6500,22010000,2,52006,13003,1,706480000,706480000,19501,6500,13001,6500,0,1,6502,27405390,27.40539
7100,3100,6900,22010000,2,55206,13803,1,739120000,739120000,20701,6900,13801,6900,0,1,6902,28111315,28.111315
7100,3100,6900,22010000,2,55206,13803,1,739120000,739120000,20701,6900,13801,6900,0,1,6902,29371349,29.371349
7100,3100,6900,22010000,2,55206,13803,1,739120000,739120000,20701,6900,13801,6900,0,1,6902,28225438,28.225438
7100,3100,6900,22010000,2,55206,13803,1,739120000,739120000,20701,6900,13801,6900,0,1,6902,29678237,29.678237
7100,3100,6900,22010000,2,55206,13803,1,739120000,739120000,20701,6900,13801,6900,0,1,6902,28126687,28.126687
7100,3100,6900,22010000,2,55206,13803,1,739120000,739120000,20701,6900,13801,6900,0,1,6902,28128415,28.128415
7100,3100,6900,22010000,2,55206,13803,1,739120000,739120000,20701,6900,13801,6900,0,1,6902,29109673,29.109673
7100,2700,500,19170000,2,4006,1003,1,192560000,192560000,1501,500,1001,500,0,1,502,2130114,2.130114
7100,2700,500,19170000,2,4006,1003,1,192560000,192560000,1501,500,1001,500,0,1,502,2130759,2.130759
7100,2700,500,19170000,2,4006,1003,1,192560000,192560000,1501,500,1001,500,0,1,502,2116543,2.116543
7100,2700,500,19170000,2,4006,1003,1,192560000,192560000,1501,500,1001,500,0,1,502,2160533,2.160533
7100,2700,500,19170000,2,4006,1003,1,192560000,192560000,1501,500,1001,500,0,1,502,2071015,2.071015
7100,2700,500,19170000,2,4006,1003,1,192560000,192560000,1501,500,1001,500,0,1,502,2159744,2.159744
7100,2700,500,19170000,2,4006,1003,1,192560000,192560000,1501,500,1001,500,0,1,502,2145573,2.145573
7100,2700,900,19170000,2,7206,1803,1,223920000,223920000,2701,900,1801,900,0,1,902,3320920,3.32092
7100,2700,900,19170000,2,7206,1803,1,223920000,223920000,2701,900,1801,900,0,1,902,3455223,3.455223
7100,2700,900,19170000,2,7206,1803,1,223920000,223920000,2701,900,1801,900,0,1,902,3353236,3.353236
7100,2700,900,19170000,2,7206,1803,1,223920000,223920000,2701,900,1801,900,0,1,902,3499464,3.499464
7100,2700,900,19170000,2,7206,1803,1,223920000,223920000,2701,900,1801,900,0,1,902,3334156,3.334156
7100,2700,900,19170000,2,7206,1803,1,223920000,223920000,2701,900,1801,900,0,1,902,3366386,3.366386
7100,2700,900,19170000,2,7206,1803,1,223920000,223920000,2701,900,1801,900,0,1,902,3441346,3.441346
7100,2700,1300,19170000,2,10406,2603,1,255280000,255280000,3901,1300,2601,1300,0,1,1302,4710818,4.710818
7100,2700,1300,19170000,2,10406,2603,1,255280000,255280000,3901,1300,2601,1300,0,1,1302,4904709,4.904709
7100,2700,1300,19170000,2,10406,2603,1,255280000,255280000,3901,1300,2601,1300,0,1,1302,4724006,4.724006
7100,2700,1300,19170000,2,10406,2603,1,255280000,255280000,3901,1300,2601,1300,0,1,1302,4981742,4.981742
7100,2700,1300,19170000,2,10406,2603,1,255280000,255280000,3901,1300,2601,1300,0,1,1302,4750592,4.750592
7100,2700,1300,19170000,2,10406,2603,1,255280000,255280000,3901,1300,2601,1300,0,1,1302,4737133,4.737133
7100,2700,1300,19170000,2,10406,2603,1,255280000,255280000,3901,1300,2601,1300,0,1,1302,4885019,4.885019
7100,2700,1700,19170000,2,13606,3403,1,286640000,286640000,5101,1700,3401,1700,0,1,1702,6112644,6.112644
7100,2700,1700,19170000,2,13606,3403,1,286640000,286640000,5101,1700,3401,1700,0,1,1702,6386486,6.386486
7100,2700,1700,19170000,2,13606,3403,1,286640000,286640000,5101,1700,3401,1700,0,1,1702,6171257,6.171257
7100,2700,1700,19170000,2,13606,3403,1,286640000,286640000,5101,1700,3401,1700,0,1,1702,6462018,6.462018
7100,2700,1700,19170000,2,13606,3403,1,286640000,286640000,5101,1700,3401,1700,0,1,1702,6157634,6.157634
7100,2700,1700,19170000,2,13606,3403,1,286640000,286640000,5101,1700,3401,1700,0,1,1702,6158135,6.158135
7100,2700,1700,19170000,2,13606,3403,1,286640000,286640000,5101,1700,3401,1700,0,1,1702,6339296,6.339296
7100,2700,2100,19170000,2,16806,4203,1,318000000,318000000,6301,2100,4201,2100,0,1,2102,7684873,7.684873
7100,2700,2100,19170000,2,16806,4203,1,318000000,318000000,6301,2100,4201,2100,0,1,2102,7962457,7.962457
7100,2700,2100,19170000,2,16806,4203,1,318000000,318000000,6301,2100,4201,2100,0,1,2102,7721703,7.721703
7100,2700,2100,19170000,2,16806,4203,1,318000000,318000000,6301,2100,4201,2100,0,1,2102,8006817,8.006817
7100,2700,2100,19170000,2,16806,4203,1,318000000,318000000,6301,2100,4201,2100,0,1,2102,7708551,7.708551
7100,2700,2100,19170000,2,16806,4203,1,318000000,318000000,6301,2100,4201,2100,0,1,2102,7684319,7.684319
7100,2700,2100,19170000,2,16806,4203,1,318000000,318000000,6301,2100,4201,2100,0,1,2102,7918058,7.918058
7100,2700,2500,19170000,2,20006,5003,1,349360000,349360000,7501,2500,5001,2500,0,1,2502,8910597,8.910597
7100,2700,2500,19170000,2,20006,5003,1,349360000,349360000,7501,2500,5001,2500,0,1,2502,9328910,9.32891
7100,2700,2500,19170000,2,20006,5003,1,349360000,349360000,7501,2500,5001,2500,0,1,2502,8985028,8.985028
7100,2700,2500,19170000,2,20006,5003,1,349360000,349360000,7501,2500,5001,2500,0,1,2502,9367122,9.367122
7100,2700,2500,19170000,2,20006,5003,1,349360000,349360000,7501,2500,5001,2500,0,1,2502,8971832,8.971832
7100,2700,2500,19170000,2,20006,5003,1,349360000,349360000,7501,2500,5001,2500,0,1,2502,8934851,8.934851
7100,2700,2500,19170000,2,20006,5003,1,349360000,349360000,7501,2500,5001,2500,0,1,2502,9226474,9.226474
7100,2700,2900,19170000,2,23206,5803,1,380720000,380720000,8701,2900,5801,2900,0,1,2902,10495792,10.495792
7100,2700,2900,19170000,2,23206,5803,1,380720000,380720000,8701,2900,5801,2900,0,1,2902,10927689,10.927689
7100,2700,2900,19170000,2,23206,5803,1,380720000,380720000,8701,2900,5801,2900,0,1,2902,10527775,10.527775
7100,2700,2900,19170000,2,23206,5803,1,380720000,380720000,8701,2900,5801,2900,0,1,2902,10941370,10.94137
7100,2700,2900,19170000,2,23206,5803,1,380720000,380720000,8701,2900,5801,2900,0,1,2902,10514587,10.514587
7100,2700,2900,19170000,2,23206,5803,1,380720000,380720000,8701,2900,5801,2900,0,1,2902,10528343,10.528343
7100,2700,2900,19170000,2,23206,5803,1,380720000,380720000,8701,2900,5801,2900,0,1,2902,10830911,10.830911
7100,2700,3300,19170000,2,26406,6603,1,412080000,412080000,9901,3300,6601,3300,0,1,3302,11946710,11.94671
7100,2700,3300,19170000,2,26406,6603,1,412080000,412080000,9901,3300,6601,3300,0,1,3302,12375809,12.375809
7100,2700,3300,19170000,2,26406,6603,1,412080000,412080000,9901,3300,6601,3300,0,1,3302,11960008,11.960008
7100,2700,3300,19170000,2,26406,6603,1,412080000,412080000,9901,3300,6601,3300,0,1,3302,12406774,12.406774
7100,2700,3300,19170000,2,26406,6603,1,412080000,412080000,9901,3300,6601,3300,0,1,3302,11926030,11.92603
7100,2700,3300,19170000,2,26406,6603,1,412080000,412080000,9901,3300,6601,3300,0,1,3302,11912487,11.912487
7100,2700,3300,19170000,2,26406,6603,1,412080000,412080000,9901,3300,6601,3300,0,1,3302,12284447,12.284447
7100,2700,3700,19170000,2,29606,7403,1,443440000,443440000,11101,3700,7401,3700,0,1,3702,13291061,13.291061
7100,2700,3700,19170000,2,29606,7403,1,443440000,443440000,11101,3700,7401,3700,0,1,3702,13852686,13.852686
7100,2700,3700,19170000,2,29606,7403,1,443440000,443440000,11101,3700,7401,3700,0,1,3702,13270931,13.270931
7100,2700,3700,19170000,2,29606,7403,1,443440000,443440000,11101,3700,7401,3700,0,1,3702,13912461,13.912461
7100,2700,3700,19170000,2,29606,7403,1,443440000,443440000,11101,3700,7401,3700,0,1,3702,13311061,13.311061
7100,2700,3700,19170000,2,29606,7403,1,443440000,443440000,11101,3700,7401,3700,0,1,3702,13324491,13.324491
7100,2700,3700,19170000,2,29606,7403,1,443440000,443440000,11101,3700,7401,3700,0,1,3702,13715857,13.715857
7100,2700,4100,19170000,2,32806,8203,1,474800000,474800000,12301,4100,8201,4100,0,1,4102,14733584,14.733584
7100,2700,4100,19170000,2,32806,8203,1,474800000,474800000,12301,4100,8201,4100,0,1,4102,15324199,15.324199
7100,2700,4100,19170000,2,32806,8203,1,474800000,474800000,12301,4100,8201,4100,0,1,4102,14707079,14.707079
7100,2700,4100,19170000,2,32806,8203,1,474800000,474800000,12301,4100,8201,4100,0,1,4102,15396674,15.396674
7100,2700,4100,19170000,2,32806,8203,1,474800000,474800000,12301,4100,8201,4100,0,1,4102,14673058,14.673058
7100,2700,4100,19170000,2,32806,8203,1,474800000,474800000,12301,4100,8201,4100,0,1,4102,14720307,14.720307
7100,2700,4100,19170000,2,32806,8203,1,474800000,474800000,12301,4100,8201,4100,0,1,4102,15141831,15.141831
7100,2700,4500,19170000,2,36006,9003,1,506160000,506160000,13501,4500,9001,4500,0,1,4502,16103573,16.103573
7100,2700,4500,19170000,2,36006,9003,1,506160000,506160000,13501,4500,9001,4500,0,1,4502,16766036,16.766036
7100,2700,4500,19170000,2,36006,9003,1,506160000,506160000,13501,4500,9001,4500,0,1,4502,16061698,16.061698
7100,2700,4500,19170000,2,36006,9003,1,506160000,506160000,13501,4500,9001,4500,0,1,4502,16899010,16.89901
7100,2700,4500,19170000,2,36006,9003,1,506160000,506160000,13501,4500,9001,4500,0,1,4502,16040266,16.040266
7100,2700,4500,19170000,2,36006,9003,1,506160000,506160000,13501,4500,9001,4500,0,1,4502,16125137,16.125137
7100,2700,4500,19170000,2,36006,9003,1,506160000,506160000,13501,4500,9001,4500,0,1,4502,16612502,16.612502
7100,2700,4900,19170000,2,39206,9803,1,537520000,537520000,14701,4900,9801,4900,0,1,4902,17546525,17.546525
7100,2700,4900,19170000,2,39206,9803,1,537520000,537520000,14701,4900,9801,4900,0,1,4902,18261325,18.261325
7100,2700,4900,19170000,2,39206,9803,1,537520000,537520000,14701,4900,9801,4900,0,1,4902,17516484,17.516484
7100,2700,4900,19170000,2,39206,9803,1,537520000,537520000,14701,4900,9801,4900,0,1,4902,18363106,18.363106
7100,2700,4900,19170000,2,39206,9803,1,537520000,537520000,14701,4900,9801,4900,0,1,4902,17395051,17.395051
7100,2700,4900,19170000,2,39206,9803,1,537520000,537520000,14701,4900,9801,4900,0,1,4902,17503271,17.503271
7100,2700,4900,19170000,2,39206,9803,1,537520000,537520000,14701,4900,9801,4900,0,1,4902,18048556,18.048556
7100,2700,5300,19170000,2,42406,10603,1,568880000,568880000,15901,5300,10601,5300,0,1,5302,18896434,18.896434
7100,2700,5300,19170000,2,42406,10603,1,568880000,568880000,15901,5300,10601,5300,0,1,5302,19711208,19.711208
7100,2700,5300,19170000,2,42406,10603,1,568880000,568880000,15901,5300,10601,5300,0,1,5302,18909708,18.909708
7100,2700,5300,19170000,2,42406,10603,1,568880000,568880000,15901,5300,10601,5300,0,1,5302,19857821,19.857821
7100,2700,5300,19170000,2,42406,10603,1,568880000,568880000,15901,5300,10601,5300,0,1,5302,18937121,18.937121
7100,2700,5300,19170000,2,42406,10603,1,568880000,568880000,15901,5300,10601,5300,0,1,5302,18983873,18.983873
7100,2700,5300,19170000,2,42406,10603,1,568880000,568880000,15901,5300,10601,5300,0,1,5302,19519737,19.519737
7100,2700,5700,19170000,2,45606,11403,1,600240000,600240000,17101,5700,11401,5700,0,1,5702,20357432,20.357432
7100,2700,5700,19170000,2,45606,11403,1,600240000,600240000,17101,5700,11401,5700,0,1,5702,21222305,21.222305
7100,2700,5700,19170000,2,45606,11403,1,600240000,600240000,17101,5700,11401,5700,0,1,5702,20309568,20.309568
7100,2700,5700,19170000,2,45606,11403,1,600240000,600240000,17101,5700,11401,5700,0,1,5702,21316428,21.316428
7100,2700,5700,19170000,2,45606,11403,1,600240000,600240000,17101,5700,11401,5700,0,1,5702,20266863,20.266863
7100,2700,5700,19170000,2,45606,11403,1,600240000,600240000,17101,5700,11401,5700,0,1,5702,20333272,20.333272
7100,2700,5700,19170000,2,45606,11403,1,600240000,600240000,17101,5700,11401,5700,0,1,5702,20998761,20.998761
7100,2700,6100,19170000,2,48806,12203,1,631600000,631600000,18301,6100,12201,6100,0,1,6102,21757874,21.757874
7100,2700,6100,19170000,2,48806,12203,1,631600000,631600000,18301,6100,12201,6100,0,1,6102,22636325,22.636325
7100,2700,6100,19170000,2,48806,12203,1,631600000,631600000,18301,6100,12201,6100,0,1,6102,21726327,21.726327
7100,2700,6100,19170000,2,48806,12203,1,631600000,631600000,18301,6100,12201,6100,0,1,6102,22818190,22.81819
7100,2700,6100,19170000,2,48806,12203,1,631600000,631600000,18301,6100,12201,6100,0,1,6102,21627864,21.627864
7100,2700,6100,19170000,2,48806,12203,1,631600000,631600000,18301,6100,12201,6100,0,1,6102,21696238,21.696238
7100,2700,6100,19170000,2,48806,12203,1,631600000,631600000,18301,6100,12201,6100,0,1,6102,22457636,22.457636
7100,2700,6500,19170000,2,52006,13003,1,662960000,662960000,19501,6500,13001,6500,0,1,6502,23190514,23.190514
7100,2700,6500,19170000,2,52006,13003,1,662960000,662960000,19501,6500,13001,6500,0,1,6502,24147204,24.147204
7100,2700,6500,19170000,2,52006,13003,1,662960000,662960000,19501,6500,13001,6500,0,1,6502,23250709,23.250709
7100,2700,6500,19170000,2,52006,13003,1,662960000,662960000,19501,6500,13001,6500,0,1,6502,24334412,24.334412
7100,2700,6500,19170000,2,52006,13003,1,662960000,662960000,19501,6500,13001,6500,0,1,6502,23081068,23.081068
7100,2700,6500,19170000,2,52006,13003,1,662960000,662960000,19501,6500,13001,6500,0,1,6502,23145285,23.145285
7100,2700,6500,19170000,2,52006,13003,1,662960000,662960000,19501,6500,13001,6500,0,1,6502,23925268,23.925268
7100,2700,6900,19170000,2,55206,13803,1,694320000,694320000,20701,6900,13801,6900,0,1,6902,24573914,24.573914
7100,2700,6900,19170000,2,55206,13803,1,694320000,694320000,20701,6900,13801,6900,0,1,6902,25654959,25.654959
7100,2700,6900,19170000,2,55206,13803,1,694320000,694320000,20701,6900,13801,6900,0,1,6902,24529167,24.529167
7100,2700,6900,19170000,2,55206,13803,1,694320000,694320000,20701,6900,13801,6900,0,1,6902,25764073,25.764073
7100,2700,6900,19170000,2,55206,13803,1,694320000,694320000,20701,6900,13801,6900,0,1,6902,24515916,24.515916
7100,2700,6900,19170000,2,55206,13803,1,694320000,694320000,20701,6900,13801,6900,0,1,6902,24542410,24.54241
7100,2700,6900,19170000,2,55206,13803,1,694320000,694320000,20701,6900,13801,6900,0,1,6902,25402653,25.402653
7100,2300,500,16330000,2,4006,1003,1,168240000,168240000,1501,500,1001,500,0,1,502,1837853,1.837853
7100,2300,500,16330000,2,4006,1003,1,168240000,168240000,1501,500,1001,500,0,1,502,1872408,1.872408
7100,2300,500,16330000,2,4006,1003,1,168240000,168240000,1501,500,1001,500,0,1,502,1849647,1.849647
7100,2300,500,16330000,2,4006,1003,1,168240000,168240000,1501,500,1001,500,0,1,502,1850061,1.850061
7100,2300,500,16330000,2,4006,1003,1,168240000,168240000,1501,500,1001,500,0,1,502,1801954,1.801954
7100,2300,500,16330000,2,4006,1003,1,168240000,168240000,1501,500,1001,500,0,1,502,1825606,1.825606
7100,2300,500,16330000,2,4006,1003,1,168240000,168240000,1501,500,1001,500,0,1,502,1813743,1.813743
7100,2300,900,16330000,2,7206,1803,1,198320000,198320000,2701,900,1801,900,0,1,902,2876415,2.876415
7100,2300,900,16330000,2,7206,1803,1,198320000,198320000,2701,900,1801,900,0,1,902,2979754,2.979754
7100,2300,900,16330000,2,7206,1803,1,198320000,198320000,2701,900,1801,900,0,1,902,2836363,2.836363
7100,2300,900,16330000,2,7206,1803,1,198320000,198320000,2701,900,1801,900,0,1,902,2950095,2.950095
7100,2300,900,16330000,2,7206,1803,1,198320000,198320000,2701,900,1801,900,0,1,902,2847782,2.847782
7100,2300,900,16330000,2,7206,1803,1,198320000,198320000,2701,900,1801,900,0,1,902,2887699,2.887699
7100,2300,900,16330000,2,7206,1803,1,198320000,198320000,2701,900,1801,900,0,1,902,2933910,2.93391
7100,2300,1300,16330000,2,10406,2603,1,228400000,228400000,3901,1300,2601,1300,0,1,1302,4052747,4.052747
7100,2300,1300,16330000,2,10406,2603,1,228400000,228400000,3901,1300,2601,1300,0,1,1302,4211866,4.211866
7100,2300,1300,16330000,2,10406,2603,1,228400000,228400000,3901,1300,2601,1300,0,1,1302,4016564,4.016564
7100,2300,1300,16330000,2,10406,2603,1,228400000,228400000,3901,1300,2601,1300,0,1,1302,4224606,4.224606
7100,2300,1300,16330000,2,10406,2603,1,228400000,228400000,3901,1300,2601,1300,0,1,1302,4041496,4.041496
7100,2300,1300,16330000,2,10406,2603,1,228400000,228400000,3901,1300,2601,1300,0,1,1302,4064000,4.064
7100,2300,1300,16330000,2,10406,2603,1,228400000,228400000,3901,1300,2601,1300,0,1,1302,4157190,4.15719
7100,2300,1700,16330000,2,13606,3403,1,258480000,258480000,5101,1700,3401,1700,0,1,1702,5259154,5.259154
7100,2300,1700,16330000,2,13606,3403,1,258480000,258480000,5101,1700,3401,1700,0,1,1702,5464897,5.464897
7100,2300,1700,16330000,2,13606,3403,1,258480000,258480000,5101,1700,3401,1700,0,1,1702,5208679,5.208679
7100,2300,1700,16330000,2,13606,3403,1,258480000,258480000,5101,1700,3401,1700,0,1,1702,5476730,5.47673
7100,2300,1700,16330000,2,13606,3403,1,258480000,258480000,5101,1700,3401,1700,0,1,1702,5247196,5.247196
7100,2300,1700,16330000,2,13606,3403,1,258480000,258480000,5101,1700,3401,1700,0,1,1702,5235749,5.235749
7100,2300,1700,16330000,2,13606,3403,1,258480000,258480000,5101,1700,3401,1700,0,1,1702,5399975,5.399975
7100,2300,2100,16330000,2,16806,4203,1,288560000,288560000,6301,2100,4201,2100,0,1,2102,6622745,6.622745
7100,2300,2100,16330000,2,16806,4203,1,288560000,288560000,6301,2100,4201,2100,0,1,2102,6802077,6.802077
7100,2300,2100,16330000,2,16806,4203,1,288560000,288560000,6301,2100,4201,2100,0,1,2102,6574304,6.574304
7100,2300,2100,16330000,2,16806,4203,1,288560000,288560000,6301,2100,4201,2100,0,1,2102,6857930,6.85793
7100,2300,2100,16330000,2,16806,4203,1,288560000,288560000,6301,2100,4201,2100,0,1,2102,6541784,6.541784
7100,2300,2100,16330000,2,16806,4203,1,288560000,288560000,6301,2100,4201,2100,0,1,2102,6586283,6.586283
7100,2300,2100,16330000,2,16806,4203,1,288560000,288560000,6301,2100,4201,2100,0,1,2102,6750742,6.750742
7100,2300,2500,16330000,2,20006,5003,1,318640000,318640000,7501,2500,5001,2500,0,1,2502,7629875,7.629875
7100,2300,2500,16330000,2,20006,5003,1,318640000,318640000,7501,2500,5001,2500,0,1,2502,7961701,7.961701
7100,2300,2500,16330000,2,20006,5003,1,318640000,318640000,7501,2500,5001,2500,0,1,2502,7599907,7.599907
7100,2300,2500,16330000,2,20006,5003,1,318640000,318640000,7501,2500,5001,2500,0,1,2502,7990255,7.990255
7100,2300,2500,16330000,2,20006,5003,1,318640000,318640000,7501,2500,5001,2500,0,1,2502,7658990,7.65899
7100,2300,2500,16330000,2,20006,5003,1,318640000,318640000,7501,2500,5001,2500,0,1,2502,7618846,7.618846
7100,2300,2500,16330000,2,20006,5003,1,318640000,318640000,7501,2500,5001,2500,0,1,2502,7879071,7.879071
7100,2300,2900,16330000,2,23206,5803,1,348720000,348720000,8701,2900,5801,2900,0,1,2902,9011984,9.011984
7100,2300,2900,16330000,2,23206,5803,1,348720000,348720000,8701,2900,5801,2900,0,1,2902,9308073,9.308073
7100,2300,2900,16330000,2,23206,5803,1,348720000,348720000,8701,2900,5801,2900,0,1,2902,8947967,8.947967
7100,2300,2900,16330000,2,23206,5803,1,348720000,348720000,8701,2900,5801,2900,0,1,2902,9371534,9.371534
7100,2300,2900,16330000,2,23206,5803,1,348720000,348720000,8701,2900,5801,2900,0,1,2902,9022398,9.022398
7100,2300,2900,16330000,2,23206,5803,1,348720000,348720000,8701,2900,5801,2900,0,1,2902,8970044,8.970044
7100,2300,2900,16330000,2,23206,5803,1,348720000,348720000,8701,2900,5801,2900,0,1,2902,9223701,9.223701
7100,2300,3300,16330000,2,26406,6603,1,378800000,378800000,9901,3300,6601,3300,0,1,3302,10011277,10.011277
7100,2300,3300,16330000,2,26406,6603,1,378800000,378800000,9901,3300,6601,3300,0,1,3302,10462909,10.462909
7100,2300,3300,16330000,2,26406,6603,1,378800000,378800000,9901,3300,6601,3300,0,1,3302,9993111,9.993111
7100,2300,3300,16330000,2,26406,6603,1,378800000,378800000,9901,3300,6601,3300,0,1,3302,10524216,10.524216
7100,2300,3300,16330000,2,26406,6603,1,378800000,378800000,9901,3300,6601,3300,0,1,3302,10058180,10.05818
7100,2300,3300,16330000,2,26406,6603,1,378800000,378800000,9901,3300,6601,3300,0,1,3302,10009685,10.009685
7100,2300,3300,16330000,2,26406,6603,1,378800000,378800000,9901,3300,6601,3300,0,1,3302,10354159,10.354159
7100,2300,3700,16330000,2,29606,7403,1,408880000,408880000,11101,3700,7401,3700,0,1,3702,11394719,11.394719
7100,2300,3700,16330000,2,29606,7403,1,408880000,408880000,11101,3700,7401,3700,0,1,3702,11798938,11.798938
7100,2300,3700,16330000,2,29606,7403,1,408880000,408880000,11101,3700,7401,3700,0,1,3702,11354220,11.35422
7100,2300,3700,16330000,2,29606,7403,1,408880000,408880000,11101,3700,7401,3700,0,1,3702,11892507,11.892507
7100,2300,3700,16330000,2,29606,7403,1,408880000,408880000,11101,3700,7401,3700,0,1,3702,11412160,11.41216
7100,2300,3700,16330000,2,29606,7403,1,408880000,408880000,11101,3700,7401,3700,0,1,3702,11365539,11.365539
7100,2300,3700,16330000,2,29606,7403,1,408880000,408880000,11101,3700,7401,3700,0,1,3702,11697561,11.697561
7100,2300,4100,16330000,2,32806,8203,1,438960000,438960000,12301,4100,8201,4100,0,1,4102,12591342,12.591342
7100,2300,4100,16330000,2,32806,8203,1,438960000,438960000,12301,4100,8201,4100,0,1,4102,13063951,13.063951
7100,2300,4100,16330000,2,32806,8203,1,438960000,438960000,12301,4100,8201,4100,0,1,4102,12560313,12.560313
7100,2300,4100,16330000,2,32806,8203,1,438960000,438960000,12301,4100,8201,4100,0,1,4102,13150754,13.150754
7100,2300,4100,16330000,2,32806,8203,1,438960000,438960000,12301,4100,8201,4100,0,1,4102,12571616,12.571616
7100,2300,4100,16330000,2,32806,8203,1,438960000,438960000,12301,4100,8201,4100,0,1,4102,12548952,12.548952
7100,2300,4100,16330000,2,32806,8203,1,438960000,438960000,12301,4100,8201,4100,0,1,4102,12928677,12.928677
7100,2300,4500,16330000,2,36006,9003,1,469040000,469040000,13501,4500,9001,4500,0,1,4502,13727548,13.727548
7100,2300,4500,16330000,2,36006,9003,1,469040000,469040000,13501,4500,9001,4500,0,1,4502,14323081,14.323081
7100,2300,4500,16330000,2,36006,9003,1,469040000,469040000,13501,4500,9001,4500,0,1,4502,13727007,13.727007
7100,2300,4500,16330000,2,36006,9003,1,469040000,469040000,13501,4500,9001,4500,0,1,4502,14423348,14.423348
7100,2300,4500,16330000,2,36006,9003,1,469040000,469040000,13501,4500,9001,4500,0,1,4502,13708601,13.708601
7100,2300,4500,16330000,2,36006,9003,1,469040000,469040000,13501,4500,9001,4500,0,1,4502,13760528,13.760528
7100,2300,4500,16330000,2,36006,9003,1,469040000,469040000,13501,4500,9001,4500,0,1,4502,14228067,14.228067
7100,2300,4900,16330000,2,39206,9803,1,499120000,499120000,14701,4900,9801,4900,0,1,4902,14943454,14.943454
7100,2300,4900,16330000,2,39206,9803,1,499120000,499120000,14701,4900,9801,4900,0,1,4902,15593159,15.593159
7100,2300,4900,16330000,2,39206,9803,1,499120000,499120000,14701,4900,9801,4900,0,1,4902,14942876,14.942876
7100,2300,4900,16330000,2,39206,9803,1,499120000,499120000,14701,4900,9801,4900,0,1,4902,15695242,15.695242
7100,2300,4900,16330000,2,39206,9803,1,499120000,499120000,14701,4900,9801,4900,0,1,4902,14965074,14.965074
7100,2300,4900,16330000,2,39206,9803,1,499120000,499120000,14701,4900,9801,4900,0,1,4902,14965666,14.965666
7100,2300,4900,16330000,2,39206,9803,1,499120000,499120000,14701,4900,9801,4900,0,1,4902,15485554,15.485554
7100,2300,5300,16330000,2,42406,10603,1,529200000,529200000,15901,5300,10601,5300,0,1,5302,16127898,16.127898
7100,2300,5300,16330000,2,42406,10603,1,529200000,529200000,15901,5300,10601,5300,0,1,5302,16839120,16.83912
7100,2300,5300,16330000,2,42406,10603,1,529200000,529200000,15901,5300,10601,5300,0,1,5302,16139353,16.139353
7100,2300,5300,16330000,2,42406,10603,1,529200000,529200000,15901,5300,10601,5300,0,1,5302,16966046,16.966046
7100,2300,5300,16330000,2,42406,10603,1,529200000,529200000,15901,5300,10601,5300,0,1,5302,16139904,16.139904
7100,2300,5300,16330000,2,42406,10603,1,529200000,529200000,15901,5300,10601,5300,0,1,5302,16151247,16.151247
7100,2300,5300,16330000,2,42406,10603,1,529200000,529200000,15901,5300,10601,5300,0,1,5302,16710281,16.710281
7100,2300,5700,16330000,2,45606,11403,1,559280000,559280000,17101,5700,11401,5700,0,1,5702,17351297,17.351297
7100,2300,5700,16330000,2,45606,11403,1,559280000,559280000,17101,5700,11401,5700,0,1,5702,18079848,18.079848
7100,2300,5700,16330000,2,45606,11403,1,559280000,559280000,17101,5700,11401,5700,0,1,5702,17371622,17.371622
7100,2300,5700,16330000,2,45606,11403,1,559280000,559280000,17101,5700,11401,5700,0,1,5702,18210563,18.210563
7100,2300,5700,16330000,2,45606,11403,1,559280000,559280000,17101,5700,11401,5700,0,1,5702,17330972,17.330972
7100,2300,5700,16330000,2,45606,11403,1,559280000,559280000,17101,5700,11401,5700,0,1,5702,17330383,17.330383
7100,2300,5700,16330000,2,45606,11403,1,559280000,559280000,17101,5700,11401,5700,0,1,5702,17942885,17.942885
7100,2300,6100,16330000,2,48806,12203,1,589360000,589360000,18301,6100,12201,6100,0,1,6102,18565204,18.565204
7100,2300,6100,16330000,2,48806,12203,1,589360000,589360000,18301,6100,12201,6100,0,1,6102,19333866,19.333866
7100,2300,6100,16330000,2,48806,12203,1,589360000,589360000,18301,6100,12201,6100,0,1,6102,18586186,18.586186
7100,2300,6100,16330000,2,48806,12203,1,589360000,589360000,18301,6100,12201,6100,0,1,6102,19508946,19.508946
7100,2300,6100,16330000,2,48806,12203,1,589360000,589360000,18301,6100,12201,6100,0,1,6102,18506375,18.506375
7100,2300,6100,16330000,2,48806,12203,1,589360000,589360000,18301,6100,12201,6100,0,1,6102,18533613,18.533613
7100,2300,6100,16330000,2,48806,12203,1,589360000,589360000,18301,6100,12201,6100,0,1,6102,19144360,19.14436
7100,2300,6500,16330000,2,52006,13003,1,619440000,619440000,19501,6500,13001,6500,0,1,6502,19753067,19.753067
7100,2300,6500,16330000,2,52006,13003,1,619440000,619440000,19501,6500,13001,6500,0,1,6502,20572451,20.572451
7100,2300,6500,16330000,2,52006,13003,1,619440000,619440000,19501,6500,13001,6500,0,1,6502,19764511,19.764511
7100,2300,6500,16330000,2,52006,13003,1,619440000,619440000,19501,6500,13001,6500,0,1,6502,20736807,20.736807
7100,2300,6500,16330000,2,52006,13003,1,619440000,619440000,19501,6500,13001,6500,0,1,6502,19786204,19.786204
7100,2300,6500,16330000,2,52006,13003,1,619440000,619440000,19501,6500,13001,6500,0,1,6502,19728672,19.728672
7100,2300,6500,16330000,2,52006,13003,1,619440000,619440000,19501,6500,13001,6500,0,1,6502,20398424,20.398424
7100,2300,6900,16330000,2,55206,13803,1,649520000,649520000,20701,6900,13801,6900,0,1,6902,20954511,20.954511
7100,2300,6900,16330000,2,55206,13803,1,649520000,649520000,20701,6900,13801,6900,0,1,6902,21875451,21.875451
7100,2300,6900,16330000,2,55206,13803,1,649520000,649520000,20701,6900,13801,6900,0,1,6902,20953746,20.953746
7100,2300,6900,16330000,2,55206,13803,1,649520000,649520000,20701,6900,13801,6900,0,1,6902,21980683,21.980683
7100,2300,6900,16330000,2,55206,13803,1,649520000,649520000,20701,6900,13801,6900,0,1,6902,20965955,20.965955
7100,2300,6900,16330000,2,55206,13803,1,649520000,649520000,20701,6900,13801,6900,0,1,6902,20977276,20.977276
7100,2300,6900,16330000,2,55206,13803,1,649520000,649520000,20701,6900,13801,6900,0,1,6902,21622921,21.622921
7100,1900,500,13490000,2,4006,1003,1,143920000,143920000,1501,500,1001,500,0,1,502,1551001,1.551001
7100,1900,500,13490000,2,4006,1003,1,143920000,143920000,1501,500,1001,500,0,1,502,1540906,1.540906
7100,1900,500,13490000,2,4006,1003,1,143920000,143920000,1501,500,1001,500,0,1,502,1550716,1.550716
7100,1900,500,13490000,2,4006,1003,1,143920000,143920000,1501,500,1001,500,0,1,502,1560915,1.560915
7100,1900,500,13490000,2,4006,1003,1,143920000,143920000,1501,500,1001,500,0,1,502,1492802,1.492802
7100,1900,500,13490000,2,4006,1003,1,143920000,143920000,1501,500,1001,500,0,1,502,1529611,1.529611
7100,1900,500,13490000,2,4006,1003,1,143920000,143920000,1501,500,1001,500,0,1,502,1540273,1.540273
7100,1900,900,13490000,2,7206,1803,1,172720000,172720000,2701,900,1801,900,0,1,902,2367598,2.367598
7100,1900,900,13490000,2,7206,1803,1,172720000,172720000,2701,900,1801,900,0,1,902,2439400,2.4394
7100,1900,900,13490000,2,7206,1803,1,172720000,172720000,2701,900,1801,900,0,1,902,2341572,2.341572
7100,1900,900,13490000,2,7206,1803,1,172720000,172720000,2701,900,1801,900,0,1,902,2449503,2.449503
7100,1900,900,13490000,2,7206,1803,1,172720000,172720000,2701,900,1801,900,0,1,902,2353320,2.35332
7100,1900,900,13490000,2,7206,1803,1,172720000,172720000,2701,900,1801,900,0,1,902,2394319,2.394319
7100,1900,900,13490000,2,7206,1803,1,172720000,172720000,2701,900,1801,900,0,1,902,2418013,2.418013
7100,1900,1300,13490000,2,10406,2603,1,201520000,201520000,3901,1300,2601,1300,0,1,1302,3342582,3.342582
7100,1900,1300,13490000,2,10406,2603,1,201520000,201520000,3901,1300,2601,1300,0,1,1302,3479257,3.479257
7100,1900,1300,13490000,2,10406,2603,1,201520000,201520000,3901,1300,2601,1300,0,1,1302,3333135,3.333135
7100,1900,1300,13490000,2,10406,2603,1,201520000,201520000,3901,1300,2601,1300,0,1,1302,3489179,3.489179
7100,1900,1300,13490000,2,10406,2603,1,201520000,201520000,3901,1300,2601,1300,0,1,1302,3352272,3.352272
7100,1900,1300,13490000,2,10406,2603,1,201520000,201520000,3901,1300,2601,1300,0,1,1302,3352675,3.352675
7100,1900,1300,13490000,2,10406,2603,1,201520000,201520000,3901,1300,2601,1300,0,1,1302,3432530,3.43253
7100,1900,1700,13490000,2,13606,3403,1,230320000,230320000,5101,1700,3401,1700,0,1,1702,4327339,4.327339
7100,1900,1700,13490000,2,13606,3403,1,230320000,230320000,5101,1700,3401,1700,0,1,1702,4510139,4.510139
7100,1900,1700,13490000,2,13606,3403,1,230320000,230320000,5101,1700,3401,1700,0,1,1702,4317856,4.317856
7100,1900,1700,13490000,2,13606,3403,1,230320000,230320000,5101,1700,3401,1700,0,1,1702,4534048,4.534048
7100,1900,1700,13490000,2,13606,3403,1,230320000,230320000,5101,1700,3401,1700,0,1,1702,4349369,4.349369
7100,1900,1700,13490000,2,13606,3403,1,230320000,230320000,5101,1700,3401,1700,0,1,1702,4336633,4.336633
7100,1900,1700,13490000,2,13606,3403,1,230320000,230320000,5101,1700,3401,1700,0,1,1702,4462686,4.462686
7100,1900,2100,13490000,2,16806,4203,1,259120000,259120000,6301,2100,4201,2100,0,1,2102,5311506,5.311506
7100,1900,2100,13490000,2,16806,4203,1,259120000,259120000,6301,2100,4201,2100,0,1,2102,5544041,5.544041
7100,1900,2100,13490000,2,16806,4203,1,259120000,259120000,6301,2100,4201,2100,0,1,2102,5311008,5.311008
7100,1900,2100,13490000,2,16806,4203,1,259120000,259120000,6301,2100,4201,2100,0,1,2102,5570242,5.570242
7100,1900,2100,13490000,2,16806,4203,1,259120000,259120000,6301,2100,4201,2100,0,1,2102,5346703,5.346703
7100,1900,2100,13490000,2,16806,4203,1,259120000,259120000,6301,2100,4201,2100,0,1,2102,5320913,5.320913
7100,1900,2100,13490000,2,16806,4203,1,259120000,259120000,6301,2100,4201,2100,0,1,2102,5491547,5.491547
7100,1900,2500,13490000,2,20006,5003,1,287920000,287920000,7501,2500,5001,2500,0,1,2502,6464869,6.464869
7100,1900,2500,13490000,2,20006,5003,1,287920000,287920000,7501,2500,5001,2500,0,1,2502,6681349,6.681349
7100,1900,2500,13490000,2,20006,5003,1,287920000,287920000,7501,2500,5001,2500,0,1,2502,6441384,6.441384
7100,1900,2500,13490000,2,20006,5003,1,287920000,287920000,7501,2500,5001,2500,0,1,2502,6710201,6.710201
7100,1900,2500,13490000,2,20006,5003,1,287920000,287920000,7501,2500,5001,2500,0,1,2502,6474467,6.474467
7100,1900,2500,13490000,2,20006,5003,1,287920000,287920000,7501,2500,5001,2500,0,1,2502,6483831,6.483831
7100,1900,2500,13490000,2,20006,5003,1,287920000,287920000,7501,2500,5001,2500,0,1,2502,6651162,6.651162
7100,1900,2900,13490000,2,23206,5803,1,316720000,316720000,8701,2900,5801,2900,0,1,2902,7278055,7.278055
7100,1900,2900,13490000,2,23206,5803,1,316720000,316720000,8701,2900,5801,2900,0,1,2902,7624783,7.624783
7100,1900,2900,13490000,2,23206,5803,1,316720000,316720000,8701,2900,5801,2900,0,1,2902,7291333,7.291333
7100,1900,2900,13490000,2,23206,5803,1,316720000,316720000,8701,2900,5801,2900,0,1,2902,7653866,7.653866
7100,1900,2900,13490000,2,23206,5803,1,316720000,316720000,8701,2900,5801,2900,0,1,2902,7342842,7.342842
7100,1900,2900,13490000,2,23206,5803,1,316720000,316720000,8701,2900,5801,2900,0,1,2902,7300755,7.300755
7100,1900,2900,13490000,2,23206,5803,1,316720000,316720000,8701,2900,5801,2900,0,1,2902,7538222,7.538222
7100,1900,3300,13490000,2,26406,6603,1,345520000,345520000,9901,3300,6601,3300,0,1,3302,8454531,8.454531
7100,1900,3300,13490000,2,26406,6603,1,345520000,345520000,9901,3300,6601,3300,0,1,3302,8749881,8.749881
7100,1900,3300,13490000,2,26406,6603,1,345520000,345520000,9901,3300,6601,3300,0,1,3302,8430412,8.430412
7100,1900,3300,13490000,2,26406,6603,1,345520000,345520000,9901,3300,6601,3300,0,1,3302,8836570,8.83657
7100,1900,3300,13490000,2,26406,6603,1,345520000,345520000,9901,3300,6601,3300,0,1,3302,8485898,8.485898
7100,1900,3300,13490000,2,26406,6603,1,345520000,345520000,9901,3300,6601,3300,0,1,3302,8439917,8.439917
7100,1900,3300,13490000,2,26406,6603,1,345520000,345520000,9901,3300,6601,3300,0,1,3302,8699378,8.699378
7100,1900,3700,13490000,2,29606,7403,1,374320000,374320000,11101,3700,7401,3700,0,1,3702,9251681,9.251681
7100,1900,3700,13490000,2,29606,7403,1,374320000,374320000,11101,3700,7401,3700,0,1,3702,9699918,9.699918
7100,1900,3700,13490000,2,29606,7403,1,374320000,374320000,11101,3700,7401,3700,0,1,3702,9271279,9.271279
7100,1900,3700,13490000,2,29606,7403,1,374320000,374320000,11101,3700,7401,3700,0,1,3702,9770266,9.770266
7100,1900,3700,13490000,2,29606,7403,1,374320000,374320000,11101,3700,7401,3700,0,1,3702,9343057,9.343057
7100,1900,3700,13490000,2,29606,7403,1,374320000,374320000,11101,3700,7401,3700,0,1,3702,9280785,9.280785
7100,1900,3700,13490000,2,29606,7403,1,374320000,374320000,11101,3700,7401,3700,0,1,3702,9617980,9.61798
7100,1900,4100,13490000,2,32806,8203,1,403120000,403120000,12301,4100,8201,4100,0,1,4102,10432286,10.432286
7100,1900,4100,13490000,2,32806,8203,1,403120000,403120000,12301,4100,8201,4100,0,1,4102,10862267,10.862267
7100,1900,4100,13490000,2,32806,8203,1,403120000,403120000,12301,4100,8201,4100,0,1,4102,10406808,10.406808
7100,1900,4100,13490000,2,32806,8203,1,403120000,403120000,12301,4100,8201,4100,0,1,4102,10898511,10.898511
7100,1900,4100,13490000,2,32806,8203,1,403120000,403120000,12301,4100,8201,4100,0,1,4102,10460025,10.460025
7100,1900,4100,13490000,2,32806,8203,1,403120000,403120000,12301,4100,8201,4100,0,1,4102,10422863,10.422863
7100,1900,4100,13490000,2,32806,8203,1,403120000,403120000,12301,4100,8201,4100,0,1,4102,10726054,10.726054
7100,1900,4500,13490000,2,36006,9003,1,431920000,431920000,13501,4500,9001,4500,0,1,4502,11418786,11.418786
7100,1900,4500,13490000,2,36006,9003,1,431920000,431920000,13501,4500,9001,4500,0,1,4502,11854519,11.854519
7100,1900,4500,13490000,2,36006,9003,1,431920000,431920000,13501,4500,9001,4500,0,1,4502,11403401,11.403401
7100,1900,4500,13490000,2,36006,9003,1,431920000,431920000,13501,4500,9001,4500,0,1,4502,11945698,11.945698
7100,1900,4500,13490000,2,36006,9003,1,431920000,431920000,13501,4500,9001,4500,0,1,4502,11449695,11.449695
7100,1900,4500,13490000,2,36006,9003,1,431920000,431920000,13501,4500,9001,4500,0,1,4502,11393907,11.393907
7100,1900,4500,13490000,2,36006,9003,1,431920000,431920000,13501,4500,9001,4500,0,1,4502,11749428,11.749428
7100,1900,4900,13490000,2,39206,9803,1,460720000,460720000,14701,4900,9801,4900,0,1,4902,12463381,12.463381
7100,1900,4900,13490000,2,39206,9803,1,460720000,460720000,14701,4900,9801,4900,0,1,4902,12914541,12.914541
7100,1900,4900,13490000,2,39206,9803,1,460720000,460720000,14701,4900,9801,4900,0,1,4902,12375156,12.375156
7100,1900,4900,13490000,2,39206,9803,1,460720000,460720000,14701,4900,9801,4900,0,1,4902,13010270,13.01027
7100,1900,4900,13490000,2,39206,9803,1,460720000,460720000,14701,4900,9801,4900,0,1,4902,12426829,12.426829
7100,1900,4900,13490000,2,39206,9803,1,460720000,460720000,14701,4900,9801,4900,0,1,4902,12393825,12.393825
7100,1900,4900,13490000,2,39206,9803,1,460720000,460720000,14701,4900,9801,4900,0,1,4902,12868922,12.868922
7100,1900,5300,13490000,2,42406,10603,1,489520000,489520000,15901,5300,10601,5300,0,1,5302,13386452,13.386452
7100,1900,5300,13490000,2,42406,10603,1,489520000,489520000,15901,5300,10601,5300,0,1,5302,13998765,13.998765
7100,1900,5300,13490000,2,42406,10603,1,489520000,489520000,15901,5300,10601,5300,0,1,5302,13377000,13.377
7100,1900,5300,13490000,2,42406,10603,1,489520000,489520000,15901,5300,10601,5300,0,1,5302,14075671,14.075671
7100,1900,5300,13490000,2,42406,10603,1,489520000,489520000,15901,5300,10601,5300,0,1,5302,13396109,13.396109
7100,1900,5300,13490000,2,42406,10603,1,489520000,489520000,15901,5300,10601,5300,0,1,5302,13460430,13.46043
7100,1900,5300,13490000,2,42406,10603,1,489520000,489520000,15901,5300,10601,5300,0,1,5302,13800760,13.80076
7100,1900,5700,13490000,2,45606,11403,1,518320000,518320000,17101,5700,11401,5700,0,1,5702,14385384,14.385384
7100,1900,5700,13490000,2,45606,11403,1,518320000,518320000,17101,5700,11401,5700,0,1,5702,15009805,15.009805
7100,1900,5700,13490000,2,45606,11403,1,518320000,518320000,17101,5700,11401,5700,0,1,5702,14375931,14.375931
7100,1900,5700,13490000,2,45606,11403,1,518320000,518320000,17101,5700,11401,5700,0,1,5702,15072435,15.072435
7100,1900,5700,13490000,2,45606,11403,1,518320000,518320000,17101,5700,11401,5700,0,1,5702,14359047,14.359047
7100,1900,5700,13490000,2,45606,11403,1,518320000,518320000,17101,5700,11401,5700,0,1,5702,14409504,14.409504
7100,1900,5700,13490000,2,45606,11403,1,518320000,518320000,17101,5700,11401,5700,0,1,5702,14822341,14.822341
7100,1900,6100,13490000,2,48806,12203,1,547120000,547120000,18301,6100,12201,6100,0,1,6102,15395439,15.395439
7100,1900,6100,13490000,2,48806,12203,1,547120000,547120000,18301,6100,12201,6100,0,1,6102,16054979,16.054979
7100,1900,6100,13490000,2,48806,12203,1,547120000,547120000,18301,6100,12201,6100,0,1,6102,15377955,15.377955
7100,1900,6100,13490000,2,48806,12203,1,547120000,547120000,18301,6100,12201,6100,0,1,6102,16132441,16.132441
7100,1900,6100,13490000,2,48806,12203,1,547120000,547120000,18301,6100,12201,6100,0,1,6102,15312020,15.31202
7100,1900,6100,13490000,2,48806,12203,1,547120000,547120000,18301,6100,12201,6100,0,1,6102,15435896,15.435896
7100,1900,6100,13490000,2,48806,12203,1,547120000,547120000,18301,6100,12201,6100,0,1,6102,15868857,15.868857
7100,1900,6500,13490000,2,52006,13003,1,575920000,575920000,19501,6500,13001,6500,0,1,6502,16363734,16.363734
7100,1900,6500,13490000,2,52006,13003,1,575920000,575920000,19501,6500,13001,6500,0,1,6502,17058729,17.058729
7100,1900,6500,13490000,2,52006,13003,1,575920000,575920000,19501,6500,13001,6500,0,1,6502,16354227,16.354227
7100,1900,6500,13490000,2,52006,13003,1,575920000,575920000,19501,6500,13001,6500,0,1,6502,17185490,17.18549
7100,1900,6500,13490000,2,52006,13003,1,575920000,575920000,19501,6500,13001,6500,0,1,6502,16270949,16.270949
7100,1900,6500,13490000,2,52006,13003,1,575920000,575920000,19501,6500,13001,6500,0,1,6502,16431651,16.431651
7100,1900,6500,13490000,2,52006,13003,1,575920000,575920000,19501,6500,13001,6500,0,1,6502,16934686,16.934686
7100,1900,6900,13490000,2,55206,13803,1,604720000,604720000,20701,6900,13801,6900,0,1,6902,17392194,17.392194
7100,1900,6900,13490000,2,55206,13803,1,604720000,604720000,20701,6900,13801,6900,0,1,6902,18086750,18.08675
7100,1900,6900,13490000,2,55206,13803,1,604720000,604720000,20701,6900,13801,6900,0,1,6902,17415794,17.415794
7100,1900,6900,13490000,2,55206,13803,1,604720000,604720000,20701,6900,13801,6900,0,1,6902,18255919,18.255919
7100,1900,6900,13490000,2,55206,13803,1,604720000,604720000,20701,6900,13801,6900,0,1,6902,17287768,17.287768
7100,1900,6900,13490000,2,55206,13803,1,604720000,604720000,20701,6900,13801,6900,0,1,6902,17509652,17.509652
7100,1900,6900,13490000,2,55206,13803,1,604720000,604720000,20701,6900,13801,6900,0,1,6902,17926962,17.926962
7100,1500,500,10650000,2,4006,1003,1,119600000,119600000,1501,500,1001,500,0,1,502,1251097,1.251097
7100,1500,500,10650000,2,4006,1003,1,119600000,119600000,1501,500,1001,500,0,1,502,1225327,1.225327
7100,1500,500,10650000,2,4006,1003,1,119600000,119600000,1501,500,1001,500,0,1,502,1259475,1.259475
7100,1500,500,10650000,2,4006,1003,1,119600000,119600000,1501,500,1001,500,0,1,502,1267182,1.267182
7100,1500,500,10650000,2,4006,1003,1,119600000,119600000,1501,500,1001,500,0,1,502,1232789,1.232789
7100,1500,500,10650000,2,4006,1003,1,119600000,119600000,1501,500,1001,500,0,1,502,1243259,1.243259
7100,1500,500,10650000,2,4006,1003,1,119600000,119600000,1501,500,1001,500,0,1,502,1267567,1.267567
7100,1500,900,10650000,2,7206,1803,1,147120000,147120000,2701,900,1801,900,0,1,902,1876744,1.876744
7100,1500,900,10650000,2,7206,1803,1,147120000,147120000,2701,900,1801,900,0,1,902,1939473,1.939473
7100,1500,900,10650000,2,7206,1803,1,147120000,147120000,2701,900,1801,900,0,1,902,1860841,1.860841
7100,1500,900,10650000,2,7206,1803,1,147120000,147120000,2701,900,1801,900,0,1,902,1947367,1.947367
7100,1500,900,10650000,2,7206,1803,1,147120000,147120000,2701,900,1801,900,0,1,902,1849570,1.84957
7100,1500,900,10650000,2,7206,1803,1,147120000,147120000,2701,900,1801,900,0,1,902,1909532,1.909532
7100,1500,900,10650000,2,7206,1803,1,147120000,147120000,2701,900,1801,900,0,1,902,1939065,1.939065
7100,1500,1300,10650000,2,10406,2603,1,174640000,174640000,3901,1300,2601,1300,0,1,1302,2639173,2.639173
7100,1500,1300,10650000,2,10406,2603,1,174640000,174640000,3901,1300,2601,1300,0,1,1302,2744597,2.744597
7100,1500,1300,10650000,2,10406,2603,1,174640000,174640000,3901,1300,2601,1300,0,1,1302,2638822,2.638822
7100,1500,1300,10650000,2,10406,2603,1,174640000,174640000,3901,1300,2601,1300,0,1,1302,2768771,2.768771
7100,1500,1300,10650000,2,10406,2603,1,174640000,174640000,3901,1300,2601,1300,0,1,1302,2631104,2.631104
7100,1500,1300,10650000,2,10406,2603,1,174640000,174640000,3901,1300,2601,1300,0,1,1302,2677696,2.677696
7100,1500,1300,10650000,2,10406,2603,1,174640000,174640000,3901,1300,2601,1300,0,1,1302,2712211,2.712211
7100,1500,1700,10650000,2,13606,3403,1,202160000,202160000,5101,1700,3401,1700,0,1,1702,3428512,3.428512
7100,1500,1700,10650000,2,13606,3403,1,202160000,202160000,5101,1700,3401,1700,0,1,1702,3556154,3.556154
7100,1500,1700,10650000,2,13606,3403,1,202160000,202160000,5101,1700,3401,1700,0,1,1702,3417150,3.41715
7100,1500,1700,10650000,2,13606,3403,1,202160000,202160000,5101,1700,3401,1700,0,1,1702,3596091,3.596091
7100,1500,1700,10650000,2,13606,3403,1,202160000,202160000,5101,1700,3401,1700,0,1,1702,3459344,3.459344
7100,1500,1700,10650000,2,13606,3403,1,202160000,202160000,5101,1700,3401,1700,0,1,1702,3466860,3.46686
7100,1500,1700,10650000,2,13606,3403,1,202160000,202160000,5101,1700,3401,1700,0,1,1702,3530258,3.530258
7100,1500,2100,10650000,2,16806,4203,1,229680000,229680000,6301,2100,4201,2100,0,1,2102,4210541,4.210541
7100,1500,2100,10650000,2,16806,4203,1,229680000,229680000,6301,2100,4201,2100,0,1,2102,4376422,4.376422
7100,1500,2100,10650000,2,16806,4203,1,229680000,229680000,6301,2100,4201,2100,0,1,2102,4220918,4.220918
7100,1500,2100,10650000,2,16806,4203,1,229680000,229680000,6301,2100,4201,2100,0,1,2102,4418398,4.418398
7100,1500,2100,10650000,2,16806,4203,1,229680000,229680000,6301,2100,4201,2100,0,1,2102,4211132,4.211132
7100,1500,2100,10650000,2,16806,4203,1,229680000,229680000,6301,2100,4201,2100,0,1,2102,4239870,4.23987
7100,1500,2100,10650000,2,16806,4203,1,229680000,229680000,6301,2100,4201,2100,0,1,2102,4334015,4.334015
7100,1500,2500,10650000,2,20006,5003,1,257200000,257200000,7501,2500,5001,2500,0,1,2502,4976617,4.976617
7100,1500,2500,10650000,2,20006,5003,1,257200000,257200000,7501,2500,5001,2500,0,1,2502,5186991,5.186991
7100,1500,2500,10650000,2,20006,5003,1,257200000,257200000,7501,2500,5001,2500,0,1,2502,5004432,5.004432
7100,1500,2500,10650000,2,20006,5003,1,257200000,257200000,7501,2500,5001,2500,0,1,2502,5249506,5.249506
7100,1500,2500,10650000,2,20006,5003,1,257200000,257200000,7501,2500,5001,2500,0,1,2502,5012045,5.012045
7100,1500,2500,10650000,2,20006,5003,1,257200000,257200000,7501,2500,5001,2500,0,1,2502,5012430,5.01243
7100,1500,2500,10650000,2,20006,5003,1,257200000,257200000,7501,2500,5001,2500,0,1,2502,5153689,5.153689
7100,1500,2900,10650000,2,23206,5803,1,284720000,284720000,8701,2900,5801,2900,0,1,2902,5998861,5.998861
7100,1500,2900,10650000,2,23206,5803,1,284720000,284720000,8701,2900,5801,2900,0,1,2902,6131766,6.131766
7100,1500,2900,10650000,2,23206,5803,1,284720000,284720000,8701,2900,5801,2900,0,1,2902,5906707,5.906707
7100,1500,2900,10650000,2,23206,5803,1,284720000,284720000,8701,2900,5801,2900,0,1,2902,6169165,6.169165
7100,1500,2900,10650000,2,23206,5803,1,284720000,284720000,8701,2900,5801,2900,0,1,2902,5924183,5.924183
7100,1500,2900,10650000,2,23206,5803,1,284720000,284720000,8701,2900,5801,2900,0,1,2902,6006367,6.006367
7100,1500,2900,10650000,2,23206,5803,1,284720000,284720000,8701,2900,5801,2900,0,1,2902,6109219,6.109219
7100,1500,3300,10650000,2,26406,6603,1,312240000,312240000,9901,3300,6601,3300,0,1,3302,6538999,6.538999
7100,1500,3300,10650000,2,26406,6603,1,312240000,312240000,9901,3300,6601,3300,0,1,3302,6829724,6.829724
7100,1500,3300,10650000,2,26406,6603,1,312240000,312240000,9901,3300,6601,3300,0,1,3302,6576179,6.576179
7100,1500,3300,10650000,2,26406,6603,1,312240000,312240000,9901,3300,6601,3300,0,1,3302,6901956,6.901956
7100,1500,3300,10650000,2,26406,6603,1,312240000,312240000,9901,3300,6601,3300,0,1,3302,6615942,6.615942
7100,1500,3300,10650000,2,26406,6603,1,312240000,312240000,9901,3300,6601,3300,0,1,3302,6603119,6.603119
7100,1500,3300,10650000,2,26406,6603,1,312240000,312240000,9901,3300,6601,3300,0,1,3302,6780335,6.780335
7100,1500,3700,10650000,2,29606,7403,1,339760000,339760000,11101,3700,7401,3700,0,1,3702,7500453,7.500453
7100,1500,3700,10650000,2,29606,7403,1,339760000,339760000,11101,3700,7401,3700,0,1,3702,7791908,7.791908
7100,1500,3700,10650000,2,29606,7403,1,339760000,339760000,11101,3700,7401,3700,0,1,3702,7492872,7.492872
7100,1500,3700,10650000,2,29606,7403,1,339760000,339760000,11101,3700,7401,3700,0,1,3702,7828747,7.828747
7100,1500,3700,10650000,2,29606,7403,1,339760000,339760000,11101,3700,7401,3700,0,1,3702,7508160,7.50816
7100,1500,3700,10650000,2,29606,7403,1,339760000,339760000,11101,3700,7401,3700,0,1,3702,7547302,7.547302
7100,1500,3700,10650000,2,29606,7403,1,339760000,339760000,11101,3700,7401,3700,0,1,3702,7707655,7.707655
7100,1500,4100,10650000,2,32806,8203,1,367280000,367280000,12301,4100,8201,4100,0,1,4102,8090316,8.090316
7100,1500,4100,10650000,2,32806,8203,1,367280000,367280000,12301,4100,8201,4100,0,1,4102,8502312,8.502312
7100,1500,4100,10650000,2,32806,8203,1,367280000,367280000,12301,4100,8201,4100,0,1,4102,8163125,8.163125
7100,1500,4100,10650000,2,32806,8203,1,367280000,367280000,12301,4100,8201,4100,0,1,4102,8544166,8.544166
7100,1500,4100,10650000,2,32806,8203,1,367280000,367280000,12301,4100,8201,4100,0,1,4102,8170420,8.17042
7100,1500,4100,10650000,2,32806,8203,1,367280000,367280000,12301,4100,8201,4100,0,1,4102,8142448,8.142448
7100,1500,4100,10650000,2,32806,8203,1,367280000,367280000,12301,4100,8201,4100,0,1,4102,8433607,8.433607
7100,1500,4500,10650000,2,36006,9003,1,394800000,394800000,13501,4500,9001,4500,0,1,4502,9086172,9.086172
7100,1500,4500,10650000,2,36006,9003,1,394800000,394800000,13501,4500,9001,4500,0,1,4502,9424130,9.42413
7100,1500,4500,10650000,2,36006,9003,1,394800000,394800000,13501,4500,9001,4500,0,1,4502,9093733,9.093733
7100,1500,4500,10650000,2,36006,9003,1,394800000,394800000,13501,4500,9001,4500,0,1,4502,9519129,9.519129
7100,1500,4500,10650000,2,36006,9003,1,394800000,394800000,13501,4500,9001,4500,0,1,4502,9052149,9.052149
7100,1500,4500,10650000,2,36006,9003,1,394800000,394800000,13501,4500,9001,4500,0,1,4502,9111304,9.111304
7100,1500,4500,10650000,2,36006,9003,1,394800000,394800000,13501,4500,9001,4500,0,1,4502,9352058,9.352058
7100,1500,4900,10650000,2,39206,9803,1,422320000,422320000,14701,4900,9801,4900,0,1,4902,9875299,9.875299
7100,1500,4900,10650000,2,39206,9803,1,422320000,422320000,14701,4900,9801,4900,0,1,4902,10226348,10.226348
7100,1500,4900,10650000,2,39206,9803,1,422320000,422320000,14701,4900,9801,4900,0,1,4902,9919941,9.919941
7100,1500,4900,10650000,2,39206,9803,1,422320000,422320000,14701,4900,9801,4900,0,1,4902,10350884,10.350884
7100,1500,4900,10650000,2,39206,9803,1,422320000,422320000,14701,4900,9801,4900,0,1,4902,9896062,9.896062
7100,1500,4900,10650000,2,39206,9803,1,422320000,422320000,14701,4900,9801,4900,0,1,4902,9882857,9.882857
7100,1500,4900,10650000,2,39206,9803,1,422320000,422320000,14701,4900,9801,4900,0,1,4902,10179748,10.179748
7100,1500,5300,10650000,2,42406,10603,1,449840000,449840000,15901,5300,10601,5300,0,1,5302,10449507,10.449507
7100,1500,5300,10650000,2,42406,10603,1,449840000,449840000,15901,5300,10601,5300,0,1,5302,10982822,10.982822
7100,1500,5300,10650000,2,42406,10603,1,449840000,449840000,15901,5300,10601,5300,0,1,5302,10510202,10.510202
7100,1500,5300,10650000,2,42406,10603,1,449840000,449840000,15901,5300,10601,5300,0,1,5302,11076379,11.076379
7100,1500,5300,10650000,2,42406,10603,1,449840000,449840000,15901,5300,10601,5300,0,1,5302,10532925,10.532925
7100,1500,5300,10650000,2,42406,10603,1,449840000,449840000,15901,5300,10601,5300,0,1,5302,10497067,10.497067
7100,1500,5300,10650000,2,42406,10603,1,449840000,449840000,15901,5300,10601,5300,0,1,5302,10897661,10.897661
7100,1500,5700,10650000,2,45606,11403,1,477360000,477360000,17101,5700,11401,5700,0,1,5702,11467299,11.467299
7100,1500,5700,10650000,2,45606,11403,1,477360000,477360000,17101,5700,11401,5700,0,1,5702,11914040,11.91404
7100,1500,5700,10650000,2,45606,11403,1,477360000,477360000,17101,5700,11401,5700,0,1,5702,11466717,11.466717
7100,1500,5700,10650000,2,45606,11403,1,477360000,477360000,17101,5700,11401,5700,0,1,5702,12033400,12.0334
7100,1500,5700,10650000,2,45606,11403,1,477360000,477360000,17101,5700,11401,5700,0,1,5702,11452513,11.452513
7100,1500,5700,10650000,2,45606,11403,1,477360000,477360000,17101,5700,11401,5700,0,1,5702,11466117,11.466117
7100,1500,5700,10650000,2,45606,11403,1,477360000,477360000,17101,5700,11401,5700,0,1,5702,11810634,11.810634
7100,1500,6100,10650000,2,48806,12203,1,504880000,504880000,18301,6100,12201,6100,0,1,6102,12205166,12.205166
7100,1500,6100,10650000,2,48806,12203,1,504880000,504880000,18301,6100,12201,6100,0,1,6102,12751683,12.751683
7100,1500,6100,10650000,2,48806,12203,1,504880000,504880000,18301,6100,12201,6100,0,1,6102,12276975,12.276975
7100,1500,6100,10650000,2,48806,12203,1,504880000,504880000,18301,6100,12201,6100,0,1,6102,12850709,12.850709
7100,1500,6100,10650000,2,48806,12203,1,504880000,504880000,18301,6100,12201,6100,0,1,6102,12183745,12.183745
7100,1500,6100,10650000,2,48806,12203,1,504880000,504880000,18301,6100,12201,6100,0,1,6102,12263008,12.263008
7100,1500,6100,10650000,2,48806,12203,1,504880000,504880000,18301,6100,12201,6100,0,1,6102,12645349,12.645349
7100,1500,6500,10650000,2,52006,13003,1,532400000,532400000,19501,6500,13001,6500,0,1,6502,12992219,12.992219
7100,1500,6500,10650000,2,52006,13003,1,532400000,532400000,19501,6500,13001,6500,0,1,6502,13580686,13.580686
7100,1500,6500,10650000,2,52006,13003,1,532400000,532400000,19501,6500,13001,6500,0,1,6502,13059068,13.059068
7100,1500,6500,10650000,2,52006,13003,1,532400000,532400000,19501,6500,13001,6500,0,1,6502,13672983,13.672983
7100,1500,6500,10650000,2,52006,13003,1,532400000,532400000,19501,6500,13001,6500,0,1,6502,13008174,13.008174
7100,1500,6500,10650000,2,52006,13003,1,532400000,532400000,19501,6500,13001,6500,0,1,6502,13066726,13.066726
7100,1500,6500,10650000,2,52006,13003,1,532400000,532400000,19501,6500,13001,6500,0,1,6502,13442456,13.442456
7100,1500,6900,10650000,2,55206,13803,1,559920000,559920000,20701,6900,13801,6900,0,1,6902,13782380,13.78238
7100,1500,6900,10650000,2,55206,13803,1,559920000,559920000,20701,6900,13801,6900,0,1,6902,14340594,14.340594
7100,1500,6900,10650000,2,55206,13803,1,559920000,559920000,20701,6900,13801,6900,0,1,6902,13822770,13.82277
7100,1500,6900,10650000,2,55206,13803,1,559920000,559920000,20701,6900,13801,6900,0,1,6902,14477281,14.477281
7100,1500,6900,10650000,2,55206,13803,1,559920000,559920000,20701,6900,13801,6900,0,1,6902,13758640,13.75864
7100,1500,6900,10650000,2,55206,13803,1,559920000,559920000,20701,6900,13801,6900,0,1,6902,13830429,13.830429
7100,1500,6900,10650000,2,55206,13803,1,559920000,559920000,20701,6900,13801,6900,0,1,6902,14251442,14.251442
7100,1100,500,7810000,2,4006,1003,1,95280000,95280000,1501,500,1001,500,0,1,502,949917,0.949917
7100,1100,500,7810000,2,4006,1003,1,95280000,95280000,1501,500,1001,500,0,1,502,975056,0.975056
7100,1100,500,7810000,2,4006,1003,1,95280000,95280000,1501,500,1001,500,0,1,502,956114,0.956114
7100,1100,500,7810000,2,4006,1003,1,95280000,95280000,1501,500,1001,500,0,1,502,961701,0.961701
7100,1100,500,7810000,2,4006,1003,1,95280000,95280000,1501,500,1001,500,0,1,502,932659,0.932659
7100,1100,500,7810000,2,4006,1003,1,95280000,95280000,1501,500,1001,500,0,1,502,986351,0.986351
7100,1100,500,7810000,2,4006,1003,1,95280000,95280000,1501,500,1001,500,0,1,502,955895,0.955895
7100,1100,900,7810000,2,7206,1803,1,121520000,121520000,2701,900,1801,900,0,1,902,1395282,1.395282
7100,1100,900,7810000,2,7206,1803,1,121520000,121520000,2701,900,1801,900,0,1,902,1429949,1.429949
7100,1100,900,7810000,2,7206,1803,1,121520000,121520000,2701,900,1801,900,0,1,902,1374551,1.374551
7100,1100,900,7810000,2,7206,1803,1,121520000,121520000,2701,900,1801,900,0,1,902,1436017,1.436017
7100,1100,900,7810000,2,7206,1803,1,121520000,121520000,2701,900,1801,900,0,1,902,1363763,1.363763
7100,1100,900,7810000,2,7206,1803,1,121520000,121520000,2701,900,1801,900,0,1,902,1430233,1.430233
7100,1100,900,7810000,2,7206,1803,1,121520000,121520000,2701,900,1801,900,0,1,902,1435636,1.435636
7100,1100,1300,7810000,2,10406,2603,1,147760000,147760000,3901,1300,2601,1300,0,1,1302,1959185,1.959185
7100,1100,1300,7810000,2,10406,2603,1,147760000,147760000,3901,1300,2601,1300,0,1,1302,2029241,2.029241
7100,1100,1300,7810000,2,10406,2603,1,147760000,147760000,3901,1300,2601,1300,0,1,1302,1949777,1.949777
7100,1100,1300,7810000,2,10406,2603,1,147760000,147760000,3901,1300,2601,1300,0,1,1302,2040356,2.040356
7100,1100,1300,7810000,2,10406,2603,1,147760000,147760000,3901,1300,2601,1300,0,1,1302,1944135,1.944135
7100,1100,1300,7810000,2,10406,2603,1,147760000,147760000,3901,1300,2601,1300,0,1,1302,1991679,1.991679
7100,1100,1300,7810000,2,10406,2603,1,147760000,147760000,3901,1300,2601,1300,0,1,1302,2023293,2.023293
7100,1100,1700,7810000,2,13606,3403,1,174000000,174000000,5101,1700,3401,1700,0,1,1702,2527115,2.527115
7100,1100,1700,7810000,2,13606,3403,1,174000000,174000000,5101,1700,3401,1700,0,1,1702,2637055,2.637055
7100,1100,1700,7810000,2,13606,3403,1,174000000,174000000,5101,1700,3401,1700,0,1,1702,2532804,2.532804
7100,1100,1700,7810000,2,13606,3403,1,174000000,174000000,5101,1700,3401,1700,0,1,1702,2654250,2.65425
7100,1100,1700,7810000,2,13606,3403,1,174000000,174000000,5101,1700,3401,1700,0,1,1702,2514110,2.51411
7100,1100,1700,7810000,2,13606,3403,1,174000000,174000000,5101,1700,3401,1700,0,1,1702,2554173,2.554173
7100,1100,1700,7810000,2,13606,3403,1,174000000,174000000,5101,1700,3401,1700,0,1,1702,2614354,2.614354
7100,1100,2100,7810000,2,16806,4203,1,200240000,200240000,6301,2100,4201,2100,0,1,2102,3116671,3.116671
7100,1100,2100,7810000,2,16806,4203,1,200240000,200240000,6301,2100,4201,2100,0,1,2102,3245890,3.24589
7100,1100,2100,7810000,2,16806,4203,1,200240000,200240000,6301,2100,4201,2100,0,1,2102,3098215,3.098215
7100,1100,2100,7810000,2,16806,4203,1,200240000,200240000,6301,2100,4201,2100,0,1,2102,3256563,3.256563
7100,1100,2100,7810000,2,16806,4203,1,200240000,200240000,6301,2100,4201,2100,0,1,2102,3098580,3.09858
7100,1100,2100,7810000,2,16806,4203,1,200240000,200240000,6301,2100,4201,2100,0,1,2102,3131747,3.131747
7100,1100,2100,7810000,2,16806,4203,1,200240000,200240000,6301,2100,4201,2100,0,1,2102,3211192,3.211192
7100,1100,2500,7810000,2,20006,5003,1,226480000,226480000,7501,2500,5001,2500,0,1,2502,3687035,3.687035
7100,1100,2500,7810000,2,20006,5003,1,226480000,226480000,7501,2500,5001,2500,0,1,2502,3834140,3.83414
7100,1100,2500,7810000,2,20006,5003,1,226480000,226480000,7501,2500,5001,2500,0,1,2502,3686610,3.68661
7100,1100,2500,7810000,2,20006,5003,1,226480000,226480000,7501,2500,5001,2500,0,1,2502,3860827,3.860827
7100,1100,2500,7810000,2,20006,5003,1,226480000,226480000,7501,2500,5001,2500,0,1,2502,3680864,3.680864
7100,1100,2500,7810000,2,20006,5003,1,226480000,226480000,7501,2500,5001,2500,0,1,2502,3709965,3.709965
7100,1100,2500,7810000,2,20006,5003,1,226480000,226480000,7501,2500,5001,2500,0,1,2502,3822850,3.82285
7100,1100,2900,7810000,2,23206,5803,1,252720000,252720000,8701,2900,5801,2900,0,1,2902,4251688,4.251688
7100,1100,2900,7810000,2,23206,5803,1,252720000,252720000,8701,2900,5801,2900,0,1,2902,4432725,4.432725
7100,1100,2900,7810000,2,23206,5803,1,252720000,252720000,8701,2900,5801,2900,0,1,2902,4265368,4.265368
7100,1100,2900,7810000,2,23206,5803,1,252720000,252720000,8701,2900,5801,2900,0,1,2902,4472263,4.472263
7100,1100,2900,7810000,2,23206,5803,1,252720000,252720000,8701,2900,5801,2900,0,1,2902,4259795,4.259795
7100,1100,2900,7810000,2,23206,5803,1,252720000,252720000,8701,2900,5801,2900,0,1,2902,4286241,4.286241
7100,1100,2900,7810000,2,23206,5803,1,252720000,252720000,8701,2900,5801,2900,0,1,2902,4412582,4.412582
7100,1100,3300,7810000,2,26406,6603,1,278960000,278960000,9901,3300,6601,3300,0,1,3302,5026172,5.026172
7100,1100,3300,7810000,2,26406,6603,1,278960000,278960000,9901,3300,6601,3300,0,1,3302,5155990,5.15599
7100,1100,3300,7810000,2,26406,6603,1,278960000,278960000,9901,3300,6601,3300,0,1,3302,5001597,5.001597
7100,1100,3300,7810000,2,26406,6603,1,278960000,278960000,9901,3300,6601,3300,0,1,3302,5213292,5.213292
7100,1100,3300,7810000,2,26406,6603,1,278960000,278960000,9901,3300,6601,3300,0,1,3302,4945479,4.945479
7100,1100,3300,7810000,2,26406,6603,1,278960000,278960000,9901,3300,6601,3300,0,1,3302,5036397,5.036397
7100,1100,3300,7810000,2,26406,6603,1,278960000,278960000,9901,3300,6601,3300,0,1,3302,5161723,5.161723
7100,1100,3700,7810000,2,29606,7403,1,305200000,305200000,11101,3700,7401,3700,0,1,3702,5416918,5.416918
7100,1100,3700,7810000,2,29606,7403,1,305200000,305200000,11101,3700,7401,3700,0,1,3702,5642637,5.642637
7100,1100,3700,7810000,2,29606,7403,1,305200000,305200000,11101,3700,7401,3700,0,1,3702,5430608,5.430608
7100,1100,3700,7810000,2,29606,7403,1,305200000,305200000,11101,3700,7401,3700,0,1,3702,5692865,5.692865
7100,1100,3700,7810000,2,29606,7403,1,305200000,305200000,11101,3700,7401,3700,0,1,3702,5431047,5.431047
7100,1100,3700,7810000,2,29606,7403,1,305200000,305200000,11101,3700,7401,3700,0,1,3702,5447740,5.44774
7100,1100,3700,7810000,2,29606,7403,1,305200000,305200000,11101,3700,7401,3700,0,1,3702,5620324,5.620324
7100,1100,4100,7810000,2,32806,8203,1,331440000,331440000,12301,4100,8201,4100,0,1,4102,5992631,5.992631
7100,1100,4100,7810000,2,32806,8203,1,331440000,331440000,12301,4100,8201,4100,0,1,4102,6243493,6.243493
7100,1100,4100,7810000,2,32806,8203,1,331440000,331440000,12301,4100,8201,4100,0,1,4102,6012366,6.012366
7100,1100,4100,7810000,2,32806,8203,1,331440000,331440000,12301,4100,8201,4100,0,1,4102,6302733,6.302733
7100,1100,4100,7810000,2,32806,8203,1,331440000,331440000,12301,4100,8201,4100,0,1,4102,6018719,6.018719
7100,1100,4100,7810000,2,32806,8203,1,331440000,331440000,12301,4100,8201,4100,0,1,4102,6027779,6.027779
7100,1100,4100,7810000,2,32806,8203,1,331440000,331440000,12301,4100,8201,4100,0,1,4102,6209800,6.2098
7100,1100,4500,7810000,2,36006,9003,1,357680000,357680000,13501,4500,9001,4500,0,1,4502,6731662,6.731662
7100,1100,4500,7810000,2,36006,9003,1,357680000,357680000,13501,4500,9001,4500,0,1,4502,6974920,6.97492
7100,1100,4500,7810000,2,36006,9003,1,357680000,357680000,13501,4500,9001,4500,0,1,4502,6723654,6.723654
7100,1100,4500,7810000,2,36006,9003,1,357680000,357680000,13501,4500,9001,4500,0,1,4502,7016468,7.016468
7100,1100,4500,7810000,2,36006,9003,1,357680000,357680000,13501,4500,9001,4500,0,1,4502,6714378,6.714378
7100,1100,4500,7810000,2,36006,9003,1,357680000,357680000,13501,4500,9001,4500,0,1,4502,6771349,6.771349
7100,1100,4500,7810000,2,36006,9003,1,357680000,357680000,13501,4500,9001,4500,0,1,4502,6915031,6.915031
7100,1100,4900,7810000,2,39206,9803,1,383920000,383920000,14701,4900,9801,4900,0,1,4902,7203360,7.20336
7100,1100,4900,7810000,2,39206,9803,1,383920000,383920000,14701,4900,9801,4900,0,1,4902,7452348,7.452348
7100,1100,4900,7810000,2,39206,9803,1,383920000,383920000,14701,4900,9801,4900,0,1,4902,7202834,7.202834
7100,1100,4900,7810000,2,39206,9803,1,383920000,383920000,14701,4900,9801,4900,0,1,4902,7504820,7.50482
7100,1100,4900,7810000,2,39206,9803,1,383920000,383920000,14701,4900,9801,4900,0,1,4902,7185940,7.18594
7100,1100,4900,7810000,2,39206,9803,1,383920000,383920000,14701,4900,9801,4900,0,1,4902,7191592,7.191592
7100,1100,4900,7810000,2,39206,9803,1,383920000,383920000,14701,4900,9801,4900,0,1,4902,7416037,7.416037
7100,1100,5300,7810000,2,42406,10603,1,410160000,410160000,15901,5300,10601,5300,0,1,5302,7903919,7.903919
7100,1100,5300,7810000,2,42406,10603,1,410160000,410160000,15901,5300,10601,5300,0,1,5302,8185327,8.185327
7100,1100,5300,7810000,2,42406,10603,1,410160000,410160000,15901,5300,10601,5300,0,1,5302,7933967,7.933967
7100,1100,5300,7810000,2,42406,10603,1,410160000,410160000,15901,5300,10601,5300,0,1,5302,8290095,8.290095
7100,1100,5300,7810000,2,42406,10603,1,410160000,410160000,15901,5300,10601,5300,0,1,5302,7909753,7.909753
7100,1100,5300,7810000,2,42406,10603,1,410160000,410160000,15901,5300,10601,5300,0,1,5302,7939610,7.93961
7100,1100,5300,7810000,2,42406,10603,1,410160000,410160000,15901,5300,10601,5300,0,1,5302,8179357,8.179357
7100,1100,5700,7810000,2,45606,11403,1,436400000,436400000,17101,5700,11401,5700,0,1,5702,8491041,8.491041
7100,1100,5700,7810000,2,45606,11403,1,436400000,436400000,17101,5700,11401,5700,0,1,5702,8787897,8.787897
7100,1100,5700,7810000,2,45606,11403,1,436400000,436400000,17101,5700,11401,5700,0,1,5702,8510112,8.510112
7100,1100,5700,7810000,2,45606,11403,1,436400000,436400000,17101,5700,11401,5700,0,1,5702,8869752,8.869752
7100,1100,5700,7810000,2,45606,11403,1,436400000,436400000,17101,5700,11401,5700,0,1,5702,8509523,8.509523
7100,1100,5700,7810000,2,45606,11403,1,436400000,436400000,17101,5700,11401,5700,0,1,5702,8515704,8.515704
7100,1100,5700,7810000,2,45606,11403,1,436400000,436400000,17101,5700,11401,5700,0,1,5702,8744936,8.744936
7100,1100,6100,7810000,2,48806,12203,1,462640000,462640000,18301,6100,12201,6100,0,1,6102,8902998,8.902998
7100,1100,6100,7810000,2,48806,12203,1,462640000,462640000,18301,6100,12201,6100,0,1,6102,9334767,9.334767
7100,1100,6100,7810000,2,48806,12203,1,462640000,462640000,18301,6100,12201,6100,0,1,6102,8936991,8.936991
7100,1100,6100,7810000,2,48806,12203,1,462640000,462640000,18301,6100,12201,6100,0,1,6102,9391677,9.391677
7100,1100,6100,7810000,2,48806,12203,1,462640000,462640000,18301,6100,12201,6100,0,1,6102,8984833,8.984833
7100,1100,6100,7810000,2,48806,12203,1,462640000,462640000,18301,6100,12201,6100,0,1,6102,8967079,8.967079
7100,1100,6100,7810000,2,48806,12203,1,462640000,462640000,18301,6100,12201,6100,0,1,6102,9233684,9.233684
7100,1100,6500,7810000,2,52006,13003,1,488880000,488880000,19501,6500,13001,6500,0,1,6502,9683348,9.683348
7100,1100,6500,7810000,2,52006,13003,1,488880000,488880000,19501,6500,13001,6500,0,1,6502,10014290,10.01429
7100,1100,6500,7810000,2,52006,13003,1,488880000,488880000,19501,6500,13001,6500,0,1,6502,9672536,9.672536
7100,1100,6500,7810000,2,52006,13003,1,488880000,488880000,19501,6500,13001,6500,0,1,6502,10103842,10.103842
7100,1100,6500,7810000,2,52006,13003,1,488880000,488880000,19501,6500,13001,6500,0,1,6502,9709394,9.709394
7100,1100,6500,7810000,2,52006,13003,1,488880000,488880000,19501,6500,13001,6500,0,1,6502,9703579,9.703579
7100,1100,6500,7810000,2,52006,13003,1,488880000,488880000,19501,6500,13001,6500,0,1,6502,9957109,9.957109
7100,1100,6900,7810000,2,55206,13803,1,515120000,515120000,20701,6900,13801,6900,0,1,6902,10230962,10.230962
7100,1100,6900,7810000,2,55206,13803,1,515120000,515120000,20701,6900,13801,6900,0,1,6902,10624914,10.624914
7100,1100,6900,7810000,2,55206,13803,1,515120000,515120000,20701,6900,13801,6900,0,1,6902,10214803,10.214803
7100,1100,6900,7810000,2,55206,13803,1,515120000,515120000,20701,6900,13801,6900,0,1,6902,10721379,10.721379
7100,1100,6900,7810000,2,55206,13803,1,515120000,515120000,20701,6900,13801,6900,0,1,6902,10201941,10.201941
7100,1100,6900,7810000,2,55206,13803,1,515120000,515120000,20701,6900,13801,6900,0,1,6902,10266108,10.266108
7100,1100,6900,7810000,2,55206,13803,1,515120000,515120000,20701,6900,13801,6900,0,1,6902,10534215,10.534215
7100,700,500,4970000,2,4006,1003,1,70960000,70960000,1501,500,1001,500,0,1,502,512999,0.512999
7100,700,500,4970000,2,4006,1003,1,70960000,70960000,1501,500,1001,500,0,1,502,516688,0.516688
7100,700,500,4970000,2,4006,1003,1,70960000,70960000,1501,500,1001,500,0,1,502,512788,0.512788
7100,700,500,4970000,2,4006,1003,1,70960000,70960000,1501,500,1001,500,0,1,502,521431,0.521431
7100,700,500,4970000,2,4006,1003,1,70960000,70960000,1501,500,1001,500,0,1,502,507208,0.507208
7100,700,500,4970000,2,4006,1003,1,70960000,70960000,1501,500,1001,500,0,1,502,516816,0.516816
7100,700,500,4970000,2,4006,1003,1,70960000,70960000,1501,500,1001,500,0,1,502,516461,0.516461
7100,700,900,4970000,2,7206,1803,1,95920000,95920000,2701,900,1801,900,0,1,902,881658,0.881658
7100,700,900,4970000,2,7206,1803,1,95920000,95920000,2701,900,1801,900,0,1,902,926537,0.926537
7100,700,900,4970000,2,7206,1803,1,95920000,95920000,2701,900,1801,900,0,1,902,874204,0.874204
7100,700,900,4970000,2,7206,1803,1,95920000,95920000,2701,900,1801,900,0,1,902,922575,0.922575
7100,700,900,4970000,2,7206,1803,1,95920000,95920000,2701,900,1801,900,0,1,902,877900,0.8779
7100,700,900,4970000,2,7206,1803,1,95920000,95920000,2701,900,1801,900,0,1,902,902031,0.902031
7100,700,900,4970000,2,7206,1803,1,95920000,95920000,2701,900,1801,900,0,1,902,905857,0.905857
7100,700,1300,4970000,2,10406,2603,1,120880000,120880000,3901,1300,2601,1300,0,1,1302,1261849,1.261849
7100,700,1300,4970000,2,10406,2603,1,120880000,120880000,3901,1300,2601,1300,0,1,1302,1303347,1.303347
7100,700,1300,4970000,2,10406,2603,1,120880000,120880000,3901,1300,2601,1300,0,1,1302,1241359,1.241359
7100,700,1300,4970000,2,10406,2603,1,120880000,120880000,3901,1300,2601,1300,0,1,1302,1310310,1.31031
7100,700,1300,4970000,2,10406,2603,1,120880000,120880000,3901,1300,2601,1300,0,1,1302,1236597,1.236597
7100,700,1300,4970000,2,10406,2603,1,120880000,120880000,3901,1300,2601,1300,0,1,1302,1270315,1.270315
7100,700,1300,4970000,2,10406,2603,1,120880000,120880000,3901,1300,2601,1300,0,1,1302,1284559,1.284559
7100,700,1700,4970000,2,13606,3403,1,145840000,145840000,5101,1700,3401,1700,0,1,1702,1628779,1.628779
7100,700,1700,4970000,2,13606,3403,1,145840000,145840000,5101,1700,3401,1700,0,1,1702,1693713,1.693713
7100,700,1700,4970000,2,13606,3403,1,145840000,145840000,5101,1700,3401,1700,0,1,1702,1610712,1.610712
7100,700,1700,4970000,2,13606,3403,1,145840000,145840000,5101,1700,3401,1700,0,1,1702,1706406,1.706406
7100,700,1700,4970000,2,13606,3403,1,145840000,145840000,5101,1700,3401,1700,0,1,1702,1611170,1.61117
7100,700,1700,4970000,2,13606,3403,1,145840000,145840000,5101,1700,3401,1700,0,1,1702,1638873,1.638873
7100,700,1700,4970000,2,13606,3403,1,145840000,145840000,5101,1700,3401,1700,0,1,1702,1670086,1.670086
7100,700,2100,4970000,2,16806,4203,1,170800000,170800000,6301,2100,4201,2100,0,1,2102,1994706,1.994706
7100,700,2100,4970000,2,16806,4203,1,170800000,170800000,6301,2100,4201,2100,0,1,2102,2083060,2.08306
7100,700,2100,4970000,2,16806,4203,1,170800000,170800000,6301,2100,4201,2100,0,1,2102,1982718,1.982718
7100,700,2100,4970000,2,16806,4203,1,170800000,170800000,6301,2100,4201,2100,0,1,2102,2093741,2.093741
7100,700,2100,4970000,2,16806,4203,1,170800000,170800000,6301,2100,4201,2100,0,1,2102,1986545,1.986545
7100,700,2100,4970000,2,16806,4203,1,170800000,170800000,6301,2100,4201,2100,0,1,2102,2009800,2.0098
7100,700,2100,4970000,2,16806,4203,1,170800000,170800000,6301,2100,4201,2100,0,1,2102,2049925,2.049925
7100,700,2500,4970000,2,20006,5003,1,195760000,195760000,7501,2500,5001,2500,0,1,2502,2369609,2.369609
7100,700,2500,4970000,2,20006,5003,1,195760000,195760000,7501,2500,5001,2500,0,1,2502,2471728,2.471728
7100,700,2500,4970000,2,20006,5003,1,195760000,195760000,7501,2500,5001,2500,0,1,2502,2360671,2.360671
7100,700,2500,4970000,2,20006,5003,1,195760000,195760000,7501,2500,5001,2500,0,1,2502,2488809,2.488809
7100,700,2500,4970000,2,20006,5003,1,195760000,195760000,7501,2500,5001,2500,0,1,2502,2365855,2.365855
7100,700,2500,4970000,2,20006,5003,1,195760000,195760000,7501,2500,5001,2500,0,1,2502,2389046,2.389046
7100,700,2500,4970000,2,20006,5003,1,195760000,195760000,7501,2500,5001,2500,0,1,2502,2434092,2.434092
7100,700,2900,4970000,2,23206,5803,1,220720000,220720000,8701,2900,5801,2900,0,1,2902,2905520,2.90552
7100,700,2900,4970000,2,23206,5803,1,220720000,220720000,8701,2900,5801,2900,0,1,2902,2990621,2.990621
7100,700,2900,4970000,2,23206,5803,1,220720000,220720000,8701,2900,5801,2900,0,1,2902,2878086,2.878086
7100,700,2900,4970000,2,23206,5803,1,220720000,220720000,8701,2900,5801,2900,0,1,2902,2897939,2.897939
7100,700,2900,4970000,2,23206,5803,1,220720000,220720000,8701,2900,5801,2900,0,1,2902,2869405,2.869405
7100,700,2900,4970000,2,23206,5803,1,220720000,220720000,8701,2900,5801,2900,0,1,2902,2788120,2.78812
7100,700,2900,4970000,2,23206,5803,1,220720000,220720000,8701,2900,5801,2900,0,1,2902,2901829,2.901829
7100,700,3300,4970000,2,26406,6603,1,245680000,245680000,9901,3300,6601,3300,0,1,3302,3105738,3.105738
7100,700,3300,4970000,2,26406,6603,1,245680000,245680000,9901,3300,6601,3300,0,1,3302,3255003,3.255003
7100,700,3300,4970000,2,26406,6603,1,245680000,245680000,9901,3300,6601,3300,0,1,3302,3109506,3.109506
7100,700,3300,4970000,2,26406,6603,1,245680000,245680000,9901,3300,6601,3300,0,1,3302,3278827,3.278827
7100,700,3300,4970000,2,26406,6603,1,245680000,245680000,9901,3300,6601,3300,0,1,3302,3115120,3.11512
7100,700,3300,4970000,2,26406,6603,1,245680000,245680000,9901,3300,6601,3300,0,1,3302,3134124,3.134124
7100,700,3300,4970000,2,26406,6603,1,245680000,245680000,9901,3300,6601,3300,0,1,3302,3209867,3.209867
7100,700,3700,4970000,2,29606,7403,1,270640000,270640000,11101,3700,7401,3700,0,1,3702,3477765,3.477765
7100,700,3700,4970000,2,29606,7403,1,270640000,270640000,11101,3700,7401,3700,0,1,3702,3647994,3.647994
7100,700,3700,4970000,2,29606,7403,1,270640000,270640000,11101,3700,7401,3700,0,1,3702,3474009,3.474009
7100,700,3700,4970000,2,29606,7403,1,270640000,270640000,11101,3700,7401,3700,0,1,3702,3666448,3.666448
7100,700,3700,4970000,2,29606,7403,1,270640000,270640000,11101,3700,7401,3700,0,1,3702,3486505,3.486505
7100,700,3700,4970000,2,29606,7403,1,270640000,270640000,11101,3700,7401,3700,0,1,3702,3513327,3.513327
7100,700,3700,4970000,2,29606,7403,1,270640000,270640000,11101,3700,7401,3700,0,1,3702,3589535,3.589535
7100,700,4100,4970000,2,32806,8203,1,295600000,295600000,12301,4100,8201,4100,0,1,4102,3844019,3.844019
7100,700,4100,4970000,2,32806,8203,1,295600000,295600000,12301,4100,8201,4100,0,1,4102,4017213,4.017213
7100,700,4100,4970000,2,32806,8203,1,295600000,295600000,12301,4100,8201,4100,0,1,4102,3886258,3.886258
7100,700,4100,4970000,2,32806,8203,1,295600000,295600000,12301,4100,8201,4100,0,1,4102,4053902,4.053902
7100,700,4100,4970000,2,32806,8203,1,295600000,295600000,12301,4100,8201,4100,0,1,4102,3870815,3.870815
7100,700,4100,4970000,2,32806,8203,1,295600000,295600000,12301,4100,8201,4100,0,1,4102,3890011,3.890011
7100,700,4100,4970000,2,32806,8203,1,295600000,295600000,12301,4100,8201,4100,0,1,4102,3983278,3.983278
7100,700,4500,4970000,2,36006,9003,1,320560000,320560000,13501,4500,9001,4500,0,1,4502,4224111,4.224111
7100,700,4500,4970000,2,36006,9003,1,320560000,320560000,13501,4500,9001,4500,0,1,4502,4424717,4.424717
7100,700,4500,4970000,2,36006,9003,1,320560000,320560000,13501,4500,9001,4500,0,1,4502,4227869,4.227869
7100,700,4500,4970000,2,36006,9003,1,320560000,320560000,13501,4500,9001,4500,0,1,4502,4456613,4.456613
7100,700,4500,4970000,2,36006,9003,1,320560000,320560000,13501,4500,9001,4500,0,1,4502,4235987,4.235987
7100,700,4500,4970000,2,36006,9003,1,320560000,320560000,13501,4500,9001,4500,0,1,4502,4258368,4.258368
7100,700,4500,4970000,2,36006,9003,1,320560000,320560000,13501,4500,9001,4500,0,1,4502,4370068,4.370068
7100,700,4900,4970000,2,39206,9803,1,345520000,345520000,14701,4900,9801,4900,0,1,4902,4777969,4.777969
7100,700,4900,4970000,2,39206,9803,1,345520000,345520000,14701,4900,9801,4900,0,1,4902,4925263,4.925263
7100,700,4900,4970000,2,39206,9803,1,345520000,345520000,14701,4900,9801,4900,0,1,4902,4761176,4.761176
7100,700,4900,4970000,2,39206,9803,1,345520000,345520000,14701,4900,9801,4900,0,1,4902,4972671,4.972671
7100,700,4900,4970000,2,39206,9803,1,345520000,345520000,14701,4900,9801,4900,0,1,4902,4757387,4.757387
7100,700,4900,4970000,2,39206,9803,1,345520000,345520000,14701,4900,9801,4900,0,1,4902,4797484,4.797484
7100,700,4900,4970000,2,39206,9803,1,345520000,345520000,14701,4900,9801,4900,0,1,4902,4886400,4.8864
7100,700,5300,4970000,2,42406,10603,1,370480000,370480000,15901,5300,10601,5300,0,1,5302,4970226,4.970226
7100,700,5300,4970000,2,42406,10603,1,370480000,370480000,15901,5300,10601,5300,0,1,5302,5211749,5.211749
7100,700,5300,4970000,2,42406,10603,1,370480000,370480000,15901,5300,10601,5300,0,1,5302,4973990,4.97399
7100,700,5300,4970000,2,42406,10603,1,370480000,370480000,15901,5300,10601,5300,0,1,5302,5245087,5.245087
7100,700,5300,4970000,2,42406,10603,1,370480000,370480000,15901,5300,10601,5300,0,1,5302,4987684,4.987684
7100,700,5300,4970000,2,42406,10603,1,370480000,370480000,15901,5300,10601,5300,0,1,5302,5013418,5.013418
7100,700,5300,4970000,2,42406,10603,1,370480000,370480000,15901,5300,10601,5300,0,1,5302,5137549,5.137549
7100,700,5700,4970000,2,45606,11403,1,395440000,395440000,17101,5700,11401,5700,0,1,5702,5388332,5.388332
7100,700,5700,4970000,2,45606,11403,1,395440000,395440000,17101,5700,11401,5700,0,1,5702,5608722,5.608722
7100,700,5700,4970000,2,45606,11403,1,395440000,395440000,17101,5700,11401,5700,0,1,5702,5348228,5.348228
7100,700,5700,4970000,2,45606,11403,1,395440000,395440000,17101,5700,11401,5700,0,1,5702,5648995,5.648995
7100,700,5700,4970000,2,45606,11403,1,395440000,395440000,17101,5700,11401,5700,0,1,5702,5384594,5.384594
7100,700,5700,4970000,2,45606,11403,1,395440000,395440000,17101,5700,11401,5700,0,1,5702,5399640,5.39964
7100,700,5700,4970000,2,45606,11403,1,395440000,395440000,17101,5700,11401,5700,0,1,5702,5549874,5.549874
7100,700,6100,4970000,2,48806,12203,1,420400000,420400000,18301,6100,12201,6100,0,1,6102,5912682,5.912682
7100,700,6100,4970000,2,48806,12203,1,420400000,420400000,18301,6100,12201,6100,0,1,6102,6113309,6.113309
7100,700,6100,4970000,2,48806,12203,1,420400000,420400000,18301,6100,12201,6100,0,1,6102,5883433,5.883433
7100,700,6100,4970000,2,48806,12203,1,420400000,420400000,18301,6100,12201,6100,0,1,6102,6167917,6.167917
7100,700,6100,4970000,2,48806,12203,1,420400000,420400000,18301,6100,12201,6100,0,1,6102,5893625,5.893625
7100,700,6100,4970000,2,48806,12203,1,420400000,420400000,18301,6100,12201,6100,0,1,6102,5929507,5.929507
7100,700,6100,4970000,2,48806,12203,1,420400000,420400000,18301,6100,12201,6100,0,1,6102,6080776,6.080776
7100,700,6500,4970000,2,52006,13003,1,445360000,445360000,19501,6500,13001,6500,0,1,6502,6092339,6.092339
7100,700,6500,4970000,2,52006,13003,1,445360000,445360000,19501,6500,13001,6500,0,1,6502,6381887,6.381887
7100,700,6500,4970000,2,52006,13003,1,445360000,445360000,19501,6500,13001,6500,0,1,6502,6099545,6.099545
7100,700,6500,4970000,2,52006,13003,1,445360000,445360000,19501,6500,13001,6500,0,1,6502,6415106,6.415106
7100,700,6500,4970000,2,52006,13003,1,445360000,445360000,19501,6500,13001,6500,0,1,6502,6176890,6.17689
7100,700,6500,4970000,2,52006,13003,1,445360000,445360000,19501,6500,13001,6500,0,1,6502,6180666,6.180666
7100,700,6500,4970000,2,52006,13003,1,445360000,445360000,19501,6500,13001,6500,0,1,6502,6286029,6.286029
7100,700,6900,4970000,2,55206,13803,1,470320000,470320000,20701,6900,13801,6900,0,1,6902,6666371,6.666371
7100,700,6900,4970000,2,55206,13803,1,470320000,470320000,20701,6900,13801,6900,0,1,6902,6894286,6.894286
7100,700,6900,4970000,2,55206,13803,1,470320000,470320000,20701,6900,13801,6900,0,1,6902,6630056,6.630056
7100,700,6900,4970000,2,55206,13803,1,470320000,470320000,20701,6900,13801,6900,0,1,6902,6890151,6.890151
7100,700,6900,4970000,2,55206,13803,1,470320000,470320000,20701,6900,13801,6900,0,1,6902,6587960,6.58796
7100,700,6900,4970000,2,55206,13803,1,470320000,470320000,20701,6900,13801,6900,0,1,6902,6676429,6.676429
7100,700,6900,4970000,2,55206,13803,1,470320000,470320000,20701,6900,13801,6900,0,1,6902,6779504,6.779504
7100,300,500,2130000,2,4006,1003,1,46640000,46640000,1501,500,1001,500,0,1,502,229318,0.229318
7100,300,500,2130000,2,4006,1003,1,46640000,46640000,1501,500,1001,500,0,1,502,230919,0.230919
7100,300,500,2130000,2,4006,1003,1,46640000,46640000,1501,500,1001,500,0,1,502,223205,0.223205
7100,300,500,2130000,2,4006,1003,1,46640000,46640000,1501,500,1001,500,0,1,502,231163,0.231163
7100,300,500,2130000,2,4006,1003,1,46640000,46640000,1501,500,1001,500,0,1,502,226964,0.226964
7100,300,500,2130000,2,4006,1003,1,46640000,46640000,1501,500,1001,500,0,1,502,229642,0.229642
7100,300,500,2130000,2,4006,1003,1,46640000,46640000,1501,500,1001,500,0,1,502,223562,0.223562
7100,300,900,2130000,2,7206,1803,1,70320000,70320000,2701,900,1801,900,0,1,902,385569,0.385569
7100,300,900,2130000,2,7206,1803,1,70320000,70320000,2701,900,1801,900,0,1,902,383223,0.383223
7100,300,900,2130000,2,7206,1803,1,70320000,70320000,2701,900,1801,900,0,1,902,381253,0.381253
7100,300,900,2130000,2,7206,1803,1,70320000,70320000,2701,900,1801,900,0,1,902,388673,0.388673
7100,300,900,2130000,2,7206,1803,1,70320000,70320000,2701,900,1801,900,0,1,902,383511,0.383511
7100,300,900,2130000,2,7206,1803,1,70320000,70320000,2701,900,1801,900,0,1,902,388444,0.388444
7100,300,900,2130000,2,7206,1803,1,70320000,70320000,2701,900,1801,900,0,1,902,382816,0.382816
7100,300,1300,2130000,2,10406,2603,1,94000000,94000000,3901,1300,2601,1300,0,1,1302,541674,0.541674
7100,300,1300,2130000,2,10406,2603,1,94000000,94000000,3901,1300,2601,1300,0,1,1302,554491,0.554491
7100,300,1300,2130000,2,10406,2603,1,94000000,94000000,3901,1300,2601,1300,0,1,1302,539930,0.53993
7100,300,1300,2130000,2,10406,2603,1,94000000,94000000,3901,1300,2601,1300,0,1,1302,557152,0.557152
7100,300,1300,2130000,2,10406,2603,1,94000000,94000000,3901,1300,2601,1300,0,1,1302,548282,0.548282
7100,300,1300,2130000,2,10406,2603,1,94000000,94000000,3901,1300,2601,1300,0,1,1302,560085,0.560085
7100,300,1300,2130000,2,10406,2603,1,94000000,94000000,3901,1300,2601,1300,0,1,1302,546578,0.546578
7100,300,1700,2130000,2,13606,3403,1,117680000,117680000,5101,1700,3401,1700,0,1,1702,715475,0.715475
7100,300,1700,2130000,2,13606,3403,1,117680000,117680000,5101,1700,3401,1700,0,1,1702,749280,0.74928
7100,300,1700,2130000,2,13606,3403,1,117680000,117680000,5101,1700,3401,1700,0,1,1702,720087,0.720087
7100,300,1700,2130000,2,13606,3403,1,117680000,117680000,5101,1700,3401,1700,0,1,1702,747407,0.747407
7100,300,1700,2130000,2,13606,3403,1,117680000,117680000,5101,1700,3401,1700,0,1,1702,717320,0.71732
7100,300,1700,2130000,2,13606,3403,1,117680000,117680000,5101,1700,3401,1700,0,1,1702,734044,0.734044
7100,300,1700,2130000,2,13606,3403,1,117680000,117680000,5101,1700,3401,1700,0,1,1702,736818,0.736818
7100,300,2100,2130000,2,16806,4203,1,141360000,141360000,6301,2100,4201,2100,0,1,2102,885643,0.885643
7100,300,2100,2130000,2,16806,4203,1,141360000,141360000,6301,2100,4201,2100,0,1,2102,929143,0.929143
7100,300,2100,2130000,2,16806,4203,1,141360000,141360000,6301,2100,4201,2100,0,1,2102,885967,0.885967
7100,300,2100,2130000,2,16806,4203,1,141360000,141360000,6301,2100,4201,2100,0,1,2102,931087,0.931087
7100,300,2100,2130000,2,16806,4203,1,141360000,141360000,6301,2100,4201,2100,0,1,2102,883537,0.883537
7100,300,2100,2130000,2,16806,4203,1,141360000,141360000,6301,2100,4201,2100,0,1,2102,912624,0.912624
7100,300,2100,2130000,2,16806,4203,1,141360000,141360000,6301,2100,4201,2100,0,1,2102,910721,0.910721
7100,300,2500,2130000,2,20006,5003,1,165040000,165040000,7501,2500,5001,2500,0,1,2502,1062796,1.062796
7100,300,2500,2130000,2,20006,5003,1,165040000,165040000,7501,2500,5001,2500,0,1,2502,1099174,1.099174
7100,300,2500,2130000,2,20006,5003,1,165040000,165040000,7501,2500,5001,2500,0,1,2502,1053506,1.053506
7100,300,2500,2130000,2,20006,5003,1,165040000,165040000,7501,2500,5001,2500,0,1,2502,1102089,1.102089
7100,300,2500,2130000,2,20006,5003,1,165040000,165040000,7501,2500,5001,2500,0,1,2502,1058938,1.058938
7100,300,2500,2130000,2,20006,5003,1,165040000,165040000,7501,2500,5001,2500,0,1,2502,1077049,1.077049
7100,300,2500,2130000,2,20006,5003,1,165040000,165040000,7501,2500,5001,2500,0,1,2502,1086460,1.08646
7100,300,2900,2130000,2,23206,5803,1,188720000,188720000,8701,2900,5801,2900,0,1,2902,1228213,1.228213
7100,300,2900,2130000,2,23206,5803,1,188720000,188720000,8701,2900,5801,2900,0,1,2902,1270946,1.270946
7100,300,2900,2130000,2,23206,5803,1,188720000,188720000,8701,2900,5801,2900,0,1,2902,1210220,1.21022
7100,300,2900,2130000,2,23206,5803,1,188720000,188720000,8701,2900,5801,2900,0,1,2902,1270589,1.270589
7100,300,2900,2130000,2,23206,5803,1,188720000,188720000,8701,2900,5801,2900,0,1,2902,1196780,1.19678
7100,300,2900,2130000,2,23206,5803,1,188720000,188720000,8701,2900,5801,2900,0,1,2902,1244712,1.244712
7100,300,2900,2130000,2,23206,5803,1,188720000,188720000,8701,2900,5801,2900,0,1,2902,1262042,1.262042
7100,300,3300,2130000,2,26406,6603,1,212400000,212400000,9901,3300,6601,3300,0,1,3302,1404015,1.404015
7100,300,3300,2130000,2,26406,6603,1,212400000,212400000,9901,3300,6601,3300,0,1,3302,1452217,1.452217
7100,300,3300,2130000,2,26406,6603,1,212400000,212400000,9901,3300,6601,3300,0,1,3302,1402019,1.402019
7100,300,3300,2130000,2,26406,6603,1,212400000,212400000,9901,3300,6601,3300,0,1,3302,1458993,1.458993
7100,300,3300,2130000,2,26406,6603,1,212400000,212400000,9901,3300,6601,3300,0,1,3302,1404456,1.404456
7100,300,3300,2130000,2,26406,6603,1,212400000,212400000,9901,3300,6601,3300,0,1,3302,1424664,1.424664
7100,300,3300,2130000,2,26406,6603,1,212400000,212400000,9901,3300,6601,3300,0,1,3302,1433694,1.433694
7100,300,3700,2130000,2,29606,7403,1,236080000,236080000,11101,3700,7401,3700,0,1,3702,1545132,1.545132
7100,300,3700,2130000,2,29606,7403,1,236080000,236080000,11101,3700,7401,3700,0,1,3702,1604687,1.604687
7100,300,3700,2130000,2,29606,7403,1,236080000,236080000,11101,3700,7401,3700,0,1,3702,1539477,1.539477
7100,300,3700,2130000,2,29606,7403,1,236080000,236080000,11101,3700,7401,3700,0,1,3702,1609708,1.609708
7100,300,3700,2130000,2,29606,7403,1,236080000,236080000,11101,3700,7401,3700,0,1,3702,1554132,1.554132
7100,300,3700,2130000,2,29606,7403,1,236080000,236080000,11101,3700,7401,3700,0,1,3702,1560475,1.560475
7100,300,3700,2130000,2,29606,7403,1,236080000,236080000,11101,3700,7401,3700,0,1,3702,1585137,1.585137
7100,300,4100,2130000,2,32806,8203,1,259760000,259760000,12301,4100,8201,4100,0,1,4102,1709108,1.709108
7100,300,4100,2130000,2,32806,8203,1,259760000,259760000,12301,4100,8201,4100,0,1,4102,1767285,1.767285
7100,300,4100,2130000,2,32806,8203,1,259760000,259760000,12301,4100,8201,4100,0,1,4102,1705314,1.705314
7100,300,4100,2130000,2,32806,8203,1,259760000,259760000,12301,4100,8201,4100,0,1,4102,1786495,1.786495
7100,300,4100,2130000,2,32806,8203,1,259760000,259760000,12301,4100,8201,4100,0,1,4102,1715375,1.715375
7100,300,4100,2130000,2,32806,8203,1,259760000,259760000,12301,4100,8201,4100,0,1,4102,1718855,1.718855
7100,300,4100,2130000,2,32806,8203,1,259760000,259760000,12301,4100,8201,4100,0,1,4102,1749719,1.749719
7100,300,4500,2130000,2,36006,9003,1,283440000,283440000,13501,4500,9001,4500,0,1,4502,1880184,1.880184
7100,300,4500,2130000,2,36006,9003,1,283440000,283440000,13501,4500,9001,4500,0,1,4502,1949327,1.949327
7100,300,4500,2130000,2,36006,9003,1,283440000,283440000,13501,4500,9001,4500,0,1,4502,1874670,1.87467
7100,300,4500,2130000,2,36006,9003,1,283440000,283440000,13501,4500,9001,4500,0,1,4502,1963326,1.963326
7100,300,4500,2130000,2,36006,9003,1,283440000,283440000,13501,4500,9001,4500,0,1,4502,1872807,1.872807
7100,300,4500,2130000,2,36006,9003,1,283440000,283440000,13501,4500,9001,4500,0,1,4502,1943025,1.943025
7100,300,4500,2130000,2,36006,9003,1,283440000,283440000,13501,4500,9001,4500,0,1,4502,1917711,1.917711
7100,300,4900,2130000,2,39206,9803,1,307120000,307120000,14701,4900,9801,4900,0,1,4902,2261874,2.261874
7100,300,4900,2130000,2,39206,9803,1,307120000,307120000,14701,4900,9801,4900,0,1,4902,2246525,2.246525
7100,300,4900,2130000,2,39206,9803,1,307120000,307120000,14701,4900,9801,4900,0,1,4902,2212650,2.21265
7100,300,4900,2130000,2,39206,9803,1,307120000,307120000,14701,4900,9801,4900,0,1,4902,2244826,2.244826
7100,300,4900,2130000,2,39206,9803,1,307120000,307120000,14701,4900,9801,4900,0,1,4902,2178939,2.178939
7100,300,4900,2130000,2,39206,9803,1,307120000,307120000,14701,4900,9801,4900,0,1,4902,2258555,2.258555
7100,300,4900,2130000,2,39206,9803,1,307120000,307120000,14701,4900,9801,4900,0,1,4902,2123590,2.12359
7100,300,5300,2130000,2,42406,10603,1,330800000,330800000,15901,5300,10601,5300,0,1,5302,2222210,2.22221
7100,300,5300,2130000,2,42406,10603,1,330800000,330800000,15901,5300,10601,5300,0,1,5302,2299377,2.299377
7100,300,5300,2130000,2,42406,10603,1,330800000,330800000,15901,5300,10601,5300,0,1,5302,2217971,2.217971
7100,300,5300,2130000,2,42406,10603,1,330800000,330800000,15901,5300,10601,5300,0,1,5302,2331013,2.331013
7100,300,5300,2130000,2,42406,10603,1,330800000,330800000,15901,5300,10601,5300,0,1,5302,2217451,2.217451
7100,300,5300,2130000,2,42406,10603,1,330800000,330800000,15901,5300,10601,5300,0,1,5302,2258667,2.258667
7100,300,5300,2130000,2,42406,10603,1,330800000,330800000,15901,5300,10601,5300,0,1,5302,2308992,2.308992
7100,300,5700,2130000,2,45606,11403,1,354480000,354480000,17101,5700,11401,5700,0,1,5702,2374399,2.374399
7100,300,5700,2130000,2,45606,11403,1,354480000,354480000,17101,5700,11401,5700,0,1,5702,2452583,2.452583
7100,300,5700,2130000,2,45606,11403,1,354480000,354480000,17101,5700,11401,5700,0,1,5702,2395998,2.395998
7100,300,5700,2130000,2,45606,11403,1,354480000,354480000,17101,5700,11401,5700,0,1,5702,2461949,2.461949
7100,300,5700,2130000,2,45606,11403,1,354480000,354480000,17101,5700,11401,5700,0,1,5702,2394854,2.394854
7100,300,5700,2130000,2,45606,11403,1,354480000,354480000,17101,5700,11401,5700,0,1,5702,2395440,2.39544
7100,300,5700,2130000,2,45606,11403,1,354480000,354480000,17101,5700,11401,5700,0,1,5702,2436118,2.436118
7100,300,6100,2130000,2,48806,12203,1,378160000,378160000,18301,6100,12201,6100,0,1,6102,2576309,2.576309
7100,300,6100,2130000,2,48806,12203,1,378160000,378160000,18301,6100,12201,6100,0,1,6102,2629953,2.629953
7100,300,6100,2130000,2,48806,12203,1,378160000,378160000,18301,6100,12201,6100,0,1,6102,2534279,2.534279
7100,300,6100,2130000,2,48806,12203,1,378160000,378160000,18301,6100,12201,6100,0,1,6102,2678458,2.678458
7100,300,6100,2130000,2,48806,12203,1,378160000,378160000,18301,6100,12201,6100,0,1,6102,2555850,2.55585
7100,300,6100,2130000,2,48806,12203,1,378160000,378160000,18301,6100,12201,6100,0,1,6102,2559422,2.559422
7100,300,6100,2130000,2,48806,12203,1,378160000,378160000,18301,6100,12201,6100,0,1,6102,2627876,2.627876
7100,300,6500,2130000,2,52006,13003,1,401840000,401840000,19501,6500,13001,6500,0,1,6502,2712520,2.71252
7100,300,6500,2130000,2,52006,13003,1,401840000,401840000,19501,6500,13001,6500,0,1,6502,2795292,2.795292
7100,300,6500,2130000,2,52006,13003,1,401840000,401840000,19501,6500,13001,6500,0,1,6502,2704579,2.704579
7100,300,6500,2130000,2,52006,13003,1,401840000,401840000,19501,6500,13001,6500,0,1,6502,2835737,2.835737
7100,300,6500,2130000,2,52006,13003,1,401840000,401840000,19501,6500,13001,6500,0,1,6502,2734438,2.734438
7100,300,6500,2130000,2,52006,13003,1,401840000,401840000,19501,6500,13001,6500,0,1,6502,2708700,2.7087
7100,300,6500,2130000,2,52006,13003,1,401840000,401840000,19501,6500,13001,6500,0,1,6502,2776175,2.776175
7100,300,6900,2130000,2,55206,13803,1,425520000,425520000,20701,6900,13801,6900,0,1,6902,2880392,2.880392
7100,300,6900,2130000,2,55206,13803,1,425520000,425520000,20701,6900,13801,6900,0,1,6902,2977183,2.977183
7100,300,6900,2130000,2,55206,13803,1,425520000,425520000,20701,6900,13801,6900,0,1,6902,2904514,2.904514
7100,300,6900,2130000,2,55206,13803,1,425520000,425520000,20701,6900,13801,6900,0,1,6902,3009623,3.009623
7100,300,6900,2130000,2,55206,13803,1,425520000,425520000,20701,6900,13801,6900,0,1,6902,2900793,2.900793
7100,300,6900,2130000,2,55206,13803,1,425520000,425520000,20701,6900,13801,6900,0,1,6902,2896899,2.896899
7100,300,6900,2130000,2,55206,13803,1,425520000,425520000,20701,6900,13801,6900,0,1,6902,2981309,2.981309
6700,7100,500,47570000,2,4006,1003,1,435760000,435760000,1501,500,1001,500,0,1,502,4909331,4.909331
6700,7100,500,47570000,2,4006,1003,1,435760000,435760000,1501,500,1001,500,0,1,502,5047347,5.047347
6700,7100,500,47570000,2,4006,1003,1,435760000,435760000,1501,500,1001,500,0,1,502,4877234,4.877234
6700,7100,500,47570000,2,4006,1003,1,435760000,435760000,1501,500,1001,500,0,1,502,5161376,5.161376
6700,7100,500,47570000,2,4006,1003,1,435760000,435760000,1501,500,1001,500,0,1,502,4941638,4.941638
6700,7100,500,47570000,2,4006,1003,1,435760000,435760000,1501,500,1001,500,0,1,502,4942820,4.94282
6700,7100,500,47570000,2,4006,1003,1,435760000,435760000,1501,500,1001,500,0,1,502,5011263,5.011263
6700,7100,900,47570000,2,7206,1803,1,479920000,479920000,2701,900,1801,900,0,1,902,8194997,8.194997
6700,7100,900,47570000,2,7206,1803,1,479920000,479920000,2701,900,1801,900,0,1,902,8545453,8.545453
6700,7100,900,47570000,2,7206,1803,1,479920000,479920000,2701,900,1801,900,0,1,902,8193470,8.19347
6700,7100,900,47570000,2,7206,1803,1,479920000,479920000,2701,900,1801,900,0,1,902,8639476,8.639476
6700,7100,900,47570000,2,7206,1803,1,479920000,479920000,2701,900,1801,900,0,1,902,8254814,8.254814
6700,7100,900,47570000,2,7206,1803,1,479920000,479920000,2701,900,1801,900,0,1,902,8196159,8.196159
6700,7100,900,47570000,2,7206,1803,1,479920000,479920000,2701,900,1801,900,0,1,902,8470955,8.470955
6700,7100,1300,47570000,2,10406,2603,1,524080000,524080000,3901,1300,2601,1300,0,1,1302,11837890,11.83789
6700,7100,1300,47570000,2,10406,2603,1,524080000,524080000,3901,1300,2601,1300,0,1,1302,12249278,12.249278
6700,7100,1300,47570000,2,10406,2603,1,524080000,524080000,3901,1300,2601,1300,0,1,1302,11836378,11.836378
6700,7100,1300,47570000,2,10406,2603,1,524080000,524080000,3901,1300,2601,1300,0,1,1302,12348900,12.3489
6700,7100,1300,47570000,2,10406,2603,1,524080000,524080000,3901,1300,2601,1300,0,1,1302,11838907,11.838907
6700,7100,1300,47570000,2,10406,2603,1,524080000,524080000,3901,1300,2601,1300,0,1,1302,11803771,11.803771
6700,7100,1300,47570000,2,10406,2603,1,524080000,524080000,3901,1300,2601,1300,0,1,1302,12136828,12.136828
6700,7100,1700,47570000,2,13606,3403,1,568240000,568240000,5101,1700,3401,1700,0,1,1702,15249788,15.249788
6700,7100,1700,47570000,2,13606,3403,1,568240000,568240000,5101,1700,3401,1700,0,1,1702,15877674,15.877674
6700,7100,1700,47570000,2,13606,3403,1,568240000,568240000,5101,1700,3401,1700,0,1,1702,15283035,15.283035
6700,7100,1700,47570000,2,13606,3403,1,568240000,568240000,5101,1700,3401,1700,0,1,1702,16034594,16.034594
6700,7100,1700,47570000,2,13606,3403,1,568240000,568240000,5101,1700,3401,1700,0,1,1702,15322212,15.322212
6700,7100,1700,47570000,2,13606,3403,1,568240000,568240000,5101,1700,3401,1700,0,1,1702,15289809,15.289809
6700,7100,1700,47570000,2,13606,3403,1,568240000,568240000,5101,1700,3401,1700,0,1,1702,15752443,15.752443
6700,7100,2100,47570000,2,16806,4203,1,612400000,612400000,6301,2100,4201,2100,0,1,2102,18771441,18.771441
6700,7100,2100,47570000,2,16806,4203,1,612400000,612400000,6301,2100,4201,2100,0,1,2102,19501429,19.501429
6700,7100,2100,47570000,2,16806,4203,1,612400000,612400000,6301,2100,4201,2100,0,1,2102,18706388,18.706388
6700,7100,2100,47570000,2,16806,4203,1,612400000,612400000,6301,2100,4201,2100,0,1,2102,19698686,19.698686
6700,7100,2100,47570000,2,16806,4203,1,612400000,612400000,6301,2100,4201,2100,0,1,2102,18803485,18.803485
6700,7100,2100,47570000,2,16806,4203,1,612400000,612400000,6301,2100,4201,2100,0,1,2102,18739608,18.739608
6700,7100,2100,47570000,2,16806,4203,1,612400000,612400000,6301,2100,4201,2100,0,1,2102,19361573,19.361573
6700,7100,2500,47570000,2,20006,5003,1,656560000,656560000,7501,2500,5001,2500,0,1,2502,22197636,22.197636
6700,7100,2500,47570000,2,20006,5003,1,656560000,656560000,7501,2500,5001,2500,0,1,2502,23170802,23.170802
6700,7100,2500,47570000,2,20006,5003,1,656560000,656560000,7501,2500,5001,2500,0,1,2502,22195970,22.19597
6700,7100,2500,47570000,2,20006,5003,1,656560000,656560000,7501,2500,5001,2500,0,1,2502,23328987,23.328987
6700,7100,2500,47570000,2,20006,5003,1,656560000,656560000,7501,2500,5001,2500,0,1,2502,22230635,22.230635
6700,7100,2500,47570000,2,20006,5003,1,656560000,656560000,7501,2500,5001,2500,0,1,2502,22163129,22.163129
6700,7100,2500,47570000,2,20006,5003,1,656560000,656560000,7501,2500,5001,2500,0,1,2502,22911605,22.911605
6700,7100,2900,47570000,2,23206,5803,1,700720000,700720000,8701,2900,5801,2900,0,1,2902,25592152,25.592152
6700,7100,2900,47570000,2,23206,5803,1,700720000,700720000,8701,2900,5801,2900,0,1,2902,26873734,26.873734
6700,7100,2900,47570000,2,23206,5803,1,700720000,700720000,8701,2900,5801,2900,0,1,2902,25657809,25.657809
6700,7100,2900,47570000,2,23206,5803,1,700720000,700720000,8701,2900,5801,2900,0,1,2902,26962951,26.962951
6700,7100,2900,47570000,2,23206,5803,1,700720000,700720000,8701,2900,5801,2900,0,1,2902,25690446,25.690446
6700,7100,2900,47570000,2,23206,5803,1,700720000,700720000,8701,2900,5801,2900,0,1,2902,25624619,25.624619
6700,7100,2900,47570000,2,23206,5803,1,700720000,700720000,8701,2900,5801,2900,0,1,2902,26545417,26.545417
6700,7100,3300,47570000,2,26406,6603,1,744880000,744880000,9901,3300,6601,3300,0,1,3302,29061694,29.061694
6700,7100,3300,47570000,2,26406,6603,1,744880000,744880000,9901,3300,6601,3300,0,1,3302,30481241,30.481241
6700,7100,3300,47570000,2,26406,6603,1,744880000,744880000,9901,3300,6601,3300,0,1,3302,29179583,29.179583
6700,7100,3300,47570000,2,26406,6603,1,744880000,744880000,9901,3300,6601,3300,0,1,3302,30618831,30.618831
6700,7100,3300,47570000,2,26406,6603,1,744880000,744880000,9901,3300,6601,3300,0,1,3302,29127152,29.127152
6700,7100,3300,47570000,2,26406,6603,1,744880000,744880000,9901,3300,6601,3300,0,1,3302,29094830,29.09483
6700,7100,3300,47570000,2,26406,6603,1,744880000,744880000,9901,3300,6601,3300,0,1,3302,30119177,30.119177
6700,7100,3700,47570000,2,29606,7403,1,789040000,789040000,11101,3700,7401,3700,0,1,3702,32510288,32.510288
6700,7100,3700,47570000,2,29606,7403,1,789040000,789040000,11101,3700,7401,3700,0,1,3702,34208081,34.208081
6700,7100,3700,47570000,2,29606,7403,1,789040000,789040000,11101,3700,7401,3700,0,1,3702,32619936,32.619936
6700,7100,3700,47570000,2,29606,7403,1,789040000,789040000,11101,3700,7401,3700,0,1,3702,34267827,34.267827
6700,7100,3700,47570000,2,29606,7403,1,789040000,789040000,11101,3700,7401,3700,0,1,3702,32670252,32.670252
6700,7100,3700,47570000,2,29606,7403,1,789040000,789040000,11101,3700,7401,3700,0,1,3702,32559685,32.559685
6700,7100,3700,47570000,2,29606,7403,1,789040000,789040000,11101,3700,7401,3700,0,1,3702,33775995,33.775995
6700,7100,4100,47570000,2,32806,8203,1,833200000,833200000,12301,4100,8201,4100,0,1,4102,36007507,36.007507
6700,7100,4100,47570000,2,32806,8203,1,833200000,833200000,12301,4100,8201,4100,0,1,4102,37729688,37.729688
6700,7100,4100,47570000,2,32806,8203,1,833200000,833200000,12301,4100,8201,4100,0,1,4102,36060627,36.060627
6700,7100,4100,47570000,2,32806,8203,1,833200000,833200000,12301,4100,8201,4100,0,1,4102,37941416,37.941416
6700,7100,4100,47570000,2,32806,8203,1,833200000,833200000,12301,4100,8201,4100,0,1,4102,36062162,36.062162
6700,7100,4100,47570000,2,32806,8203,1,833200000,833200000,12301,4100,8201,4100,0,1,4102,36058750,36.05875
6700,7100,4100,47570000,2,32806,8203,1,833200000,833200000,12301,4100,8201,4100,0,1,4102,37325337,37.325337
6700,7100,4500,47570000,2,36006,9003,1,877360000,877360000,13501,4500,9001,4500,0,1,4502,39538406,39.538406
6700,7100,4500,47570000,2,36006,9003,1,877360000,877360000,13501,4500,9001,4500,0,1,4502,41499024,41.499024
6700,7100,4500,47570000,2,36006,9003,1,877360000,877360000,13501,4500,9001,4500,0,1,4502,39572568,39.572568
6700,7100,4500,47570000,2,36006,9003,1,877360000,877360000,13501,4500,9001,4500,0,1,4502,41640270,41.64027
6700,7100,4500,47570000,2,36006,9003,1,877360000,877360000,13501,4500,9001,4500,0,1,4502,39570844,39.570844
6700,7100,4500,47570000,2,36006,9003,1,877360000,877360000,13501,4500,9001,4500,0,1,4502,39506303,39.506303
6700,7100,4500,47570000,2,36006,9003,1,877360000,877360000,13501,4500,9001,4500,0,1,4502,40950390,40.95039
6700,7100,4900,47570000,2,39206,9803,1,921520000,921520000,14701,4900,9801,4900,0,1,4902,42974978,42.974978
6700,7100,4900,47570000,2,39206,9803,1,921520000,921520000,14701,4900,9801,4900,0,1,4902,45122613,45.122613
6700,7100,4900,47570000,2,39206,9803,1,921520000,921520000,14701,4900,9801,4900,0,1,4902,43133287,43.133287
6700,7100,4900,47570000,2,39206,9803,1,921520000,921520000,14701,4900,9801,4900,0,1,4902,45290563,45.290563
6700,7100,4900,47570000,2,39206,9803,1,921520000,921520000,14701,4900,9801,4900,0,1,4902,43007035,43.007035
6700,7100,4900,47570000,2,39206,9803,1,921520000,921520000,14701,4900,9801,4900,0,1,4902,43040997,43.040997
6700,7100,4900,47570000,2,39206,9803,1,921520000,921520000,14701,4900,9801,4900,0,1,4902,44567469,44.567469
6700,7100,5300,47570000,2,42406,10603,1,965680000,965680000,15901,5300,10601,5300,0,1,5302,46490900,46.4909
6700,7100,5300,47570000,2,42406,10603,1,965680000,965680000,15901,5300,10601,5300,0,1,5302,48905411,48.905411
6700,7100,5300,47570000,2,42406,10603,1,965680000,965680000,15901,5300,10601,5300,0,1,5302,46641376,46.641376
6700,7100,5300,47570000,2,42406,10603,1,965680000,965680000,15901,5300,10601,5300,0,1,5302,48999637,48.999637
6700,7100,5300,47570000,2,42406,10603,1,965680000,965680000,15901,5300,10601,5300,0,1,5302,46525262,46.525262
6700,7100,5300,47570000,2,42406,10603,1,965680000,965680000,15901,5300,10601,5300,0,1,5302,46523168,46.523168
6700,7100,5300,47570000,2,42406,10603,1,965680000,965680000,15901,5300,10601,5300,0,1,5302,48203778,48.203778
6700,7100,5700,47570000,2,45606,11403,1,1009840000,1009840000,17101,5700,11401,5700,0,1,5702,49995270,49.99527
6700,7100,5700,47570000,2,45606,11403,1,1009840000,1009840000,17101,5700,11401,5700,0,1,5702,52566992,52.566992
6700,7100,5700,47570000,2,45606,11403,1,1009840000,1009840000,17101,5700,11401,5700,0,1,5702,50243950,50.24395
6700,7100,5700,47570000,2,45606,11403,1,1009840000,1009840000,17101,5700,11401,5700,0,1,5702,52712983,52.712983
6700,7100,5700,47570000,2,45606,11403,1,1009840000,1009840000,17101,5700,11401,5700,0,1,5702,50088041,50.088041
6700,7100,5700,47570000,2,45606,11403,1,1009840000,1009840000,17101,5700,11401,5700,0,1,5702,50055779,50.055779
6700,7100,5700,47570000,2,45606,11403,1,1009840000,1009840000,17101,5700,11401,5700,0,1,5702,51917869,51.917869
6700,7100,6100,47570000,2,48806,12203,1,1054000000,1054000000,18301,6100,12201,6100,0,1,6102,53556448,53.556448
6700,7100,6100,47570000,2,48806,12203,1,1054000000,1054000000,18301,6100,12201,6100,0,1,6102,56379441,56.379441
6700,7100,6100,47570000,2,48806,12203,1,1054000000,1054000000,18301,6100,12201,6100,0,1,6102,53805021,53.805021
6700,7100,6100,47570000,2,48806,12203,1,1054000000,1054000000,18301,6100,12201,6100,0,1,6102,56413548,56.413548
6700,7100,6100,47570000,2,48806,12203,1,1054000000,1054000000,18301,6100,12201,6100,0,1,6102,53558191,53.558191
6700,7100,6100,47570000,2,48806,12203,1,1054000000,1054000000,18301,6100,12201,6100,0,1,6102,53523220,53.52322
6700,7100,6100,47570000,2,48806,12203,1,1054000000,1054000000,18301,6100,12201,6100,0,1,6102,55472269,55.472269
6700,7100,6500,47570000,2,52006,13003,1,1098160000,1098160000,19501,6500,13001,6500,0,1,6502,57063391,57.063391
6700,7100,6500,47570000,2,52006,13003,1,1098160000,1098160000,19501,6500,13001,6500,0,1,6502,60116688,60.116688
6700,7100,6500,47570000,2,52006,13003,1,1098160000,1098160000,19501,6500,13001,6500,0,1,6502,57279849,57.279849
6700,7100,6500,47570000,2,52006,13003,1,1098160000,1098160000,19501,6500,13001,6500,0,1,6502,60149003,60.149003
6700,7100,6500,47570000,2,52006,13003,1,1098160000,1098160000,19501,6500,13001,6500,0,1,6502,57126682,57.126682
6700,7100,6500,47570000,2,52006,13003,1,1098160000,1098160000,19501,6500,13001,6500,0,1,6502,57000023,57.000023
6700,7100,6500,47570000,2,52006,13003,1,1098160000,1098160000,19501,6500,13001,6500,0,1,6502,59214421,59.214421
6700,7100,6900,47570000,2,55206,13803,1,1142320000,1142320000,20701,6900,13801,6900,0,1,6902,60669695,60.669695
6700,7100,6900,47570000,2,55206,13803,1,1142320000,1142320000,20701,6900,13801,6900,0,1,6902,63858544,63.858544
6700,7100,6900,47570000,2,55206,13803,1,1142320000,1142320000,20701,6900,13801,6900,0,1,6902,60859982,60.859982
6700,7100,6900,47570000,2,55206,13803,1,1142320000,1142320000,20701,6900,13801,6900,0,1,6902,63895509,63.895509
6700,7100,6900,47570000,2,55206,13803,1,1142320000,1142320000,20701,6900,13801,6900,0,1,6902,60634744,60.634744
6700,7100,6900,47570000,2,55206,13803,1,1142320000,1142320000,20701,6900,13801,6900,0,1,6902,60539966,60.539966
6700,7100,6900,47570000,2,55206,13803,1,1142320000,1142320000,20701,6900,13801,6900,0,1,6902,62763181,62.763181
6700,6700,500,44890000,2,4006,1003,1,412720000,412720000,1501,500,1001,500,0,1,502,4706259,4.706259
6700,6700,500,44890000,2,4006,1003,1,412720000,412720000,1501,500,1001,500,0,1,502,4786247,4.786247
6700,6700,500,44890000,2,4006,1003,1,412720000,412720000,1501,500,1001,500,0,1,502,4602629,4.602629
6700,6700,500,44890000,2,4006,1003,1,412720000,412720000,1501,500,1001,500,0,1,502,4819516,4.819516
6700,6700,500,44890000,2,4006,1003,1,412720000,412720000,1501,500,1001,500,0,1,502,4676043,4.676043
6700,6700,500,44890000,2,4006,1003,1,412720000,412720000,1501,500,1001,500,0,1,502,4645832,4.645832
6700,6700,500,44890000,2,4006,1003,1,412720000,412720000,1501,500,1001,500,0,1,502,4738039,4.738039
6700,6700,900,44890000,2,7206,1803,1,455600000,455600000,2701,900,1801,900,0,1,902,7943800,7.9438
6700,6700,900,44890000,2,7206,1803,1,455600000,455600000,2701,900,1801,900,0,1,902,8174553,8.174553
6700,6700,900,44890000,2,7206,1803,1,455600000,455600000,2701,900,1801,900,0,1,902,7836174,7.836174
6700,6700,900,44890000,2,7206,1803,1,455600000,455600000,2701,900,1801,900,0,1,902,8221687,8.221687
6700,6700,900,44890000,2,7206,1803,1,455600000,455600000,2701,900,1801,900,0,1,902,7913004,7.913004
6700,6700,900,44890000,2,7206,1803,1,455600000,455600000,2701,900,1801,900,0,1,902,7943184,7.943184
6700,6700,900,44890000,2,7206,1803,1,455600000,455600000,2701,900,1801,900,0,1,902,8140946,8.140946
6700,6700,1300,44890000,2,10406,2603,1,498480000,498480000,3901,1300,2601,1300,0,1,1302,11050361,11.050361
6700,6700,1300,44890000,2,10406,2603,1,498480000,498480000,3901,1300,2601,1300,0,1,1302,11465236,11.465236
6700,6700,1300,44890000,2,10406,2603,1,498480000,498480000,3901,1300,2601,1300,0,1,1302,10989820,10.98982
6700,6700,1300,44890000,2,10406,2603,1,498480000,498480000,3901,1300,2601,1300,0,1,1302,11549107,11.549107
6700,6700,1300,44890000,2,10406,2603,1,498480000,498480000,3901,1300,2601,1300,0,1,1302,11051928,11.051928
6700,6700,1300,44890000,2,10406,2603,1,498480000,498480000,3901,1300,2601,1300,0,1,1302,11020004,11.020004
6700,6700,1300,44890000,2,10406,2603,1,498480000,498480000,3901,1300,2601,1300,0,1,1302,11400225,11.400225
6700,6700,1700,44890000,2,13606,3403,1,541360000,541360000,5101,1700,3401,1700,0,1,1702,14471914,14.471914
6700,6700,1700,44890000,2,13606,3403,1,541360000,541360000,5101,1700,3401,1700,0,1,1702,14970059,14.970059
6700,6700,1700,44890000,2,13606,3403,1,541360000,541360000,5101,1700,3401,1700,0,1,1702,14372121,14.372121
6700,6700,1700,44890000,2,13606,3403,1,541360000,541360000,5101,1700,3401,1700,0,1,1702,15139873,15.139873
6700,6700,1700,44890000,2,13606,3403,1,541360000,541360000,5101,1700,3401,1700,0,1,1702,14441010,14.44101
6700,6700,1700,44890000,2,13606,3403,1,541360000,541360000,5101,1700,3401,1700,0,1,1702,14410208,14.410208
6700,6700,1700,44890000,2,13606,3403,1,541360000,541360000,5101,1700,3401,1700,0,1,1702,14847060,14.84706
6700,6700,2100,44890000,2,16806,4203,1,584240000,584240000,6301,2100,4201,2100,0,1,2102,17721811,17.721811
6700,6700,2100,44890000,2,16806,4203,1,584240000,584240000,6301,2100,4201,2100,0,1,2102,18459209,18.459209
6700,6700,2100,44890000,2,16806,4203,1,584240000,584240000,6301,2100,4201,2100,0,1,2102,17644188,17.644188
6700,6700,2100,44890000,2,16806,4203,1,584240000,584240000,6301,2100,4201,2100,0,1,2102,18508490,18.50849
6700,6700,2100,44890000,2,16806,4203,1,584240000,584240000,6301,2100,4201,2100,0,1,2102,17676875,17.676875
6700,6700,2100,44890000,2,16806,4203,1,584240000,584240000,6301,2100,4201,2100,0,1,2102,17675221,17.675221
6700,6700,2100,44890000,2,16806,4203,1,584240000,584240000,6301,2100,4201,2100,0,1,2102,18231550,18.23155
6700,6700,2500,44890000,2,20006,5003,1,627120000,627120000,7501,2500,5001,2500,0,1,2502,20985842,20.985842
6700,6700,2500,44890000,2,20006,5003,1,627120000,627120000,7501,2500,5001,2500,0,1,2502,21849880,21.84988
6700,6700,2500,44890000,2,20006,5003,1,627120000,627120000,7501,2500,5001,2500,0,1,2502,20912529,20.912529
6700,6700,2500,44890000,2,20006,5003,1,627120000,627120000,7501,2500,5001,2500,0,1,2502,21986975,21.986975
6700,6700,2500,44890000,2,20006,5003,1,627120000,627120000,7501,2500,5001,2500,0,1,2502,20944373,20.944373
6700,6700,2500,44890000,2,20006,5003,1,627120000,627120000,7501,2500,5001,2500,0,1,2502,20942894,20.942894
6700,6700,2500,44890000,2,20006,5003,1,627120000,627120000,7501,2500,5001,2500,0,1,2502,21622599,21.622599
6700,6700,2900,44890000,2,23206,5803,1,670000000,670000000,8701,2900,5801,2900,0,1,2902,24243789,24.243789
6700,6700,2900,44890000,2,23206,5803,1,670000000,670000000,8701,2900,5801,2900,0,1,2902,25309944,25.309944
6700,6700,2900,44890000,2,23206,5803,1,670000000,670000000,8701,2900,5801,2900,0,1,2902,24137040,24.13704
6700,6700,2900,44890000,2,23206,5803,1,670000000,670000000,8701,2900,5801,2900,0,1,2902,25434307,25.434307
6700,6700,2900,44890000,2,23206,5803,1,670000000,670000000,8701,2900,5801,2900,0,1,2902,24183025,24.183025
6700,6700,2900,44890000,2,23206,5803,1,670000000,670000000,8701,2900,5801,2900,0,1,2902,24214019,24.214019
6700,6700,2900,44890000,2,23206,5803,1,670000000,670000000,8701,2900,5801,2900,0,1,2902,25048922,25.048922
6700,6700,3300,44890000,2,26406,6603,1,712880000,712880000,9901,3300,6601,3300,0,1,3302,27527243,27.527243
6700,6700,3300,44890000,2,26406,6603,1,712880000,712880000,9901,3300,6601,3300,0,1,3302,28773137,28.773137
6700,6700,3300,44890000,2,26406,6603,1,712880000,712880000,9901,3300,6601,3300,0,1,3302,27479871,27.479871
6700,6700,3300,44890000,2,26406,6603,1,712880000,712880000,9901,3300,6601,3300,0,1,3302,28881471,28.881471
6700,6700,3300,44890000,2,26406,6603,1,712880000,712880000,9901,3300,6601,3300,0,1,3302,27482270,27.48227
6700,6700,3300,44890000,2,26406,6603,1,712880000,712880000,9901,3300,6601,3300,0,1,3302,27449548,27.449548
6700,6700,3300,44890000,2,26406,6603,1,712880000,712880000,9901,3300,6601,3300,0,1,3302,28410388,28.410388
6700,6700,3700,44890000,2,29606,7403,1,755760000,755760000,11101,3700,7401,3700,0,1,3702,30814231,30.814231
6700,6700,3700,44890000,2,29606,7403,1,755760000,755760000,11101,3700,7401,3700,0,1,3702,32232119,32.232119
6700,6700,3700,44890000,2,29606,7403,1,755760000,755760000,11101,3700,7401,3700,0,1,3702,30736062,30.736062
6700,6700,3700,44890000,2,29606,7403,1,755760000,755760000,11101,3700,7401,3700,0,1,3702,32345005,32.345005
6700,6700,3700,44890000,2,29606,7403,1,755760000,755760000,11101,3700,7401,3700,0,1,3702,30767417,30.767417
6700,6700,3700,44890000,2,29606,7403,1,755760000,755760000,11101,3700,7401,3700,0,1,3702,30766444,30.766444
6700,6700,3700,44890000,2,29606,7403,1,755760000,755760000,11101,3700,7401,3700,0,1,3702,31798155,31.798155
6700,6700,4100,44890000,2,32806,8203,1,798640000,798640000,12301,4100,8201,4100,0,1,4102,34104927,34.104927
6700,6700,4100,44890000,2,32806,8203,1,798640000,798640000,12301,4100,8201,4100,0,1,4102,35568387,35.568387
6700,6700,4100,44890000,2,32806,8203,1,798640000,798640000,12301,4100,8201,4100,0,1,4102,34056266,34.056266
6700,6700,4100,44890000,2,32806,8203,1,798640000,798640000,12301,4100,8201,4100,0,1,4102,35771875,35.771875
6700,6700,4100,44890000,2,32806,8203,1,798640000,798640000,12301,4100,8201,4100,0,1,4102,33998721,33.998721
6700,6700,4100,44890000,2,32806,8203,1,798640000,798640000,12301,4100,8201,4100,0,1,4102,34000579,34.000579
6700,6700,4100,44890000,2,32806,8203,1,798640000,798640000,12301,4100,8201,4100,0,1,4102,35226096,35.226096
6700,6700,4500,44890000,2,36006,9003,1,841520000,841520000,13501,4500,9001,4500,0,1,4502,37369134,37.369134
6700,6700,4500,44890000,2,36006,9003,1,841520000,841520000,13501,4500,9001,4500,0,1,4502,39108963,39.108963
6700,6700,4500,44890000,2,36006,9003,1,841520000,841520000,13501,4500,9001,4500,0,1,4502,37399342,37.399342
6700,6700,4500,44890000,2,36006,9003,1,841520000,841520000,13501,4500,9001,4500,0,1,4502,39311723,39.311723
6700,6700,4500,44890000,2,36006,9003,1,841520000,841520000,13501,4500,9001,4500,0,1,4502,37237003,37.237003
6700,6700,4500,44890000,2,36006,9003,1,841520000,841520000,13501,4500,9001,4500,0,1,4502,37287483,37.287483
6700,6700,4500,44890000,2,36006,9003,1,841520000,841520000,13501,4500,9001,4500,0,1,4502,38667214,38.667214
6700,6700,4900,44890000,2,39206,9803,1,884400000,884400000,14701,4900,9801,4900,0,1,4902,40679578,40.679578
6700,6700,4900,44890000,2,39206,9803,1,884400000,884400000,14701,4900,9801,4900,0,1,4902,42579437,42.579437
6700,6700,4900,44890000,2,39206,9803,1,884400000,884400000,14701,4900,9801,4900,0,1,4902,40649050,40.64905
6700,6700,4900,44890000,2,39206,9803,1,884400000,884400000,14701,4900,9801,4900,0,1,4902,42805467,42.805467
6700,6700,4900,44890000,2,39206,9803,1,884400000,884400000,14701,4900,9801,4900,0,1,4902,40619122,40.619122
6700,6700,4900,44890000,2,39206,9803,1,884400000,884400000,14701,4900,9801,4900,0,1,4902,40566176,40.566176
6700,6700,4900,44890000,2,39206,9803,1,884400000,884400000,14701,4900,9801,4900,0,1,4902,42050633,42.050633
6700,6700,5300,44890000,2,42406,10603,1,927280000,927280000,15901,5300,10601,5300,0,1,5302,43936628,43.936628
6700,6700,5300,44890000,2,42406,10603,1,927280000,927280000,15901,5300,10601,5300,0,1,5302,46138181,46.138181
6700,6700,5300,44890000,2,42406,10603,1,927280000,927280000,15901,5300,10601,5300,0,1,5302,44073416,44.073416
6700,6700,5300,44890000,2,42406,10603,1,927280000,927280000,15901,5300,10601,5300,0,1,5302,46325098,46.325098
6700,6700,5300,44890000,2,42406,10603,1,927280000,927280000,15901,5300,10601,5300,0,1,5302,43998181,43.998181
6700,6700,5300,44890000,2,42406,10603,1,927280000,927280000,15901,5300,10601,5300,0,1,5302,43967181,43.967181
6700,6700,5300,44890000,2,42406,10603,1,927280000,927280000,15901,5300,10601,5300,0,1,5302,45506199,45.506199
6700,6700,5700,44890000,2,45606,11403,1,970160000,970160000,17101,5700,11401,5700,0,1,5702,47246290,47.24629
6700,6700,5700,44890000,2,45606,11403,1,970160000,970160000,17101,5700,11401,5700,0,1,5702,49602170,49.60217
6700,6700,5700,44890000,2,45606,11403,1,970160000,970160000,17101,5700,11401,5700,0,1,5702,47401672,47.401672
6700,6700,5700,44890000,2,45606,11403,1,970160000,970160000,17101,5700,11401,5700,0,1,5702,49831468,49.831468
6700,6700,5700,44890000,2,45606,11403,1,970160000,970160000,17101,5700,11401,5700,0,1,5702,47276699,47.276699
6700,6700,5700,44890000,2,45606,11403,1,970160000,970160000,17101,5700,11401,5700,0,1,5702,47182963,47.182963
6700,6700,5700,44890000,2,45606,11403,1,970160000,970160000,17101,5700,11401,5700,0,1,5702,49011506,49.011506
6700,6700,6100,44890000,2,48806,12203,1,1013040000,1013040000,18301,6100,12201,6100,0,1,6102,50532386,50.532386
6700,6700,6100,44890000,2,48806,12203,1,1013040000,1013040000,18301,6100,12201,6100,0,1,6102,53200975,53.200975
6700,6700,6100,44890000,2,48806,12203,1,1013040000,1013040000,18301,6100,12201,6100,0,1,6102,50708085,50.708085
6700,6700,6100,44890000,2,48806,12203,1,1013040000,1013040000,18301,6100,12201,6100,0,1,6102,53294087,53.294087
6700,6700,6100,44890000,2,48806,12203,1,1013040000,1013040000,18301,6100,12201,6100,0,1,6102,50650287,50.650287
6700,6700,6100,44890000,2,48806,12203,1,1013040000,1013040000,18301,6100,12201,6100,0,1,6102,50501990,50.50199
6700,6700,6100,44890000,2,48806,12203,1,1013040000,1013040000,18301,6100,12201,6100,0,1,6102,52315565,52.315565
6700,6700,6500,44890000,2,52006,13003,1,1055920000,1055920000,19501,6500,13001,6500,0,1,6502,53788180,53.78818
6700,6700,6500,44890000,2,52006,13003,1,1055920000,1055920000,19501,6500,13001,6500,0,1,6502,56695968,56.695968
6700,6700,6500,44890000,2,52006,13003,1,1055920000,1055920000,19501,6500,13001,6500,0,1,6502,53974563,53.974563
6700,6700,6500,44890000,2,52006,13003,1,1055920000,1055920000,19501,6500,13001,6500,0,1,6502,56811525,56.811525
6700,6700,6500,44890000,2,52006,13003,1,1055920000,1055920000,19501,6500,13001,6500,0,1,6502,54005059,54.005059
6700,6700,6500,44890000,2,52006,13003,1,1055920000,1055920000,19501,6500,13001,6500,0,1,6502,53848433,53.848433
6700,6700,6500,44890000,2,52006,13003,1,1055920000,1055920000,19501,6500,13001,6500,0,1,6502,55827590,55.82759
6700,6700,6900,44890000,2,55206,13803,1,1098800000,1098800000,20701,6900,13801,6900,0,1,6902,57231262,57.231262
6700,6700,6900,44890000,2,55206,13803,1,1098800000,1098800000,20701,6900,13801,6900,0,1,6902,60157561,60.157561
6700,6700,6900,44890000,2,55206,13803,1,1098800000,1098800000,20701,6900,13801,6900,0,1,6902,57494679,57.494679
6700,6700,6900,44890000,2,55206,13803,1,1098800000,1098800000,20701,6900,13801,6900,0,1,6902,60335588,60.335588
6700,6700,6900,44890000,2,55206,13803,1,1098800000,1098800000,20701,6900,13801,6900,0,1,6902,57419065,57.419065
6700,6700,6900,44890000,2,55206,13803,1,1098800000,1098800000,20701,6900,13801,6900,0,1,6902,57133858,57.133858
6700,6700,6900,44890000,2,55206,13803,1,1098800000,1098800000,20701,6900,13801,6900,0,1,6902,59388794,59.388794
6700,6300,500,42210000,2,4006,1003,1,389680000,389680000,1501,500,1001,500,0,1,502,4441892,4.441892
6700,6300,500,42210000,2,4006,1003,1,389680000,389680000,1501,500,1001,500,0,1,502,4526802,4.526802
6700,6300,500,42210000,2,4006,1003,1,389680000,389680000,1501,500,1001,500,0,1,502,4413451,4.413451
6700,6300,500,42210000,2,4006,1003,1,389680000,389680000,1501,500,1001,500,0,1,502,4556988,4.556988
6700,6300,500,42210000,2,4006,1003,1,389680000,389680000,1501,500,1001,500,0,1,502,4470805,4.470805
6700,6300,500,42210000,2,4006,1003,1,389680000,389680000,1501,500,1001,500,0,1,502,4385074,4.385074
6700,6300,500,42210000,2,4006,1003,1,389680000,389680000,1501,500,1001,500,0,1,502,4590149,4.590149
6700,6300,900,42210000,2,7206,1803,1,431280000,431280000,2701,900,1801,900,0,1,902,7269494,7.269494
6700,6300,900,42210000,2,7206,1803,1,431280000,431280000,2701,900,1801,900,0,1,902,7616339,7.616339
6700,6300,900,42210000,2,7206,1803,1,431280000,431280000,2701,900,1801,900,0,1,902,7399699,7.399699
6700,6300,900,42210000,2,7206,1803,1,431280000,431280000,2701,900,1801,900,0,1,902,7662703,7.662703
6700,6300,900,42210000,2,7206,1803,1,431280000,431280000,2701,900,1801,900,0,1,902,7344627,7.344627
6700,6300,900,42210000,2,7206,1803,1,431280000,431280000,2701,900,1801,900,0,1,902,7452177,7.452177
6700,6300,900,42210000,2,7206,1803,1,431280000,431280000,2701,900,1801,900,0,1,902,7692216,7.692216
6700,6300,1300,42210000,2,10406,2603,1,472880000,472880000,3901,1300,2601,1300,0,1,1302,10506363,10.506363
6700,6300,1300,42210000,2,10406,2603,1,472880000,472880000,3901,1300,2601,1300,0,1,1302,10925485,10.925485
6700,6300,1300,42210000,2,10406,2603,1,472880000,472880000,3901,1300,2601,1300,0,1,1302,10364201,10.364201
6700,6300,1300,42210000,2,10406,2603,1,472880000,472880000,3901,1300,2601,1300,0,1,1302,11009609,11.009609
6700,6300,1300,42210000,2,10406,2603,1,472880000,472880000,3901,1300,2601,1300,0,1,1302,10540649,10.540649
6700,6300,1300,42210000,2,10406,2603,1,472880000,472880000,3901,1300,2601,1300,0,1,1302,10335819,10.335819
6700,6300,1300,42210000,2,10406,2603,1,472880000,472880000,3901,1300,2601,1300,0,1,1302,10742919,10.742919
6700,6300,1700,42210000,2,13606,3403,1,514480000,514480000,5101,1700,3401,1700,0,1,1702,13613291,13.613291
6700,6300,1700,42210000,2,13606,3403,1,514480000,514480000,5101,1700,3401,1700,0,1,1702,14122433,14.122433
6700,6300,1700,42210000,2,13606,3403,1,514480000,514480000,5101,1700,3401,1700,0,1,1702,13576505,13.576505
6700,6300,1700,42210000,2,13606,3403,1,514480000,514480000,5101,1700,3401,1700,0,1,1702,14220269,14.220269
6700,6300,1700,42210000,2,13606,3403,1,514480000,514480000,5101,1700,3401,1700,0,1,1702,13665165,13.665165
6700,6300,1700,42210000,2,13606,3403,1,514480000,514480000,5101,1700,3401,1700,0,1,1702,13548118,13.548118
6700,6300,1700,42210000,2,13606,3403,1,514480000,514480000,5101,1700,3401,1700,0,1,1702,14006325,14.006325
6700,6300,2100,42210000,2,16806,4203,1,556080000,556080000,6301,2100,4201,2100,0,1,2102,16657081,16.657081
6700,6300,2100,42210000,2,16806,4203,1,556080000,556080000,6301,2100,4201,2100,0,1,2102,17341896,17.341896
6700,6300,2100,42210000,2,16806,4203,1,556080000,556080000,6301,2100,4201,2100,0,1,2102,16628589,16.628589
6700,6300,2100,42210000,2,16806,4203,1,556080000,556080000,6301,2100,4201,2100,0,1,2102,17457183,17.457183
6700,6300,2100,42210000,2,16806,4203,1,556080000,556080000,6301,2100,4201,2100,0,1,2102,16717474,16.717474
6700,6300,2100,42210000,2,16806,4203,1,556080000,556080000,6301,2100,4201,2100,0,1,2102,16588077,16.588077
6700,6300,2100,42210000,2,16806,4203,1,556080000,556080000,6301,2100,4201,2100,0,1,2102,17251436,17.251436
6700,6300,2500,42210000,2,20006,5003,1,597680000,597680000,7501,2500,5001,2500,0,1,2502,19725894,19.725894
6700,6300,2500,42210000,2,20006,5003,1,597680000,597680000,7501,2500,5001,2500,0,1,2502,20569361,20.569361
6700,6300,2500,42210000,2,20006,5003,1,597680000,597680000,7501,2500,5001,2500,0,1,2502,19696082,19.696082
6700,6300,2500,42210000,2,20006,5003,1,597680000,597680000,7501,2500,5001,2500,0,1,2502,20673434,20.673434
6700,6300,2500,42210000,2,20006,5003,1,597680000,597680000,7501,2500,5001,2500,0,1,2502,19765270,19.76527
6700,6300,2500,42210000,2,20006,5003,1,597680000,597680000,7501,2500,5001,2500,0,1,2502,19654743,19.654743
6700,6300,2500,42210000,2,20006,5003,1,597680000,597680000,7501,2500,5001,2500,0,1,2502,20365086,20.365086
6700,6300,2900,42210000,2,23206,5803,1,639280000,639280000,8701,2900,5801,2900,0,1,2902,22768601,22.768601
6700,6300,2900,42210000,2,23206,5803,1,639280000,639280000,8701,2900,5801,2900,0,1,2902,23822914,23.822914
6700,6300,2900,42210000,2,23206,5803,1,639280000,639280000,8701,2900,5801,2900,0,1,2902,22798433,22.798433
6700,6300,2900,42210000,2,23206,5803,1,639280000,639280000,8701,2900,5801,2900,0,1,2902,23904844,23.904844
6700,6300,2900,42210000,2,23206,5803,1,639280000,639280000,8701,2900,5801,2900,0,1,2902,22826771,22.826771
6700,6300,2900,42210000,2,23206,5803,1,639280000,639280000,8701,2900,5801,2900,0,1,2902,22728079,22.728079
6700,6300,2900,42210000,2,23206,5803,1,639280000,639280000,8701,2900,5801,2900,0,1,2902,23519666,23.519666
6700,6300,3300,42210000,2,26406,6603,1,680880000,680880000,9901,3300,6601,3300,0,1,3302,25829935,25.829935
6700,6300,3300,42210000,2,26406,6603,1,680880000,680880000,9901,3300,6601,3300,0,1,3302,27079438,27.079438
6700,6300,3300,42210000,2,26406,6603,1,680880000,680880000,9901,3300,6601,3300,0,1,3302,25859141,25.859141
6700,6300,3300,42210000,2,26406,6603,1,680880000,680880000,9901,3300,6601,3300,0,1,3302,27155567,27.155567
6700,6300,3300,42210000,2,26406,6603,1,680880000,680880000,9901,3300,6601,3300,0,1,3302,25860056,25.860056
6700,6300,3300,42210000,2,26406,6603,1,680880000,680880000,9901,3300,6601,3300,0,1,3302,25800018,25.800018
6700,6300,3300,42210000,2,26406,6603,1,680880000,680880000,9901,3300,6601,3300,0,1,3302,26710486,26.710486
6700,6300,3700,42210000,2,29606,7403,1,722480000,722480000,11101,3700,7401,3700,0,1,3702,28867018,28.867018
6700,6300,3700,42210000,2,29606,7403,1,722480000,722480000,11101,3700,7401,3700,0,1,3702,30322023,30.322023
6700,6300,3700,42210000,2,29606,7403,1,722480000,722480000,11101,3700,7401,3700,0,1,3702,28911064,28.911064
6700,6300,3700,42210000,2,29606,7403,1,722480000,722480000,11101,3700,7401,3700,0,1,3702,30431618,30.431618
6700,6300,3700,42210000,2,29606,7403,1,722480000,722480000,11101,3700,7401,3700,0,1,3702,28941598,28.941598
6700,6300,3700,42210000,2,29606,7403,1,722480000,722480000,11101,3700,7401,3700,0,1,3702,28912619,28.912619
6700,6300,3700,42210000,2,29606,7403,1,722480000,722480000,11101,3700,7401,3700,0,1,3702,29920669,29.920669
6700,6300,4100,42210000,2,32806,8203,1,764080000,764080000,12301,4100,8201,4100,0,1,4102,32021366,32.021366
6700,6300,4100,42210000,2,32806,8203,1,764080000,764080000,12301,4100,8201,4100,0,1,4102,33521405,33.521405
6700,6300,4100,42210000,2,32806,8203,1,764080000,764080000,12301,4100,8201,4100,0,1,4102,32022935,32.022935
6700,6300,4100,42210000,2,32806,8203,1,764080000,764080000,12301,4100,8201,4100,0,1,4102,33648619,33.648619
6700,6300,4100,42210000,2,32806,8203,1,764080000,764080000,12301,4100,8201,4100,0,1,4102,31992847,31.992847
6700,6300,4100,42210000,2,32806,8203,1,764080000,764080000,12301,4100,8201,4100,0,1,4102,31947094,31.947094
6700,6300,4100,42210000,2,32806,8203,1,764080000,764080000,12301,4100,8201,4100,0,1,4102,33172853,33.172853
6700,6300,4500,42210000,2,36006,9003,1,805680000,805680000,13501,4500,9001,4500,0,1,4502,35094829,35.094829
6700,6300,4500,42210000,2,36006,9003,1,805680000,805680000,13501,4500,9001,4500,0,1,4502,36723759,36.723759
6700,6300,4500,42210000,2,36006,9003,1,805680000,805680000,13501,4500,9001,4500,0,1,4502,35123406,35.123406
6700,6300,4500,42210000,2,36006,9003,1,805680000,805680000,13501,4500,9001,4500,0,1,4502,36913547,36.913547
6700,6300,4500,42210000,2,36006,9003,1,805680000,805680000,13501,4500,9001,4500,0,1,4502,34979645,34.979645
6700,6300,4500,42210000,2,36006,9003,1,805680000,805680000,13501,4500,9001,4500,0,1,4502,35066389,35.066389
6700,6300,4500,42210000,2,36006,9003,1,805680000,805680000,13501,4500,9001,4500,0,1,4502,36359992,36.359992
6700,6300,4900,42210000,2,39206,9803,1,847280000,847280000,14701,4900,9801,4900,0,1,4902,38182330,38.18233
6700,6300,4900,42210000,2,39206,9803,1,847280000,847280000,14701,4900,9801,4900,0,1,4902,40148411,40.148411
6700,6300,4900,42210000,2,39206,9803,1,847280000,847280000,14701,4900,9801,4900,0,1,4902,38234706,38.234706
6700,6300,4900,42210000,2,39206,9803,1,847280000,847280000,14701,4900,9801,4900,0,1,4902,40235013,40.235013
6700,6300,4900,42210000,2,39206,9803,1,847280000,847280000,14701,4900,9801,4900,0,1,4902,38263383,38.263383
6700,6300,4900,42210000,2,39206,9803,1,847280000,847280000,14701,4900,9801,4900,0,1,4902,38133363,38.133363
6700,6300,4900,42210000,2,39206,9803,1,847280000,847280000,14701,4900,9801,4900,0,1,4902,39540562,39.540562
6700,6300,5300,42210000,2,42406,10603,1,888880000,888880000,15901,5300,10601,5300,0,1,5302,41264150,41.26415
6700,6300,5300,42210000,2,42406,10603,1,888880000,888880000,15901,5300,10601,5300,0,1,5302,43433189,43.433189
6700,6300,5300,42210000,2,42406,10603,1,888880000,888880000,15901,5300,10601,5300,0,1,5302,41359076,41.359076
6700,6300,5300,42210000,2,42406,10603,1,888880000,888880000,15901,5300,10601,5300,0,1,5302,43559260,43.55926
6700,6300,5300,42210000,2,42406,10603,1,888880000,888880000,15901,5300,10601,5300,0,1,5302,41330820,41.33082
6700,6300,5300,42210000,2,42406,10603,1,888880000,888880000,15901,5300,10601,5300,0,1,5302,41262466,41.262466
6700,6300,5300,42210000,2,42406,10603,1,888880000,888880000,15901,5300,10601,5300,0,1,5302,42764796,42.764796
6700,6300,5700,42210000,2,45606,11403,1,930480000,930480000,17101,5700,11401,5700,0,1,5702,44420049,44.420049
6700,6300,5700,42210000,2,45606,11403,1,930480000,930480000,17101,5700,11401,5700,0,1,5702,46708754,46.708754
6700,6300,5700,42210000,2,45606,11403,1,930480000,930480000,17101,5700,11401,5700,0,1,5702,44543337,44.543337
6700,6300,5700,42210000,2,45606,11403,1,930480000,930480000,17101,5700,11401,5700,0,1,5702,46851793,46.851793
6700,6300,5700,42210000,2,45606,11403,1,930480000,930480000,17101,5700,11401,5700,0,1,5702,44514801,44.514801
6700,6300,5700,42210000,2,45606,11403,1,930480000,930480000,17101,5700,11401,5700,0,1,5702,44486130,44.48613
6700,6300,5700,42210000,2,45606,11403,1,930480000,930480000,17101,5700,11401,5700,0,1,5702,46029859,46.029859
6700,6300,6100,42210000,2,48806,12203,1,972080000,972080000,18301,6100,12201,6100,0,1,6102,47556249,47.556249
6700,6300,6100,42210000,2,48806,12203,1,972080000,972080000,18301,6100,12201,6100,0,1,6102,50006329,50.006329
6700,6300,6100,42210000,2,48806,12203,1,972080000,972080000,18301,6100,12201,6100,0,1,6102,47767179,47.767179
6700,6300,6100,42210000,2,48806,12203,1,972080000,972080000,18301,6100,12201,6100,0,1,6102,50093611,50.093611
6700,6300,6100,42210000,2,48806,12203,1,972080000,972080000,18301,6100,12201,6100,0,1,6102,47586137,47.586137
6700,6300,6100,42210000,2,48806,12203,1,972080000,972080000,18301,6100,12201,6100,0,1,6102,47502092,47.502092
6700,6300,6100,42210000,2,48806,12203,1,972080000,972080000,18301,6100,12201,6100,0,1,6102,49260605,49.260605
6700,6300,6500,42210000,2,52006,13003,1,1013680000,1013680000,19501,6500,13001,6500,0,1,6502,50620215,50.620215
6700,6300,6500,42210000,2,52006,13003,1,1013680000,1013680000,19501,6500,13001,6500,0,1,6502,53199478,53.199478
6700,6300,6500,42210000,2,52006,13003,1,1013680000,1013680000,19501,6500,13001,6500,0,1,6502,50912693,50.912693
6700,6300,6500,42210000,2,52006,13003,1,1013680000,1013680000,19501,6500,13001,6500,0,1,6502,53325591,53.325591
6700,6300,6500,42210000,2,52006,13003,1,1013680000,1013680000,19501,6500,13001,6500,0,1,6502,50680369,50.680369
6700,6300,6500,42210000,2,52006,13003,1,1013680000,1013680000,19501,6500,13001,6500,0,1,6502,50736308,50.736308
6700,6300,6500,42210000,2,52006,13003,1,1013680000,1013680000,19501,6500,13001,6500,0,1,6502,52460606,52.460606
6700,6300,6900,42210000,2,55206,13803,1,1055280000,1055280000,20701,6900,13801,6900,0,1,6902,53723907,53.723907
6700,6300,6900,42210000,2,55206,13803,1,1055280000,1055280000,20701,6900,13801,6900,0,1,6902,56562495,56.562495
6700,6300,6900,42210000,2,55206,13803,1,1055280000,1055280000,20701,6900,13801,6900,0,1,6902,54034700,54.0347
6700,6300,6900,42210000,2,55206,13803,1,1055280000,1055280000,20701,6900,13801,6900,0,1,6902,56627840,56.62784
6700,6300,6900,42210000,2,55206,13803,1,1055280000,1055280000,20701,6900,13801,6900,0,1,6902,53845964,53.845964
6700,6300,6900,42210000,2,55206,13803,1,1055280000,1055280000,20701,6900,13801,6900,0,1,6902,53781492,53.781492
6700,6300,6900,42210000,2,55206,13803,1,1055280000,1055280000,20701,6900,13801,6900,0,1,6902,55673502,55.673502
6700,5900,500,39530000,2,4006,1003,1,366640000,366640000,1501,500,1001,500,0,1,502,4165431,4.165431
6700,5900,500,39530000,2,4006,1003,1,366640000,366640000,1501,500,1001,500,0,1,502,4253653,4.253653
6700,5900,500,39530000,2,4006,1003,1,366640000,366640000,1501,500,1001,500,0,1,502,4139022,4.139022
6700,5900,500,39530000,2,4006,1003,1,366640000,366640000,1501,500,1001,500,0,1,502,4282010,4.28201
6700,5900,500,39530000,2,4006,1003,1,366640000,366640000,1501,500,1001,500,0,1,502,4138270,4.13827
6700,5900,500,39530000,2,4006,1003,1,366640000,366640000,1501,500,1001,500,0,1,502,4194536,4.194536
6700,5900,500,39530000,2,4006,1003,1,366640000,366640000,1501,500,1001,500,0,1,502,4225595,4.225595
6700,5900,900,39530000,2,7206,1803,1,406960000,406960000,2701,900,1801,900,0,1,902,6814716,6.814716
6700,5900,900,39530000,2,7206,1803,1,406960000,406960000,2701,900,1801,900,0,1,902,7134505,7.134505
6700,5900,900,39530000,2,7206,1803,1,406960000,406960000,2701,900,1801,900,0,1,902,6875129,6.875129
6700,5900,900,39530000,2,7206,1803,1,406960000,406960000,2701,900,1801,900,0,1,902,7166477,7.166477
6700,5900,900,39530000,2,7206,1803,1,406960000,406960000,2701,900,1801,900,0,1,902,6847943,6.847943
6700,5900,900,39530000,2,7206,1803,1,406960000,406960000,2701,900,1801,900,0,1,902,7027512,7.027512
6700,5900,900,39530000,2,7206,1803,1,406960000,406960000,2701,900,1801,900,0,1,902,7076243,7.076243
6700,5900,1300,39530000,2,10406,2603,1,447280000,447280000,3901,1300,2601,1300,0,1,1302,9829826,9.829826
6700,5900,1300,39530000,2,10406,2603,1,447280000,447280000,3901,1300,2601,1300,0,1,1302,10228640,10.22864
6700,5900,1300,39530000,2,10406,2603,1,447280000,447280000,3901,1300,2601,1300,0,1,1302,9903552,9.903552
6700,5900,1300,39530000,2,10406,2603,1,447280000,447280000,3901,1300,2601,1300,0,1,1302,10266986,10.266986
6700,5900,1300,39530000,2,10406,2603,1,447280000,447280000,3901,1300,2601,1300,0,1,1302,9875851,9.875851
6700,5900,1300,39530000,2,10406,2603,1,447280000,447280000,3901,1300,2601,1300,0,1,1302,9698891,9.698891
6700,5900,1300,39530000,2,10406,2603,1,447280000,447280000,3901,1300,2601,1300,0,1,1302,10162242,10.162242
6700,5900,1700,39530000,2,13606,3403,1,487600000,487600000,5101,1700,3401,1700,0,1,1702,12697499,12.697499
6700,5900,1700,39530000,2,13606,3403,1,487600000,487600000,5101,1700,3401,1700,0,1,1702,13261303,13.261303
6700,5900,1700,39530000,2,13606,3403,1,487600000,487600000,5101,1700,3401,1700,0,1,1702,12751194,12.751194
6700,5900,1700,39530000,2,13606,3403,1,487600000,487600000,5101,1700,3401,1700,0,1,1702,13310076,13.310076
6700,5900,1700,39530000,2,13606,3403,1,487600000,487600000,5101,1700,3401,1700,0,1,1702,12724608,12.724608
6700,5900,1700,39530000,2,13606,3403,1,487600000,487600000,5101,1700,3401,1700,0,1,1702,12777915,12.777915
6700,5900,1700,39530000,2,13606,3403,1,487600000,487600000,5101,1700,3401,1700,0,1,1702,13121999,13.121999
6700,5900,2100,39530000,2,16806,4203,1,527920000,527920000,6301,2100,4201,2100,0,1,2102,15573575,15.573575
6700,5900,2100,39530000,2,16806,4203,1,527920000,527920000,6301,2100,4201,2100,0,1,2102,16230070,16.23007
6700,5900,2100,39530000,2,16806,4203,1,527920000,527920000,6301,2100,4201,2100,0,1,2102,15639173,15.639173
6700,5900,2100,39530000,2,16806,4203,1,527920000,527920000,6301,2100,4201,2100,0,1,2102,16353305,16.353305
6700,5900,2100,39530000,2,16806,4203,1,527920000,527920000,6301,2100,4201,2100,0,1,2102,15611840,15.61184
6700,5900,2100,39530000,2,16806,4203,1,527920000,527920000,6301,2100,4201,2100,0,1,2102,15640898,15.640898
6700,5900,2100,39530000,2,16806,4203,1,527920000,527920000,6301,2100,4201,2100,0,1,2102,16097070,16.09707
6700,5900,2500,39530000,2,20006,5003,1,568240000,568240000,7501,2500,5001,2500,0,1,2502,18426080,18.42608
6700,5900,2500,39530000,2,20006,5003,1,568240000,568240000,7501,2500,5001,2500,0,1,2502,19295113,19.295113
6700,5900,2500,39530000,2,20006,5003,1,568240000,568240000,7501,2500,5001,2500,0,1,2502,18490561,18.490561
6700,5900,2500,39530000,2,20006,5003,1,568240000,568240000,7501,2500,5001,2500,0,1,2502,19365181,19.365181
6700,5900,2500,39530000,2,20006,5003,1,568240000,568240000,7501,2500,5001,2500,0,1,2502,18462997,18.462997
6700,5900,2500,39530000,2,20006,5003,1,568240000,568240000,7501,2500,5001,2500,0,1,2502,18489822,18.489822
6700,5900,2500,39530000,2,20006,5003,1,568240000,568240000,7501,2500,5001,2500,0,1,2502,19061485,19.061485
6700,5900,2900,39530000,2,23206,5803,1,608560000,608560000,8701,2900,5801,2900,0,1,2902,21379819,21.379819
6700,5900,2900,39530000,2,23206,5803,1,608560000,608560000,8701,2900,5801,2900,0,1,2902,22339986,22.339986
6700,5900,2900,39530000,2,23206,5803,1,608560000,608560000,8701,2900,5801,2900,0,1,2902,21406651,21.406651
6700,5900,2900,39530000,2,23206,5803,1,608560000,608560000,8701,2900,5801,2900,0,1,2902,22433404,22.433404
6700,5900,2900,39530000,2,23206,5803,1,608560000,608560000,8701,2900,5801,2900,0,1,2902,21353030,21.35303
6700,5900,2900,39530000,2,23206,5803,1,608560000,608560000,8701,2900,5801,2900,0,1,2902,21326358,21.326358
6700,5900,2900,39530000,2,23206,5803,1,608560000,608560000,8701,2900,5801,2900,0,1,2902,22045081,22.045081
6700,5900,3300,39530000,2,26406,6603,1,648880000,648880000,9901,3300,6601,3300,0,1,3302,24220623,24.220623
6700,5900,3300,39530000,2,26406,6603,1,648880000,648880000,9901,3300,6601,3300,0,1,3302,25344386,25.344386
6700,5900,3300,39530000,2,26406,6603,1,648880000,648880000,9901,3300,6601,3300,0,1,3302,24287982,24.287982
6700,5900,3300,39530000,2,26406,6603,1,648880000,648880000,9901,3300,6601,3300,0,1,3302,25397174,25.397174
6700,5900,3300,39530000,2,26406,6603,1,648880000,648880000,9901,3300,6601,3300,0,1,3302,24248264,24.248264
6700,5900,3300,39530000,2,26406,6603,1,648880000,648880000,9901,3300,6601,3300,0,1,3302,24193859,24.193859
6700,5900,3300,39530000,2,26406,6603,1,648880000,648880000,9901,3300,6601,3300,0,1,3302,25067451,25.067451
6700,5900,3700,39530000,2,29606,7403,1,689200000,689200000,11101,3700,7401,3700,0,1,3702,27065593,27.065593
6700,5900,3700,39530000,2,29606,7403,1,689200000,689200000,11101,3700,7401,3700,0,1,3702,28411767,28.411767
6700,5900,3700,39530000,2,29606,7403,1,689200000,689200000,11101,3700,7401,3700,0,1,3702,27142904,27.142904
6700,5900,3700,39530000,2,29606,7403,1,689200000,689200000,11101,3700,7401,3700,0,1,3702,28533063,28.533063
6700,5900,3700,39530000,2,29606,7403,1,689200000,689200000,11101,3700,7401,3700,0,1,3702,27096286,27.096286
6700,5900,3700,39530000,2,29606,7403,1,689200000,689200000,11101,3700,7401,3700,0,1,3702,27094339,27.094339
6700,5900,3700,39530000,2,29606,7403,1,689200000,689200000,11101,3700,7401,3700,0,1,3702,28020355,28.020355
6700,5900,4100,39530000,2,32806,8203,1,729520000,729520000,12301,4100,8201,4100,0,1,4102,29965594,29.965594
6700,5900,4100,39530000,2,32806,8203,1,729520000,729520000,12301,4100,8201,4100,0,1,4102,31260510,31.26051
6700,5900,4100,39530000,2,32806,8203,1,729520000,729520000,12301,4100,8201,4100,0,1,4102,30050379,30.050379
6700,5900,4100,39530000,2,32806,8203,1,729520000,729520000,12301,4100,8201,4100,0,1,4102,31552733,31.552733
6700,5900,4100,39530000,2,32806,8203,1,729520000,729520000,12301,4100,8201,4100,0,1,4102,29895916,29.895916
6700,5900,4100,39530000,2,32806,8203,1,729520000,729520000,12301,4100,8201,4100,0,1,4102,29938904,29.938904
6700,5900,4100,39530000,2,32806,8203,1,729520000,729520000,12301,4100,8201,4100,0,1,4102,31033233,31.033233
6700,5900,4500,39530000,2,36006,9003,1,769840000,769840000,13501,4500,9001,4500,0,1,4502,32846657,32.846657
6700,5900,4500,39530000,2,36006,9003,1,769840000,769840000,13501,4500,9001,4500,0,1,4502,34435549,34.435549
6700,5900,4500,39530000,2,36006,9003,1,769840000,769840000,13501,4500,9001,4500,0,1,4502,32923790,32.92379
6700,5900,4500,39530000,2,36006,9003,1,769840000,769840000,13501,4500,9001,4500,0,1,4502,34629974,34.629974
6700,5900,4500,39530000,2,36006,9003,1,769840000,769840000,13501,4500,9001,4500,0,1,4502,32774412,32.774412
6700,5900,4500,39530000,2,36006,9003,1,769840000,769840000,13501,4500,9001,4500,0,1,4502,32801045,32.801045
6700,5900,4500,39530000,2,36006,9003,1,769840000,769840000,13501,4500,9001,4500,0,1,4502,34024574,34.024574
6700,5900,4900,39530000,2,39206,9803,1,810160000,810160000,14701,4900,9801,4900,0,1,4902,35768573,35.768573
6700,5900,4900,39530000,2,39206,9803,1,810160000,810160000,14701,4900,9801,4900,0,1,4902,37482086,37.482086
6700,5900,4900,39530000,2,39206,9803,1,810160000,810160000,14701,4900,9801,4900,0,1,4902,35895235,35.895235
6700,5900,4900,39530000,2,39206,9803,1,810160000,810160000,14701,4900,9801,4900,0,1,4902,37634157,37.634157
6700,5900,4900,39530000,2,39206,9803,1,810160000,810160000,14701,4900,9801,4900,0,1,4902,35715189,35.715189
6700,5900,4900,39530000,2,39206,9803,1,810160000,810160000,14701,4900,9801,4900,0,1,4902,35741882,35.741882
6700,5900,4900,39530000,2,39206,9803,1,810160000,810160000,14701,4900,9801,4900,0,1,4902,37032653,37.032653
6700,5900,5300,39530000,2,42406,10603,1,850480000,850480000,15901,5300,10601,5300,0,1,5302,38695031,38.695031
6700,5900,5300,39530000,2,42406,10603,1,850480000,850480000,15901,5300,10601,5300,0,1,5302,40593788,40.593788
6700,5900,5300,39530000,2,42406,10603,1,850480000,850480000,15901,5300,10601,5300,0,1,5302,38836367,38.836367
6700,5900,5300,39530000,2,42406,10603,1,850480000,850480000,15901,5300,10601,5300,0,1,5302,40770159,40.770159
6700,5900,5300,39530000,2,42406,10603,1,850480000,850480000,15901,5300,10601,5300,0,1,5302,38776815,38.776815
6700,5900,5300,39530000,2,42406,10603,1,850480000,850480000,15901,5300,10601,5300,0,1,5302,38620668,38.620668
6700,5900,5300,39530000,2,42406,10603,1,850480000,850480000,15901,5300,10601,5300,0,1,5302,40073362,40.073362
6700,5900,5700,39530000,2,45606,11403,1,890800000,890800000,17101,5700,11401,5700,0,1,5702,41537159,41.537159
6700,5900,5700,39530000,2,45606,11403,1,890800000,890800000,17101,5700,11401,5700,0,1,5702,43606877,43.606877
6700,5900,5700,39530000,2,45606,11403,1,890800000,890800000,17101,5700,11401,5700,0,1,5702,41730997,41.730997
6700,5900,5700,39530000,2,45606,11403,1,890800000,890800000,17101,5700,11401,5700,0,1,5702,43814231,43.814231
6700,5900,5700,39530000,2,45606,11403,1,890800000,890800000,17101,5700,11401,5700,0,1,5702,41636172,41.636172
6700,5900,5700,39530000,2,45606,11403,1,890800000,890800000,17101,5700,11401,5700,0,1,5702,41586263,41.586263
6700,5900,5700,39530000,2,45606,11403,1,890800000,890800000,17101,5700,11401,5700,0,1,5702,43112635,43.112635
6700,5900,6100,39530000,2,48806,12203,1,931120000,931120000,18301,6100,12201,6100,0,1,6102,44471045,44.471045
6700,5900,6100,39530000,2,48806,12203,1,931120000,931120000,18301,6100,12201,6100,0,1,6102,46830720,46.83072
6700,5900,6100,39530000,2,48806,12203,1,931120000,931120000,18301,6100,12201,6100,0,1,6102,44666633,44.666633
6700,5900,6100,39530000,2,48806,12203,1,931120000,931120000,18301,6100,12201,6100,0,1,6102,46882832,46.882832
6700,5900,6100,39530000,2,48806,12203,1,931120000,931120000,18301,6100,12201,6100,0,1,6102,44564856,44.564856
6700,5900,6100,39530000,2,48806,12203,1,931120000,931120000,18301,6100,12201,6100,0,1,6102,44444225,44.444225
6700,5900,6100,39530000,2,48806,12203,1,931120000,931120000,18301,6100,12201,6100,0,1,6102,46146404,46.146404
6700,5900,6500,39530000,2,52006,13003,1,971440000,971440000,19501,6500,13001,6500,0,1,6502,47466709,47.466709
6700,5900,6500,39530000,2,52006,13003,1,971440000,971440000,19501,6500,13001,6500,0,1,6502,49882124,49.882124
6700,5900,6500,39530000,2,52006,13003,1,971440000,971440000,19501,6500,13001,6500,0,1,6502,47633944,47.633944
6700,5900,6500,39530000,2,52006,13003,1,971440000,971440000,19501,6500,13001,6500,0,1,6502,50007518,50.007518
6700,5900,6500,39530000,2,52006,13003,1,971440000,971440000,19501,6500,13001,6500,0,1,6502,47555475,47.555475
6700,5900,6500,39530000,2,52006,13003,1,971440000,971440000,19501,6500,13001,6500,0,1,6502,47438921,47.438921
6700,5900,6500,39530000,2,52006,13003,1,971440000,971440000,19501,6500,13001,6500,0,1,6502,49129187,49.129187
6700,5900,6900,39530000,2,55206,13803,1,1011760000,1011760000,20701,6900,13801,6900,0,1,6902,50293738,50.293738
6700,5900,6900,39530000,2,55206,13803,1,1011760000,1011760000,20701,6900,13801,6900,0,1,6902,53225183,53.225183
6700,5900,6900,39530000,2,55206,13803,1,1011760000,1011760000,20701,6900,13801,6900,0,1,6902,50654700,50.6547
6700,5900,6900,39530000,2,55206,13803,1,1011760000,1011760000,20701,6900,13801,6900,0,1,6902,53196199,53.196199
6700,5900,6900,39530000,2,55206,13803,1,1011760000,1011760000,20701,6900,13801,6900,0,1,6902,50431226,50.431226
6700,5900,6900,39530000,2,55206,13803,1,1011760000,1011760000,20701,6900,13801,6900,0,1,6902,50459065,50.459065
6700,5900,6900,39530000,2,55206,13803,1,1011760000,1011760000,20701,6900,13801,6900,0,1,6902,52305169,52.305169
6700,5500,500,36850000,2,4006,1003,1,343600000,343600000,1501,500,1001,500,0,1,502,3843033,3.843033
6700,5500,500,36850000,2,4006,1003,1,343600000,343600000,1501,500,1001,500,0,1,502,4015051,4.015051
6700,5500,500,36850000,2,4006,1003,1,343600000,343600000,1501,500,1001,500,0,1,502,3816390,3.81639
6700,5500,500,36850000,2,4006,1003,1,343600000,343600000,1501,500,1001,500,0,1,502,4044828,4.044828
6700,5500,500,36850000,2,4006,1003,1,343600000,343600000,1501,500,1001,500,0,1,502,3842411,3.842411
6700,5500,500,36850000,2,4006,1003,1,343600000,343600000,1501,500,1001,500,0,1,502,3867598,3.867598
6700,5500,500,36850000,2,4006,1003,1,343600000,343600000,1501,500,1001,500,0,1,502,3973597,3.973597
6700,5500,900,36850000,2,7206,1803,1,382640000,382640000,2701,900,1801,900,0,1,902,6322750,6.32275
6700,5500,900,36850000,2,7206,1803,1,382640000,382640000,2701,900,1801,900,0,1,902,6676930,6.67693
6700,5500,900,36850000,2,7206,1803,1,382640000,382640000,2701,900,1801,900,0,1,902,6347640,6.34764
6700,5500,900,36850000,2,7206,1803,1,382640000,382640000,2701,900,1801,900,0,1,902,6703541,6.703541
6700,5500,900,36850000,2,7206,1803,1,382640000,382640000,2701,900,1801,900,0,1,902,6401518,6.401518
6700,5500,900,36850000,2,7206,1803,1,382640000,382640000,2701,900,1801,900,0,1,902,6375774,6.375774
6700,5500,900,36850000,2,7206,1803,1,382640000,382640000,2701,900,1801,900,0,1,902,6593683,6.593683
6700,5500,1300,36850000,2,10406,2603,1,421680000,421680000,3901,1300,2601,1300,0,1,1302,9168164,9.168164
6700,5500,1300,36850000,2,10406,2603,1,421680000,421680000,3901,1300,2601,1300,0,1,1302,9543913,9.543913
6700,5500,1300,36850000,2,10406,2603,1,421680000,421680000,3901,1300,2601,1300,0,1,1302,9138508,9.138508
6700,5500,1300,36850000,2,10406,2603,1,421680000,421680000,3901,1300,2601,1300,0,1,1302,9593246,9.593246
6700,5500,1300,36850000,2,10406,2603,1,421680000,421680000,3901,1300,2601,1300,0,1,1302,9193474,9.193474
6700,5500,1300,36850000,2,10406,2603,1,421680000,421680000,3901,1300,2601,1300,0,1,1302,9218230,9.21823
6700,5500,1300,36850000,2,10406,2603,1,421680000,421680000,3901,1300,2601,1300,0,1,1302,9462138,9.462138
6700,5500,1700,36850000,2,13606,3403,1,460720000,460720000,5101,1700,3401,1700,0,1,1702,11840051,11.840051
6700,5500,1700,36850000,2,13606,3403,1,460720000,460720000,5101,1700,3401,1700,0,1,1702,12360505,12.360505
6700,5500,1700,36850000,2,13606,3403,1,460720000,460720000,5101,1700,3401,1700,0,1,1702,11865739,11.865739
6700,5500,1700,36850000,2,13606,3403,1,460720000,460720000,5101,1700,3401,1700,0,1,1702,12419750,12.41975
6700,5500,1700,36850000,2,13606,3403,1,460720000,460720000,5101,1700,3401,1700,0,1,1702,11890890,11.89089
6700,5500,1700,36850000,2,13606,3403,1,460720000,460720000,5101,1700,3401,1700,0,1,1702,11891611,11.891611
6700,5500,1700,36850000,2,13606,3403,1,460720000,460720000,5101,1700,3401,1700,0,1,1702,12244352,12.244352
6700,5500,2100,36850000,2,16806,4203,1,499760000,499760000,6301,2100,4201,2100,0,1,2102,14557420,14.55742
6700,5500,2100,36850000,2,16806,4203,1,499760000,499760000,6301,2100,4201,2100,0,1,2102,15198941,15.198941
6700,5500,2100,36850000,2,16806,4203,1,499760000,499760000,6301,2100,4201,2100,0,1,2102,14583081,14.583081
6700,5500,2100,36850000,2,16806,4203,1,499760000,499760000,6301,2100,4201,2100,0,1,2102,15233293,15.233293
6700,5500,2100,36850000,2,16806,4203,1,499760000,499760000,6301,2100,4201,2100,0,1,2102,14634564,14.634564
6700,5500,2100,36850000,2,16806,4203,1,499760000,499760000,6301,2100,4201,2100,0,1,2102,14582469,14.582469
6700,5500,2100,36850000,2,16806,4203,1,499760000,499760000,6301,2100,4201,2100,0,1,2102,15005884,15.005884
6700,5500,2500,36850000,2,20006,5003,1,538800000,538800000,7501,2500,5001,2500,0,1,2502,17267413,17.267413
6700,5500,2500,36850000,2,20006,5003,1,538800000,538800000,7501,2500,5001,2500,0,1,2502,18023970,18.02397
6700,5500,2500,36850000,2,20006,5003,1,538800000,538800000,7501,2500,5001,2500,0,1,2502,17233249,17.233249
6700,5500,2500,36850000,2,20006,5003,1,538800000,538800000,7501,2500,5001,2500,0,1,2502,18142538,18.142538
6700,5500,2500,36850000,2,20006,5003,1,538800000,538800000,7501,2500,5001,2500,0,1,2502,17336841,17.336841
6700,5500,2500,36850000,2,20006,5003,1,538800000,538800000,7501,2500,5001,2500,0,1,2502,17293116,17.293116
6700,5500,2500,36850000,2,20006,5003,1,538800000,538800000,7501,2500,5001,2500,0,1,2502,17794387,17.794387
6700,5500,2900,36850000,2,23206,5803,1,577840000,577840000,8701,2900,5801,2900,0,1,2902,19856009,19.856009
6700,5500,2900,36850000,2,23206,5803,1,577840000,577840000,8701,2900,5801,2900,0,1,2902,20811704,20.811704
6700,5500,2900,36850000,2,23206,5803,1,577840000,577840000,8701,2900,5801,2900,0,1,2902,19881014,19.881014
6700,5500,2900,36850000,2,23206,5803,1,577840000,577840000,8701,2900,5801,2900,0,1,2902,20905113,20.905113
6700,5500,2900,36850000,2,23206,5803,1,577840000,577840000,8701,2900,5801,2900,0,1,2902,19931524,19.931524
6700,5500,2900,36850000,2,23206,5803,1,577840000,577840000,8701,2900,5801,2900,0,1,2902,19906100,19.9061
6700,5500,2900,36850000,2,23206,5803,1,577840000,577840000,8701,2900,5801,2900,0,1,2902,20577243,20.577243
6700,5500,3300,36850000,2,26406,6603,1,616880000,616880000,9901,3300,6601,3300,0,1,3302,22639137,22.639137
6700,5500,3300,36850000,2,26406,6603,1,616880000,616880000,9901,3300,6601,3300,0,1,3302,23623273,23.623273
6700,5500,3300,36850000,2,26406,6603,1,616880000,616880000,9901,3300,6601,3300,0,1,3302,22576849,22.576849
6700,5500,3300,36850000,2,26406,6603,1,616880000,616880000,9901,3300,6601,3300,0,1,3302,23749752,23.749752
6700,5500,3300,36850000,2,26406,6603,1,616880000,616880000,9901,3300,6601,3300,0,1,3302,22664628,22.664628
6700,5500,3300,36850000,2,26406,6603,1,616880000,616880000,9901,3300,6601,3300,0,1,3302,22601909,22.601909
6700,5500,3300,36850000,2,26406,6603,1,616880000,616880000,9901,3300,6601,3300,0,1,3302,23320817,23.320817
6700,5500,3700,36850000,2,29606,7403,1,655920000,655920000,11101,3700,7401,3700,0,1,3702,25261048,25.261048
6700,5500,3700,36850000,2,29606,7403,1,655920000,655920000,11101,3700,7401,3700,0,1,3702,26434506,26.434506
6700,5500,3700,36850000,2,29606,7403,1,655920000,655920000,11101,3700,7401,3700,0,1,3702,25351608,25.351608
6700,5500,3700,36850000,2,29606,7403,1,655920000,655920000,11101,3700,7401,3700,0,1,3702,26566386,26.566386
6700,5500,3700,36850000,2,29606,7403,1,655920000,655920000,11101,3700,7401,3700,0,1,3702,25377248,25.377248
6700,5500,3700,36850000,2,29606,7403,1,655920000,655920000,11101,3700,7401,3700,0,1,3702,25286021,25.286021
6700,5500,3700,36850000,2,29606,7403,1,655920000,655920000,11101,3700,7401,3700,0,1,3702,26144900,26.1449
6700,5500,4100,36850000,2,32806,8203,1,694960000,694960000,12301,4100,8201,4100,0,1,4102,27964829,27.964829
6700,5500,4100,36850000,2,32806,8203,1,694960000,694960000,12301,4100,8201,4100,0,1,4102,29227263,29.227263
6700,5500,4100,36850000,2,32806,8203,1,694960000,694960000,12301,4100,8201,4100,0,1,4102,28023160,28.02316
6700,5500,4100,36850000,2,32806,8203,1,694960000,694960000,12301,4100,8201,4100,0,1,4102,29386283,29.386283
6700,5500,4100,36850000,2,32806,8203,1,694960000,694960000,12301,4100,8201,4100,0,1,4102,27965900,27.9659
6700,5500,4100,36850000,2,32806,8203,1,694960000,694960000,12301,4100,8201,4100,0,1,4102,27939796,27.939796
6700,5500,4100,36850000,2,32806,8203,1,694960000,694960000,12301,4100,8201,4100,0,1,4102,28923264,28.923264
6700,5500,4500,36850000,2,36006,9003,1,734000000,734000000,13501,4500,9001,4500,0,1,4502,30657447,30.657447
6700,5500,4500,36850000,2,36006,9003,1,734000000,734000000,13501,4500,9001,4500,0,1,4502,32224418,32.224418
6700,5500,4500,36850000,2,36006,9003,1,734000000,734000000,13501,4500,9001,4500,0,1,4502,30794212,30.794212
6700,5500,4500,36850000,2,36006,9003,1,734000000,734000000,13501,4500,9001,4500,0,1,4502,32269310,32.26931
6700,5500,4500,36850000,2,36006,9003,1,734000000,734000000,13501,4500,9001,4500,0,1,4502,30751001,30.751001
6700,5500,4500,36850000,2,36006,9003,1,734000000,734000000,13501,4500,9001,4500,0,1,4502,30682541,30.682541
6700,5500,4500,36850000,2,36006,9003,1,734000000,734000000,13501,4500,9001,4500,0,1,4502,31783569,31.783569
6700,5500,4900,36850000,2,39206,9803,1,773040000,773040000,14701,4900,9801,4900,0,1,4902,33339948,33.339948
6700,5500,4900,36850000,2,39206,9803,1,773040000,773040000,14701,4900,9801,4900,0,1,4902,34961125,34.961125
6700,5500,4900,36850000,2,39206,9803,1,773040000,773040000,14701,4900,9801,4900,0,1,4902,33452780,33.45278
6700,5500,4900,36850000,2,39206,9803,1,773040000,773040000,14701,4900,9801,4900,0,1,4902,35094672,35.094672
6700,5500,4900,36850000,2,39206,9803,1,773040000,773040000,14701,4900,9801,4900,0,1,4902,33408717,33.408717
6700,5500,4900,36850000,2,39206,9803,1,773040000,773040000,14701,4900,9801,4900,0,1,4902,33365056,33.365056
6700,5500,4900,36850000,2,39206,9803,1,773040000,773040000,14701,4900,9801,4900,0,1,4902,34567885,34.567885
6700,5500,5300,36850000,2,42406,10603,1,812080000,812080000,15901,5300,10601,5300,0,1,5302,36043348,36.043348
6700,5500,5300,36850000,2,42406,10603,1,812080000,812080000,15901,5300,10601,5300,0,1,5302,37853219,37.853219
6700,5500,5300,36850000,2,42406,10603,1,812080000,812080000,15901,5300,10601,5300,0,1,5302,36161119,36.161119
6700,5500,5300,36850000,2,42406,10603,1,812080000,812080000,15901,5300,10601,5300,0,1,5302,37919802,37.919802
6700,5500,5300,36850000,2,42406,10603,1,812080000,812080000,15901,5300,10601,5300,0,1,5302,36136288,36.136288
6700,5500,5300,36850000,2,42406,10603,1,812080000,812080000,15901,5300,10601,5300,0,1,5302,36068456,36.068456
6700,5500,5300,36850000,2,42406,10603,1,812080000,812080000,15901,5300,10601,5300,0,1,5302,37387416,37.387416
6700,5500,5700,36850000,2,45606,11403,1,851120000,851120000,17101,5700,11401,5700,0,1,5702,38860608,38.860608
6700,5500,5700,36850000,2,45606,11403,1,851120000,851120000,17101,5700,11401,5700,0,1,5702,40711241,40.711241
6700,5500,5700,36850000,2,45606,11403,1,851120000,851120000,17101,5700,11401,5700,0,1,5702,38908229,38.908229
6700,5500,5700,36850000,2,45606,11403,1,851120000,851120000,17101,5700,11401,5700,0,1,5702,40862847,40.862847
6700,5500,5700,36850000,2,45606,11403,1,851120000,851120000,17101,5700,11401,5700,0,1,5702,38835725,38.835725
6700,5500,5700,36850000,2,45606,11403,1,851120000,851120000,17101,5700,11401,5700,0,1,5702,38861540,38.86154
6700,5500,5700,36850000,2,45606,11403,1,851120000,851120000,17101,5700,11401,5700,0,1,5702,40154476,40.154476
6700,5500,6100,36850000,2,48806,12203,1,890160000,890160000,18301,6100,12201,6100,0,1,6102,41479508,41.479508
6700,5500,6100,36850000,2,48806,12203,1,890160000,890160000,18301,6100,12201,6100,0,1,6102,43635086,43.635086
6700,5500,6100,36850000,2,48806,12203,1,890160000,890160000,18301,6100,12201,6100,0,1,6102,41712910,41.71291
6700,5500,6100,36850000,2,48806,12203,1,890160000,890160000,18301,6100,12201,6100,0,1,6102,43689690,43.68969
6700,5500,6100,36850000,2,48806,12203,1,890160000,890160000,18301,6100,12201,6100,0,1,6102,41552129,41.552129
6700,5500,6100,36850000,2,48806,12203,1,890160000,890160000,18301,6100,12201,6100,0,1,6102,41504578,41.504578
6700,5500,6100,36850000,2,48806,12203,1,890160000,890160000,18301,6100,12201,6100,0,1,6102,43032378,43.032378
6700,5500,6500,36850000,2,52006,13003,1,929200000,929200000,19501,6500,13001,6500,0,1,6502,44156850,44.15685
6700,5500,6500,36850000,2,52006,13003,1,929200000,929200000,19501,6500,13001,6500,0,1,6502,46475604,46.475604
6700,5500,6500,36850000,2,52006,13003,1,929200000,929200000,19501,6500,13001,6500,0,1,6502,44401665,44.401665
6700,5500,6500,36850000,2,52006,13003,1,929200000,929200000,19501,6500,13001,6500,0,1,6502,46570160,46.57016
6700,5500,6500,36850000,2,52006,13003,1,929200000,929200000,19501,6500,13001,6500,0,1,6502,44239017,44.239017
6700,5500,6500,36850000,2,52006,13003,1,929200000,929200000,19501,6500,13001,6500,0,1,6502,44182757,44.182757
6700,5500,6500,36850000,2,52006,13003,1,929200000,929200000,19501,6500,13001,6500,0,1,6502,45885378,45.885378
6900,6900,500,47610000,2,4006,1003,1,436080000,436080000,1501,500,1001,500,0,1,502,4992612,4.992612
6900,6900,500,47610000,2,4006,1003,1,436080000,436080000,1501,500,1001,500,0,1,502,5113192,5.113192
6900,6900,500,47610000,2,4006,1003,1,436080000,436080000,1501,500,1001,500,0,1,502,4991951,4.991951
6900,6900,500,47610000,2,4006,1003,1,436080000,436080000,1501,500,1001,500,0,1,502,5025309,5.025309
6900,6900,500,47610000,2,4006,1003,1,436080000,436080000,1501,500,1001,500,0,1,502,4957168,4.957168
6900,6900,500,47610000,2,4006,1003,1,436080000,436080000,1501,500,1001,500,0,1,502,4992972,4.992972
6900,6900,500,47610000,2,4006,1003,1,436080000,436080000,1501,500,1001,500,0,1,502,5026689,5.026689
6900,6900,500,47610000,2,4006,1003,1,436080000,436080000,1501,500,1001,500,0,1,502,5114469,5.114469
6900,6900,900,47610000,2,7206,1803,1,480240000,480240000,2701,900,1801,900,0,1,902,8460647,8.460647
6900,6900,900,47610000,2,7206,1803,1,480240000,480240000,2701,900,1801,900,0,1,902,8697699,8.697699
6900,6900,900,47610000,2,7206,1803,1,480240000,480240000,2701,900,1801,900,0,1,902,8173311,8.173311
6900,6900,900,47610000,2,7206,1803,1,480240000,480240000,2701,900,1801,900,0,1,902,8494339,8.494339
6900,6900,900,47610000,2,7206,1803,1,480240000,480240000,2701,900,1801,900,0,1,902,8205358,8.205358
6900,6900,900,47610000,2,7206,1803,1,480240000,480240000,2701,900,1801,900,0,1,902,8402663,8.402663
6900,6900,900,47610000,2,7206,1803,1,480240000,480240000,2701,900,1801,900,0,1,902,8302716,8.302716
6900,6900,900,47610000,2,7206,1803,1,480240000,480240000,2701,900,1801,900,0,1,902,8562686,8.562686
6900,6900,1300,47610000,2,10406,2603,1,524400000,524400000,3901,1300,2601,1300,0,1,1302,11783691,11.783691
6900,6900,1300,47610000,2,10406,2603,1,524400000,524400000,3901,1300,2601,1300,0,1,1302,12332797,12.332797
6900,6900,1300,47610000,2,10406,2603,1,524400000,524400000,3901,1300,2601,1300,0,1,1302,11816658,11.816658
6900,6900,1300,47610000,2,10406,2603,1,524400000,524400000,3901,1300,2601,1300,0,1,1302,12165384,12.165384
6900,6900,1300,47610000,2,10406,2603,1,524400000,524400000,3901,1300,2601,1300,0,1,1302,11818018,11.818018
6900,6900,1300,47610000,2,10406,2603,1,524400000,524400000,3901,1300,2601,1300,0,1,1302,12100739,12.100739
6900,6900,1300,47610000,2,10406,2603,1,524400000,524400000,3901,1300,2601,1300,0,1,1302,11925961,11.925961
6900,6900,1300,47610000,2,10406,2603,1,524400000,524400000,3901,1300,2601,1300,0,1,1302,12275807,12.275807
6900,6900,1700,47610000,2,13606,3403,1,568560000,568560000,5101,1700,3401,1700,0,1,1702,15520062,15.520062
6900,6900,1700,47610000,2,13606,3403,1,568560000,568560000,5101,1700,3401,1700,0,1,1702,16082391,16.082391
6900,6900,1700,47610000,2,13606,3403,1,568560000,568560000,5101,1700,3401,1700,0,1,1702,15239550,15.23955
6900,6900,1700,47610000,2,13606,3403,1,568560000,568560000,5101,1700,3401,1700,0,1,1702,15879980,15.87998
6900,6900,1700,47610000,2,13606,3403,1,568560000,568560000,5101,1700,3401,1700,0,1,1702,15301882,15.301882
6900,6900,1700,47610000,2,13606,3403,1,568560000,568560000,5101,1700,3401,1700,0,1,1702,15744151,15.744151
6900,6900,1700,47610000,2,13606,3403,1,568560000,568560000,5101,1700,3401,1700,0,1,1702,15453008,15.453008
6900,6900,1700,47610000,2,13606,3403,1,568560000,568560000,5101,1700,3401,1700,0,1,1702,15911508,15.911508
6900,6900,2100,47610000,2,16806,4203,1,612720000,612720000,6301,2100,4201,2100,0,1,2102,19167742,19.167742
6900,6900,2100,47610000,2,16806,4203,1,612720000,612720000,6301,2100,4201,2100,0,1,2102,19673355,19.673355
6900,6900,2100,47610000,2,16806,4203,1,612720000,612720000,6301,2100,4201,2100,0,1,2102,18680491,18.680491
6900,6900,2100,47610000,2,16806,4203,1,612720000,612720000,6301,2100,4201,2100,0,1,2102,19481576,19.481576
6900,6900,2100,47610000,2,16806,4203,1,612720000,612720000,6301,2100,4201,2100,0,1,2102,18816160,18.81616
6900,6900,2100,47610000,2,16806,4203,1,612720000,612720000,6301,2100,4201,2100,0,1,2102,19321215,19.321215
6900,6900,2100,47610000,2,16806,4203,1,612720000,612720000,6301,2100,4201,2100,0,1,2102,18926211,18.926211
6900,6900,2100,47610000,2,16806,4203,1,612720000,612720000,6301,2100,4201,2100,0,1,2102,19431767,19.431767
6900,6900,2500,47610000,2,20006,5003,1,656880000,656880000,7501,2500,5001,2500,0,1,2502,22628641,22.628641
6900,6900,2500,47610000,2,20006,5003,1,656880000,656880000,7501,2500,5001,2500,0,1,2502,23345732,23.345732
6900,6900,2500,47610000,2,20006,5003,1,656880000,656880000,7501,2500,5001,2500,0,1,2502,22160366,22.160366
6900,6900,2500,47610000,2,20006,5003,1,656880000,656880000,7501,2500,5001,2500,0,1,2502,23148597,23.148597
6900,6900,2500,47610000,2,20006,5003,1,656880000,656880000,7501,2500,5001,2500,0,1,2502,22365658,22.365658
6900,6900,2500,47610000,2,20006,5003,1,656880000,656880000,7501,2500,5001,2500,0,1,2502,22907611,22.907611
6900,6900,2500,47610000,2,20006,5003,1,656880000,656880000,7501,2500,5001,2500,0,1,2502,22480984,22.480984
6900,6900,2500,47610000,2,20006,5003,1,656880000,656880000,7501,2500,5001,2500,0,1,2502,23058450,23.05845
6900,6900,2900,47610000,2,23206,5803,1,701040000,701040000,8701,2900,5801,2900,0,1,2902,26185374,26.185374
6900,6900,2900,47610000,2,23206,5803,1,701040000,701040000,8701,2900,5801,2900,0,1,2902,27046182,27.046182
6900,6900,2900,47610000,2,23206,5803,1,701040000,701040000,8701,2900,5801,2900,0,1,2902,25612791,25.612791
6900,6900,2900,47610000,2,23206,5803,1,701040000,701040000,8701,2900,5801,2900,0,1,2902,26791265,26.791265
6900,6900,2900,47610000,2,23206,5803,1,701040000,701040000,8701,2900,5801,2900,0,1,2902,25841914,25.841914
6900,6900,2900,47610000,2,23206,5803,1,701040000,701040000,8701,2900,5801,2900,0,1,2902,26473363,26.473363
6900,6900,2900,47610000,2,23206,5803,1,701040000,701040000,8701,2900,5801,2900,0,1,2902,25991375,25.991375
6900,6900,2900,47610000,2,23206,5803,1,701040000,701040000,8701,2900,5801,2900,0,1,2902,26716761,26.716761
6900,6900,3300,47610000,2,26406,6603,1,745200000,745200000,9901,3300,6601,3300,0,1,3302,29702642,29.702642
6900,6900,3300,47610000,2,26406,6603,1,745200000,745200000,9901,3300,6601,3300,0,1,3302,30709377,30.709377
6900,6900,3300,47610000,2,26406,6603,1,745200000,745200000,9901,3300,6601,3300,0,1,3302,29130633,29.130633
6900,6900,3300,47610000,2,26406,6603,1,745200000,745200000,9901,3300,6601,3300,0,1,3302,30393894,30.393894
6900,6900,3300,47610000,2,26406,6603,1,745200000,745200000,9901,3300,6601,3300,0,1,3302,29377023,29.377023
6900,6900,3300,47610000,2,26406,6603,1,745200000,745200000,9901,3300,6601,3300,0,1,3302,30072000,30.072
6900,6900,3300,47610000,2,26406,6603,1,745200000,745200000,9901,3300,6601,3300,0,1,3302,29513757,29.513757
6900,6900,3300,47610000,2,26406,6603,1,745200000,745200000,9901,3300,6601,3300,0,1,3302,30270652,30.270652
6900,6900,3700,47610000,2,29606,7403,1,789360000,789360000,11101,3700,7401,3700,0,1,3702,33238570,33.23857
6900,6900,3700,47610000,2,29606,7403,1,789360000,789360000,11101,3700,7401,3700,0,1,3702,34368898,34.368898
6900,6900,3700,47610000,2,29606,7403,1,789360000,789360000,11101,3700,7401,3700,0,1,3702,32552056,32.552056
6900,6900,3700,47610000,2,29606,7403,1,789360000,789360000,11101,3700,7401,3700,0,1,3702,34027493,34.027493
6900,6900,3700,47610000,2,29606,7403,1,789360000,789360000,11101,3700,7401,3700,0,1,3702,32848360,32.84836
6900,6900,3700,47610000,2,29606,7403,1,789360000,789360000,11101,3700,7401,3700,0,1,3702,33688644,33.688644
6900,6900,3700,47610000,2,29606,7403,1,789360000,789360000,11101,3700,7401,3700,0,1,3702,33058520,33.05852
6900,6900,3700,47610000,2,29606,7403,1,789360000,789360000,11101,3700,7401,3700,0,1,3702,33951437,33.951437
6900,6900,4100,47610000,2,32806,8203,1,833520000,833520000,12301,4100,8201,4100,0,1,4102,36753111,36.753111
6900,6900,4100,47610000,2,32806,8203,1,833520000,833520000,12301,4100,8201,4100,0,1,4102,38084229,38.084229
6900,6900,4100,47610000,2,32806,8203,1,833520000,833520000,12301,4100,8201,4100,0,1,4102,36031583,36.031583
6900,6900,4100,47610000,2,32806,8203,1,833520000,833520000,12301,4100,8201,4100,0,1,4102,37594121,37.594121
6900,6900,4100,47610000,2,32806,8203,1,833520000,833520000,12301,4100,8201,4100,0,1,4102,36529753,36.529753
6900,6900,4100,47610000,2,32806,8203,1,833520000,833520000,12301,4100,8201,4100,0,1,4102,37178383,37.178383
6900,6900,4100,47610000,2,32806,8203,1,833520000,833520000,12301,4100,8201,4100,0,1,4102,36610471,36.610471
6900,6900,4100,47610000,2,32806,8203,1,833520000,833520000,12301,4100,8201,4100,0,1,4102,37410609,37.410609
6900,6900,4500,47610000,2,36006,9003,1,877680000,877680000,13501,4500,9001,4500,0,1,4502,40481178,40.481178
6900,6900,4500,47610000,2,36006,9003,1,877680000,877680000,13501,4500,9001,4500,0,1,4502,41737669,41.737669
6900,6900,4500,47610000,2,36006,9003,1,877680000,877680000,13501,4500,9001,4500,0,1,4502,39512474,39.512474
6900,6900,4500,47610000,2,36006,9003,1,877680000,877680000,13501,4500,9001,4500,0,1,4502,41340097,41.340097
6900,6900,4500,47610000,2,36006,9003,1,877680000,877680000,13501,4500,9001,4500,0,1,4502,39994894,39.994894
6900,6900,4500,47610000,2,36006,9003,1,877680000,877680000,13501,4500,9001,4500,0,1,4502,40845874,40.845874
6900,6900,4500,47610000,2,36006,9003,1,877680000,877680000,13501,4500,9001,4500,0,1,4502,40103217,40.103217
6900,6900,4500,47610000,2,36006,9003,1,877680000,877680000,13501,4500,9001,4500,0,1,4502,41210897,41.210897
6900,6900,4900,47610000,2,39206,9803,1,921840000,921840000,14701,4900,9801,4900,0,1,4902,43963650,43.96365
6900,6900,4900,47610000,2,39206,9803,1,921840000,921840000,14701,4900,9801,4900,0,1,4902,45478455,45.478455
6900,6900,4900,47610000,2,39206,9803,1,921840000,921840000,14701,4900,9801,4900,0,1,4902,42961030,42.96103
6900,6900,4900,47610000,2,39206,9803,1,921840000,921840000,14701,4900,9801,4900,0,1,4902,44917727,44.917727
6900,6900,4900,47610000,2,39206,9803,1,921840000,921840000,14701,4900,9801,4900,0,1,4902,43524847,43.524847
6900,6900,4900,47610000,2,39206,9803,1,921840000,921840000,14701,4900,9801,4900,0,1,4902,44361395,44.361395
6900,6900,4900,47610000,2,39206,9803,1,921840000,921840000,14701,4900,9801,4900,0,1,4902,43558155,43.558155
6900,6900,4900,47610000,2,39206,9803,1,921840000,921840000,14701,4900,9801,4900,0,1,4902,44673607,44.673607
6900,6900,5300,47610000,2,42406,10603,1,966000000,966000000,15901,5300,10601,5300,0,1,5302,47434144,47.434144
6900,6900,5300,47610000,2,42406,10603,1,966000000,966000000,15901,5300,10601,5300,0,1,5302,49211329,49.211329
6900,6900,5300,47610000,2,42406,10603,1,966000000,966000000,15901,5300,10601,5300,0,1,5302,46530989,46.530989
6900,6900,5300,47610000,2,42406,10603,1,966000000,966000000,15901,5300,10601,5300,0,1,5302,48724935,48.724935
6900,6900,5300,47610000,2,42406,10603,1,966000000,966000000,15901,5300,10601,5300,0,1,5302,47137751,47.137751
6900,6900,5300,47610000,2,42406,10603,1,966000000,966000000,15901,5300,10601,5300,0,1,5302,48003409,48.003409
6900,6900,5300,47610000,2,42406,10603,1,966000000,966000000,15901,5300,10601,5300,0,1,5302,47104989,47.104989
6900,6900,5300,47610000,2,42406,10603,1,966000000,966000000,15901,5300,10601,5300,0,1,5302,48363818,48.363818
6900,6900,5700,47610000,2,45606,11403,1,1010160000,1010160000,17101,5700,11401,5700,0,1,5702,50988314,50.988314
6900,6900,5700,47610000,2,45606,11403,1,1010160000,1010160000,17101,5700,11401,5700,0,1,5702,52918631,52.918631
6900,6900,5700,47610000,2,45606,11403,1,1010160000,1010160000,17101,5700,11401,5700,0,1,5702,50064815,50.064815
6900,6900,5700,47610000,2,45606,11403,1,1010160000,1010160000,17101,5700,11401,5700,0,1,5702,52316901,52.316901
6900,6900,5700,47610000,2,45606,11403,1,1010160000,1010160000,17101,5700,11401,5700,0,1,5702,50670834,50.670834
6900,6900,5700,47610000,2,45606,11403,1,1010160000,1010160000,17101,5700,11401,5700,0,1,5702,51590525,51.590525
6900,6900,5700,47610000,2,45606,11403,1,1010160000,1010160000,17101,5700,11401,5700,0,1,5702,50637070,50.63707
6900,6900,5700,47610000,2,45606,11403,1,1010160000,1010160000,17101,5700,11401,5700,0,1,5702,51979349,51.979349
6900,6900,6100,47610000,2,48806,12203,1,1054320000,1054320000,18301,6100,12201,6100,0,1,6102,54643791,54.643791
6900,6900,6100,47610000,2,48806,12203,1,1054320000,1054320000,18301,6100,12201,6100,0,1,6102,56601810,56.60181
6900,6900,6100,47610000,2,48806,12203,1,1054320000,1054320000,18301,6100,12201,6100,0,1,6102,53484485,53.484485
6900,6900,6100,47610000,2,48806,12203,1,1054320000,1054320000,18301,6100,12201,6100,0,1,6102,56081845,56.081845
6900,6900,6100,47610000,2,48806,12203,1,1054320000,1054320000,18301,6100,12201,6100,0,1,6102,54206784,54.206784
6900,6900,6100,47610000,2,48806,12203,1,1054320000,1054320000,18301,6100,12201,6100,0,1,6102,55228273,55.228273
6900,6900,6100,47610000,2,48806,12203,1,1054320000,1054320000,18301,6100,12201,6100,0,1,6102,54303792,54.303792
6900,6900,6100,47610000,2,48806,12203,1,1054320000,1054320000,18301,6100,12201,6100,0,1,6102,55606032,55.606032
6900,6900,6500,47610000,2,52006,13003,1,1098480000,1098480000,19501,6500,13001,6500,0,1,6502,58153389,58.153389
6900,6900,6500,47610000,2,52006,13003,1,1098480000,1098480000,19501,6500,13001,6500,0,1,6502,60442120,60.44212
6900,6900,6500,47610000,2,52006,13003,1,1098480000,1098480000,19501,6500,13001,6500,0,1,6502,57028099,57.028099
6900,6900,6500,47610000,2,52006,13003,1,1098480000,1098480000,19501,6500,13001,6500,0,1,6502,59715816,59.715816
6900,6900,6500,47610000,2,52006,13003,1,1098480000,1098480000,19501,6500,13001,6500,0,1,6502,57737332,57.737332
6900,6900,6500,47610000,2,52006,13003,1,1098480000,1098480000,19501,6500,13001,6500,0,1,6502,58843838,58.843838
6900,6900,6500,47610000,2,52006,13003,1,1098480000,1098480000,19501,6500,13001,6500,0,1,6502,57831178,57.831178
6900,6900,6500,47610000,2,52006,13003,1,1098480000,1098480000,19501,6500,13001,6500,0,1,6502,59256944,59.256944
6900,6900,6900,47610000,2,55206,13803,1,1142640000,1142640000,20701,6900,13801,6900,0,1,6902,61769817,61.769817
6900,6900,6900,47610000,2,55206,13803,1,1142640000,1142640000,20701,6900,13801,6900,0,1,6902,64007668,64.007668
6900,6900,6900,47610000,2,55206,13803,1,1142640000,1142640000,20701,6900,13801,6900,0,1,6902,60514445,60.514445
6900,6900,6900,47610000,2,55206,13803,1,1142640000,1142640000,20701,6900,13801,6900,0,1,6902,63405547,63.405547
6900,6900,6900,47610000,2,55206,13803,1,1142640000,1142640000,20701,6900,13801,6900,0,1,6902,61232009,61.232009
6900,6900,6900,47610000,2,55206,13803,1,1142640000,1142640000,20701,6900,13801,6900,0,1,6902,62405919,62.405919
6900,6900,6900,47610000,2,55206,13803,1,1142640000,1142640000,20701,6900,13801,6900,0,1,6902,61388973,61.388973
6900,6900,6900,47610000,2,55206,13803,1,1142640000,1142640000,20701,6900,13801,6900,0,1,6902,62951112,62.951112
6900,6500,500,44850000,2,4006,1003,1,412400000,412400000,1501,500,1001,500,0,1,502,4758723,4.758723
6900,6500,500,44850000,2,4006,1003,1,412400000,412400000,1501,500,1001,500,0,1,502,4802252,4.802252
6900,6500,500,44850000,2,4006,1003,1,412400000,412400000,1501,500,1001,500,0,1,502,4660874,4.660874
6900,6500,500,44850000,2,4006,1003,1,412400000,412400000,1501,500,1001,500,0,1,502,4865389,4.865389
6900,6500,500,44850000,2,4006,1003,1,412400000,412400000,1501,500,1001,500,0,1,502,4863247,4.863247
6900,6500,500,44850000,2,4006,1003,1,412400000,412400000,1501,500,1001,500,0,1,502,4832278,4.832278
6900,6500,500,44850000,2,4006,1003,1,412400000,412400000,1501,500,1001,500,0,1,502,4691511,4.691511
6900,6500,500,44850000,2,4006,1003,1,412400000,412400000,1501,500,1001,500,0,1,502,4728192,4.728192
6900,6500,900,44850000,2,7206,1803,1,455280000,455280000,2701,900,1801,900,0,1,902,7876681,7.876681
6900,6500,900,44850000,2,7206,1803,1,455280000,455280000,2701,900,1801,900,0,1,902,8147436,8.147436
6900,6500,900,44850000,2,7206,1803,1,455280000,455280000,2701,900,1801,900,0,1,902,7736878,7.736878
6900,6500,900,44850000,2,7206,1803,1,455280000,455280000,2701,900,1801,900,0,1,902,8115287,8.115287
6900,6500,900,44850000,2,7206,1803,1,455280000,455280000,2701,900,1801,900,0,1,902,7908941,7.908941
6900,6500,900,44850000,2,7206,1803,1,455280000,455280000,2701,900,1801,900,0,1,902,8039166,8.039166
6900,6500,900,44850000,2,7206,1803,1,455280000,455280000,2701,900,1801,900,0,1,902,7797118,7.797118
6900,6500,900,44850000,2,7206,1803,1,455280000,455280000,2701,900,1801,900,0,1,902,8007510,8.00751
6900,6500,1300,44850000,2,10406,2603,1,498160000,498160000,3901,1300,2601,1300,0,1,1302,11358133,11.358133
6900,6500,1300,44850000,2,10406,2603,1,498160000,498160000,3901,1300,2601,1300,0,1,1302,11697854,11.697854
6900,6500,1300,44850000,2,10406,2603,1,498160000,498160000,3901,1300,2601,1300,0,1,1302,11158476,11.158476
6900,6500,1300,44850000,2,10406,2603,1,498160000,498160000,3901,1300,2601,1300,0,1,1302,11572860,11.57286
6900,6500,1300,44850000,2,10406,2603,1,498160000,498160000,3901,1300,2601,1300,0,1,1302,11327467,11.327467
6900,6500,1300,44850000,2,10406,2603,1,498160000,498160000,3901,1300,2601,1300,0,1,1302,11524066,11.524066
6900,6500,1300,44850000,2,10406,2603,1,498160000,498160000,3901,1300,2601,1300,0,1,1302,11219530,11.21953
6900,6500,1300,44850000,2,10406,2603,1,498160000,498160000,3901,1300,2601,1300,0,1,1302,11482631,11.482631
6900,6500,1700,44850000,2,13606,3403,1,541040000,541040000,5101,1700,3401,1700,0,1,1702,14531803,14.531803
6900,6500,1700,44850000,2,13606,3403,1,541040000,541040000,5101,1700,3401,1700,0,1,1702,15020984,15.020984
6900,6500,1700,44850000,2,13606,3403,1,541040000,541040000,5101,1700,3401,1700,0,1,1702,14215941,14.215941
6900,6500,1700,44850000,2,13606,3403,1,541040000,541040000,5101,1700,3401,1700,0,1,1702,14866645,14.866645
6900,6500,1700,44850000,2,13606,3403,1,541040000,541040000,5101,1700,3401,1700,0,1,1702,14599685,14.599685
6900,6500,1700,44850000,2,13606,3403,1,541040000,541040000,5101,1700,3401,1700,0,1,1702,14724297,14.724297
6900,6500,1700,44850000,2,13606,3403,1,541040000,541040000,5101,1700,3401,1700,0,1,1702,14479919,14.479919
6900,6500,1700,44850000,2,13606,3403,1,541040000,541040000,5101,1700,3401,1700,0,1,1702,14763466,14.763466
6900,6500,2100,44850000,2,16806,4203,1,583920000,583920000,6301,2100,4201,2100,0,1,2102,18008248,18.008248
6900,6500,2100,44850000,2,16806,4203,1,583920000,583920000,6301,2100,4201,2100,0,1,2102,18532713,18.532713
6900,6500,2100,44850000,2,16806,4203,1,583920000,583920000,6301,2100,4201,2100,0,1,2102,17587999,17.587999
6900,6500,2100,44850000,2,16806,4203,1,583920000,583920000,6301,2100,4201,2100,0,1,2102,18328080,18.32808
6900,6500,2100,44850000,2,16806,4203,1,583920000,583920000,6301,2100,4201,2100,0,1,2102,17904492,17.904492
6900,6500,2100,44850000,2,16806,4203,1,583920000,583920000,6301,2100,4201,2100,0,1,2102,18158438,18.158438
6900,6500,2100,44850000,2,16806,4203,1,583920000,583920000,6301,2100,4201,2100,0,1,2102,17731126,17.731126
6900,6500,2100,44850000,2,16806,4203,1,583920000,583920000,6301,2100,4201,2100,0,1,2102,18233925,18.233925
6900,6500,2500,44850000,2,20006,5003,1,626800000,626800000,7501,2500,5001,2500,0,1,2502,21328864,21.328864
6900,6500,2500,44850000,2,20006,5003,1,626800000,626800000,7501,2500,5001,2500,0,1,2502,21990690,21.99069
6900,6500,2500,44850000,2,20006,5003,1,626800000,626800000,7501,2500,5001,2500,0,1,2502,20842776,20.842776
6900,6500,2500,44850000,2,20006,5003,1,626800000,626800000,7501,2500,5001,2500,0,1,2502,21813938,21.813938
6900,6500,2500,44850000,2,20006,5003,1,626800000,626800000,7501,2500,5001,2500,0,1,2502,21204975,21.204975
6900,6500,2500,44850000,2,20006,5003,1,626800000,626800000,7501,2500,5001,2500,0,1,2502,21588398,21.588398
6900,6500,2500,44850000,2,20006,5003,1,626800000,626800000,7501,2500,5001,2500,0,1,2502,21018776,21.018776
6900,6500,2500,44850000,2,20006,5003,1,626800000,626800000,7501,2500,5001,2500,0,1,2502,21735351,21.735351
6900,6500,2900,44850000,2,23206,5803,1,669680000,669680000,8701,2900,5801,2900,0,1,2902,24642629,24.642629
6900,6500,2900,44850000,2,23206,5803,1,669680000,669680000,8701,2900,5801,2900,0,1,2902,25433735,25.433735
6900,6500,2900,44850000,2,23206,5803,1,669680000,669680000,8701,2900,5801,2900,0,1,2902,24161262,24.161262
6900,6500,2900,44850000,2,23206,5803,1,669680000,669680000,8701,2900,5801,2900,0,1,2902,25142639,25.142639
6900,6500,2900,44850000,2,23206,5803,1,669680000,669680000,8701,2900,5801,2900,0,1,2902,24460132,24.460132
6900,6500,2900,44850000,2,23206,5803,1,669680000,669680000,8701,2900,5801,2900,0,1,2902,24911966,24.911966
6900,6500,2900,44850000,2,23206,5803,1,669680000,669680000,8701,2900,5801,2900,0,1,2902,24325263,24.325263
6900,6500,2900,44850000,2,23206,5803,1,669680000,669680000,8701,2900,5801,2900,0,1,2902,25028460,25.02846
6900,6500,3300,44850000,2,26406,6603,1,712560000,712560000,9901,3300,6601,3300,0,1,3302,28067848,28.067848
6900,6500,3300,44850000,2,26406,6603,1,712560000,712560000,9901,3300,6601,3300,0,1,3302,28931361,28.931361
6900,6500,3300,44850000,2,26406,6603,1,712560000,712560000,9901,3300,6601,3300,0,1,3302,27380429,27.380429
6900,6500,3300,44850000,2,26406,6603,1,712560000,712560000,9901,3300,6601,3300,0,1,3302,28619306,28.619306
6900,6500,3300,44850000,2,26406,6603,1,712560000,712560000,9901,3300,6601,3300,0,1,3302,27792220,27.79222
6900,6500,3300,44850000,2,26406,6603,1,712560000,712560000,9901,3300,6601,3300,0,1,3302,28297961,28.297961
6900,6500,3300,44850000,2,26406,6603,1,712560000,712560000,9901,3300,6601,3300,0,1,3302,27675537,27.675537
6900,6500,3300,44850000,2,26406,6603,1,712560000,712560000,9901,3300,6601,3300,0,1,3302,28424174,28.424174
6900,6500,3700,44850000,2,29606,7403,1,755440000,755440000,11101,3700,7401,3700,0,1,3702,31333511,31.333511
6900,6500,3700,44850000,2,29606,7403,1,755440000,755440000,11101,3700,7401,3700,0,1,3702,32372054,32.372054
6900,6500,3700,44850000,2,29606,7403,1,755440000,755440000,11101,3700,7401,3700,0,1,3702,30645541,30.645541
6900,6500,3700,44850000,2,29606,7403,1,755440000,755440000,11101,3700,7401,3700,0,1,3702,32018320,32.01832
6900,6500,3700,44850000,2,29606,7403,1,755440000,755440000,11101,3700,7401,3700,0,1,3702,31073232,31.073232
6900,6500,3700,44850000,2,29606,7403,1,755440000,755440000,11101,3700,7401,3700,0,1,3702,31647248,31.647248
6900,6500,3700,44850000,2,29606,7403,1,755440000,755440000,11101,3700,7401,3700,0,1,3702,30979389,30.979389
6900,6500,3700,44850000,2,29606,7403,1,755440000,755440000,11101,3700,7401,3700,0,1,3702,31832972,31.832972
6900,6500,4100,44850000,2,32806,8203,1,798320000,798320000,12301,4100,8201,4100,0,1,4102,34649095,34.649095
6900,6500,4100,44850000,2,32806,8203,1,798320000,798320000,12301,4100,8201,4100,0,1,4102,35884483,35.884483
6900,6500,4100,44850000,2,32806,8203,1,798320000,798320000,12301,4100,8201,4100,0,1,4102,34024622,34.024622
6900,6500,4100,44850000,2,32806,8203,1,798320000,798320000,12301,4100,8201,4100,0,1,4102,35444470,35.44447
6900,6500,4100,44850000,2,32806,8203,1,798320000,798320000,12301,4100,8201,4100,0,1,4102,34404573,34.404573
6900,6500,4100,44850000,2,32806,8203,1,798320000,798320000,12301,4100,8201,4100,0,1,4102,35053893,35.053893
6900,6500,4100,44850000,2,32806,8203,1,798320000,798320000,12301,4100,8201,4100,0,1,4102,34331968,34.331968
6900,6500,4100,44850000,2,32806,8203,1,798320000,798320000,12301,4100,8201,4100,0,1,4102,35220111,35.220111
6900,6500,4500,44850000,2,36006,9003,1,841200000,841200000,13501,4500,9001,4500,0,1,4502,37971707,37.971707
6900,6500,4500,44850000,2,36006,9003,1,841200000,841200000,13501,4500,9001,4500,0,1,4502,39344635,39.344635
6900,6500,4500,44850000,2,36006,9003,1,841200000,841200000,13501,4500,9001,4500,0,1,4502,37235154,37.235154
6900,6500,4500,44850000,2,36006,9003,1,841200000,841200000,13501,4500,9001,4500,0,1,4502,38815587,38.815587
6900,6500,4500,44850000,2,36006,9003,1,841200000,841200000,13501,4500,9001,4500,0,1,4502,37679956,37.679956
6900,6500,4500,44850000,2,36006,9003,1,841200000,841200000,13501,4500,9001,4500,0,1,4502,38390112,38.390112
6900,6500,4500,44850000,2,36006,9003,1,841200000,841200000,13501,4500,9001,4500,0,1,4502,37630381,37.630381
6900,6500,4500,44850000,2,36006,9003,1,841200000,841200000,13501,4500,9001,4500,0,1,4502,38717674,38.717674
6900,6500,4900,44850000,2,39206,9803,1,884080000,884080000,14701,4900,9801,4900,0,1,4902,41338470,41.33847
6900,6500,4900,44850000,2,39206,9803,1,884080000,884080000,14701,4900,9801,4900,0,1,4902,42808960,42.80896
6900,6500,4900,44850000,2,39206,9803,1,884080000,884080000,14701,4900,9801,4900,0,1,4902,40522617,40.522617
6900,6500,4900,44850000,2,39206,9803,1,884080000,884080000,14701,4900,9801,4900,0,1,4902,42332982,42.332982
6900,6500,4900,44850000,2,39206,9803,1,884080000,884080000,14701,4900,9801,4900,0,1,4902,41019638,41.019638
6900,6500,4900,44850000,2,39206,9803,1,884080000,884080000,14701,4900,9801,4900,0,1,4902,41825477,41.825477
6900,6500,4900,44850000,2,39206,9803,1,884080000,884080000,14701,4900,9801,4900,0,1,4902,40940085,40.940085
6900,6500,4900,44850000,2,39206,9803,1,884080000,884080000,14701,4900,9801,4900,0,1,4902,42190047,42.190047
6900,6500,5300,44850000,2,42406,10603,1,926960000,926960000,15901,5300,10601,5300,0,1,5302,44813800,44.8138
6900,6500,5300,44850000,2,42406,10603,1,926960000,926960000,15901,5300,10601,5300,0,1,5302,46282651,46.282651
6900,6500,5300,44850000,2,42406,10603,1,926960000,926960000,15901,5300,10601,5300,0,1,5302,43801954,43.801954
6900,6500,5300,44850000,2,42406,10603,1,926960000,926960000,15901,5300,10601,5300,0,1,5302,45821438,45.821438
6900,6500,5300,44850000,2,42406,10603,1,926960000,926960000,15901,5300,10601,5300,0,1,5302,44381763,44.381763
6900,6500,5300,44850000,2,42406,10603,1,926960000,926960000,15901,5300,10601,5300,0,1,5302,45205896,45.205896
6900,6500,5300,44850000,2,42406,10603,1,926960000,926960000,15901,5300,10601,5300,0,1,5302,44351710,44.35171
6900,6500,5300,44850000,2,42406,10603,1,926960000,926960000,15901,5300,10601,5300,0,1,5302,45642388,45.642388
6900,6500,5700,44850000,2,45606,11403,1,969840000,969840000,17101,5700,11401,5700,0,1,5702,47995315,47.995315
6900,6500,5700,44850000,2,45606,11403,1,969840000,969840000,17101,5700,11401,5700,0,1,5702,49806118,49.806118
6900,6500,5700,44850000,2,45606,11403,1,969840000,969840000,17101,5700,11401,5700,0,1,5702,47163127,47.163127
6900,6500,5700,44850000,2,45606,11403,1,969840000,969840000,17101,5700,11401,5700,0,1,5702,49272319,49.272319
6900,6500,5700,44850000,2,45606,11403,1,969840000,969840000,17101,5700,11401,5700,0,1,5702,47606644,47.606644
6900,6500,5700,44850000,2,45606,11403,1,969840000,969840000,17101,5700,11401,5700,0,1,5702,48636164,48.636164
6900,6500,5700,44850000,2,45606,11403,1,969840000,969840000,17101,5700,11401,5700,0,1,5702,47689159,47.689159
6900,6500,5700,44850000,2,45606,11403,1,969840000,969840000,17101,5700,11401,5700,0,1,5702,49187677,49.187677
6900,6500,6100,44850000,2,48806,12203,1,1012720000,1012720000,18301,6100,12201,6100,0,1,6102,51391802,51.391802
6900,6500,6100,44850000,2,48806,12203,1,1012720000,1012720000,18301,6100,12201,6100,0,1,6102,53268079,53.268079
6900,6500,6100,44850000,2,48806,12203,1,1012720000,1012720000,18301,6100,12201,6100,0,1,6102,50394511,50.394511
6900,6500,6100,44850000,2,48806,12203,1,1012720000,1012720000,18301,6100,12201,6100,0,1,6102,52739484,52.739484
6900,6500,6100,44850000,2,48806,12203,1,1012720000,1012720000,18301,6100,12201,6100,0,1,6102,51101378,51.101378
6900,6500,6100,44850000,2,48806,12203,1,1012720000,1012720000,18301,6100,12201,6100,0,1,6102,52111180,52.11118
6900,6500,6100,44850000,2,48806,12203,1,1012720000,1012720000,18301,6100,12201,6100,0,1,6102,51070534,51.070534
6900,6500,6100,44850000,2,48806,12203,1,1012720000,1012720000,18301,6100,12201,6100,0,1,6102,52570780,52.57078
6900,6500,6500,44850000,2,52006,13003,1,1055600000,1055600000,19501,6500,13001,6500,0,1,6502,54770662,54.770662
6900,6500,6500,44850000,2,52006,13003,1,1055600000,1055600000,19501,6500,13001,6500,0,1,6502,56882120,56.88212
6900,6500,6500,44850000,2,52006,13003,1,1055600000,1055600000,19501,6500,13001,6500,0,1,6502,53759399,53.759399
6900,6500,6500,44850000,2,52006,13003,1,1055600000,1055600000,19501,6500,13001,6500,0,1,6502,56200366,56.200366
6900,6500,6500,44850000,2,52006,13003,1,1055600000,1055600000,19501,6500,13001,6500,0,1,6502,54352969,54.352969
6900,6500,6500,44850000,2,52006,13003,1,1055600000,1055600000,19501,6500,13001,6500,0,1,6502,55534150,55.53415
6900,6500,6500,44850000,2,52006,13003,1,1055600000,1055600000,19501,6500,13001,6500,0,1,6502,54383440,54.38344
6900,6500,6500,44850000,2,52006,13003,1,1055600000,1055600000,19501,6500,13001,6500,0,1,6502,55958407,55.958407
6900,6500,6900,44850000,2,55206,13803,1,1098480000,1098480000,20701,6900,13801,6900,0,1,6902,58148913,58.148913
6900,6500,6900,44850000,2,55206,13803,1,1098480000,1098480000,20701,6900,13801,6900,0,1,6902,60382217,60.382217
6900,6500,6900,44850000,2,55206,13803,1,1098480000,1098480000,20701,6900,13801,6900,0,1,6902,57006321,57.006321
6900,6500,6900,44850000,2,55206,13803,1,1098480000,1098480000,20701,6900,13801,6900,0,1,6902,59617942,59.617942
6900,6500,6900,44850000,2,55206,13803,1,1098480000,1098480000,20701,6900,13801,6900,0,1,6902,57531610,57.53161
6900,6500,6900,44850000,2,55206,13803,1,1098480000,1098480000,20701,6900,13801,6900,0,1,6902,58816562,58.816562
6900,6500,6900,44850000,2,55206,13803,1,1098480000,1098480000,20701,6900,13801,6900,0,1,6902,57835506,57.835506
6900,6500,6900,44850000,2,55206,13803,1,1098480000,1098480000,20701,6900,13801,6900,0,1,6902,59513890,59.51389
6900,6100,500,42090000,2,4006,1003,1,388720000,388720000,1501,500,1001,500,0,1,502,4484592,4.484592
6900,6100,500,42090000,2,4006,1003,1,388720000,388720000,1501,500,1001,500,0,1,502,4569752,4.569752
6900,6100,500,42090000,2,4006,1003,1,388720000,388720000,1501,500,1001,500,0,1,502,4456453,4.456453
6900,6100,500,42090000,2,4006,1003,1,388720000,388720000,1501,500,1001,500,0,1,502,4538500,4.5385
6900,6100,500,42090000,2,4006,1003,1,388720000,388720000,1501,500,1001,500,0,1,502,4455372,4.455372
6900,6100,500,42090000,2,4006,1003,1,388720000,388720000,1501,500,1001,500,0,1,502,4568382,4.568382
6900,6100,500,42090000,2,4006,1003,1,388720000,388720000,1501,500,1001,500,0,1,502,4426602,4.426602
6900,6100,500,42090000,2,4006,1003,1,388720000,388720000,1501,500,1001,500,0,1,502,4486042,4.486042
6900,6100,900,42090000,2,7206,1803,1,430320000,430320000,2701,900,1801,900,0,1,902,7397606,7.397606
6900,6100,900,42090000,2,7206,1803,1,430320000,430320000,2701,900,1801,900,0,1,902,7659721,7.659721
6900,6100,900,42090000,2,7206,1803,1,430320000,430320000,2701,900,1801,900,0,1,902,7285487,7.285487
6900,6100,900,42090000,2,7206,1803,1,430320000,430320000,2701,900,1801,900,0,1,902,7586088,7.586088
6900,6100,900,42090000,2,7206,1803,1,430320000,430320000,2701,900,1801,900,0,1,902,7368604,7.368604
6900,6100,900,42090000,2,7206,1803,1,430320000,430320000,2701,900,1801,900,0,1,902,7523998,7.523998
6900,6100,900,42090000,2,7206,1803,1,430320000,430320000,2701,900,1801,900,0,1,902,7339930,7.33993
6900,6100,900,42090000,2,7206,1803,1,430320000,430320000,2701,900,1801,900,0,1,902,7553656,7.553656
6900,6100,1300,42090000,2,10406,2603,1,471920000,471920000,3901,1300,2601,1300,0,1,1302,10646643,10.646643
6900,6100,1300,42090000,2,10406,2603,1,471920000,471920000,3901,1300,2601,1300,0,1,1302,10992056,10.992056
6900,6100,1300,42090000,2,10406,2603,1,471920000,471920000,3901,1300,2601,1300,0,1,1302,10471152,10.471152
6900,6100,1300,42090000,2,10406,2603,1,471920000,471920000,3901,1300,2601,1300,0,1,1302,10855774,10.855774
6900,6100,1300,42090000,2,10406,2603,1,471920000,471920000,3901,1300,2601,1300,0,1,1302,10617704,10.617704
6900,6100,1300,42090000,2,10406,2603,1,471920000,471920000,3901,1300,2601,1300,0,1,1302,10766105,10.766105
6900,6100,1300,42090000,2,10406,2603,1,471920000,471920000,3901,1300,2601,1300,0,1,1302,10543992,10.543992
6900,6100,1300,42090000,2,10406,2603,1,471920000,471920000,3901,1300,2601,1300,0,1,1302,10796068,10.796068
6900,6100,1700,42090000,2,13606,3403,1,513520000,513520000,5101,1700,3401,1700,0,1,1702,13637516,13.637516
6900,6100,1700,42090000,2,13606,3403,1,513520000,513520000,5101,1700,3401,1700,0,1,1702,14102148,14.102148
6900,6100,1700,42090000,2,13606,3403,1,513520000,513520000,5101,1700,3401,1700,0,1,1702,13355498,13.355498
6900,6100,1700,42090000,2,13606,3403,1,513520000,513520000,5101,1700,3401,1700,0,1,1702,13939163,13.939163
6900,6100,1700,42090000,2,13606,3403,1,513520000,513520000,5101,1700,3401,1700,0,1,1702,13564410,13.56441
6900,6100,1700,42090000,2,13606,3403,1,513520000,513520000,5101,1700,3401,1700,0,1,1702,13807702,13.807702
6900,6100,1700,42090000,2,13606,3403,1,513520000,513520000,5101,1700,3401,1700,0,1,1702,13463917,13.463917
6900,6100,1700,42090000,2,13606,3403,1,513520000,513520000,5101,1700,3401,1700,0,1,1702,13860676,13.860676
6900,6100,2100,42090000,2,16806,4203,1,555120000,555120000,6301,2100,4201,2100,0,1,2102,16909293,16.909293
6900,6100,2100,42090000,2,16806,4203,1,555120000,555120000,6301,2100,4201,2100,0,1,2102,17409578,17.409578
6900,6100,2100,42090000,2,16806,4203,1,555120000,555120000,6301,2100,4201,2100,0,1,2102,16557494,16.557494
6900,6100,2100,42090000,2,16806,4203,1,555120000,555120000,6301,2100,4201,2100,0,1,2102,17184925,17.184925
6900,6100,2100,42090000,2,16806,4203,1,555120000,555120000,6301,2100,4201,2100,0,1,2102,16749549,16.749549
6900,6100,2100,42090000,2,16806,4203,1,555120000,555120000,6301,2100,4201,2100,0,1,2102,17042218,17.042218
6900,6100,2100,42090000,2,16806,4203,1,555120000,555120000,6301,2100,4201,2100,0,1,2102,16682568,16.682568
6900,6100,2100,42090000,2,16806,4203,1,555120000,555120000,6301,2100,4201,2100,0,1,2102,17231769,17.231769
6900,6100,2500,42090000,2,20006,5003,1,596720000,596720000,7501,2500,5001,2500,0,1,2502,20015498,20.015498
6900,6100,2500,42090000,2,20006,5003,1,596720000,596720000,7501,2500,5001,2500,0,1,2502,20616578,20.616578
6900,6100,2500,42090000,2,20006,5003,1,596720000,596720000,7501,2500,5001,2500,0,1,2502,19579783,19.579783
6900,6100,2500,42090000,2,20006,5003,1,596720000,596720000,7501,2500,5001,2500,0,1,2502,20392120,20.39212
6900,6100,2500,42090000,2,20006,5003,1,596720000,596720000,7501,2500,5001,2500,0,1,2502,19852779,19.852779
6900,6100,2500,42090000,2,20006,5003,1,596720000,596720000,7501,2500,5001,2500,0,1,2502,20142202,20.142202
6900,6100,2500,42090000,2,20006,5003,1,596720000,596720000,7501,2500,5001,2500,0,1,2502,19791733,19.791733
6900,6100,2500,42090000,2,20006,5003,1,596720000,596720000,7501,2500,5001,2500,0,1,2502,20316376,20.316376
6900,6100,2900,42090000,2,23206,5803,1,638320000,638320000,8701,2900,5801,2900,0,1,2902,23119699,23.119699
6900,6100,2900,42090000,2,23206,5803,1,638320000,638320000,8701,2900,5801,2900,0,1,2902,23902134,23.902134
6900,6100,2900,42090000,2,23206,5803,1,638320000,638320000,8701,2900,5801,2900,0,1,2902,22672456,22.672456
6900,6100,2900,42090000,2,23206,5803,1,638320000,638320000,8701,2900,5801,2900,0,1,2902,23605118,23.605118
6900,6100,2900,42090000,2,23206,5803,1,638320000,638320000,8701,2900,5801,2900,0,1,2902,22886492,22.886492
6900,6100,2900,42090000,2,23206,5803,1,638320000,638320000,8701,2900,5801,2900,0,1,2902,23295633,23.295633
6900,6100,2900,42090000,2,23206,5803,1,638320000,638320000,8701,2900,5801,2900,0,1,2902,22915472,22.915472
6900,6100,2900,42090000,2,23206,5803,1,638320000,638320000,8701,2900,5801,2900,0,1,2902,23502492,23.502492
6900,6100,3300,42090000,2,26406,6603,1,679920000,679920000,9901,3300,6601,3300,0,1,3302,26248876,26.248876
6900,6100,3300,42090000,2,26406,6603,1,679920000,679920000,9901,3300,6601,3300,0,1,3302,27165568,27.165568
6900,6100,3300,42090000,2,26406,6603,1,679920000,679920000,9901,3300,6601,3300,0,1,3302,25774720,25.77472
6900,6100,3300,42090000,2,26406,6603,1,679920000,679920000,9901,3300,6601,3300,0,1,3302,26815677,26.815677
6900,6100,3300,42090000,2,26406,6603,1,679920000,679920000,9901,3300,6601,3300,0,1,3302,25959764,25.959764
6900,6100,3300,42090000,2,26406,6603,1,679920000,679920000,9901,3300,6601,3300,0,1,3302,26446897,26.446897
6900,6100,3300,42090000,2,26406,6603,1,679920000,679920000,9901,3300,6601,3300,0,1,3302,26063076,26.063076
6900,6100,3300,42090000,2,26406,6603,1,679920000,679920000,9901,3300,6601,3300,0,1,3302,26667338,26.667338
6900,6100,3700,42090000,2,29606,7403,1,721520000,721520000,11101,3700,7401,3700,0,1,3702,29420586,29.420586
6900,6100,3700,42090000,2,29606,7403,1,721520000,721520000,11101,3700,7401,3700,0,1,3702,30504067,30.504067
6900,6100,3700,42090000,2,29606,7403,1,721520000,721520000,11101,3700,7401,3700,0,1,3702,28762287,28.762287
6900,6100,3700,42090000,2,29606,7403,1,721520000,721520000,11101,3700,7401,3700,0,1,3702,30097964,30.097964
6900,6100,3700,42090000,2,29606,7403,1,721520000,721520000,11101,3700,7401,3700,0,1,3702,29044364,29.044364
6900,6100,3700,42090000,2,29606,7403,1,721520000,721520000,11101,3700,7401,3700,0,1,3702,29658042,29.658042
6900,6100,3700,42090000,2,29606,7403,1,721520000,721520000,11101,3700,7401,3700,0,1,3702,29201860,29.20186
6900,6100,3700,42090000,2,29606,7403,1,721520000,721520000,11101,3700,7401,3700,0,1,3702,29909918,29.909918
6900,6100,4100,42090000,2,32806,8203,1,763120000,763120000,12301,4100,8201,4100,0,1,4102,32532154,32.532154
6900,6100,4100,42090000,2,32806,8203,1,763120000,763120000,12301,4100,8201,4100,0,1,4102,33638555,33.638555
6900,6100,4100,42090000,2,32806,8203,1,763120000,763120000,12301,4100,8201,4100,0,1,4102,31862974,31.862974
6900,6100,4100,42090000,2,32806,8203,1,763120000,763120000,12301,4100,8201,4100,0,1,4102,33123452,33.123452
6900,6100,4100,42090000,2,32806,8203,1,763120000,763120000,12301,4100,8201,4100,0,1,4102,32131593,32.131593
6900,6100,4100,42090000,2,32806,8203,1,763120000,763120000,12301,4100,8201,4100,0,1,4102,32773258,32.773258
6900,6100,4100,42090000,2,32806,8203,1,763120000,763120000,12301,4100,8201,4100,0,1,4102,32247903,32.247903
6900,6100,4100,42090000,2,32806,8203,1,763120000,763120000,12301,4100,8201,4100,0,1,4102,33124862,33.124862
6900,6100,4500,42090000,2,36006,9003,1,804720000,804720000,13501,4500,9001,4500,0,1,4502,35646268,35.646268
6900,6100,4500,42090000,2,36006,9003,1,804720000,804720000,13501,4500,9001,4500,0,1,4502,36935382,36.935382
6900,6100,4500,42090000,2,36006,9003,1,804720000,804720000,13501,4500,9001,4500,0,1,4502,34905849,34.905849
6900,6100,4500,42090000,2,36006,9003,1,804720000,804720000,13501,4500,9001,4500,0,1,4502,36437111,36.437111
6900,6100,4500,42090000,2,36006,9003,1,804720000,804720000,13501,4500,9001,4500,0,1,4502,35374706,35.374706
6900,6100,4500,42090000,2,36006,9003,1,804720000,804720000,13501,4500,9001,4500,0,1,4502,35941245,35.941245
6900,6100,4500,42090000,2,36006,9003,1,804720000,804720000,13501,4500,9001,4500,0,1,4502,35441088,35.441088
6900,6100,4500,42090000,2,36006,9003,1,804720000,804720000,13501,4500,9001,4500,0,1,4502,36245179,36.245179
6900,6100,4900,42090000,2,39206,9803,1,846320000,846320000,14701,4900,9801,4900,0,1,4902,38817482,38.817482
6900,6100,4900,42090000,2,39206,9803,1,846320000,846320000,14701,4900,9801,4900,0,1,4902,40174005,40.174005
6900,6100,4900,42090000,2,39206,9803,1,846320000,846320000,14701,4900,9801,4900,0,1,4902,38061954,38.061954
6900,6100,4900,42090000,2,39206,9803,1,846320000,846320000,14701,4900,9801,4900,0,1,4902,39693397,39.693397
6900,6100,4900,42090000,2,39206,9803,1,846320000,846320000,14701,4900,9801,4900,0,1,4902,38391053,38.391053
6900,6100,4900,42090000,2,39206,9803,1,846320000,846320000,14701,4900,9801,4900,0,1,4902,39079061,39.079061
6900,6100,4900,42090000,2,39206,9803,1,846320000,846320000,14701,4900,9801,4900,0,1,4902,38518276,38.518276
6900,6100,4900,42090000,2,39206,9803,1,846320000,846320000,14701,4900,9801,4900,0,1,4902,39514410,39.51441
6900,6100,5300,42090000,2,42406,10603,1,887920000,887920000,15901,5300,10601,5300,0,1,5302,41921395,41.921395
6900,6100,5300,42090000,2,42406,10603,1,887920000,887920000,15901,5300,10601,5300,0,1,5302,43452762,43.452762
6900,6100,5300,42090000,2,42406,10603,1,887920000,887920000,15901,5300,10601,5300,0,1,5302,41173182,41.173182
6900,6100,5300,42090000,2,42406,10603,1,887920000,887920000,15901,5300,10601,5300,0,1,5302,43061227,43.061227
6900,6100,5300,42090000,2,42406,10603,1,887920000,887920000,15901,5300,10601,5300,0,1,5302,41476679,41.476679
6900,6100,5300,42090000,2,42406,10603,1,887920000,887920000,15901,5300,10601,5300,0,1,5302,42339609,42.339609
6900,6100,5300,42090000,2,42406,10603,1,887920000,887920000,15901,5300,10601,5300,0,1,5302,41668277,41.668277
6900,6100,5300,42090000,2,42406,10603,1,887920000,887920000,15901,5300,10601,5300,0,1,5302,42694432,42.694432
6900,6100,5700,42090000,2,45606,11403,1,929520000,929520000,17101,5700,11401,5700,0,1,5702,45086222,45.086222
6900,6100,5700,42090000,2,45606,11403,1,929520000,929520000,17101,5700,11401,5700,0,1,5702,46774559,46.774559
6900,6100,5700,42090000,2,45606,11403,1,929520000,929520000,17101,5700,11401,5700,0,1,5702,44230964,44.230964
6900,6100,5700,42090000,2,45606,11403,1,929520000,929520000,17101,5700,11401,5700,0,1,5702,46129729,46.129729
6900,6100,5700,42090000,2,45606,11403,1,929520000,929520000,17101,5700,11401,5700,0,1,5702,44624754,44.624754
6900,6100,5700,42090000,2,45606,11403,1,929520000,929520000,17101,5700,11401,5700,0,1,5702,45473885,45.473885
6900,6100,5700,42090000,2,45606,11403,1,929520000,929520000,17101,5700,11401,5700,0,1,5702,44809778,44.809778
6900,6100,5700,42090000,2,45606,11403,1,929520000,929520000,17101,5700,11401,5700,0,1,5702,45979505,45.979505
6900,6100,6100,42090000,2,48806,12203,1,971120000,971120000,18301,6100,12201,6100,0,1,6102,48304207,48.304207
6900,6100,6100,42090000,2,48806,12203,1,971120000,971120000,18301,6100,12201,6100,0,1,6102,49974089,49.974089
6900,6100,6100,42090000,2,48806,12203,1,971120000,971120000,18301,6100,12201,6100,0,1,6102,47339431,47.339431
6900,6100,6100,42090000,2,48806,12203,1,971120000,971120000,18301,6100,12201,6100,0,1,6102,49469573,49.469573
6900,6100,6100,42090000,2,48806,12203,1,971120000,971120000,18301,6100,12201,6100,0,1,6102,47808192,47.808192
6900,6100,6100,42090000,2,48806,12203,1,971120000,971120000,18301,6100,12201,6100,0,1,6102,48718001,48.718001
6900,6100,6100,42090000,2,48806,12203,1,971120000,971120000,18301,6100,12201,6100,0,1,6102,48032906,48.032906
6900,6100,6100,42090000,2,48806,12203,1,971120000,971120000,18301,6100,12201,6100,0,1,6102,49222560,49.22256
6900,6100,6500,42090000,2,52006,13003,1,1012720000,1012720000,19501,6500,13001,6500,0,1,6502,51397086,51.397086
6900,6100,6500,42090000,2,52006,13003,1,1012720000,1012720000,19501,6500,13001,6500,0,1,6502,53249993,53.249993
6900,6100,6500,42090000,2,52006,13003,1,1012720000,1012720000,19501,6500,13001,6500,0,1,6502,50440857,50.440857
6900,6100,6500,42090000,2,52006,13003,1,1012720000,1012720000,19501,6500,13001,6500,0,1,6502,52748264,52.748264
6900,6100,6500,42090000,2,52006,13003,1,1012720000,1012720000,19501,6500,13001,6500,0,1,6502,50963300,50.9633
6900,6100,6500,42090000,2,52006,13003,1,1012720000,1012720000,19501,6500,13001,6500,0,1,6502,51873312,51.873312
6900,6100,6500,42090000,2,52006,13003,1,1012720000,1012720000,19501,6500,13001,6500,0,1,6502,51122853,51.122853
6900,6100,6500,42090000,2,52006,13003,1,1012720000,1012720000,19501,6500,13001,6500,0,1,6502,52419081,52.419081
6900,6100,6900,42090000,2,55206,13803,1,1054320000,1054320000,20701,6900,13801,6900,0,1,6902,54519142,54.519142
6900,6100,6900,42090000,2,55206,13803,1,1054320000,1054320000,20701,6900,13801,6900,0,1,6902,56499548,56.499548
6900,6100,6900,42090000,2,55206,13803,1,1054320000,1054320000,20701,6900,13801,6900,0,1,6902,53551675,53.551675
6900,6100,6900,42090000,2,55206,13803,1,1054320000,1054320000,20701,6900,13801,6900,0,1,6902,56021587,56.021587
6900,6100,6900,42090000,2,55206,13803,1,1054320000,1054320000,20701,6900,13801,6900,0,1,6902,53996965,53.996965
6900,6100,6900,42090000,2,55206,13803,1,1054320000,1054320000,20701,6900,13801,6900,0,1,6902,55101635,55.101635
6900,6100,6900,42090000,2,55206,13803,1,1054320000,1054320000,20701,6900,13801,6900,0,1,6902,54270639,54.270639
6900,6100,6900,42090000,2,55206,13803,1,1054320000,1054320000,20701,6900,13801,6900,0,1,6902,55615922,55.615922
6900,5700,500,39330000,2,4006,1003,1,365040000,365040000,1501,500,1001,500,0,1,502,4222040,4.22204
6900,5700,500,39330000,2,4006,1003,1,365040000,365040000,1501,500,1001,500,0,1,502,4251431,4.251431
6900,5700,500,39330000,2,4006,1003,1,365040000,365040000,1501,500,1001,500,0,1,502,4166867,4.166867
6900,5700,500,39330000,2,4006,1003,1,365040000,365040000,1501,500,1001,500,0,1,502,4251995,4.251995
6900,5700,500,39330000,2,4006,1003,1,365040000,365040000,1501,500,1001,500,0,1,502,4137920,4.13792
6900,5700,500,39330000,2,4006,1003,1,365040000,365040000,1501,500,1001,500,0,1,502,4167237,4.167237
6900,5700,500,39330000,2,4006,1003,1,365040000,365040000,1501,500,1001,500,0,1,502,4195561,4.195561
6900,5700,500,39330000,2,4006,1003,1,365040000,365040000,1501,500,1001,500,0,1,502,4194375,4.194375
6900,5700,900,39330000,2,7206,1803,1,405360000,405360000,2701,900,1801,900,0,1,902,6913646,6.913646
6900,5700,900,39330000,2,7206,1803,1,405360000,405360000,2701,900,1801,900,0,1,902,7133480,7.13348
6900,5700,900,39330000,2,7206,1803,1,405360000,405360000,2701,900,1801,900,0,1,902,6797720,6.79772
6900,5700,900,39330000,2,7206,1803,1,405360000,405360000,2701,900,1801,900,0,1,902,7085645,7.085645
6900,5700,900,39330000,2,7206,1803,1,405360000,405360000,2701,900,1801,900,0,1,902,6886718,6.886718
6900,5700,900,39330000,2,7206,1803,1,405360000,405360000,2701,900,1801,900,0,1,902,6968786,6.968786
6900,5700,900,39330000,2,7206,1803,1,405360000,405360000,2701,900,1801,900,0,1,902,6859825,6.859825
6900,5700,900,39330000,2,7206,1803,1,405360000,405360000,2701,900,1801,900,0,1,902,7030243,7.030243
6900,5700,1300,39330000,2,10406,2603,1,445680000,445680000,3901,1300,2601,1300,0,1,1302,9798575,9.798575
6900,5700,1300,39330000,2,10406,2603,1,445680000,445680000,3901,1300,2601,1300,0,1,1302,10138228,10.138228
6900,5700,1300,39330000,2,10406,2603,1,445680000,445680000,3901,1300,2601,1300,0,1,1302,9615145,9.615145
6900,5700,1300,39330000,2,10406,2603,1,445680000,445680000,3901,1300,2601,1300,0,1,1302,10018490,10.01849
6900,5700,1300,39330000,2,10406,2603,1,445680000,445680000,3901,1300,2601,1300,0,1,1302,9754118,9.754118
6900,5700,1300,39330000,2,10406,2603,1,445680000,445680000,3901,1300,2601,1300,0,1,1302,9909329,9.909329
6900,5700,1300,39330000,2,10406,2603,1,445680000,445680000,3901,1300,2601,1300,0,1,1302,9727165,9.727165
6900,5700,1300,39330000,2,10406,2603,1,445680000,445680000,3901,1300,2601,1300,0,1,1302,9991868,9.991868
6900,5700,1700,39330000,2,13606,3403,1,486000000,486000000,5101,1700,3401,1700,0,1,1702,12875563,12.875563
6900,5700,1700,39330000,2,13606,3403,1,486000000,486000000,5101,1700,3401,1700,0,1,1702,13282675,13.282675
6900,5700,1700,39330000,2,13606,3403,1,486000000,486000000,5101,1700,3401,1700,0,1,1702,12621391,12.621391
6900,5700,1700,39330000,2,13606,3403,1,486000000,486000000,5101,1700,3401,1700,0,1,1702,13077793,13.077793
6900,5700,1700,39330000,2,13606,3403,1,486000000,486000000,5101,1700,3401,1700,0,1,1702,12790581,12.790581
6900,5700,1700,39330000,2,13606,3403,1,486000000,486000000,5101,1700,3401,1700,0,1,1702,12934212,12.934212
6900,5700,1700,39330000,2,13606,3403,1,486000000,486000000,5101,1700,3401,1700,0,1,1702,12707142,12.707142
6900,5700,1700,39330000,2,13606,3403,1,486000000,486000000,5101,1700,3401,1700,0,1,1702,13035349,13.035349
6900,5700,2100,39330000,2,16806,4203,1,526320000,526320000,6301,2100,4201,2100,0,1,2102,15762766,15.762766
6900,5700,2100,39330000,2,16806,4203,1,526320000,526320000,6301,2100,4201,2100,0,1,2102,16273769,16.273769
6900,5700,2100,39330000,2,16806,4203,1,526320000,526320000,6301,2100,4201,2100,0,1,2102,15465097,15.465097
6900,5700,2100,39330000,2,16806,4203,1,526320000,526320000,6301,2100,4201,2100,0,1,2102,16062913,16.062913
6900,5700,2100,39330000,2,16806,4203,1,526320000,526320000,6301,2100,4201,2100,0,1,2102,15640540,15.64054
6900,5700,2100,39330000,2,16806,4203,1,526320000,526320000,6301,2100,4201,2100,0,1,2102,15886343,15.886343
6900,5700,2100,39330000,2,16806,4203,1,526320000,526320000,6301,2100,4201,2100,0,1,2102,15612622,15.612622
6900,5700,2100,39330000,2,16806,4203,1,526320000,526320000,6301,2100,4201,2100,0,1,2102,16035571,16.035571
6900,5700,2500,39330000,2,20006,5003,1,566640000,566640000,7501,2500,5001,2500,0,1,2502,18685177,18.685177
6900,5700,2500,39330000,2,20006,5003,1,566640000,566640000,7501,2500,5001,2500,0,1,2502,19296125,19.296125
6900,5700,2500,39330000,2,20006,5003,1,566640000,566640000,7501,2500,5001,2500,0,1,2502,18300799,18.300799
6900,5700,2500,39330000,2,20006,5003,1,566640000,566640000,7501,2500,5001,2500,0,1,2502,19067320,19.06732
6900,5700,2500,39330000,2,20006,5003,1,566640000,566640000,7501,2500,5001,2500,0,1,2502,18499299,18.499299
6900,5700,2500,39330000,2,20006,5003,1,566640000,566640000,7501,2500,5001,2500,0,1,2502,18840227,18.840227
6900,5700,2500,39330000,2,20006,5003,1,566640000,566640000,7501,2500,5001,2500,0,1,2502,18472622,18.472622
6900,5700,2500,39330000,2,20006,5003,1,566640000,566640000,7501,2500,5001,2500,0,1,2502,19007620,19.00762
6900,5700,2900,39330000,2,23206,5803,1,606960000,606960000,8701,2900,5801,2900,0,1,2902,21592921,21.592921
6900,5700,2900,39330000,2,23206,5803,1,606960000,606960000,8701,2900,5801,2900,0,1,2902,22321528,22.321528
6900,5700,2900,39330000,2,23206,5803,1,606960000,606960000,8701,2900,5801,2900,0,1,2902,21182352,21.182352
6900,5700,2900,39330000,2,23206,5803,1,606960000,606960000,8701,2900,5801,2900,0,1,2902,22112354,22.112354
6900,5700,2900,39330000,2,23206,5803,1,606960000,606960000,8701,2900,5801,2900,0,1,2902,21415231,21.415231
6900,5700,2900,39330000,2,23206,5803,1,606960000,606960000,8701,2900,5801,2900,0,1,2902,21801867,21.801867
6900,5700,2900,39330000,2,23206,5803,1,606960000,606960000,8701,2900,5801,2900,0,1,2902,21442212,21.442212
6900,5700,2900,39330000,2,23206,5803,1,606960000,606960000,8701,2900,5801,2900,0,1,2902,21983778,21.983778
6900,5700,3300,39330000,2,26406,6603,1,647280000,647280000,9901,3300,6601,3300,0,1,3302,24554238,24.554238
6900,5700,3300,39330000,2,26406,6603,1,647280000,647280000,9901,3300,6601,3300,0,1,3302,25378574,25.378574
6900,5700,3300,39330000,2,26406,6603,1,647280000,647280000,9901,3300,6601,3300,0,1,3302,24075348,24.075348
6900,5700,3300,39330000,2,26406,6603,1,647280000,647280000,9901,3300,6601,3300,0,1,3302,25030825,25.030825
6900,5700,3300,39330000,2,26406,6603,1,647280000,647280000,9901,3300,6601,3300,0,1,3302,24310143,24.310143
6900,5700,3300,39330000,2,26406,6603,1,647280000,647280000,9901,3300,6601,3300,0,1,3302,24738690,24.73869
6900,5700,3300,39330000,2,26406,6603,1,647280000,647280000,9901,3300,6601,3300,0,1,3302,24271092,24.271092
6900,5700,3300,39330000,2,26406,6603,1,647280000,647280000,9901,3300,6601,3300,0,1,3302,24988778,24.988778
6900,5700,3700,39330000,2,29606,7403,1,687600000,687600000,11101,3700,7401,3700,0,1,3702,27424730,27.42473
6900,5700,3700,39330000,2,29606,7403,1,687600000,687600000,11101,3700,7401,3700,0,1,3702,28393059,28.393059
6900,5700,3700,39330000,2,29606,7403,1,687600000,687600000,11101,3700,7401,3700,0,1,3702,26931745,26.931745
6900,5700,3700,39330000,2,29606,7403,1,687600000,687600000,11101,3700,7401,3700,0,1,3702,28042087,28.042087
6900,5700,3700,39330000,2,29606,7403,1,687600000,687600000,11101,3700,7401,3700,0,1,3702,27161215,27.161215
6900,5700,3700,39330000,2,29606,7403,1,687600000,687600000,11101,3700,7401,3700,0,1,3702,27700377,27.700377
6900,5700,3700,39330000,2,29606,7403,1,687600000,687600000,11101,3700,7401,3700,0,1,3702,27226452,27.226452
6900,5700,3700,39330000,2,29606,7403,1,687600000,687600000,11101,3700,7401,3700,0,1,3702,27951488,27.951488
6900,5700,4100,39330000,2,32806,8203,1,727920000,727920000,12301,4100,8201,4100,0,1,4102,30385982,30.385982
6900,5700,4100,39330000,2,32806,8203,1,727920000,727920000,12301,4100,8201,4100,0,1,4102,31440965,31.440965
6900,5700,4100,39330000,2,32806,8203,1,727920000,727920000,12301,4100,8201,4100,0,1,4102,29807592,29.807592
6900,5700,4100,39330000,2,32806,8203,1,727920000,727920000,12301,4100,8201,4100,0,1,4102,30955827,30.955827
6900,5700,4100,39330000,2,32806,8203,1,727920000,727920000,12301,4100,8201,4100,0,1,4102,30068365,30.068365
6900,5700,4100,39330000,2,32806,8203,1,727920000,727920000,12301,4100,8201,4100,0,1,4102,30596489,30.596489
6900,5700,4100,39330000,2,32806,8203,1,727920000,727920000,12301,4100,8201,4100,0,1,4102,30110411,30.110411
6900,5700,4100,39330000,2,32806,8203,1,727920000,727920000,12301,4100,8201,4100,0,1,4102,30913890,30.91389
6900,5700,4500,39330000,2,36006,9003,1,768240000,768240000,13501,4500,9001,4500,0,1,4502,33311748,33.311748
6900,5700,4500,39330000,2,36006,9003,1,768240000,768240000,13501,4500,9001,4500,0,1,4502,34513654,34.513654
6900,5700,4500,39330000,2,36006,9003,1,768240000,768240000,13501,4500,9001,4500,0,1,4502,32715709,32.715709
6900,5700,4500,39330000,2,36006,9003,1,768240000,768240000,13501,4500,9001,4500,0,1,4502,34078833,34.078833
6900,5700,4500,39330000,2,36006,9003,1,768240000,768240000,13501,4500,9001,4500,0,1,4502,32923963,32.923963
6900,5700,4500,39330000,2,36006,9003,1,768240000,768240000,13501,4500,9001,4500,0,1,4502,33676285,33.676285
6900,5700,4500,39330000,2,36006,9003,1,768240000,768240000,13501,4500,9001,4500,0,1,4502,33057179,33.057179
6900,5700,4500,39330000,2,36006,9003,1,768240000,768240000,13501,4500,9001,4500,0,1,4502,33887033,33.887033
6900,5700,4900,39330000,2,39206,9803,1,808560000,808560000,14701,4900,9801,4900,0,1,4902,36210006,36.210006
6900,5700,4900,39330000,2,39206,9803,1,808560000,808560000,14701,4900,9801,4900,0,1,4902,37635032,37.635032
6900,5700,4900,39330000,2,39206,9803,1,808560000,808560000,14701,4900,9801,4900,0,1,4902,35574963,35.574963
6900,5700,4900,39330000,2,39206,9803,1,808560000,808560000,14701,4900,9801,4900,0,1,4902,37025714,37.025714
6900,5700,4900,39330000,2,39206,9803,1,808560000,808560000,14701,4900,9801,4900,0,1,4902,35882254,35.882254
6900,5700,4900,39330000,2,39206,9803,1,808560000,808560000,14701,4900,9801,4900,0,1,4902,36573894,36.573894
6900,5700,4900,39330000,2,39206,9803,1,808560000,808560000,14701,4900,9801,4900,0,1,4902,36012174,36.012174
6900,5700,4900,39330000,2,39206,9803,1,808560000,808560000,14701,4900,9801,4900,0,1,4902,36961605,36.961605
6900,5700,5300,39330000,2,42406,10603,1,848880000,848880000,15901,5300,10601,5300,0,1,5302,39225967,39.225967
6900,5700,5300,39330000,2,42406,10603,1,848880000,848880000,15901,5300,10601,5300,0,1,5302,40737682,40.737682
6900,5700,5300,39330000,2,42406,10603,1,848880000,848880000,15901,5300,10601,5300,0,1,5302,38447490,38.44749
6900,5700,5300,39330000,2,42406,10603,1,848880000,848880000,15901,5300,10601,5300,0,1,5302,40113714,40.113714
6900,5700,5300,39330000,2,42406,10603,1,848880000,848880000,15901,5300,10601,5300,0,1,5302,38753124,38.753124
6900,5700,5300,39330000,2,42406,10603,1,848880000,848880000,15901,5300,10601,5300,0,1,5302,39563449,39.563449
6900,5700,5300,39330000,2,42406,10603,1,848880000,848880000,15901,5300,10601,5300,0,1,5302,38882338,38.882338
6900,5700,5300,39330000,2,42406,10603,1,848880000,848880000,15901,5300,10601,5300,0,1,5302,39955815,39.955815
6900,5700,5700,39330000,2,45606,11403,1,889200000,889200000,17101,5700,11401,5700,0,1,5702,42116675,42.116675
6900,5700,5700,39330000,2,45606,11403,1,889200000,889200000,17101,5700,11401,5700,0,1,5702,43669803,43.669803
6900,5700,5700,39330000,2,45606,11403,1,889200000,889200000,17101,5700,11401,5700,0,1,5702,41314106,41.314106
6900,5700,5700,39330000,2,45606,11403,1,889200000,889200000,17101,5700,11401,5700,0,1,5702,43230152,43.230152
6900,5700,5700,39330000,2,45606,11403,1,889200000,889200000,17101,5700,11401,5700,0,1,5702,41701243,41.701243
6900,5700,5700,39330000,2,45606,11403,1,889200000,889200000,17101,5700,11401,5700,0,1,5702,42590060,42.59006
6900,5700,5700,39330000,2,45606,11403,1,889200000,889200000,17101,5700,11401,5700,0,1,5702,41750737,41.750737
6900,5700,5700,39330000,2,45606,11403,1,889200000,889200000,17101,5700,11401,5700,0,1,5702,42957756,42.957756
6900,5700,6100,39330000,2,48806,12203,1,929520000,929520000,18301,6100,12201,6100,0,1,6102,45260424,45.260424
6900,5700,6100,39330000,2,48806,12203,1,929520000,929520000,18301,6100,12201,6100,0,1,6102,46786748,46.786748
6900,5700,6100,39330000,2,48806,12203,1,929520000,929520000,18301,6100,12201,6100,0,1,6102,44368677,44.368677
6900,5700,6100,39330000,2,48806,12203,1,929520000,929520000,18301,6100,12201,6100,0,1,6102,46396471,46.396471
6900,5700,6100,39330000,2,48806,12203,1,929520000,929520000,18301,6100,12201,6100,0,1,6102,44748367,44.748367
6900,5700,6100,39330000,2,48806,12203,1,929520000,929520000,18301,6100,12201,6100,0,1,6102,45671581,45.671581
6900,5700,6100,39330000,2,48806,12203,1,929520000,929520000,18301,6100,12201,6100,0,1,6102,44885807,44.885807
6900,5700,6100,39330000,2,48806,12203,1,929520000,929520000,18301,6100,12201,6100,0,1,6102,46030031,46.030031
6900,5700,6500,39330000,2,52006,13003,1,969840000,969840000,19501,6500,13001,6500,0,1,6502,48109792,48.109792
6900,5700,6500,39330000,2,52006,13003,1,969840000,969840000,19501,6500,13001,6500,0,1,6502,49892626,49.892626
6900,5700,6500,39330000,2,52006,13003,1,969840000,969840000,19501,6500,13001,6500,0,1,6502,47114902,47.114902
6900,5700,6500,39330000,2,52006,13003,1,969840000,969840000,19501,6500,13001,6500,0,1,6502,49155364,49.155364
6900,5700,6500,39330000,2,52006,13003,1,969840000,969840000,19501,6500,13001,6500,0,1,6502,47658717,47.658717
6900,5700,6500,39330000,2,52006,13003,1,969840000,969840000,19501,6500,13001,6500,0,1,6502,48628821,48.628821
6900,5700,6500,39330000,2,52006,13003,1,969840000,969840000,19501,6500,13001,6500,0,1,6502,47805217,47.805217
6900,5700,6500,39330000,2,52006,13003,1,969840000,969840000,19501,6500,13001,6500,0,1,6502,48996291,48.996291
6900,5700,6900,39330000,2,55206,13803,1,1010160000,1010160000,20701,6900,13801,6900,0,1,6902,51091500,51.0915
6900,5700,6900,39330000,2,55206,13803,1,1010160000,1010160000,20701,6900,13801,6900,0,1,6902,52938064,52.938064
6900,5700,6900,39330000,2,55206,13803,1,1010160000,1010160000,20701,6900,13801,6900,0,1,6902,49985219,49.985219
6900,5700,6900,39330000,2,55206,13803,1,1010160000,1010160000,20701,6900,13801,6900,0,1,6902,52220505,52.220505
6900,5700,6900,39330000,2,55206,13803,1,1010160000,1010160000,20701,6900,13801,6900,0,1,6902,50623680,50.62368
6900,5700,6900,39330000,2,55206,13803,1,1010160000,1010160000,20701,6900,13801,6900,0,1,6902,51602193,51.602193
6900,5700,6900,39330000,2,55206,13803,1,1010160000,1010160000,20701,6900,13801,6900,0,1,6902,50713181,50.713181
6900,5700,6900,39330000,2,55206,13803,1,1010160000,1010160000,20701,6900,13801,6900,0,1,6902,52044623,52.044623
6900,5300,500,36570000,2,4006,1003,1,341360000,341360000,1501,500,1001,500,0,1,502,3941441,3.941441
6900,5300,500,36570000,2,4006,1003,1,341360000,341360000,1501,500,1001,500,0,1,502,3969936,3.969936
6900,5300,500,36570000,2,4006,1003,1,341360000,341360000,1501,500,1001,500,0,1,502,3827859,3.827859
6900,5300,500,36570000,2,4006,1003,1,341360000,341360000,1501,500,1001,500,0,1,502,3942925,3.942925
6900,5300,500,36570000,2,4006,1003,1,341360000,341360000,1501,500,1001,500,0,1,502,3888890,3.88889
6900,5300,500,36570000,2,4006,1003,1,341360000,341360000,1501,500,1001,500,0,1,502,3915855,3.915855
6900,5300,500,36570000,2,4006,1003,1,341360000,341360000,1501,500,1001,500,0,1,502,3889626,3.889626
6900,5300,500,36570000,2,4006,1003,1,341360000,341360000,1501,500,1001,500,0,1,502,3856046,3.856046
6900,5300,900,36570000,2,7206,1803,1,380400000,380400000,2701,900,1801,900,0,1,902,6439705,6.439705
6900,5300,900,36570000,2,7206,1803,1,380400000,380400000,2701,900,1801,900,0,1,902,6665930,6.66593
6900,5300,900,36570000,2,7206,1803,1,380400000,380400000,2701,900,1801,900,0,1,902,6314826,6.314826
6900,5300,900,36570000,2,7206,1803,1,380400000,380400000,2701,900,1801,900,0,1,902,6599489,6.599489
6900,5300,900,36570000,2,7206,1803,1,380400000,380400000,2701,900,1801,900,0,1,902,6404367,6.404367
6900,5300,900,36570000,2,7206,1803,1,380400000,380400000,2701,900,1801,900,0,1,902,6481647,6.481647
6900,5300,900,36570000,2,7206,1803,1,380400000,380400000,2701,900,1801,900,0,1,902,6375960,6.37596
6900,5300,900,36570000,2,7206,1803,1,380400000,380400000,2701,900,1801,900,0,1,902,6573278,6.573278
6900,5300,1300,36570000,2,10406,2603,1,419440000,419440000,3901,1300,2601,1300,0,1,1302,9154384,9.154384
6900,5300,1300,36570000,2,10406,2603,1,419440000,419440000,3901,1300,2601,1300,0,1,1302,9466154,9.466154
6900,5300,1300,36570000,2,10406,2603,1,419440000,419440000,3901,1300,2601,1300,0,1,1302,8949819,8.949819
6900,5300,1300,36570000,2,10406,2603,1,419440000,419440000,3901,1300,2601,1300,0,1,1302,9350218,9.350218
6900,5300,1300,36570000,2,10406,2603,1,419440000,419440000,3901,1300,2601,1300,0,1,1302,9094292,9.094292
6900,5300,1300,36570000,2,10406,2603,1,419440000,419440000,3901,1300,2601,1300,0,1,1302,9212703,9.212703
6900,5300,1300,36570000,2,10406,2603,1,419440000,419440000,3901,1300,2601,1300,0,1,1302,9038887,9.038887
6900,5300,1300,36570000,2,10406,2603,1,419440000,419440000,3901,1300,2601,1300,0,1,1302,9324234,9.324234
6900,5300,1700,36570000,2,13606,3403,1,458480000,458480000,5101,1700,3401,1700,0,1,1702,12056297,12.056297
6900,5300,1700,36570000,2,13606,3403,1,458480000,458480000,5101,1700,3401,1700,0,1,1702,12385949,12.385949
6900,5300,1700,36570000,2,13606,3403,1,458480000,458480000,5101,1700,3401,1700,0,1,1702,11771190,11.77119
6900,5300,1700,36570000,2,13606,3403,1,458480000,458480000,5101,1700,3401,1700,0,1,1702,12277557,12.277557
6900,5300,1700,36570000,2,13606,3403,1,458480000,458480000,5101,1700,3401,1700,0,1,1702,11899413,11.899413
6900,5300,1700,36570000,2,13606,3403,1,458480000,458480000,5101,1700,3401,1700,0,1,1702,12142484,12.142484
6900,5300,1700,36570000,2,13606,3403,1,458480000,458480000,5101,1700,3401,1700,0,1,1702,11868062,11.868062
6900,5300,1700,36570000,2,13606,3403,1,458480000,458480000,5101,1700,3401,1700,0,1,1702,12191775,12.191775
6900,5300,2100,36570000,2,16806,4203,1,497520000,497520000,6301,2100,4201,2100,0,1,2102,14716495,14.716495
6900,5300,2100,36570000,2,16806,4203,1,497520000,497520000,6301,2100,4201,2100,0,1,2102,15191761,15.191761
6900,5300,2100,36570000,2,16806,4203,1,497520000,497520000,6301,2100,4201,2100,0,1,2102,14391464,14.391464
6900,5300,2100,36570000,2,16806,4203,1,497520000,497520000,6301,2100,4201,2100,0,1,2102,14933950,14.93395
6900,5300,2100,36570000,2,16806,4203,1,497520000,497520000,6301,2100,4201,2100,0,1,2102,14610604,14.610604
6900,5300,2100,36570000,2,16806,4203,1,497520000,497520000,6301,2100,4201,2100,0,1,2102,14853067,14.853067
6900,5300,2100,36570000,2,16806,4203,1,497520000,497520000,6301,2100,4201,2100,0,1,2102,14533620,14.53362
6900,5300,2100,36570000,2,16806,4203,1,497520000,497520000,6301,2100,4201,2100,0,1,2102,14984981,14.984981
6900,5300,2500,36570000,2,20006,5003,1,536560000,536560000,7501,2500,5001,2500,0,1,2502,17450738,17.450738
6900,5300,2500,36570000,2,20006,5003,1,536560000,536560000,7501,2500,5001,2500,0,1,2502,17984853,17.984853
6900,5300,2500,36570000,2,20006,5003,1,536560000,536560000,7501,2500,5001,2500,0,1,2502,17047220,17.04722
6900,5300,2500,36570000,2,20006,5003,1,536560000,536560000,7501,2500,5001,2500,0,1,2502,17705769,17.705769
6900,5300,2500,36570000,2,20006,5003,1,536560000,536560000,7501,2500,5001,2500,0,1,2502,17286615,17.286615
6900,5300,2500,36570000,2,20006,5003,1,536560000,536560000,7501,2500,5001,2500,0,1,2502,17534654,17.534654
6900,5300,2500,36570000,2,20006,5003,1,536560000,536560000,7501,2500,5001,2500,0,1,2502,17195928,17.195928
6900,5300,2500,36570000,2,20006,5003,1,536560000,536560000,7501,2500,5001,2500,0,1,2502,17739335,17.739335
6900,5300,2900,36570000,2,23206,5803,1,575600000,575600000,8701,2900,5801,2900,0,1,2902,20170035,20.170035
6900,5300,2900,36570000,2,23206,5803,1,575600000,575600000,8701,2900,5801,2900,0,1,2902,20804712,20.804712
6900,5300,2900,36570000,2,23206,5803,1,575600000,575600000,8701,2900,5801,2900,0,1,2902,19714832,19.714832
6900,5300,2900,36570000,2,23206,5803,1,575600000,575600000,8701,2900,5801,2900,0,1,2902,20548591,20.548591
6900,5300,2900,36570000,2,23206,5803,1,575600000,575600000,8701,2900,5801,2900,0,1,2902,19962797,19.962797
6900,5300,2900,36570000,2,23206,5803,1,575600000,575600000,8701,2900,5801,2900,0,1,2902,20307231,20.307231
6900,5300,2900,36570000,2,23206,5803,1,575600000,575600000,8701,2900,5801,2900,0,1,2902,19927349,19.927349
6900,5300,2900,36570000,2,23206,5803,1,575600000,575600000,8701,2900,5801,2900,0,1,2902,20450533,20.450533
6900,5300,3300,36570000,2,26406,6603,1,614640000,614640000,9901,3300,6601,3300,0,1,3302,22906476,22.906476
6900,5300,3300,36570000,2,26406,6603,1,614640000,614640000,9901,3300,6601,3300,0,1,3302,23619156,23.619156
6900,5300,3300,36570000,2,26406,6603,1,614640000,614640000,9901,3300,6601,3300,0,1,3302,22398693,22.398693
6900,5300,3300,36570000,2,26406,6603,1,614640000,614640000,9901,3300,6601,3300,0,1,3302,23339709,23.339709
6900,5300,3300,36570000,2,26406,6603,1,614640000,614640000,9901,3300,6601,3300,0,1,3302,22666807,22.666807
6900,5300,3300,36570000,2,26406,6603,1,614640000,614640000,9901,3300,6601,3300,0,1,3302,23057492,23.057492
6900,5300,3300,36570000,2,26406,6603,1,614640000,614640000,9901,3300,6601,3300,0,1,3302,22590916,22.590916
6900,5300,3300,36570000,2,26406,6603,1,614640000,614640000,9901,3300,6601,3300,0,1,3302,23248552,23.248552
6900,5300,3700,36570000,2,29606,7403,1,653680000,653680000,11101,3700,7401,3700,0,1,3702,25576447,25.576447
6900,5300,3700,36570000,2,29606,7403,1,653680000,653680000,11101,3700,7401,3700,0,1,3702,26486394,26.486394
6900,5300,3700,36570000,2,29606,7403,1,653680000,653680000,11101,3700,7401,3700,0,1,3702,24992748,24.992748
6900,5300,3700,36570000,2,29606,7403,1,653680000,653680000,11101,3700,7401,3700,0,1,3702,26163314,26.163314
6900,5300,3700,36570000,2,29606,7403,1,653680000,653680000,11101,3700,7401,3700,0,1,3702,25293680,25.29368
6900,5300,3700,36570000,2,29606,7403,1,653680000,653680000,11101,3700,7401,3700,0,1,3702,25821141,25.821141
6900,5300,3700,36570000,2,29606,7403,1,653680000,653680000,11101,3700,7401,3700,0,1,3702,25332464,25.332464
6900,5300,3700,36570000,2,29606,7403,1,653680000,653680000,11101,3700,7401,3700,0,1,3702,26058261,26.058261
6900,5300,4100,36570000,2,32806,8203,1,692720000,692720000,12301,4100,8201,4100,0,1,4102,28245632,28.245632
6900,5300,4100,36570000,2,32806,8203,1,692720000,692720000,12301,4100,8201,4100,0,1,4102,29291256,29.291256
6900,5300,4100,36570000,2,32806,8203,1,692720000,692720000,12301,4100,8201,4100,0,1,4102,27668734,27.668734
6900,5300,4100,36570000,2,32806,8203,1,692720000,692720000,12301,4100,8201,4100,0,1,4102,28831386,28.831386
6900,5300,4100,36570000,2,32806,8203,1,692720000,692720000,12301,4100,8201,4100,0,1,4102,28006894,28.006894
6900,5300,4100,36570000,2,32806,8203,1,692720000,692720000,12301,4100,8201,4100,0,1,4102,28446299,28.446299
6900,5300,4100,36570000,2,32806,8203,1,692720000,692720000,12301,4100,8201,4100,0,1,4102,27982098,27.982098
6900,5300,4100,36570000,2,32806,8203,1,692720000,692720000,12301,4100,8201,4100,0,1,4102,28872346,28.872346
6900,5300,4500,36570000,2,36006,9003,1,731760000,731760000,13501,4500,9001,4500,0,1,4502,30959394,30.959394
6900,5300,4500,36570000,2,36006,9003,1,731760000,731760000,13501,4500,9001,4500,0,1,4502,32142240,32.14224
6900,5300,4500,36570000,2,36006,9003,1,731760000,731760000,13501,4500,9001,4500,0,1,4502,30355132,30.355132
6900,5300,4500,36570000,2,36006,9003,1,731760000,731760000,13501,4500,9001,4500,0,1,4502,31670197,31.670197
6900,5300,4500,36570000,2,36006,9003,1,731760000,731760000,13501,4500,9001,4500,0,1,4502,30699501,30.699501
6900,5300,4500,36570000,2,36006,9003,1,731760000,731760000,13501,4500,9001,4500,0,1,4502,31228183,31.228183
6900,5300,4500,36570000,2,36006,9003,1,731760000,731760000,13501,4500,9001,4500,0,1,4502,30726092,30.726092
6900,5300,4500,36570000,2,36006,9003,1,731760000,731760000,13501,4500,9001,4500,0,1,4502,31604852,31.604852
6900,5300,4900,36570000,2,39206,9803,1,770800000,770800000,14701,4900,9801,4900,0,1,4902,33742574,33.742574
6900,5300,4900,36570000,2,39206,9803,1,770800000,770800000,14701,4900,9801,4900,0,1,4902,34937222,34.937222
6900,5300,4900,36570000,2,39206,9803,1,770800000,770800000,14701,4900,9801,4900,0,1,4902,33057546,33.057546
6900,5300,4900,36570000,2,39206,9803,1,770800000,770800000,14701,4900,9801,4900,0,1,4902,34447554,34.447554
6900,5300,4900,36570000,2,39206,9803,1,770800000,770800000,14701,4900,9801,4900,0,1,4902,33437454,33.437454
6900,5300,4900,36570000,2,39206,9803,1,770800000,770800000,14701,4900,9801,4900,0,1,4902,34044397,34.044397
6900,5300,4900,36570000,2,39206,9803,1,770800000,770800000,14701,4900,9801,4900,0,1,4902,33479557,33.479557
6900,5300,4900,36570000,2,39206,9803,1,770800000,770800000,14701,4900,9801,4900,0,1,4902,34363300,34.3633
6900,5300,5300,36570000,2,42406,10603,1,809840000,809840000,15901,5300,10601,5300,0,1,5302,36449302,36.449302
6900,5300,5300,36570000,2,42406,10603,1,809840000,809840000,15901,5300,10601,5300,0,1,5302,37849948,37.849948
6900,5300,5300,36570000,2,42406,10603,1,809840000,809840000,15901,5300,10601,5300,0,1,5302,35758183,35.758183
6900,5300,5300,36570000,2,42406,10603,1,809840000,809840000,15901,5300,10601,5300,0,1,5302,37281829,37.281829
6900,5300,5300,36570000,2,42406,10603,1,809840000,809840000,15901,5300,10601,5300,0,1,5302,36103076,36.103076
6900,5300,5300,36570000,2,42406,10603,1,809840000,809840000,15901,5300,10601,5300,0,1,5302,36770113,36.770113
6900,5300,5300,36570000,2,42406,10603,1,809840000,809840000,15901,5300,10601,5300,0,1,5302,36148158,36.148158
6900,5300,5300,36570000,2,42406,10603,1,809840000,809840000,15901,5300,10601,5300,0,1,5302,37234201,37.234201
6900,5300,5700,36570000,2,45606,11403,1,848880000,848880000,17101,5700,11401,5700,0,1,5702,39225556,39.225556
6900,5300,5700,36570000,2,45606,11403,1,848880000,848880000,17101,5700,11401,5700,0,1,5702,40701817,40.701817
6900,5300,5700,36570000,2,45606,11403,1,848880000,848880000,17101,5700,11401,5700,0,1,5702,38573276,38.573276
6900,5300,5700,36570000,2,45606,11403,1,848880000,848880000,17101,5700,11401,5700,0,1,5702,40177748,40.177748
6900,5300,5700,36570000,2,45606,11403,1,848880000,848880000,17101,5700,11401,5700,0,1,5702,38828514,38.828514
6900,5300,5700,36570000,2,45606,11403,1,848880000,848880000,17101,5700,11401,5700,0,1,5702,39579133,39.579133
6900,5300,5700,36570000,2,45606,11403,1,848880000,848880000,17101,5700,11401,5700,0,1,5702,38949374,38.949374
6900,5300,5700,36570000,2,45606,11403,1,848880000,848880000,17101,5700,11401,5700,0,1,5702,40026702,40.026702
6900,5300,6100,36570000,2,48806,12203,1,887920000,887920000,18301,6100,12201,6100,0,1,6102,41979483,41.979483
6900,5300,6100,36570000,2,48806,12203,1,887920000,887920000,18301,6100,12201,6100,0,1,6102,43441529,43.441529
6900,5300,6100,36570000,2,48806,12203,1,887920000,887920000,18301,6100,12201,6100,0,1,6102,41183550,41.18355
6900,5300,6100,36570000,2,48806,12203,1,887920000,887920000,18301,6100,12201,6100,0,1,6102,42973472,42.973472
6900,5300,6100,36570000,2,48806,12203,1,887920000,887920000,18301,6100,12201,6100,0,1,6102,41608697,41.608697
6900,5300,6100,36570000,2,48806,12203,1,887920000,887920000,18301,6100,12201,6100,0,1,6102,42308422,42.308422
6900,5300,6100,36570000,2,48806,12203,1,887920000,887920000,18301,6100,12201,6100,0,1,6102,41715595,41.715595
6900,5300,6100,36570000,2,48806,12203,1,887920000,887920000,18301,6100,12201,6100,0,1,6102,42826185,42.826185
6900,5300,6500,36570000,2,52006,13003,1,926960000,926960000,19501,6500,13001,6500,0,1,6502,44758662,44.758662
6900,5300,6500,36570000,2,52006,13003,1,926960000,926960000,19501,6500,13001,6500,0,1,6502,46327635,46.327635
6900,5300,6500,36570000,2,52006,13003,1,926960000,926960000,19501,6500,13001,6500,0,1,6502,43905975,43.905975
6900,5300,6500,36570000,2,52006,13003,1,926960000,926960000,19501,6500,13001,6500,0,1,6502,45798358,45.798358
6900,5300,6500,36570000,2,52006,13003,1,926960000,926960000,19501,6500,13001,6500,0,1,6502,44264429,44.264429
6900,5300,6500,36570000,2,52006,13003,1,926960000,926960000,19501,6500,13001,6500,0,1,6502,45142573,45.142573
6900,5300,6500,36570000,2,52006,13003,1,926960000,926960000,19501,6500,13001,6500,0,1,6502,44410704,44.410704
6900,5300,6500,36570000,2,52006,13003,1,926960000,926960000,19501,6500,13001,6500,0,1,6502,45625829,45.625829
6900,5300,6900,36570000,2,55206,13803,1,966000000,966000000,20701,6900,13801,6900,0,1,6902,47491813,47.491813
6900,5300,6900,36570000,2,55206,13803,1,966000000,966000000,20701,6900,13801,6900,0,1,6902,49134761,49.134761
6900,5300,6900,36570000,2,55206,13803,1,966000000,966000000,20701,6900,13801,6900,0,1,6902,46496559,46.496559
6900,5300,6900,36570000,2,55206,13803,1,966000000,966000000,20701,6900,13801,6900,0,1,6902,48641175,48.641175
6900,5300,6900,36570000,2,55206,13803,1,966000000,966000000,20701,6900,13801,6900,0,1,6902,46920182,46.920182
6900,5300,6900,36570000,2,55206,13803,1,966000000,966000000,20701,6900,13801,6900,0,1,6902,47929839,47.929839
6900,5300,6900,36570000,2,55206,13803,1,966000000,966000000,20701,6900,13801,6900,0,1,6902,47151969,47.151969
6900,5300,6900,36570000,2,55206,13803,1,966000000,966000000,20701,6900,13801,6900,0,1,6902,48409813,48.409813
6900,4900,500,33810000,2,4006,1003,1,317680000,317680000,1501,500,1001,500,0,1,502,3641490,3.64149
6900,4900,500,33810000,2,4006,1003,1,317680000,317680000,1501,500,1001,500,0,1,502,3666136,3.666136
6900,4900,500,33810000,2,4006,1003,1,317680000,317680000,1501,500,1001,500,0,1,502,3593995,3.593995
6900,4900,500,33810000,2,4006,1003,1,317680000,317680000,1501,500,1001,500,0,1,502,3691144,3.691144
6900,4900,500,33810000,2,4006,1003,1,317680000,317680000,1501,500,1001,500,0,1,502,3617261,3.617261
6900,4900,500,33810000,2,4006,1003,1,317680000,317680000,1501,500,1001,500,0,1,502,3640604,3.640604
6900,4900,500,33810000,2,4006,1003,1,317680000,317680000,1501,500,1001,500,0,1,502,3689748,3.689748
6900,4900,500,33810000,2,4006,1003,1,317680000,317680000,1501,500,1001,500,0,1,502,3520693,3.520693
6900,4900,900,33810000,2,7206,1803,1,355440000,355440000,2701,900,1801,900,0,1,902,5982748,5.982748
6900,4900,900,33810000,2,7206,1803,1,355440000,355440000,2701,900,1801,900,0,1,902,6149920,6.14992
6900,4900,900,33810000,2,7206,1803,1,355440000,355440000,2701,900,1801,900,0,1,902,5845750,5.84575
6900,4900,900,33810000,2,7206,1803,1,355440000,355440000,2701,900,1801,900,0,1,902,6125334,6.125334
6900,4900,900,33810000,2,7206,1803,1,355440000,355440000,2701,900,1801,900,0,1,902,5937049,5.937049
6900,4900,900,33810000,2,7206,1803,1,355440000,355440000,2701,900,1801,900,0,1,902,6016706,6.016706
6900,4900,900,33810000,2,7206,1803,1,355440000,355440000,2701,900,1801,900,0,1,902,5959417,5.959417
6900,4900,900,33810000,2,7206,1803,1,355440000,355440000,2701,900,1801,900,0,1,902,6043765,6.043765
6900,4900,1300,33810000,2,10406,2603,1,393200000,393200000,3901,1300,2601,1300,0,1,1302,8478447,8.478447
6900,4900,1300,33810000,2,10406,2603,1,393200000,393200000,3901,1300,2601,1300,0,1,1302,8726028,8.726028
6900,4900,1300,33810000,2,10406,2603,1,393200000,393200000,3901,1300,2601,1300,0,1,1302,8310609,8.310609
6900,4900,1300,33810000,2,10406,2603,1,393200000,393200000,3901,1300,2601,1300,0,1,1302,8665030,8.66503
6900,4900,1300,33810000,2,10406,2603,1,393200000,393200000,3901,1300,2601,1300,0,1,1302,8431742,8.431742
6900,4900,1300,33810000,2,10406,2603,1,393200000,393200000,3901,1300,2601,1300,0,1,1302,8553820,8.55382
6900,4900,1300,33810000,2,10406,2603,1,393200000,393200000,3901,1300,2601,1300,0,1,1302,8408842,8.408842
6900,4900,1300,33810000,2,10406,2603,1,393200000,393200000,3901,1300,2601,1300,0,1,1302,8607088,8.607088
6900,4900,1700,33810000,2,13606,3403,1,430960000,430960000,5101,1700,3401,1700,0,1,1702,11112908,11.112908
6900,4900,1700,33810000,2,13606,3403,1,430960000,430960000,5101,1700,3401,1700,0,1,1702,11383417,11.383417
6900,4900,1700,33810000,2,13606,3403,1,430960000,430960000,5101,1700,3401,1700,0,1,1702,10892780,10.89278
6900,4900,1700,33810000,2,13606,3403,1,430960000,430960000,5101,1700,3401,1700,0,1,1702,11318969,11.318969
6900,4900,1700,33810000,2,13606,3403,1,430960000,430960000,5101,1700,3401,1700,0,1,1702,11061025,11.061025
6900,4900,1700,33810000,2,13606,3403,1,430960000,430960000,5101,1700,3401,1700,0,1,1702,11196799,11.196799
6900,4900,1700,33810000,2,13606,3403,1,430960000,430960000,5101,1700,3401,1700,0,1,1702,11037711,11.037711
6900,4900,1700,33810000,2,13606,3403,1,430960000,430960000,5101,1700,3401,1700,0,1,1702,11295066,11.295066
6900,4900,2100,33810000,2,16806,4203,1,468720000,468720000,6301,2100,4201,2100,0,1,2102,13650714,13.650714
6900,4900,2100,33810000,2,16806,4203,1,468720000,468720000,6301,2100,4201,2100,0,1,2102,14022603,14.022603
6900,4900,2100,33810000,2,16806,4203,1,468720000,468720000,6301,2100,4201,2100,0,1,2102,13367266,13.367266
6900,4900,2100,33810000,2,16806,4203,1,468720000,468720000,6301,2100,4201,2100,0,1,2102,13884875,13.884875
6900,4900,2100,33810000,2,16806,4203,1,468720000,468720000,6301,2100,4201,2100,0,1,2102,13520115,13.520115
6900,4900,2100,33810000,2,16806,4203,1,468720000,468720000,6301,2100,4201,2100,0,1,2102,13728722,13.728722
6900,4900,2100,33810000,2,16806,4203,1,468720000,468720000,6301,2100,4201,2100,0,1,2102,13542999,13.542999
6900,4900,2100,33810000,2,16806,4203,1,468720000,468720000,6301,2100,4201,2100,0,1,2102,13909310,13.90931
6900,4900,2500,33810000,2,20006,5003,1,506480000,506480000,7501,2500,5001,2500,0,1,2502,16142427,16.142427
6900,4900,2500,33810000,2,20006,5003,1,506480000,506480000,7501,2500,5001,2500,0,1,2502,16667555,16.667555
6900,4900,2500,33810000,2,20006,5003,1,506480000,506480000,7501,2500,5001,2500,0,1,2502,15841919,15.841919
6900,4900,2500,33810000,2,20006,5003,1,506480000,506480000,7501,2500,5001,2500,0,1,2502,16415672,16.415672
6900,4900,2500,33810000,2,20006,5003,1,506480000,506480000,7501,2500,5001,2500,0,1,2502,16014515,16.014515
6900,4900,2500,33810000,2,20006,5003,1,506480000,506480000,7501,2500,5001,2500,0,1,2502,16292784,16.292784
6900,4900,2500,33810000,2,20006,5003,1,506480000,506480000,7501,2500,5001,2500,0,1,2502,15991149,15.991149
6900,4900,2500,33810000,2,20006,5003,1,506480000,506480000,7501,2500,5001,2500,0,1,2502,16438228,16.438228
6900,4900,2900,33810000,2,23206,5803,1,544240000,544240000,8701,2900,5801,2900,0,1,2902,18599581,18.599581
6900,4900,2900,33810000,2,23206,5803,1,544240000,544240000,8701,2900,5801,2900,0,1,2902,19260159,19.260159
6900,4900,2900,33810000,2,23206,5803,1,544240000,544240000,8701,2900,5801,2900,0,1,2902,18258046,18.258046
6900,4900,2900,33810000,2,23206,5803,1,544240000,544240000,8701,2900,5801,2900,0,1,2902,19036576,19.036576
6900,4900,2900,33810000,2,23206,5803,1,544240000,544240000,8701,2900,5801,2900,0,1,2902,18442080,18.44208
6900,4900,2900,33810000,2,23206,5803,1,544240000,544240000,8701,2900,5801,2900,0,1,2902,18806385,18.806385
6900,4900,2900,33810000,2,23206,5803,1,544240000,544240000,8701,2900,5801,2900,0,1,2902,18483286,18.483286
6900,4900,2900,33810000,2,23206,5803,1,544240000,544240000,8701,2900,5801,2900,0,1,2902,19002818,19.002818
6900,4900,3300,33810000,2,26406,6603,1,582000000,582000000,9901,3300,6601,3300,0,1,3302,21150710,21.15071
6900,4900,3300,33810000,2,26406,6603,1,582000000,582000000,9901,3300,6601,3300,0,1,3302,21877810,21.87781
6900,4900,3300,33810000,2,26406,6603,1,582000000,582000000,9901,3300,6601,3300,0,1,3302,20697141,20.697141
6900,4900,3300,33810000,2,26406,6603,1,582000000,582000000,9901,3300,6601,3300,0,1,3302,21570604,21.570604
6900,4900,3300,33810000,2,26406,6603,1,582000000,582000000,9901,3300,6601,3300,0,1,3302,20897813,20.897813
6900,4900,3300,33810000,2,26406,6603,1,582000000,582000000,9901,3300,6601,3300,0,1,3302,21365865,21.365865
6900,4900,3300,33810000,2,26406,6603,1,582000000,582000000,9901,3300,6601,3300,0,1,3302,20959609,20.959609
6900,4900,3300,33810000,2,26406,6603,1,582000000,582000000,9901,3300,6601,3300,0,1,3302,21535456,21.535456
6900,4900,3700,33810000,2,29606,7403,1,619760000,619760000,11101,3700,7401,3700,0,1,3702,23660436,23.660436
6900,4900,3700,33810000,2,29606,7403,1,619760000,619760000,11101,3700,7401,3700,0,1,3702,24484248,24.484248
6900,4900,3700,33810000,2,29606,7403,1,619760000,619760000,11101,3700,7401,3700,0,1,3702,23147989,23.147989
6900,4900,3700,33810000,2,29606,7403,1,619760000,619760000,11101,3700,7401,3700,0,1,3702,24133401,24.133401
6900,4900,3700,33810000,2,29606,7403,1,619760000,619760000,11101,3700,7401,3700,0,1,3702,23484680,23.48468
6900,4900,3700,33810000,2,29606,7403,1,619760000,619760000,11101,3700,7401,3700,0,1,3702,23920261,23.920261
6900,4900,3700,33810000,2,29606,7403,1,619760000,619760000,11101,3700,7401,3700,0,1,3702,23396896,23.396896
6900,4900,3700,33810000,2,29606,7403,1,619760000,619760000,11101,3700,7401,3700,0,1,3702,24079638,24.079638
6900,4900,4100,33810000,2,32806,8203,1,657520000,657520000,12301,4100,8201,4100,0,1,4102,26103545,26.103545
6900,4900,4100,33810000,2,32806,8203,1,657520000,657520000,12301,4100,8201,4100,0,1,4102,27051074,27.051074
6900,4900,4100,33810000,2,32806,8203,1,657520000,657520000,12301,4100,8201,4100,0,1,4102,25651160,25.65116
6900,4900,4100,33810000,2,32806,8203,1,657520000,657520000,12301,4100,8201,4100,0,1,4102,26677674,26.677674
6900,4900,4100,33810000,2,32806,8203,1,657520000,657520000,12301,4100,8201,4100,0,1,4102,25840257,25.840257
6900,4900,4100,33810000,2,32806,8203,1,657520000,657520000,12301,4100,8201,4100,0,1,4102,26381023,26.381023
6900,4900,4100,33810000,2,32806,8203,1,657520000,657520000,12301,4100,8201,4100,0,1,4102,25907616,25.907616
6900,4900,4100,33810000,2,32806,8203,1,657520000,657520000,12301,4100,8201,4100,0,1,4102,26654843,26.654843
6900,4900,4500,33810000,2,36006,9003,1,695280000,695280000,13501,4500,9001,4500,0,1,4502,28668496,28.668496
6900,4900,4500,33810000,2,36006,9003,1,695280000,695280000,13501,4500,9001,4500,0,1,4502,29711167,29.711167
6900,4900,4500,33810000,2,36006,9003,1,695280000,695280000,13501,4500,9001,4500,0,1,4502,28085961,28.085961
6900,4900,4500,33810000,2,36006,9003,1,695280000,695280000,13501,4500,9001,4500,0,1,4502,29177082,29.177082
6900,4900,4500,33810000,2,36006,9003,1,695280000,695280000,13501,4500,9001,4500,0,1,4502,28357629,28.357629
6900,4900,4500,33810000,2,36006,9003,1,695280000,695280000,13501,4500,9001,4500,0,1,4502,28933333,28.933333
6900,4900,4500,33810000,2,36006,9003,1,695280000,695280000,13501,4500,9001,4500,0,1,4502,28395897,28.395897
6900,4900,4500,33810000,2,36006,9003,1,695280000,695280000,13501,4500,9001,4500,0,1,4502,29249957,29.249957
6900,4900,4900,33810000,2,39206,9803,1,733040000,733040000,14701,4900,9801,4900,0,1,4902,31190541,31.190541
6900,4900,4900,33810000,2,39206,9803,1,733040000,733040000,14701,4900,9801,4900,0,1,4902,32341967,32.341967
6900,4900,4900,33810000,2,39206,9803,1,733040000,733040000,14701,4900,9801,4900,0,1,4902,30569393,30.569393
6900,4900,4900,33810000,2,39206,9803,1,733040000,733040000,14701,4900,9801,4900,0,1,4902,31825485,31.825485
6900,4900,4900,33810000,2,39206,9803,1,733040000,733040000,14701,4900,9801,4900,0,1,4902,30895295,30.895295
6900,4900,4900,33810000,2,39206,9803,1,733040000,733040000,14701,4900,9801,4900,0,1,4902,31448618,31.448618
6900,4900,4900,33810000,2,39206,9803,1,733040000,733040000,14701,4900,9801,4900,0,1,4902,30918024,30.918024
6900,4900,4900,33810000,2,39206,9803,1,733040000,733040000,14701,4900,9801,4900,0,1,4902,31864738,31.864738
6900,4900,5300,33810000,2,42406,10603,1,770800000,770800000,15901,5300,10601,5300,0,1,5302,33736943,33.736943
6900,4900,5300,33810000,2,42406,10603,1,770800000,770800000,15901,5300,10601,5300,0,1,5302,35045980,35.04598
6900,4900,5300,33810000,2,42406,10603,1,770800000,770800000,15901,5300,10601,5300,0,1,5302,33183289,33.183289
6900,4900,5300,33810000,2,42406,10603,1,770800000,770800000,15901,5300,10601,5300,0,1,5302,34518810,34.51881
6900,4900,5300,33810000,2,42406,10603,1,770800000,770800000,15901,5300,10601,5300,0,1,5302,33441927,33.441927
6900,4900,5300,33810000,2,42406,10603,1,770800000,770800000,15901,5300,10601,5300,0,1,5302,34075010,34.07501
6900,4900,5300,33810000,2,42406,10603,1,770800000,770800000,15901,5300,10601,5300,0,1,5302,33401669,33.401669
6900,4900,5300,33810000,2,42406,10603,1,770800000,770800000,15901,5300,10601,5300,0,1,5302,34494141,34.494141
6900,4900,5700,33810000,2,45606,11403,1,808560000,808560000,17101,5700,11401,5700,0,1,5702,36262862,36.262862
6900,4900,5700,33810000,2,45606,11403,1,808560000,808560000,17101,5700,11401,5700,0,1,5702,37567981,37.567981
6900,4900,5700,33810000,2,45606,11403,1,808560000,808560000,17101,5700,11401,5700,0,1,5702,35521702,35.521702
6900,4900,5700,33810000,2,45606,11403,1,808560000,808560000,17101,5700,11401,5700,0,1,5702,37122602,37.122602
6900,4900,5700,33810000,2,45606,11403,1,808560000,808560000,17101,5700,11401,5700,0,1,5702,35891709,35.891709
6900,4900,5700,33810000,2,45606,11403,1,808560000,808560000,17101,5700,11401,5700,0,1,5702,36638870,36.63887
6900,4900,5700,33810000,2,45606,11403,1,808560000,808560000,17101,5700,11401,5700,0,1,5702,35914289,35.914289
6900,4900,5700,33810000,2,45606,11403,1,808560000,808560000,17101,5700,11401,5700,0,1,5702,37008407,37.008407
6900,4900,6100,33810000,2,48806,12203,1,846320000,846320000,18301,6100,12201,6100,0,1,6102,38824620,38.82462
6900,4900,6100,33810000,2,48806,12203,1,846320000,846320000,18301,6100,12201,6100,0,1,6102,40198824,40.198824
6900,4900,6100,33810000,2,48806,12203,1,846320000,846320000,18301,6100,12201,6100,0,1,6102,38054171,38.054171
6900,4900,6100,33810000,2,48806,12203,1,846320000,846320000,18301,6100,12201,6100,0,1,6102,39823545,39.823545
6900,4900,6100,33810000,2,48806,12203,1,846320000,846320000,18301,6100,12201,6100,0,1,6102,38548976,38.548976
6900,4900,6100,33810000,2,48806,12203,1,846320000,846320000,18301,6100,12201,6100,0,1,6102,39244837,39.244837
6900,4900,6100,33810000,2,48806,12203,1,846320000,846320000,18301,6100,12201,6100,0,1,6102,38463877,38.463877
6900,4900,6100,33810000,2,48806,12203,1,846320000,846320000,18301,6100,12201,6100,0,1,6102,39709618,39.709618
6900,4900,6500,33810000,2,52006,13003,1,884080000,884080000,19501,6500,13001,6500,0,1,6502,41386651,41.386651
6900,4900,6500,33810000,2,52006,13003,1,884080000,884080000,19501,6500,13001,6500,0,1,6502,42791087,42.791087
6900,4900,6500,33810000,2,52006,13003,1,884080000,884080000,19501,6500,13001,6500,0,1,6502,40523802,40.523802
6900,4900,6500,33810000,2,52006,13003,1,884080000,884080000,19501,6500,13001,6500,0,1,6502,42254188,42.254188
6900,4900,6500,33810000,2,52006,13003,1,884080000,884080000,19501,6500,13001,6500,0,1,6502,40995260,40.99526
6900,4900,6500,33810000,2,52006,13003,1,884080000,884080000,19501,6500,13001,6500,0,1,6502,41756236,41.756236
6900,4900,6500,33810000,2,52006,13003,1,884080000,884080000,19501,6500,13001,6500,0,1,6502,40950488,40.950488
6900,4900,6500,33810000,2,52006,13003,1,884080000,884080000,19501,6500,13001,6500,0,1,6502,42278210,42.27821
6900,4900,6900,33810000,2,55206,13803,1,921840000,921840000,20701,6900,13801,6900,0,1,6902,43876420,43.87642
6900,4900,6900,33810000,2,55206,13803,1,921840000,921840000,20701,6900,13801,6900,0,1,6902,45430489,45.430489
6900,4900,6900,33810000,2,55206,13803,1,921840000,921840000,20701,6900,13801,6900,0,1,6902,42993200,42.9932
6900,4900,6900,33810000,2,55206,13803,1,921840000,921840000,20701,6900,13801,6900,0,1,6902,44877056,44.877056
6900,4900,6900,33810000,2,55206,13803,1,921840000,921840000,20701,6900,13801,6900,0,1,6902,43478567,43.478567
6900,4900,6900,33810000,2,55206,13803,1,921840000,921840000,20701,6900,13801,6900,0,1,6902,44356827,44.356827
6900,4900,6900,33810000,2,55206,13803,1,921840000,921840000,20701,6900,13801,6900,0,1,6902,43455287,43.455287
6900,4900,6900,33810000,2,55206,13803,1,921840000,921840000,20701,6900,13801,6900,0,1,6902,44679710,44.67971
6900,4500,500,31050000,2,4006,1003,1,294000000,294000000,1501,500,1001,500,0,1,502,3411808,3.411808
6900,4500,500,31050000,2,4006,1003,1,294000000,294000000,1501,500,1001,500,0,1,502,3389362,3.389362
6900,4500,500,31050000,2,4006,1003,1,294000000,294000000,1501,500,1001,500,0,1,502,3298331,3.298331
6900,4500,500,31050000,2,4006,1003,1,294000000,294000000,1501,500,1001,500,0,1,502,3344125,3.344125
6900,4500,500,31050000,2,4006,1003,1,294000000,294000000,1501,500,1001,500,0,1,502,3365603,3.365603
6900,4500,500,31050000,2,4006,1003,1,294000000,294000000,1501,500,1001,500,0,1,502,3411344,3.411344
6900,4500,500,31050000,2,4006,1003,1,294000000,294000000,1501,500,1001,500,0,1,502,3276998,3.276998
6900,4500,500,31050000,2,4006,1003,1,294000000,294000000,1501,500,1001,500,0,1,502,3299622,3.299622
6900,4500,900,31050000,2,7206,1803,1,330480000,330480000,2701,900,1801,900,0,1,902,5485562,5.485562
6900,4500,900,31050000,2,7206,1803,1,330480000,330480000,2701,900,1801,900,0,1,902,5658807,5.658807
6900,4500,900,31050000,2,7206,1803,1,330480000,330480000,2701,900,1801,900,0,1,902,5360241,5.360241
6900,4500,900,31050000,2,7206,1803,1,330480000,330480000,2701,900,1801,900,0,1,902,5599264,5.599264
6900,4500,900,31050000,2,7206,1803,1,330480000,330480000,2701,900,1801,900,0,1,902,5463432,5.463432
6900,4500,900,31050000,2,7206,1803,1,330480000,330480000,2701,900,1801,900,0,1,902,5559754,5.559754
6900,4500,900,31050000,2,7206,1803,1,330480000,330480000,2701,900,1801,900,0,1,902,5400699,5.400699
6900,4500,900,31050000,2,7206,1803,1,330480000,330480000,2701,900,1801,900,0,1,902,5537865,5.537865
6900,4500,1300,31050000,2,10406,2603,1,366960000,366960000,3901,1300,2601,1300,0,1,1302,7768543,7.768543
6900,4500,1300,31050000,2,10406,2603,1,366960000,366960000,3901,1300,2601,1300,0,1,1302,8032634,8.032634
6900,4500,1300,31050000,2,10406,2603,1,366960000,366960000,3901,1300,2601,1300,0,1,1302,7629890,7.62989
6900,4500,1300,31050000,2,10406,2603,1,366960000,366960000,3901,1300,2601,1300,0,1,1302,7932588,7.932588
6900,4500,1300,31050000,2,10406,2603,1,366960000,366960000,3901,1300,2601,1300,0,1,1302,7747145,7.747145
6900,4500,1300,31050000,2,10406,2603,1,366960000,366960000,3901,1300,2601,1300,0,1,1302,7899379,7.899379
6900,4500,1300,31050000,2,10406,2603,1,366960000,366960000,3901,1300,2601,1300,0,1,1302,7661268,7.661268
6900,4500,1300,31050000,2,10406,2603,1,366960000,366960000,3901,1300,2601,1300,0,1,1302,7877348,7.877348
6900,4500,1700,31050000,2,13606,3403,1,403440000,403440000,5101,1700,3401,1700,0,1,1702,10213194,10.213194
6900,4500,1700,31050000,2,13606,3403,1,403440000,403440000,5101,1700,3401,1700,0,1,1702,10512433,10.512433
6900,4500,1700,31050000,2,13606,3403,1,403440000,403440000,5101,1700,3401,1700,0,1,1702,10013936,10.013936
6900,4500,1700,31050000,2,13606,3403,1,403440000,403440000,5101,1700,3401,1700,0,1,1702,10384707,10.384707
6900,4500,1700,31050000,2,13606,3403,1,403440000,403440000,5101,1700,3401,1700,0,1,1702,10166971,10.166971
6900,4500,1700,31050000,2,13606,3403,1,403440000,403440000,5101,1700,3401,1700,0,1,1702,10351089,10.351089
6900,4500,1700,31050000,2,13606,3403,1,403440000,403440000,5101,1700,3401,1700,0,1,1702,10074258,10.074258
6900,4500,1700,31050000,2,13606,3403,1,403440000,403440000,5101,1700,3401,1700,0,1,1702,10330140,10.33014
6900,4500,2100,31050000,2,16806,4203,1,439920000,439920000,6301,2100,4201,2100,0,1,2102,12534876,12.534876
6900,4500,2100,31050000,2,16806,4203,1,439920000,439920000,6301,2100,4201,2100,0,1,2102,12798148,12.798148
6900,4500,2100,31050000,2,16806,4203,1,439920000,439920000,6301,2100,4201,2100,0,1,2102,12107937,12.107937
6900,4500,2100,31050000,2,16806,4203,1,439920000,439920000,6301,2100,4201,2100,0,1,2102,12592654,12.592654
6900,4500,2100,31050000,2,16806,4203,1,439920000,439920000,6301,2100,4201,2100,0,1,2102,12335372,12.335372
6900,4500,2100,31050000,2,16806,4203,1,439920000,439920000,6301,2100,4201,2100,0,1,2102,12613500,12.6135
6900,4500,2100,31050000,2,16806,4203,1,439920000,439920000,6301,2100,4201,2100,0,1,2102,12198800,12.1988
6900,4500,2100,31050000,2,16806,4203,1,439920000,439920000,6301,2100,4201,2100,0,1,2102,12706416,12.706416
6900,4500,2500,31050000,2,20006,5003,1,476400000,476400000,7501,2500,5001,2500,0,1,2502,14808022,14.808022
6900,4500,2500,31050000,2,20006,5003,1,476400000,476400000,7501,2500,5001,2500,0,1,2502,15270624,15.270624
6900,4500,2500,31050000,2,20006,5003,1,476400000,476400000,7501,2500,5001,2500,0,1,2502,14517034,14.517034
6900,4500,2500,31050000,2,20006,5003,1,476400000,476400000,7501,2500,5001,2500,0,1,2502,15012875,15.012875
6900,4500,2500,31050000,2,20006,5003,1,476400000,476400000,7501,2500,5001,2500,0,1,2502,14538167,14.538167
6900,4500,2500,31050000,2,20006,5003,1,476400000,476400000,7501,2500,5001,2500,0,1,2502,14973064,14.973064
6900,4500,2500,31050000,2,20006,5003,1,476400000,476400000,7501,2500,5001,2500,0,1,2502,14605634,14.605634
6900,4500,2500,31050000,2,20006,5003,1,476400000,476400000,7501,2500,5001,2500,0,1,2502,15042756,15.042756
6900,4500,2900,31050000,2,23206,5803,1,512880000,512880000,8701,2900,5801,2900,0,1,2902,17143753,17.143753
6900,4500,2900,31050000,2,23206,5803,1,512880000,512880000,8701,2900,5801,2900,0,1,2902,17662343,17.662343
6900,4500,2900,31050000,2,23206,5803,1,512880000,512880000,8701,2900,5801,2900,0,1,2902,16761055,16.761055
6900,4500,2900,31050000,2,23206,5803,1,512880000,512880000,8701,2900,5801,2900,0,1,2902,17397696,17.397696
6900,4500,2900,31050000,2,23206,5803,1,512880000,512880000,8701,2900,5801,2900,0,1,2902,17009906,17.009906
6900,4500,2900,31050000,2,23206,5803,1,512880000,512880000,8701,2900,5801,2900,0,1,2902,17303258,17.303258
6900,4500,2900,31050000,2,23206,5803,1,512880000,512880000,8701,2900,5801,2900,0,1,2902,16917443,16.917443
6900,4500,2900,31050000,2,23206,5803,1,512880000,512880000,8701,2900,5801,2900,0,1,2902,17375547,17.375547
6900,4500,3300,31050000,2,26406,6603,1,549360000,549360000,9901,3300,6601,3300,0,1,3302,19449206,19.449206
6900,4500,3300,31050000,2,26406,6603,1,549360000,549360000,9901,3300,6601,3300,0,1,3302,20086257,20.086257
6900,4500,3300,31050000,2,26406,6603,1,549360000,549360000,9901,3300,6601,3300,0,1,3302,19047703,19.047703
6900,4500,3300,31050000,2,26406,6603,1,549360000,549360000,9901,3300,6601,3300,0,1,3302,19783502,19.783502
6900,4500,3300,31050000,2,26406,6603,1,549360000,549360000,9901,3300,6601,3300,0,1,3302,19291740,19.29174
6900,4500,3300,31050000,2,26406,6603,1,549360000,549360000,9901,3300,6601,3300,0,1,3302,19584030,19.58403
6900,4500,3300,31050000,2,26406,6603,1,549360000,549360000,9901,3300,6601,3300,0,1,3302,19195175,19.195175
6900,4500,3300,31050000,2,26406,6603,1,549360000,549360000,9901,3300,6601,3300,0,1,3302,19751073,19.751073
6900,4500,3700,31050000,2,29606,7403,1,585840000,585840000,11101,3700,7401,3700,0,1,3702,21764457,21.764457
6900,4500,3700,31050000,2,29606,7403,1,585840000,585840000,11101,3700,7401,3700,0,1,3702,22439207,22.439207
6900,4500,3700,31050000,2,29606,7403,1,585840000,585840000,11101,3700,7401,3700,0,1,3702,21324994,21.324994
6900,4500,3700,31050000,2,29606,7403,1,585840000,585840000,11101,3700,7401,3700,0,1,3702,22175564,22.175564
6900,4500,3700,31050000,2,29606,7403,1,585840000,585840000,11101,3700,7401,3700,0,1,3702,21517081,21.517081
6900,4500,3700,31050000,2,29606,7403,1,585840000,585840000,11101,3700,7401,3700,0,1,3702,21894922,21.894922
6900,4500,3700,31050000,2,29606,7403,1,585840000,585840000,11101,3700,7401,3700,0,1,3702,21495927,21.495927
6900,4500,3700,31050000,2,29606,7403,1,585840000,585840000,11101,3700,7401,3700,0,1,3702,22121144,22.121144
6900,4500,4100,31050000,2,32806,8203,1,622320000,622320000,12301,4100,8201,4100,0,1,4102,24043093,24.043093
6900,4500,4100,31050000,2,32806,8203,1,622320000,622320000,12301,4100,8201,4100,0,1,4102,24844933,24.844933
6900,4500,4100,31050000,2,32806,8203,1,622320000,622320000,12301,4100,8201,4100,0,1,4102,23525624,23.525624
6900,4500,4100,31050000,2,32806,8203,1,622320000,622320000,12301,4100,8201,4100,0,1,4102,24508964,24.508964
6900,4500,4100,31050000,2,32806,8203,1,622320000,622320000,12301,4100,8201,4100,0,1,4102,23868110,23.86811
6900,4500,4100,31050000,2,32806,8203,1,622320000,622320000,12301,4100,8201,4100,0,1,4102,24187523,24.187523
6900,4500,4100,31050000,2,32806,8203,1,622320000,622320000,12301,4100,8201,4100,0,1,4102,23889063,23.889063
6900,4500,4100,31050000,2,32806,8203,1,622320000,622320000,12301,4100,8201,4100,0,1,4102,24413183,24.413183
6900,4500,4500,31050000,2,36006,9003,1,658800000,658800000,13501,4500,9001,4500,0,1,4502,26311513,26.311513
6900,4500,4500,31050000,2,36006,9003,1,658800000,658800000,13501,4500,9001,4500,0,1,4502,27255742,27.255742
6900,4500,4500,31050000,2,36006,9003,1,658800000,658800000,13501,4500,9001,4500,0,1,4502,25804002,25.804002
6900,4500,4500,31050000,2,36006,9003,1,658800000,658800000,13501,4500,9001,4500,0,1,4502,26856785,26.856785
6900,4500,4500,31050000,2,36006,9003,1,658800000,658800000,13501,4500,9001,4500,0,1,4502,26059739,26.059739
6900,4500,4500,31050000,2,36006,9003,1,658800000,658800000,13501,4500,9001,4500,0,1,4502,26605071,26.605071
6900,4500,4500,31050000,2,36006,9003,1,658800000,658800000,13501,4500,9001,4500,0,1,4502,26109656,26.109656
6900,4500,4500,31050000,2,36006,9003,1,658800000,658800000,13501,4500,9001,4500,0,1,4502,26821362,26.821362
6900,4500,4900,31050000,2,39206,9803,1,695280000,695280000,14701,4900,9801,4900,0,1,4902,28664481,28.664481
6900,4500,4900,31050000,2,39206,9803,1,695280000,695280000,14701,4900,9801,4900,0,1,4902,29609818,29.609818
6900,4500,4900,31050000,2,39206,9803,1,695280000,695280000,14701,4900,9801,4900,0,1,4902,28119352,28.119352
6900,4500,4900,31050000,2,39206,9803,1,695280000,695280000,14701,4900,9801,4900,0,1,4902,29270896,29.270896
6900,4500,4900,31050000,2,39206,9803,1,695280000,695280000,14701,4900,9801,4900,0,1,4902,28315228,28.315228
6900,4500,4900,31050000,2,39206,9803,1,695280000,695280000,14701,4900,9801,4900,0,1,4902,28874295,28.874295
6900,4500,4900,31050000,2,39206,9803,1,695280000,695280000,14701,4900,9801,4900,0,1,4902,28403800,28.4038
6900,4500,4900,31050000,2,39206,9803,1,695280000,695280000,14701,4900,9801,4900,0,1,4902,29175354,29.175354
6900,4500,5300,31050000,2,42406,10603,1,731760000,731760000,15901,5300,10601,5300,0,1,5302,30992261,30.992261
6900,4500,5300,31050000,2,42406,10603,1,731760000,731760000,15901,5300,10601,5300,0,1,5302,32069710,32.06971
6900,4500,5300,31050000,2,42406,10603,1,731760000,731760000,15901,5300,10601,5300,0,1,5302,30362021,30.362021
6900,4500,5300,31050000,2,42406,10603,1,731760000,731760000,15901,5300,10601,5300,0,1,5302,31614406,31.614406
6900,4500,5300,31050000,2,42406,10603,1,731760000,731760000,15901,5300,10601,5300,0,1,5302,30648578,30.648578
6900,4500,5300,31050000,2,42406,10603,1,731760000,731760000,15901,5300,10601,5300,0,1,5302,31188343,31.188343
6900,4500,5300,31050000,2,42406,10603,1,731760000,731760000,15901,5300,10601,5300,0,1,5302,30732857,30.732857
6900,4500,5300,31050000,2,42406,10603,1,731760000,731760000,15901,5300,10601,5300,0,1,5302,31636536,31.636536
6900,4500,5700,31050000,2,45606,11403,1,768240000,768240000,17101,5700,11401,5700,0,1,5702,33320934,33.320934
6900,4500,5700,31050000,2,45606,11403,1,768240000,768240000,17101,5700,11401,5700,0,1,5702,34477967,34.477967
6900,4500,5700,31050000,2,45606,11403,1,768240000,768240000,17101,5700,11401,5700,0,1,5702,32641880,32.64188
6900,4500,5700,31050000,2,45606,11403,1,768240000,768240000,17101,5700,11401,5700,0,1,5702,34057501,34.057501
6900,4500,5700,31050000,2,45606,11403,1,768240000,768240000,17101,5700,11401,5700,0,1,5702,33023562,33.023562
6900,4500,5700,31050000,2,45606,11403,1,768240000,768240000,17101,5700,11401,5700,0,1,5702,33611262,33.611262
6900,4500,5700,31050000,2,45606,11403,1,768240000,768240000,17101,5700,11401,5700,0,1,5702,32985356,32.985356
6900,4500,5700,31050000,2,45606,11403,1,768240000,768240000,17101,5700,11401,5700,0,1,5702,33936204,33.936204
6900,4500,6100,31050000,2,48806,12203,1,804720000,804720000,18301,6100,12201,6100,0,1,6102,35664545,35.664545
6900,4500,6100,31050000,2,48806,12203,1,804720000,804720000,18301,6100,12201,6100,0,1,6102,36952864,36.952864
6900,4500,6100,31050000,2,48806,12203,1,804720000,804720000,18301,6100,12201,6100,0,1,6102,34910742,34.910742
6900,4500,6100,31050000,2,48806,12203,1,804720000,804720000,18301,6100,12201,6100,0,1,6102,36438689,36.438689
6900,4500,6100,31050000,2,48806,12203,1,804720000,804720000,18301,6100,12201,6100,0,1,6102,35260558,35.260558
6900,4500,6100,31050000,2,48806,12203,1,804720000,804720000,18301,6100,12201,6100,0,1,6102,36021523,36.021523
6900,4500,6100,31050000,2,48806,12203,1,804720000,804720000,18301,6100,12201,6100,0,1,6102,35329443,35.329443
6900,4500,6100,31050000,2,48806,12203,1,804720000,804720000,18301,6100,12201,6100,0,1,6102,36393570,36.39357
6900,4500,6500,31050000,2,52006,13003,1,841200000,841200000,19501,6500,13001,6500,0,1,6502,37978075,37.978075
6900,4500,6500,31050000,2,52006,13003,1,841200000,841200000,19501,6500,13001,6500,0,1,6502,39360164,39.360164
6900,4500,6500,31050000,2,52006,13003,1,841200000,841200000,19501,6500,13001,6500,0,1,6502,37226709,37.226709
6900,4500,6500,31050000,2,52006,13003,1,841200000,841200000,19501,6500,13001,6500,0,1,6502,38808668,38.808668
6900,4500,6500,31050000,2,52006,13003,1,841200000,841200000,19501,6500,13001,6500,0,1,6502,37589383,37.589383
6900,4500,6500,31050000,2,52006,13003,1,841200000,841200000,19501,6500,13001,6500,0,1,6502,38348128,38.348128
6900,4500,6500,31050000,2,52006,13003,1,841200000,841200000,19501,6500,13001,6500,0,1,6502,37567471,37.567471
6900,4500,6500,31050000,2,52006,13003,1,841200000,841200000,19501,6500,13001,6500,0,1,6502,38671987,38.671987
6900,4500,6900,31050000,2,55206,13803,1,877680000,877680000,20701,6900,13801,6900,0,1,6902,40342623,40.342623
6900,4500,6900,31050000,2,55206,13803,1,877680000,877680000,20701,6900,13801,6900,0,1,6902,41784171,41.784171
6900,4500,6900,31050000,2,55206,13803,1,877680000,877680000,20701,6900,13801,6900,0,1,6902,39591419,39.591419
6900,4500,6900,31050000,2,55206,13803,1,877680000,877680000,20701,6900,13801,6900,0,1,6902,41198924,41.198924
6900,4500,6900,31050000,2,55206,13803,1,877680000,877680000,20701,6900,13801,6900,0,1,6902,39976155,39.976155
6900,4500,6900,31050000,2,55206,13803,1,877680000,877680000,20701,6900,13801,6900,0,1,6902,40848565,40.848565
6900,4500,6900,31050000,2,55206,13803,1,877680000,877680000,20701,6900,13801,6900,0,1,6902,39953794,39.953794
6900,4500,6900,31050000,2,55206,13803,1,877680000,877680000,20701,6900,13801,6900,0,1,6902,41221528,41.221528
6900,4100,500,28290000,2,4006,1003,1,270320000,270320000,1501,500,1001,500,0,1,502,3067074,3.067074
6900,4100,500,28290000,2,4006,1003,1,270320000,270320000,1501,500,1001,500,0,1,502,3108717,3.108717
6900,4100,500,28290000,2,4006,1003,1,270320000,270320000,1501,500,1001,500,0,1,502,2892393,2.892393
6900,4100,500,28290000,2,4006,1003,1,270320000,270320000,1501,500,1001,500,0,1,502,3088063,3.088063
6900,4100,500,28290000,2,4006,1003,1,270320000,270320000,1501,500,1001,500,0,1,502,2925590,2.92559
6900,4100,500,28290000,2,4006,1003,1,270320000,270320000,1501,500,1001,500,0,1,502,3087719,3.087719
6900,4100,500,28290000,2,4006,1003,1,270320000,270320000,1501,500,1001,500,0,1,502,3047476,3.047476
6900,4100,500,28290000,2,4006,1003,1,270320000,270320000,1501,500,1001,500,0,1,502,3109260,3.10926
6900,4100,900,28290000,2,7206,1803,1,305520000,305520000,2701,900,1801,900,0,1,902,5004249,5.004249
6900,4100,900,28290000,2,7206,1803,1,305520000,305520000,2701,900,1801,900,0,1,902,5157285,5.157285
6900,4100,900,28290000,2,7206,1803,1,305520000,305520000,2701,900,1801,900,0,1,902,4899018,4.899018
6900,4100,900,28290000,2,7206,1803,1,305520000,305520000,2701,900,1801,900,0,1,902,5109269,5.109269
6900,4100,900,28290000,2,7206,1803,1,305520000,305520000,2701,900,1801,900,0,1,902,4984800,4.9848
6900,4100,900,28290000,2,7206,1803,1,305520000,305520000,2701,900,1801,900,0,1,902,5077925,5.077925
6900,4100,900,28290000,2,7206,1803,1,305520000,305520000,2701,900,1801,900,0,1,902,4918201,4.918201
6900,4100,900,28290000,2,7206,1803,1,305520000,305520000,2701,900,1801,900,0,1,902,5136377,5.136377
6900,4100,1300,28290000,2,10406,2603,1,340720000,340720000,3901,1300,2601,1300,0,1,1302,7093540,7.09354
6900,4100,1300,28290000,2,10406,2603,1,340720000,340720000,3901,1300,2601,1300,0,1,1302,7316767,7.316767
6900,4100,1300,28290000,2,10406,2603,1,340720000,340720000,3901,1300,2601,1300,0,1,1302,6955445,6.955445
6900,4100,1300,28290000,2,10406,2603,1,340720000,340720000,3901,1300,2601,1300,0,1,1302,7251241,7.251241
6900,4100,1300,28290000,2,10406,2603,1,340720000,340720000,3901,1300,2601,1300,0,1,1302,7070385,7.070385
6900,4100,1300,28290000,2,10406,2603,1,340720000,340720000,3901,1300,2601,1300,0,1,1302,7210409,7.210409
6900,4100,1300,28290000,2,10406,2603,1,340720000,340720000,3901,1300,2601,1300,0,1,1302,6990801,6.990801
6900,4100,1300,28290000,2,10406,2603,1,340720000,340720000,3901,1300,2601,1300,0,1,1302,7271283,7.271283
6900,4100,1700,28290000,2,13606,3403,1,375920000,375920000,5101,1700,3401,1700,0,1,1702,9195231,9.195231
6900,4100,1700,28290000,2,13606,3403,1,375920000,375920000,5101,1700,3401,1700,0,1,1702,9533878,9.533878
6900,4100,1700,28290000,2,13606,3403,1,375920000,375920000,5101,1700,3401,1700,0,1,1702,9001680,9.00168
6900,4100,1700,28290000,2,13606,3403,1,375920000,375920000,5101,1700,3401,1700,0,1,1702,9422744,9.422744
6900,4100,1700,28290000,2,13606,3403,1,375920000,375920000,5101,1700,3401,1700,0,1,1702,9147217,9.147217
6900,4100,1700,28290000,2,13606,3403,1,375920000,375920000,5101,1700,3401,1700,0,1,1702,9327111,9.327111
6900,4100,1700,28290000,2,13606,3403,1,375920000,375920000,5101,1700,3401,1700,0,1,1702,9072352,9.072352
6900,4100,1700,28290000,2,13606,3403,1,375920000,375920000,5101,1700,3401,1700,0,1,1702,9403664,9.403664
6900,4100,2100,28290000,2,16806,4203,1,411120000,411120000,6301,2100,4201,2100,0,1,2102,11447375,11.447375
6900,4100,2100,28290000,2,16806,4203,1,411120000,411120000,6301,2100,4201,2100,0,1,2102,11797315,11.797315
6900,4100,2100,28290000,2,16806,4203,1,411120000,411120000,6301,2100,4201,2100,0,1,2102,11209794,11.209794
6900,4100,2100,28290000,2,16806,4203,1,411120000,411120000,6301,2100,4201,2100,0,1,2102,11618602,11.618602
6900,4100,2100,28290000,2,16806,4203,1,411120000,411120000,6301,2100,4201,2100,0,1,2102,11375018,11.375018
6900,4100,2100,28290000,2,16806,4203,1,411120000,411120000,6301,2100,4201,2100,0,1,2102,11554127,11.554127
6900,4100,2100,28290000,2,16806,4203,1,411120000,411120000,6301,2100,4201,2100,0,1,2102,11325929,11.325929
6900,4100,2100,28290000,2,16806,4203,1,411120000,411120000,6301,2100,4201,2100,0,1,2102,11666726,11.666726
6900,4100,2500,28290000,2,20006,5003,1,446320000,446320000,7501,2500,5001,2500,0,1,2502,13368694,13.368694
6900,4100,2500,28290000,2,20006,5003,1,446320000,446320000,7501,2500,5001,2500,0,1,2502,13858481,13.858481
6900,4100,2500,28290000,2,20006,5003,1,446320000,446320000,7501,2500,5001,2500,0,1,2502,13122676,13.122676
6900,4100,2500,28290000,2,20006,5003,1,446320000,446320000,7501,2500,5001,2500,0,1,2502,13680021,13.680021
6900,4100,2500,28290000,2,20006,5003,1,446320000,446320000,7501,2500,5001,2500,0,1,2502,13326585,13.326585
6900,4100,2500,28290000,2,20006,5003,1,446320000,446320000,7501,2500,5001,2500,0,1,2502,13559965,13.559965
6900,4100,2500,28290000,2,20006,5003,1,446320000,446320000,7501,2500,5001,2500,0,1,2502,13222852,13.222852
6900,4100,2500,28290000,2,20006,5003,1,446320000,446320000,7501,2500,5001,2500,0,1,2502,13707187,13.707187
6900,4100,2900,28290000,2,23206,5803,1,481520000,481520000,8701,2900,5801,2900,0,1,2902,15694115,15.694115
6900,4100,2900,28290000,2,23206,5803,1,481520000,481520000,8701,2900,5801,2900,0,1,2902,16125580,16.12558
6900,4100,2900,28290000,2,23206,5803,1,481520000,481520000,8701,2900,5801,2900,0,1,2902,15353012,15.353012
6900,4100,2900,28290000,2,23206,5803,1,481520000,481520000,8701,2900,5801,2900,0,1,2902,15871948,15.871948
6900,4100,2900,28290000,2,23206,5803,1,481520000,481520000,8701,2900,5801,2900,0,1,2902,15598563,15.598563
6900,4100,2900,28290000,2,23206,5803,1,481520000,481520000,8701,2900,5801,2900,0,1,2902,15851959,15.851959
6900,4100,2900,28290000,2,23206,5803,1,481520000,481520000,8701,2900,5801,2900,0,1,2902,15456545,15.456545
6900,4100,2900,28290000,2,23206,5803,1,481520000,481520000,8701,2900,5801,2900,0,1,2902,15971847,15.971847
6900,4100,3300,28290000,2,26406,6603,1,516720000,516720000,9901,3300,6601,3300,0,1,3302,17773925,17.773925
6900,4100,3300,28290000,2,26406,6603,1,516720000,516720000,9901,3300,6601,3300,0,1,3302,18350762,18.350762
6900,4100,3300,28290000,2,26406,6603,1,516720000,516720000,9901,3300,6601,3300,0,1,3302,17387535,17.387535
6900,4100,3300,28290000,2,26406,6603,1,516720000,516720000,9901,3300,6601,3300,0,1,3302,18080016,18.080016
6900,4100,3300,28290000,2,26406,6603,1,516720000,516720000,9901,3300,6601,3300,0,1,3302,17628063,17.628063
6900,4100,3300,28290000,2,26406,6603,1,516720000,516720000,9901,3300,6601,3300,0,1,3302,17912287,17.912287
6900,4100,3300,28290000,2,26406,6603,1,516720000,516720000,9901,3300,6601,3300,0,1,3302,17522710,17.52271
6900,4100,3300,28290000,2,26406,6603,1,516720000,516720000,9901,3300,6601,3300,0,1,3302,18099227,18.099227
6900,4100,3700,28290000,2,29606,7403,1,551920000,551920000,11101,3700,7401,3700,0,1,3702,19852419,19.852419
6900,4100,3700,28290000,2,29606,7403,1,551920000,551920000,11101,3700,7401,3700,0,1,3702,20517043,20.517043
6900,4100,3700,28290000,2,29606,7403,1,551920000,551920000,11101,3700,7401,3700,0,1,3702,19489196,19.489196
6900,4100,3700,28290000,2,29606,7403,1,551920000,551920000,11101,3700,7401,3700,0,1,3702,20286704,20.286704
6900,4100,3700,28290000,2,29606,7403,1,551920000,551920000,11101,3700,7401,3700,0,1,3702,19793551,19.793551
6900,4100,3700,28290000,2,29606,7403,1,551920000,551920000,11101,3700,7401,3700,0,1,3702,20152373,20.152373
6900,4100,3700,28290000,2,29606,7403,1,551920000,551920000,11101,3700,7401,3700,0,1,3702,19823004,19.823004
6900,4100,3700,28290000,2,29606,7403,1,551920000,551920000,11101,3700,7401,3700,0,1,3702,20316746,20.316746
6900,4100,4100,28290000,2,32806,8203,1,587120000,587120000,12301,4100,8201,4100,0,1,4102,21960045,21.960045
6900,4100,4100,28290000,2,32806,8203,1,587120000,587120000,12301,4100,8201,4100,0,1,4102,22715362,22.715362
6900,4100,4100,28290000,2,32806,8203,1,587120000,587120000,12301,4100,8201,4100,0,1,4102,21490390,21.49039
6900,4100,4100,28290000,2,32806,8203,1,587120000,587120000,12301,4100,8201,4100,0,1,4102,22305842,22.305842
6900,4100,4100,28290000,2,32806,8203,1,587120000,587120000,12301,4100,8201,4100,0,1,4102,21844623,21.844623
6900,4100,4100,28290000,2,32806,8203,1,587120000,587120000,12301,4100,8201,4100,0,1,4102,22125448,22.125448
6900,4100,4100,28290000,2,32806,8203,1,587120000,587120000,12301,4100,8201,4100,0,1,4102,21793518,21.793518
6900,4100,4100,28290000,2,32806,8203,1,587120000,587120000,12301,4100,8201,4100,0,1,4102,22422940,22.42294
6900,4100,4500,28290000,2,36006,9003,1,622320000,622320000,13501,4500,9001,4500,0,1,4502,24133981,24.133981
6900,4100,4500,28290000,2,36006,9003,1,622320000,622320000,13501,4500,9001,4500,0,1,4502,24901874,24.901874
6900,4100,4500,28290000,2,36006,9003,1,622320000,622320000,13501,4500,9001,4500,0,1,4502,23590192,23.590192
6900,4100,4500,28290000,2,36006,9003,1,622320000,622320000,13501,4500,9001,4500,0,1,4502,24525060,24.52506
6900,4100,4500,28290000,2,36006,9003,1,622320000,622320000,13501,4500,9001,4500,0,1,4502,23970435,23.970435
6900,4100,4500,28290000,2,36006,9003,1,622320000,622320000,13501,4500,9001,4500,0,1,4502,24351000,24.351
6900,4100,4500,28290000,2,36006,9003,1,622320000,622320000,13501,4500,9001,4500,0,1,4502,23950629,23.950629
6900,4100,4500,28290000,2,36006,9003,1,622320000,622320000,13501,4500,9001,4500,0,1,4502,24601580,24.60158
6900,4100,4900,28290000,2,39206,9803,1,657520000,657520000,14701,4900,9801,4900,0,1,4902,26203728,26.203728
6900,4100,4900,28290000,2,39206,9803,1,657520000,657520000,14701,4900,9801,4900,0,1,4902,27120157,27.120157
6900,4100,4900,28290000,2,39206,9803,1,657520000,657520000,14701,4900,9801,4900,0,1,4902,25655419,25.655419
6900,4100,4900,28290000,2,39206,9803,1,657520000,657520000,14701,4900,9801,4900,0,1,4902,26717354,26.717354
6900,4100,4900,28290000,2,39206,9803,1,657520000,657520000,14701,4900,9801,4900,0,1,4902,25979467,25.979467
6900,4100,4900,28290000,2,39206,9803,1,657520000,657520000,14701,4900,9801,4900,0,1,4902,26495891,26.495891
6900,4100,4900,28290000,2,39206,9803,1,657520000,657520000,14701,4900,9801,4900,0,1,4902,26052537,26.052537
6900,4100,4900,28290000,2,39206,9803,1,657520000,657520000,14701,4900,9801,4900,0,1,4902,26782174,26.782174
6900,4100,5300,28290000,2,42406,10603,1,692720000,692720000,15901,5300,10601,5300,0,1,5302,28360567,28.360567
6900,4100,5300,28290000,2,42406,10603,1,692720000,692720000,15901,5300,10601,5300,0,1,5302,29409339,29.409339
6900,4100,5300,28290000,2,42406,10603,1,692720000,692720000,15901,5300,10601,5300,0,1,5302,27785542,27.785542
6900,4100,5300,28290000,2,42406,10603,1,692720000,692720000,15901,5300,10601,5300,0,1,5302,28905011,28.905011
6900,4100,5300,28290000,2,42406,10603,1,692720000,692720000,15901,5300,10601,5300,0,1,5302,28267496,28.267496
6900,4100,5300,28290000,2,42406,10603,1,692720000,692720000,15901,5300,10601,5300,0,1,5302,28725054,28.725054
6900,4100,5300,28290000,2,42406,10603,1,692720000,692720000,15901,5300,10601,5300,0,1,5302,28248215,28.248215
6900,4100,5300,28290000,2,42406,10603,1,692720000,692720000,15901,5300,10601,5300,0,1,5302,29024402,29.024402
6900,4100,5700,28290000,2,45606,11403,1,727920000,727920000,17101,5700,11401,5700,0,1,5702,30491876,30.491876
6900,4100,5700,28290000,2,45606,11403,1,727920000,727920000,17101,5700,11401,5700,0,1,5702,31580079,31.580079
6900,4100,5700,28290000,2,45606,11403,1,727920000,727920000,17101,5700,11401,5700,0,1,5702,29815619,29.815619
6900,4100,5700,28290000,2,45606,11403,1,727920000,727920000,17101,5700,11401,5700,0,1,5702,31069407,31.069407
6900,4100,5700,28290000,2,45606,11403,1,727920000,727920000,17101,5700,11401,5700,0,1,5702,30256818,30.256818
6900,4100,5700,28290000,2,45606,11403,1,727920000,727920000,17101,5700,11401,5700,0,1,5702,30741227,30.741227
6900,4100,5700,28290000,2,45606,11403,1,727920000,727920000,17101,5700,11401,5700,0,1,5702,30165660,30.16566
6900,4100,5700,28290000,2,45606,11403,1,727920000,727920000,17101,5700,11401,5700,0,1,5702,31110732,31.110732
6900,4100,6100,28290000,2,48806,12203,1,763120000,763120000,18301,6100,12201,6100,0,1,6102,32591706,32.591706
6900,4100,6100,28290000,2,48806,12203,1,763120000,763120000,18301,6100,12201,6100,0,1,6102,33751534,33.751534
6900,4100,6100,28290000,2,48806,12203,1,763120000,763120000,18301,6100,12201,6100,0,1,6102,31910120,31.91012
6900,4100,6100,28290000,2,48806,12203,1,763120000,763120000,18301,6100,12201,6100,0,1,6102,33187760,33.18776
6900,4100,6100,28290000,2,48806,12203,1,763120000,763120000,18301,6100,12201,6100,0,1,6102,32335726,32.335726
6900,4100,6100,28290000,2,48806,12203,1,763120000,763120000,18301,6100,12201,6100,0,1,6102,32887091,32.887091
6900,4100,6100,28290000,2,48806,12203,1,763120000,763120000,18301,6100,12201,6100,0,1,6102,32372096,32.372096
6900,4100,6100,28290000,2,48806,12203,1,763120000,763120000,18301,6100,12201,6100,0,1,6102,33225436,33.225436
6900,4100,6500,28290000,2,52006,13003,1,798320000,798320000,19501,6500,13001,6500,0,1,6502,34729390,34.72939
6900,4100,6500,28290000,2,52006,13003,1,798320000,798320000,19501,6500,13001,6500,0,1,6502,35898180,35.89818
6900,4100,6500,28290000,2,52006,13003,1,798320000,798320000,19501,6500,13001,6500,0,1,6502,34064691,34.064691
6900,4100,6500,28290000,2,52006,13003,1,798320000,798320000,19501,6500,13001,6500,0,1,6502,35459200,35.4592
6900,4100,6500,28290000,2,52006,13003,1,798320000,798320000,19501,6500,13001,6500,0,1,6502,34503839,34.503839
6900,4100,6500,28290000,2,52006,13003,1,798320000,798320000,19501,6500,13001,6500,0,1,6502,35093679,35.093679
6900,4100,6500,28290000,2,52006,13003,1,798320000,798320000,19501,6500,13001,6500,0,1,6502,34562555,34.562555
6900,4100,6500,28290000,2,52006,13003,1,798320000,798320000,19501,6500,13001,6500,0,1,6502,35319336,35.319336
6900,4100,6900,28290000,2,55206,13803,1,833520000,833520000,20701,6900,13801,6900,0,1,6902,36810117,36.810117
6900,4100,6900,28290000,2,55206,13803,1,833520000,833520000,20701,6900,13801,6900,0,1,6902,38147916,38.147916
6900,4100,6900,28290000,2,55206,13803,1,833520000,833520000,20701,6900,13801,6900,0,1,6902,36066857,36.066857
6900,4100,6900,28290000,2,55206,13803,1,833520000,833520000,20701,6900,13801,6900,0,1,6902,37603524,37.603524
6900,4100,6900,28290000,2,55206,13803,1,833520000,833520000,20701,6900,13801,6900,0,1,6902,36515397,36.515397
6900,4100,6900,28290000,2,55206,13803,1,833520000,833520000,20701,6900,13801,6900,0,1,6902,37231974,37.231974
6900,4100,6900,28290000,2,55206,13803,1,833520000,833520000,20701,6900,13801,6900,0,1,6902,36613987,36.613987
6900,4100,6900,28290000,2,55206,13803,1,833520000,833520000,20701,6900,13801,6900,0,1,6902,37442438,37.442438
6900,3700,500,25530000,2,4006,1003,1,246640000,246640000,1501,500,1001,500,0,1,502,2777515,2.777515
6900,3700,500,25530000,2,4006,1003,1,246640000,246640000,1501,500,1001,500,0,1,502,2723715,2.723715
6900,3700,500,25530000,2,4006,1003,1,246640000,246640000,1501,500,1001,500,0,1,502,2743156,2.743156
6900,3700,500,25530000,2,4006,1003,1,246640000,246640000,1501,500,1001,500,0,1,502,2700491,2.700491
6900,3700,500,25530000,2,4006,1003,1,246640000,246640000,1501,500,1001,500,0,1,502,2824202,2.824202
6900,3700,500,25530000,2,4006,1003,1,246640000,246640000,1501,500,1001,500,0,1,502,2856443,2.856443
6900,3700,500,25530000,2,4006,1003,1,246640000,246640000,1501,500,1001,500,0,1,502,2873810,2.87381
6900,3700,500,25530000,2,4006,1003,1,246640000,246640000,1501,500,1001,500,0,1,502,2759977,2.759977
6900,3700,900,25530000,2,7206,1803,1,280560000,280560000,2701,900,1801,900,0,1,902,4513663,4.513663
6900,3700,900,25530000,2,7206,1803,1,280560000,280560000,2701,900,1801,900,0,1,902,4651485,4.651485
6900,3700,900,25530000,2,7206,1803,1,280560000,280560000,2701,900,1801,900,0,1,902,4442948,4.442948
6900,3700,900,25530000,2,7206,1803,1,280560000,280560000,2701,900,1801,900,0,1,902,4624434,4.624434
6900,3700,900,25530000,2,7206,1803,1,280560000,280560000,2701,900,1801,900,0,1,902,4531294,4.531294
6900,3700,900,25530000,2,7206,1803,1,280560000,280560000,2701,900,1801,900,0,1,902,4585059,4.585059
6900,3700,900,25530000,2,7206,1803,1,280560000,280560000,2701,900,1801,900,0,1,902,4548932,4.548932
6900,3700,900,25530000,2,7206,1803,1,280560000,280560000,2701,900,1801,900,0,1,902,4566604,4.566604
6900,3700,1300,25530000,2,10406,2603,1,314480000,314480000,3901,1300,2601,1300,0,1,1302,6390644,6.390644
6900,3700,1300,25530000,2,10406,2603,1,314480000,314480000,3901,1300,2601,1300,0,1,1302,6621897,6.621897
6900,3700,1300,25530000,2,10406,2603,1,314480000,314480000,3901,1300,2601,1300,0,1,1302,6270788,6.270788
6900,3700,1300,25530000,2,10406,2603,1,314480000,314480000,3901,1300,2601,1300,0,1,1302,6551790,6.55179
6900,3700,1300,25530000,2,10406,2603,1,314480000,314480000,3901,1300,2601,1300,0,1,1302,6389966,6.389966
6900,3700,1300,25530000,2,10406,2603,1,314480000,314480000,3901,1300,2601,1300,0,1,1302,6503041,6.503041
6900,3700,1300,25530000,2,10406,2603,1,314480000,314480000,3901,1300,2601,1300,0,1,1302,6415251,6.415251
6900,3700,1300,25530000,2,10406,2603,1,314480000,314480000,3901,1300,2601,1300,0,1,1302,6484854,6.484854
6900,3700,1700,25530000,2,13606,3403,1,348400000,348400000,5101,1700,3401,1700,0,1,1702,8305874,8.305874
6900,3700,1700,25530000,2,13606,3403,1,348400000,348400000,5101,1700,3401,1700,0,1,1702,8579281,8.579281
6900,3700,1700,25530000,2,13606,3403,1,348400000,348400000,5101,1700,3401,1700,0,1,1702,8139348,8.139348
6900,3700,1700,25530000,2,13606,3403,1,348400000,348400000,5101,1700,3401,1700,0,1,1702,8487969,8.487969
6900,3700,1700,25530000,2,13606,3403,1,348400000,348400000,5101,1700,3401,1700,0,1,1702,8287690,8.28769
6900,3700,1700,25530000,2,13606,3403,1,348400000,348400000,5101,1700,3401,1700,0,1,1702,8422266,8.422266
6900,3700,1700,25530000,2,13606,3403,1,348400000,348400000,5101,1700,3401,1700,0,1,1702,8305026,8.305026
6900,3700,1700,25530000,2,13606,3403,1,348400000,348400000,5101,1700,3401,1700,0,1,1702,8441238,8.441238
6900,3700,2100,25530000,2,16806,4203,1,382320000,382320000,6301,2100,4201,2100,0,1,2102,10359027,10.359027
6900,3700,2100,25530000,2,16806,4203,1,382320000,382320000,6301,2100,4201,2100,0,1,2102,10643789,10.643789
6900,3700,2100,25530000,2,16806,4203,1,382320000,382320000,6301,2100,4201,2100,0,1,2102,10151932,10.151932
6900,3700,2100,25530000,2,16806,4203,1,382320000,382320000,6301,2100,4201,2100,0,1,2102,10490114,10.490114
6900,3700,2100,25530000,2,16806,4203,1,382320000,382320000,6301,2100,4201,2100,0,1,2102,10323833,10.323833
6900,3700,2100,25530000,2,16806,4203,1,382320000,382320000,6301,2100,4201,2100,0,1,2102,10456041,10.456041
6900,3700,2100,25530000,2,16806,4203,1,382320000,382320000,6301,2100,4201,2100,0,1,2102,10276875,10.276875
6900,3700,2100,25530000,2,16806,4203,1,382320000,382320000,6301,2100,4201,2100,0,1,2102,10435425,10.435425
6900,3700,2500,25530000,2,20006,5003,1,416240000,416240000,7501,2500,5001,2500,0,1,2502,12237983,12.237983
6900,3700,2500,25530000,2,20006,5003,1,416240000,416240000,7501,2500,5001,2500,0,1,2502,12636250,12.63625
6900,3700,2500,25530000,2,20006,5003,1,416240000,416240000,7501,2500,5001,2500,0,1,2502,12001049,12.001049
6900,3700,2500,25530000,2,20006,5003,1,416240000,416240000,7501,2500,5001,2500,0,1,2502,12447560,12.44756
6900,3700,2500,25530000,2,20006,5003,1,416240000,416240000,7501,2500,5001,2500,0,1,2502,12182154,12.182154
6900,3700,2500,25530000,2,20006,5003,1,416240000,416240000,7501,2500,5001,2500,0,1,2502,12339159,12.339159
6900,3700,2500,25530000,2,20006,5003,1,416240000,416240000,7501,2500,5001,2500,0,1,2502,12114676,12.114676
6900,3700,2500,25530000,2,20006,5003,1,416240000,416240000,7501,2500,5001,2500,0,1,2502,12409144,12.409144
6900,3700,2900,25530000,2,23206,5803,1,450160000,450160000,8701,2900,5801,2900,0,1,2902,13985906,13.985906
6900,3700,2900,25530000,2,23206,5803,1,450160000,450160000,8701,2900,5801,2900,0,1,2902,14508022,14.508022
6900,3700,2900,25530000,2,23206,5803,1,450160000,450160000,8701,2900,5801,2900,0,1,2902,13695941,13.695941
6900,3700,2900,25530000,2,23206,5803,1,450160000,450160000,8701,2900,5801,2900,0,1,2902,14255630,14.25563
6900,3700,2900,25530000,2,23206,5803,1,450160000,450160000,8701,2900,5801,2900,0,1,2902,13916687,13.916687
6900,3700,2900,25530000,2,23206,5803,1,450160000,450160000,8701,2900,5801,2900,0,1,2902,14157053,14.157053
6900,3700,2900,25530000,2,23206,5803,1,450160000,450160000,8701,2900,5801,2900,0,1,2902,13882723,13.882723
6900,3700,2900,25530000,2,23206,5803,1,450160000,450160000,8701,2900,5801,2900,0,1,2902,14229542,14.229542
6900,3700,3300,25530000,2,26406,6603,1,484080000,484080000,9901,3300,6601,3300,0,1,3302,16027227,16.027227
6900,3700,3300,25530000,2,26406,6603,1,484080000,484080000,9901,3300,6601,3300,0,1,3302,16575845,16.575845
6900,3700,3300,25530000,2,26406,6603,1,484080000,484080000,9901,3300,6601,3300,0,1,3302,15704533,15.704533
6900,3700,3300,25530000,2,26406,6603,1,484080000,484080000,9901,3300,6601,3300,0,1,3302,16321823,16.321823
6900,3700,3300,25530000,2,26406,6603,1,484080000,484080000,9901,3300,6601,3300,0,1,3302,15970877,15.970877
6900,3700,3300,25530000,2,26406,6603,1,484080000,484080000,9901,3300,6601,3300,0,1,3302,16163013,16.163013
6900,3700,3300,25530000,2,26406,6603,1,484080000,484080000,9901,3300,6601,3300,0,1,3302,15953013,15.953013
6900,3700,3300,25530000,2,26406,6603,1,484080000,484080000,9901,3300,6601,3300,0,1,3302,16272206,16.272206
6900,3700,3700,25530000,2,29606,7403,1,518000000,518000000,11101,3700,7401,3700,0,1,3702,17958685,17.958685
6900,3700,3700,25530000,2,29606,7403,1,518000000,518000000,11101,3700,7401,3700,0,1,3702,18498341,18.498341
6900,3700,3700,25530000,2,29606,7403,1,518000000,518000000,11101,3700,7401,3700,0,1,3702,17590432,17.590432
6900,3700,3700,25530000,2,29606,7403,1,518000000,518000000,11101,3700,7401,3700,0,1,3702,18223296,18.223296
6900,3700,3700,25530000,2,29606,7403,1,518000000,518000000,11101,3700,7401,3700,0,1,3702,17706866,17.706866
6900,3700,3700,25530000,2,29606,7403,1,518000000,518000000,11101,3700,7401,3700,0,1,3702,18101187,18.101187
6900,3700,3700,25530000,2,29606,7403,1,518000000,518000000,11101,3700,7401,3700,0,1,3702,17756859,17.756859
6900,3700,3700,25530000,2,29606,7403,1,518000000,518000000,11101,3700,7401,3700,0,1,3702,18195435,18.195435
6900,3700,4100,25530000,2,32806,8203,1,551920000,551920000,12301,4100,8201,4100,0,1,4102,19838217,19.838217
6900,3700,4100,25530000,2,32806,8203,1,551920000,551920000,12301,4100,8201,4100,0,1,4102,20454741,20.454741
6900,3700,4100,25530000,2,32806,8203,1,551920000,551920000,12301,4100,8201,4100,0,1,4102,19426007,19.426007
6900,3700,4100,25530000,2,32806,8203,1,551920000,551920000,12301,4100,8201,4100,0,1,4102,20143307,20.143307
6900,3700,4100,25530000,2,32806,8203,1,551920000,551920000,12301,4100,8201,4100,0,1,4102,19618901,19.618901
6900,3700,4100,25530000,2,32806,8203,1,551920000,551920000,12301,4100,8201,4100,0,1,4102,19967381,19.967381
6900,3700,4100,25530000,2,32806,8203,1,551920000,551920000,12301,4100,8201,4100,0,1,4102,19580342,19.580342
6900,3700,4100,25530000,2,32806,8203,1,551920000,551920000,12301,4100,8201,4100,0,1,4102,20172091,20.172091
6900,3700,4500,25530000,2,36006,9003,1,585840000,585840000,13501,4500,9001,4500,0,1,4502,21734690,21.73469
6900,3700,4500,25530000,2,36006,9003,1,585840000,585840000,13501,4500,9001,4500,0,1,4502,22487728,22.487728
6900,3700,4500,25530000,2,36006,9003,1,585840000,585840000,13501,4500,9001,4500,0,1,4502,21274249,21.274249
6900,3700,4500,25530000,2,36006,9003,1,585840000,585840000,13501,4500,9001,4500,0,1,4502,22134266,22.134266
6900,3700,4500,25530000,2,36006,9003,1,585840000,585840000,13501,4500,9001,4500,0,1,4502,21590085,21.590085
6900,3700,4500,25530000,2,36006,9003,1,585840000,585840000,13501,4500,9001,4500,0,1,4502,21970992,21.970992
6900,3700,4500,25530000,2,36006,9003,1,585840000,585840000,13501,4500,9001,4500,0,1,4502,21607547,21.607547
6900,3700,4500,25530000,2,36006,9003,1,585840000,585840000,13501,4500,9001,4500,0,1,4502,22079129,22.079129
6900,3700,4900,25530000,2,39206,9803,1,619760000,619760000,14701,4900,9801,4900,0,1,4902,23642308,23.642308
6900,3700,4900,25530000,2,39206,9803,1,619760000,619760000,14701,4900,9801,4900,0,1,4902,24457472,24.457472
6900,3700,4900,25530000,2,39206,9803,1,619760000,619760000,14701,4900,9801,4900,0,1,4902,23142177,23.142177
6900,3700,4900,25530000,2,39206,9803,1,619760000,619760000,14701,4900,9801,4900,0,1,4902,24124598,24.124598
6900,3700,4900,25530000,2,39206,9803,1,619760000,619760000,14701,4900,9801,4900,0,1,4902,23504045,23.504045
6900,3700,4900,25530000,2,39206,9803,1,619760000,619760000,14701,4900,9801,4900,0,1,4902,23855603,23.855603
6900,3700,4900,25530000,2,39206,9803,1,619760000,619760000,14701,4900,9801,4900,0,1,4902,23521495,23.521495
6900,3700,4900,25530000,2,39206,9803,1,619760000,619760000,14701,4900,9801,4900,0,1,4902,24029820,24.02982
6900,3700,5300,25530000,2,42406,10603,1,653680000,653680000,15901,5300,10601,5300,0,1,5302,25572874,25.572874
6900,3700,5300,25530000,2,42406,10603,1,653680000,653680000,15901,5300,10601,5300,0,1,5302,26402664,26.402664
6900,3700,5300,25530000,2,42406,10603,1,653680000,653680000,15901,5300,10601,5300,0,1,5302,25083360,25.08336
6900,3700,5300,25530000,2,42406,10603,1,653680000,653680000,15901,5300,10601,5300,0,1,5302,26116012,26.116012
6900,3700,5300,25530000,2,42406,10603,1,653680000,653680000,15901,5300,10601,5300,0,1,5302,25406214,25.406214
6900,3700,5300,25530000,2,42406,10603,1,653680000,653680000,15901,5300,10601,5300,0,1,5302,25839242,25.839242
6900,3700,5300,25530000,2,42406,10603,1,653680000,653680000,15901,5300,10601,5300,0,1,5302,25437298,25.437298
6900,3700,5300,25530000,2,42406,10603,1,653680000,653680000,15901,5300,10601,5300,0,1,5302,25949490,25.94949
6900,3700,5700,25530000,2,45606,11403,1,687600000,687600000,17101,5700,11401,5700,0,1,5702,27464975,27.464975
6900,3700,5700,25530000,2,45606,11403,1,687600000,687600000,17101,5700,11401,5700,0,1,5702,28443584,28.443584
6900,3700,5700,25530000,2,45606,11403,1,687600000,687600000,17101,5700,11401,5700,0,1,5702,26905269,26.905269
6900,3700,5700,25530000,2,45606,11403,1,687600000,687600000,17101,5700,11401,5700,0,1,5702,28018008,28.018008
6900,3700,5700,25530000,2,45606,11403,1,687600000,687600000,17101,5700,11401,5700,0,1,5702,27234673,27.234673
6900,3700,5700,25530000,2,45606,11403,1,687600000,687600000,17101,5700,11401,5700,0,1,5702,27725199,27.725199
6900,3700,5700,25530000,2,45606,11403,1,687600000,687600000,17101,5700,11401,5700,0,1,5702,27252081,27.252081
6900,3700,5700,25530000,2,45606,11403,1,687600000,687600000,17101,5700,11401,5700,0,1,5702,27883224,27.883224
6900,3700,6100,25530000,2,48806,12203,1,721520000,721520000,18301,6100,12201,6100,0,1,6102,29444023,29.444023
6900,3700,6100,25530000,2,48806,12203,1,721520000,721520000,18301,6100,12201,6100,0,1,6102,30361498,30.361498
6900,3700,6100,25530000,2,48806,12203,1,721520000,721520000,18301,6100,12201,6100,0,1,6102,28813008,28.813008
6900,3700,6100,25530000,2,48806,12203,1,721520000,721520000,18301,6100,12201,6100,0,1,6102,30048115,30.048115
6900,3700,6100,25530000,2,48806,12203,1,721520000,721520000,18301,6100,12201,6100,0,1,6102,29128927,29.128927
6900,3700,6100,25530000,2,48806,12203,1,721520000,721520000,18301,6100,12201,6100,0,1,6102,29726965,29.726965
6900,3700,6100,25530000,2,48806,12203,1,721520000,721520000,18301,6100,12201,6100,0,1,6102,29096000,29.096
6900,3700,6100,25530000,2,48806,12203,1,721520000,721520000,18301,6100,12201,6100,0,1,6102,29938908,29.938908
6900,3700,6500,25530000,2,52006,13003,1,755440000,755440000,19501,6500,13001,6500,0,1,6502,31302289,31.302289
6900,3700,6500,25530000,2,52006,13003,1,755440000,755440000,19501,6500,13001,6500,0,1,6502,32485205,32.485205
6900,3700,6500,25530000,2,52006,13003,1,755440000,755440000,19501,6500,13001,6500,0,1,6502,30650939,30.650939
6900,3700,6500,25530000,2,52006,13003,1,755440000,755440000,19501,6500,13001,6500,0,1,6502,32004691,32.004691
6900,3700,6500,25530000,2,52006,13003,1,755440000,755440000,19501,6500,13001,6500,0,1,6502,31071719,31.071719
6900,3700,6500,25530000,2,52006,13003,1,755440000,755440000,19501,6500,13001,6500,0,1,6502,31599410,31.59941
6900,3700,6500,25530000,2,52006,13003,1,755440000,755440000,19501,6500,13001,6500,0,1,6502,30964865,30.964865
6900,3700,6500,25530000,2,52006,13003,1,755440000,755440000,19501,6500,13001,6500,0,1,6502,31786762,31.786762
6900,3700,6900,25530000,2,55206,13803,1,789360000,789360000,20701,6900,13801,6900,0,1,6902,33220091,33.220091
6900,3700,6900,25530000,2,55206,13803,1,789360000,789360000,20701,6900,13801,6900,0,1,6902,34438485,34.438485
6900,3700,6900,25530000,2,55206,13803,1,789360000,789360000,20701,6900,13801,6900,0,1,6902,32556167,32.556167
6900,3700,6900,25530000,2,55206,13803,1,789360000,789360000,20701,6900,13801,6900,0,1,6902,33950423,33.950423
6900,3700,6900,25530000,2,55206,13803,1,789360000,789360000,20701,6900,13801,6900,0,1,6902,32912757,32.912757
6900,3700,6900,25530000,2,55206,13803,1,789360000,789360000,20701,6900,13801,6900,0,1,6902,33547159,33.547159
6900,3700,6900,25530000,2,55206,13803,1,789360000,789360000,20701,6900,13801,6900,0,1,6902,32841221,32.841221
6900,3700,6900,25530000,2,55206,13803,1,789360000,789360000,20701,6900,13801,6900,0,1,6902,33802649,33.802649
6900,3300,500,22770000,2,4006,1003,1,222960000,222960000,1501,500,1001,500,0,1,502,2486097,2.486097
6900,3300,500,22770000,2,4006,1003,1,222960000,222960000,1501,500,1001,500,0,1,502,2407941,2.407941
6900,3300,500,22770000,2,4006,1003,1,222960000,222960000,1501,500,1001,500,0,1,502,2428400,2.4284
6900,3300,500,22770000,2,4006,1003,1,222960000,222960000,1501,500,1001,500,0,1,502,2536097,2.536097
6900,3300,500,22770000,2,4006,1003,1,222960000,222960000,1501,500,1001,500,0,1,502,2519719,2.519719
6900,3300,500,22770000,2,4006,1003,1,222960000,222960000,1501,500,1001,500,0,1,502,2552239,2.552239
6900,3300,500,22770000,2,4006,1003,1,222960000,222960000,1501,500,1001,500,0,1,502,2503161,2.503161
6900,3300,500,22770000,2,4006,1003,1,222960000,222960000,1501,500,1001,500,0,1,502,2470251,2.470251
6900,3300,900,22770000,2,7206,1803,1,255600000,255600000,2701,900,1801,900,0,1,902,4005609,4.005609
6900,3300,900,22770000,2,7206,1803,1,255600000,255600000,2701,900,1801,900,0,1,902,4246852,4.246852
6900,3300,900,22770000,2,7206,1803,1,255600000,255600000,2701,900,1801,900,0,1,902,3940176,3.940176
6900,3300,900,22770000,2,7206,1803,1,255600000,255600000,2701,900,1801,900,0,1,902,4130800,4.1308
6900,3300,900,22770000,2,7206,1803,1,255600000,255600000,2701,900,1801,900,0,1,902,4024801,4.024801
6900,3300,900,22770000,2,7206,1803,1,255600000,255600000,2701,900,1801,900,0,1,902,4083659,4.083659
6900,3300,900,22770000,2,7206,1803,1,255600000,255600000,2701,900,1801,900,0,1,902,3962937,3.962937
6900,3300,900,22770000,2,7206,1803,1,255600000,255600000,2701,900,1801,900,0,1,902,4067395,4.067395
6900,3300,1300,22770000,2,10406,2603,1,288240000,288240000,3901,1300,2601,1300,0,1,1302,5707762,5.707762
6900,3300,1300,22770000,2,10406,2603,1,288240000,288240000,3901,1300,2601,1300,0,1,1302,5907186,5.907186
6900,3300,1300,22770000,2,10406,2603,1,288240000,288240000,3901,1300,2601,1300,0,1,1302,5596160,5.59616
6900,3300,1300,22770000,2,10406,2603,1,288240000,288240000,3901,1300,2601,1300,0,1,1302,5851862,5.851862
6900,3300,1300,22770000,2,10406,2603,1,288240000,288240000,3901,1300,2601,1300,0,1,1302,5691914,5.691914
6900,3300,1300,22770000,2,10406,2603,1,288240000,288240000,3901,1300,2601,1300,0,1,1302,5800614,5.800614
6900,3300,1300,22770000,2,10406,2603,1,288240000,288240000,3901,1300,2601,1300,0,1,1302,5637892,5.637892
6900,3300,1300,22770000,2,10406,2603,1,288240000,288240000,3901,1300,2601,1300,0,1,1302,5785197,5.785197
6900,3300,1700,22770000,2,13606,3403,1,320880000,320880000,5101,1700,3401,1700,0,1,1702,7404938,7.404938
6900,3300,1700,22770000,2,13606,3403,1,320880000,320880000,5101,1700,3401,1700,0,1,1702,7650247,7.650247
6900,3300,1700,22770000,2,13606,3403,1,320880000,320880000,5101,1700,3401,1700,0,1,1702,7256496,7.256496
6900,3300,1700,22770000,2,13606,3403,1,320880000,320880000,5101,1700,3401,1700,0,1,1702,7546002,7.546002
6900,3300,1700,22770000,2,13606,3403,1,320880000,320880000,5101,1700,3401,1700,0,1,1702,7389151,7.389151
6900,3300,1700,22770000,2,13606,3403,1,320880000,320880000,5101,1700,3401,1700,0,1,1702,7504113,7.504113
6900,3300,1700,22770000,2,13606,3403,1,320880000,320880000,5101,1700,3401,1700,0,1,1702,7334712,7.334712
6900,3300,1700,22770000,2,13606,3403,1,320880000,320880000,5101,1700,3401,1700,0,1,1702,7520327,7.520327
6900,3300,2100,22770000,2,16806,4203,1,353520000,353520000,6301,2100,4201,2100,0,1,2102,9245216,9.245216
6900,3300,2100,22770000,2,16806,4203,1,353520000,353520000,6301,2100,4201,2100,0,1,2102,9540342,9.540342
6900,3300,2100,22770000,2,16806,4203,1,353520000,353520000,6301,2100,4201,2100,0,1,2102,9048141,9.048141
6900,3300,2100,22770000,2,16806,4203,1,353520000,353520000,6301,2100,4201,2100,0,1,2102,9398163,9.398163
6900,3300,2100,22770000,2,16806,4203,1,353520000,353520000,6301,2100,4201,2100,0,1,2102,9223737,9.223737
6900,3300,2100,22770000,2,16806,4203,1,353520000,353520000,6301,2100,4201,2100,0,1,2102,9311630,9.31163
6900,3300,2100,22770000,2,16806,4203,1,353520000,353520000,6301,2100,4201,2100,0,1,2102,9242431,9.242431
6900,3300,2100,22770000,2,16806,4203,1,353520000,353520000,6301,2100,4201,2100,0,1,2102,9357781,9.357781
6900,3300,2500,22770000,2,20006,5003,1,386160000,386160000,7501,2500,5001,2500,0,1,2502,10782278,10.782278
6900,3300,2500,22770000,2,20006,5003,1,386160000,386160000,7501,2500,5001,2500,0,1,2502,11165453,11.165453
6900,3300,2500,22770000,2,20006,5003,1,386160000,386160000,7501,2500,5001,2500,0,1,2502,10577752,10.577752
6900,3300,2500,22770000,2,20006,5003,1,386160000,386160000,7501,2500,5001,2500,0,1,2502,10974892,10.974892
6900,3300,2500,22770000,2,20006,5003,1,386160000,386160000,7501,2500,5001,2500,0,1,2502,10740020,10.74002
6900,3300,2500,22770000,2,20006,5003,1,386160000,386160000,7501,2500,5001,2500,0,1,2502,10918210,10.91821
6900,3300,2500,22770000,2,20006,5003,1,386160000,386160000,7501,2500,5001,2500,0,1,2502,10702719,10.702719
6900,3300,2500,22770000,2,20006,5003,1,386160000,386160000,7501,2500,5001,2500,0,1,2502,10958683,10.958683
6900,3300,2900,22770000,2,23206,5803,1,418800000,418800000,8701,2900,5801,2900,0,1,2902,12611155,12.611155
6900,3300,2900,22770000,2,23206,5803,1,418800000,418800000,8701,2900,5801,2900,0,1,2902,13033596,13.033596
6900,3300,2900,22770000,2,23206,5803,1,418800000,418800000,8701,2900,5801,2900,0,1,2902,12406516,12.406516
6900,3300,2900,22770000,2,23206,5803,1,418800000,418800000,8701,2900,5801,2900,0,1,2902,12818532,12.818532
6900,3300,2900,22770000,2,23206,5803,1,418800000,418800000,8701,2900,5801,2900,0,1,2902,12587171,12.587171
6900,3300,2900,22770000,2,23206,5803,1,418800000,418800000,8701,2900,5801,2900,0,1,2902,12773693,12.773693
6900,3300,2900,22770000,2,23206,5803,1,418800000,418800000,8701,2900,5801,2900,0,1,2902,12551831,12.551831
6900,3300,2900,22770000,2,23206,5803,1,418800000,418800000,8701,2900,5801,2900,0,1,2902,12796352,12.796352
6900,3300,3300,22770000,2,26406,6603,1,451440000,451440000,9901,3300,6601,3300,0,1,3302,14345787,14.345787
6900,3300,3300,22770000,2,26406,6603,1,451440000,451440000,9901,3300,6601,3300,0,1,3302,14794259,14.794259
6900,3300,3300,22770000,2,26406,6603,1,451440000,451440000,9901,3300,6601,3300,0,1,3302,14069304,14.069304
6900,3300,3300,22770000,2,26406,6603,1,451440000,451440000,9901,3300,6601,3300,0,1,3302,14549102,14.549102
6900,3300,3300,22770000,2,26406,6603,1,451440000,451440000,9901,3300,6601,3300,0,1,3302,14280914,14.280914
6900,3300,3300,22770000,2,26406,6603,1,451440000,451440000,9901,3300,6601,3300,0,1,3302,14467679,14.467679
6900,3300,3300,22770000,2,26406,6603,1,451440000,451440000,9901,3300,6601,3300,0,1,3302,14222634,14.222634
6900,3300,3300,22770000,2,26406,6603,1,451440000,451440000,9901,3300,6601,3300,0,1,3302,14514440,14.51444
6900,3300,3700,22770000,2,29606,7403,1,484080000,484080000,11101,3700,7401,3700,0,1,3702,16033698,16.033698
6900,3300,3700,22770000,2,29606,7403,1,484080000,484080000,11101,3700,7401,3700,0,1,3702,16540023,16.540023
6900,3300,3700,22770000,2,29606,7403,1,484080000,484080000,11101,3700,7401,3700,0,1,3702,15701032,15.701032
6900,3300,3700,22770000,2,29606,7403,1,484080000,484080000,11101,3700,7401,3700,0,1,3702,16275376,16.275376
6900,3300,3700,22770000,2,29606,7403,1,484080000,484080000,11101,3700,7401,3700,0,1,3702,15952651,15.952651
6900,3300,3700,22770000,2,29606,7403,1,484080000,484080000,11101,3700,7401,3700,0,1,3702,16185093,16.185093
6900,3300,3700,22770000,2,29606,7403,1,484080000,484080000,11101,3700,7401,3700,0,1,3702,15873329,15.873329
6900,3300,3700,22770000,2,29606,7403,1,484080000,484080000,11101,3700,7401,3700,0,1,3702,16243458,16.243458
6900,3300,4100,22770000,2,32806,8203,1,516720000,516720000,12301,4100,8201,4100,0,1,4102,17745983,17.745983
6900,3300,4100,22770000,2,32806,8203,1,516720000,516720000,12301,4100,8201,4100,0,1,4102,18309819,18.309819
6900,3300,4100,22770000,2,32806,8203,1,516720000,516720000,12301,4100,8201,4100,0,1,4102,17380619,17.380619
6900,3300,4100,22770000,2,32806,8203,1,516720000,516720000,12301,4100,8201,4100,0,1,4102,17993930,17.99393
6900,3300,4100,22770000,2,32806,8203,1,516720000,516720000,12301,4100,8201,4100,0,1,4102,17585491,17.585491
6900,3300,4100,22770000,2,32806,8203,1,516720000,516720000,12301,4100,8201,4100,0,1,4102,17868040,17.86804
6900,3300,4100,22770000,2,32806,8203,1,516720000,516720000,12301,4100,8201,4100,0,1,4102,17535981,17.535981
6900,3300,4100,22770000,2,32806,8203,1,516720000,516720000,12301,4100,8201,4100,0,1,4102,17967725,17.967725
6900,3300,4500,22770000,2,36006,9003,1,549360000,549360000,13501,4500,9001,4500,0,1,4502,19455612,19.455612
6900,3300,4500,22770000,2,36006,9003,1,549360000,549360000,13501,4500,9001,4500,0,1,4502,20043682,20.043682
6900,3300,4500,22770000,2,36006,9003,1,549360000,549360000,13501,4500,9001,4500,0,1,4502,19028747,19.028747
6900,3300,4500,22770000,2,36006,9003,1,549360000,549360000,13501,4500,9001,4500,0,1,4502,19768659,19.768659
6900,3300,4500,22770000,2,36006,9003,1,549360000,549360000,13501,4500,9001,4500,0,1,4502,19283782,19.283782
6900,3300,4500,22770000,2,36006,9003,1,549360000,549360000,13501,4500,9001,4500,0,1,4502,19605514,19.605514
6900,3300,4500,22770000,2,36006,9003,1,549360000,549360000,13501,4500,9001,4500,0,1,4502,19240853,19.240853
6900,3300,4500,22770000,2,36006,9003,1,549360000,549360000,13501,4500,9001,4500,0,1,4502,19814791,19.814791
6900,3300,4900,22770000,2,39206,9803,1,582000000,582000000,14701,4900,9801,4900,0,1,4902,21116509,21.116509
6900,3300,4900,22770000,2,39206,9803,1,582000000,582000000,14701,4900,9801,4900,0,1,4902,21855660,21.85566
6900,3300,4900,22770000,2,39206,9803,1,582000000,582000000,14701,4900,9801,4900,0,1,4902,20659845,20.659845
6900,3300,4900,22770000,2,39206,9803,1,582000000,582000000,14701,4900,9801,4900,0,1,4902,21480105,21.480105
6900,3300,4900,22770000,2,39206,9803,1,582000000,582000000,14701,4900,9801,4900,0,1,4902,20929671,20.929671
6900,3300,4900,22770000,2,39206,9803,1,582000000,582000000,14701,4900,9801,4900,0,1,4902,21316973,21.316973
6900,3300,4900,22770000,2,39206,9803,1,582000000,582000000,14701,4900,9801,4900,0,1,4902,20899434,20.899434
6900,3300,4900,22770000,2,39206,9803,1,582000000,582000000,14701,4900,9801,4900,0,1,4902,21465016,21.465016
6900,3300,5300,22770000,2,42406,10603,1,614640000,614640000,15901,5300,10601,5300,0,1,5302,22771688,22.771688
6900,3300,5300,22770000,2,42406,10603,1,614640000,614640000,15901,5300,10601,5300,0,1,5302,23570064,23.570064
6900,3300,5300,22770000,2,42406,10603,1,614640000,614640000,15901,5300,10601,5300,0,1,5302,22361250,22.36125
6900,3300,5300,22770000,2,42406,10603,1,614640000,614640000,15901,5300,10601,5300,0,1,5302,23240035,23.240035
6900,3300,5300,22770000,2,42406,10603,1,614640000,614640000,15901,5300,10601,5300,0,1,5302,22594293,22.594293
6900,3300,5300,22770000,2,42406,10603,1,614640000,614640000,15901,5300,10601,5300,0,1,5302,23009519,23.009519
6900,3300,5300,22770000,2,42406,10603,1,614640000,614640000,15901,5300,10601,5300,0,1,5302,22530387,22.530387
6900,3300,5300,22770000,2,42406,10603,1,614640000,614640000,15901,5300,10601,5300,0,1,5302,23147110,23.14711
6900,3300,5700,22770000,2,45606,11403,1,647280000,647280000,17101,5700,11401,5700,0,1,5702,24516396,24.516396
6900,3300,5700,22770000,2,45606,11403,1,647280000,647280000,17101,5700,11401,5700,0,1,5702,25348788,25.348788
6900,3300,5700,22770000,2,45606,11403,1,647280000,647280000,17101,5700,11401,5700,0,1,5702,24030821,24.030821
6900,3300,5700,22770000,2,45606,11403,1,647280000,647280000,17101,5700,11401,5700,0,1,5702,24945441,24.945441
6900,3300,5700,22770000,2,45606,11403,1,647280000,647280000,17101,5700,11401,5700,0,1,5702,24283656,24.283656
6900,3300,5700,22770000,2,45606,11403,1,647280000,647280000,17101,5700,11401,5700,0,1,5702,24729747,24.729747
6900,3300,5700,22770000,2,45606,11403,1,647280000,647280000,17101,5700,11401,5700,0,1,5702,24215460,24.21546
6900,3300,5700,22770000,2,45606,11403,1,647280000,647280000,17101,5700,11401,5700,0,1,5702,24915704,24.915704
6900,3300,6100,22770000,2,48806,12203,1,679920000,679920000,18301,6100,12201,6100,0,1,6102,26218613,26.218613
6900,3300,6100,22770000,2,48806,12203,1,679920000,679920000,18301,6100,12201,6100,0,1,6102,27131476,27.131476
6900,3300,6100,22770000,2,48806,12203,1,679920000,679920000,18301,6100,12201,6100,0,1,6102,25644171,25.644171
6900,3300,6100,22770000,2,48806,12203,1,679920000,679920000,18301,6100,12201,6100,0,1,6102,26733019,26.733019
6900,3300,6100,22770000,2,48806,12203,1,679920000,679920000,18301,6100,12201,6100,0,1,6102,26025910,26.02591
6900,3300,6100,22770000,2,48806,12203,1,679920000,679920000,18301,6100,12201,6100,0,1,6102,26430028,26.430028
6900,3300,6100,22770000,2,48806,12203,1,679920000,679920000,18301,6100,12201,6100,0,1,6102,25961684,25.961684
6900,3300,6100,22770000,2,48806,12203,1,679920000,679920000,18301,6100,12201,6100,0,1,6102,26662337,26.662337
6900,3300,6500,22770000,2,52006,13003,1,712560000,712560000,19501,6500,13001,6500,0,1,6502,27914191,27.914191
6900,3300,6500,22770000,2,52006,13003,1,712560000,712560000,19501,6500,13001,6500,0,1,6502,28924710,28.92471
6900,3300,6500,22770000,2,52006,13003,1,712560000,712560000,19501,6500,13001,6500,0,1,6502,27411302,27.411302
6900,3300,6500,22770000,2,52006,13003,1,712560000,712560000,19501,6500,13001,6500,0,1,6502,28402860,28.40286
6900,3300,6500,22770000,2,52006,13003,1,712560000,712560000,19501,6500,13001,6500,0,1,6502,27748078,27.748078
6900,3300,6500,22770000,2,52006,13003,1,712560000,712560000,19501,6500,13001,6500,0,1,6502,28274080,28.27408
6900,3300,6500,22770000,2,52006,13003,1,712560000,712560000,19501,6500,13001,6500,0,1,6502,27619128,27.619128
6900,3300,6500,22770000,2,52006,13003,1,712560000,712560000,19501,6500,13001,6500,0,1,6502,28481460,28.48146
6900,3300,6900,22770000,2,55206,13803,1,745200000,745200000,20701,6900,13801,6900,0,1,6902,29635321,29.635321
6900,3300,6900,22770000,2,55206,13803,1,745200000,745200000,20701,6900,13801,6900,0,1,6902,30706447,30.706447
6900,3300,6900,22770000,2,55206,13803,1,745200000,745200000,20701,6900,13801,6900,0,1,6902,29077100,29.0771
6900,3300,6900,22770000,2,55206,13803,1,745200000,745200000,20701,6900,13801,6900,0,1,6902,30280267,30.280267
6900,3300,6900,22770000,2,55206,13803,1,745200000,745200000,20701,6900,13801,6900,0,1,6902,29376980,29.37698
6900,3300,6900,22770000,2,55206,13803,1,745200000,745200000,20701,6900,13801,6900,0,1,6902,29987136,29.987136
6900,3300,6900,22770000,2,55206,13803,1,745200000,745200000,20701,6900,13801,6900,0,1,6902,29322086,29.322086
6900,3300,6900,22770000,2,55206,13803,1,745200000,745200000,20701,6900,13801,6900,0,1,6902,30147500,30.1475
6900,2900,500,20010000,2,4006,1003,1,199280000,199280000,1501,500,1001,500,0,1,502,2196427,2.196427
6900,2900,500,20010000,2,4006,1003,1,199280000,199280000,1501,500,1001,500,0,1,502,2116096,2.116096
6900,2900,500,20010000,2,4006,1003,1,199280000,199280000,1501,500,1001,500,0,1,502,2210703,2.210703
6900,2900,500,20010000,2,4006,1003,1,199280000,199280000,1501,500,1001,500,0,1,502,2130557,2.130557
6900,2900,500,20010000,2,4006,1003,1,199280000,199280000,1501,500,1001,500,0,1,502,2144637,2.144637
6900,2900,500,20010000,2,4006,1003,1,199280000,199280000,1501,500,1001,500,0,1,502,2224572,2.224572
6900,2900,500,20010000,2,4006,1003,1,199280000,199280000,1501,500,1001,500,0,1,502,2210362,2.210362
6900,2900,500,20010000,2,4006,1003,1,199280000,199280000,1501,500,1001,500,0,1,502,2101320,2.10132
6900,2900,900,20010000,2,7206,1803,1,230640000,230640000,2701,900,1801,900,0,1,902,3537412,3.537412
6900,2900,900,20010000,2,7206,1803,1,230640000,230640000,2701,900,1801,900,0,1,902,3734725,3.734725
6900,2900,900,20010000,2,7206,1803,1,230640000,230640000,2701,900,1801,900,0,1,902,3478613,3.478613
6900,2900,900,20010000,2,7206,1803,1,230640000,230640000,2701,900,1801,900,0,1,902,3633901,3.633901
6900,2900,900,20010000,2,7206,1803,1,230640000,230640000,2701,900,1801,900,0,1,902,3554266,3.554266
6900,2900,900,20010000,2,7206,1803,1,230640000,230640000,2701,900,1801,900,0,1,902,3590094,3.590094
6900,2900,900,20010000,2,7206,1803,1,230640000,230640000,2701,900,1801,900,0,1,902,3492296,3.492296
6900,2900,900,20010000,2,7206,1803,1,230640000,230640000,2701,900,1801,900,0,1,902,3573606,3.573606
6900,2900,1300,20010000,2,10406,2603,1,262000000,262000000,3901,1300,2601,1300,0,1,1302,5030594,5.030594
6900,2900,1300,20010000,2,10406,2603,1,262000000,262000000,3901,1300,2601,1300,0,1,1302,5194370,5.19437
6900,2900,1300,20010000,2,10406,2603,1,262000000,262000000,3901,1300,2601,1300,0,1,1302,4928095,4.928095
6900,2900,1300,20010000,2,10406,2603,1,262000000,262000000,3901,1300,2601,1300,0,1,1302,5149122,5.149122
6900,2900,1300,20010000,2,10406,2603,1,262000000,262000000,3901,1300,2601,1300,0,1,1302,5016616,5.016616
6900,2900,1300,20010000,2,10406,2603,1,262000000,262000000,3901,1300,2601,1300,0,1,1302,5104468,5.104468
6900,2900,1300,20010000,2,10406,2603,1,262000000,262000000,3901,1300,2601,1300,0,1,1302,4958132,4.958132
6900,2900,1300,20010000,2,10406,2603,1,262000000,262000000,3901,1300,2601,1300,0,1,1302,5088201,5.088201
6900,2900,1700,20010000,2,13606,3403,1,293360000,293360000,5101,1700,3401,1700,0,1,1702,6505948,6.505948
6900,2900,1700,20010000,2,13606,3403,1,293360000,293360000,5101,1700,3401,1700,0,1,1702,6717616,6.717616
6900,2900,1700,20010000,2,13606,3403,1,293360000,293360000,5101,1700,3401,1700,0,1,1702,6385142,6.385142
6900,2900,1700,20010000,2,13606,3403,1,293360000,293360000,5101,1700,3401,1700,0,1,1702,6661915,6.661915
6900,2900,1700,20010000,2,13606,3403,1,293360000,293360000,5101,1700,3401,1700,0,1,1702,6487752,6.487752
6900,2900,1700,20010000,2,13606,3403,1,293360000,293360000,5101,1700,3401,1700,0,1,1702,6591817,6.591817
6900,2900,1700,20010000,2,13606,3403,1,293360000,293360000,5101,1700,3401,1700,0,1,1702,6424927,6.424927
6900,2900,1700,20010000,2,13606,3403,1,293360000,293360000,5101,1700,3401,1700,0,1,1702,6606152,6.606152
6900,2900,2100,20010000,2,16806,4203,1,324720000,324720000,6301,2100,4201,2100,0,1,2102,8165697,8.165697
6900,2900,2100,20010000,2,16806,4203,1,324720000,324720000,6301,2100,4201,2100,0,1,2102,8378298,8.378298
6900,2900,2100,20010000,2,16806,4203,1,324720000,324720000,6301,2100,4201,2100,0,1,2102,7999768,7.999768
6900,2900,2100,20010000,2,16806,4203,1,324720000,324720000,6301,2100,4201,2100,0,1,2102,8264331,8.264331
6900,2900,2100,20010000,2,16806,4203,1,324720000,324720000,6301,2100,4201,2100,0,1,2102,8128408,8.128408
6900,2900,2100,20010000,2,16806,4203,1,324720000,324720000,6301,2100,4201,2100,0,1,2102,8235458,8.235458
6900,2900,2100,20010000,2,16806,4203,1,324720000,324720000,6301,2100,4201,2100,0,1,2102,8031785,8.031785
6900,2900,2100,20010000,2,16806,4203,1,324720000,324720000,6301,2100,4201,2100,0,1,2102,8221114,8.221114
6900,2900,2500,20010000,2,20006,5003,1,356080000,356080000,7501,2500,5001,2500,0,1,2502,9483562,9.483562
6900,2900,2500,20010000,2,20006,5003,1,356080000,356080000,7501,2500,5001,2500,0,1,2502,9805576,9.805576
6900,2900,2500,20010000,2,20006,5003,1,356080000,356080000,7501,2500,5001,2500,0,1,2502,9289599,9.289599
6900,2900,2500,20010000,2,20006,5003,1,356080000,356080000,7501,2500,5001,2500,0,1,2502,9655448,9.655448
6900,2900,2500,20010000,2,20006,5003,1,356080000,356080000,7501,2500,5001,2500,0,1,2502,9454350,9.45435
6900,2900,2500,20010000,2,20006,5003,1,356080000,356080000,7501,2500,5001,2500,0,1,2502,9602277,9.602277
6900,2900,2500,20010000,2,20006,5003,1,356080000,356080000,7501,2500,5001,2500,0,1,2502,9347552,9.347552
6900,2900,2500,20010000,2,20006,5003,1,356080000,356080000,7501,2500,5001,2500,0,1,2502,9633664,9.633664
6900,2900,2900,20010000,2,23206,5803,1,387440000,387440000,8701,2900,5801,2900,0,1,2902,11153200,11.1532
6900,2900,2900,20010000,2,23206,5803,1,387440000,387440000,8701,2900,5801,2900,0,1,2902,11471929,11.471929
6900,2900,2900,20010000,2,23206,5803,1,387440000,387440000,8701,2900,5801,2900,0,1,2902,10919752,10.919752
6900,2900,2900,20010000,2,23206,5803,1,387440000,387440000,8701,2900,5801,2900,0,1,2902,11300874,11.300874
6900,2900,2900,20010000,2,23206,5803,1,387440000,387440000,8701,2900,5801,2900,0,1,2902,11110144,11.110144
6900,2900,2900,20010000,2,23206,5803,1,387440000,387440000,8701,2900,5801,2900,0,1,2902,11280239,11.280239
6900,2900,2900,20010000,2,23206,5803,1,387440000,387440000,8701,2900,5801,2900,0,1,2902,10992047,10.992047
6900,2900,2900,20010000,2,23206,5803,1,387440000,387440000,8701,2900,5801,2900,0,1,2902,11265868,11.265868
6900,2900,3300,20010000,2,26406,6603,1,418800000,418800000,9901,3300,6601,3300,0,1,3302,12604128,12.604128
6900,2900,3300,20010000,2,26406,6603,1,418800000,418800000,9901,3300,6601,3300,0,1,3302,12915775,12.915775
6900,2900,3300,20010000,2,26406,6603,1,418800000,418800000,9901,3300,6601,3300,0,1,3302,12385698,12.385698
6900,2900,3300,20010000,2,26406,6603,1,418800000,418800000,9901,3300,6601,3300,0,1,3302,12828268,12.828268
6900,2900,3300,20010000,2,26406,6603,1,418800000,418800000,9901,3300,6601,3300,0,1,3302,12561992,12.561992
6900,2900,3300,20010000,2,26406,6603,1,418800000,418800000,9901,3300,6601,3300,0,1,3302,12725475,12.725475
6900,2900,3300,20010000,2,26406,6603,1,418800000,418800000,9901,3300,6601,3300,0,1,3302,12478593,12.478593
6900,2900,3300,20010000,2,26406,6603,1,418800000,418800000,9901,3300,6601,3300,0,1,3302,12804246,12.804246
6900,2900,3700,20010000,2,29606,7403,1,450160000,450160000,11101,3700,7401,3700,0,1,3702,13955660,13.95566
6900,2900,3700,20010000,2,29606,7403,1,450160000,450160000,11101,3700,7401,3700,0,1,3702,14566980,14.56698
6900,2900,3700,20010000,2,29606,7403,1,450160000,450160000,11101,3700,7401,3700,0,1,3702,13676370,13.67637
6900,2900,3700,20010000,2,29606,7403,1,450160000,450160000,11101,3700,7401,3700,0,1,3702,14266036,14.266036
6900,2900,3700,20010000,2,29606,7403,1,450160000,450160000,11101,3700,7401,3700,0,1,3702,13873728,13.873728
6900,2900,3700,20010000,2,29606,7403,1,450160000,450160000,11101,3700,7401,3700,0,1,3702,14119768,14.119768
6900,2900,3700,20010000,2,29606,7403,1,450160000,450160000,11101,3700,7401,3700,0,1,3702,13787722,13.787722
6900,2900,3700,20010000,2,29606,7403,1,450160000,450160000,11101,3700,7401,3700,0,1,3702,14193240,14.19324
6900,2900,4100,20010000,2,32806,8203,1,481520000,481520000,12301,4100,8201,4100,0,1,4102,15614293,15.614293
6900,2900,4100,20010000,2,32806,8203,1,481520000,481520000,12301,4100,8201,4100,0,1,4102,16122444,16.122444
6900,2900,4100,20010000,2,32806,8203,1,481520000,481520000,12301,4100,8201,4100,0,1,4102,15288963,15.288963
6900,2900,4100,20010000,2,32806,8203,1,481520000,481520000,12301,4100,8201,4100,0,1,4102,15812530,15.81253
6900,2900,4100,20010000,2,32806,8203,1,481520000,481520000,12301,4100,8201,4100,0,1,4102,15488199,15.488199
6900,2900,4100,20010000,2,32806,8203,1,481520000,481520000,12301,4100,8201,4100,0,1,4102,15751209,15.751209
6900,2900,4100,20010000,2,32806,8203,1,481520000,481520000,12301,4100,8201,4100,0,1,4102,15410955,15.410955
6900,2900,4100,20010000,2,32806,8203,1,481520000,481520000,12301,4100,8201,4100,0,1,4102,15826020,15.82602
6900,2900,4500,20010000,2,36006,9003,1,512880000,512880000,13501,4500,9001,4500,0,1,4502,17084622,17.084622
6900,2900,4500,20010000,2,36006,9003,1,512880000,512880000,13501,4500,9001,4500,0,1,4502,17639879,17.639879
6900,2900,4500,20010000,2,36006,9003,1,512880000,512880000,13501,4500,9001,4500,0,1,4502,16732883,16.732883
6900,2900,4500,20010000,2,36006,9003,1,512880000,512880000,13501,4500,9001,4500,0,1,4502,17332417,17.332417
6900,2900,4500,20010000,2,36006,9003,1,512880000,512880000,13501,4500,9001,4500,0,1,4502,16954010,16.95401
6900,2900,4500,20010000,2,36006,9003,1,512880000,512880000,13501,4500,9001,4500,0,1,4502,17237897,17.237897
6900,2900,4500,20010000,2,36006,9003,1,512880000,512880000,13501,4500,9001,4500,0,1,4502,16864759,16.864759
6900,2900,4500,20010000,2,36006,9003,1,512880000,512880000,13501,4500,9001,4500,0,1,4502,17294968,17.294968
6900,2900,4900,20010000,2,39206,9803,1,544240000,544240000,14701,4900,9801,4900,0,1,4902,18610105,18.610105
6900,2900,4900,20010000,2,39206,9803,1,544240000,544240000,14701,4900,9801,4900,0,1,4902,19182280,19.18228
6900,2900,4900,20010000,2,39206,9803,1,544240000,544240000,14701,4900,9801,4900,0,1,4902,18239377,18.239377
6900,2900,4900,20010000,2,39206,9803,1,544240000,544240000,14701,4900,9801,4900,0,1,4902,18937887,18.937887
6900,2900,4900,20010000,2,39206,9803,1,544240000,544240000,14701,4900,9801,4900,0,1,4902,18375299,18.375299
6900,2900,4900,20010000,2,39206,9803,1,544240000,544240000,14701,4900,9801,4900,0,1,4902,18744143,18.744143
6900,2900,4900,20010000,2,39206,9803,1,544240000,544240000,14701,4900,9801,4900,0,1,4902,18389038,18.389038
6900,2900,4900,20010000,2,39206,9803,1,544240000,544240000,14701,4900,9801,4900,0,1,4902,18882846,18.882846
6900,2900,5300,20010000,2,42406,10603,1,575600000,575600000,15901,5300,10601,5300,0,1,5302,20060832,20.060832
6900,2900,5300,20010000,2,42406,10603,1,575600000,575600000,15901,5300,10601,5300,0,1,5302,20742748,20.742748
6900,2900,5300,20010000,2,42406,10603,1,575600000,575600000,15901,5300,10601,5300,0,1,5302,19673784,19.673784
6900,2900,5300,20010000,2,42406,10603,1,575600000,575600000,15901,5300,10601,5300,0,1,5302,20492375,20.492375
6900,2900,5300,20010000,2,42406,10603,1,575600000,575600000,15901,5300,10601,5300,0,1,5302,19890342,19.890342
6900,2900,5300,20010000,2,42406,10603,1,575600000,575600000,15901,5300,10601,5300,0,1,5302,20237719,20.237719
6900,2900,5300,20010000,2,42406,10603,1,575600000,575600000,15901,5300,10601,5300,0,1,5302,19865817,19.865817
6900,2900,5300,20010000,2,42406,10603,1,575600000,575600000,15901,5300,10601,5300,0,1,5302,20407046,20.407046
6900,2900,5700,20010000,2,45606,11403,1,606960000,606960000,17101,5700,11401,5700,0,1,5702,21558056,21.558056
6900,2900,5700,20010000,2,45606,11403,1,606960000,606960000,17101,5700,11401,5700,0,1,5702,22312840,22.31284
6900,2900,5700,20010000,2,45606,11403,1,606960000,606960000,17101,5700,11401,5700,0,1,5702,21143086,21.143086
6900,2900,5700,20010000,2,45606,11403,1,606960000,606960000,17101,5700,11401,5700,0,1,5702,21892522,21.892522
6900,2900,5700,20010000,2,45606,11403,1,606960000,606960000,17101,5700,11401,5700,0,1,5702,21389636,21.389636
6900,2900,5700,20010000,2,45606,11403,1,606960000,606960000,17101,5700,11401,5700,0,1,5702,21741656,21.741656
6900,2900,5700,20010000,2,45606,11403,1,606960000,606960000,17101,5700,11401,5700,0,1,5702,21296243,21.296243
6900,2900,5700,20010000,2,45606,11403,1,606960000,606960000,17101,5700,11401,5700,0,1,5702,21918443,21.918443
6900,2900,6100,20010000,2,48806,12203,1,638320000,638320000,18301,6100,12201,6100,0,1,6102,23037035,23.037035
6900,2900,6100,20010000,2,48806,12203,1,638320000,638320000,18301,6100,12201,6100,0,1,6102,23858623,23.858623
6900,2900,6100,20010000,2,48806,12203,1,638320000,638320000,18301,6100,12201,6100,0,1,6102,22601165,22.601165
6900,2900,6100,20010000,2,48806,12203,1,638320000,638320000,18301,6100,12201,6100,0,1,6102,23446820,23.44682
6900,2900,6100,20010000,2,48806,12203,1,638320000,638320000,18301,6100,12201,6100,0,1,6102,22869742,22.869742
6900,2900,6100,20010000,2,48806,12203,1,638320000,638320000,18301,6100,12201,6100,0,1,6102,23280412,23.280412
6900,2900,6100,20010000,2,48806,12203,1,638320000,638320000,18301,6100,12201,6100,0,1,6102,22797570,22.79757
6900,2900,6100,20010000,2,48806,12203,1,638320000,638320000,18301,6100,12201,6100,0,1,6102,23431950,23.43195
6900,2900,6500,20010000,2,52006,13003,1,669680000,669680000,19501,6500,13001,6500,0,1,6502,24591926,24.591926
6900,2900,6500,20010000,2,52006,13003,1,669680000,669680000,19501,6500,13001,6500,0,1,6502,25397964,25.397964
6900,2900,6500,20010000,2,52006,13003,1,669680000,669680000,19501,6500,13001,6500,0,1,6502,24070649,24.070649
6900,2900,6500,20010000,2,52006,13003,1,669680000,669680000,19501,6500,13001,6500,0,1,6502,25004182,25.004182
6900,2900,6500,20010000,2,52006,13003,1,669680000,669680000,19501,6500,13001,6500,0,1,6502,24340191,24.340191
6900,2900,6500,20010000,2,52006,13003,1,669680000,669680000,19501,6500,13001,6500,0,1,6502,24777167,24.777167
6900,2900,6500,20010000,2,52006,13003,1,669680000,669680000,19501,6500,13001,6500,0,1,6502,24264774,24.264774
6900,2900,6500,20010000,2,52006,13003,1,669680000,669680000,19501,6500,13001,6500,0,1,6502,25019158,25.019158
6900,2900,6900,20010000,2,55206,13803,1,701040000,701040000,20701,6900,13801,6900,0,1,6902,26074517,26.074517
6900,2900,6900,20010000,2,55206,13803,1,701040000,701040000,20701,6900,13801,6900,0,1,6902,26981213,26.981213
6900,2900,6900,20010000,2,55206,13803,1,701040000,701040000,20701,6900,13801,6900,0,1,6902,25552235,25.552235
6900,2900,6900,20010000,2,55206,13803,1,701040000,701040000,20701,6900,13801,6900,0,1,6902,26573970,26.57397
6900,2900,6900,20010000,2,55206,13803,1,701040000,701040000,20701,6900,13801,6900,0,1,6902,25862388,25.862388
6900,2900,6900,20010000,2,55206,13803,1,701040000,701040000,20701,6900,13801,6900,0,1,6902,26337260,26.33726
6900,2900,6900,20010000,2,55206,13803,1,701040000,701040000,20701,6900,13801,6900,0,1,6902,25768046,25.768046
6900,2900,6900,20010000,2,55206,13803,1,701040000,701040000,20701,6900,13801,6900,0,1,6902,26499551,26.499551
6900,2500,500,17250000,2,4006,1003,1,175600000,175600000,1501,500,1001,500,0,1,502,1916199,1.916199
6900,2500,500,17250000,2,4006,1003,1,175600000,175600000,1501,500,1001,500,0,1,502,1817759,1.817759
6900,2500,500,17250000,2,4006,1003,1,175600000,175600000,1501,500,1001,500,0,1,502,1904245,1.904245
6900,2500,500,17250000,2,4006,1003,1,175600000,175600000,1501,500,1001,500,0,1,502,1829992,1.829992
6900,2500,500,17250000,2,4006,1003,1,175600000,175600000,1501,500,1001,500,0,1,502,1830909,1.830909
6900,2500,500,17250000,2,4006,1003,1,175600000,175600000,1501,500,1001,500,0,1,502,1891297,1.891297
6900,2500,500,17250000,2,4006,1003,1,175600000,175600000,1501,500,1001,500,0,1,502,1871264,1.871264
6900,2500,500,17250000,2,4006,1003,1,175600000,175600000,1501,500,1001,500,0,1,502,1783662,1.783662
6900,2500,900,17250000,2,7206,1803,1,205680000,205680000,2701,900,1801,900,0,1,902,3045054,3.045054
6900,2500,900,17250000,2,7206,1803,1,205680000,205680000,2701,900,1801,900,0,1,902,3149090,3.14909
6900,2500,900,17250000,2,7206,1803,1,205680000,205680000,2701,900,1801,900,0,1,902,2985918,2.985918
6900,2500,900,17250000,2,7206,1803,1,205680000,205680000,2701,900,1801,900,0,1,902,3214641,3.214641
6900,2500,900,17250000,2,7206,1803,1,205680000,205680000,2701,900,1801,900,0,1,902,3024304,3.024304
6900,2500,900,17250000,2,7206,1803,1,205680000,205680000,2701,900,1801,900,0,1,902,3087992,3.087992
6900,2500,900,17250000,2,7206,1803,1,205680000,205680000,2701,900,1801,900,0,1,902,3001228,3.001228
6900,2500,900,17250000,2,7206,1803,1,205680000,205680000,2701,900,1801,900,0,1,902,3226992,3.226992
6900,2500,1300,17250000,2,10406,2603,1,235760000,235760000,3901,1300,2601,1300,0,1,1302,4336791,4.336791
6900,2500,1300,17250000,2,10406,2603,1,235760000,235760000,3901,1300,2601,1300,0,1,1302,4462458,4.462458
6900,2500,1300,17250000,2,10406,2603,1,235760000,235760000,3901,1300,2601,1300,0,1,1302,4247127,4.247127
6900,2500,1300,17250000,2,10406,2603,1,235760000,235760000,3901,1300,2601,1300,0,1,1302,4442020,4.44202
6900,2500,1300,17250000,2,10406,2603,1,235760000,235760000,3901,1300,2601,1300,0,1,1302,4324812,4.324812
6900,2500,1300,17250000,2,10406,2603,1,235760000,235760000,3901,1300,2601,1300,0,1,1302,4401586,4.401586
6900,2500,1300,17250000,2,10406,2603,1,235760000,235760000,3901,1300,2601,1300,0,1,1302,4266807,4.266807
6900,2500,1300,17250000,2,10406,2603,1,235760000,235760000,3901,1300,2601,1300,0,1,1302,4383913,4.383913
6900,2500,1700,17250000,2,13606,3403,1,265840000,265840000,5101,1700,3401,1700,0,1,1702,5623928,5.623928
6900,2500,1700,17250000,2,13606,3403,1,265840000,265840000,5101,1700,3401,1700,0,1,1702,5795835,5.795835
6900,2500,1700,17250000,2,13606,3403,1,265840000,265840000,5101,1700,3401,1700,0,1,1702,5505550,5.50555
6900,2500,1700,17250000,2,13606,3403,1,265840000,265840000,5101,1700,3401,1700,0,1,1702,5747895,5.747895
6900,2500,1700,17250000,2,13606,3403,1,265840000,265840000,5101,1700,3401,1700,0,1,1702,5599532,5.599532
6900,2500,1700,17250000,2,13606,3403,1,265840000,265840000,5101,1700,3401,1700,0,1,1702,5693939,5.693939
6900,2500,1700,17250000,2,13606,3403,1,265840000,265840000,5101,1700,3401,1700,0,1,1702,5533332,5.533332
6900,2500,1700,17250000,2,13606,3403,1,265840000,265840000,5101,1700,3401,1700,0,1,1702,5706244,5.706244
6900,2500,2100,17250000,2,16806,4203,1,295920000,295920000,6301,2100,4201,2100,0,1,2102,6909952,6.909952
6900,2500,2100,17250000,2,16806,4203,1,295920000,295920000,6301,2100,4201,2100,0,1,2102,7137458,7.137458
6900,2500,2100,17250000,2,16806,4203,1,295920000,295920000,6301,2100,4201,2100,0,1,2102,6756290,6.75629
6900,2500,2100,17250000,2,16806,4203,1,295920000,295920000,6301,2100,4201,2100,0,1,2102,7039161,7.039161
6900,2500,2100,17250000,2,16806,4203,1,295920000,295920000,6301,2100,4201,2100,0,1,2102,6880002,6.880002
6900,2500,2100,17250000,2,16806,4203,1,295920000,295920000,6301,2100,4201,2100,0,1,2102,6985942,6.985942
6900,2500,2100,17250000,2,16806,4203,1,295920000,295920000,6301,2100,4201,2100,0,1,2102,6793257,6.793257
6900,2500,2100,17250000,2,16806,4203,1,295920000,295920000,6301,2100,4201,2100,0,1,2102,7002059,7.002059
6900,2500,2500,17250000,2,20006,5003,1,326000000,326000000,7501,2500,5001,2500,0,1,2502,8340749,8.340749
6900,2500,2500,17250000,2,20006,5003,1,326000000,326000000,7501,2500,5001,2500,0,1,2502,8560660,8.56066
6900,2500,2500,17250000,2,20006,5003,1,326000000,326000000,7501,2500,5001,2500,0,1,2502,8202551,8.202551
6900,2500,2500,17250000,2,20006,5003,1,326000000,326000000,7501,2500,5001,2500,0,1,2502,8439788,8.439788
6900,2500,2500,17250000,2,20006,5003,1,326000000,326000000,7501,2500,5001,2500,0,1,2502,8287240,8.28724
6900,2500,2500,17250000,2,20006,5003,1,326000000,326000000,7501,2500,5001,2500,0,1,2502,8394047,8.394047
6900,2500,2500,17250000,2,20006,5003,1,326000000,326000000,7501,2500,5001,2500,0,1,2502,8246655,8.246655
6900,2500,2500,17250000,2,20006,5003,1,326000000,326000000,7501,2500,5001,2500,0,1,2502,8452183,8.452183
6900,2500,2900,17250000,2,23206,5803,1,356080000,356080000,8701,2900,5801,2900,0,1,2902,9474369,9.474369
6900,2500,2900,17250000,2,23206,5803,1,356080000,356080000,8701,2900,5801,2900,0,1,2902,9795177,9.795177
6900,2500,2900,17250000,2,23206,5803,1,356080000,356080000,8701,2900,5801,2900,0,1,2902,9282807,9.282807
6900,2500,2900,17250000,2,23206,5803,1,356080000,356080000,8701,2900,5801,2900,0,1,2902,9622750,9.62275
6900,2500,2900,17250000,2,23206,5803,1,356080000,356080000,8701,2900,5801,2900,0,1,2902,9431993,9.431993
6900,2500,2900,17250000,2,23206,5803,1,356080000,356080000,8701,2900,5801,2900,0,1,2902,9588630,9.58863
6900,2500,2900,17250000,2,23206,5803,1,356080000,356080000,8701,2900,5801,2900,0,1,2902,9342810,9.34281
6900,2500,2900,17250000,2,23206,5803,1,356080000,356080000,8701,2900,5801,2900,0,1,2902,9635951,9.635951
6900,2500,3300,17250000,2,26406,6603,1,386160000,386160000,9901,3300,6601,3300,0,1,3302,10943406,10.943406
6900,2500,3300,17250000,2,26406,6603,1,386160000,386160000,9901,3300,6601,3300,0,1,3302,11203836,11.203836
6900,2500,3300,17250000,2,26406,6603,1,386160000,386160000,9901,3300,6601,3300,0,1,3302,10744921,10.744921
6900,2500,3300,17250000,2,26406,6603,1,386160000,386160000,9901,3300,6601,3300,0,1,3302,11062453,11.062453
6900,2500,3300,17250000,2,26406,6603,1,386160000,386160000,9901,3300,6601,3300,0,1,3302,10828960,10.82896
6900,2500,3300,17250000,2,26406,6603,1,386160000,386160000,9901,3300,6601,3300,0,1,3302,10982398,10.982398
6900,2500,3300,17250000,2,26406,6603,1,386160000,386160000,9901,3300,6601,3300,0,1,3302,10778575,10.778575
6900,2500,3300,17250000,2,26406,6603,1,386160000,386160000,9901,3300,6601,3300,0,1,3302,11062869,11.062869
6900,2500,3700,17250000,2,29606,7403,1,416240000,416240000,11101,3700,7401,3700,0,1,3702,12182622,12.182622
6900,2500,3700,17250000,2,29606,7403,1,416240000,416240000,11101,3700,7401,3700,0,1,3702,12576852,12.576852
6900,2500,3700,17250000,2,29606,7403,1,416240000,416240000,11101,3700,7401,3700,0,1,3702,11927752,11.927752
6900,2500,3700,17250000,2,29606,7403,1,416240000,416240000,11101,3700,7401,3700,0,1,3702,12372818,12.372818
6900,2500,3700,17250000,2,29606,7403,1,416240000,416240000,11101,3700,7401,3700,0,1,3702,12130277,12.130277
6900,2500,3700,17250000,2,29606,7403,1,416240000,416240000,11101,3700,7401,3700,0,1,3702,12303196,12.303196
6900,2500,3700,17250000,2,29606,7403,1,416240000,416240000,11101,3700,7401,3700,0,1,3702,12032499,12.032499
6900,2500,3700,17250000,2,29606,7403,1,416240000,416240000,11101,3700,7401,3700,0,1,3702,12353248,12.353248
6900,2500,4100,17250000,2,32806,8203,1,446320000,446320000,12301,4100,8201,4100,0,1,4102,13474908,13.474908
6900,2500,4100,17250000,2,32806,8203,1,446320000,446320000,12301,4100,8201,4100,0,1,4102,13935973,13.935973
6900,2500,4100,17250000,2,32806,8203,1,446320000,446320000,12301,4100,8201,4100,0,1,4102,13217867,13.217867
6900,2500,4100,17250000,2,32806,8203,1,446320000,446320000,12301,4100,8201,4100,0,1,4102,13675039,13.675039
6900,2500,4100,17250000,2,32806,8203,1,446320000,446320000,12301,4100,8201,4100,0,1,4102,13424196,13.424196
6900,2500,4100,17250000,2,32806,8203,1,446320000,446320000,12301,4100,8201,4100,0,1,4102,13620344,13.620344
6900,2500,4100,17250000,2,32806,8203,1,446320000,446320000,12301,4100,8201,4100,0,1,4102,13310804,13.310804
6900,2500,4100,17250000,2,32806,8203,1,446320000,446320000,12301,4100,8201,4100,0,1,4102,13696222,13.696222
6900,2500,4500,17250000,2,36006,9003,1,476400000,476400000,13501,4500,9001,4500,0,1,4502,14795950,14.79595
6900,2500,4500,17250000,2,36006,9003,1,476400000,476400000,13501,4500,9001,4500,0,1,4502,15292305,15.292305
6900,2500,4500,17250000,2,36006,9003,1,476400000,476400000,13501,4500,9001,4500,0,1,4502,14466885,14.466885
6900,2500,4500,17250000,2,36006,9003,1,476400000,476400000,13501,4500,9001,4500,0,1,4502,14985086,14.985086
6900,2500,4500,17250000,2,36006,9003,1,476400000,476400000,13501,4500,9001,4500,0,1,4502,14679516,14.679516
6900,2500,4500,17250000,2,36006,9003,1,476400000,476400000,13501,4500,9001,4500,0,1,4502,14884153,14.884153
6900,2500,4500,17250000,2,36006,9003,1,476400000,476400000,13501,4500,9001,4500,0,1,4502,14574702,14.574702
6900,2500,4500,17250000,2,36006,9003,1,476400000,476400000,13501,4500,9001,4500,0,1,4502,15070049,15.070049
6900,2500,4900,17250000,2,39206,9803,1,506480000,506480000,14701,4900,9801,4900,0,1,4902,16093003,16.093003
6900,2500,4900,17250000,2,39206,9803,1,506480000,506480000,14701,4900,9801,4900,0,1,4902,16557237,16.557237
6900,2500,4900,17250000,2,39206,9803,1,506480000,506480000,14701,4900,9801,4900,0,1,4902,15762809,15.762809
6900,2500,4900,17250000,2,39206,9803,1,506480000,506480000,14701,4900,9801,4900,0,1,4902,16253164,16.253164
6900,2500,4900,17250000,2,39206,9803,1,506480000,506480000,14701,4900,9801,4900,0,1,4902,15914561,15.914561
6900,2500,4900,17250000,2,39206,9803,1,506480000,506480000,14701,4900,9801,4900,0,1,4902,16198462,16.198462
6900,2500,4900,17250000,2,39206,9803,1,506480000,506480000,14701,4900,9801,4900,0,1,4902,15885085,15.885085
6900,2500,4900,17250000,2,39206,9803,1,506480000,506480000,14701,4900,9801,4900,0,1,4902,16320603,16.320603
6900,2500,5300,17250000,2,42406,10603,1,536560000,536560000,15901,5300,10601,5300,0,1,5302,17348192,17.348192
6900,2500,5300,17250000,2,42406,10603,1,536560000,536560000,15901,5300,10601,5300,0,1,5302,17904965,17.904965
6900,2500,5300,17250000,2,42406,10603,1,536560000,536560000,15901,5300,10601,5300,0,1,5302,16994411,16.994411
6900,2500,5300,17250000,2,42406,10603,1,536560000,536560000,15901,5300,10601,5300,0,1,5302,17622515,17.622515
6900,2500,5300,17250000,2,42406,10603,1,536560000,536560000,15901,5300,10601,5300,0,1,5302,17187196,17.187196
6900,2500,5300,17250000,2,42406,10603,1,536560000,536560000,15901,5300,10601,5300,0,1,5302,17503572,17.503572
6900,2500,5300,17250000,2,42406,10603,1,536560000,536560000,15901,5300,10601,5300,0,1,5302,17161621,17.161621
6900,2500,5300,17250000,2,42406,10603,1,536560000,536560000,15901,5300,10601,5300,0,1,5302,17609942,17.609942
6900,2500,5700,17250000,2,45606,11403,1,566640000,566640000,17101,5700,11401,5700,0,1,5702,18625869,18.625869
6900,2500,5700,17250000,2,45606,11403,1,566640000,566640000,17101,5700,11401,5700,0,1,5702,19239507,19.239507
6900,2500,5700,17250000,2,45606,11403,1,566640000,566640000,17101,5700,11401,5700,0,1,5702,18269458,18.269458
6900,2500,5700,17250000,2,45606,11403,1,566640000,566640000,17101,5700,11401,5700,0,1,5702,18878000,18.878
6900,2500,5700,17250000,2,45606,11403,1,566640000,566640000,17101,5700,11401,5700,0,1,5702,18460977,18.460977
6900,2500,5700,17250000,2,45606,11403,1,566640000,566640000,17101,5700,11401,5700,0,1,5702,18751373,18.751373
6900,2500,5700,17250000,2,45606,11403,1,566640000,566640000,17101,5700,11401,5700,0,1,5702,18415033,18.415033
6900,2500,5700,17250000,2,45606,11403,1,566640000,566640000,17101,5700,11401,5700,0,1,5702,18900627,18.900627
6900,2500,6100,17250000,2,48806,12203,1,596720000,596720000,18301,6100,12201,6100,0,1,6102,19932317,19.932317
6900,2500,6100,17250000,2,48806,12203,1,596720000,596720000,18301,6100,12201,6100,0,1,6102,20648680,20.64868
6900,2500,6100,17250000,2,48806,12203,1,596720000,596720000,18301,6100,12201,6100,0,1,6102,19536229,19.536229
6900,2500,6100,17250000,2,48806,12203,1,596720000,596720000,18301,6100,12201,6100,0,1,6102,20231175,20.231175
6900,2500,6100,17250000,2,48806,12203,1,596720000,596720000,18301,6100,12201,6100,0,1,6102,19762456,19.762456
6900,2500,6100,17250000,2,48806,12203,1,596720000,596720000,18301,6100,12201,6100,0,1,6102,20097547,20.097547
6900,2500,6100,17250000,2,48806,12203,1,596720000,596720000,18301,6100,12201,6100,0,1,6102,19686020,19.68602
6900,2500,6100,17250000,2,48806,12203,1,596720000,596720000,18301,6100,12201,6100,0,1,6102,20243859,20.243859
6900,2500,6500,17250000,2,52006,13003,1,626800000,626800000,19501,6500,13001,6500,0,1,6502,21193776,21.193776
6900,2500,6500,17250000,2,52006,13003,1,626800000,626800000,19501,6500,13001,6500,0,1,6502,21906843,21.906843
6900,2500,6500,17250000,2,52006,13003,1,626800000,626800000,19501,6500,13001,6500,0,1,6502,20825434,20.825434
6900,2500,6500,17250000,2,52006,13003,1,626800000,626800000,19501,6500,13001,6500,0,1,6502,21513139,21.513139
6900,2500,6500,17250000,2,52006,13003,1,626800000,626800000,19501,6500,13001,6500,0,1,6502,20990735,20.990735
6900,2500,6500,17250000,2,52006,13003,1,626800000,626800000,19501,6500,13001,6500,0,1,6502,21325617,21.325617
6900,2500,6500,17250000,2,52006,13003,1,626800000,626800000,19501,6500,13001,6500,0,1,6502,21002719,21.002719
6900,2500,6500,17250000,2,52006,13003,1,626800000,626800000,19501,6500,13001,6500,0,1,6502,21576146,21.576146
6900,2500,6900,17250000,2,55206,13803,1,656880000,656880000,20701,6900,13801,6900,0,1,6902,22474377,22.474377
6900,2500,6900,17250000,2,55206,13803,1,656880000,656880000,20701,6900,13801,6900,0,1,6902,23256509,23.256509
6900,2500,6900,17250000,2,55206,13803,1,656880000,656880000,20701,6900,13801,6900,0,1,6902,22050417,22.050417
6900,2500,6900,17250000,2,55206,13803,1,656880000,656880000,20701,6900,13801,6900,0,1,6902,22875130,22.87513
6900,2500,6900,17250000,2,55206,13803,1,656880000,656880000,20701,6900,13801,6900,0,1,6902,22303601,22.303601
6900,2500,6900,17250000,2,55206,13803,1,656880000,656880000,20701,6900,13801,6900,0,1,6902,22640865,22.640865
6900,2500,6900,17250000,2,55206,13803,1,656880000,656880000,20701,6900,13801,6900,0,1,6902,22261145,22.261145
6900,2500,6900,17250000,2,55206,13803,1,656880000,656880000,20701,6900,13801,6900,0,1,6902,22905380,22.90538
6900,2100,500,14490000,2,4006,1003,1,151920000,151920000,1501,500,1001,500,0,1,502,1480823,1.480823
6900,2100,500,14490000,2,4006,1003,1,151920000,151920000,1501,500,1001,500,0,1,502,1535475,1.535475
6900,2100,500,14490000,2,4006,1003,1,151920000,151920000,1501,500,1001,500,0,1,502,1636160,1.63616
6900,2100,500,14490000,2,4006,1003,1,151920000,151920000,1501,500,1001,500,0,1,502,1514443,1.514443
6900,2100,500,14490000,2,4006,1003,1,151920000,151920000,1501,500,1001,500,0,1,502,1524596,1.524596
6900,2100,500,14490000,2,4006,1003,1,151920000,151920000,1501,500,1001,500,0,1,502,1491345,1.491345
6900,2100,500,14490000,2,4006,1003,1,151920000,151920000,1501,500,1001,500,0,1,502,1625836,1.625836
6900,2100,500,14490000,2,4006,1003,1,151920000,151920000,1501,500,1001,500,0,1,502,1503530,1.50353
6900,2100,900,14490000,2,7206,1803,1,180720000,180720000,2701,900,1801,900,0,1,902,2686789,2.686789
6900,2100,900,14490000,2,7206,1803,1,180720000,180720000,2701,900,1801,900,0,1,902,2757368,2.757368
6900,2100,900,14490000,2,7206,1803,1,180720000,180720000,2701,900,1801,900,0,1,902,2524091,2.524091
6900,2100,900,14490000,2,7206,1803,1,180720000,180720000,2701,900,1801,900,0,1,902,2729166,2.729166
6900,2100,900,14490000,2,7206,1803,1,180720000,180720000,2701,900,1801,900,0,1,902,2558410,2.55841
6900,2100,900,14490000,2,7206,1803,1,180720000,180720000,2701,900,1801,900,0,1,902,2709177,2.709177
6900,2100,900,14490000,2,7206,1803,1,180720000,180720000,2701,900,1801,900,0,1,902,2534094,2.534094
6900,2100,900,14490000,2,7206,1803,1,180720000,180720000,2701,900,1801,900,0,1,902,2697321,2.697321
6900,2100,1300,14490000,2,10406,2603,1,209520000,209520000,3901,1300,2601,1300,0,1,1302,3641271,3.641271
6900,2100,1300,14490000,2,10406,2603,1,209520000,209520000,3901,1300,2601,1300,0,1,1302,3756360,3.75636
6900,2100,1300,14490000,2,10406,2603,1,209520000,209520000,3901,1300,2601,1300,0,1,1302,3583576,3.583576
6900,2100,1300,14490000,2,10406,2603,1,209520000,209520000,3901,1300,2601,1300,0,1,1302,3720402,3.720402
6900,2100,1300,14490000,2,10406,2603,1,209520000,209520000,3901,1300,2601,1300,0,1,1302,3656690,3.65669
6900,2100,1300,14490000,2,10406,2603,1,209520000,209520000,3901,1300,2601,1300,0,1,1302,3669186,3.669186
6900,2100,1300,14490000,2,10406,2603,1,209520000,209520000,3901,1300,2601,1300,0,1,1302,3593708,3.593708
6900,2100,1300,14490000,2,10406,2603,1,209520000,209520000,3901,1300,2601,1300,0,1,1302,3700992,3.700992
6900,2100,1700,14490000,2,13606,3403,1,238320000,238320000,5101,1700,3401,1700,0,1,1702,4729064,4.729064
6900,2100,1700,14490000,2,13606,3403,1,238320000,238320000,5101,1700,3401,1700,0,1,1702,4888832,4.888832
6900,2100,1700,14490000,2,13606,3403,1,238320000,238320000,5101,1700,3401,1700,0,1,1702,4628669,4.628669
6900,2100,1700,14490000,2,13606,3403,1,238320000,238320000,5101,1700,3401,1700,0,1,1702,4825626,4.825626
6900,2100,1700,14490000,2,13606,3403,1,238320000,238320000,5101,1700,3401,1700,0,1,1702,4739318,4.739318
6900,2100,1700,14490000,2,13606,3403,1,238320000,238320000,5101,1700,3401,1700,0,1,1702,4749823,4.749823
6900,2100,1700,14490000,2,13606,3403,1,238320000,238320000,5101,1700,3401,1700,0,1,1702,4648170,4.64817
6900,2100,1700,14490000,2,13606,3403,1,238320000,238320000,5101,1700,3401,1700,0,1,1702,4806142,4.806142
6900,2100,2100,14490000,2,16806,4203,1,267120000,267120000,6301,2100,4201,2100,0,1,2102,5804055,5.804055
6900,2100,2100,14490000,2,16806,4203,1,267120000,267120000,6301,2100,4201,2100,0,1,2102,6003728,6.003728
6900,2100,2100,14490000,2,16806,4203,1,267120000,267120000,6301,2100,4201,2100,0,1,2102,5712088,5.712088
6900,2100,2100,14490000,2,16806,4203,1,267120000,267120000,6301,2100,4201,2100,0,1,2102,5921018,5.921018
6900,2100,2100,14490000,2,16806,4203,1,267120000,267120000,6301,2100,4201,2100,0,1,2102,5781257,5.781257
6900,2100,2100,14490000,2,16806,4203,1,267120000,267120000,6301,2100,4201,2100,0,1,2102,5876495,5.876495
6900,2100,2100,14490000,2,16806,4203,1,267120000,267120000,6301,2100,4201,2100,0,1,2102,5725135,5.725135
6900,2100,2100,14490000,2,16806,4203,1,267120000,267120000,6301,2100,4201,2100,0,1,2102,5895556,5.895556
6900,2100,2500,14490000,2,20006,5003,1,295920000,295920000,7501,2500,5001,2500,0,1,2502,6998619,6.998619
6900,2100,2500,14490000,2,20006,5003,1,295920000,295920000,7501,2500,5001,2500,0,1,2502,7217148,7.217148
6900,2100,2500,14490000,2,20006,5003,1,295920000,295920000,7501,2500,5001,2500,0,1,2502,6924145,6.924145
6900,2100,2500,14490000,2,20006,5003,1,295920000,295920000,7501,2500,5001,2500,0,1,2502,7124323,7.124323
6900,2100,2500,14490000,2,20006,5003,1,295920000,295920000,7501,2500,5001,2500,0,1,2502,7009293,7.009293
6900,2100,2500,14490000,2,20006,5003,1,295920000,295920000,7501,2500,5001,2500,0,1,2502,7057347,7.057347
6900,2100,2500,14490000,2,20006,5003,1,295920000,295920000,7501,2500,5001,2500,0,1,2502,6976391,6.976391
6900,2100,2500,14490000,2,20006,5003,1,295920000,295920000,7501,2500,5001,2500,0,1,2502,7138588,7.138588
6900,2100,2900,14490000,2,23206,5803,1,324720000,324720000,8701,2900,5801,2900,0,1,2902,7959362,7.959362
6900,2100,2900,14490000,2,23206,5803,1,324720000,324720000,8701,2900,5801,2900,0,1,2902,8235676,8.235676
6900,2100,2900,14490000,2,23206,5803,1,324720000,324720000,8701,2900,5801,2900,0,1,2902,7813072,7.813072
6900,2100,2900,14490000,2,23206,5803,1,324720000,324720000,8701,2900,5801,2900,0,1,2902,8097290,8.09729
6900,2100,2900,14490000,2,23206,5803,1,324720000,324720000,8701,2900,5801,2900,0,1,2902,7923851,7.923851
6900,2100,2900,14490000,2,23206,5803,1,324720000,324720000,8701,2900,5801,2900,0,1,2902,8031236,8.031236
6900,2100,2900,14490000,2,23206,5803,1,324720000,324720000,8701,2900,5801,2900,0,1,2902,7860012,7.860012
6900,2100,2900,14490000,2,23206,5803,1,324720000,324720000,8701,2900,5801,2900,0,1,2902,8107717,8.107717
6900,2100,3300,14490000,2,26406,6603,1,353520000,353520000,9901,3300,6601,3300,0,1,3302,9171933,9.171933
6900,2100,3300,14490000,2,26406,6603,1,353520000,353520000,9901,3300,6601,3300,0,1,3302,9462602,9.462602
6900,2100,3300,14490000,2,26406,6603,1,353520000,353520000,9901,3300,6601,3300,0,1,3302,9024018,9.024018
6900,2100,3300,14490000,2,26406,6603,1,353520000,353520000,9901,3300,6601,3300,0,1,3302,9302033,9.302033
6900,2100,3300,14490000,2,26406,6603,1,353520000,353520000,9901,3300,6601,3300,0,1,3302,9153569,9.153569
6900,2100,3300,14490000,2,26406,6603,1,353520000,353520000,9901,3300,6601,3300,0,1,3302,9249588,9.249588
6900,2100,3300,14490000,2,26406,6603,1,353520000,353520000,9901,3300,6601,3300,0,1,3302,9110085,9.110085
6900,2100,3300,14490000,2,26406,6603,1,353520000,353520000,9901,3300,6601,3300,0,1,3302,9291319,9.291319
6900,2100,3700,14490000,2,29606,7403,1,382320000,382320000,11101,3700,7401,3700,0,1,3702,10125826,10.125826
6900,2100,3700,14490000,2,29606,7403,1,382320000,382320000,11101,3700,7401,3700,0,1,3702,10475511,10.475511
6900,2100,3700,14490000,2,29606,7403,1,382320000,382320000,11101,3700,7401,3700,0,1,3702,9929050,9.92905
6900,2100,3700,14490000,2,29606,7403,1,382320000,382320000,11101,3700,7401,3700,0,1,3702,10320943,10.320943
6900,2100,3700,14490000,2,29606,7403,1,382320000,382320000,11101,3700,7401,3700,0,1,3702,10082273,10.082273
6900,2100,3700,14490000,2,29606,7403,1,382320000,382320000,11101,3700,7401,3700,0,1,3702,10210199,10.210199
6900,2100,3700,14490000,2,29606,7403,1,382320000,382320000,11101,3700,7401,3700,0,1,3702,9996135,9.996135
6900,2100,3700,14490000,2,29606,7403,1,382320000,382320000,11101,3700,7401,3700,0,1,3702,10301856,10.301856
6900,2100,4100,14490000,2,32806,8203,1,411120000,411120000,12301,4100,8201,4100,0,1,4102,11334603,11.334603
6900,2100,4100,14490000,2,32806,8203,1,411120000,411120000,12301,4100,8201,4100,0,1,4102,11690577,11.690577
6900,2100,4100,14490000,2,32806,8203,1,411120000,411120000,12301,4100,8201,4100,0,1,4102,11168886,11.168886
6900,2100,4100,14490000,2,32806,8203,1,411120000,411120000,12301,4100,8201,4100,0,1,4102,11459959,11.459959
6900,2100,4100,14490000,2,32806,8203,1,411120000,411120000,12301,4100,8201,4100,0,1,4102,11265040,11.26504
6900,2100,4100,14490000,2,32806,8203,1,411120000,411120000,12301,4100,8201,4100,0,1,4102,11372986,11.372986
6900,2100,4100,14490000,2,32806,8203,1,411120000,411120000,12301,4100,8201,4100,0,1,4102,11232159,11.232159
6900,2100,4100,14490000,2,32806,8203,1,411120000,411120000,12301,4100,8201,4100,0,1,4102,11535561,11.535561
6900,2100,4500,14490000,2,36006,9003,1,439920000,439920000,13501,4500,9001,4500,0,1,4502,12468411,12.468411
6900,2100,4500,14490000,2,36006,9003,1,439920000,439920000,13501,4500,9001,4500,0,1,4502,12806410,12.80641
6900,2100,4500,14490000,2,36006,9003,1,439920000,439920000,13501,4500,9001,4500,0,1,4502,12212161,12.212161
6900,2100,4500,14490000,2,36006,9003,1,439920000,439920000,13501,4500,9001,4500,0,1,4502,12618344,12.618344
6900,2100,4500,14490000,2,36006,9003,1,439920000,439920000,13501,4500,9001,4500,0,1,4502,12340245,12.340245
6900,2100,4500,14490000,2,36006,9003,1,439920000,439920000,13501,4500,9001,4500,0,1,4502,12533001,12.533001
6900,2100,4500,14490000,2,36006,9003,1,439920000,439920000,13501,4500,9001,4500,0,1,4502,12305065,12.305065
6900,2100,4500,14490000,2,36006,9003,1,439920000,439920000,13501,4500,9001,4500,0,1,4502,12628783,12.628783
6900,2100,4900,14490000,2,39206,9803,1,468720000,468720000,14701,4900,9801,4900,0,1,4902,13521996,13.521996
6900,2100,4900,14490000,2,39206,9803,1,468720000,468720000,14701,4900,9801,4900,0,1,4902,13952689,13.952689
6900,2100,4900,14490000,2,39206,9803,1,468720000,468720000,14701,4900,9801,4900,0,1,4902,13259146,13.259146
6900,2100,4900,14490000,2,39206,9803,1,468720000,468720000,14701,4900,9801,4900,0,1,4902,13711756,13.711756
6900,2100,4900,14490000,2,39206,9803,1,468720000,468720000,14701,4900,9801,4900,0,1,4902,13375274,13.375274
6900,2100,4900,14490000,2,39206,9803,1,468720000,468720000,14701,4900,9801,4900,0,1,4902,13651941,13.651941
6900,2100,4900,14490000,2,39206,9803,1,468720000,468720000,14701,4900,9801,4900,0,1,4902,13392436,13.392436
6900,2100,4900,14490000,2,39206,9803,1,468720000,468720000,14701,4900,9801,4900,0,1,4902,13722160,13.72216
6900,2100,5300,14490000,2,42406,10603,1,497520000,497520000,15901,5300,10601,5300,0,1,5302,14636159,14.636159
6900,2100,5300,14490000,2,42406,10603,1,497520000,497520000,15901,5300,10601,5300,0,1,5302,15059539,15.059539
6900,2100,5300,14490000,2,42406,10603,1,497520000,497520000,15901,5300,10601,5300,0,1,5302,14352579,14.352579
6900,2100,5300,14490000,2,42406,10603,1,497520000,497520000,15901,5300,10601,5300,0,1,5302,14838878,14.838878
6900,2100,5300,14490000,2,42406,10603,1,497520000,497520000,15901,5300,10601,5300,0,1,5302,14488402,14.488402
6900,2100,5300,14490000,2,42406,10603,1,497520000,497520000,15901,5300,10601,5300,0,1,5302,14728414,14.728414
6900,2100,5300,14490000,2,42406,10603,1,497520000,497520000,15901,5300,10601,5300,0,1,5302,14450728,14.450728
6900,2100,5300,14490000,2,42406,10603,1,497520000,497520000,15901,5300,10601,5300,0,1,5302,14857401,14.857401
6900,2100,5700,14490000,2,45606,11403,1,526320000,526320000,17101,5700,11401,5700,0,1,5702,15709040,15.70904
6900,2100,5700,14490000,2,45606,11403,1,526320000,526320000,17101,5700,11401,5700,0,1,5702,16213670,16.21367
6900,2100,5700,14490000,2,45606,11403,1,526320000,526320000,17101,5700,11401,5700,0,1,5702,15411743,15.411743
6900,2100,5700,14490000,2,45606,11403,1,526320000,526320000,17101,5700,11401,5700,0,1,5702,15934198,15.934198
6900,2100,5700,14490000,2,45606,11403,1,526320000,526320000,17101,5700,11401,5700,0,1,5702,15526507,15.526507
6900,2100,5700,14490000,2,45606,11403,1,526320000,526320000,17101,5700,11401,5700,0,1,5702,15789814,15.789814
6900,2100,5700,14490000,2,45606,11403,1,526320000,526320000,17101,5700,11401,5700,0,1,5702,15536443,15.536443
6900,2100,5700,14490000,2,45606,11403,1,526320000,526320000,17101,5700,11401,5700,0,1,5702,15944738,15.944738
6900,2100,6100,14490000,2,48806,12203,1,555120000,555120000,18301,6100,12201,6100,0,1,6102,16785561,16.785561
6900,2100,6100,14490000,2,48806,12203,1,555120000,555120000,18301,6100,12201,6100,0,1,6102,17328022,17.328022
6900,2100,6100,14490000,2,48806,12203,1,555120000,555120000,18301,6100,12201,6100,0,1,6102,16452867,16.452867
6900,2100,6100,14490000,2,48806,12203,1,555120000,555120000,18301,6100,12201,6100,0,1,6102,17070456,17.070456
6900,2100,6100,14490000,2,48806,12203,1,555120000,555120000,18301,6100,12201,6100,0,1,6102,16601285,16.601285
6900,2100,6100,14490000,2,48806,12203,1,555120000,555120000,18301,6100,12201,6100,0,1,6102,16943290,16.94329
6900,2100,6100,14490000,2,48806,12203,1,555120000,555120000,18301,6100,12201,6100,0,1,6102,16560081,16.560081
6900,2100,6100,14490000,2,48806,12203,1,555120000,555120000,18301,6100,12201,6100,0,1,6102,17025978,17.025978
6900,2100,6500,14490000,2,52006,13003,1,583920000,583920000,19501,6500,13001,6500,0,1,6502,17879532,17.879532
6900,2100,6500,14490000,2,52006,13003,1,583920000,583920000,19501,6500,13001,6500,0,1,6502,18523202,18.523202
6900,2100,6500,14490000,2,52006,13003,1,583920000,583920000,19501,6500,13001,6500,0,1,6502,17522153,17.522153
6900,2100,6500,14490000,2,52006,13003,1,583920000,583920000,19501,6500,13001,6500,0,1,6502,18173125,18.173125
6900,2100,6500,14490000,2,52006,13003,1,583920000,583920000,19501,6500,13001,6500,0,1,6502,17670956,17.670956
6900,2100,6500,14490000,2,52006,13003,1,583920000,583920000,19501,6500,13001,6500,0,1,6502,18022344,18.022344
6900,2100,6500,14490000,2,52006,13003,1,583920000,583920000,19501,6500,13001,6500,0,1,6502,17651176,17.651176
6900,2100,6500,14490000,2,52006,13003,1,583920000,583920000,19501,6500,13001,6500,0,1,6502,18146342,18.146342
6900,2100,6900,14490000,2,55206,13803,1,612720000,612720000,20701,6900,13801,6900,0,1,6902,18934134,18.934134
6900,2100,6900,14490000,2,55206,13803,1,612720000,612720000,20701,6900,13801,6900,0,1,6902,19600068,19.600068
6900,2100,6900,14490000,2,55206,13803,1,612720000,612720000,20701,6900,13801,6900,0,1,6902,18630559,18.630559
6900,2100,6900,14490000,2,55206,13803,1,612720000,612720000,20701,6900,13801,6900,0,1,6902,19212782,19.212782
6900,2100,6900,14490000,2,55206,13803,1,612720000,612720000,20701,6900,13801,6900,0,1,6902,18720061,18.720061
6900,2100,6900,14490000,2,55206,13803,1,612720000,612720000,20701,6900,13801,6900,0,1,6902,19113394,19.113394
6900,2100,6900,14490000,2,55206,13803,1,612720000,612720000,20701,6900,13801,6900,0,1,6902,18760252,18.760252
6900,2100,6900,14490000,2,55206,13803,1,612720000,612720000,20701,6900,13801,6900,0,1,6902,19279443,19.279443
6900,1700,500,11730000,2,4006,1003,1,128240000,128240000,1501,500,1001,500,0,1,502,1205093,1.205093
6900,1700,500,11730000,2,4006,1003,1,128240000,128240000,1501,500,1001,500,0,1,502,1240212,1.240212
6900,1700,500,11730000,2,4006,1003,1,128240000,128240000,1501,500,1001,500,0,1,502,1213312,1.213312
6900,1700,500,11730000,2,4006,1003,1,128240000,128240000,1501,500,1001,500,0,1,502,1231393,1.231393
6900,1700,500,11730000,2,4006,1003,1,128240000,128240000,1501,500,1001,500,0,1,502,1204869,1.204869
6900,1700,500,11730000,2,4006,1003,1,128240000,128240000,1501,500,1001,500,0,1,502,1231112,1.231112
6900,1700,500,11730000,2,4006,1003,1,128240000,128240000,1501,500,1001,500,0,1,502,1196307,1.196307
6900,1700,500,11730000,2,4006,1003,1,128240000,128240000,1501,500,1001,500,0,1,502,1222508,1.222508
6900,1700,900,11730000,2,7206,1803,1,155760000,155760000,2701,900,1801,900,0,1,902,2078391,2.078391
6900,1700,900,11730000,2,7206,1803,1,155760000,155760000,2701,900,1801,900,0,1,902,2140009,2.140009
6900,1700,900,11730000,2,7206,1803,1,155760000,155760000,2701,900,1801,900,0,1,902,2061674,2.061674
6900,1700,900,11730000,2,7206,1803,1,155760000,155760000,2701,900,1801,900,0,1,902,2123330,2.12333
6900,1700,900,11730000,2,7206,1803,1,155760000,155760000,2701,900,1801,900,0,1,902,2070072,2.070072
6900,1700,900,11730000,2,7206,1803,1,155760000,155760000,2701,900,1801,900,0,1,902,2103600,2.1036
6900,1700,900,11730000,2,7206,1803,1,155760000,155760000,2701,900,1801,900,0,1,902,2053449,2.053449
6900,1700,900,11730000,2,7206,1803,1,155760000,155760000,2701,900,1801,900,0,1,902,2112156,2.112156
6900,1700,1300,11730000,2,10406,2603,1,183280000,183280000,3901,1300,2601,1300,0,1,1302,3086701,3.086701
6900,1700,1300,11730000,2,10406,2603,1,183280000,183280000,3901,1300,2601,1300,0,1,1302,3169470,3.16947
6900,1700,1300,11730000,2,10406,2603,1,183280000,183280000,3901,1300,2601,1300,0,1,1302,3049898,3.049898
6900,1700,1300,11730000,2,10406,2603,1,183280000,183280000,3901,1300,2601,1300,0,1,1302,3135068,3.135068
6900,1700,1300,11730000,2,10406,2603,1,183280000,183280000,3901,1300,2601,1300,0,1,1302,3078106,3.078106
6900,1700,1300,11730000,2,10406,2603,1,183280000,183280000,3901,1300,2601,1300,0,1,1302,3041741,3.041741
6900,1700,1300,11730000,2,10406,2603,1,183280000,183280000,3901,1300,2601,1300,0,1,1302,3058092,3.058092
6900,1700,1300,11730000,2,10406,2603,1,183280000,183280000,3901,1300,2601,1300,0,1,1302,3095437,3.095437
6900,1700,1700,11730000,2,13606,3403,1,210800000,210800000,5101,1700,3401,1700,0,1,1702,3823414,3.823414
6900,1700,1700,11730000,2,13606,3403,1,210800000,210800000,5101,1700,3401,1700,0,1,1702,3949061,3.949061
6900,1700,1700,11730000,2,13606,3403,1,210800000,210800000,5101,1700,3401,1700,0,1,1702,3764380,3.76438
6900,1700,1700,11730000,2,13606,3403,1,210800000,210800000,5101,1700,3401,1700,0,1,1702,3901321,3.901321
6900,1700,1700,11730000,2,13606,3403,1,210800000,210800000,5101,1700,3401,1700,0,1,1702,3794068,3.794068
6900,1700,1700,11730000,2,13606,3403,1,210800000,210800000,5101,1700,3401,1700,0,1,1702,3871390,3.87139
6900,1700,1700,11730000,2,13606,3403,1,210800000,210800000,5101,1700,3401,1700,0,1,1702,3777593,3.777593
6900,1700,1700,11730000,2,13606,3403,1,210800000,210800000,5101,1700,3401,1700,0,1,1702,3882796,3.882796
6900,1700,2100,11730000,2,16806,4203,1,238320000,238320000,6301,2100,4201,2100,0,1,2102,4710119,4.710119
6900,1700,2100,11730000,2,16806,4203,1,238320000,238320000,6301,2100,4201,2100,0,1,2102,4856602,4.856602
6900,1700,2100,11730000,2,16806,4203,1,238320000,238320000,6301,2100,4201,2100,0,1,2102,4616809,4.616809
6900,1700,2100,11730000,2,16806,4203,1,238320000,238320000,6301,2100,4201,2100,0,1,2102,4794335,4.794335
6900,1700,2100,11730000,2,16806,4203,1,238320000,238320000,6301,2100,4201,2100,0,1,2102,4664533,4.664533
6900,1700,2100,11730000,2,16806,4203,1,238320000,238320000,6301,2100,4201,2100,0,1,2102,4750795,4.750795
6900,1700,2100,11730000,2,16806,4203,1,238320000,238320000,6301,2100,4201,2100,0,1,2102,4646111,4.646111
6900,1700,2100,11730000,2,16806,4203,1,238320000,238320000,6301,2100,4201,2100,0,1,2102,4777625,4.777625
6900,1700,2500,11730000,2,20006,5003,1,265840000,265840000,7501,2500,5001,2500,0,1,2502,5588868,5.588868
6900,1700,2500,11730000,2,20006,5003,1,265840000,265840000,7501,2500,5001,2500,0,1,2502,5769748,5.769748
6900,1700,2500,11730000,2,20006,5003,1,265840000,265840000,7501,2500,5001,2500,0,1,2502,5475008,5.475008
6900,1700,2500,11730000,2,20006,5003,1,265840000,265840000,7501,2500,5001,2500,0,1,2502,5704453,5.704453
6900,1700,2500,11730000,2,20006,5003,1,265840000,265840000,7501,2500,5001,2500,0,1,2502,5530916,5.530916
6900,1700,2500,11730000,2,20006,5003,1,265840000,265840000,7501,2500,5001,2500,0,1,2502,5647789,5.647789
6900,1700,2500,11730000,2,20006,5003,1,265840000,265840000,7501,2500,5001,2500,0,1,2502,5511621,5.511621
6900,1700,2500,11730000,2,20006,5003,1,265840000,265840000,7501,2500,5001,2500,0,1,2502,5672027,5.672027
6900,1700,2900,11730000,2,23206,5803,1,293360000,293360000,8701,2900,5801,2900,0,1,2902,6494075,6.494075
6900,1700,2900,11730000,2,23206,5803,1,293360000,293360000,8701,2900,5801,2900,0,1,2902,6707012,6.707012
6900,1700,2900,11730000,2,23206,5803,1,293360000,293360000,8701,2900,5801,2900,0,1,2902,6359177,6.359177
6900,1700,2900,11730000,2,23206,5803,1,293360000,293360000,8701,2900,5801,2900,0,1,2902,6615717,6.615717
6900,1700,2900,11730000,2,23206,5803,1,293360000,293360000,8701,2900,5801,2900,0,1,2902,6436843,6.436843
6900,1700,2900,11730000,2,23206,5803,1,293360000,293360000,8701,2900,5801,2900,0,1,2902,6523221,6.523221
6900,1700,2900,11730000,2,23206,5803,1,293360000,293360000,8701,2900,5801,2900,0,1,2902,6402993,6.402993
6900,1700,2900,11730000,2,23206,5803,1,293360000,293360000,8701,2900,5801,2900,0,1,2902,6607186,6.607186
6900,1700,3300,11730000,2,26406,6603,1,320880000,320880000,9901,3300,6601,3300,0,1,3302,7505514,7.505514
6900,1700,3300,11730000,2,26406,6603,1,320880000,320880000,9901,3300,6601,3300,0,1,3302,7672416,7.672416
6900,1700,3300,11730000,2,26406,6603,1,320880000,320880000,9901,3300,6601,3300,0,1,3302,7367036,7.367036
6900,1700,3300,11730000,2,26406,6603,1,320880000,320880000,9901,3300,6601,3300,0,1,3302,7570940,7.57094
6900,1700,3300,11730000,2,26406,6603,1,320880000,320880000,9901,3300,6601,3300,0,1,3302,7452318,7.452318
6900,1700,3300,11730000,2,26406,6603,1,320880000,320880000,9901,3300,6601,3300,0,1,3302,7514214,7.514214
6900,1700,3300,11730000,2,26406,6603,1,320880000,320880000,9901,3300,6601,3300,0,1,3302,7399211,7.399211
6900,1700,3300,11730000,2,26406,6603,1,320880000,320880000,9901,3300,6601,3300,0,1,3302,7579522,7.579522
6900,1700,3700,11730000,2,29606,7403,1,348400000,348400000,11101,3700,7401,3700,0,1,3702,8207473,8.207473
6900,1700,3700,11730000,2,29606,7403,1,348400000,348400000,11101,3700,7401,3700,0,1,3702,8491634,8.491634
6900,1700,3700,11730000,2,29606,7403,1,348400000,348400000,11101,3700,7401,3700,0,1,3702,8062805,8.062805
6900,1700,3700,11730000,2,29606,7403,1,348400000,348400000,11101,3700,7401,3700,0,1,3702,8350408,8.350408
6900,1700,3700,11730000,2,29606,7403,1,348400000,348400000,11101,3700,7401,3700,0,1,3702,8165853,8.165853
6900,1700,3700,11730000,2,29606,7403,1,348400000,348400000,11101,3700,7401,3700,0,1,3702,8284902,8.284902
6900,1700,3700,11730000,2,29606,7403,1,348400000,348400000,11101,3700,7401,3700,0,1,3702,8116002,8.116002
6900,1700,3700,11730000,2,29606,7403,1,348400000,348400000,11101,3700,7401,3700,0,1,3702,8364555,8.364555
6900,1700,4100,11730000,2,32806,8203,1,375920000,375920000,12301,4100,8201,4100,0,1,4102,9255590,9.25559
6900,1700,4100,11730000,2,32806,8203,1,375920000,375920000,12301,4100,8201,4100,0,1,4102,9493527,9.493527
6900,1700,4100,11730000,2,32806,8203,1,375920000,375920000,12301,4100,8201,4100,0,1,4102,9073835,9.073835
6900,1700,4100,11730000,2,32806,8203,1,375920000,375920000,12301,4100,8201,4100,0,1,4102,9320833,9.320833
6900,1700,4100,11730000,2,32806,8203,1,375920000,375920000,12301,4100,8201,4100,0,1,4102,9186190,9.18619
6900,1700,4100,11730000,2,32806,8203,1,375920000,375920000,12301,4100,8201,4100,0,1,4102,9269033,9.269033
6900,1700,4100,11730000,2,32806,8203,1,375920000,375920000,12301,4100,8201,4100,0,1,4102,9146680,9.14668
6900,1700,4100,11730000,2,32806,8203,1,375920000,375920000,12301,4100,8201,4100,0,1,4102,9368734,9.368734
6900,1700,4500,11730000,2,36006,9003,1,403440000,403440000,13501,4500,9001,4500,0,1,4502,10153062,10.153062
6900,1700,4500,11730000,2,36006,9003,1,403440000,403440000,13501,4500,9001,4500,0,1,4502,10410046,10.410046
6900,1700,4500,11730000,2,36006,9003,1,403440000,403440000,13501,4500,9001,4500,0,1,4502,9935481,9.935481
6900,1700,4500,11730000,2,36006,9003,1,403440000,403440000,13501,4500,9001,4500,0,1,4502,10230716,10.230716
6900,1700,4500,11730000,2,36006,9003,1,403440000,403440000,13501,4500,9001,4500,0,1,4502,10023921,10.023921
6900,1700,4500,11730000,2,36006,9003,1,403440000,403440000,13501,4500,9001,4500,0,1,4502,10167152,10.167152
6900,1700,4500,11730000,2,36006,9003,1,403440000,403440000,13501,4500,9001,4500,0,1,4502,10032041,10.032041
6900,1700,4500,11730000,2,36006,9003,1,403440000,403440000,13501,4500,9001,4500,0,1,4502,10275930,10.27593
6900,1700,4900,11730000,2,39206,9803,1,430960000,430960000,14701,4900,9801,4900,0,1,4902,10847566,10.847566
6900,1700,4900,11730000,2,39206,9803,1,430960000,430960000,14701,4900,9801,4900,0,1,4902,11224721,11.224721
6900,1700,4900,11730000,2,39206,9803,1,430960000,430960000,14701,4900,9801,4900,0,1,4902,10642316,10.642316
6900,1700,4900,11730000,2,39206,9803,1,430960000,430960000,14701,4900,9801,4900,0,1,4902,11035279,11.035279
6900,1700,4900,11730000,2,39206,9803,1,430960000,430960000,14701,4900,9801,4900,0,1,4902,10761103,10.761103
6900,1700,4900,11730000,2,39206,9803,1,430960000,430960000,14701,4900,9801,4900,0,1,4902,10945497,10.945497
6900,1700,4900,11730000,2,39206,9803,1,430960000,430960000,14701,4900,9801,4900,0,1,4902,10724522,10.724522
6900,1700,4900,11730000,2,39206,9803,1,430960000,430960000,14701,4900,9801,4900,0,1,4902,11049894,11.049894
6900,1700,5300,11730000,2,42406,10603,1,458480000,458480000,15901,5300,10601,5300,0,1,5302,11878964,11.878964
6900,1700,5300,11730000,2,42406,10603,1,458480000,458480000,15901,5300,10601,5300,0,1,5302,12265233,12.265233
6900,1700,5300,11730000,2,42406,10603,1,458480000,458480000,15901,5300,10601,5300,0,1,5302,11644981,11.644981
6900,1700,5300,11730000,2,42406,10603,1,458480000,458480000,15901,5300,10601,5300,0,1,5302,12053096,12.053096
6900,1700,5300,11730000,2,42406,10603,1,458480000,458480000,15901,5300,10601,5300,0,1,5302,11784467,11.784467
6900,1700,5300,11730000,2,42406,10603,1,458480000,458480000,15901,5300,10601,5300,0,1,5302,11930169,11.930169
6900,1700,5300,11730000,2,42406,10603,1,458480000,458480000,15901,5300,10601,5300,0,1,5302,11737827,11.737827
6900,1700,5300,11730000,2,42406,10603,1,458480000,458480000,15901,5300,10601,5300,0,1,5302,12044527,12.044527
6900,1700,5700,11730000,2,45606,11403,1,486000000,486000000,17101,5700,11401,5700,0,1,5702,12777122,12.777122
6900,1700,5700,11730000,2,45606,11403,1,486000000,486000000,17101,5700,11401,5700,0,1,5702,13177736,13.177736
6900,1700,5700,11730000,2,45606,11403,1,486000000,486000000,17101,5700,11401,5700,0,1,5702,12499007,12.499007
6900,1700,5700,11730000,2,45606,11403,1,486000000,486000000,17101,5700,11401,5700,0,1,5702,12964427,12.964427
6900,1700,5700,11730000,2,45606,11403,1,486000000,486000000,17101,5700,11401,5700,0,1,5702,12630112,12.630112
6900,1700,5700,11730000,2,45606,11403,1,486000000,486000000,17101,5700,11401,5700,0,1,5702,12798400,12.7984
6900,1700,5700,11730000,2,45606,11403,1,486000000,486000000,17101,5700,11401,5700,0,1,5702,12613952,12.613952
6900,1700,5700,11730000,2,45606,11403,1,486000000,486000000,17101,5700,11401,5700,0,1,5702,12979369,12.979369
6900,1700,6100,11730000,2,48806,12203,1,513520000,513520000,18301,6100,12201,6100,0,1,6102,13650307,13.650307
6900,1700,6100,11730000,2,48806,12203,1,513520000,513520000,18301,6100,12201,6100,0,1,6102,14052324,14.052324
6900,1700,6100,11730000,2,48806,12203,1,513520000,513520000,18301,6100,12201,6100,0,1,6102,13383237,13.383237
6900,1700,6100,11730000,2,48806,12203,1,513520000,513520000,18301,6100,12201,6100,0,1,6102,13846981,13.846981
6900,1700,6100,11730000,2,48806,12203,1,513520000,513520000,18301,6100,12201,6100,0,1,6102,13520620,13.52062
6900,1700,6100,11730000,2,48806,12203,1,513520000,513520000,18301,6100,12201,6100,0,1,6102,13727457,13.727457
6900,1700,6100,11730000,2,48806,12203,1,513520000,513520000,18301,6100,12201,6100,0,1,6102,13486132,13.486132
6900,1700,6100,11730000,2,48806,12203,1,513520000,513520000,18301,6100,12201,6100,0,1,6102,13880321,13.880321
6900,1700,6500,11730000,2,52006,13003,1,541040000,541040000,19501,6500,13001,6500,0,1,6502,14548216,14.548216
6900,1700,6500,11730000,2,52006,13003,1,541040000,541040000,19501,6500,13001,6500,0,1,6502,14968328,14.968328
6900,1700,6500,11730000,2,52006,13003,1,541040000,541040000,19501,6500,13001,6500,0,1,6502,14249923,14.249923
6900,1700,6500,11730000,2,52006,13003,1,541040000,541040000,19501,6500,13001,6500,0,1,6502,14765502,14.765502
6900,1700,6500,11730000,2,52006,13003,1,541040000,541040000,19501,6500,13001,6500,0,1,6502,14391313,14.391313
6900,1700,6500,11730000,2,52006,13003,1,541040000,541040000,19501,6500,13001,6500,0,1,6502,14584689,14.584689
6900,1700,6500,11730000,2,52006,13003,1,541040000,541040000,19501,6500,13001,6500,0,1,6502,14360069,14.360069
6900,1700,6500,11730000,2,52006,13003,1,541040000,541040000,19501,6500,13001,6500,0,1,6502,14792448,14.792448
6900,1700,6900,11730000,2,55206,13803,1,568560000,568560000,20701,6900,13801,6900,0,1,6902,15404908,15.404908
6900,1700,6900,11730000,2,55206,13803,1,568560000,568560000,20701,6900,13801,6900,0,1,6902,15961117,15.961117
6900,1700,6900,11730000,2,55206,13803,1,568560000,568560000,20701,6900,13801,6900,0,1,6902,15085005,15.085005
6900,1700,6900,11730000,2,55206,13803,1,568560000,568560000,20701,6900,13801,6900,0,1,6902,15648604,15.648604
6900,1700,6900,11730000,2,55206,13803,1,568560000,568560000,20701,6900,13801,6900,0,1,6902,15256633,15.256633
6900,1700,6900,11730000,2,55206,13803,1,568560000,568560000,20701,6900,13801,6900,0,1,6902,15458182,15.458182
6900,1700,6900,11730000,2,55206,13803,1,568560000,568560000,20701,6900,13801,6900,0,1,6902,15233281,15.233281
6900,1700,6900,11730000,2,55206,13803,1,568560000,568560000,20701,6900,13801,6900,0,1,6902,15675331,15.675331
6900,1300,500,8970000,2,4006,1003,1,104560000,104560000,1501,500,1001,500,0,1,502,918883,0.918883
6900,1300,500,8970000,2,4006,1003,1,104560000,104560000,1501,500,1001,500,0,1,502,953865,0.953865
6900,1300,500,8970000,2,4006,1003,1,104560000,104560000,1501,500,1001,500,0,1,502,911629,0.911629
6900,1300,500,8970000,2,4006,1003,1,104560000,104560000,1501,500,1001,500,0,1,502,946827,0.946827
6900,1300,500,8970000,2,4006,1003,1,104560000,104560000,1501,500,1001,500,0,1,502,925950,0.92595
6900,1300,500,8970000,2,4006,1003,1,104560000,104560000,1501,500,1001,500,0,1,502,932489,0.932489
6900,1300,500,8970000,2,4006,1003,1,104560000,104560000,1501,500,1001,500,0,1,502,925634,0.925634
6900,1300,500,8970000,2,4006,1003,1,104560000,104560000,1501,500,1001,500,0,1,502,939448,0.939448
6900,1300,900,8970000,2,7206,1803,1,130800000,130800000,2701,900,1801,900,0,1,902,1590100,1.5901
6900,1300,900,8970000,2,7206,1803,1,130800000,130800000,2701,900,1801,900,0,1,902,1649486,1.649486
6900,1300,900,8970000,2,7206,1803,1,130800000,130800000,2701,900,1801,900,0,1,902,1563816,1.563816
6900,1300,900,8970000,2,7206,1803,1,130800000,130800000,2701,900,1801,900,0,1,902,1633320,1.63332
6900,1300,900,8970000,2,7206,1803,1,130800000,130800000,2701,900,1801,900,0,1,902,1606816,1.606816
6900,1300,900,8970000,2,7206,1803,1,130800000,130800000,2701,900,1801,900,0,1,902,1607383,1.607383
6900,1300,900,8970000,2,7206,1803,1,130800000,130800000,2701,900,1801,900,0,1,902,1579392,1.579392
6900,1300,900,8970000,2,7206,1803,1,130800000,130800000,2701,900,1801,900,0,1,902,1626997,1.626997
6900,1300,1300,8970000,2,10406,2603,1,157040000,157040000,3901,1300,2601,1300,0,1,1302,2256517,2.256517
6900,1300,1300,8970000,2,10406,2603,1,157040000,157040000,3901,1300,2601,1300,0,1,1302,2339614,2.339614
6900,1300,1300,8970000,2,10406,2603,1,157040000,157040000,3901,1300,2601,1300,0,1,1302,2240826,2.240826
6900,1300,1300,8970000,2,10406,2603,1,157040000,157040000,3901,1300,2601,1300,0,1,1302,2309626,2.309626
6900,1300,1300,8970000,2,10406,2603,1,157040000,157040000,3901,1300,2601,1300,0,1,1302,2256161,2.256161
6900,1300,1300,8970000,2,10406,2603,1,157040000,157040000,3901,1300,2601,1300,0,1,1302,2279577,2.279577
6900,1300,1300,8970000,2,10406,2603,1,157040000,157040000,3901,1300,2601,1300,0,1,1302,2234429,2.234429
6900,1300,1300,8970000,2,10406,2603,1,157040000,157040000,3901,1300,2601,1300,0,1,1302,2316872,2.316872
6900,1300,1700,8970000,2,13606,3403,1,183280000,183280000,5101,1700,3401,1700,0,1,1702,3079304,3.079304
6900,1300,1700,8970000,2,13606,3403,1,183280000,183280000,5101,1700,3401,1700,0,1,1702,3154222,3.154222
6900,1300,1700,8970000,2,13606,3403,1,183280000,183280000,5101,1700,3401,1700,0,1,1702,3032453,3.032453
6900,1300,1700,8970000,2,13606,3403,1,183280000,183280000,5101,1700,3401,1700,0,1,1702,3133509,3.133509
6900,1300,1700,8970000,2,13606,3403,1,183280000,183280000,5101,1700,3401,1700,0,1,1702,2985092,2.985092
6900,1300,1700,8970000,2,13606,3403,1,183280000,183280000,5101,1700,3401,1700,0,1,1702,3112939,3.112939
6900,1300,1700,8970000,2,13606,3403,1,183280000,183280000,5101,1700,3401,1700,0,1,1702,3066725,3.066725
6900,1300,1700,8970000,2,13606,3403,1,183280000,183280000,5101,1700,3401,1700,0,1,1702,3098437,3.098437
6900,1300,2100,8970000,2,16806,4203,1,209520000,209520000,6301,2100,4201,2100,0,1,2102,3623449,3.623449
6900,1300,2100,8970000,2,16806,4203,1,209520000,209520000,6301,2100,4201,2100,0,1,2102,3726288,3.726288
6900,1300,2100,8970000,2,16806,4203,1,209520000,209520000,6301,2100,4201,2100,0,1,2102,3544428,3.544428
6900,1300,2100,8970000,2,16806,4203,1,209520000,209520000,6301,2100,4201,2100,0,1,2102,3693314,3.693314
6900,1300,2100,8970000,2,16806,4203,1,209520000,209520000,6301,2100,4201,2100,0,1,2102,3589263,3.589263
6900,1300,2100,8970000,2,16806,4203,1,209520000,209520000,6301,2100,4201,2100,0,1,2102,3635626,3.635626
6900,1300,2100,8970000,2,16806,4203,1,209520000,209520000,6301,2100,4201,2100,0,1,2102,3575667,3.575667
6900,1300,2100,8970000,2,16806,4203,1,209520000,209520000,6301,2100,4201,2100,0,1,2102,3686599,3.686599
6900,1300,2500,8970000,2,20006,5003,1,235760000,235760000,7501,2500,5001,2500,0,1,2502,4284139,4.284139
6900,1300,2500,8970000,2,20006,5003,1,235760000,235760000,7501,2500,5001,2500,0,1,2502,4420657,4.420657
6900,1300,2500,8970000,2,20006,5003,1,235760000,235760000,7501,2500,5001,2500,0,1,2502,4210729,4.210729
6900,1300,2500,8970000,2,20006,5003,1,235760000,235760000,7501,2500,5001,2500,0,1,2502,4350065,4.350065
6900,1300,2500,8970000,2,20006,5003,1,235760000,235760000,7501,2500,5001,2500,0,1,2502,4264957,4.264957
6900,1300,2500,8970000,2,20006,5003,1,235760000,235760000,7501,2500,5001,2500,0,1,2502,4309159,4.309159
6900,1300,2500,8970000,2,20006,5003,1,235760000,235760000,7501,2500,5001,2500,0,1,2502,4251619,4.251619
6900,1300,2500,8970000,2,20006,5003,1,235760000,235760000,7501,2500,5001,2500,0,1,2502,4359370,4.35937
6900,1300,2900,8970000,2,23206,5803,1,262000000,262000000,8701,2900,5801,2900,0,1,2902,4950224,4.950224
6900,1300,2900,8970000,2,23206,5803,1,262000000,262000000,8701,2900,5801,2900,0,1,2902,5118646,5.118646
6900,1300,2900,8970000,2,23206,5803,1,262000000,262000000,8701,2900,5801,2900,0,1,2902,4860276,4.860276
6900,1300,2900,8970000,2,23206,5803,1,262000000,262000000,8701,2900,5801,2900,0,1,2902,5075403,5.075403
6900,1300,2900,8970000,2,23206,5803,1,262000000,262000000,8701,2900,5801,2900,0,1,2902,4929963,4.929963
6900,1300,2900,8970000,2,23206,5803,1,262000000,262000000,8701,2900,5801,2900,0,1,2902,4997160,4.99716
6900,1300,2900,8970000,2,23206,5803,1,262000000,262000000,8701,2900,5801,2900,0,1,2902,4911888,4.911888
6900,1300,2900,8970000,2,23206,5803,1,262000000,262000000,8701,2900,5801,2900,0,1,2902,5043964,5.043964
6900,1300,3300,8970000,2,26406,6603,1,288240000,288240000,9901,3300,6601,3300,0,1,3302,5621137,5.621137
6900,1300,3300,8970000,2,26406,6603,1,288240000,288240000,9901,3300,6601,3300,0,1,3302,5815264,5.815264
6900,1300,3300,8970000,2,26406,6603,1,288240000,288240000,9901,3300,6601,3300,0,1,3302,5525259,5.525259
6900,1300,3300,8970000,2,26406,6603,1,288240000,288240000,9901,3300,6601,3300,0,1,3302,5759643,5.759643
6900,1300,3300,8970000,2,26406,6603,1,288240000,288240000,9901,3300,6601,3300,0,1,3302,5588081,5.588081
6900,1300,3300,8970000,2,26406,6603,1,288240000,288240000,9901,3300,6601,3300,0,1,3302,5676674,5.676674
6900,1300,3300,8970000,2,26406,6603,1,288240000,288240000,9901,3300,6601,3300,0,1,3302,5562023,5.562023
6900,1300,3300,8970000,2,26406,6603,1,288240000,288240000,9901,3300,6601,3300,0,1,3302,5745182,5.745182
6900,1300,3700,8970000,2,29606,7403,1,314480000,314480000,11101,3700,7401,3700,0,1,3702,6472836,6.472836
6900,1300,3700,8970000,2,29606,7403,1,314480000,314480000,11101,3700,7401,3700,0,1,3702,6604820,6.60482
6900,1300,3700,8970000,2,29606,7403,1,314480000,314480000,11101,3700,7401,3700,0,1,3702,6344271,6.344271
6900,1300,3700,8970000,2,29606,7403,1,314480000,314480000,11101,3700,7401,3700,0,1,3702,6568888,6.568888
6900,1300,3700,8970000,2,29606,7403,1,314480000,314480000,11101,3700,7401,3700,0,1,3702,6437289,6.437289
6900,1300,3700,8970000,2,29606,7403,1,314480000,314480000,11101,3700,7401,3700,0,1,3702,6465698,6.465698
6900,1300,3700,8970000,2,29606,7403,1,314480000,314480000,11101,3700,7401,3700,0,1,3702,6378690,6.37869
6900,1300,3700,8970000,2,29606,7403,1,314480000,314480000,11101,3700,7401,3700,0,1,3702,6548276,6.548276
6900,1300,4100,8970000,2,32806,8203,1,340720000,340720000,12301,4100,8201,4100,0,1,4102,6973409,6.973409
6900,1300,4100,8970000,2,32806,8203,1,340720000,340720000,12301,4100,8201,4100,0,1,4102,7205097,7.205097
6900,1300,4100,8970000,2,32806,8203,1,340720000,340720000,12301,4100,8201,4100,0,1,4102,6845111,6.845111
6900,1300,4100,8970000,2,32806,8203,1,340720000,340720000,12301,4100,8201,4100,0,1,4102,7091226,7.091226
6900,1300,4100,8970000,2,32806,8203,1,340720000,340720000,12301,4100,8201,4100,0,1,4102,6940058,6.940058
6900,1300,4100,8970000,2,32806,8203,1,340720000,340720000,12301,4100,8201,4100,0,1,4102,7023653,7.023653
6900,1300,4100,8970000,2,32806,8203,1,340720000,340720000,12301,4100,8201,4100,0,1,4102,6896257,6.896257
6900,1300,4100,8970000,2,32806,8203,1,340720000,340720000,12301,4100,8201,4100,0,1,4102,7118902,7.118902
6900,1300,4500,8970000,2,36006,9003,1,366960000,366960000,13501,4500,9001,4500,0,1,4502,7803243,7.803243
6900,1300,4500,8970000,2,36006,9003,1,366960000,366960000,13501,4500,9001,4500,0,1,4502,8037452,8.037452
6900,1300,4500,8970000,2,36006,9003,1,366960000,366960000,13501,4500,9001,4500,0,1,4502,7660023,7.660023
6900,1300,4500,8970000,2,36006,9003,1,366960000,366960000,13501,4500,9001,4500,0,1,4502,7894535,7.894535
6900,1300,4500,8970000,2,36006,9003,1,366960000,366960000,13501,4500,9001,4500,0,1,4502,7755016,7.755016
6900,1300,4500,8970000,2,36006,9003,1,366960000,366960000,13501,4500,9001,4500,0,1,4502,7796739,7.796739
6900,1300,4500,8970000,2,36006,9003,1,366960000,366960000,13501,4500,9001,4500,0,1,4502,7702942,7.702942
6900,1300,4500,8970000,2,36006,9003,1,366960000,366960000,13501,4500,9001,4500,0,1,4502,7911417,7.911417
6900,1300,4900,8970000,2,39206,9803,1,393200000,393200000,14701,4900,9801,4900,0,1,4902,8322941,8.322941
6900,1300,4900,8970000,2,39206,9803,1,393200000,393200000,14701,4900,9801,4900,0,1,4902,8609641,8.609641
6900,1300,4900,8970000,2,39206,9803,1,393200000,393200000,14701,4900,9801,4900,0,1,4902,8171847,8.171847
6900,1300,4900,8970000,2,39206,9803,1,393200000,393200000,14701,4900,9801,4900,0,1,4902,8471476,8.471476
6900,1300,4900,8970000,2,39206,9803,1,393200000,393200000,14701,4900,9801,4900,0,1,4902,8274699,8.274699
6900,1300,4900,8970000,2,39206,9803,1,393200000,393200000,14701,4900,9801,4900,0,1,4902,8395702,8.395702
6900,1300,4900,8970000,2,39206,9803,1,393200000,393200000,14701,4900,9801,4900,0,1,4902,8231652,8.231652
6900,1300,4900,8970000,2,39206,9803,1,393200000,393200000,14701,4900,9801,4900,0,1,4902,8506298,8.506298
6900,1300,5300,8970000,2,42406,10603,1,419440000,419440000,15901,5300,10601,5300,0,1,5302,9162204,9.162204
6900,1300,5300,8970000,2,42406,10603,1,419440000,419440000,15901,5300,10601,5300,0,1,5302,9400525,9.400525
6900,1300,5300,8970000,2,42406,10603,1,419440000,419440000,15901,5300,10601,5300,0,1,5302,8981354,8.981354
6900,1300,5300,8970000,2,42406,10603,1,419440000,419440000,15901,5300,10601,5300,0,1,5302,9303316,9.303316
6900,1300,5300,8970000,2,42406,10603,1,419440000,419440000,15901,5300,10601,5300,0,1,5302,9103507,9.103507
6900,1300,5300,8970000,2,42406,10603,1,419440000,419440000,15901,5300,10601,5300,0,1,5302,9177474,9.177474
6900,1300,5300,8970000,2,42406,10603,1,419440000,419440000,15901,5300,10601,5300,0,1,5302,9058246,9.058246
6900,1300,5300,8970000,2,42406,10603,1,419440000,419440000,15901,5300,10601,5300,0,1,5302,9309723,9.309723
6900,1300,5700,8970000,2,45606,11403,1,445680000,445680000,17101,5700,11401,5700,0,1,5702,9839470,9.83947
6900,1300,5700,8970000,2,45606,11403,1,445680000,445680000,17101,5700,11401,5700,0,1,5702,10021949,10.021949
6900,1300,5700,8970000,2,45606,11403,1,445680000,445680000,17101,5700,11401,5700,0,1,5702,9641617,9.641617
6900,1300,5700,8970000,2,45606,11403,1,445680000,445680000,17101,5700,11401,5700,0,1,5702,9994349,9.994349
6900,1300,5700,8970000,2,45606,11403,1,445680000,445680000,17101,5700,11401,5700,0,1,5702,9761432,9.761432
6900,1300,5700,8970000,2,45606,11403,1,445680000,445680000,17101,5700,11401,5700,0,1,5702,9867814,9.867814
6900,1300,5700,8970000,2,45606,11403,1,445680000,445680000,17101,5700,11401,5700,0,1,5702,9706210,9.70621
6900,1300,5700,8970000,2,45606,11403,1,445680000,445680000,17101,5700,11401,5700,0,1,5702,10009504,10.009504
6900,1300,6100,8970000,2,48806,12203,1,471920000,471920000,18301,6100,12201,6100,0,1,6102,10355134,10.355134
6900,1300,6100,8970000,2,48806,12203,1,471920000,471920000,18301,6100,12201,6100,0,1,6102,10792008,10.792008
6900,1300,6100,8970000,2,48806,12203,1,471920000,471920000,18301,6100,12201,6100,0,1,6102,10155494,10.155494
6900,1300,6100,8970000,2,48806,12203,1,471920000,471920000,18301,6100,12201,6100,0,1,6102,10524560,10.52456
6900,1300,6100,8970000,2,48806,12203,1,471920000,471920000,18301,6100,12201,6100,0,1,6102,10256018,10.256018
6900,1300,6100,8970000,2,48806,12203,1,471920000,471920000,18301,6100,12201,6100,0,1,6102,10433787,10.433787
6900,1300,6100,8970000,2,48806,12203,1,471920000,471920000,18301,6100,12201,6100,0,1,6102,10239463,10.239463
6900,1300,6100,8970000,2,48806,12203,1,471920000,471920000,18301,6100,12201,6100,0,1,6102,10584428,10.584428
6900,1300,6500,8970000,2,52006,13003,1,498160000,498160000,19501,6500,13001,6500,0,1,6502,11187721,11.187721
6900,1300,6500,8970000,2,52006,13003,1,498160000,498160000,19501,6500,13001,6500,0,1,6502,11496723,11.496723
6900,1300,6500,8970000,2,52006,13003,1,498160000,498160000,19501,6500,13001,6500,0,1,6502,10962722,10.962722
6900,1300,6500,8970000,2,52006,13003,1,498160000,498160000,19501,6500,13001,6500,0,1,6502,11345044,11.345044
6900,1300,6500,8970000,2,52006,13003,1,498160000,498160000,19501,6500,13001,6500,0,1,6502,11087059,11.087059
6900,1300,6500,8970000,2,52006,13003,1,498160000,498160000,19501,6500,13001,6500,0,1,6502,11194631,11.194631
6900,1300,6500,8970000,2,52006,13003,1,498160000,498160000,19501,6500,13001,6500,0,1,6502,11047201,11.047201
6900,1300,6500,8970000,2,52006,13003,1,498160000,498160000,19501,6500,13001,6500,0,1,6502,11374221,11.374221
6900,1300,6900,8970000,2,55206,13803,1,524400000,524400000,20701,6900,13801,6900,0,1,6902,11875337,11.875337
6900,1300,6900,8970000,2,55206,13803,1,524400000,524400000,20701,6900,13801,6900,0,1,6902,12215615,12.215615
6900,1300,6900,8970000,2,55206,13803,1,524400000,524400000,20701,6900,13801,6900,0,1,6902,11627107,11.627107
6900,1300,6900,8970000,2,55206,13803,1,524400000,524400000,20701,6900,13801,6900,0,1,6902,12001337,12.001337
6900,1300,6900,8970000,2,55206,13803,1,524400000,524400000,20701,6900,13801,6900,0,1,6902,11721451,11.721451
6900,1300,6900,8970000,2,55206,13803,1,524400000,524400000,20701,6900,13801,6900,0,1,6902,11908240,11.90824
6900,1300,6900,8970000,2,55206,13803,1,524400000,524400000,20701,6900,13801,6900,0,1,6902,11739572,11.739572
6900,1300,6900,8970000,2,55206,13803,1,524400000,524400000,20701,6900,13801,6900,0,1,6902,12068550,12.06855
6900,900,500,6210000,2,4006,1003,1,80880000,80880000,1501,500,1001,500,0,1,502,632010,0.63201
6900,900,500,6210000,2,4006,1003,1,80880000,80880000,1501,500,1001,500,0,1,502,645979,0.645979
6900,900,500,6210000,2,4006,1003,1,80880000,80880000,1501,500,1001,500,0,1,502,632316,0.632316
6900,900,500,6210000,2,4006,1003,1,80880000,80880000,1501,500,1001,500,0,1,502,655486,0.655486
6900,900,500,6210000,2,4006,1003,1,80880000,80880000,1501,500,1001,500,0,1,502,640136,0.640136
6900,900,500,6210000,2,4006,1003,1,80880000,80880000,1501,500,1001,500,0,1,502,646337,0.646337
6900,900,500,6210000,2,4006,1003,1,80880000,80880000,1501,500,1001,500,0,1,502,645209,0.645209
6900,900,500,6210000,2,4006,1003,1,80880000,80880000,1501,500,1001,500,0,1,502,650763,0.650763
6900,900,900,6210000,2,7206,1803,1,105840000,105840000,2701,900,1801,900,0,1,902,1103107,1.103107
6900,900,900,6210000,2,7206,1803,1,105840000,105840000,2701,900,1801,900,0,1,902,1139984,1.139984
6900,900,900,6210000,2,7206,1803,1,105840000,105840000,2701,900,1801,900,0,1,902,1093539,1.093539
6900,900,900,6210000,2,7206,1803,1,105840000,105840000,2701,900,1801,900,0,1,902,1135173,1.135173
6900,900,900,6210000,2,7206,1803,1,105840000,105840000,2701,900,1801,900,0,1,902,1107955,1.107955
6900,900,900,6210000,2,7206,1803,1,105840000,105840000,2701,900,1801,900,0,1,902,1113411,1.113411
6900,900,900,6210000,2,7206,1803,1,105840000,105840000,2701,900,1801,900,0,1,902,1098569,1.098569
6900,900,900,6210000,2,7206,1803,1,105840000,105840000,2701,900,1801,900,0,1,902,1118187,1.118187
6900,900,1300,6210000,2,10406,2603,1,130800000,130800000,3901,1300,2601,1300,0,1,1302,1569754,1.569754
6900,900,1300,6210000,2,10406,2603,1,130800000,130800000,3901,1300,2601,1300,0,1,1302,1622976,1.622976
6900,900,1300,6210000,2,10406,2603,1,130800000,130800000,3901,1300,2601,1300,0,1,1302,1553617,1.553617
6900,900,1300,6210000,2,10406,2603,1,130800000,130800000,3901,1300,2601,1300,0,1,1302,1610611,1.610611
6900,900,1300,6210000,2,10406,2603,1,130800000,130800000,3901,1300,2601,1300,0,1,1302,1582603,1.582603
6900,900,1300,6210000,2,10406,2603,1,130800000,130800000,3901,1300,2601,1300,0,1,1302,1588437,1.588437
6900,900,1300,6210000,2,10406,2603,1,130800000,130800000,3901,1300,2601,1300,0,1,1302,1558154,1.558154
6900,900,1300,6210000,2,10406,2603,1,130800000,130800000,3901,1300,2601,1300,0,1,1302,1605770,1.60577
6900,900,1700,6210000,2,13606,3403,1,155760000,155760000,5101,1700,3401,1700,0,1,1702,2038380,2.03838
6900,900,1700,6210000,2,13606,3403,1,155760000,155760000,5101,1700,3401,1700,0,1,1702,2098999,2.098999
6900,900,1700,6210000,2,13606,3403,1,155760000,155760000,5101,1700,3401,1700,0,1,1702,2013364,2.013364
6900,900,1700,6210000,2,13606,3403,1,155760000,155760000,5101,1700,3401,1700,0,1,1702,2087507,2.087507
6900,900,1700,6210000,2,13606,3403,1,155760000,155760000,5101,1700,3401,1700,0,1,1702,2032604,2.032604
6900,900,1700,6210000,2,13606,3403,1,155760000,155760000,5101,1700,3401,1700,0,1,1702,2051897,2.051897
6900,900,1700,6210000,2,13606,3403,1,155760000,155760000,5101,1700,3401,1700,0,1,1702,2019106,2.019106
6900,900,1700,6210000,2,13606,3403,1,155760000,155760000,5101,1700,3401,1700,0,1,1702,2079477,2.079477
6900,900,2100,6210000,2,16806,4203,1,180720000,180720000,6301,2100,4201,2100,0,1,2102,2507698,2.507698
6900,900,2100,6210000,2,16806,4203,1,180720000,180720000,6301,2100,4201,2100,0,1,2102,2594933,2.594933
6900,900,2100,6210000,2,16806,4203,1,180720000,180720000,6301,2100,4201,2100,0,1,2102,2471611,2.471611
6900,900,2100,6210000,2,16806,4203,1,180720000,180720000,6301,2100,4201,2100,0,1,2102,2565749,2.565749
6900,900,2100,6210000,2,16806,4203,1,180720000,180720000,6301,2100,4201,2100,0,1,2102,2495235,2.495235
6900,900,2100,6210000,2,16806,4203,1,180720000,180720000,6301,2100,4201,2100,0,1,2102,2528715,2.528715
6900,900,2100,6210000,2,16806,4203,1,180720000,180720000,6301,2100,4201,2100,0,1,2102,2499811,2.499811
6900,900,2100,6210000,2,16806,4203,1,180720000,180720000,6301,2100,4201,2100,0,1,2102,2560997,2.560997
6900,900,2500,6210000,2,20006,5003,1,205680000,205680000,7501,2500,5001,2500,0,1,2502,3103401,3.103401
6900,900,2500,6210000,2,20006,5003,1,205680000,205680000,7501,2500,5001,2500,0,1,2502,3079228,3.079228
6900,900,2500,6210000,2,20006,5003,1,205680000,205680000,7501,2500,5001,2500,0,1,2502,3066050,3.06605
6900,900,2500,6210000,2,20006,5003,1,205680000,205680000,7501,2500,5001,2500,0,1,2502,3167022,3.167022
6900,900,2500,6210000,2,20006,5003,1,205680000,205680000,7501,2500,5001,2500,0,1,2502,3125842,3.125842
6900,900,2500,6210000,2,20006,5003,1,205680000,205680000,7501,2500,5001,2500,0,1,2502,2999024,2.999024
6900,900,2500,6210000,2,20006,5003,1,205680000,205680000,7501,2500,5001,2500,0,1,2502,3130452,3.130452
6900,900,2500,6210000,2,20006,5003,1,205680000,205680000,7501,2500,5001,2500,0,1,2502,3153952,3.153952
6900,900,2900,6210000,2,23206,5803,1,230640000,230640000,8701,2900,5801,2900,0,1,2902,3440847,3.440847
6900,900,2900,6210000,2,23206,5803,1,230640000,230640000,8701,2900,5801,2900,0,1,2902,3577988,3.577988
6900,900,2900,6210000,2,23206,5803,1,230640000,230640000,8701,2900,5801,2900,0,1,2902,3388610,3.38861
6900,900,2900,6210000,2,23206,5803,1,230640000,230640000,8701,2900,5801,2900,0,1,2902,3519712,3.519712
6900,900,2900,6210000,2,23206,5803,1,230640000,230640000,8701,2900,5801,2900,0,1,2902,3419463,3.419463
6900,900,2900,6210000,2,23206,5803,1,230640000,230640000,8701,2900,5801,2900,0,1,2902,3573053,3.573053
6900,900,2900,6210000,2,23206,5803,1,230640000,230640000,8701,2900,5801,2900,0,1,2902,3424007,3.424007
6900,900,2900,6210000,2,23206,5803,1,230640000,230640000,8701,2900,5801,2900,0,1,2902,3524473,3.524473
6900,900,3300,6210000,2,26406,6603,1,255600000,255600000,9901,3300,6601,3300,0,1,3302,3923697,3.923697
6900,900,3300,6210000,2,26406,6603,1,255600000,255600000,9901,3300,6601,3300,0,1,3302,4155710,4.15571
6900,900,3300,6210000,2,26406,6603,1,255600000,255600000,9901,3300,6601,3300,0,1,3302,3882998,3.882998
6900,900,3300,6210000,2,26406,6603,1,255600000,255600000,9901,3300,6601,3300,0,1,3302,3999574,3.999574
6900,900,3300,6210000,2,26406,6603,1,255600000,255600000,9901,3300,6601,3300,0,1,3302,3927481,3.927481
6900,900,3300,6210000,2,26406,6603,1,255600000,255600000,9901,3300,6601,3300,0,1,3302,3946488,3.946488
6900,900,3300,6210000,2,26406,6603,1,255600000,255600000,9901,3300,6601,3300,0,1,3302,3902611,3.902611
6900,900,3300,6210000,2,26406,6603,1,255600000,255600000,9901,3300,6601,3300,0,1,3302,4004292,4.004292
6900,900,3700,6210000,2,29606,7403,1,280560000,280560000,11101,3700,7401,3700,0,1,3702,4390363,4.390363
6900,900,3700,6210000,2,29606,7403,1,280560000,280560000,11101,3700,7401,3700,0,1,3702,4539012,4.539012
6900,900,3700,6210000,2,29606,7403,1,280560000,280560000,11101,3700,7401,3700,0,1,3702,4378459,4.378459
6900,900,3700,6210000,2,29606,7403,1,280560000,280560000,11101,3700,7401,3700,0,1,3702,4495831,4.495831
6900,900,3700,6210000,2,29606,7403,1,280560000,280560000,11101,3700,7401,3700,0,1,3702,4395022,4.395022
6900,900,3700,6210000,2,29606,7403,1,280560000,280560000,11101,3700,7401,3700,0,1,3702,4430263,4.430263
6900,900,3700,6210000,2,29606,7403,1,280560000,280560000,11101,3700,7401,3700,0,1,3702,4356500,4.3565
6900,900,3700,6210000,2,29606,7403,1,280560000,280560000,11101,3700,7401,3700,0,1,3702,4500604,4.500604
6900,900,4100,6210000,2,32806,8203,1,305520000,305520000,12301,4100,8201,4100,0,1,4102,4864249,4.864249
6900,900,4100,6210000,2,32806,8203,1,305520000,305520000,12301,4100,8201,4100,0,1,4102,5033905,5.033905
6900,900,4100,6210000,2,32806,8203,1,305520000,305520000,12301,4100,8201,4100,0,1,4102,4777942,4.777942
6900,900,4100,6210000,2,32806,8203,1,305520000,305520000,12301,4100,8201,4100,0,1,4102,4970230,4.97023
6900,900,4100,6210000,2,32806,8203,1,305520000,305520000,12301,4100,8201,4100,0,1,4102,4855686,4.855686
6900,900,4100,6210000,2,32806,8203,1,305520000,305520000,12301,4100,8201,4100,0,1,4102,4908422,4.908422
6900,900,4100,6210000,2,32806,8203,1,305520000,305520000,12301,4100,8201,4100,0,1,4102,4830723,4.830723
6900,900,4100,6210000,2,32806,8203,1,305520000,305520000,12301,4100,8201,4100,0,1,4102,4953202,4.953202
6900,900,4500,6210000,2,36006,9003,1,330480000,330480000,13501,4500,9001,4500,0,1,4502,5542049,5.542049
6900,900,4500,6210000,2,36006,9003,1,330480000,330480000,13501,4500,9001,4500,0,1,4502,5519330,5.51933
6900,900,4500,6210000,2,36006,9003,1,330480000,330480000,13501,4500,9001,4500,0,1,4502,5412328,5.412328
6900,900,4500,6210000,2,36006,9003,1,330480000,330480000,13501,4500,9001,4500,0,1,4502,5537773,5.537773
6900,900,4500,6210000,2,36006,9003,1,330480000,330480000,13501,4500,9001,4500,0,1,4502,5449038,5.449038
6900,900,4500,6210000,2,36006,9003,1,330480000,330480000,13501,4500,9001,4500,0,1,4502,5370523,5.370523
6900,900,4500,6210000,2,36006,9003,1,330480000,330480000,13501,4500,9001,4500,0,1,4502,5470927,5.470927
6900,900,4500,6210000,2,36006,9003,1,330480000,330480000,13501,4500,9001,4500,0,1,4502,5559349,5.559349
6900,900,4900,6210000,2,39206,9803,1,355440000,355440000,14701,4900,9801,4900,0,1,4902,5801967,5.801967
6900,900,4900,6210000,2,39206,9803,1,355440000,355440000,14701,4900,9801,4900,0,1,4902,6084638,6.084638
6900,900,4900,6210000,2,39206,9803,1,355440000,355440000,14701,4900,9801,4900,0,1,4902,5699593,5.699593
6900,900,4900,6210000,2,39206,9803,1,355440000,355440000,14701,4900,9801,4900,0,1,4902,5911274,5.911274
6900,900,4900,6210000,2,39206,9803,1,355440000,355440000,14701,4900,9801,4900,0,1,4902,5752411,5.752411
6900,900,4900,6210000,2,39206,9803,1,355440000,355440000,14701,4900,9801,4900,0,1,4902,5956788,5.956788
6900,900,4900,6210000,2,39206,9803,1,355440000,355440000,14701,4900,9801,4900,0,1,4902,5760981,5.760981
6900,900,4900,6210000,2,39206,9803,1,355440000,355440000,14701,4900,9801,4900,0,1,4902,5906571,5.906571
6900,900,5300,6210000,2,42406,10603,1,380400000,380400000,15901,5300,10601,5300,0,1,5302,6271377,6.271377
6900,900,5300,6210000,2,42406,10603,1,380400000,380400000,15901,5300,10601,5300,0,1,5302,6483199,6.483199
6900,900,5300,6210000,2,42406,10603,1,380400000,380400000,15901,5300,10601,5300,0,1,5302,6152558,6.152558
6900,900,5300,6210000,2,42406,10603,1,380400000,380400000,15901,5300,10601,5300,0,1,5302,6391139,6.391139
6900,900,5300,6210000,2,42406,10603,1,380400000,380400000,15901,5300,10601,5300,0,1,5302,6230526,6.230526
6900,900,5300,6210000,2,42406,10603,1,380400000,380400000,15901,5300,10601,5300,0,1,5302,6338388,6.338388
6900,900,5300,6210000,2,42406,10603,1,380400000,380400000,15901,5300,10601,5300,0,1,5302,6216561,6.216561
6900,900,5300,6210000,2,42406,10603,1,380400000,380400000,15901,5300,10601,5300,0,1,5302,6396846,6.396846
6900,900,5700,6210000,2,45606,11403,1,405360000,405360000,17101,5700,11401,5700,0,1,5702,6915740,6.91574
6900,900,5700,6210000,2,45606,11403,1,405360000,405360000,17101,5700,11401,5700,0,1,5702,7072182,7.072182
6900,900,5700,6210000,2,45606,11403,1,405360000,405360000,17101,5700,11401,5700,0,1,5702,6775535,6.775535
6900,900,5700,6210000,2,45606,11403,1,405360000,405360000,17101,5700,11401,5700,0,1,5702,6964746,6.964746
6900,900,5700,6210000,2,45606,11403,1,405360000,405360000,17101,5700,11401,5700,0,1,5702,6818935,6.818935
6900,900,5700,6210000,2,45606,11403,1,405360000,405360000,17101,5700,11401,5700,0,1,5702,6920988,6.920988
6900,900,5700,6210000,2,45606,11403,1,405360000,405360000,17101,5700,11401,5700,0,1,5702,6841887,6.841887
6900,900,5700,6210000,2,45606,11403,1,405360000,405360000,17101,5700,11401,5700,0,1,5702,6996033,6.996033
6900,900,6100,6210000,2,48806,12203,1,430320000,430320000,18301,6100,12201,6100,0,1,6102,7212664,7.212664
6900,900,6100,6210000,2,48806,12203,1,430320000,430320000,18301,6100,12201,6100,0,1,6102,7459353,7.459353
6900,900,6100,6210000,2,48806,12203,1,430320000,430320000,18301,6100,12201,6100,0,1,6102,7082968,7.082968
6900,900,6100,6210000,2,48806,12203,1,430320000,430320000,18301,6100,12201,6100,0,1,6102,7377223,7.377223
6900,900,6100,6210000,2,48806,12203,1,430320000,430320000,18301,6100,12201,6100,0,1,6102,7168505,7.168505
6900,900,6100,6210000,2,48806,12203,1,430320000,430320000,18301,6100,12201,6100,0,1,6102,7278280,7.27828
6900,900,6100,6210000,2,48806,12203,1,430320000,430320000,18301,6100,12201,6100,0,1,6102,7163762,7.163762
6900,900,6100,6210000,2,48806,12203,1,430320000,430320000,18301,6100,12201,6100,0,1,6102,7350218,7.350218
6900,900,6500,6210000,2,52006,13003,1,455280000,455280000,19501,6500,13001,6500,0,1,6502,7847314,7.847314
6900,900,6500,6210000,2,52006,13003,1,455280000,455280000,19501,6500,13001,6500,0,1,6502,8034696,8.034696
6900,900,6500,6210000,2,52006,13003,1,455280000,455280000,19501,6500,13001,6500,0,1,6502,7695323,7.695323
6900,900,6500,6210000,2,52006,13003,1,455280000,455280000,19501,6500,13001,6500,0,1,6502,7961678,7.961678
6900,900,6500,6210000,2,52006,13003,1,455280000,455280000,19501,6500,13001,6500,0,1,6502,7798405,7.798405
6900,900,6500,6210000,2,52006,13003,1,455280000,455280000,19501,6500,13001,6500,0,1,6502,7837524,7.837524
6900,900,6500,6210000,2,52006,13003,1,455280000,455280000,19501,6500,13001,6500,0,1,6502,7772338,7.772338
6900,900,6500,6210000,2,52006,13003,1,455280000,455280000,19501,6500,13001,6500,0,1,6502,7943319,7.943319
6900,900,6900,6210000,2,55206,13803,1,480240000,480240000,20701,6900,13801,6900,0,1,6902,8159964,8.159964
6900,900,6900,6210000,2,55206,13803,1,480240000,480240000,20701,6900,13801,6900,0,1,6902,8443920,8.44392
6900,900,6900,6210000,2,55206,13803,1,480240000,480240000,20701,6900,13801,6900,0,1,6902,8006555,8.006555
6900,900,6900,6210000,2,55206,13803,1,480240000,480240000,20701,6900,13801,6900,0,1,6902,8299626,8.299626
6900,900,6900,6210000,2,55206,13803,1,480240000,480240000,20701,6900,13801,6900,0,1,6902,8101487,8.101487
6900,900,6900,6210000,2,55206,13803,1,480240000,480240000,20701,6900,13801,6900,0,1,6902,8224517,8.224517
6900,900,6900,6210000,2,55206,13803,1,480240000,480240000,20701,6900,13801,6900,0,1,6902,8096530,8.09653
6900,900,6900,6210000,2,55206,13803,1,480240000,480240000,20701,6900,13801,6900,0,1,6902,8313482,8.313482
6900,500,500,3450000,2,4006,1003,1,57200000,57200000,1501,500,1001,500,0,1,502,348324,0.348324
6900,500,500,3450000,2,4006,1003,1,57200000,57200000,1501,500,1001,500,0,1,502,344260,0.34426
6900,500,500,3450000,2,4006,1003,1,57200000,57200000,1501,500,1001,500,0,1,502,348624,0.348624
6900,500,500,3450000,2,4006,1003,1,57200000,57200000,1501,500,1001,500,0,1,502,363101,0.363101
6900,500,500,3450000,2,4006,1003,1,57200000,57200000,1501,500,1001,500,0,1,502,359473,0.359473
6900,500,500,3450000,2,4006,1003,1,57200000,57200000,1501,500,1001,500,0,1,502,359677,0.359677
6900,500,500,3450000,2,4006,1003,1,57200000,57200000,1501,500,1001,500,0,1,502,356936,0.356936
6900,500,500,3450000,2,4006,1003,1,57200000,57200000,1501,500,1001,500,0,1,502,353235,0.353235
6900,500,900,3450000,2,7206,1803,1,80880000,80880000,2701,900,1801,900,0,1,902,613487,0.613487
6900,500,900,3450000,2,7206,1803,1,80880000,80880000,2701,900,1801,900,0,1,902,624684,0.624684
6900,500,900,3450000,2,7206,1803,1,80880000,80880000,2701,900,1801,900,0,1,902,609816,0.609816
6900,500,900,3450000,2,7206,1803,1,80880000,80880000,2701,900,1801,900,0,1,902,629648,0.629648
6900,500,900,3450000,2,7206,1803,1,80880000,80880000,2701,900,1801,900,0,1,902,619375,0.619375
6900,500,900,3450000,2,7206,1803,1,80880000,80880000,2701,900,1801,900,0,1,902,618943,0.618943
6900,500,900,3450000,2,7206,1803,1,80880000,80880000,2701,900,1801,900,0,1,902,621733,0.621733
6900,500,900,3450000,2,7206,1803,1,80880000,80880000,2701,900,1801,900,0,1,902,624438,0.624438
6900,500,1300,3450000,2,10406,2603,1,104560000,104560000,3901,1300,2601,1300,0,1,1302,903713,0.903713
6900,500,1300,3450000,2,10406,2603,1,104560000,104560000,3901,1300,2601,1300,0,1,1302,907485,0.907485
6900,500,1300,3450000,2,10406,2603,1,104560000,104560000,3901,1300,2601,1300,0,1,1302,877619,0.877619
6900,500,1300,3450000,2,10406,2603,1,104560000,104560000,3901,1300,2601,1300,0,1,1302,912864,0.912864
6900,500,1300,3450000,2,10406,2603,1,104560000,104560000,3901,1300,2601,1300,0,1,1302,887254,0.887254
6900,500,1300,3450000,2,10406,2603,1,104560000,104560000,3901,1300,2601,1300,0,1,1302,901179,0.901179
6900,500,1300,3450000,2,10406,2603,1,104560000,104560000,3901,1300,2601,1300,0,1,1302,889975,0.889975
6900,500,1300,3450000,2,10406,2603,1,104560000,104560000,3901,1300,2601,1300,0,1,1302,896517,0.896517
6900,500,1700,3450000,2,13606,3403,1,128240000,128240000,5101,1700,3401,1700,0,1,1702,1150127,1.150127
6900,500,1700,3450000,2,13606,3403,1,128240000,128240000,5101,1700,3401,1700,0,1,1702,1174631,1.174631
6900,500,1700,3450000,2,13606,3403,1,128240000,128240000,5101,1700,3401,1700,0,1,1702,1143512,1.143512
6900,500,1700,3450000,2,13606,3403,1,128240000,128240000,5101,1700,3401,1700,0,1,1702,1178195,1.178195
6900,500,1700,3450000,2,13606,3403,1,128240000,128240000,5101,1700,3401,1700,0,1,1702,1162669,1.162669
6900,500,1700,3450000,2,13606,3403,1,128240000,128240000,5101,1700,3401,1700,0,1,1702,1157483,1.157483
6900,500,1700,3450000,2,13606,3403,1,128240000,128240000,5101,1700,3401,1700,0,1,1702,1146248,1.146248
6900,500,1700,3450000,2,13606,3403,1,128240000,128240000,5101,1700,3401,1700,0,1,1702,1167772,1.167772
6900,500,2100,3450000,2,16806,4203,1,151920000,151920000,6301,2100,4201,2100,0,1,2102,1412389,1.412389
6900,500,2100,3450000,2,16806,4203,1,151920000,151920000,6301,2100,4201,2100,0,1,2102,1448575,1.448575
6900,500,2100,3450000,2,16806,4203,1,151920000,151920000,6301,2100,4201,2100,0,1,2102,1401532,1.401532
6900,500,2100,3450000,2,16806,4203,1,151920000,151920000,6301,2100,4201,2100,0,1,2102,1444736,1.444736
6900,500,2100,3450000,2,16806,4203,1,151920000,151920000,6301,2100,4201,2100,0,1,2102,1423633,1.423633
6900,500,2100,3450000,2,16806,4203,1,151920000,151920000,6301,2100,4201,2100,0,1,2102,1418170,1.41817
6900,500,2100,3450000,2,16806,4203,1,151920000,151920000,6301,2100,4201,2100,0,1,2102,1415240,1.41524
6900,500,2100,3450000,2,16806,4203,1,151920000,151920000,6301,2100,4201,2100,0,1,2102,1434172,1.434172
6900,500,2500,3450000,2,20006,5003,1,175600000,175600000,7501,2500,5001,2500,0,1,2502,1823038,1.823038
6900,500,2500,3450000,2,20006,5003,1,175600000,175600000,7501,2500,5001,2500,0,1,2502,1842287,1.842287
6900,500,2500,3450000,2,20006,5003,1,175600000,175600000,7501,2500,5001,2500,0,1,2502,1685067,1.685067
6900,500,2500,3450000,2,20006,5003,1,175600000,175600000,7501,2500,5001,2500,0,1,2502,1830825,1.830825
6900,500,2500,3450000,2,20006,5003,1,175600000,175600000,7501,2500,5001,2500,0,1,2502,1795379,1.795379
6900,500,2500,3450000,2,20006,5003,1,175600000,175600000,7501,2500,5001,2500,0,1,2502,1819045,1.819045
6900,500,2500,3450000,2,20006,5003,1,175600000,175600000,7501,2500,5001,2500,0,1,2502,1826899,1.826899
6900,500,2500,3450000,2,20006,5003,1,175600000,175600000,7501,2500,5001,2500,0,1,2502,1836926,1.836926
6900,500,2900,3450000,2,23206,5803,1,199280000,199280000,8701,2900,5801,2900,0,1,2902,1932450,1.93245
6900,500,2900,3450000,2,23206,5803,1,199280000,199280000,8701,2900,5801,2900,0,1,2902,1991149,1.991149
6900,500,2900,3450000,2,23206,5803,1,199280000,199280000,8701,2900,5801,2900,0,1,2902,1924093,1.924093
6900,500,2900,3450000,2,23206,5803,1,199280000,199280000,8701,2900,5801,2900,0,1,2902,1997548,1.997548
6900,500,2900,3450000,2,23206,5803,1,199280000,199280000,8701,2900,5801,2900,0,1,2902,1984593,1.984593
6900,500,2900,3450000,2,23206,5803,1,199280000,199280000,8701,2900,5801,2900,0,1,2902,1978624,1.978624
6900,500,2900,3450000,2,23206,5803,1,199280000,199280000,8701,2900,5801,2900,0,1,2902,1957814,1.957814
6900,500,2900,3450000,2,23206,5803,1,199280000,199280000,8701,2900,5801,2900,0,1,2902,2003344,2.003344
6900,500,3300,3450000,2,26406,6603,1,222960000,222960000,9901,3300,6601,3300,0,1,3302,2216936,2.216936
6900,500,3300,3450000,2,26406,6603,1,222960000,222960000,9901,3300,6601,3300,0,1,3302,2291647,2.291647
6900,500,3300,3450000,2,26406,6603,1,222960000,222960000,9901,3300,6601,3300,0,1,3302,2189542,2.189542
6900,500,3300,3450000,2,26406,6603,1,222960000,222960000,9901,3300,6601,3300,0,1,3302,2251614,2.251614
6900,500,3300,3450000,2,26406,6603,1,222960000,222960000,9901,3300,6601,3300,0,1,3302,2193858,2.193858
6900,500,3300,3450000,2,26406,6603,1,222960000,222960000,9901,3300,6601,3300,0,1,3302,2214159,2.214159
6900,500,3300,3450000,2,26406,6603,1,222960000,222960000,9901,3300,6601,3300,0,1,3302,2225661,2.225661
6900,500,3300,3450000,2,26406,6603,1,222960000,222960000,9901,3300,6601,3300,0,1,3302,2262416,2.262416
6900,500,3700,3450000,2,29606,7403,1,246640000,246640000,11101,3700,7401,3700,0,1,3702,2479195,2.479195
6900,500,3700,3450000,2,29606,7403,1,246640000,246640000,11101,3700,7401,3700,0,1,3702,2542245,2.542245
6900,500,3700,3450000,2,29606,7403,1,246640000,246640000,11101,3700,7401,3700,0,1,3702,2451399,2.451399
6900,500,3700,3450000,2,29606,7403,1,246640000,246640000,11101,3700,7401,3700,0,1,3702,2536118,2.536118
6900,500,3700,3450000,2,29606,7403,1,246640000,246640000,11101,3700,7401,3700,0,1,3702,2463446,2.463446
6900,500,3700,3450000,2,29606,7403,1,246640000,246640000,11101,3700,7401,3700,0,1,3702,2493211,2.493211
6900,500,3700,3450000,2,29606,7403,1,246640000,246640000,11101,3700,7401,3700,0,1,3702,2476432,2.476432
6900,500,3700,3450000,2,29606,7403,1,246640000,246640000,11101,3700,7401,3700,0,1,3702,2522863,2.522863
6900,500,4100,3450000,2,32806,8203,1,270320000,270320000,12301,4100,8201,4100,0,1,4102,2751569,2.751569
6900,500,4100,3450000,2,32806,8203,1,270320000,270320000,12301,4100,8201,4100,0,1,4102,2827485,2.827485
6900,500,4100,3450000,2,32806,8203,1,270320000,270320000,12301,4100,8201,4100,0,1,4102,2714869,2.714869
6900,500,4100,3450000,2,32806,8203,1,270320000,270320000,12301,4100,8201,4100,0,1,4102,2797509,2.797509
6900,500,4100,3450000,2,32806,8203,1,270320000,270320000,12301,4100,8201,4100,0,1,4102,2738405,2.738405
6900,500,4100,3450000,2,32806,8203,1,270320000,270320000,12301,4100,8201,4100,0,1,4102,2756209,2.756209
6900,500,4100,3450000,2,32806,8203,1,270320000,270320000,12301,4100,8201,4100,0,1,4102,2731500,2.7315
6900,500,4100,3450000,2,32806,8203,1,270320000,270320000,12301,4100,8201,4100,0,1,4102,2789803,2.789803
6900,500,4500,3450000,2,36006,9003,1,294000000,294000000,13501,4500,9001,4500,0,1,4502,3003877,3.003877
6900,500,4500,3450000,2,36006,9003,1,294000000,294000000,13501,4500,9001,4500,0,1,4502,3092252,3.092252
6900,500,4500,3450000,2,36006,9003,1,294000000,294000000,13501,4500,9001,4500,0,1,4502,2964118,2.964118
6900,500,4500,3450000,2,36006,9003,1,294000000,294000000,13501,4500,9001,4500,0,1,4502,3076376,3.076376
6900,500,4500,3450000,2,36006,9003,1,294000000,294000000,13501,4500,9001,4500,0,1,4502,3004376,3.004376
6900,500,4500,3450000,2,36006,9003,1,294000000,294000000,13501,4500,9001,4500,0,1,4502,3030947,3.030947
6900,500,4500,3450000,2,36006,9003,1,294000000,294000000,13501,4500,9001,4500,0,1,4502,2998993,2.998993
6900,500,4500,3450000,2,36006,9003,1,294000000,294000000,13501,4500,9001,4500,0,1,4502,3064024,3.064024
6900,500,4900,3450000,2,39206,9803,1,317680000,317680000,14701,4900,9801,4900,0,1,4902,3289097,3.289097
6900,500,4900,3450000,2,39206,9803,1,317680000,317680000,14701,4900,9801,4900,0,1,4902,3378829,3.378829
6900,500,4900,3450000,2,39206,9803,1,317680000,317680000,14701,4900,9801,4900,0,1,4902,3248797,3.248797
6900,500,4900,3450000,2,39206,9803,1,317680000,317680000,14701,4900,9801,4900,0,1,4902,3350622,3.350622
6900,500,4900,3450000,2,39206,9803,1,317680000,317680000,14701,4900,9801,4900,0,1,4902,3257749,3.257749
6900,500,4900,3450000,2,39206,9803,1,317680000,317680000,14701,4900,9801,4900,0,1,4902,3307914,3.307914
6900,500,4900,3450000,2,39206,9803,1,317680000,317680000,14701,4900,9801,4900,0,1,4902,3273813,3.273813
6900,500,4900,3450000,2,39206,9803,1,317680000,317680000,14701,4900,9801,4900,0,1,4902,3335003,3.335003
6900,500,5300,3450000,2,42406,10603,1,341360000,341360000,15901,5300,10601,5300,0,1,5302,3698554,3.698554
6900,500,5300,3450000,2,42406,10603,1,341360000,341360000,15901,5300,10601,5300,0,1,5302,3774581,3.774581
6900,500,5300,3450000,2,42406,10603,1,341360000,341360000,15901,5300,10601,5300,0,1,5302,3641162,3.641162
6900,500,5300,3450000,2,42406,10603,1,341360000,341360000,15901,5300,10601,5300,0,1,5302,3768343,3.768343
6900,500,5300,3450000,2,42406,10603,1,341360000,341360000,15901,5300,10601,5300,0,1,5302,3700055,3.700055
6900,500,5300,3450000,2,42406,10603,1,341360000,341360000,15901,5300,10601,5300,0,1,5302,3744195,3.744195
6900,500,5300,3450000,2,42406,10603,1,341360000,341360000,15901,5300,10601,5300,0,1,5302,3701429,3.701429
6900,500,5300,3450000,2,42406,10603,1,341360000,341360000,15901,5300,10601,5300,0,1,5302,3733598,3.733598
6900,500,5700,3450000,2,45606,11403,1,365040000,365040000,17101,5700,11401,5700,0,1,5702,3798756,3.798756
6900,500,5700,3450000,2,45606,11403,1,365040000,365040000,17101,5700,11401,5700,0,1,5702,3926883,3.926883
6900,500,5700,3450000,2,45606,11403,1,365040000,365040000,17101,5700,11401,5700,0,1,5702,3744974,3.744974
6900,500,5700,3450000,2,45606,11403,1,365040000,365040000,17101,5700,11401,5700,0,1,5702,3902168,3.902168
6900,500,5700,3450000,2,45606,11403,1,365040000,365040000,17101,5700,11401,5700,0,1,5702,3786514,3.786514
6900,500,5700,3450000,2,45606,11403,1,365040000,365040000,17101,5700,11401,5700,0,1,5702,3852975,3.852975
6900,500,5700,3450000,2,45606,11403,1,365040000,365040000,17101,5700,11401,5700,0,1,5702,3779302,3.779302
6900,500,5700,3450000,2,45606,11403,1,365040000,365040000,17101,5700,11401,5700,0,1,5702,3891485,3.891485
6900,500,6100,3450000,2,48806,12203,1,388720000,388720000,18301,6100,12201,6100,0,1,6102,4070292,4.070292
6900,500,6100,3450000,2,48806,12203,1,388720000,388720000,18301,6100,12201,6100,0,1,6102,4235920,4.23592
6900,500,6100,3450000,2,48806,12203,1,388720000,388720000,18301,6100,12201,6100,0,1,6102,3998524,3.998524
6900,500,6100,3450000,2,48806,12203,1,388720000,388720000,18301,6100,12201,6100,0,1,6102,4187198,4.187198
6900,500,6100,3450000,2,48806,12203,1,388720000,388720000,18301,6100,12201,6100,0,1,6102,4085995,4.085995
6900,500,6100,3450000,2,48806,12203,1,388720000,388720000,18301,6100,12201,6100,0,1,6102,4122510,4.12251
6900,500,6100,3450000,2,48806,12203,1,388720000,388720000,18301,6100,12201,6100,0,1,6102,4059369,4.059369
6900,500,6100,3450000,2,48806,12203,1,388720000,388720000,18301,6100,12201,6100,0,1,6102,4158148,4.158148
6900,500,6500,3450000,2,52006,13003,1,412400000,412400000,19501,6500,13001,6500,0,1,6502,4346478,4.346478
6900,500,6500,3450000,2,52006,13003,1,412400000,412400000,19501,6500,13001,6500,0,1,6502,4506298,4.506298
6900,500,6500,3450000,2,52006,13003,1,412400000,412400000,19501,6500,13001,6500,0,1,6502,4262388,4.262388
6900,500,6500,3450000,2,52006,13003,1,412400000,412400000,19501,6500,13001,6500,0,1,6502,4437995,4.437995
6900,500,6500,3450000,2,52006,13003,1,412400000,412400000,19501,6500,13001,6500,0,1,6502,4362417,4.362417
6900,500,6500,3450000,2,52006,13003,1,412400000,412400000,19501,6500,13001,6500,0,1,6502,4388403,4.388403
6900,500,6500,3450000,2,52006,13003,1,412400000,412400000,19501,6500,13001,6500,0,1,6502,4333304,4.333304
6900,500,6500,3450000,2,52006,13003,1,412400000,412400000,19501,6500,13001,6500,0,1,6502,4424454,4.424454
6900,500,6900,3450000,2,55206,13803,1,436080000,436080000,20701,6900,13801,6900,0,1,6902,4791424,4.791424
6900,500,6900,3450000,2,55206,13803,1,436080000,436080000,20701,6900,13801,6900,0,1,6902,4819751,4.819751
6900,500,6900,3450000,2,55206,13803,1,436080000,436080000,20701,6900,13801,6900,0,1,6902,4533012,4.533012
6900,500,6900,3450000,2,55206,13803,1,436080000,436080000,20701,6900,13801,6900,0,1,6902,4714017,4.714017
6900,500,6900,3450000,2,55206,13803,1,436080000,436080000,20701,6900,13801,6900,0,1,6902,4796930,4.79693
6900,500,6900,3450000,2,55206,13803,1,436080000,436080000,20701,6900,13801,6900,0,1,6902,4767500,4.7675
6900,500,6900,3450000,2,55206,13803,1,436080000,436080000,20701,6900,13801,6900,0,1,6902,4750808,4.750808
6900,500,6900,3450000,2,55206,13803,1,436080000,436080000,20701,6900,13801,6900,0,1,6902,4826997,4.826997
6900,100,500,690000,2,4006,1003,1,33520000,33520000,1501,500,1001,500,0,1,502,81642,0.081642
6900,100,500,690000,2,4006,1003,1,33520000,33520000,1501,500,1001,500,0,1,502,92450,0.09245
6900,100,500,690000,2,4006,1003,1,33520000,33520000,1501,500,1001,500,0,1,502,82142,0.082142
6900,100,500,690000,2,4006,1003,1,33520000,33520000,1501,500,1001,500,0,1,502,91001,0.091001
6900,100,500,690000,2,4006,1003,1,33520000,33520000,1501,500,1001,500,0,1,502,82868,0.082868
6900,100,500,690000,2,4006,1003,1,33520000,33520000,1501,500,1001,500,0,1,502,83517,0.083517
6900,100,500,690000,2,4006,1003,1,33520000,33520000,1501,500,1001,500,0,1,502,86530,0.08653
6900,100,500,690000,2,4006,1003,1,33520000,33520000,1501,500,1001,500,0,1,502,88008,0.088008
6900,100,900,690000,2,7206,1803,1,55920000,55920000,2701,900,1801,900,0,1,902,133713,0.133713
6900,100,900,690000,2,7206,1803,1,55920000,55920000,2701,900,1801,900,0,1,902,152930,0.15293
6900,100,900,690000,2,7206,1803,1,55920000,55920000,2701,900,1801,900,0,1,902,134140,0.13414
6900,100,900,690000,2,7206,1803,1,55920000,55920000,2701,900,1801,900,0,1,902,150465,0.150465
6900,100,900,690000,2,7206,1803,1,55920000,55920000,2701,900,1801,900,0,1,902,134877,0.134877
6900,100,900,690000,2,7206,1803,1,55920000,55920000,2701,900,1801,900,0,1,902,138263,0.138263
6900,100,900,690000,2,7206,1803,1,55920000,55920000,2701,900,1801,900,0,1,902,140518,0.140518
6900,100,900,690000,2,7206,1803,1,55920000,55920000,2701,900,1801,900,0,1,902,145189,0.145189
6900,100,1300,690000,2,10406,2603,1,78320000,78320000,3901,1300,2601,1300,0,1,1302,191572,0.191572
6900,100,1300,690000,2,10406,2603,1,78320000,78320000,3901,1300,2601,1300,0,1,1302,212460,0.21246
6900,100,1300,690000,2,10406,2603,1,78320000,78320000,3901,1300,2601,1300,0,1,1302,188328,0.188328
6900,100,1300,690000,2,10406,2603,1,78320000,78320000,3901,1300,2601,1300,0,1,1302,209814,0.209814
6900,100,1300,690000,2,10406,2603,1,78320000,78320000,3901,1300,2601,1300,0,1,1302,194104,0.194104
6900,100,1300,690000,2,10406,2603,1,78320000,78320000,3901,1300,2601,1300,0,1,1302,199204,0.199204
6900,100,1300,690000,2,10406,2603,1,78320000,78320000,3901,1300,2601,1300,0,1,1302,201380,0.20138
6900,100,1300,690000,2,10406,2603,1,78320000,78320000,3901,1300,2601,1300,0,1,1302,208020,0.20802
6900,100,1700,690000,2,13606,3403,1,100720000,100720000,5101,1700,3401,1700,0,1,1702,245948,0.245948
6900,100,1700,690000,2,13606,3403,1,100720000,100720000,5101,1700,3401,1700,0,1,1702,272194,0.272194
6900,100,1700,690000,2,13606,3403,1,100720000,100720000,5101,1700,3401,1700,0,1,1702,243386,0.243386
6900,100,1700,690000,2,13606,3403,1,100720000,100720000,5101,1700,3401,1700,0,1,1702,269693,0.269693
6900,100,1700,690000,2,13606,3403,1,100720000,100720000,5101,1700,3401,1700,0,1,1702,259274,0.259274
6900,100,1700,690000,2,13606,3403,1,100720000,100720000,5101,1700,3401,1700,0,1,1702,258646,0.258646
6900,100,1700,690000,2,13606,3403,1,100720000,100720000,5101,1700,3401,1700,0,1,1702,260614,0.260614
6900,100,1700,690000,2,13606,3403,1,100720000,100720000,5101,1700,3401,1700,0,1,1702,254805,0.254805
6900,100,2100,690000,2,16806,4203,1,123120000,123120000,6301,2100,4201,2100,0,1,2102,297820,0.29782
6900,100,2100,690000,2,16806,4203,1,123120000,123120000,6301,2100,4201,2100,0,1,2102,336592,0.336592
6900,100,2100,690000,2,16806,4203,1,123120000,123120000,6301,2100,4201,2100,0,1,2102,295844,0.295844
6900,100,2100,690000,2,16806,4203,1,123120000,123120000,6301,2100,4201,2100,0,1,2102,333976,0.333976
6900,100,2100,690000,2,16806,4203,1,123120000,123120000,6301,2100,4201,2100,0,1,2102,319795,0.319795
6900,100,2100,690000,2,16806,4203,1,123120000,123120000,6301,2100,4201,2100,0,1,2102,319135,0.319135
6900,100,2100,690000,2,16806,4203,1,123120000,123120000,6301,2100,4201,2100,0,1,2102,321842,0.321842
6900,100,2100,690000,2,16806,4203,1,123120000,123120000,6301,2100,4201,2100,0,1,2102,322160,0.32216
6900,100,2500,690000,2,20006,5003,1,145520000,145520000,7501,2500,5001,2500,0,1,2502,354755,0.354755
6900,100,2500,690000,2,20006,5003,1,145520000,145520000,7501,2500,5001,2500,0,1,2502,388610,0.38861
6900,100,2500,690000,2,20006,5003,1,145520000,145520000,7501,2500,5001,2500,0,1,2502,353338,0.353338
6900,100,2500,690000,2,20006,5003,1,145520000,145520000,7501,2500,5001,2500,0,1,2502,370551,0.370551
6900,100,2500,690000,2,20006,5003,1,145520000,145520000,7501,2500,5001,2500,0,1,2502,375805,0.375805
6900,100,2500,690000,2,20006,5003,1,145520000,145520000,7501,2500,5001,2500,0,1,2502,372839,0.372839
6900,100,2500,690000,2,20006,5003,1,145520000,145520000,7501,2500,5001,2500,0,1,2502,377445,0.377445
6900,100,2500,690000,2,20006,5003,1,145520000,145520000,7501,2500,5001,2500,0,1,2502,376809,0.376809
6900,100,2900,690000,2,23206,5803,1,167920000,167920000,8701,2900,5801,2900,0,1,2902,423498,0.423498
6900,100,2900,690000,2,23206,5803,1,167920000,167920000,8701,2900,5801,2900,0,1,2902,446095,0.446095
6900,100,2900,690000,2,23206,5803,1,167920000,167920000,8701,2900,5801,2900,0,1,2902,422494,0.422494
6900,100,2900,690000,2,23206,5803,1,167920000,167920000,8701,2900,5801,2900,0,1,2902,429521,0.429521
6900,100,2900,690000,2,23206,5803,1,167920000,167920000,8701,2900,5801,2900,0,1,2902,428963,0.428963
6900,100,2900,690000,2,23206,5803,1,167920000,167920000,8701,2900,5801,2900,0,1,2902,433524,0.433524
6900,100,2900,690000,2,23206,5803,1,167920000,167920000,8701,2900,5801,2900,0,1,2902,432105,0.432105
6900,100,2900,690000,2,23206,5803,1,167920000,167920000,8701,2900,5801,2900,0,1,2902,431400,0.4314
6900,100,3300,690000,2,26406,6603,1,190320000,190320000,9901,3300,6601,3300,0,1,3302,483927,0.483927
6900,100,3300,690000,2,26406,6603,1,190320000,190320000,9901,3300,6601,3300,0,1,3302,507050,0.50705
6900,100,3300,690000,2,26406,6603,1,190320000,190320000,9901,3300,6601,3300,0,1,3302,481948,0.481948
6900,100,3300,690000,2,26406,6603,1,190320000,190320000,9901,3300,6601,3300,0,1,3302,490594,0.490594
6900,100,3300,690000,2,26406,6603,1,190320000,190320000,9901,3300,6601,3300,0,1,3302,489560,0.48956
6900,100,3300,690000,2,26406,6603,1,190320000,190320000,9901,3300,6601,3300,0,1,3302,501756,0.501756
6900,100,3300,690000,2,26406,6603,1,190320000,190320000,9901,3300,6601,3300,0,1,3302,493910,0.49391
6900,100,3300,690000,2,26406,6603,1,190320000,190320000,9901,3300,6601,3300,0,1,3302,493146,0.493146
6900,100,3700,690000,2,29606,7403,1,212720000,212720000,11101,3700,7401,3700,0,1,3702,540857,0.540857
6900,100,3700,690000,2,29606,7403,1,212720000,212720000,11101,3700,7401,3700,0,1,3702,572462,0.572462
6900,100,3700,690000,2,29606,7403,1,212720000,212720000,11101,3700,7401,3700,0,1,3702,538978,0.538978
6900,100,3700,690000,2,29606,7403,1,212720000,212720000,11101,3700,7401,3700,0,1,3702,552837,0.552837
6900,100,3700,690000,2,29606,7403,1,212720000,212720000,11101,3700,7401,3700,0,1,3702,551754,0.551754
6900,100,3700,690000,2,29606,7403,1,212720000,212720000,11101,3700,7401,3700,0,1,3702,561452,0.561452
6900,100,3700,690000,2,29606,7403,1,212720000,212720000,11101,3700,7401,3700,0,1,3702,555908,0.555908
6900,100,3700,690000,2,29606,7403,1,212720000,212720000,11101,3700,7401,3700,0,1,3702,555115,0.555115
6900,100,4100,690000,2,32806,8203,1,235120000,235120000,12301,4100,8201,4100,0,1,4102,605050,0.60505
6900,100,4100,690000,2,32806,8203,1,235120000,235120000,12301,4100,8201,4100,0,1,4102,634671,0.634671
6900,100,4100,690000,2,32806,8203,1,235120000,235120000,12301,4100,8201,4100,0,1,4102,605547,0.605547
6900,100,4100,690000,2,32806,8203,1,235120000,235120000,12301,4100,8201,4100,0,1,4102,615717,0.615717
6900,100,4100,690000,2,32806,8203,1,235120000,235120000,12301,4100,8201,4100,0,1,4102,613662,0.613662
6900,100,4100,690000,2,32806,8203,1,235120000,235120000,12301,4100,8201,4100,0,1,4102,622374,0.622374
6900,100,4100,690000,2,32806,8203,1,235120000,235120000,12301,4100,8201,4100,0,1,4102,615227,0.615227
6900,100,4100,690000,2,32806,8203,1,235120000,235120000,12301,4100,8201,4100,0,1,4102,618028,0.618028
6900,100,4500,690000,2,36006,9003,1,257520000,257520000,13501,4500,9001,4500,0,1,4502,666102,0.666102
6900,100,4500,690000,2,36006,9003,1,257520000,257520000,13501,4500,9001,4500,0,1,4502,702443,0.702443
6900,100,4500,690000,2,36006,9003,1,257520000,257520000,13501,4500,9001,4500,0,1,4502,662218,0.662218
6900,100,4500,690000,2,36006,9003,1,257520000,257520000,13501,4500,9001,4500,0,1,4502,677494,0.677494
6900,100,4500,690000,2,36006,9003,1,257520000,257520000,13501,4500,9001,4500,0,1,4502,679241,0.679241
6900,100,4500,690000,2,36006,9003,1,257520000,257520000,13501,4500,9001,4500,0,1,4502,688710,0.68871
6900,100,4500,690000,2,36006,9003,1,257520000,257520000,13501,4500,9001,4500,0,1,4502,671009,0.671009
6900,100,4500,690000,2,36006,9003,1,257520000,257520000,13501,4500,9001,4500,0,1,4502,680171,0.680171
6900,100,4900,690000,2,39206,9803,1,279920000,279920000,14701,4900,9801,4900,0,1,4902,727244,0.727244
6900,100,4900,690000,2,39206,9803,1,279920000,279920000,14701,4900,9801,4900,0,1,4902,768692,0.768692
6900,100,4900,690000,2,39206,9803,1,279920000,279920000,14701,4900,9801,4900,0,1,4902,730703,0.730703
6900,100,4900,690000,2,39206,9803,1,279920000,279920000,14701,4900,9801,4900,0,1,4902,742903,0.742903
6900,100,4900,690000,2,39206,9803,1,279920000,279920000,14701,4900,9801,4900,0,1,4902,737723,0.737723
6900,100,4900,690000,2,39206,9803,1,279920000,279920000,14701,4900,9801,4900,0,1,4902,740621,0.740621
6900,100,4900,690000,2,39206,9803,1,279920000,279920000,14701,4900,9801,4900,0,1,4902,753271,0.753271
6900,100,4900,690000,2,39206,9803,1,279920000,279920000,14701,4900,9801,4900,0,1,4902,739637,0.739637
6900,100,5300,690000,2,42406,10603,1,302320000,302320000,15901,5300,10601,5300,0,1,5302,788101,0.788101
6900,100,5300,690000,2,42406,10603,1,302320000,302320000,15901,5300,10601,5300,0,1,5302,799452,0.799452
6900,100,5300,690000,2,42406,10603,1,302320000,302320000,15901,5300,10601,5300,0,1,5302,785706,0.785706
6900,100,5300,690000,2,42406,10603,1,302320000,302320000,15901,5300,10601,5300,0,1,5302,805217,0.805217
6900,100,5300,690000,2,42406,10603,1,302320000,302320000,15901,5300,10601,5300,0,1,5302,803589,0.803589
6900,100,5300,690000,2,42406,10603,1,302320000,302320000,15901,5300,10601,5300,0,1,5302,788705,0.788705
6900,100,5300,690000,2,42406,10603,1,302320000,302320000,15901,5300,10601,5300,0,1,5302,790701,0.790701
6900,100,5300,690000,2,42406,10603,1,302320000,302320000,15901,5300,10601,5300,0,1,5302,802627,0.802627
6900,100,5700,690000,2,45606,11403,1,324720000,324720000,17101,5700,11401,5700,0,1,5702,847328,0.847328
6900,100,5700,690000,2,45606,11403,1,324720000,324720000,17101,5700,11401,5700,0,1,5702,856756,0.856756
6900,100,5700,690000,2,45606,11403,1,324720000,324720000,17101,5700,11401,5700,0,1,5702,849359,0.849359
6900,100,5700,690000,2,45606,11403,1,324720000,324720000,17101,5700,11401,5700,0,1,5702,861741,0.861741
6900,100,5700,690000,2,45606,11403,1,324720000,324720000,17101,5700,11401,5700,0,1,5702,870775,0.870775
6900,100,5700,690000,2,45606,11403,1,324720000,324720000,17101,5700,11401,5700,0,1,5702,860625,0.860625
6900,100,5700,690000,2,45606,11403,1,324720000,324720000,17101,5700,11401,5700,0,1,5702,869684,0.869684
6900,100,5700,690000,2,45606,11403,1,324720000,324720000,17101,5700,11401,5700,0,1,5702,867785,0.867785
6900,100,6100,690000,2,48806,12203,1,347120000,347120000,18301,6100,12201,6100,0,1,6102,909187,0.909187
6900,100,6100,690000,2,48806,12203,1,347120000,347120000,18301,6100,12201,6100,0,1,6102,930236,0.930236
6900,100,6100,690000,2,48806,12203,1,347120000,347120000,18301,6100,12201,6100,0,1,6102,956266,0.956266
6900,100,6100,690000,2,48806,12203,1,347120000,347120000,18301,6100,12201,6100,0,1,6102,922987,0.922987
6900,100,6100,690000,2,48806,12203,1,347120000,347120000,18301,6100,12201,6100,0,1,6102,929638,0.929638
6900,100,6100,690000,2,48806,12203,1,347120000,347120000,18301,6100,12201,6100,0,1,6102,942446,0.942446
6900,100,6100,690000,2,48806,12203,1,347120000,347120000,18301,6100,12201,6100,0,1,6102,914766,0.914766
6900,100,6100,690000,2,48806,12203,1,347120000,347120000,18301,6100,12201,6100,0,1,6102,933953,0.933953
6900,100,6500,690000,2,52006,13003,1,369520000,369520000,19501,6500,13001,6500,0,1,6502,966165,0.966165
6900,100,6500,690000,2,52006,13003,1,369520000,369520000,19501,6500,13001,6500,0,1,6502,1023038,1.023038
6900,100,6500,690000,2,52006,13003,1,369520000,369520000,19501,6500,13001,6500,0,1,6502,1000513,1.000513
6900,100,6500,690000,2,52006,13003,1,369520000,369520000,19501,6500,13001,6500,0,1,6502,990486,0.990486
6900,100,6500,690000,2,52006,13003,1,369520000,369520000,19501,6500,13001,6500,0,1,6502,1029341,1.029341
6900,100,6500,690000,2,52006,13003,1,369520000,369520000,19501,6500,13001,6500,0,1,6502,1016969,1.016969
6900,100,6500,690000,2,52006,13003,1,369520000,369520000,19501,6500,13001,6500,0,1,6502,975709,0.975709
6900,100,6500,690000,2,52006,13003,1,369520000,369520000,19501,6500,13001,6500,0,1,6502,994257,0.994257
6900,100,6900,690000,2,55206,13803,1,391920000,391920000,20701,6900,13801,6900,0,1,6902,1035476,1.035476
6900,100,6900,690000,2,55206,13803,1,391920000,391920000,20701,6900,13801,6900,0,1,6902,1053934,1.053934
6900,100,6900,690000,2,55206,13803,1,391920000,391920000,20701,6900,13801,6900,0,1,6902,1083346,1.083346
6900,100,6900,690000,2,55206,13803,1,391920000,391920000,20701,6900,13801,6900,0,1,6902,1057919,1.057919
6900,100,6900,690000,2,55206,13803,1,391920000,391920000,20701,6900,13801,6900,0,1,6902,1062643,1.062643
6900,100,6900,690000,2,55206,13803,1,391920000,391920000,20701,6900,13801,6900,0,1,6902,1075377,1.075377
6900,100,6900,690000,2,55206,13803,1,391920000,391920000,20701,6900,13801,6900,0,1,6902,1046743,1.046743
6900,100,6900,690000,2,55206,13803,1,391920000,391920000,20701,6900,13801,6900,0,1,6902,1055497,1.055497
6500,6900,500,44850000,2,4006,1003,1,412400000,412400000,1501,500,1001,500,0,1,502,4589248,4.589248
6500,6900,500,44850000,2,4006,1003,1,412400000,412400000,1501,500,1001,500,0,1,502,4816405,4.816405
6500,6900,500,44850000,2,4006,1003,1,412400000,412400000,1501,500,1001,500,0,1,502,4621560,4.62156
6500,6900,500,44850000,2,4006,1003,1,412400000,412400000,1501,500,1001,500,0,1,502,4767822,4.767822
6500,6900,500,44850000,2,4006,1003,1,412400000,412400000,1501,500,1001,500,0,1,502,4557964,4.557964
6500,6900,500,44850000,2,4006,1003,1,412400000,412400000,1501,500,1001,500,0,1,502,4621024,4.621024
6500,6900,500,44850000,2,4006,1003,1,412400000,412400000,1501,500,1001,500,0,1,502,4527797,4.527797
6500,6900,500,44850000,2,4006,1003,1,412400000,412400000,1501,500,1001,500,0,1,502,4653766,4.653766
6500,6900,900,44850000,2,7206,1803,1,455280000,455280000,2701,900,1801,900,0,1,902,8053301,8.053301
6500,6900,900,44850000,2,7206,1803,1,455280000,455280000,2701,900,1801,900,0,1,902,8144051,8.144051
6500,6900,900,44850000,2,7206,1803,1,455280000,455280000,2701,900,1801,900,0,1,902,7708867,7.708867
6500,6900,900,44850000,2,7206,1803,1,455280000,455280000,2701,900,1801,900,0,1,902,8020362,8.020362
6500,6900,900,44850000,2,7206,1803,1,455280000,455280000,2701,900,1801,900,0,1,902,7978060,7.97806
6500,6900,900,44850000,2,7206,1803,1,455280000,455280000,2701,900,1801,900,0,1,902,8052520,8.05252
6500,6900,900,44850000,2,7206,1803,1,455280000,455280000,2701,900,1801,900,0,1,902,7921395,7.921395
6500,6900,900,44850000,2,7206,1803,1,455280000,455280000,2701,900,1801,900,0,1,902,8111100,8.1111
6500,6900,1300,44850000,2,10406,2603,1,498160000,498160000,3901,1300,2601,1300,0,1,1302,11190336,11.190336
6500,6900,1300,44850000,2,10406,2603,1,498160000,498160000,3901,1300,2601,1300,0,1,1302,11675390,11.67539
6500,6900,1300,44850000,2,10406,2603,1,498160000,498160000,3901,1300,2601,1300,0,1,1302,11159809,11.159809
6500,6900,1300,44850000,2,10406,2603,1,498160000,498160000,3901,1300,2601,1300,0,1,1302,11485620,11.48562
6500,6900,1300,44850000,2,10406,2603,1,498160000,498160000,3901,1300,2601,1300,0,1,1302,11073722,11.073722
6500,6900,1300,44850000,2,10406,2603,1,498160000,498160000,3901,1300,2601,1300,0,1,1302,11307742,11.307742
6500,6900,1300,44850000,2,10406,2603,1,498160000,498160000,3901,1300,2601,1300,0,1,1302,11033462,11.033462
6500,6900,1300,44850000,2,10406,2603,1,498160000,498160000,3901,1300,2601,1300,0,1,1302,11375076,11.375076
6500,6900,1700,44850000,2,13606,3403,1,541040000,541040000,5101,1700,3401,1700,0,1,1702,14656999,14.656999
6500,6900,1700,44850000,2,13606,3403,1,541040000,541040000,5101,1700,3401,1700,0,1,1702,15011978,15.011978
6500,6900,1700,44850000,2,13606,3403,1,541040000,541040000,5101,1700,3401,1700,0,1,1702,14211669,14.211669
6500,6900,1700,44850000,2,13606,3403,1,541040000,541040000,5101,1700,3401,1700,0,1,1702,14821697,14.821697
6500,6900,1700,44850000,2,13606,3403,1,541040000,541040000,5101,1700,3401,1700,0,1,1702,14534832,14.534832
6500,6900,1700,44850000,2,13606,3403,1,541040000,541040000,5101,1700,3401,1700,0,1,1702,14729852,14.729852
6500,6900,1700,44850000,2,13606,3403,1,541040000,541040000,5101,1700,3401,1700,0,1,1702,14462632,14.462632
6500,6900,1700,44850000,2,13606,3403,1,541040000,541040000,5101,1700,3401,1700,0,1,1702,14873501,14.873501
6500,6900,2100,44850000,2,16806,4203,1,583920000,583920000,6301,2100,4201,2100,0,1,2102,17985923,17.985923
6500,6900,2100,44850000,2,16806,4203,1,583920000,583920000,6301,2100,4201,2100,0,1,2102,18549444,18.549444
6500,6900,2100,44850000,2,16806,4203,1,583920000,583920000,6301,2100,4201,2100,0,1,2102,17593604,17.593604
6500,6900,2100,44850000,2,16806,4203,1,583920000,583920000,6301,2100,4201,2100,0,1,2102,18258352,18.258352
6500,6900,2100,44850000,2,16806,4203,1,583920000,583920000,6301,2100,4201,2100,0,1,2102,17789745,17.789745
6500,6900,2100,44850000,2,16806,4203,1,583920000,583920000,6301,2100,4201,2100,0,1,2102,18098189,18.098189
6500,6900,2100,44850000,2,16806,4203,1,583920000,583920000,6301,2100,4201,2100,0,1,2102,17759922,17.759922
6500,6900,2100,44850000,2,16806,4203,1,583920000,583920000,6301,2100,4201,2100,0,1,2102,18289855,18.289855
6500,6900,2500,44850000,2,20006,5003,1,626800000,626800000,7501,2500,5001,2500,0,1,2502,21284841,21.284841
6500,6900,2500,44850000,2,20006,5003,1,626800000,626800000,7501,2500,5001,2500,0,1,2502,21983638,21.983638
6500,6900,2500,44850000,2,20006,5003,1,626800000,626800000,7501,2500,5001,2500,0,1,2502,20846470,20.84647
6500,6900,2500,44850000,2,20006,5003,1,626800000,626800000,7501,2500,5001,2500,0,1,2502,21645366,21.645366
6500,6900,2500,44850000,2,20006,5003,1,626800000,626800000,7501,2500,5001,2500,0,1,2502,21089802,21.089802
6500,6900,2500,44850000,2,20006,5003,1,626800000,626800000,7501,2500,5001,2500,0,1,2502,21443268,21.443268
6500,6900,2500,44850000,2,20006,5003,1,626800000,626800000,7501,2500,5001,2500,0,1,2502,21032497,21.032497
6500,6900,2500,44850000,2,20006,5003,1,626800000,626800000,7501,2500,5001,2500,0,1,2502,21678912,21.678912
6500,6900,2900,44850000,2,23206,5803,1,669680000,669680000,8701,2900,5801,2900,0,1,2902,24639150,24.63915
6500,6900,2900,44850000,2,23206,5803,1,669680000,669680000,8701,2900,5801,2900,0,1,2902,25455335,25.455335
6500,6900,2900,44850000,2,23206,5803,1,669680000,669680000,8701,2900,5801,2900,0,1,2902,24094818,24.094818
6500,6900,2900,44850000,2,23206,5803,1,669680000,669680000,8701,2900,5801,2900,0,1,2902,25109423,25.109423
6500,6900,2900,44850000,2,23206,5803,1,669680000,669680000,8701,2900,5801,2900,0,1,2902,24325731,24.325731
6500,6900,2900,44850000,2,23206,5803,1,669680000,669680000,8701,2900,5801,2900,0,1,2902,24832545,24.832545
6500,6900,2900,44850000,2,23206,5803,1,669680000,669680000,8701,2900,5801,2900,0,1,2902,24370319,24.370319
6500,6900,2900,44850000,2,23206,5803,1,669680000,669680000,8701,2900,5801,2900,0,1,2902,25075331,25.075331
6500,6900,3300,44850000,2,26406,6603,1,712560000,712560000,9901,3300,6601,3300,0,1,3302,27925670,27.92567
6500,6900,3300,44850000,2,26406,6603,1,712560000,712560000,9901,3300,6601,3300,0,1,3302,28885871,28.885871
6500,6900,3300,44850000,2,26406,6603,1,712560000,712560000,9901,3300,6601,3300,0,1,3302,27358106,27.358106
6500,6900,3300,44850000,2,26406,6603,1,712560000,712560000,9901,3300,6601,3300,0,1,3302,28581578,28.581578
6500,6900,3300,44850000,2,26406,6603,1,712560000,712560000,9901,3300,6601,3300,0,1,3302,27674302,27.674302
6500,6900,3300,44850000,2,26406,6603,1,712560000,712560000,9901,3300,6601,3300,0,1,3302,28151469,28.151469
6500,6900,3300,44850000,2,26406,6603,1,712560000,712560000,9901,3300,6601,3300,0,1,3302,27704278,27.704278
6500,6900,3300,44850000,2,26406,6603,1,712560000,712560000,9901,3300,6601,3300,0,1,3302,28444434,28.444434
6500,6900,3700,44850000,2,29606,7403,1,755440000,755440000,11101,3700,7401,3700,0,1,3702,31290689,31.290689
6500,6900,3700,44850000,2,29606,7403,1,755440000,755440000,11101,3700,7401,3700,0,1,3702,32380244,32.380244
6500,6900,3700,44850000,2,29606,7403,1,755440000,755440000,11101,3700,7401,3700,0,1,3702,30633413,30.633413
6500,6900,3700,44850000,2,29606,7403,1,755440000,755440000,11101,3700,7401,3700,0,1,3702,31957502,31.957502
6500,6900,3700,44850000,2,29606,7403,1,755440000,755440000,11101,3700,7401,3700,0,1,3702,30956640,30.95664
6500,6900,3700,44850000,2,29606,7403,1,755440000,755440000,11101,3700,7401,3700,0,1,3702,31587891,31.587891
6500,6900,3700,44850000,2,29606,7403,1,755440000,755440000,11101,3700,7401,3700,0,1,3702,31005219,31.005219
6500,6900,3700,44850000,2,29606,7403,1,755440000,755440000,11101,3700,7401,3700,0,1,3702,31875335,31.875335
6500,6900,4100,44850000,2,32806,8203,1,798320000,798320000,12301,4100,8201,4100,0,1,4102,34572538,34.572538
6500,6900,4100,44850000,2,32806,8203,1,798320000,798320000,12301,4100,8201,4100,0,1,4102,35843430,35.84343
6500,6900,4100,44850000,2,32806,8203,1,798320000,798320000,12301,4100,8201,4100,0,1,4102,33908890,33.90889
6500,6900,4100,44850000,2,32806,8203,1,798320000,798320000,12301,4100,8201,4100,0,1,4102,35308546,35.308546
6500,6900,4100,44850000,2,32806,8203,1,798320000,798320000,12301,4100,8201,4100,0,1,4102,34230317,34.230317
6500,6900,4100,44850000,2,32806,8203,1,798320000,798320000,12301,4100,8201,4100,0,1,4102,34931793,34.931793
6500,6900,4100,44850000,2,32806,8203,1,798320000,798320000,12301,4100,8201,4100,0,1,4102,34291642,34.291642
6500,6900,4100,44850000,2,32806,8203,1,798320000,798320000,12301,4100,8201,4100,0,1,4102,35278318,35.278318
6500,6900,4500,44850000,2,36006,9003,1,841200000,841200000,13501,4500,9001,4500,0,1,4502,37971377,37.971377
6500,6900,4500,44850000,2,36006,9003,1,841200000,841200000,13501,4500,9001,4500,0,1,4502,39312918,39.312918
6500,6900,4500,44850000,2,36006,9003,1,841200000,841200000,13501,4500,9001,4500,0,1,4502,37218025,37.218025
6500,6900,4500,44850000,2,36006,9003,1,841200000,841200000,13501,4500,9001,4500,0,1,4502,38869655,38.869655
6500,6900,4500,44850000,2,36006,9003,1,841200000,841200000,13501,4500,9001,4500,0,1,4502,37585210,37.58521
6500,6900,4500,44850000,2,36006,9003,1,841200000,841200000,13501,4500,9001,4500,0,1,4502,38290376,38.290376
6500,6900,4500,44850000,2,36006,9003,1,841200000,841200000,13501,4500,9001,4500,0,1,4502,37636832,37.636832
6500,6900,4500,44850000,2,36006,9003,1,841200000,841200000,13501,4500,9001,4500,0,1,4502,38655981,38.655981
6500,6900,4900,44850000,2,39206,9803,1,884080000,884080000,14701,4900,9801,4900,0,1,4902,41297226,41.297226
6500,6900,4900,44850000,2,39206,9803,1,884080000,884080000,14701,4900,9801,4900,0,1,4902,42801259,42.801259
6500,6900,4900,44850000,2,39206,9803,1,884080000,884080000,14701,4900,9801,4900,0,1,4902,40470530,40.47053
6500,6900,4900,44850000,2,39206,9803,1,884080000,884080000,14701,4900,9801,4900,0,1,4902,42295539,42.295539
6500,6900,4900,44850000,2,39206,9803,1,884080000,884080000,14701,4900,9801,4900,0,1,4902,40863684,40.863684
6500,6900,4900,44850000,2,39206,9803,1,884080000,884080000,14701,4900,9801,4900,0,1,4902,41741015,41.741015
6500,6900,4900,44850000,2,39206,9803,1,884080000,884080000,14701,4900,9801,4900,0,1,4902,41028121,41.028121
6500,6900,4900,44850000,2,39206,9803,1,884080000,884080000,14701,4900,9801,4900,0,1,4902,42143199,42.143199
6500,6900,5300,44850000,2,42406,10603,1,926960000,926960000,15901,5300,10601,5300,0,1,5302,44743344,44.743344
6500,6900,5300,44850000,2,42406,10603,1,926960000,926960000,15901,5300,10601,5300,0,1,5302,46241944,46.241944
6500,6900,5300,44850000,2,42406,10603,1,926960000,926960000,15901,5300,10601,5300,0,1,5302,43799580,43.79958
6500,6900,5300,44850000,2,42406,10603,1,926960000,926960000,15901,5300,10601,5300,0,1,5302,45755543,45.755543
6500,6900,5300,44850000,2,42406,10603,1,926960000,926960000,15901,5300,10601,5300,0,1,5302,44203637,44.203637
6500,6900,5300,44850000,2,42406,10603,1,926960000,926960000,15901,5300,10601,5300,0,1,5302,45068578,45.068578
6500,6900,5300,44850000,2,42406,10603,1,926960000,926960000,15901,5300,10601,5300,0,1,5302,44366097,44.366097
6500,6900,5300,44850000,2,42406,10603,1,926960000,926960000,15901,5300,10601,5300,0,1,5302,45616067,45.616067
6500,6900,5700,44850000,2,45606,11403,1,969840000,969840000,17101,5700,11401,5700,0,1,5702,48160598,48.160598
6500,6900,5700,44850000,2,45606,11403,1,969840000,969840000,17101,5700,11401,5700,0,1,5702,49724032,49.724032
6500,6900,5700,44850000,2,45606,11403,1,969840000,969840000,17101,5700,11401,5700,0,1,5702,47103587,47.103587
6500,6900,5700,44850000,2,45606,11403,1,969840000,969840000,17101,5700,11401,5700,0,1,5702,49185091,49.185091
6500,6900,5700,44850000,2,45606,11403,1,969840000,969840000,17101,5700,11401,5700,0,1,5702,47635778,47.635778
6500,6900,5700,44850000,2,45606,11403,1,969840000,969840000,17101,5700,11401,5700,0,1,5702,48490416,48.490416
6500,6900,5700,44850000,2,45606,11403,1,969840000,969840000,17101,5700,11401,5700,0,1,5702,47704904,47.704904
6500,6900,5700,44850000,2,45606,11403,1,969840000,969840000,17101,5700,11401,5700,0,1,5702,48945575,48.945575
6500,6900,6100,44850000,2,48806,12203,1,1012720000,1012720000,18301,6100,12201,6100,0,1,6102,51464526,51.464526
6500,6900,6100,44850000,2,48806,12203,1,1012720000,1012720000,18301,6100,12201,6100,0,1,6102,53269143,53.269143
6500,6900,6100,44850000,2,48806,12203,1,1012720000,1012720000,18301,6100,12201,6100,0,1,6102,50346991,50.346991
6500,6900,6100,44850000,2,48806,12203,1,1012720000,1012720000,18301,6100,12201,6100,0,1,6102,52733194,52.733194
6500,6900,6100,44850000,2,48806,12203,1,1012720000,1012720000,18301,6100,12201,6100,0,1,6102,50888512,50.888512
6500,6900,6100,44850000,2,48806,12203,1,1012720000,1012720000,18301,6100,12201,6100,0,1,6102,51891746,51.891746
6500,6900,6100,44850000,2,48806,12203,1,1012720000,1012720000,18301,6100,12201,6100,0,1,6102,51080095,51.080095
6500,6900,6100,44850000,2,48806,12203,1,1012720000,1012720000,18301,6100,12201,6100,0,1,6102,52485098,52.485098
6500,6900,6500,44850000,2,52006,13003,1,1055600000,1055600000,19501,6500,13001,6500,0,1,6502,54751827,54.751827
6500,6900,6500,44850000,2,52006,13003,1,1055600000,1055600000,19501,6500,13001,6500,0,1,6502,56735579,56.735579
6500,6900,6500,44850000,2,52006,13003,1,1055600000,1055600000,19501,6500,13001,6500,0,1,6502,53621763,53.621763
6500,6900,6500,44850000,2,52006,13003,1,1055600000,1055600000,19501,6500,13001,6500,0,1,6502,56184989,56.184989
6500,6900,6500,44850000,2,52006,13003,1,1055600000,1055600000,19501,6500,13001,6500,0,1,6502,54211255,54.211255
6500,6900,6500,44850000,2,52006,13003,1,1055600000,1055600000,19501,6500,13001,6500,0,1,6502,55266712,55.266712
6500,6900,6500,44850000,2,52006,13003,1,1055600000,1055600000,19501,6500,13001,6500,0,1,6502,54355556,54.355556
6500,6900,6500,44850000,2,52006,13003,1,1055600000,1055600000,19501,6500,13001,6500,0,1,6502,55873474,55.873474
6500,6900,6900,44850000,2,55206,13803,1,1098480000,1098480000,20701,6900,13801,6900,0,1,6902,58129834,58.129834
6500,6900,6900,44850000,2,55206,13803,1,1098480000,1098480000,20701,6900,13801,6900,0,1,6902,60299934,60.299934
6500,6900,6900,44850000,2,55206,13803,1,1098480000,1098480000,20701,6900,13801,6900,0,1,6902,56947763,56.947763
6500,6900,6900,44850000,2,55206,13803,1,1098480000,1098480000,20701,6900,13801,6900,0,1,6902,59623566,59.623566
6500,6900,6900,44850000,2,55206,13803,1,1098480000,1098480000,20701,6900,13801,6900,0,1,6902,57547865,57.547865
6500,6900,6900,44850000,2,55206,13803,1,1098480000,1098480000,20701,6900,13801,6900,0,1,6902,58695319,58.695319
6500,6900,6900,44850000,2,55206,13803,1,1098480000,1098480000,20701,6900,13801,6900,0,1,6902,57793028,57.793028
6500,6900,6900,44850000,2,55206,13803,1,1098480000,1098480000,20701,6900,13801,6900,0,1,6902,59250342,59.250342
6500,6500,500,42250000,2,4006,1003,1,390000000,390000000,1501,500,1001,500,0,1,502,4436661,4.436661
6500,6500,500,42250000,2,4006,1003,1,390000000,390000000,1501,500,1001,500,0,1,502,4530703,4.530703
6500,6500,500,42250000,2,4006,1003,1,390000000,390000000,1501,500,1001,500,0,1,502,4367360,4.36736
6500,6500,500,42250000,2,4006,1003,1,390000000,390000000,1501,500,1001,500,0,1,502,4500079,4.500079
6500,6500,500,42250000,2,4006,1003,1,390000000,390000000,1501,500,1001,500,0,1,502,4468095,4.468095
6500,6500,500,42250000,2,4006,1003,1,390000000,390000000,1501,500,1001,500,0,1,502,4498621,4.498621
6500,6500,500,42250000,2,4006,1003,1,390000000,390000000,1501,500,1001,500,0,1,502,4466979,4.466979
6500,6500,500,42250000,2,4006,1003,1,390000000,390000000,1501,500,1001,500,0,1,502,4498854,4.498854
6500,6500,900,42250000,2,7206,1803,1,431600000,431600000,2701,900,1801,900,0,1,902,7408273,7.408273
6500,6500,900,42250000,2,7206,1803,1,431600000,431600000,2701,900,1801,900,0,1,902,7652411,7.652411
6500,6500,900,42250000,2,7206,1803,1,431600000,431600000,2701,900,1801,900,0,1,902,7274904,7.274904
6500,6500,900,42250000,2,7206,1803,1,431600000,431600000,2701,900,1801,900,0,1,902,7599983,7.599983
6500,6500,900,42250000,2,7206,1803,1,431600000,431600000,2701,900,1801,900,0,1,902,7379852,7.379852
6500,6500,900,42250000,2,7206,1803,1,431600000,431600000,2701,900,1801,900,0,1,902,7480497,7.480497
6500,6500,900,42250000,2,7206,1803,1,431600000,431600000,2701,900,1801,900,0,1,902,7348919,7.348919
6500,6500,900,42250000,2,7206,1803,1,431600000,431600000,2701,900,1801,900,0,1,902,7556225,7.556225
6500,6500,1300,42250000,2,10406,2603,1,473200000,473200000,3901,1300,2601,1300,0,1,1302,10524592,10.524592
6500,6500,1300,42250000,2,10406,2603,1,473200000,473200000,3901,1300,2601,1300,0,1,1302,10999155,10.999155
6500,6500,1300,42250000,2,10406,2603,1,473200000,473200000,3901,1300,2601,1300,0,1,1302,10459868,10.459868
6500,6500,1300,42250000,2,10406,2603,1,473200000,473200000,3901,1300,2601,1300,0,1,1302,10832876,10.832876
6500,6500,1300,42250000,2,10406,2603,1,473200000,473200000,3901,1300,2601,1300,0,1,1302,10618568,10.618568
6500,6500,1300,42250000,2,10406,2603,1,473200000,473200000,3901,1300,2601,1300,0,1,1302,10757251,10.757251
6500,6500,1300,42250000,2,10406,2603,1,473200000,473200000,3901,1300,2601,1300,0,1,1302,10589431,10.589431
6500,6500,1300,42250000,2,10406,2603,1,473200000,473200000,3901,1300,2601,1300,0,1,1302,10862884,10.862884
6500,6500,1700,42250000,2,13606,3403,1,514800000,514800000,5101,1700,3401,1700,0,1,1702,13811339,13.811339
6500,6500,1700,42250000,2,13606,3403,1,514800000,514800000,5101,1700,3401,1700,0,1,1702,14121126,14.121126
6500,6500,1700,42250000,2,13606,3403,1,514800000,514800000,5101,1700,3401,1700,0,1,1702,13368728,13.368728
6500,6500,1700,42250000,2,13606,3403,1,514800000,514800000,5101,1700,3401,1700,0,1,1702,13936497,13.936497
6500,6500,1700,42250000,2,13606,3403,1,514800000,514800000,5101,1700,3401,1700,0,1,1702,13553036,13.553036
6500,6500,1700,42250000,2,13606,3403,1,514800000,514800000,5101,1700,3401,1700,0,1,1702,13782519,13.782519
6500,6500,1700,42250000,2,13606,3403,1,514800000,514800000,5101,1700,3401,1700,0,1,1702,13523973,13.523973
6500,6500,1700,42250000,2,13606,3403,1,514800000,514800000,5101,1700,3401,1700,0,1,1702,13906728,13.906728
6500,6500,2100,42250000,2,16806,4203,1,556400000,556400000,6301,2100,4201,2100,0,1,2102,16914003,16.914003
6500,6500,2100,42250000,2,16806,4203,1,556400000,556400000,6301,2100,4201,2100,0,1,2102,17456631,17.456631
6500,6500,2100,42250000,2,16806,4203,1,556400000,556400000,6301,2100,4201,2100,0,1,2102,16575145,16.575145
6500,6500,2100,42250000,2,16806,4203,1,556400000,556400000,6301,2100,4201,2100,0,1,2102,17172021,17.172021
6500,6500,2100,42250000,2,16806,4203,1,556400000,556400000,6301,2100,4201,2100,0,1,2102,16760770,16.76077
6500,6500,2100,42250000,2,16806,4203,1,556400000,556400000,6301,2100,4201,2100,0,1,2102,17027188,17.027188
6500,6500,2100,42250000,2,16806,4203,1,556400000,556400000,6301,2100,4201,2100,0,1,2102,16718108,16.718108
6500,6500,2100,42250000,2,16806,4203,1,556400000,556400000,6301,2100,4201,2100,0,1,2102,17211116,17.211116
6500,6500,2500,42250000,2,20006,5003,1,598000000,598000000,7501,2500,5001,2500,0,1,2502,20048420,20.04842
6500,6500,2500,42250000,2,20006,5003,1,598000000,598000000,7501,2500,5001,2500,0,1,2502,20707039,20.707039
6500,6500,2500,42250000,2,20006,5003,1,598000000,598000000,7501,2500,5001,2500,0,1,2502,19666110,19.66611
6500,6500,2500,42250000,2,20006,5003,1,598000000,598000000,7501,2500,5001,2500,0,1,2502,20380190,20.38019
6500,6500,2500,42250000,2,20006,5003,1,598000000,598000000,7501,2500,5001,2500,0,1,2502,19851952,19.851952
6500,6500,2500,42250000,2,20006,5003,1,598000000,598000000,7501,2500,5001,2500,0,1,2502,20191098,20.191098
6500,6500,2500,42250000,2,20006,5003,1,598000000,598000000,7501,2500,5001,2500,0,1,2502,19880510,19.88051
6500,6500,2500,42250000,2,20006,5003,1,598000000,598000000,7501,2500,5001,2500,0,1,2502,20408113,20.408113
6500,6500,2900,42250000,2,23206,5803,1,639600000,639600000,8701,2900,5801,2900,0,1,2902,23180220,23.18022
6500,6500,2900,42250000,2,23206,5803,1,639600000,639600000,8701,2900,5801,2900,0,1,2902,23985247,23.985247
6500,6500,2900,42250000,2,23206,5803,1,639600000,639600000,8701,2900,5801,2900,0,1,2902,22689580,22.68958
6500,6500,2900,42250000,2,23206,5803,1,639600000,639600000,8701,2900,5801,2900,0,1,2902,23646897,23.646897
6500,6500,2900,42250000,2,23206,5803,1,639600000,639600000,8701,2900,5801,2900,0,1,2902,22967377,22.967377
6500,6500,2900,42250000,2,23206,5803,1,639600000,639600000,8701,2900,5801,2900,0,1,2902,23377283,23.377283
6500,6500,2900,42250000,2,23206,5803,1,639600000,639600000,8701,2900,5801,2900,0,1,2902,22919151,22.919151
6500,6500,2900,42250000,2,23206,5803,1,639600000,639600000,8701,2900,5801,2900,0,1,2902,23603669,23.603669
6500,6500,3300,42250000,2,26406,6603,1,681200000,681200000,9901,3300,6601,3300,0,1,3302,26325208,26.325208
6500,6500,3300,42250000,2,26406,6603,1,681200000,681200000,9901,3300,6601,3300,0,1,3302,27216687,27.216687
6500,6500,3300,42250000,2,26406,6603,1,681200000,681200000,9901,3300,6601,3300,0,1,3302,25837492,25.837492
6500,6500,3300,42250000,2,26406,6603,1,681200000,681200000,9901,3300,6601,3300,0,1,3302,26834743,26.834743
6500,6500,3300,42250000,2,26406,6603,1,681200000,681200000,9901,3300,6601,3300,0,1,3302,26055216,26.055216
6500,6500,3300,42250000,2,26406,6603,1,681200000,681200000,9901,3300,6601,3300,0,1,3302,26551955,26.551955
6500,6500,3300,42250000,2,26406,6603,1,681200000,681200000,9901,3300,6601,3300,0,1,3302,26097998,26.097998
6500,6500,3300,42250000,2,26406,6603,1,681200000,681200000,9901,3300,6601,3300,0,1,3302,26792267,26.792267
6500,6500,3700,42250000,2,29606,7403,1,722800000,722800000,11101,3700,7401,3700,0,1,3702,29421425,29.421425
6500,6500,3700,42250000,2,29606,7403,1,722800000,722800000,11101,3700,7401,3700,0,1,3702,30494833,30.494833
6500,6500,3700,42250000,2,29606,7403,1,722800000,722800000,11101,3700,7401,3700,0,1,3702,28873105,28.873105
6500,6500,3700,42250000,2,29606,7403,1,722800000,722800000,11101,3700,7401,3700,0,1,3702,30047173,30.047173
6500,6500,3700,42250000,2,29606,7403,1,722800000,722800000,11101,3700,7401,3700,0,1,3702,29167492,29.167492
6500,6500,3700,42250000,2,29606,7403,1,722800000,722800000,11101,3700,7401,3700,0,1,3702,29718831,29.718831
6500,6500,3700,42250000,2,29606,7403,1,722800000,722800000,11101,3700,7401,3700,0,1,3702,29212624,29.212624
6500,6500,3700,42250000,2,29606,7403,1,722800000,722800000,11101,3700,7401,3700,0,1,3702,29993329,29.993329
6500,6500,4100,42250000,2,32806,8203,1,764400000,764400000,12301,4100,8201,4100,0,1,4102,32570473,32.570473
6500,6500,4100,42250000,2,32806,8203,1,764400000,764400000,12301,4100,8201,4100,0,1,4102,33818730,33.81873
6500,6500,4100,42250000,2,32806,8203,1,764400000,764400000,12301,4100,8201,4100,0,1,4102,31944366,31.944366
6500,6500,4100,42250000,2,32806,8203,1,764400000,764400000,12301,4100,8201,4100,0,1,4102,33261412,33.261412
6500,6500,4100,42250000,2,32806,8203,1,764400000,764400000,12301,4100,8201,4100,0,1,4102,32224522,32.224522
6500,6500,4100,42250000,2,32806,8203,1,764400000,764400000,12301,4100,8201,4100,0,1,4102,32847168,32.847168
6500,6500,4100,42250000,2,32806,8203,1,764400000,764400000,12301,4100,8201,4100,0,1,4102,32281093,32.281093
6500,6500,4100,42250000,2,32806,8203,1,764400000,764400000,12301,4100,8201,4100,0,1,4102,33214931,33.214931
6500,6500,4500,42250000,2,36006,9003,1,806000000,806000000,13501,4500,9001,4500,0,1,4502,35797195,35.797195
6500,6500,4500,42250000,2,36006,9003,1,806000000,806000000,13501,4500,9001,4500,0,1,4502,37113876,37.113876
6500,6500,4500,42250000,2,36006,9003,1,806000000,806000000,13501,4500,9001,4500,0,1,4502,35052305,35.052305
6500,6500,4500,42250000,2,36006,9003,1,806000000,806000000,13501,4500,9001,4500,0,1,4502,36582390,36.58239
6500,6500,4500,42250000,2,36006,9003,1,806000000,806000000,13501,4500,9001,4500,0,1,4502,35413673,35.413673
6500,6500,4500,42250000,2,36006,9003,1,806000000,806000000,13501,4500,9001,4500,0,1,4502,36042973,36.042973
6500,6500,4500,42250000,2,36006,9003,1,806000000,806000000,13501,4500,9001,4500,0,1,4502,35461711,35.461711
6500,6500,4500,42250000,2,36006,9003,1,806000000,806000000,13501,4500,9001,4500,0,1,4502,36451686,36.451686
6500,6500,4900,42250000,2,39206,9803,1,847600000,847600000,14701,4900,9801,4900,0,1,4902,38884835,38.884835
6500,6500,4900,42250000,2,39206,9803,1,847600000,847600000,14701,4900,9801,4900,0,1,4902,40418510,40.41851
6500,6500,4900,42250000,2,39206,9803,1,847600000,847600000,14701,4900,9801,4900,0,1,4902,38114715,38.114715
6500,6500,4900,42250000,2,39206,9803,1,847600000,847600000,14701,4900,9801,4900,0,1,4902,39798002,39.798002
6500,6500,4900,42250000,2,39206,9803,1,847600000,847600000,14701,4900,9801,4900,0,1,4902,38519754,38.519754
6500,6500,4900,42250000,2,39206,9803,1,847600000,847600000,14701,4900,9801,4900,0,1,4902,39231596,39.231596
6500,6500,4900,42250000,2,39206,9803,1,847600000,847600000,14701,4900,9801,4900,0,1,4902,38613999,38.613999
6500,6500,4900,42250000,2,39206,9803,1,847600000,847600000,14701,4900,9801,4900,0,1,4902,39680163,39.680163
6500,6500,5300,42250000,2,42406,10603,1,889200000,889200000,15901,5300,10601,5300,0,1,5302,42134117,42.134117
6500,6500,5300,42250000,2,42406,10603,1,889200000,889200000,15901,5300,10601,5300,0,1,5302,43689336,43.689336
6500,6500,5300,42250000,2,42406,10603,1,889200000,889200000,15901,5300,10601,5300,0,1,5302,41222554,41.222554
6500,6500,5300,42250000,2,42406,10603,1,889200000,889200000,15901,5300,10601,5300,0,1,5302,43136662,43.136662
6500,6500,5300,42250000,2,42406,10603,1,889200000,889200000,15901,5300,10601,5300,0,1,5302,41665758,41.665758
6500,6500,5300,42250000,2,42406,10603,1,889200000,889200000,15901,5300,10601,5300,0,1,5302,42490613,42.490613
6500,6500,5300,42250000,2,42406,10603,1,889200000,889200000,15901,5300,10601,5300,0,1,5302,41793568,41.793568
6500,6500,5300,42250000,2,42406,10603,1,889200000,889200000,15901,5300,10601,5300,0,1,5302,42877120,42.87712
6500,6500,5700,42250000,2,45606,11403,1,930800000,930800000,17101,5700,11401,5700,0,1,5702,45358355,45.358355
6500,6500,5700,42250000,2,45606,11403,1,930800000,930800000,17101,5700,11401,5700,0,1,5702,47008367,47.008367
6500,6500,5700,42250000,2,45606,11403,1,930800000,930800000,17101,5700,11401,5700,0,1,5702,44311592,44.311592
6500,6500,5700,42250000,2,45606,11403,1,930800000,930800000,17101,5700,11401,5700,0,1,5702,46359635,46.359635
6500,6500,5700,42250000,2,45606,11403,1,930800000,930800000,17101,5700,11401,5700,0,1,5702,44785202,44.785202
6500,6500,5700,42250000,2,45606,11403,1,930800000,930800000,17101,5700,11401,5700,0,1,5702,45660886,45.660886
6500,6500,5700,42250000,2,45606,11403,1,930800000,930800000,17101,5700,11401,5700,0,1,5702,44938744,44.938744
6500,6500,5700,42250000,2,45606,11403,1,930800000,930800000,17101,5700,11401,5700,0,1,5702,46146018,46.146018
6500,6500,6100,42250000,2,48806,12203,1,972400000,972400000,18301,6100,12201,6100,0,1,6102,48495422,48.495422
6500,6500,6100,42250000,2,48806,12203,1,972400000,972400000,18301,6100,12201,6100,0,1,6102,50293697,50.293697
6500,6500,6100,42250000,2,48806,12203,1,972400000,972400000,18301,6100,12201,6100,0,1,6102,47442158,47.442158
6500,6500,6100,42250000,2,48806,12203,1,972400000,972400000,18301,6100,12201,6100,0,1,6102,49667840,49.66784
6500,6500,6100,42250000,2,48806,12203,1,972400000,972400000,18301,6100,12201,6100,0,1,6102,47963287,47.963287
6500,6500,6100,42250000,2,48806,12203,1,972400000,972400000,18301,6100,12201,6100,0,1,6102,48939640,48.93964
6500,6500,6100,42250000,2,48806,12203,1,972400000,972400000,18301,6100,12201,6100,0,1,6102,48078822,48.078822
6500,6500,6100,42250000,2,48806,12203,1,972400000,972400000,18301,6100,12201,6100,0,1,6102,49458807,49.458807
6500,6500,6500,42250000,2,52006,13003,1,1014000000,1014000000,19501,6500,13001,6500,0,1,6502,51628374,51.628374
6500,6500,6500,42250000,2,52006,13003,1,1014000000,1014000000,19501,6500,13001,6500,0,1,6502,53585153,53.585153
6500,6500,6500,42250000,2,52006,13003,1,1014000000,1014000000,19501,6500,13001,6500,0,1,6502,50492025,50.492025
6500,6500,6500,42250000,2,52006,13003,1,1014000000,1014000000,19501,6500,13001,6500,0,1,6502,52854091,52.854091
6500,6500,6500,42250000,2,52006,13003,1,1014000000,1014000000,19501,6500,13001,6500,0,1,6502,51086201,51.086201
6500,6500,6500,42250000,2,52006,13003,1,1014000000,1014000000,19501,6500,13001,6500,0,1,6502,52015430,52.01543
6500,6500,6500,42250000,2,52006,13003,1,1014000000,1014000000,19501,6500,13001,6500,0,1,6502,51213337,51.213337
6500,6500,6500,42250000,2,52006,13003,1,1014000000,1014000000,19501,6500,13001,6500,0,1,6502,52674130,52.67413
6500,6500,6900,42250000,2,55206,13803,1,1055600000,1055600000,20701,6900,13801,6900,0,1,6902,54855437,54.855437
6500,6500,6900,42250000,2,55206,13803,1,1055600000,1055600000,20701,6900,13801,6900,0,1,6902,56852202,56.852202
6500,6500,6900,42250000,2,55206,13803,1,1055600000,1055600000,20701,6900,13801,6900,0,1,6902,53646569,53.646569
6500,6500,6900,42250000,2,55206,13803,1,1055600000,1055600000,20701,6900,13801,6900,0,1,6902,56059972,56.059972
6500,6500,6900,42250000,2,55206,13803,1,1055600000,1055600000,20701,6900,13801,6900,0,1,6902,54287589,54.287589
6500,6500,6900,42250000,2,55206,13803,1,1055600000,1055600000,20701,6900,13801,6900,0,1,6902,55345850,55.34585
6500,6500,6900,42250000,2,55206,13803,1,1055600000,1055600000,20701,6900,13801,6900,0,1,6902,54419820,54.41982
6500,6500,6900,42250000,2,55206,13803,1,1055600000,1055600000,20701,6900,13801,6900,0,1,6902,55881485,55.881485
6500,6100,500,39650000,2,4006,1003,1,367600000,367600000,1501,500,1001,500,0,1,502,4309059,4.309059
6500,6100,500,39650000,2,4006,1003,1,367600000,367600000,1501,500,1001,500,0,1,502,4211977,4.211977
6500,6100,500,39650000,2,4006,1003,1,367600000,367600000,1501,500,1001,500,0,1,502,4113487,4.113487
6500,6100,500,39650000,2,4006,1003,1,367600000,367600000,1501,500,1001,500,0,1,502,4241462,4.241462
6500,6100,500,39650000,2,4006,1003,1,367600000,367600000,1501,500,1001,500,0,1,502,4242983,4.242983
6500,6100,500,39650000,2,4006,1003,1,367600000,367600000,1501,500,1001,500,0,1,502,4270534,4.270534
6500,6100,500,39650000,2,4006,1003,1,367600000,367600000,1501,500,1001,500,0,1,502,4241660,4.24166
6500,6100,500,39650000,2,4006,1003,1,367600000,367600000,1501,500,1001,500,0,1,502,4242034,4.242034
6500,6100,900,39650000,2,7206,1803,1,407920000,407920000,2701,900,1801,900,0,1,902,7015825,7.015825
6500,6100,900,39650000,2,7206,1803,1,407920000,407920000,2701,900,1801,900,0,1,902,7163869,7.163869
6500,6100,900,39650000,2,7206,1803,1,407920000,407920000,2701,900,1801,900,0,1,902,6827663,6.827663
6500,6100,900,39650000,2,7206,1803,1,407920000,407920000,2701,900,1801,900,0,1,902,7106304,7.106304
6500,6100,900,39650000,2,7206,1803,1,407920000,407920000,2701,900,1801,900,0,1,902,6958641,6.958641
6500,6100,900,39650000,2,7206,1803,1,407920000,407920000,2701,900,1801,900,0,1,902,7046578,7.046578
6500,6100,900,39650000,2,7206,1803,1,407920000,407920000,2701,900,1801,900,0,1,902,6930556,6.930556
6500,6100,900,39650000,2,7206,1803,1,407920000,407920000,2701,900,1801,900,0,1,902,7074552,7.074552
6500,6100,1300,39650000,2,10406,2603,1,448240000,448240000,3901,1300,2601,1300,0,1,1302,9950069,9.950069
6500,6100,1300,39650000,2,10406,2603,1,448240000,448240000,3901,1300,2601,1300,0,1,1302,10206928,10.206928
6500,6100,1300,39650000,2,10406,2603,1,448240000,448240000,3901,1300,2601,1300,0,1,1302,9708538,9.708538
6500,6100,1300,39650000,2,10406,2603,1,448240000,448240000,3901,1300,2601,1300,0,1,1302,10103649,10.103649
6500,6100,1300,39650000,2,10406,2603,1,448240000,448240000,3901,1300,2601,1300,0,1,1302,9848039,9.848039
6500,6100,1300,39650000,2,10406,2603,1,448240000,448240000,3901,1300,2601,1300,0,1,1302,10010201,10.010201
6500,6100,1300,39650000,2,10406,2603,1,448240000,448240000,3901,1300,2601,1300,0,1,1302,9820775,9.820775
6500,6100,1300,39650000,2,10406,2603,1,448240000,448240000,3901,1300,2601,1300,0,1,1302,10075745,10.075745
6500,6100,1700,39650000,2,13606,3403,1,488560000,488560000,5101,1700,3401,1700,0,1,1702,13032490,13.03249
6500,6100,1700,39650000,2,13606,3403,1,488560000,488560000,5101,1700,3401,1700,0,1,1702,13374253,13.374253
6500,6100,1700,39650000,2,13606,3403,1,488560000,488560000,5101,1700,3401,1700,0,1,1702,12677751,12.677751
6500,6100,1700,39650000,2,13606,3403,1,488560000,488560000,5101,1700,3401,1700,0,1,1702,13183077,13.183077
6500,6100,1700,39650000,2,13606,3403,1,488560000,488560000,5101,1700,3401,1700,0,1,1702,12877191,12.877191
6500,6100,1700,39650000,2,13606,3403,1,488560000,488560000,5101,1700,3401,1700,0,1,1702,13069595,13.069595
6500,6100,1700,39650000,2,13606,3403,1,488560000,488560000,5101,1700,3401,1700,0,1,1702,12822984,12.822984
6500,6100,1700,39650000,2,13606,3403,1,488560000,488560000,5101,1700,3401,1700,0,1,1702,13209510,13.20951
6500,6100,2100,39650000,2,16806,4203,1,528880000,528880000,6301,2100,4201,2100,0,1,2102,15947739,15.947739
6500,6100,2100,39650000,2,16806,4203,1,528880000,528880000,6301,2100,4201,2100,0,1,2102,16410755,16.410755
6500,6100,2100,39650000,2,16806,4203,1,528880000,528880000,6301,2100,4201,2100,0,1,2102,15593877,15.593877
6500,6100,2100,39650000,2,16806,4203,1,528880000,528880000,6301,2100,4201,2100,0,1,2102,16220518,16.220518
6500,6100,2100,39650000,2,16806,4203,1,528880000,528880000,6301,2100,4201,2100,0,1,2102,15788120,15.78812
6500,6100,2100,39650000,2,16806,4203,1,528880000,528880000,6301,2100,4201,2100,0,1,2102,16035198,16.035198
6500,6100,2100,39650000,2,16806,4203,1,528880000,528880000,6301,2100,4201,2100,0,1,2102,15761143,15.761143
6500,6100,2100,39650000,2,16806,4203,1,528880000,528880000,6301,2100,4201,2100,0,1,2102,16193594,16.193594
6500,6100,2500,39650000,2,20006,5003,1,569200000,569200000,7501,2500,5001,2500,0,1,2502,18909476,18.909476
6500,6100,2500,39650000,2,20006,5003,1,569200000,569200000,7501,2500,5001,2500,0,1,2502,19485048,19.485048
6500,6100,2500,39650000,2,20006,5003,1,569200000,569200000,7501,2500,5001,2500,0,1,2502,18427594,18.427594
6500,6100,2500,39650000,2,20006,5003,1,569200000,569200000,7501,2500,5001,2500,0,1,2502,19226749,19.226749
6500,6100,2500,39650000,2,20006,5003,1,569200000,569200000,7501,2500,5001,2500,0,1,2502,18694539,18.694539
6500,6100,2500,39650000,2,20006,5003,1,569200000,569200000,7501,2500,5001,2500,0,1,2502,19042866,19.042866
6500,6100,2500,39650000,2,20006,5003,1,569200000,569200000,7501,2500,5001,2500,0,1,2502,18641072,18.641072
6500,6100,2500,39650000,2,20006,5003,1,569200000,569200000,7501,2500,5001,2500,0,1,2502,19198305,19.198305
6500,6100,2900,39650000,2,23206,5803,1,609520000,609520000,8701,2900,5801,2900,0,1,2902,21811576,21.811576
6500,6100,2900,39650000,2,23206,5803,1,609520000,609520000,8701,2900,5801,2900,0,1,2902,22562390,22.56239
6500,6100,2900,39650000,2,23206,5803,1,609520000,609520000,8701,2900,5801,2900,0,1,2902,21334742,21.334742
6500,6100,2900,39650000,2,23206,5803,1,609520000,609520000,8701,2900,5801,2900,0,1,2902,22211129,22.211129
6500,6100,2900,39650000,2,23206,5803,1,609520000,609520000,8701,2900,5801,2900,0,1,2902,21569985,21.569985
6500,6100,2900,39650000,2,23206,5803,1,609520000,609520000,8701,2900,5801,2900,0,1,2902,21976876,21.976876
6500,6100,2900,39650000,2,23206,5803,1,609520000,609520000,8701,2900,5801,2900,0,1,2902,21596686,21.596686
6500,6100,2900,39650000,2,23206,5803,1,609520000,609520000,8701,2900,5801,2900,0,1,2902,22184789,22.184789
6500,6100,3300,39650000,2,26406,6603,1,649840000,649840000,9901,3300,6601,3300,0,1,3302,24792722,24.792722
6500,6100,3300,39650000,2,26406,6603,1,649840000,649840000,9901,3300,6601,3300,0,1,3302,25556606,25.556606
6500,6100,3300,39650000,2,26406,6603,1,649840000,649840000,9901,3300,6601,3300,0,1,3302,24208838,24.208838
6500,6100,3300,39650000,2,26406,6603,1,649840000,649840000,9901,3300,6601,3300,0,1,3302,25251588,25.251588
6500,6100,3300,39650000,2,26406,6603,1,649840000,649840000,9901,3300,6601,3300,0,1,3302,24474816,24.474816
6500,6100,3300,39650000,2,26406,6603,1,649840000,649840000,9901,3300,6601,3300,0,1,3302,24950879,24.950879
6500,6100,3300,39650000,2,26406,6603,1,649840000,649840000,9901,3300,6601,3300,0,1,3302,24514841,24.514841
6500,6100,3300,39650000,2,26406,6603,1,649840000,649840000,9901,3300,6601,3300,0,1,3302,25211525,25.211525
6500,6100,3700,39650000,2,29606,7403,1,690160000,690160000,11101,3700,7401,3700,0,1,3702,27719526,27.719526
6500,6100,3700,39650000,2,29606,7403,1,690160000,690160000,11101,3700,7401,3700,0,1,3702,28637235,28.637235
6500,6100,3700,39650000,2,29606,7403,1,690160000,690160000,11101,3700,7401,3700,0,1,3702,27113207,27.113207
6500,6100,3700,39650000,2,29606,7403,1,690160000,690160000,11101,3700,7401,3700,0,1,3702,28298861,28.298861
6500,6100,3700,39650000,2,29606,7403,1,690160000,690160000,11101,3700,7401,3700,0,1,3702,27414011,27.414011
6500,6100,3700,39650000,2,29606,7403,1,690160000,690160000,11101,3700,7401,3700,0,1,3702,27955191,27.955191
6500,6100,3700,39650000,2,29606,7403,1,690160000,690160000,11101,3700,7401,3700,0,1,3702,27455914,27.455914
6500,6100,3700,39650000,2,29606,7403,1,690160000,690160000,11101,3700,7401,3700,0,1,3702,28221120,28.22112
6500,6100,4100,39650000,2,32806,8203,1,730480000,730480000,12301,4100,8201,4100,0,1,4102,30672330,30.67233
6500,6100,4100,39650000,2,32806,8203,1,730480000,730480000,12301,4100,8201,4100,0,1,4102,31707353,31.707353
6500,6100,4100,39650000,2,32806,8203,1,730480000,730480000,12301,4100,8201,4100,0,1,4102,29993330,29.99333
6500,6100,4100,39650000,2,32806,8203,1,730480000,730480000,12301,4100,8201,4100,0,1,4102,31313952,31.313952
6500,6100,4100,39650000,2,32806,8203,1,730480000,730480000,12301,4100,8201,4100,0,1,4102,30308601,30.308601
6500,6100,4100,39650000,2,32806,8203,1,730480000,730480000,12301,4100,8201,4100,0,1,4102,30961949,30.961949
6500,6100,4100,39650000,2,32806,8203,1,730480000,730480000,12301,4100,8201,4100,0,1,4102,30396715,30.396715
6500,6100,4100,39650000,2,32806,8203,1,730480000,730480000,12301,4100,8201,4100,0,1,4102,31197025,31.197025
6500,6100,4500,39650000,2,36006,9003,1,770800000,770800000,13501,4500,9001,4500,0,1,4502,33559123,33.559123
6500,6100,4500,39650000,2,36006,9003,1,770800000,770800000,13501,4500,9001,4500,0,1,4502,34782893,34.782893
6500,6100,4500,39650000,2,36006,9003,1,770800000,770800000,13501,4500,9001,4500,0,1,4502,32906486,32.906486
6500,6100,4500,39650000,2,36006,9003,1,770800000,770800000,13501,4500,9001,4500,0,1,4502,34303008,34.303008
6500,6100,4500,39650000,2,36006,9003,1,770800000,770800000,13501,4500,9001,4500,0,1,4502,33197635,33.197635
6500,6100,4500,39650000,2,36006,9003,1,770800000,770800000,13501,4500,9001,4500,0,1,4502,33918186,33.918186
6500,6100,4500,39650000,2,36006,9003,1,770800000,770800000,13501,4500,9001,4500,0,1,4502,33273944,33.273944
6500,6100,4500,39650000,2,36006,9003,1,770800000,770800000,13501,4500,9001,4500,0,1,4502,34236886,34.236886
6500,6100,4900,39650000,2,39206,9803,1,811120000,811120000,14701,4900,9801,4900,0,1,4902,36506251,36.506251
6500,6100,4900,39650000,2,39206,9803,1,811120000,811120000,14701,4900,9801,4900,0,1,4902,37835660,37.83566
6500,6100,4900,39650000,2,39206,9803,1,811120000,811120000,14701,4900,9801,4900,0,1,4902,35772489,35.772489
6500,6100,4900,39650000,2,39206,9803,1,811120000,811120000,14701,4900,9801,4900,0,1,4902,37363289,37.363289
6500,6100,4900,39650000,2,39206,9803,1,811120000,811120000,14701,4900,9801,4900,0,1,4902,36185027,36.185027
6500,6100,4900,39650000,2,39206,9803,1,811120000,811120000,14701,4900,9801,4900,0,1,4902,36912715,36.912715
6500,6100,4900,39650000,2,39206,9803,1,811120000,811120000,14701,4900,9801,4900,0,1,4902,36212137,36.212137
6500,6100,4900,39650000,2,39206,9803,1,811120000,811120000,14701,4900,9801,4900,0,1,4902,37200321,37.200321
6500,6100,5300,39650000,2,42406,10603,1,851440000,851440000,15901,5300,10601,5300,0,1,5302,39489425,39.489425
6500,6100,5300,39650000,2,42406,10603,1,851440000,851440000,15901,5300,10601,5300,0,1,5302,40927610,40.92761
6500,6100,5300,39650000,2,42406,10603,1,851440000,851440000,15901,5300,10601,5300,0,1,5302,38703363,38.703363
6500,6100,5300,39650000,2,42406,10603,1,851440000,851440000,15901,5300,10601,5300,0,1,5302,40471842,40.471842
6500,6100,5300,39650000,2,42406,10603,1,851440000,851440000,15901,5300,10601,5300,0,1,5302,39124450,39.12445
6500,6100,5300,39650000,2,42406,10603,1,851440000,851440000,15901,5300,10601,5300,0,1,5302,39907438,39.907438
6500,6100,5300,39650000,2,42406,10603,1,851440000,851440000,15901,5300,10601,5300,0,1,5302,39173013,39.173013
6500,6100,5300,39650000,2,42406,10603,1,851440000,851440000,15901,5300,10601,5300,0,1,5302,40341730,40.34173
6500,6100,5700,39650000,2,45606,11403,1,891760000,891760000,17101,5700,11401,5700,0,1,5702,42437182,42.437182
6500,6100,5700,39650000,2,45606,11403,1,891760000,891760000,17101,5700,11401,5700,0,1,5702,44011952,44.011952
6500,6100,5700,39650000,2,45606,11403,1,891760000,891760000,17101,5700,11401,5700,0,1,5702,41633321,41.633321
6500,6100,5700,39650000,2,45606,11403,1,891760000,891760000,17101,5700,11401,5700,0,1,5702,43520308,43.520308
6500,6100,5700,39650000,2,45606,11403,1,891760000,891760000,17101,5700,11401,5700,0,1,5702,42002669,42.002669
6500,6100,5700,39650000,2,45606,11403,1,891760000,891760000,17101,5700,11401,5700,0,1,5702,42916535,42.916535
6500,6100,5700,39650000,2,45606,11403,1,891760000,891760000,17101,5700,11401,5700,0,1,5702,42136210,42.13621
6500,6100,5700,39650000,2,45606,11403,1,891760000,891760000,17101,5700,11401,5700,0,1,5702,43296721,43.296721
6500,6100,6100,39650000,2,48806,12203,1,932080000,932080000,18301,6100,12201,6100,0,1,6102,45559683,45.559683
6500,6100,6100,39650000,2,48806,12203,1,932080000,932080000,18301,6100,12201,6100,0,1,6102,47071435,47.071435
6500,6100,6100,39650000,2,48806,12203,1,932080000,932080000,18301,6100,12201,6100,0,1,6102,44515041,44.515041
6500,6100,6100,39650000,2,48806,12203,1,932080000,932080000,18301,6100,12201,6100,0,1,6102,46601439,46.601439
6500,6100,6100,39650000,2,48806,12203,1,932080000,932080000,18301,6100,12201,6100,0,1,6102,45058698,45.058698
6500,6100,6100,39650000,2,48806,12203,1,932080000,932080000,18301,6100,12201,6100,0,1,6102,45950778,45.950778
6500,6100,6100,39650000,2,48806,12203,1,932080000,932080000,18301,6100,12201,6100,0,1,6102,45110375,45.110375
6500,6100,6100,39650000,2,48806,12203,1,932080000,932080000,18301,6100,12201,6100,0,1,6102,46316015,46.316015
6500,6100,6500,39650000,2,52006,13003,1,972400000,972400000,19501,6500,13001,6500,0,1,6502,48410420,48.41042
6500,6100,6500,39650000,2,52006,13003,1,972400000,972400000,19501,6500,13001,6500,0,1,6502,50175809,50.175809
6500,6100,6500,39650000,2,52006,13003,1,972400000,972400000,19501,6500,13001,6500,0,1,6502,47486109,47.486109
6500,6100,6500,39650000,2,52006,13003,1,972400000,972400000,19501,6500,13001,6500,0,1,6502,49649463,49.649463
6500,6100,6500,39650000,2,52006,13003,1,972400000,972400000,19501,6500,13001,6500,0,1,6502,48023207,48.023207
6500,6100,6500,39650000,2,52006,13003,1,972400000,972400000,19501,6500,13001,6500,0,1,6502,49017815,49.017815
6500,6100,6500,39650000,2,52006,13003,1,972400000,972400000,19501,6500,13001,6500,0,1,6502,48179357,48.179357
6500,6100,6500,39650000,2,52006,13003,1,972400000,972400000,19501,6500,13001,6500,0,1,6502,49426975,49.426975
6500,6100,6900,39650000,2,55206,13803,1,1012720000,1012720000,20701,6900,13801,6900,0,1,6902,51522324,51.522324
6500,6100,6900,39650000,2,55206,13803,1,1012720000,1012720000,20701,6900,13801,6900,0,1,6902,53243180,53.24318
6500,6100,6900,39650000,2,55206,13803,1,1012720000,1012720000,20701,6900,13801,6900,0,1,6902,50445579,50.445579
6500,6100,6900,39650000,2,55206,13803,1,1012720000,1012720000,20701,6900,13801,6900,0,1,6902,52790974,52.790974
6500,6100,6900,39650000,2,55206,13803,1,1012720000,1012720000,20701,6900,13801,6900,0,1,6902,51097749,51.097749
6500,6100,6900,39650000,2,55206,13803,1,1012720000,1012720000,20701,6900,13801,6900,0,1,6902,52064062,52.064062
6500,6100,6900,39650000,2,55206,13803,1,1012720000,1012720000,20701,6900,13801,6900,0,1,6902,51153531,51.153531
6500,6100,6900,39650000,2,55206,13803,1,1012720000,1012720000,20701,6900,13801,6900,0,1,6902,52486085,52.486085
6500,5700,500,37050000,2,4006,1003,1,345200000,345200000,1501,500,1001,500,0,1,502,3945373,3.945373
6500,5700,500,37050000,2,4006,1003,1,345200000,345200000,1501,500,1001,500,0,1,502,4062843,4.062843
6500,5700,500,37050000,2,4006,1003,1,345200000,345200000,1501,500,1001,500,0,1,502,3866473,3.866473
6500,5700,500,37050000,2,4006,1003,1,345200000,345200000,1501,500,1001,500,0,1,502,4035819,4.035819
6500,5700,500,37050000,2,4006,1003,1,345200000,345200000,1501,500,1001,500,0,1,502,3970987,3.970987
6500,5700,500,37050000,2,4006,1003,1,345200000,345200000,1501,500,1001,500,0,1,502,3835213,3.835213
6500,5700,500,37050000,2,4006,1003,1,345200000,345200000,1501,500,1001,500,0,1,502,3971267,3.971267
6500,5700,500,37050000,2,4006,1003,1,345200000,345200000,1501,500,1001,500,0,1,502,3972758,3.972758
6500,5700,900,37050000,2,7206,1803,1,384240000,384240000,2701,900,1801,900,0,1,902,6489682,6.489682
6500,5700,900,37050000,2,7206,1803,1,384240000,384240000,2701,900,1801,900,0,1,902,6711240,6.71124
6500,5700,900,37050000,2,7206,1803,1,384240000,384240000,2701,900,1801,900,0,1,902,6368769,6.368769
6500,5700,900,37050000,2,7206,1803,1,384240000,384240000,2701,900,1801,900,0,1,902,6654743,6.654743
6500,5700,900,37050000,2,7206,1803,1,384240000,384240000,2701,900,1801,900,0,1,902,6460790,6.46079
6500,5700,900,37050000,2,7206,1803,1,384240000,384240000,2701,900,1801,900,0,1,902,6568992,6.568992
6500,5700,900,37050000,2,7206,1803,1,384240000,384240000,2701,900,1801,900,0,1,902,6435133,6.435133
6500,5700,900,37050000,2,7206,1803,1,384240000,384240000,2701,900,1801,900,0,1,902,6624532,6.624532
6500,5700,1300,37050000,2,10406,2603,1,423280000,423280000,3901,1300,2601,1300,0,1,1302,9229481,9.229481
6500,5700,1300,37050000,2,10406,2603,1,423280000,423280000,3901,1300,2601,1300,0,1,1302,9551421,9.551421
6500,5700,1300,37050000,2,10406,2603,1,423280000,423280000,3901,1300,2601,1300,0,1,1302,9056628,9.056628
6500,5700,1300,37050000,2,10406,2603,1,423280000,423280000,3901,1300,2601,1300,0,1,1302,9453621,9.453621
6500,5700,1300,37050000,2,10406,2603,1,423280000,423280000,3901,1300,2601,1300,0,1,1302,9167576,9.167576
6500,5700,1300,37050000,2,10406,2603,1,423280000,423280000,3901,1300,2601,1300,0,1,1302,9333198,9.333198
6500,5700,1300,37050000,2,10406,2603,1,423280000,423280000,3901,1300,2601,1300,0,1,1302,9133249,9.133249
6500,5700,1300,37050000,2,10406,2603,1,423280000,423280000,3901,1300,2601,1300,0,1,1302,9422285,9.422285
6500,5700,1700,37050000,2,13606,3403,1,462320000,462320000,5101,1700,3401,1700,0,1,1702,12150963,12.150963
6500,5700,1700,37050000,2,13606,3403,1,462320000,462320000,5101,1700,3401,1700,0,1,1702,12507628,12.507628
6500,5700,1700,37050000,2,13606,3403,1,462320000,462320000,5101,1700,3401,1700,0,1,1702,11884029,11.884029
6500,5700,1700,37050000,2,13606,3403,1,462320000,462320000,5101,1700,3401,1700,0,1,1702,12312688,12.312688
6500,5700,1700,37050000,2,13606,3403,1,462320000,462320000,5101,1700,3401,1700,0,1,1702,12046286,12.046286
6500,5700,1700,37050000,2,13606,3403,1,462320000,462320000,5101,1700,3401,1700,0,1,1702,12207588,12.207588
6500,5700,1700,37050000,2,13606,3403,1,462320000,462320000,5101,1700,3401,1700,0,1,1702,12020377,12.020377
6500,5700,1700,37050000,2,13606,3403,1,462320000,462320000,5101,1700,3401,1700,0,1,1702,12337400,12.3374
6500,5700,2100,37050000,2,16806,4203,1,501360000,501360000,6301,2100,4201,2100,0,1,2102,14896807,14.896807
6500,5700,2100,37050000,2,16806,4203,1,501360000,501360000,6301,2100,4201,2100,0,1,2102,15345538,15.345538
6500,5700,2100,37050000,2,16806,4203,1,501360000,501360000,6301,2100,4201,2100,0,1,2102,14578391,14.578391
6500,5700,2100,37050000,2,16806,4203,1,501360000,501360000,6301,2100,4201,2100,0,1,2102,15145719,15.145719
6500,5700,2100,37050000,2,16806,4203,1,501360000,501360000,6301,2100,4201,2100,0,1,2102,14724515,14.724515
6500,5700,2100,37050000,2,16806,4203,1,501360000,501360000,6301,2100,4201,2100,0,1,2102,14982049,14.982049
6500,5700,2100,37050000,2,16806,4203,1,501360000,501360000,6301,2100,4201,2100,0,1,2102,14749460,14.74946
6500,5700,2100,37050000,2,16806,4203,1,501360000,501360000,6301,2100,4201,2100,0,1,2102,15119619,15.119619
6500,5700,2500,37050000,2,20006,5003,1,540400000,540400000,7501,2500,5001,2500,0,1,2502,17614638,17.614638
6500,5700,2500,37050000,2,20006,5003,1,540400000,540400000,7501,2500,5001,2500,0,1,2502,18180222,18.180222
6500,5700,2500,37050000,2,20006,5003,1,540400000,540400000,7501,2500,5001,2500,0,1,2502,17230720,17.23072
6500,5700,2500,37050000,2,20006,5003,1,540400000,540400000,7501,2500,5001,2500,0,1,2502,17945765,17.945765
6500,5700,2500,37050000,2,20006,5003,1,540400000,540400000,7501,2500,5001,2500,0,1,2502,17457751,17.457751
6500,5700,2500,37050000,2,20006,5003,1,540400000,540400000,7501,2500,5001,2500,0,1,2502,17761057,17.761057
6500,5700,2500,37050000,2,20006,5003,1,540400000,540400000,7501,2500,5001,2500,0,1,2502,17421616,17.421616
6500,5700,2500,37050000,2,20006,5003,1,540400000,540400000,7501,2500,5001,2500,0,1,2502,17919569,17.919569
6500,5700,2900,37050000,2,23206,5803,1,579440000,579440000,8701,2900,5801,2900,0,1,2902,20381449,20.381449
6500,5700,2900,37050000,2,23206,5803,1,579440000,579440000,8701,2900,5801,2900,0,1,2902,21050689,21.050689
6500,5700,2900,37050000,2,23206,5803,1,579440000,579440000,8701,2900,5801,2900,0,1,2902,19936913,19.936913
6500,5700,2900,37050000,2,23206,5803,1,579440000,579440000,8701,2900,5801,2900,0,1,2902,20750724,20.750724
6500,5700,2900,37050000,2,23206,5803,1,579440000,579440000,8701,2900,5801,2900,0,1,2902,20150302,20.150302
6500,5700,2900,37050000,2,23206,5803,1,579440000,579440000,8701,2900,5801,2900,0,1,2902,20528720,20.52872
6500,5700,2900,37050000,2,23206,5803,1,579440000,579440000,8701,2900,5801,2900,0,1,2902,20175840,20.17584
6500,5700,2900,37050000,2,23206,5803,1,579440000,579440000,8701,2900,5801,2900,0,1,2902,20713247,20.713247
6500,5700,3300,37050000,2,26406,6603,1,618480000,618480000,9901,3300,6601,3300,0,1,3302,23114934,23.114934
6500,5700,3300,37050000,2,26406,6603,1,618480000,618480000,9901,3300,6601,3300,0,1,3302,23912839,23.912839
6500,5700,3300,37050000,2,26406,6603,1,618480000,618480000,9901,3300,6601,3300,0,1,3302,22630273,22.630273
6500,5700,3300,37050000,2,26406,6603,1,618480000,618480000,9901,3300,6601,3300,0,1,3302,23582088,23.582088
6500,5700,3300,37050000,2,26406,6603,1,618480000,618480000,9901,3300,6601,3300,0,1,3302,22903759,22.903759
6500,5700,3300,37050000,2,26406,6603,1,618480000,618480000,9901,3300,6601,3300,0,1,3302,23314857,23.314857
6500,5700,3300,37050000,2,26406,6603,1,618480000,618480000,9901,3300,6601,3300,0,1,3302,22857319,22.857319
6500,5700,3300,37050000,2,26406,6603,1,618480000,618480000,9901,3300,6601,3300,0,1,3302,23526008,23.526008
6500,5700,3700,37050000,2,29606,7403,1,657520000,657520000,11101,3700,7401,3700,0,1,3702,25861481,25.861481
6500,5700,3700,37050000,2,29606,7403,1,657520000,657520000,11101,3700,7401,3700,0,1,3702,26741822,26.741822
6500,5700,3700,37050000,2,29606,7403,1,657520000,657520000,11101,3700,7401,3700,0,1,3702,25379517,25.379517
6500,5700,3700,37050000,2,29606,7403,1,657520000,657520000,11101,3700,7401,3700,0,1,3702,26402134,26.402134
6500,5700,3700,37050000,2,29606,7403,1,657520000,657520000,11101,3700,7401,3700,0,1,3702,25658200,25.6582
6500,5700,3700,37050000,2,29606,7403,1,657520000,657520000,11101,3700,7401,3700,0,1,3702,26083487,26.083487
6500,5700,3700,37050000,2,29606,7403,1,657520000,657520000,11101,3700,7401,3700,0,1,3702,25632991,25.632991
6500,5700,3700,37050000,2,29606,7403,1,657520000,657520000,11101,3700,7401,3700,0,1,3702,26336532,26.336532
6500,5700,4100,37050000,2,32806,8203,1,696560000,696560000,12301,4100,8201,4100,0,1,4102,28649707,28.649707
6500,5700,4100,37050000,2,32806,8203,1,696560000,696560000,12301,4100,8201,4100,0,1,4102,29620467,29.620467
6500,5700,4100,37050000,2,32806,8203,1,696560000,696560000,12301,4100,8201,4100,0,1,4102,28021622,28.021622
6500,5700,4100,37050000,2,32806,8203,1,696560000,696560000,12301,4100,8201,4100,0,1,4102,29209911,29.209911
6500,5700,4100,37050000,2,32806,8203,1,696560000,696560000,12301,4100,8201,4100,0,1,4102,28287851,28.287851
6500,5700,4100,37050000,2,32806,8203,1,696560000,696560000,12301,4100,8201,4100,0,1,4102,28874889,28.874889
6500,5700,4100,37050000,2,32806,8203,1,696560000,696560000,12301,4100,8201,4100,0,1,4102,28329438,28.329438
6500,5700,4100,37050000,2,32806,8203,1,696560000,696560000,12301,4100,8201,4100,0,1,4102,29157689,29.157689
6500,5700,4500,37050000,2,36006,9003,1,735600000,735600000,13501,4500,9001,4500,0,1,4502,31348884,31.348884
6500,5700,4500,37050000,2,36006,9003,1,735600000,735600000,13501,4500,9001,4500,0,1,4502,32472263,32.472263
6500,5700,4500,37050000,2,36006,9003,1,735600000,735600000,13501,4500,9001,4500,0,1,4502,30756172,30.756172
6500,5700,4500,37050000,2,36006,9003,1,735600000,735600000,13501,4500,9001,4500,0,1,4502,32046110,32.04611
6500,5700,4500,37050000,2,36006,9003,1,735600000,735600000,13501,4500,9001,4500,0,1,4502,31106861,31.106861
6500,5700,4500,37050000,2,36006,9003,1,735600000,735600000,13501,4500,9001,4500,0,1,4502,31631371,31.631371
6500,5700,4500,37050000,2,36006,9003,1,735600000,735600000,13501,4500,9001,4500,0,1,4502,31081659,31.081659
6500,5700,4500,37050000,2,36006,9003,1,735600000,735600000,13501,4500,9001,4500,0,1,4502,31995104,31.995104
6500,5700,4900,37050000,2,39206,9803,1,774640000,774640000,14701,4900,9801,4900,0,1,4902,34141340,34.14134
6500,5700,4900,37050000,2,39206,9803,1,774640000,774640000,14701,4900,9801,4900,0,1,4902,35371896,35.371896
6500,5700,4900,37050000,2,39206,9803,1,774640000,774640000,14701,4900,9801,4900,0,1,4902,33547695,33.547695
6500,5700,4900,37050000,2,39206,9803,1,774640000,774640000,14701,4900,9801,4900,0,1,4902,34890430,34.89043
6500,5700,4900,37050000,2,39206,9803,1,774640000,774640000,14701,4900,9801,4900,0,1,4902,33772329,33.772329
6500,5700,4900,37050000,2,39206,9803,1,774640000,774640000,14701,4900,9801,4900,0,1,4902,34484495,34.484495
6500,5700,4900,37050000,2,39206,9803,1,774640000,774640000,14701,4900,9801,4900,0,1,4902,33831631,33.831631
6500,5700,4900,37050000,2,39206,9803,1,774640000,774640000,14701,4900,9801,4900,0,1,4902,34773481,34.773481
6500,5700,5300,37050000,2,42406,10603,1,813680000,813680000,15901,5300,10601,5300,0,1,5302,36923338,36.923338
6500,5700,5300,37050000,2,42406,10603,1,813680000,813680000,15901,5300,10601,5300,0,1,5302,38322358,38.322358
6500,5700,5300,37050000,2,42406,10603,1,813680000,813680000,15901,5300,10601,5300,0,1,5302,36230884,36.230884
6500,5700,5300,37050000,2,42406,10603,1,813680000,813680000,15901,5300,10601,5300,0,1,5302,37758649,37.758649
6500,5700,5300,37050000,2,42406,10603,1,813680000,813680000,15901,5300,10601,5300,0,1,5302,36540885,36.540885
6500,5700,5300,37050000,2,42406,10603,1,813680000,813680000,15901,5300,10601,5300,0,1,5302,37284856,37.284856
6500,5700,5300,37050000,2,42406,10603,1,813680000,813680000,15901,5300,10601,5300,0,1,5302,36586126,36.586126
6500,5700,5300,37050000,2,42406,10603,1,813680000,813680000,15901,5300,10601,5300,0,1,5302,37700974,37.700974
6500,5700,5700,37050000,2,45606,11403,1,852720000,852720000,17101,5700,11401,5700,0,1,5702,39697237,39.697237
6500,5700,5700,37050000,2,45606,11403,1,852720000,852720000,17101,5700,11401,5700,0,1,5702,41151087,41.151087
6500,5700,5700,37050000,2,45606,11403,1,852720000,852720000,17101,5700,11401,5700,0,1,5702,38897849,38.897849
6500,5700,5700,37050000,2,45606,11403,1,852720000,852720000,17101,5700,11401,5700,0,1,5702,40613579,40.613579
6500,5700,5700,37050000,2,45606,11403,1,852720000,852720000,17101,5700,11401,5700,0,1,5702,39269382,39.269382
6500,5700,5700,37050000,2,45606,11403,1,852720000,852720000,17101,5700,11401,5700,0,1,5702,40003790,40.00379
6500,5700,5700,37050000,2,45606,11403,1,852720000,852720000,17101,5700,11401,5700,0,1,5702,39347584,39.347584
6500,5700,5700,37050000,2,45606,11403,1,852720000,852720000,17101,5700,11401,5700,0,1,5702,40492162,40.492162
6500,5700,6100,37050000,2,48806,12203,1,891760000,891760000,18301,6100,12201,6100,0,1,6102,42448139,42.448139
6500,5700,6100,37050000,2,48806,12203,1,891760000,891760000,18301,6100,12201,6100,0,1,6102,44014315,44.014315
6500,5700,6100,37050000,2,48806,12203,1,891760000,891760000,18301,6100,12201,6100,0,1,6102,41638428,41.638428
6500,5700,6100,37050000,2,48806,12203,1,891760000,891760000,18301,6100,12201,6100,0,1,6102,43447578,43.447578
6500,5700,6100,37050000,2,48806,12203,1,891760000,891760000,18301,6100,12201,6100,0,1,6102,42036183,42.036183
6500,5700,6100,37050000,2,48806,12203,1,891760000,891760000,18301,6100,12201,6100,0,1,6102,42857479,42.857479
6500,5700,6100,37050000,2,48806,12203,1,891760000,891760000,18301,6100,12201,6100,0,1,6102,42110994,42.110994
6500,5700,6100,37050000,2,48806,12203,1,891760000,891760000,18301,6100,12201,6100,0,1,6102,43319795,43.319795
6500,5700,6500,37050000,2,52006,13003,1,930800000,930800000,19501,6500,13001,6500,0,1,6502,45211330,45.21133
6500,5700,6500,37050000,2,52006,13003,1,930800000,930800000,19501,6500,13001,6500,0,1,6502,46886081,46.886081
6500,5700,6500,37050000,2,52006,13003,1,930800000,930800000,19501,6500,13001,6500,0,1,6502,44353212,44.353212
6500,5700,6500,37050000,2,52006,13003,1,930800000,930800000,19501,6500,13001,6500,0,1,6502,46396561,46.396561
6500,5700,6500,37050000,2,52006,13003,1,930800000,930800000,19501,6500,13001,6500,0,1,6502,44892002,44.892002
6500,5700,6500,37050000,2,52006,13003,1,930800000,930800000,19501,6500,13001,6500,0,1,6502,45587687,45.587687
6500,5700,6500,37050000,2,52006,13003,1,930800000,930800000,19501,6500,13001,6500,0,1,6502,44866172,44.866172
6500,5700,6500,37050000,2,52006,13003,1,930800000,930800000,19501,6500,13001,6500,0,1,6502,46236797,46.236797
6500,5700,6900,37050000,2,55206,13803,1,969840000,969840000,20701,6900,13801,6900,0,1,6902,48015657,48.015657
6500,5700,6900,37050000,2,55206,13803,1,969840000,969840000,20701,6900,13801,6900,0,1,6902,49765716,49.765716
6500,5700,6900,37050000,2,55206,13803,1,969840000,969840000,20701,6900,13801,6900,0,1,6902,47149184,47.149184
6500,5700,6900,37050000,2,55206,13803,1,969840000,969840000,20701,6900,13801,6900,0,1,6902,49170783,49.170783
6500,5700,6900,37050000,2,55206,13803,1,969840000,969840000,20701,6900,13801,6900,0,1,6902,47614591,47.614591
6500,5700,6900,37050000,2,55206,13803,1,969840000,969840000,20701,6900,13801,6900,0,1,6902,48434263,48.434263
6500,5700,6900,37050000,2,55206,13803,1,969840000,969840000,20701,6900,13801,6900,0,1,6902,47641581,47.641581
6500,5700,6900,37050000,2,55206,13803,1,969840000,969840000,20701,6900,13801,6900,0,1,6902,49068459,49.068459
6500,5300,500,34450000,2,4006,1003,1,322800000,322800000,1501,500,1001,500,0,1,502,3688654,3.688654
6500,5300,500,34450000,2,4006,1003,1,322800000,322800000,1501,500,1001,500,0,1,502,3739361,3.739361
6500,5300,500,34450000,2,4006,1003,1,322800000,322800000,1501,500,1001,500,0,1,502,3599922,3.599922
6500,5300,500,34450000,2,4006,1003,1,322800000,322800000,1501,500,1001,500,0,1,502,3713600,3.7136
6500,5300,500,34450000,2,4006,1003,1,322800000,322800000,1501,500,1001,500,0,1,502,3689330,3.68933
6500,5300,500,34450000,2,4006,1003,1,322800000,322800000,1501,500,1001,500,0,1,502,3689161,3.689161
6500,5300,500,34450000,2,4006,1003,1,322800000,322800000,1501,500,1001,500,0,1,502,3663271,3.663271
6500,5300,500,34450000,2,4006,1003,1,322800000,322800000,1501,500,1001,500,0,1,502,3714293,3.714293
6500,5300,900,34450000,2,7206,1803,1,360560000,360560000,2701,900,1801,900,0,1,902,6069463,6.069463
6500,5300,900,34450000,2,7206,1803,1,360560000,360560000,2701,900,1801,900,0,1,902,6280825,6.280825
6500,5300,900,34450000,2,7206,1803,1,360560000,360560000,2701,900,1801,900,0,1,902,5991475,5.991475
6500,5300,900,34450000,2,7206,1803,1,360560000,360560000,2701,900,1801,900,0,1,902,6238801,6.238801
6500,5300,900,34450000,2,7206,1803,1,360560000,360560000,2701,900,1801,900,0,1,902,6045738,6.045738
6500,5300,900,34450000,2,7206,1803,1,360560000,360560000,2701,900,1801,900,0,1,902,6120048,6.120048
6500,5300,900,34450000,2,7206,1803,1,360560000,360560000,2701,900,1801,900,0,1,902,6022185,6.022185
6500,5300,900,34450000,2,7206,1803,1,360560000,360560000,2701,900,1801,900,0,1,902,6190923,6.190923
6500,5300,1300,34450000,2,10406,2603,1,398320000,398320000,3901,1300,2601,1300,0,1,1302,8598449,8.598449
6500,5300,1300,34450000,2,10406,2603,1,398320000,398320000,3901,1300,2601,1300,0,1,1302,8900244,8.900244
6500,5300,1300,34450000,2,10406,2603,1,398320000,398320000,3901,1300,2601,1300,0,1,1302,8430762,8.430762
6500,5300,1300,34450000,2,10406,2603,1,398320000,398320000,3901,1300,2601,1300,0,1,1302,8803393,8.803393
6500,5300,1300,34450000,2,10406,2603,1,398320000,398320000,3901,1300,2601,1300,0,1,1302,8536749,8.536749
6500,5300,1300,34450000,2,10406,2603,1,398320000,398320000,3901,1300,2601,1300,0,1,1302,8679299,8.679299
6500,5300,1300,34450000,2,10406,2603,1,398320000,398320000,3901,1300,2601,1300,0,1,1302,8513448,8.513448
6500,5300,1300,34450000,2,10406,2603,1,398320000,398320000,3901,1300,2601,1300,0,1,1302,8778772,8.778772
6500,5300,1700,34450000,2,13606,3403,1,436080000,436080000,5101,1700,3401,1700,0,1,1702,11309705,11.309705
6500,5300,1700,34450000,2,13606,3403,1,436080000,436080000,5101,1700,3401,1700,0,1,1702,11660045,11.660045
6500,5300,1700,34450000,2,13606,3403,1,436080000,436080000,5101,1700,3401,1700,0,1,1702,11105680,11.10568
6500,5300,1700,34450000,2,13606,3403,1,436080000,436080000,5101,1700,3401,1700,0,1,1702,11523729,11.523729
6500,5300,1700,34450000,2,13606,3403,1,436080000,436080000,5101,1700,3401,1700,0,1,1702,11222681,11.222681
6500,5300,1700,34450000,2,13606,3403,1,436080000,436080000,5101,1700,3401,1700,0,1,1702,11374088,11.374088
6500,5300,1700,34450000,2,13606,3403,1,436080000,436080000,5101,1700,3401,1700,0,1,1702,11177899,11.177899
6500,5300,1700,34450000,2,13606,3403,1,436080000,436080000,5101,1700,3401,1700,0,1,1702,11493217,11.493217
6500,5300,2100,34450000,2,16806,4203,1,473840000,473840000,6301,2100,4201,2100,0,1,2102,13844926,13.844926
6500,5300,2100,34450000,2,16806,4203,1,473840000,473840000,6301,2100,4201,2100,0,1,2102,14285691,14.285691
6500,5300,2100,34450000,2,16806,4203,1,473840000,473840000,6301,2100,4201,2100,0,1,2102,13585867,13.585867
6500,5300,2100,34450000,2,16806,4203,1,473840000,473840000,6301,2100,4201,2100,0,1,2102,14104262,14.104262
6500,5300,2100,34450000,2,16806,4203,1,473840000,473840000,6301,2100,4201,2100,0,1,2102,13758533,13.758533
6500,5300,2100,34450000,2,16806,4203,1,473840000,473840000,6301,2100,4201,2100,0,1,2102,13921680,13.92168
6500,5300,2100,34450000,2,16806,4203,1,473840000,473840000,6301,2100,4201,2100,0,1,2102,13690907,13.690907
6500,5300,2100,34450000,2,16806,4203,1,473840000,473840000,6301,2100,4201,2100,0,1,2102,14078758,14.078758
6500,5300,2500,34450000,2,20006,5003,1,511600000,511600000,7501,2500,5001,2500,0,1,2502,16396199,16.396199
6500,5300,2500,34450000,2,20006,5003,1,511600000,511600000,7501,2500,5001,2500,0,1,2502,16899237,16.899237
6500,5300,2500,34450000,2,20006,5003,1,511600000,511600000,7501,2500,5001,2500,0,1,2502,16034925,16.034925
6500,5300,2500,34450000,2,20006,5003,1,511600000,511600000,7501,2500,5001,2500,0,1,2502,16695209,16.695209
6500,5300,2500,34450000,2,20006,5003,1,511600000,511600000,7501,2500,5001,2500,0,1,2502,16284710,16.28471
6500,5300,2500,34450000,2,20006,5003,1,511600000,511600000,7501,2500,5001,2500,0,1,2502,16519100,16.5191
6500,5300,2500,34450000,2,20006,5003,1,511600000,511600000,7501,2500,5001,2500,0,1,2502,16224614,16.224614
6500,5300,2500,34450000,2,20006,5003,1,511600000,511600000,7501,2500,5001,2500,0,1,2502,16662180,16.66218
6500,5300,2900,34450000,2,23206,5803,1,549360000,549360000,8701,2900,5801,2900,0,1,2902,18933417,18.933417
6500,5300,2900,34450000,2,23206,5803,1,549360000,549360000,8701,2900,5801,2900,0,1,2902,19580515,19.580515
6500,5300,2900,34450000,2,23206,5803,1,549360000,549360000,8701,2900,5801,2900,0,1,2902,18577824,18.577824
6500,5300,2900,34450000,2,23206,5803,1,549360000,549360000,8701,2900,5801,2900,0,1,2902,19328875,19.328875
6500,5300,2900,34450000,2,23206,5803,1,549360000,549360000,8701,2900,5801,2900,0,1,2902,18787727,18.787727
6500,5300,2900,34450000,2,23206,5803,1,549360000,549360000,8701,2900,5801,2900,0,1,2902,19108549,19.108549
6500,5300,2900,34450000,2,23206,5803,1,549360000,549360000,8701,2900,5801,2900,0,1,2902,18730789,18.730789
6500,5300,2900,34450000,2,23206,5803,1,549360000,549360000,8701,2900,5801,2900,0,1,2902,19276386,19.276386
6500,5300,3300,34450000,2,26406,6603,1,587120000,587120000,9901,3300,6601,3300,0,1,3302,21535031,21.535031
6500,5300,3300,34450000,2,26406,6603,1,587120000,587120000,9901,3300,6601,3300,0,1,3302,22227705,22.227705
6500,5300,3300,34450000,2,26406,6603,1,587120000,587120000,9901,3300,6601,3300,0,1,3302,21058189,21.058189
6500,5300,3300,34450000,2,26406,6603,1,587120000,587120000,9901,3300,6601,3300,0,1,3302,21939554,21.939554
6500,5300,3300,34450000,2,26406,6603,1,587120000,587120000,9901,3300,6601,3300,0,1,3302,21338038,21.338038
6500,5300,3300,34450000,2,26406,6603,1,587120000,587120000,9901,3300,6601,3300,0,1,3302,21683132,21.683132
6500,5300,3300,34450000,2,26406,6603,1,587120000,587120000,9901,3300,6601,3300,0,1,3302,21314764,21.314764
6500,5300,3300,34450000,2,26406,6603,1,587120000,587120000,9901,3300,6601,3300,0,1,3302,21914598,21.914598
6500,5300,3700,34450000,2,29606,7403,1,624880000,624880000,11101,3700,7401,3700,0,1,3702,24075272,24.075272
6500,5300,3700,34450000,2,29606,7403,1,624880000,624880000,11101,3700,7401,3700,0,1,3702,24854809,24.854809
6500,5300,3700,34450000,2,29606,7403,1,624880000,624880000,11101,3700,7401,3700,0,1,3702,23569639,23.569639
6500,5300,3700,34450000,2,29606,7403,1,624880000,624880000,11101,3700,7401,3700,0,1,3702,24592059,24.592059
6500,5300,3700,34450000,2,29606,7403,1,624880000,624880000,11101,3700,7401,3700,0,1,3702,23873881,23.873881
6500,5300,3700,34450000,2,29606,7403,1,624880000,624880000,11101,3700,7401,3700,0,1,3702,24303774,24.303774
6500,5300,3700,34450000,2,29606,7403,1,624880000,624880000,11101,3700,7401,3700,0,1,3702,23836859,23.836859
6500,5300,3700,34450000,2,29606,7403,1,624880000,624880000,11101,3700,7401,3700,0,1,3702,24482570,24.48257
6500,5300,4100,34450000,2,32806,8203,1,662640000,662640000,12301,4100,8201,4100,0,1,4102,26603872,26.603872
6500,5300,4100,34450000,2,32806,8203,1,662640000,662640000,12301,4100,8201,4100,0,1,4102,27595403,27.595403
6500,5300,4100,34450000,2,32806,8203,1,662640000,662640000,12301,4100,8201,4100,0,1,4102,26129567,26.129567
6500,5300,4100,34450000,2,32806,8203,1,662640000,662640000,12301,4100,8201,4100,0,1,4102,27148730,27.14873
6500,5300,4100,34450000,2,32806,8203,1,662640000,662640000,12301,4100,8201,4100,0,1,4102,26382361,26.382361
6500,5300,4100,34450000,2,32806,8203,1,662640000,662640000,12301,4100,8201,4100,0,1,4102,26837609,26.837609
6500,5300,4100,34450000,2,32806,8203,1,662640000,662640000,12301,4100,8201,4100,0,1,4102,26405500,26.4055
6500,5300,4100,34450000,2,32806,8203,1,662640000,662640000,12301,4100,8201,4100,0,1,4102,27188070,27.18807
6500,5300,4500,34450000,2,36006,9003,1,700400000,700400000,13501,4500,9001,4500,0,1,4502,29198784,29.198784
6500,5300,4500,34450000,2,36006,9003,1,700400000,700400000,13501,4500,9001,4500,0,1,4502,30261286,30.261286
6500,5300,4500,34450000,2,36006,9003,1,700400000,700400000,13501,4500,9001,4500,0,1,4502,28614075,28.614075
6500,5300,4500,34450000,2,36006,9003,1,700400000,700400000,13501,4500,9001,4500,0,1,4502,29757639,29.757639
6500,5300,4500,34450000,2,36006,9003,1,700400000,700400000,13501,4500,9001,4500,0,1,4502,28954343,28.954343
6500,5300,4500,34450000,2,36006,9003,1,700400000,700400000,13501,4500,9001,4500,0,1,4502,29453020,29.45302
6500,5300,4500,34450000,2,36006,9003,1,700400000,700400000,13501,4500,9001,4500,0,1,4502,28914429,28.914429
6500,5300,4500,34450000,2,36006,9003,1,700400000,700400000,13501,4500,9001,4500,0,1,4502,29780396,29.780396
6500,5300,4900,34450000,2,39206,9803,1,738160000,738160000,14701,4900,9801,4900,0,1,4902,31762506,31.762506
6500,5300,4900,34450000,2,39206,9803,1,738160000,738160000,14701,4900,9801,4900,0,1,4902,32887652,32.887652
6500,5300,4900,34450000,2,39206,9803,1,738160000,738160000,14701,4900,9801,4900,0,1,4902,31169726,31.169726
6500,5300,4900,34450000,2,39206,9803,1,738160000,738160000,14701,4900,9801,4900,0,1,4902,32460313,32.460313
6500,5300,4900,34450000,2,39206,9803,1,738160000,738160000,14701,4900,9801,4900,0,1,4902,31414737,31.414737
6500,5300,4900,34450000,2,39206,9803,1,738160000,738160000,14701,4900,9801,4900,0,1,4902,32044278,32.044278
6500,5300,4900,34450000,2,39206,9803,1,738160000,738160000,14701,4900,9801,4900,0,1,4902,31506789,31.506789
6500,5300,4900,34450000,2,39206,9803,1,738160000,738160000,14701,4900,9801,4900,0,1,4902,32391294,32.391294
6500,5300,5300,34450000,2,42406,10603,1,775920000,775920000,15901,5300,10601,5300,0,1,5302,34319686,34.319686
6500,5300,5300,34450000,2,42406,10603,1,775920000,775920000,15901,5300,10601,5300,0,1,5302,35514538,35.514538
6500,5300,5300,34450000,2,42406,10603,1,775920000,775920000,15901,5300,10601,5300,0,1,5302,33607278,33.607278
6500,5300,5300,34450000,2,42406,10603,1,775920000,775920000,15901,5300,10601,5300,0,1,5302,35170653,35.170653
6500,5300,5300,34450000,2,42406,10603,1,775920000,775920000,15901,5300,10601,5300,0,1,5302,34008538,34.008538
6500,5300,5300,34450000,2,42406,10603,1,775920000,775920000,15901,5300,10601,5300,0,1,5302,34643305,34.643305
6500,5300,5300,34450000,2,42406,10603,1,775920000,775920000,15901,5300,10601,5300,0,1,5302,34062790,34.06279
6500,5300,5300,34450000,2,42406,10603,1,775920000,775920000,15901,5300,10601,5300,0,1,5302,34999818,34.999818
6500,5300,5700,34450000,2,45606,11403,1,813680000,813680000,17101,5700,11401,5700,0,1,5702,36907219,36.907219
6500,5300,5700,34450000,2,45606,11403,1,813680000,813680000,17101,5700,11401,5700,0,1,5702,38362796,38.362796
6500,5300,5700,34450000,2,45606,11403,1,813680000,813680000,17101,5700,11401,5700,0,1,5702,36193327,36.193327
6500,5300,5700,34450000,2,45606,11403,1,813680000,813680000,17101,5700,11401,5700,0,1,5702,37788124,37.788124
6500,5300,5700,34450000,2,45606,11403,1,813680000,813680000,17101,5700,11401,5700,0,1,5702,36569262,36.569262
6500,5300,5700,34450000,2,45606,11403,1,813680000,813680000,17101,5700,11401,5700,0,1,5702,37300125,37.300125
6500,5300,5700,34450000,2,45606,11403,1,813680000,813680000,17101,5700,11401,5700,0,1,5702,36658706,36.658706
6500,5300,5700,34450000,2,45606,11403,1,813680000,813680000,17101,5700,11401,5700,0,1,5702,37659222,37.659222
6500,5300,6100,34450000,2,48806,12203,1,851440000,851440000,18301,6100,12201,6100,0,1,6102,39490682,39.490682
6500,5300,6100,34450000,2,48806,12203,1,851440000,851440000,18301,6100,12201,6100,0,1,6102,41010053,41.010053
6500,5300,6100,34450000,2,48806,12203,1,851440000,851440000,18301,6100,12201,6100,0,1,6102,38688030,38.68803
6500,5300,6100,34450000,2,48806,12203,1,851440000,851440000,18301,6100,12201,6100,0,1,6102,40476609,40.476609
6500,5300,6100,34450000,2,48806,12203,1,851440000,851440000,18301,6100,12201,6100,0,1,6102,39172806,39.172806
6500,5300,6100,34450000,2,48806,12203,1,851440000,851440000,18301,6100,12201,6100,0,1,6102,39882920,39.88292
6500,5300,6100,34450000,2,48806,12203,1,851440000,851440000,18301,6100,12201,6100,0,1,6102,39217714,39.217714
6500,5300,6100,34450000,2,48806,12203,1,851440000,851440000,18301,6100,12201,6100,0,1,6102,40263794,40.263794
6500,5300,6500,34450000,2,52006,13003,1,889200000,889200000,19501,6500,13001,6500,0,1,6502,42116882,42.116882
6500,5300,6500,34450000,2,52006,13003,1,889200000,889200000,19501,6500,13001,6500,0,1,6502,43673457,43.673457
6500,5300,6500,34450000,2,52006,13003,1,889200000,889200000,19501,6500,13001,6500,0,1,6502,41220663,41.220663
6500,5300,6500,34450000,2,52006,13003,1,889200000,889200000,19501,6500,13001,6500,0,1,6502,43102809,43.102809
6500,5300,6500,34450000,2,52006,13003,1,889200000,889200000,19501,6500,13001,6500,0,1,6502,41709242,41.709242
6500,5300,6500,34450000,2,52006,13003,1,889200000,889200000,19501,6500,13001,6500,0,1,6502,42517311,42.517311
6500,5300,6500,34450000,2,52006,13003,1,889200000,889200000,19501,6500,13001,6500,0,1,6502,41767799,41.767799
6500,5300,6500,34450000,2,52006,13003,1,889200000,889200000,19501,6500,13001,6500,0,1,6502,42954025,42.954025
6500,5300,6900,34450000,2,55206,13803,1,926960000,926960000,20701,6900,13801,6900,0,1,6902,44677764,44.677764
6500,5300,6900,34450000,2,55206,13803,1,926960000,926960000,20701,6900,13801,6900,0,1,6902,46300030,46.30003
6500,5300,6900,34450000,2,55206,13803,1,926960000,926960000,20701,6900,13801,6900,0,1,6902,43811535,43.811535
6500,5300,6900,34450000,2,55206,13803,1,926960000,926960000,20701,6900,13801,6900,0,1,6902,45860782,45.860782
6500,5300,6900,34450000,2,55206,13803,1,926960000,926960000,20701,6900,13801,6900,0,1,6902,44331049,44.331049
6500,5300,6900,34450000,2,55206,13803,1,926960000,926960000,20701,6900,13801,6900,0,1,6902,45205022,45.205022
6500,5300,6900,34450000,2,55206,13803,1,926960000,926960000,20701,6900,13801,6900,0,1,6902,44405420,44.40542
6500,5300,6900,34450000,2,55206,13803,1,926960000,926960000,20701,6900,13801,6900,0,1,6902,45650795,45.650795
6500,4900,500,31850000,2,4006,1003,1,300400000,300400000,1501,500,1001,500,0,1,502,3398077,3.398077
6500,4900,500,31850000,2,4006,1003,1,300400000,300400000,1501,500,1001,500,0,1,502,3445055,3.445055
6500,4900,500,31850000,2,4006,1003,1,300400000,300400000,1501,500,1001,500,0,1,502,3346711,3.346711
6500,4900,500,31850000,2,4006,1003,1,300400000,300400000,1501,500,1001,500,0,1,502,3468680,3.46868
6500,4900,500,31850000,2,4006,1003,1,300400000,300400000,1501,500,1001,500,0,1,502,3303778,3.303778
6500,4900,500,31850000,2,4006,1003,1,300400000,300400000,1501,500,1001,500,0,1,502,3267256,3.267256
6500,4900,500,31850000,2,4006,1003,1,300400000,300400000,1501,500,1001,500,0,1,502,3419970,3.41997
6500,4900,500,31850000,2,4006,1003,1,300400000,300400000,1501,500,1001,500,0,1,502,3444773,3.444773
6500,4900,900,31850000,2,7206,1803,1,336880000,336880000,2701,900,1801,900,0,1,902,5621777,5.621777
6500,4900,900,31850000,2,7206,1803,1,336880000,336880000,2701,900,1801,900,0,1,902,5827897,5.827897
6500,4900,900,31850000,2,7206,1803,1,336880000,336880000,2701,900,1801,900,0,1,902,5474101,5.474101
6500,4900,900,31850000,2,7206,1803,1,336880000,336880000,2701,900,1801,900,0,1,902,5748451,5.748451
6500,4900,900,31850000,2,7206,1803,1,336880000,336880000,2701,900,1801,900,0,1,902,5581489,5.581489
6500,4900,900,31850000,2,7206,1803,1,336880000,336880000,2701,900,1801,900,0,1,902,5660729,5.660729
6500,4900,900,31850000,2,7206,1803,1,336880000,336880000,2701,900,1801,900,0,1,902,5552075,5.552075
6500,4900,900,31850000,2,7206,1803,1,336880000,336880000,2701,900,1801,900,0,1,902,5714344,5.714344
6500,4900,1300,31850000,2,10406,2603,1,373360000,373360000,3901,1300,2601,1300,0,1,1302,7941508,7.941508
6500,4900,1300,31850000,2,10406,2603,1,373360000,373360000,3901,1300,2601,1300,0,1,1302,8211960,8.21196
6500,4900,1300,31850000,2,10406,2603,1,373360000,373360000,3901,1300,2601,1300,0,1,1302,7793786,7.793786
6500,4900,1300,31850000,2,10406,2603,1,373360000,373360000,3901,1300,2601,1300,0,1,1302,8124468,8.124468
6500,4900,1300,31850000,2,10406,2603,1,373360000,373360000,3901,1300,2601,1300,0,1,1302,7893431,7.893431
6500,4900,1300,31850000,2,10406,2603,1,373360000,373360000,3901,1300,2601,1300,0,1,1302,8032658,8.032658
6500,4900,1300,31850000,2,10406,2603,1,373360000,373360000,3901,1300,2601,1300,0,1,1302,7871413,7.871413
6500,4900,1300,31850000,2,10406,2603,1,373360000,373360000,3901,1300,2601,1300,0,1,1302,8101989,8.101989
6500,4900,1700,31850000,2,13606,3403,1,409840000,409840000,5101,1700,3401,1700,0,1,1702,10451657,10.451657
6500,4900,1700,31850000,2,13606,3403,1,409840000,409840000,5101,1700,3401,1700,0,1,1702,10740551,10.740551
6500,4900,1700,31850000,2,13606,3403,1,409840000,409840000,5101,1700,3401,1700,0,1,1702,10274426,10.274426
6500,4900,1700,31850000,2,13606,3403,1,409840000,409840000,5101,1700,3401,1700,0,1,1702,10624554,10.624554
6500,4900,1700,31850000,2,13606,3403,1,409840000,409840000,5101,1700,3401,1700,0,1,1702,10390105,10.390105
6500,4900,1700,31850000,2,13606,3403,1,409840000,409840000,5101,1700,3401,1700,0,1,1702,10530719,10.530719
6500,4900,1700,31850000,2,13606,3403,1,409840000,409840000,5101,1700,3401,1700,0,1,1702,10328899,10.328899
6500,4900,1700,31850000,2,13606,3403,1,409840000,409840000,5101,1700,3401,1700,0,1,1702,10601993,10.601993
6500,4900,2100,31850000,2,16806,4203,1,446320000,446320000,6301,2100,4201,2100,0,1,2102,12820069,12.820069
6500,4900,2100,31850000,2,16806,4203,1,446320000,446320000,6301,2100,4201,2100,0,1,2102,13119619,13.119619
6500,4900,2100,31850000,2,16806,4203,1,446320000,446320000,6301,2100,4201,2100,0,1,2102,12670918,12.670918
6500,4900,2100,31850000,2,16806,4203,1,446320000,446320000,6301,2100,4201,2100,0,1,2102,13054163,13.054163
6500,4900,2100,31850000,2,16806,4203,1,446320000,446320000,6301,2100,4201,2100,0,1,2102,12727198,12.727198
6500,4900,2100,31850000,2,16806,4203,1,446320000,446320000,6301,2100,4201,2100,0,1,2102,12895189,12.895189
6500,4900,2100,31850000,2,16806,4203,1,446320000,446320000,6301,2100,4201,2100,0,1,2102,12670267,12.670267
6500,4900,2100,31850000,2,16806,4203,1,446320000,446320000,6301,2100,4201,2100,0,1,2102,13031629,13.031629
6500,4900,2500,31850000,2,20006,5003,1,482800000,482800000,7501,2500,5001,2500,0,1,2502,15029693,15.029693
6500,4900,2500,31850000,2,20006,5003,1,482800000,482800000,7501,2500,5001,2500,0,1,2502,15656223,15.656223
6500,4900,2500,31850000,2,20006,5003,1,482800000,482800000,7501,2500,5001,2500,0,1,2502,14753938,14.753938
6500,4900,2500,31850000,2,20006,5003,1,482800000,482800000,7501,2500,5001,2500,0,1,2502,15302834,15.302834
6500,4900,2500,31850000,2,20006,5003,1,482800000,482800000,7501,2500,5001,2500,0,1,2502,14903362,14.903362
6500,4900,2500,31850000,2,20006,5003,1,482800000,482800000,7501,2500,5001,2500,0,1,2502,15170616,15.170616
6500,4900,2500,31850000,2,20006,5003,1,482800000,482800000,7501,2500,5001,2500,0,1,2502,14851809,14.851809
6500,4900,2500,31850000,2,20006,5003,1,482800000,482800000,7501,2500,5001,2500,0,1,2502,15347093,15.347093
6500,4900,2900,31850000,2,23206,5803,1,519280000,519280000,8701,2900,5801,2900,0,1,2902,17548214,17.548214
6500,4900,2900,31850000,2,23206,5803,1,519280000,519280000,8701,2900,5801,2900,0,1,2902,18103226,18.103226
6500,4900,2900,31850000,2,23206,5803,1,519280000,519280000,8701,2900,5801,2900,0,1,2902,17211077,17.211077
6500,4900,2900,31850000,2,23206,5803,1,519280000,519280000,8701,2900,5801,2900,0,1,2902,17826472,17.826472
6500,4900,2900,31850000,2,23206,5803,1,519280000,519280000,8701,2900,5801,2900,0,1,2902,17388627,17.388627
6500,4900,2900,31850000,2,23206,5803,1,519280000,519280000,8701,2900,5801,2900,0,1,2902,17693912,17.693912
6500,4900,2900,31850000,2,23206,5803,1,519280000,519280000,8701,2900,5801,2900,0,1,2902,17357026,17.357026
6500,4900,2900,31850000,2,23206,5803,1,519280000,519280000,8701,2900,5801,2900,0,1,2902,17881595,17.881595
6500,4900,3300,31850000,2,26406,6603,1,555760000,555760000,9901,3300,6601,3300,0,1,3302,19939072,19.939072
6500,4900,3300,31850000,2,26406,6603,1,555760000,555760000,9901,3300,6601,3300,0,1,3302,20606345,20.606345
6500,4900,3300,31850000,2,26406,6603,1,555760000,555760000,9901,3300,6601,3300,0,1,3302,19536514,19.536514
6500,4900,3300,31850000,2,26406,6603,1,555760000,555760000,9901,3300,6601,3300,0,1,3302,20305798,20.305798
6500,4900,3300,31850000,2,26406,6603,1,555760000,555760000,9901,3300,6601,3300,0,1,3302,19723051,19.723051
6500,4900,3300,31850000,2,26406,6603,1,555760000,555760000,9901,3300,6601,3300,0,1,3302,20053933,20.053933
6500,4900,3300,31850000,2,26406,6603,1,555760000,555760000,9901,3300,6601,3300,0,1,3302,19700881,19.700881
6500,4900,3300,31850000,2,26406,6603,1,555760000,555760000,9901,3300,6601,3300,0,1,3302,20326908,20.326908
6500,4900,3700,31850000,2,29606,7403,1,592240000,592240000,11101,3700,7401,3700,0,1,3702,22246804,22.246804
6500,4900,3700,31850000,2,29606,7403,1,592240000,592240000,11101,3700,7401,3700,0,1,3702,23012836,23.012836
6500,4900,3700,31850000,2,29606,7403,1,592240000,592240000,11101,3700,7401,3700,0,1,3702,21870520,21.87052
6500,4900,3700,31850000,2,29606,7403,1,592240000,592240000,11101,3700,7401,3700,0,1,3702,22744984,22.744984
6500,4900,3700,31850000,2,29606,7403,1,592240000,592240000,11101,3700,7401,3700,0,1,3702,22079996,22.079996
6500,4900,3700,31850000,2,29606,7403,1,592240000,592240000,11101,3700,7401,3700,0,1,3702,22467835,22.467835
6500,4900,3700,31850000,2,29606,7403,1,592240000,592240000,11101,3700,7401,3700,0,1,3702,22057308,22.057308
6500,4900,3700,31850000,2,29606,7403,1,592240000,592240000,11101,3700,7401,3700,0,1,3702,22672996,22.672996
6500,4900,4100,31850000,2,32806,8203,1,628720000,628720000,12301,4100,8201,4100,0,1,4102,24589220,24.58922
6500,4900,4100,31850000,2,32806,8203,1,628720000,628720000,12301,4100,8201,4100,0,1,4102,25556751,25.556751
6500,4900,4100,31850000,2,32806,8203,1,628720000,628720000,12301,4100,8201,4100,0,1,4102,24185857,24.185857
6500,4900,4100,31850000,2,32806,8203,1,628720000,628720000,12301,4100,8201,4100,0,1,4102,25065386,25.065386
6500,4900,4100,31850000,2,32806,8203,1,628720000,628720000,12301,4100,8201,4100,0,1,4102,24405380,24.40538
6500,4900,4100,31850000,2,32806,8203,1,628720000,628720000,12301,4100,8201,4100,0,1,4102,24837814,24.837814
6500,4900,4100,31850000,2,32806,8203,1,628720000,628720000,12301,4100,8201,4100,0,1,4102,24383198,24.383198
6500,4900,4100,31850000,2,32806,8203,1,628720000,628720000,12301,4100,8201,4100,0,1,4102,25127469,25.127469
6500,4900,4500,31850000,2,36006,9003,1,665200000,665200000,13501,4500,9001,4500,0,1,4502,27004118,27.004118
6500,4900,4500,31850000,2,36006,9003,1,665200000,665200000,13501,4500,9001,4500,0,1,4502,28005547,28.005547
6500,4900,4500,31850000,2,36006,9003,1,665200000,665200000,13501,4500,9001,4500,0,1,4502,26433480,26.43348
6500,4900,4500,31850000,2,36006,9003,1,665200000,665200000,13501,4500,9001,4500,0,1,4502,27506161,27.506161
6500,4900,4500,31850000,2,36006,9003,1,665200000,665200000,13501,4500,9001,4500,0,1,4502,26738553,26.738553
6500,4900,4500,31850000,2,36006,9003,1,665200000,665200000,13501,4500,9001,4500,0,1,4502,27225902,27.225902
6500,4900,4500,31850000,2,36006,9003,1,665200000,665200000,13501,4500,9001,4500,0,1,4502,26759644,26.759644
6500,4900,4500,31850000,2,36006,9003,1,665200000,665200000,13501,4500,9001,4500,0,1,4502,27559723,27.559723
6500,4900,4900,31850000,2,39206,9803,1,701680000,701680000,14701,4900,9801,4900,0,1,4902,29369526,29.369526
6500,4900,4900,31850000,2,39206,9803,1,701680000,701680000,14701,4900,9801,4900,0,1,4902,30444282,30.444282
6500,4900,4900,31850000,2,39206,9803,1,701680000,701680000,14701,4900,9801,4900,0,1,4902,28772635,28.772635
6500,4900,4900,31850000,2,39206,9803,1,701680000,701680000,14701,4900,9801,4900,0,1,4902,29956271,29.956271
6500,4900,4900,31850000,2,39206,9803,1,701680000,701680000,14701,4900,9801,4900,0,1,4902,29071547,29.071547
6500,4900,4900,31850000,2,39206,9803,1,701680000,701680000,14701,4900,9801,4900,0,1,4902,29551243,29.551243
6500,4900,4900,31850000,2,39206,9803,1,701680000,701680000,14701,4900,9801,4900,0,1,4902,29093022,29.093022
6500,4900,4900,31850000,2,39206,9803,1,701680000,701680000,14701,4900,9801,4900,0,1,4902,29996832,29.996832
6500,4900,5300,31850000,2,42406,10603,1,738160000,738160000,15901,5300,10601,5300,0,1,5302,31778444,31.778444
6500,4900,5300,31850000,2,42406,10603,1,738160000,738160000,15901,5300,10601,5300,0,1,5302,32948142,32.948142
6500,4900,5300,31850000,2,42406,10603,1,738160000,738160000,15901,5300,10601,5300,0,1,5302,31156388,31.156388
6500,4900,5300,31850000,2,42406,10603,1,738160000,738160000,15901,5300,10601,5300,0,1,5302,32423525,32.423525
6500,4900,5300,31850000,2,42406,10603,1,738160000,738160000,15901,5300,10601,5300,0,1,5302,31444872,31.444872
6500,4900,5300,31850000,2,42406,10603,1,738160000,738160000,15901,5300,10601,5300,0,1,5302,32052858,32.052858
6500,4900,5300,31850000,2,42406,10603,1,738160000,738160000,15901,5300,10601,5300,0,1,5302,31497958,31.497958
6500,4900,5300,31850000,2,42406,10603,1,738160000,738160000,15901,5300,10601,5300,0,1,5302,32444149,32.444149
6500,4900,5700,31850000,2,45606,11403,1,774640000,774640000,17101,5700,11401,5700,0,1,5702,34152674,34.152674
6500,4900,5700,31850000,2,45606,11403,1,774640000,774640000,17101,5700,11401,5700,0,1,5702,35418725,35.418725
6500,4900,5700,31850000,2,45606,11403,1,774640000,774640000,17101,5700,11401,5700,0,1,5702,33484118,33.484118
6500,4900,5700,31850000,2,45606,11403,1,774640000,774640000,17101,5700,11401,5700,0,1,5702,34923892,34.923892
6500,4900,5700,31850000,2,45606,11403,1,774640000,774640000,17101,5700,11401,5700,0,1,5702,33779469,33.779469
6500,4900,5700,31850000,2,45606,11403,1,774640000,774640000,17101,5700,11401,5700,0,1,5702,34380922,34.380922
6500,4900,5700,31850000,2,45606,11403,1,774640000,774640000,17101,5700,11401,5700,0,1,5702,33848657,33.848657
6500,4900,5700,31850000,2,45606,11403,1,774640000,774640000,17101,5700,11401,5700,0,1,5702,34877083,34.877083
6500,4900,6100,31850000,2,48806,12203,1,811120000,811120000,18301,6100,12201,6100,0,1,6102,36558268,36.558268
6500,4900,6100,31850000,2,48806,12203,1,811120000,811120000,18301,6100,12201,6100,0,1,6102,37917921,37.917921
6500,4900,6100,31850000,2,48806,12203,1,811120000,811120000,18301,6100,12201,6100,0,1,6102,35797658,35.797658
6500,4900,6100,31850000,2,48806,12203,1,811120000,811120000,18301,6100,12201,6100,0,1,6102,37368826,37.368826
6500,4900,6100,31850000,2,48806,12203,1,811120000,811120000,18301,6100,12201,6100,0,1,6102,36156157,36.156157
6500,4900,6100,31850000,2,48806,12203,1,811120000,811120000,18301,6100,12201,6100,0,1,6102,36851898,36.851898
6500,4900,6100,31850000,2,48806,12203,1,811120000,811120000,18301,6100,12201,6100,0,1,6102,36221230,36.22123
6500,4900,6100,31850000,2,48806,12203,1,811120000,811120000,18301,6100,12201,6100,0,1,6102,37323776,37.323776
6500,4900,6500,31850000,2,52006,13003,1,847600000,847600000,19501,6500,13001,6500,0,1,6502,38900225,38.900225
6500,4900,6500,31850000,2,52006,13003,1,847600000,847600000,19501,6500,13001,6500,0,1,6502,40380830,40.38083
6500,4900,6500,31850000,2,52006,13003,1,847600000,847600000,19501,6500,13001,6500,0,1,6502,38137671,38.137671
6500,4900,6500,31850000,2,52006,13003,1,847600000,847600000,19501,6500,13001,6500,0,1,6502,39789304,39.789304
6500,4900,6500,31850000,2,52006,13003,1,847600000,847600000,19501,6500,13001,6500,0,1,6502,38534659,38.534659
6500,4900,6500,31850000,2,52006,13003,1,847600000,847600000,19501,6500,13001,6500,0,1,6502,39248634,39.248634
6500,4900,6500,31850000,2,52006,13003,1,847600000,847600000,19501,6500,13001,6500,0,1,6502,38615035,38.615035
6500,4900,6500,31850000,2,52006,13003,1,847600000,847600000,19501,6500,13001,6500,0,1,6502,39711035,39.711035
6500,4900,6900,31850000,2,55206,13803,1,884080000,884080000,20701,6900,13801,6900,0,1,6902,41289813,41.289813
6500,4900,6900,31850000,2,55206,13803,1,884080000,884080000,20701,6900,13801,6900,0,1,6902,42875782,42.875782
6500,4900,6900,31850000,2,55206,13803,1,884080000,884080000,20701,6900,13801,6900,0,1,6902,40564530,40.56453
6500,4900,6900,31850000,2,55206,13803,1,884080000,884080000,20701,6900,13801,6900,0,1,6902,42331177,42.331177
6500,4900,6900,31850000,2,55206,13803,1,884080000,884080000,20701,6900,13801,6900,0,1,6902,40910586,40.910586
6500,4900,6900,31850000,2,55206,13803,1,884080000,884080000,20701,6900,13801,6900,0,1,6902,41679726,41.679726
6500,4900,6900,31850000,2,55206,13803,1,884080000,884080000,20701,6900,13801,6900,0,1,6902,40978192,40.978192
6500,4900,6900,31850000,2,55206,13803,1,884080000,884080000,20701,6900,13801,6900,0,1,6902,42124163,42.124163
6500,4500,500,29250000,2,4006,1003,1,278000000,278000000,1501,500,1001,500,0,1,502,3144572,3.144572
6500,4500,500,29250000,2,4006,1003,1,278000000,278000000,1501,500,1001,500,0,1,502,3187365,3.187365
6500,4500,500,29250000,2,4006,1003,1,278000000,278000000,1501,500,1001,500,0,1,502,3104840,3.10484
6500,4500,500,29250000,2,4006,1003,1,278000000,278000000,1501,500,1001,500,0,1,502,3165808,3.165808
6500,4500,500,29250000,2,4006,1003,1,278000000,278000000,1501,500,1001,500,0,1,502,3165091,3.165091
6500,4500,500,29250000,2,4006,1003,1,278000000,278000000,1501,500,1001,500,0,1,502,3066053,3.066053
6500,4500,500,29250000,2,4006,1003,1,278000000,278000000,1501,500,1001,500,0,1,502,3165472,3.165472
6500,4500,500,29250000,2,4006,1003,1,278000000,278000000,1501,500,1001,500,0,1,502,3045386,3.045386
6500,4500,900,29250000,2,7206,1803,1,313200000,313200000,2701,900,1801,900,0,1,902,5138601,5.138601
6500,4500,900,29250000,2,7206,1803,1,313200000,313200000,2701,900,1801,900,0,1,902,5310041,5.310041
6500,4500,900,29250000,2,7206,1803,1,313200000,313200000,2701,900,1801,900,0,1,902,5044725,5.044725
6500,4500,900,29250000,2,7206,1803,1,313200000,313200000,2701,900,1801,900,0,1,902,5288458,5.288458
6500,4500,900,29250000,2,7206,1803,1,313200000,313200000,2701,900,1801,900,0,1,902,5098611,5.098611
6500,4500,900,29250000,2,7206,1803,1,313200000,313200000,2701,900,1801,900,0,1,902,5186518,5.186518
6500,4500,900,29250000,2,7206,1803,1,313200000,313200000,2701,900,1801,900,0,1,902,5118373,5.118373
6500,4500,900,29250000,2,7206,1803,1,313200000,313200000,2701,900,1801,900,0,1,902,5241899,5.241899
6500,4500,1300,29250000,2,10406,2603,1,348400000,348400000,3901,1300,2601,1300,0,1,1302,7297279,7.297279
6500,4500,1300,29250000,2,10406,2603,1,348400000,348400000,3901,1300,2601,1300,0,1,1302,7553978,7.553978
6500,4500,1300,29250000,2,10406,2603,1,348400000,348400000,3901,1300,2601,1300,0,1,1302,7170990,7.17099
6500,4500,1300,29250000,2,10406,2603,1,348400000,348400000,3901,1300,2601,1300,0,1,1302,7479968,7.479968
6500,4500,1300,29250000,2,10406,2603,1,348400000,348400000,3901,1300,2601,1300,0,1,1302,7253615,7.253615
6500,4500,1300,29250000,2,10406,2603,1,348400000,348400000,3901,1300,2601,1300,0,1,1302,7368109,7.368109
6500,4500,1300,29250000,2,10406,2603,1,348400000,348400000,3901,1300,2601,1300,0,1,1302,7217178,7.217178
6500,4500,1300,29250000,2,10406,2603,1,348400000,348400000,3901,1300,2601,1300,0,1,1302,7455134,7.455134
6500,4500,1700,29250000,2,13606,3403,1,383600000,383600000,5101,1700,3401,1700,0,1,1702,9638754,9.638754
6500,4500,1700,29250000,2,13606,3403,1,383600000,383600000,5101,1700,3401,1700,0,1,1702,9934651,9.934651
6500,4500,1700,29250000,2,13606,3403,1,383600000,383600000,5101,1700,3401,1700,0,1,1702,9427704,9.427704
6500,4500,1700,29250000,2,13606,3403,1,383600000,383600000,5101,1700,3401,1700,0,1,1702,9797493,9.797493
6500,4500,1700,29250000,2,13606,3403,1,383600000,383600000,5101,1700,3401,1700,0,1,1702,9573836,9.573836
6500,4500,1700,29250000,2,13606,3403,1,383600000,383600000,5101,1700,3401,1700,0,1,1702,9659553,9.659553
6500,4500,1700,29250000,2,13606,3403,1,383600000,383600000,5101,1700,3401,1700,0,1,1702,9552457,9.552457
6500,4500,1700,29250000,2,13606,3403,1,383600000,383600000,5101,1700,3401,1700,0,1,1702,9818406,9.818406
6500,4500,2100,29250000,2,16806,4203,1,418800000,418800000,6301,2100,4201,2100,0,1,2102,11640472,11.640472
6500,4500,2100,29250000,2,16806,4203,1,418800000,418800000,6301,2100,4201,2100,0,1,2102,12029522,12.029522
6500,4500,2100,29250000,2,16806,4203,1,418800000,418800000,6301,2100,4201,2100,0,1,2102,11428160,11.42816
6500,4500,2100,29250000,2,16806,4203,1,418800000,418800000,6301,2100,4201,2100,0,1,2102,11849891,11.849891
6500,4500,2100,29250000,2,16806,4203,1,418800000,418800000,6301,2100,4201,2100,0,1,2102,11554492,11.554492
6500,4500,2100,29250000,2,16806,4203,1,418800000,418800000,6301,2100,4201,2100,0,1,2102,11731634,11.731634
6500,4500,2100,29250000,2,16806,4203,1,418800000,418800000,6301,2100,4201,2100,0,1,2102,11517463,11.517463
6500,4500,2100,29250000,2,16806,4203,1,418800000,418800000,6301,2100,4201,2100,0,1,2102,11869702,11.869702
6500,4500,2500,29250000,2,20006,5003,1,454000000,454000000,7501,2500,5001,2500,0,1,2502,13947228,13.947228
6500,4500,2500,29250000,2,20006,5003,1,454000000,454000000,7501,2500,5001,2500,0,1,2502,14376686,14.376686
6500,4500,2500,29250000,2,20006,5003,1,454000000,454000000,7501,2500,5001,2500,0,1,2502,13710963,13.710963
6500,4500,2500,29250000,2,20006,5003,1,454000000,454000000,7501,2500,5001,2500,0,1,2502,14130338,14.130338
6500,4500,2500,29250000,2,20006,5003,1,454000000,454000000,7501,2500,5001,2500,0,1,2502,13831645,13.831645
6500,4500,2500,29250000,2,20006,5003,1,454000000,454000000,7501,2500,5001,2500,0,1,2502,14031590,14.03159
6500,4500,2500,29250000,2,20006,5003,1,454000000,454000000,7501,2500,5001,2500,0,1,2502,13811666,13.811666
6500,4500,2500,29250000,2,20006,5003,1,454000000,454000000,7501,2500,5001,2500,0,1,2502,14187654,14.187654
6500,4500,2900,29250000,2,23206,5803,1,489200000,489200000,8701,2900,5801,2900,0,1,2902,16153685,16.153685
6500,4500,2900,29250000,2,23206,5803,1,489200000,489200000,8701,2900,5801,2900,0,1,2902,16665541,16.665541
6500,4500,2900,29250000,2,23206,5803,1,489200000,489200000,8701,2900,5801,2900,0,1,2902,15850265,15.850265
6500,4500,2900,29250000,2,23206,5803,1,489200000,489200000,8701,2900,5801,2900,0,1,2902,16390839,16.390839
6500,4500,2900,29250000,2,23206,5803,1,489200000,489200000,8701,2900,5801,2900,0,1,2902,15937097,15.937097
6500,4500,2900,29250000,2,23206,5803,1,489200000,489200000,8701,2900,5801,2900,0,1,2902,16225829,16.225829
6500,4500,2900,29250000,2,23206,5803,1,489200000,489200000,8701,2900,5801,2900,0,1,2902,16005193,16.005193
6500,4500,2900,29250000,2,23206,5803,1,489200000,489200000,8701,2900,5801,2900,0,1,2902,16423504,16.423504
6500,4500,3300,29250000,2,26406,6603,1,524400000,524400000,9901,3300,6601,3300,0,1,3302,18302740,18.30274
6500,4500,3300,29250000,2,26406,6603,1,524400000,524400000,9901,3300,6601,3300,0,1,3302,18893689,18.893689
6500,4500,3300,29250000,2,26406,6603,1,524400000,524400000,9901,3300,6601,3300,0,1,3302,17969007,17.969007
6500,4500,3300,29250000,2,26406,6603,1,524400000,524400000,9901,3300,6601,3300,0,1,3302,18603811,18.603811
6500,4500,3300,29250000,2,26406,6603,1,524400000,524400000,9901,3300,6601,3300,0,1,3302,18099015,18.099015
6500,4500,3300,29250000,2,26406,6603,1,524400000,524400000,9901,3300,6601,3300,0,1,3302,18457569,18.457569
6500,4500,3300,29250000,2,26406,6603,1,524400000,524400000,9901,3300,6601,3300,0,1,3302,18128769,18.128769
6500,4500,3300,29250000,2,26406,6603,1,524400000,524400000,9901,3300,6601,3300,0,1,3302,18644822,18.644822
6500,4500,3700,29250000,2,29606,7403,1,559600000,559600000,11101,3700,7401,3700,0,1,3702,20473344,20.473344
6500,4500,3700,29250000,2,29606,7403,1,559600000,559600000,11101,3700,7401,3700,0,1,3702,21201911,21.201911
6500,4500,3700,29250000,2,29606,7403,1,559600000,559600000,11101,3700,7401,3700,0,1,3702,20062619,20.062619
6500,4500,3700,29250000,2,29606,7403,1,559600000,559600000,11101,3700,7401,3700,0,1,3702,20839512,20.839512
6500,4500,3700,29250000,2,29606,7403,1,559600000,559600000,11101,3700,7401,3700,0,1,3702,20283917,20.283917
6500,4500,3700,29250000,2,29606,7403,1,559600000,559600000,11101,3700,7401,3700,0,1,3702,20596520,20.59652
6500,4500,3700,29250000,2,29606,7403,1,559600000,559600000,11101,3700,7401,3700,0,1,3702,20303643,20.303643
6500,4500,3700,29250000,2,29606,7403,1,559600000,559600000,11101,3700,7401,3700,0,1,3702,20879345,20.879345
6500,4500,4100,29250000,2,32806,8203,1,594800000,594800000,12301,4100,8201,4100,0,1,4102,22661931,22.661931
6500,4500,4100,29250000,2,32806,8203,1,594800000,594800000,12301,4100,8201,4100,0,1,4102,23430035,23.430035
6500,4500,4100,29250000,2,32806,8203,1,594800000,594800000,12301,4100,8201,4100,0,1,4102,22199687,22.199687
6500,4500,4100,29250000,2,32806,8203,1,594800000,594800000,12301,4100,8201,4100,0,1,4102,23042586,23.042586
6500,4500,4100,29250000,2,32806,8203,1,594800000,594800000,12301,4100,8201,4100,0,1,4102,22352204,22.352204
6500,4500,4100,29250000,2,32806,8203,1,594800000,594800000,12301,4100,8201,4100,0,1,4102,22799582,22.799582
6500,4500,4100,29250000,2,32806,8203,1,594800000,594800000,12301,4100,8201,4100,0,1,4102,22466618,22.466618
6500,4500,4100,29250000,2,32806,8203,1,594800000,594800000,12301,4100,8201,4100,0,1,4102,23076879,23.076879
6500,4500,4500,29250000,2,36006,9003,1,630000000,630000000,13501,4500,9001,4500,0,1,4502,24804899,24.804899
6500,4500,4500,29250000,2,36006,9003,1,630000000,630000000,13501,4500,9001,4500,0,1,4502,25666626,25.666626
6500,4500,4500,29250000,2,36006,9003,1,630000000,630000000,13501,4500,9001,4500,0,1,4502,24374855,24.374855
6500,4500,4500,29250000,2,36006,9003,1,630000000,630000000,13501,4500,9001,4500,0,1,4502,25367382,25.367382
6500,4500,4500,29250000,2,36006,9003,1,630000000,630000000,13501,4500,9001,4500,0,1,4502,24529849,24.529849
6500,4500,4500,29250000,2,36006,9003,1,630000000,630000000,13501,4500,9001,4500,0,1,4502,24973857,24.973857
6500,4500,4500,29250000,2,36006,9003,1,630000000,630000000,13501,4500,9001,4500,0,1,4502,24683370,24.68337
6500,4500,4500,29250000,2,36006,9003,1,630000000,630000000,13501,4500,9001,4500,0,1,4502,25401852,25.401852
6500,4500,4900,29250000,2,39206,9803,1,665200000,665200000,14701,4900,9801,4900,0,1,4902,27017226,27.017226
6500,4500,4900,29250000,2,39206,9803,1,665200000,665200000,14701,4900,9801,4900,0,1,4902,27970669,27.970669
6500,4500,4900,29250000,2,39206,9803,1,665200000,665200000,14701,4900,9801,4900,0,1,4902,26475892,26.475892
6500,4500,4900,29250000,2,39206,9803,1,665200000,665200000,14701,4900,9801,4900,0,1,4902,27556630,27.55663
6500,4500,4900,29250000,2,39206,9803,1,665200000,665200000,14701,4900,9801,4900,0,1,4902,26682475,26.682475
6500,4500,4900,29250000,2,39206,9803,1,665200000,665200000,14701,4900,9801,4900,0,1,4902,27251858,27.251858
6500,4500,4900,29250000,2,39206,9803,1,665200000,665200000,14701,4900,9801,4900,0,1,4902,26797073,26.797073
6500,4500,4900,29250000,2,39206,9803,1,665200000,665200000,14701,4900,9801,4900,0,1,4902,27591626,27.591626
6500,4500,5300,29250000,2,42406,10603,1,700400000,700400000,15901,5300,10601,5300,0,1,5302,29199453,29.199453
6500,4500,5300,29250000,2,42406,10603,1,700400000,700400000,15901,5300,10601,5300,0,1,5302,30281052,30.281052
6500,4500,5300,29250000,2,42406,10603,1,700400000,700400000,15901,5300,10601,5300,0,1,5302,28648541,28.648541
6500,4500,5300,29250000,2,42406,10603,1,700400000,700400000,15901,5300,10601,5300,0,1,5302,29820224,29.820224
6500,4500,5300,29250000,2,42406,10603,1,700400000,700400000,15901,5300,10601,5300,0,1,5302,28885628,28.885628
6500,4500,5300,29250000,2,42406,10603,1,700400000,700400000,15901,5300,10601,5300,0,1,5302,29394262,29.394262
6500,4500,5300,29250000,2,42406,10603,1,700400000,700400000,15901,5300,10601,5300,0,1,5302,28938014,28.938014
6500,4500,5300,29250000,2,42406,10603,1,700400000,700400000,15901,5300,10601,5300,0,1,5302,29799898,29.799898
6500,4500,5700,29250000,2,45606,11403,1,735600000,735600000,17101,5700,11401,5700,0,1,5702,31389560,31.38956
6500,4500,5700,29250000,2,45606,11403,1,735600000,735600000,17101,5700,11401,5700,0,1,5702,32473919,32.473919
6500,4500,5700,29250000,2,45606,11403,1,735600000,735600000,17101,5700,11401,5700,0,1,5702,30783131,30.783131
6500,4500,5700,29250000,2,45606,11403,1,735600000,735600000,17101,5700,11401,5700,0,1,5702,32058262,32.058262
6500,4500,5700,29250000,2,45606,11403,1,735600000,735600000,17101,5700,11401,5700,0,1,5702,31128632,31.128632
6500,4500,5700,29250000,2,45606,11403,1,735600000,735600000,17101,5700,11401,5700,0,1,5702,31607661,31.607661
6500,4500,5700,29250000,2,45606,11403,1,735600000,735600000,17101,5700,11401,5700,0,1,5702,31192681,31.192681
6500,4500,5700,29250000,2,45606,11403,1,735600000,735600000,17101,5700,11401,5700,0,1,5702,32079844,32.079844
6500,4500,6100,29250000,2,48806,12203,1,770800000,770800000,18301,6100,12201,6100,0,1,6102,33565973,33.565973
6500,4500,6100,29250000,2,48806,12203,1,770800000,770800000,18301,6100,12201,6100,0,1,6102,34768876,34.768876
6500,4500,6100,29250000,2,48806,12203,1,770800000,770800000,18301,6100,12201,6100,0,1,6102,32926401,32.926401
6500,4500,6100,29250000,2,48806,12203,1,770800000,770800000,18301,6100,12201,6100,0,1,6102,34301112,34.301112
6500,4500,6100,29250000,2,48806,12203,1,770800000,770800000,18301,6100,12201,6100,0,1,6102,33210169,33.210169
6500,4500,6100,29250000,2,48806,12203,1,770800000,770800000,18301,6100,12201,6100,0,1,6102,33822133,33.822133
6500,4500,6100,29250000,2,48806,12203,1,770800000,770800000,18301,6100,12201,6100,0,1,6102,33312974,33.312974
6500,4500,6100,29250000,2,48806,12203,1,770800000,770800000,18301,6100,12201,6100,0,1,6102,34230400,34.2304
6500,4500,6500,29250000,2,52006,13003,1,806000000,806000000,19501,6500,13001,6500,0,1,6502,35747531,35.747531
6500,4500,6500,29250000,2,52006,13003,1,806000000,806000000,19501,6500,13001,6500,0,1,6502,37038776,37.038776
6500,4500,6500,29250000,2,52006,13003,1,806000000,806000000,19501,6500,13001,6500,0,1,6502,35060358,35.060358
6500,4500,6500,29250000,2,52006,13003,1,806000000,806000000,19501,6500,13001,6500,0,1,6502,36553045,36.553045
6500,4500,6500,29250000,2,52006,13003,1,806000000,806000000,19501,6500,13001,6500,0,1,6502,35375965,35.375965
6500,4500,6500,29250000,2,52006,13003,1,806000000,806000000,19501,6500,13001,6500,0,1,6502,36038321,36.038321
6500,4500,6500,29250000,2,52006,13003,1,806000000,806000000,19501,6500,13001,6500,0,1,6502,35483700,35.4837
6500,4500,6500,29250000,2,52006,13003,1,806000000,806000000,19501,6500,13001,6500,0,1,6502,36512821,36.512821
6500,4500,6900,29250000,2,55206,13803,1,841200000,841200000,20701,6900,13801,6900,0,1,6902,37912218,37.912218
6500,4500,6900,29250000,2,55206,13803,1,841200000,841200000,20701,6900,13801,6900,0,1,6902,39322742,39.322742
6500,4500,6900,29250000,2,55206,13803,1,841200000,841200000,20701,6900,13801,6900,0,1,6902,37249428,37.249428
6500,4500,6900,29250000,2,55206,13803,1,841200000,841200000,20701,6900,13801,6900,0,1,6902,38803370,38.80337
6500,4500,6900,29250000,2,55206,13803,1,841200000,841200000,20701,6900,13801,6900,0,1,6902,37549474,37.549474
6500,4500,6900,29250000,2,55206,13803,1,841200000,841200000,20701,6900,13801,6900,0,1,6902,38268671,38.268671
6500,4500,6900,29250000,2,55206,13803,1,841200000,841200000,20701,6900,13801,6900,0,1,6902,37661429,37.661429
6500,4500,6900,29250000,2,55206,13803,1,841200000,841200000,20701,6900,13801,6900,0,1,6902,38754475,38.754475
6500,4100,500,26650000,2,4006,1003,1,255600000,255600000,1501,500,1001,500,0,1,502,2910324,2.910324
6500,4100,500,26650000,2,4006,1003,1,255600000,255600000,1501,500,1001,500,0,1,502,2824750,2.82475
6500,4100,500,26650000,2,4006,1003,1,255600000,255600000,1501,500,1001,500,0,1,502,2883198,2.883198
6500,4100,500,26650000,2,4006,1003,1,255600000,255600000,1501,500,1001,500,0,1,502,2843979,2.843979
6500,4100,500,26650000,2,4006,1003,1,255600000,255600000,1501,500,1001,500,0,1,502,2862435,2.862435
6500,4100,500,26650000,2,4006,1003,1,255600000,255600000,1501,500,1001,500,0,1,502,2743583,2.743583
6500,4100,500,26650000,2,4006,1003,1,255600000,255600000,1501,500,1001,500,0,1,502,2761796,2.761796
6500,4100,500,26650000,2,4006,1003,1,255600000,255600000,1501,500,1001,500,0,1,502,2863382,2.863382
6500,4100,900,26650000,2,7206,1803,1,289520000,289520000,2701,900,1801,900,0,1,902,4685790,4.68579
6500,4100,900,26650000,2,7206,1803,1,289520000,289520000,2701,900,1801,900,0,1,902,4842498,4.842498
6500,4100,900,26650000,2,7206,1803,1,289520000,289520000,2701,900,1801,900,0,1,902,4607046,4.607046
6500,4100,900,26650000,2,7206,1803,1,289520000,289520000,2701,900,1801,900,0,1,902,4814246,4.814246
6500,4100,900,26650000,2,7206,1803,1,289520000,289520000,2701,900,1801,900,0,1,902,4646360,4.64636
6500,4100,900,26650000,2,7206,1803,1,289520000,289520000,2701,900,1801,900,0,1,902,4724031,4.724031
6500,4100,900,26650000,2,7206,1803,1,289520000,289520000,2701,900,1801,900,0,1,902,4664359,4.664359
6500,4100,900,26650000,2,7206,1803,1,289520000,289520000,2701,900,1801,900,0,1,902,4757039,4.757039
6500,4100,1300,26650000,2,10406,2603,1,323440000,323440000,3901,1300,2601,1300,0,1,1302,6659582,6.659582
6500,4100,1300,26650000,2,10406,2603,1,323440000,323440000,3901,1300,2601,1300,0,1,1302,6893254,6.893254
6500,4100,1300,26650000,2,10406,2603,1,323440000,323440000,3901,1300,2601,1300,0,1,1302,6543622,6.543622
6500,4100,1300,26650000,2,10406,2603,1,323440000,323440000,3901,1300,2601,1300,0,1,1302,6826082,6.826082
6500,4100,1300,26650000,2,10406,2603,1,323440000,323440000,3901,1300,2601,1300,0,1,1302,6629532,6.629532
6500,4100,1300,26650000,2,10406,2603,1,323440000,323440000,3901,1300,2601,1300,0,1,1302,6713352,6.713352
6500,4100,1300,26650000,2,10406,2603,1,323440000,323440000,3901,1300,2601,1300,0,1,1302,6611045,6.611045
6500,4100,1300,26650000,2,10406,2603,1,323440000,323440000,3901,1300,2601,1300,0,1,1302,6774772,6.774772
6500,4100,1700,26650000,2,13606,3403,1,357360000,357360000,5101,1700,3401,1700,0,1,1702,8648461,8.648461
6500,4100,1700,26650000,2,13606,3403,1,357360000,357360000,5101,1700,3401,1700,0,1,1702,8941696,8.941696
6500,4100,1700,26650000,2,13606,3403,1,357360000,357360000,5101,1700,3401,1700,0,1,1702,8481324,8.481324
6500,4100,1700,26650000,2,13606,3403,1,357360000,357360000,5101,1700,3401,1700,0,1,1702,8822437,8.822437
6500,4100,1700,26650000,2,13606,3403,1,357360000,357360000,5101,1700,3401,1700,0,1,1702,8575019,8.575019
6500,4100,1700,26650000,2,13606,3403,1,357360000,357360000,5101,1700,3401,1700,0,1,1702,8714196,8.714196
6500,4100,1700,26650000,2,13606,3403,1,357360000,357360000,5101,1700,3401,1700,0,1,1702,8592814,8.592814
6500,4100,1700,26650000,2,13606,3403,1,357360000,357360000,5101,1700,3401,1700,0,1,1702,8790512,8.790512
6500,4100,2100,26650000,2,16806,4203,1,391280000,391280000,6301,2100,4201,2100,0,1,2102,10786673,10.786673
6500,4100,2100,26650000,2,16806,4203,1,391280000,391280000,6301,2100,4201,2100,0,1,2102,11106782,11.106782
6500,4100,2100,26650000,2,16806,4203,1,391280000,391280000,6301,2100,4201,2100,0,1,2102,10564011,10.564011
6500,4100,2100,26650000,2,16806,4203,1,391280000,391280000,6301,2100,4201,2100,0,1,2102,10960468,10.960468
6500,4100,2100,26650000,2,16806,4203,1,391280000,391280000,6301,2100,4201,2100,0,1,2102,10748699,10.748699
6500,4100,2100,26650000,2,16806,4203,1,391280000,391280000,6301,2100,4201,2100,0,1,2102,10814440,10.81444
6500,4100,2100,26650000,2,16806,4203,1,391280000,391280000,6301,2100,4201,2100,0,1,2102,10720510,10.72051
6500,4100,2100,26650000,2,16806,4203,1,391280000,391280000,6301,2100,4201,2100,0,1,2102,10941559,10.941559
6500,4100,2500,26650000,2,20006,5003,1,425200000,425200000,7501,2500,5001,2500,0,1,2502,12611611,12.611611
6500,4100,2500,26650000,2,20006,5003,1,425200000,425200000,7501,2500,5001,2500,0,1,2502,13071358,13.071358
6500,4100,2500,26650000,2,20006,5003,1,425200000,425200000,7501,2500,5001,2500,0,1,2502,12369613,12.369613
6500,4100,2500,26650000,2,20006,5003,1,425200000,425200000,7501,2500,5001,2500,0,1,2502,12817252,12.817252
6500,4100,2500,26650000,2,20006,5003,1,425200000,425200000,7501,2500,5001,2500,0,1,2502,12513306,12.513306
6500,4100,2500,26650000,2,20006,5003,1,425200000,425200000,7501,2500,5001,2500,0,1,2502,12717846,12.717846
6500,4100,2500,26650000,2,20006,5003,1,425200000,425200000,7501,2500,5001,2500,0,1,2502,12530859,12.530859
6500,4100,2500,26650000,2,20006,5003,1,425200000,425200000,7501,2500,5001,2500,0,1,2502,12835939,12.835939
6500,4100,2900,26650000,2,23206,5803,1,459120000,459120000,8701,2900,5801,2900,0,1,2902,14739832,14.739832
6500,4100,2900,26650000,2,23206,5803,1,459120000,459120000,8701,2900,5801,2900,0,1,2902,15209982,15.209982
6500,4100,2900,26650000,2,23206,5803,1,459120000,459120000,8701,2900,5801,2900,0,1,2902,14467484,14.467484
6500,4100,2900,26650000,2,23206,5803,1,459120000,459120000,8701,2900,5801,2900,0,1,2902,14923090,14.92309
6500,4100,2900,26650000,2,23206,5803,1,459120000,459120000,8701,2900,5801,2900,0,1,2902,14598179,14.598179
6500,4100,2900,26650000,2,23206,5803,1,459120000,459120000,8701,2900,5801,2900,0,1,2902,14818111,14.818111
6500,4100,2900,26650000,2,23206,5803,1,459120000,459120000,8701,2900,5801,2900,0,1,2902,14616177,14.616177
6500,4100,2900,26650000,2,23206,5803,1,459120000,459120000,8701,2900,5801,2900,0,1,2902,14969569,14.969569
6500,4100,3300,26650000,2,26406,6603,1,493040000,493040000,9901,3300,6601,3300,0,1,3302,16752684,16.752684
6500,4100,3300,26650000,2,26406,6603,1,493040000,493040000,9901,3300,6601,3300,0,1,3302,17316853,17.316853
6500,4100,3300,26650000,2,26406,6603,1,493040000,493040000,9901,3300,6601,3300,0,1,3302,16400796,16.400796
6500,4100,3300,26650000,2,26406,6603,1,493040000,493040000,9901,3300,6601,3300,0,1,3302,17049803,17.049803
6500,4100,3300,26650000,2,26406,6603,1,493040000,493040000,9901,3300,6601,3300,0,1,3302,16539508,16.539508
6500,4100,3300,26650000,2,26406,6603,1,493040000,493040000,9901,3300,6601,3300,0,1,3302,16804808,16.804808
6500,4100,3300,26650000,2,26406,6603,1,493040000,493040000,9901,3300,6601,3300,0,1,3302,16600084,16.600084
6500,4100,3300,26650000,2,26406,6603,1,493040000,493040000,9901,3300,6601,3300,0,1,3302,16963952,16.963952
6500,4100,3700,26650000,2,29606,7403,1,526960000,526960000,11101,3700,7401,3700,0,1,3702,18682671,18.682671
6500,4100,3700,26650000,2,29606,7403,1,526960000,526960000,11101,3700,7401,3700,0,1,3702,19293910,19.29391
6500,4100,3700,26650000,2,29606,7403,1,526960000,526960000,11101,3700,7401,3700,0,1,3702,18362547,18.362547
6500,4100,3700,26650000,2,29606,7403,1,526960000,526960000,11101,3700,7401,3700,0,1,3702,18983645,18.983645
6500,4100,3700,26650000,2,29606,7403,1,526960000,526960000,11101,3700,7401,3700,0,1,3702,18515366,18.515366
6500,4100,3700,26650000,2,29606,7403,1,526960000,526960000,11101,3700,7401,3700,0,1,3702,18790753,18.790753
6500,4100,3700,26650000,2,29606,7403,1,526960000,526960000,11101,3700,7401,3700,0,1,3702,18533744,18.533744
6500,4100,3700,26650000,2,29606,7403,1,526960000,526960000,11101,3700,7401,3700,0,1,3702,19003787,19.003787
6500,4100,4100,26650000,2,32806,8203,1,560880000,560880000,12301,4100,8201,4100,0,1,4102,20670408,20.670408
6500,4100,4100,26650000,2,32806,8203,1,560880000,560880000,12301,4100,8201,4100,0,1,4102,21379208,21.379208
6500,4100,4100,26650000,2,32806,8203,1,560880000,560880000,12301,4100,8201,4100,0,1,4102,20287869,20.287869
6500,4100,4100,26650000,2,32806,8203,1,560880000,560880000,12301,4100,8201,4100,0,1,4102,20988538,20.988538
6500,4100,4100,26650000,2,32806,8203,1,560880000,560880000,12301,4100,8201,4100,0,1,4102,20436614,20.436614
6500,4100,4100,26650000,2,32806,8203,1,560880000,560880000,12301,4100,8201,4100,0,1,4102,20763701,20.763701
6500,4100,4100,26650000,2,32806,8203,1,560880000,560880000,12301,4100,8201,4100,0,1,4102,20468194,20.468194
6500,4100,4100,26650000,2,32806,8203,1,560880000,560880000,12301,4100,8201,4100,0,1,4102,21020939,21.020939
6500,4100,4500,26650000,2,36006,9003,1,594800000,594800000,13501,4500,9001,4500,0,1,4502,22646144,22.646144
6500,4100,4500,26650000,2,36006,9003,1,594800000,594800000,13501,4500,9001,4500,0,1,4502,23437903,23.437903
6500,4100,4500,26650000,2,36006,9003,1,594800000,594800000,13501,4500,9001,4500,0,1,4502,22213541,22.213541
6500,4100,4500,26650000,2,36006,9003,1,594800000,594800000,13501,4500,9001,4500,0,1,4502,23006086,23.006086
6500,4100,4500,26650000,2,36006,9003,1,594800000,594800000,13501,4500,9001,4500,0,1,4502,22405313,22.405313
6500,4100,4500,26650000,2,36006,9003,1,594800000,594800000,13501,4500,9001,4500,0,1,4502,22764806,22.764806
6500,4100,4500,26650000,2,36006,9003,1,594800000,594800000,13501,4500,9001,4500,0,1,4502,22465182,22.465182
6500,4100,4500,26650000,2,36006,9003,1,594800000,594800000,13501,4500,9001,4500,0,1,4502,23036543,23.036543
6500,4100,4900,26650000,2,39206,9803,1,628720000,628720000,14701,4900,9801,4900,0,1,4902,24691504,24.691504
6500,4100,4900,26650000,2,39206,9803,1,628720000,628720000,14701,4900,9801,4900,0,1,4902,25495472,25.495472
6500,4100,4900,26650000,2,39206,9803,1,628720000,628720000,14701,4900,9801,4900,0,1,4902,24169500,24.1695
6500,4100,4900,26650000,2,39206,9803,1,628720000,628720000,14701,4900,9801,4900,0,1,4902,25077164,25.077164
6500,4100,4900,26650000,2,39206,9803,1,628720000,628720000,14701,4900,9801,4900,0,1,4902,24372610,24.37261
6500,4100,4900,26650000,2,39206,9803,1,628720000,628720000,14701,4900,9801,4900,0,1,4902,24846874,24.846874
6500,4100,4900,26650000,2,39206,9803,1,628720000,628720000,14701,4900,9801,4900,0,1,4902,24440880,24.44088
6500,4100,4900,26650000,2,39206,9803,1,628720000,628720000,14701,4900,9801,4900,0,1,4902,25130345,25.130345
6500,4100,5300,26650000,2,42406,10603,1,662640000,662640000,15901,5300,10601,5300,0,1,5302,26751436,26.751436
6500,4100,5300,26650000,2,42406,10603,1,662640000,662640000,15901,5300,10601,5300,0,1,5302,27594971,27.594971
6500,4100,5300,26650000,2,42406,10603,1,662640000,662640000,15901,5300,10601,5300,0,1,5302,26154151,26.154151
6500,4100,5300,26650000,2,42406,10603,1,662640000,662640000,15901,5300,10601,5300,0,1,5302,27204621,27.204621
6500,4100,5300,26650000,2,42406,10603,1,662640000,662640000,15901,5300,10601,5300,0,1,5302,26387352,26.387352
6500,4100,5300,26650000,2,42406,10603,1,662640000,662640000,15901,5300,10601,5300,0,1,5302,26838730,26.83873
6500,4100,5300,26650000,2,42406,10603,1,662640000,662640000,15901,5300,10601,5300,0,1,5302,26514279,26.514279
6500,4100,5300,26650000,2,42406,10603,1,662640000,662640000,15901,5300,10601,5300,0,1,5302,27282855,27.282855
6500,4100,5700,26650000,2,45606,11403,1,696560000,696560000,17101,5700,11401,5700,0,1,5702,28715400,28.7154
6500,4100,5700,26650000,2,45606,11403,1,696560000,696560000,17101,5700,11401,5700,0,1,5702,29691087,29.691087
6500,4100,5700,26650000,2,45606,11403,1,696560000,696560000,17101,5700,11401,5700,0,1,5702,28055918,28.055918
6500,4100,5700,26650000,2,45606,11403,1,696560000,696560000,17101,5700,11401,5700,0,1,5702,29206200,29.2062
6500,4100,5700,26650000,2,45606,11403,1,696560000,696560000,17101,5700,11401,5700,0,1,5702,28375919,28.375919
6500,4100,5700,26650000,2,45606,11403,1,696560000,696560000,17101,5700,11401,5700,0,1,5702,28844506,28.844506
6500,4100,5700,26650000,2,45606,11403,1,696560000,696560000,17101,5700,11401,5700,0,1,5702,28422395,28.422395
6500,4100,5700,26650000,2,45606,11403,1,696560000,696560000,17101,5700,11401,5700,0,1,5702,29281677,29.281677
6500,4100,6100,26650000,2,48806,12203,1,730480000,730480000,18301,6100,12201,6100,0,1,6102,30673799,30.673799
6500,4100,6100,26650000,2,48806,12203,1,730480000,730480000,18301,6100,12201,6100,0,1,6102,31818592,31.818592
6500,4100,6100,26650000,2,48806,12203,1,730480000,730480000,18301,6100,12201,6100,0,1,6102,30046636,30.046636
6500,4100,6100,26650000,2,48806,12203,1,730480000,730480000,18301,6100,12201,6100,0,1,6102,31348915,31.348915
6500,4100,6100,26650000,2,48806,12203,1,730480000,730480000,18301,6100,12201,6100,0,1,6102,30412359,30.412359
6500,4100,6100,26650000,2,48806,12203,1,730480000,730480000,18301,6100,12201,6100,0,1,6102,30896793,30.896793
6500,4100,6100,26650000,2,48806,12203,1,730480000,730480000,18301,6100,12201,6100,0,1,6102,30485549,30.485549
6500,4100,6100,26650000,2,48806,12203,1,730480000,730480000,18301,6100,12201,6100,0,1,6102,31366571,31.366571
6500,4100,6500,26650000,2,52006,13003,1,764400000,764400000,19501,6500,13001,6500,0,1,6502,32651075,32.651075
6500,4100,6500,26650000,2,52006,13003,1,764400000,764400000,19501,6500,13001,6500,0,1,6502,33949974,33.949974
6500,4100,6500,26650000,2,52006,13003,1,764400000,764400000,19501,6500,13001,6500,0,1,6502,32019756,32.019756
6500,4100,6500,26650000,2,52006,13003,1,764400000,764400000,19501,6500,13001,6500,0,1,6502,33321794,33.321794
6500,4100,6500,26650000,2,52006,13003,1,764400000,764400000,19501,6500,13001,6500,0,1,6502,32385849,32.385849
6500,4100,6500,26650000,2,52006,13003,1,764400000,764400000,19501,6500,13001,6500,0,1,6502,32890250,32.89025
6500,4100,6500,26650000,2,52006,13003,1,764400000,764400000,19501,6500,13001,6500,0,1,6502,32431168,32.431168
6500,4100,6500,26650000,2,52006,13003,1,764400000,764400000,19501,6500,13001,6500,0,1,6502,33442182,33.442182
6500,4100,6900,26650000,2,55206,13803,1,798320000,798320000,20701,6900,13801,6900,0,1,6902,34773215,34.773215
6500,4100,6900,26650000,2,55206,13803,1,798320000,798320000,20701,6900,13801,6900,0,1,6902,35953788,35.953788
6500,4100,6900,26650000,2,55206,13803,1,798320000,798320000,20701,6900,13801,6900,0,1,6902,33953038,33.953038
6500,4100,6900,26650000,2,55206,13803,1,798320000,798320000,20701,6900,13801,6900,0,1,6902,35449839,35.449839
6500,4100,6900,26650000,2,55206,13803,1,798320000,798320000,20701,6900,13801,6900,0,1,6902,34267911,34.267911
6500,4100,6900,26650000,2,55206,13803,1,798320000,798320000,20701,6900,13801,6900,0,1,6902,34875347,34.875347
6500,4100,6900,26650000,2,55206,13803,1,798320000,798320000,20701,6900,13801,6900,0,1,6902,34531284,34.531284
6500,4100,6900,26650000,2,55206,13803,1,798320000,798320000,20701,6900,13801,6900,0,1,6902,35508814,35.508814
6500,3700,500,24050000,2,4006,1003,1,233200000,233200000,1501,500,1001,500,0,1,502,2593104,2.593104
6500,3700,500,24050000,2,4006,1003,1,233200000,233200000,1501,500,1001,500,0,1,502,2533239,2.533239
6500,3700,500,24050000,2,4006,1003,1,233200000,233200000,1501,500,1001,500,0,1,502,2506460,2.50646
6500,3700,500,24050000,2,4006,1003,1,233200000,233200000,1501,500,1001,500,0,1,502,2628821,2.628821
6500,3700,500,24050000,2,4006,1003,1,233200000,233200000,1501,500,1001,500,0,1,502,2592456,2.592456
6500,3700,500,24050000,2,4006,1003,1,233200000,233200000,1501,500,1001,500,0,1,502,2490146,2.490146
6500,3700,500,24050000,2,4006,1003,1,233200000,233200000,1501,500,1001,500,0,1,502,2575366,2.575366
6500,3700,500,24050000,2,4006,1003,1,233200000,233200000,1501,500,1001,500,0,1,502,2650294,2.650294
6500,3700,900,24050000,2,7206,1803,1,265840000,265840000,2701,900,1801,900,0,1,902,4276026,4.276026
6500,3700,900,24050000,2,7206,1803,1,265840000,265840000,2701,900,1801,900,0,1,902,4381008,4.381008
6500,3700,900,24050000,2,7206,1803,1,265840000,265840000,2701,900,1801,900,0,1,902,4160214,4.160214
6500,3700,900,24050000,2,7206,1803,1,265840000,265840000,2701,900,1801,900,0,1,902,4341929,4.341929
6500,3700,900,24050000,2,7206,1803,1,265840000,265840000,2701,900,1801,900,0,1,902,4207005,4.207005
6500,3700,900,24050000,2,7206,1803,1,265840000,265840000,2701,900,1801,900,0,1,902,4259440,4.25944
6500,3700,900,24050000,2,7206,1803,1,265840000,265840000,2701,900,1801,900,0,1,902,4242173,4.242173
6500,3700,900,24050000,2,7206,1803,1,265840000,265840000,2701,900,1801,900,0,1,902,4405064,4.405064
6500,3700,1300,24050000,2,10406,2603,1,298480000,298480000,3901,1300,2601,1300,0,1,1302,6028294,6.028294
6500,3700,1300,24050000,2,10406,2603,1,298480000,298480000,3901,1300,2601,1300,0,1,1302,6224256,6.224256
6500,3700,1300,24050000,2,10406,2603,1,298480000,298480000,3901,1300,2601,1300,0,1,1302,5909803,5.909803
6500,3700,1300,24050000,2,10406,2603,1,298480000,298480000,3901,1300,2601,1300,0,1,1302,6183214,6.183214
6500,3700,1300,24050000,2,10406,2603,1,298480000,298480000,3901,1300,2601,1300,0,1,1302,5967119,5.967119
6500,3700,1300,24050000,2,10406,2603,1,298480000,298480000,3901,1300,2601,1300,0,1,1302,6064665,6.064665
6500,3700,1300,24050000,2,10406,2603,1,298480000,298480000,3901,1300,2601,1300,0,1,1302,6008381,6.008381
6500,3700,1300,24050000,2,10406,2603,1,298480000,298480000,3901,1300,2601,1300,0,1,1302,6165988,6.165988
6500,3700,1700,24050000,2,13606,3403,1,331120000,331120000,5101,1700,3401,1700,0,1,1702,7800942,7.800942
6500,3700,1700,24050000,2,13606,3403,1,331120000,331120000,5101,1700,3401,1700,0,1,1702,8091485,8.091485
6500,3700,1700,24050000,2,13606,3403,1,331120000,331120000,5101,1700,3401,1700,0,1,1702,7640546,7.640546
6500,3700,1700,24050000,2,13606,3403,1,331120000,331120000,5101,1700,3401,1700,0,1,1702,7996127,7.996127
6500,3700,1700,24050000,2,13606,3403,1,331120000,331120000,5101,1700,3401,1700,0,1,1702,7733471,7.733471
6500,3700,1700,24050000,2,13606,3403,1,331120000,331120000,5101,1700,3401,1700,0,1,1702,7855189,7.855189
6500,3700,1700,24050000,2,13606,3403,1,331120000,331120000,5101,1700,3401,1700,0,1,1702,7775030,7.77503
6500,3700,1700,24050000,2,13606,3403,1,331120000,331120000,5101,1700,3401,1700,0,1,1702,7979035,7.979035
6500,3700,2100,24050000,2,16806,4203,1,363760000,363760000,6301,2100,4201,2100,0,1,2102,9731436,9.731436
6500,3700,2100,24050000,2,16806,4203,1,363760000,363760000,6301,2100,4201,2100,0,1,2102,10017895,10.017895
6500,3700,2100,24050000,2,16806,4203,1,363760000,363760000,6301,2100,4201,2100,0,1,2102,9585637,9.585637
6500,3700,2100,24050000,2,16806,4203,1,363760000,363760000,6301,2100,4201,2100,0,1,2102,9881828,9.881828
6500,3700,2100,24050000,2,16806,4203,1,363760000,363760000,6301,2100,4201,2100,0,1,2102,9669075,9.669075
6500,3700,2100,24050000,2,16806,4203,1,363760000,363760000,6301,2100,4201,2100,0,1,2102,9764142,9.764142
6500,3700,2100,24050000,2,16806,4203,1,363760000,363760000,6301,2100,4201,2100,0,1,2102,9651371,9.651371
6500,3700,2100,24050000,2,16806,4203,1,363760000,363760000,6301,2100,4201,2100,0,1,2102,9908403,9.908403
6500,3700,2500,24050000,2,20006,5003,1,396400000,396400000,7501,2500,5001,2500,0,1,2502,11401557,11.401557
6500,3700,2500,24050000,2,20006,5003,1,396400000,396400000,7501,2500,5001,2500,0,1,2502,11772704,11.772704
6500,3700,2500,24050000,2,20006,5003,1,396400000,396400000,7501,2500,5001,2500,0,1,2502,11292966,11.292966
6500,3700,2500,24050000,2,20006,5003,1,396400000,396400000,7501,2500,5001,2500,0,1,2502,11592506,11.592506
6500,3700,2500,24050000,2,20006,5003,1,396400000,396400000,7501,2500,5001,2500,0,1,2502,11383668,11.383668
6500,3700,2500,24050000,2,20006,5003,1,396400000,396400000,7501,2500,5001,2500,0,1,2502,11575363,11.575363
6500,3700,2500,24050000,2,20006,5003,1,396400000,396400000,7501,2500,5001,2500,0,1,2502,11457334,11.457334
6500,3700,2500,24050000,2,20006,5003,1,396400000,396400000,7501,2500,5001,2500,0,1,2502,11617011,11.617011
6500,3700,2900,24050000,2,23206,5803,1,429040000,429040000,8701,2900,5801,2900,0,1,2902,13307230,13.30723
6500,3700,2900,24050000,2,23206,5803,1,429040000,429040000,8701,2900,5801,2900,0,1,2902,13741215,13.741215
6500,3700,2900,24050000,2,23206,5803,1,429040000,429040000,8701,2900,5801,2900,0,1,2902,12882269,12.882269
6500,3700,2900,24050000,2,23206,5803,1,429040000,429040000,8701,2900,5801,2900,0,1,2902,13513299,13.513299
6500,3700,2900,24050000,2,23206,5803,1,429040000,429040000,8701,2900,5801,2900,0,1,2902,13031583,13.031583
6500,3700,2900,24050000,2,23206,5803,1,429040000,429040000,8701,2900,5801,2900,0,1,2902,13282762,13.282762
6500,3700,2900,24050000,2,23206,5803,1,429040000,429040000,8701,2900,5801,2900,0,1,2902,12993770,12.99377
6500,3700,2900,24050000,2,23206,5803,1,429040000,429040000,8701,2900,5801,2900,0,1,2902,13567043,13.567043
6500,3700,3300,24050000,2,26406,6603,1,461680000,461680000,9901,3300,6601,3300,0,1,3302,15104119,15.104119
6500,3700,3300,24050000,2,26406,6603,1,461680000,461680000,9901,3300,6601,3300,0,1,3302,15559017,15.559017
6500,3700,3300,24050000,2,26406,6603,1,461680000,461680000,9901,3300,6601,3300,0,1,3302,14798885,14.798885
6500,3700,3300,24050000,2,26406,6603,1,461680000,461680000,9901,3300,6601,3300,0,1,3302,15307385,15.307385
6500,3700,3300,24050000,2,26406,6603,1,461680000,461680000,9901,3300,6601,3300,0,1,3302,14981187,14.981187
6500,3700,3300,24050000,2,26406,6603,1,461680000,461680000,9901,3300,6601,3300,0,1,3302,15205134,15.205134
6500,3700,3300,24050000,2,26406,6603,1,461680000,461680000,9901,3300,6601,3300,0,1,3302,14944546,14.944546
6500,3700,3300,24050000,2,26406,6603,1,461680000,461680000,9901,3300,6601,3300,0,1,3302,15355626,15.355626
6500,3700,3700,24050000,2,29606,7403,1,494320000,494320000,11101,3700,7401,3700,0,1,3702,16893210,16.89321
6500,3700,3700,24050000,2,29606,7403,1,494320000,494320000,11101,3700,7401,3700,0,1,3702,17444514,17.444514
6500,3700,3700,24050000,2,29606,7403,1,494320000,494320000,11101,3700,7401,3700,0,1,3702,16550074,16.550074
6500,3700,3700,24050000,2,29606,7403,1,494320000,494320000,11101,3700,7401,3700,0,1,3702,17196054,17.196054
6500,3700,3700,24050000,2,29606,7403,1,494320000,494320000,11101,3700,7401,3700,0,1,3702,16724231,16.724231
6500,3700,3700,24050000,2,29606,7403,1,494320000,494320000,11101,3700,7401,3700,0,1,3702,17008294,17.008294
6500,3700,3700,24050000,2,29606,7403,1,494320000,494320000,11101,3700,7401,3700,0,1,3702,16695127,16.695127
6500,3700,3700,24050000,2,29606,7403,1,494320000,494320000,11101,3700,7401,3700,0,1,3702,17222227,17.222227
6500,3700,4100,24050000,2,32806,8203,1,526960000,526960000,12301,4100,8201,4100,0,1,4102,18690971,18.690971
6500,3700,4100,24050000,2,32806,8203,1,526960000,526960000,12301,4100,8201,4100,0,1,4102,19298808,19.298808
6500,3700,4100,24050000,2,32806,8203,1,526960000,526960000,12301,4100,8201,4100,0,1,4102,18269694,18.269694
6500,3700,4100,24050000,2,32806,8203,1,526960000,526960000,12301,4100,8201,4100,0,1,4102,18957120,18.95712
6500,3700,4100,24050000,2,32806,8203,1,526960000,526960000,12301,4100,8201,4100,0,1,4102,18486033,18.486033
6500,3700,4100,24050000,2,32806,8203,1,526960000,526960000,12301,4100,8201,4100,0,1,4102,18818249,18.818249
6500,3700,4100,24050000,2,32806,8203,1,526960000,526960000,12301,4100,8201,4100,0,1,4102,18530645,18.530645
6500,3700,4100,24050000,2,32806,8203,1,526960000,526960000,12301,4100,8201,4100,0,1,4102,19006486,19.006486
6500,3700,4500,24050000,2,36006,9003,1,559600000,559600000,13501,4500,9001,4500,0,1,4502,20492633,20.492633
6500,3700,4500,24050000,2,36006,9003,1,559600000,559600000,13501,4500,9001,4500,0,1,4502,21191658,21.191658
6500,3700,4500,24050000,2,36006,9003,1,559600000,559600000,13501,4500,9001,4500,0,1,4502,20057466,20.057466
6500,3700,4500,24050000,2,36006,9003,1,559600000,559600000,13501,4500,9001,4500,0,1,4502,20906974,20.906974
6500,3700,4500,24050000,2,36006,9003,1,559600000,559600000,13501,4500,9001,4500,0,1,4502,20287415,20.287415
6500,3700,4500,24050000,2,36006,9003,1,559600000,559600000,13501,4500,9001,4500,0,1,4502,20627161,20.627161
6500,3700,4500,24050000,2,36006,9003,1,559600000,559600000,13501,4500,9001,4500,0,1,4502,20241227,20.241227
6500,3700,4500,24050000,2,36006,9003,1,559600000,559600000,13501,4500,9001,4500,0,1,4502,20862777,20.862777
6500,3700,4900,24050000,2,39206,9803,1,592240000,592240000,14701,4900,9801,4900,0,1,4902,22269827,22.269827
6500,3700,4900,24050000,2,39206,9803,1,592240000,592240000,14701,4900,9801,4900,0,1,4902,23070473,23.070473
6500,3700,4900,24050000,2,39206,9803,1,592240000,592240000,14701,4900,9801,4900,0,1,4902,21834312,21.834312
6500,3700,4900,24050000,2,39206,9803,1,592240000,592240000,14701,4900,9801,4900,0,1,4902,22638037,22.638037
6500,3700,4900,24050000,2,39206,9803,1,592240000,592240000,14701,4900,9801,4900,0,1,4902,22101824,22.101824
6500,3700,4900,24050000,2,39206,9803,1,592240000,592240000,14701,4900,9801,4900,0,1,4902,22450724,22.450724
6500,3700,4900,24050000,2,39206,9803,1,592240000,592240000,14701,4900,9801,4900,0,1,4902,22026095,22.026095
6500,3700,4900,24050000,2,39206,9803,1,592240000,592240000,14701,4900,9801,4900,0,1,4902,22745093,22.745093
6500,3700,5300,24050000,2,42406,10603,1,624880000,624880000,15901,5300,10601,5300,0,1,5302,24060768,24.060768
6500,3700,5300,24050000,2,42406,10603,1,624880000,624880000,15901,5300,10601,5300,0,1,5302,24865350,24.86535
6500,3700,5300,24050000,2,42406,10603,1,624880000,624880000,15901,5300,10601,5300,0,1,5302,23557638,23.557638
6500,3700,5300,24050000,2,42406,10603,1,624880000,624880000,15901,5300,10601,5300,0,1,5302,24549973,24.549973
6500,3700,5300,24050000,2,42406,10603,1,624880000,624880000,15901,5300,10601,5300,0,1,5302,23807194,23.807194
6500,3700,5300,24050000,2,42406,10603,1,624880000,624880000,15901,5300,10601,5300,0,1,5302,24227771,24.227771
6500,3700,5300,24050000,2,42406,10603,1,624880000,624880000,15901,5300,10601,5300,0,1,5302,23824760,23.82476
6500,3700,5300,24050000,2,42406,10603,1,624880000,624880000,15901,5300,10601,5300,0,1,5302,24507791,24.507791
6500,3700,5700,24050000,2,45606,11403,1,657520000,657520000,17101,5700,11401,5700,0,1,5702,25871050,25.87105
6500,3700,5700,24050000,2,45606,11403,1,657520000,657520000,17101,5700,11401,5700,0,1,5702,26729236,26.729236
6500,3700,5700,24050000,2,45606,11403,1,657520000,657520000,17101,5700,11401,5700,0,1,5702,25346354,25.346354
6500,3700,5700,24050000,2,45606,11403,1,657520000,657520000,17101,5700,11401,5700,0,1,5702,26371313,26.371313
6500,3700,5700,24050000,2,45606,11403,1,657520000,657520000,17101,5700,11401,5700,0,1,5702,25596410,25.59641
6500,3700,5700,24050000,2,45606,11403,1,657520000,657520000,17101,5700,11401,5700,0,1,5702,26072671,26.072671
6500,3700,5700,24050000,2,45606,11403,1,657520000,657520000,17101,5700,11401,5700,0,1,5702,25579412,25.579412
6500,3700,5700,24050000,2,45606,11403,1,657520000,657520000,17101,5700,11401,5700,0,1,5702,26388465,26.388465
6500,3700,6100,24050000,2,48806,12203,1,690160000,690160000,18301,6100,12201,6100,0,1,6102,27701633,27.701633
6500,3700,6100,24050000,2,48806,12203,1,690160000,690160000,18301,6100,12201,6100,0,1,6102,28617502,28.617502
6500,3700,6100,24050000,2,48806,12203,1,690160000,690160000,18301,6100,12201,6100,0,1,6102,27174977,27.174977
6500,3700,6100,24050000,2,48806,12203,1,690160000,690160000,18301,6100,12201,6100,0,1,6102,28277570,28.27757
6500,3700,6100,24050000,2,48806,12203,1,690160000,690160000,18301,6100,12201,6100,0,1,6102,27354033,27.354033
6500,3700,6100,24050000,2,48806,12203,1,690160000,690160000,18301,6100,12201,6100,0,1,6102,27854987,27.854987
6500,3700,6100,24050000,2,48806,12203,1,690160000,690160000,18301,6100,12201,6100,0,1,6102,27385972,27.385972
6500,3700,6100,24050000,2,48806,12203,1,690160000,690160000,18301,6100,12201,6100,0,1,6102,28187805,28.187805
6500,3700,6500,24050000,2,52006,13003,1,722800000,722800000,19501,6500,13001,6500,0,1,6502,29456611,29.456611
6500,3700,6500,24050000,2,52006,13003,1,722800000,722800000,19501,6500,13001,6500,0,1,6502,30524098,30.524098
6500,3700,6500,24050000,2,52006,13003,1,722800000,722800000,19501,6500,13001,6500,0,1,6502,28898466,28.898466
6500,3700,6500,24050000,2,52006,13003,1,722800000,722800000,19501,6500,13001,6500,0,1,6502,30071613,30.071613
6500,3700,6500,24050000,2,52006,13003,1,722800000,722800000,19501,6500,13001,6500,0,1,6502,29165049,29.165049
6500,3700,6500,24050000,2,52006,13003,1,722800000,722800000,19501,6500,13001,6500,0,1,6502,29738137,29.738137
6500,3700,6500,24050000,2,52006,13003,1,722800000,722800000,19501,6500,13001,6500,0,1,6502,29197606,29.197606
6500,3700,6500,24050000,2,52006,13003,1,722800000,722800000,19501,6500,13001,6500,0,1,6502,30053904,30.053904
6500,3700,6900,24050000,2,55206,13803,1,755440000,755440000,20701,6900,13801,6900,0,1,6902,31237739,31.237739
6500,3700,6900,24050000,2,55206,13803,1,755440000,755440000,20701,6900,13801,6900,0,1,6902,32364628,32.364628
6500,3700,6900,24050000,2,55206,13803,1,755440000,755440000,20701,6900,13801,6900,0,1,6902,30693092,30.693092
6500,3700,6900,24050000,2,55206,13803,1,755440000,755440000,20701,6900,13801,6900,0,1,6902,31923275,31.923275
6500,3700,6900,24050000,2,55206,13803,1,755440000,755440000,20701,6900,13801,6900,0,1,6902,30929495,30.929495
6500,3700,6900,24050000,2,55206,13803,1,755440000,755440000,20701,6900,13801,6900,0,1,6902,31553827,31.553827
6500,3700,6900,24050000,2,55206,13803,1,755440000,755440000,20701,6900,13801,6900,0,1,6902,31019983,31.019983
6500,3700,6900,24050000,2,55206,13803,1,755440000,755440000,20701,6900,13801,6900,0,1,6902,31885642,31.885642
6500,3300,500,21450000,2,4006,1003,1,210800000,210800000,1501,500,1001,500,0,1,502,2391546,2.391546
6500,3300,500,21450000,2,4006,1003,1,210800000,210800000,1501,500,1001,500,0,1,502,2249870,2.24987
6500,3300,500,21450000,2,4006,1003,1,210800000,210800000,1501,500,1001,500,0,1,502,2333507,2.333507
6500,3300,500,21450000,2,4006,1003,1,210800000,210800000,1501,500,1001,500,0,1,502,2360271,2.360271
6500,3300,500,21450000,2,4006,1003,1,210800000,210800000,1501,500,1001,500,0,1,502,2375394,2.375394
6500,3300,500,21450000,2,4006,1003,1,210800000,210800000,1501,500,1001,500,0,1,502,2292950,2.29295
6500,3300,500,21450000,2,4006,1003,1,210800000,210800000,1501,500,1001,500,0,1,502,2406369,2.406369
6500,3300,500,21450000,2,4006,1003,1,210800000,210800000,1501,500,1001,500,0,1,502,2391173,2.391173
6500,3300,900,21450000,2,7206,1803,1,242160000,242160000,2701,900,1801,900,0,1,902,3785673,3.785673
6500,3300,900,21450000,2,7206,1803,1,242160000,242160000,2701,900,1801,900,0,1,902,4021823,4.021823
6500,3300,900,21450000,2,7206,1803,1,242160000,242160000,2701,900,1801,900,0,1,902,3721453,3.721453
6500,3300,900,21450000,2,7206,1803,1,242160000,242160000,2701,900,1801,900,0,1,902,3890565,3.890565
6500,3300,900,21450000,2,7206,1803,1,242160000,242160000,2701,900,1801,900,0,1,902,3749272,3.749272
6500,3300,900,21450000,2,7206,1803,1,242160000,242160000,2701,900,1801,900,0,1,902,3804023,3.804023
6500,3300,900,21450000,2,7206,1803,1,242160000,242160000,2701,900,1801,900,0,1,902,3770813,3.770813
6500,3300,900,21450000,2,7206,1803,1,242160000,242160000,2701,900,1801,900,0,1,902,3875034,3.875034
6500,3300,1300,21450000,2,10406,2603,1,273520000,273520000,3901,1300,2601,1300,0,1,1302,5367940,5.36794
6500,3300,1300,21450000,2,10406,2603,1,273520000,273520000,3901,1300,2601,1300,0,1,1302,5547617,5.547617
6500,3300,1300,21450000,2,10406,2603,1,273520000,273520000,3901,1300,2601,1300,0,1,1302,5279471,5.279471
6500,3300,1300,21450000,2,10406,2603,1,273520000,273520000,3901,1300,2601,1300,0,1,1302,5506678,5.506678
6500,3300,1300,21450000,2,10406,2603,1,273520000,273520000,3901,1300,2601,1300,0,1,1302,5326563,5.326563
6500,3300,1300,21450000,2,10406,2603,1,273520000,273520000,3901,1300,2601,1300,0,1,1302,5412913,5.412913
6500,3300,1300,21450000,2,10406,2603,1,273520000,273520000,3901,1300,2601,1300,0,1,1302,5344226,5.344226
6500,3300,1300,21450000,2,10406,2603,1,273520000,273520000,3901,1300,2601,1300,0,1,1302,5488110,5.48811
6500,3300,1700,21450000,2,13606,3403,1,304880000,304880000,5101,1700,3401,1700,0,1,1702,6970898,6.970898
6500,3300,1700,21450000,2,13606,3403,1,304880000,304880000,5101,1700,3401,1700,0,1,1702,7195854,7.195854
6500,3300,1700,21450000,2,13606,3403,1,304880000,304880000,5101,1700,3401,1700,0,1,1702,6838781,6.838781
6500,3300,1700,21450000,2,13606,3403,1,304880000,304880000,5101,1700,3401,1700,0,1,1702,7121800,7.1218
6500,3300,1700,21450000,2,13606,3403,1,304880000,304880000,5101,1700,3401,1700,0,1,1702,6955750,6.95575
6500,3300,1700,21450000,2,13606,3403,1,304880000,304880000,5101,1700,3401,1700,0,1,1702,7023152,7.023152
6500,3300,1700,21450000,2,13606,3403,1,304880000,304880000,5101,1700,3401,1700,0,1,1702,6906831,6.906831
6500,3300,1700,21450000,2,13606,3403,1,304880000,304880000,5101,1700,3401,1700,0,1,1702,7079446,7.079446
6500,3300,2100,21450000,2,16806,4203,1,336240000,336240000,6301,2100,4201,2100,0,1,2102,8710316,8.710316
6500,3300,2100,21450000,2,16806,4203,1,336240000,336240000,6301,2100,4201,2100,0,1,2102,8973443,8.973443
6500,3300,2100,21450000,2,16806,4203,1,336240000,336240000,6301,2100,4201,2100,0,1,2102,8608242,8.608242
6500,3300,2100,21450000,2,16806,4203,1,336240000,336240000,6301,2100,4201,2100,0,1,2102,8842546,8.842546
6500,3300,2100,21450000,2,16806,4203,1,336240000,336240000,6301,2100,4201,2100,0,1,2102,8658213,8.658213
6500,3300,2100,21450000,2,16806,4203,1,336240000,336240000,6301,2100,4201,2100,0,1,2102,8742604,8.742604
6500,3300,2100,21450000,2,16806,4203,1,336240000,336240000,6301,2100,4201,2100,0,1,2102,8643175,8.643175
6500,3300,2100,21450000,2,16806,4203,1,336240000,336240000,6301,2100,4201,2100,0,1,2102,8841934,8.841934
6500,3300,2500,21450000,2,20006,5003,1,367600000,367600000,7501,2500,5001,2500,0,1,2502,10150504,10.150504
6500,3300,2500,21450000,2,20006,5003,1,367600000,367600000,7501,2500,5001,2500,0,1,2502,10501307,10.501307
6500,3300,2500,21450000,2,20006,5003,1,367600000,367600000,7501,2500,5001,2500,0,1,2502,9951896,9.951896
6500,3300,2500,21450000,2,20006,5003,1,367600000,367600000,7501,2500,5001,2500,0,1,2502,10329111,10.329111
6500,3300,2500,21450000,2,20006,5003,1,367600000,367600000,7501,2500,5001,2500,0,1,2502,10077835,10.077835
6500,3300,2500,21450000,2,20006,5003,1,367600000,367600000,7501,2500,5001,2500,0,1,2502,10227315,10.227315
6500,3300,2500,21450000,2,20006,5003,1,367600000,367600000,7501,2500,5001,2500,0,1,2502,10062799,10.062799
6500,3300,2500,21450000,2,20006,5003,1,367600000,367600000,7501,2500,5001,2500,0,1,2502,10351520,10.35152
6500,3300,2900,21450000,2,23206,5803,1,398960000,398960000,8701,2900,5801,2900,0,1,2902,11905937,11.905937
6500,3300,2900,21450000,2,23206,5803,1,398960000,398960000,8701,2900,5801,2900,0,1,2902,12238662,12.238662
6500,3300,2900,21450000,2,23206,5803,1,398960000,398960000,8701,2900,5801,2900,0,1,2902,11699226,11.699226
6500,3300,2900,21450000,2,23206,5803,1,398960000,398960000,8701,2900,5801,2900,0,1,2902,12053345,12.053345
6500,3300,2900,21450000,2,23206,5803,1,398960000,398960000,8701,2900,5801,2900,0,1,2902,11819950,11.81995
6500,3300,2900,21450000,2,23206,5803,1,398960000,398960000,8701,2900,5801,2900,0,1,2902,11984666,11.984666
6500,3300,2900,21450000,2,23206,5803,1,398960000,398960000,8701,2900,5801,2900,0,1,2902,11798593,11.798593
6500,3300,2900,21450000,2,23206,5803,1,398960000,398960000,8701,2900,5801,2900,0,1,2902,12030601,12.030601
6500,3300,3300,21450000,2,26406,6603,1,430320000,430320000,9901,3300,6601,3300,0,1,3302,13503424,13.503424
6500,3300,3300,21450000,2,26406,6603,1,430320000,430320000,9901,3300,6601,3300,0,1,3302,13890540,13.89054
6500,3300,3300,21450000,2,26406,6603,1,430320000,430320000,9901,3300,6601,3300,0,1,3302,13255797,13.255797
6500,3300,3300,21450000,2,26406,6603,1,430320000,430320000,9901,3300,6601,3300,0,1,3302,13647449,13.647449
6500,3300,3300,21450000,2,26406,6603,1,430320000,430320000,9901,3300,6601,3300,0,1,3302,13376262,13.376262
6500,3300,3300,21450000,2,26406,6603,1,430320000,430320000,9901,3300,6601,3300,0,1,3302,13584675,13.584675
6500,3300,3300,21450000,2,26406,6603,1,430320000,430320000,9901,3300,6601,3300,0,1,3302,13398374,13.398374
6500,3300,3300,21450000,2,26406,6603,1,430320000,430320000,9901,3300,6601,3300,0,1,3302,13672535,13.672535
6500,3300,3700,21450000,2,29606,7403,1,461680000,461680000,11101,3700,7401,3700,0,1,3702,15093298,15.093298
6500,3300,3700,21450000,2,29606,7403,1,461680000,461680000,11101,3700,7401,3700,0,1,3702,15574835,15.574835
6500,3300,3700,21450000,2,29606,7403,1,461680000,461680000,11101,3700,7401,3700,0,1,3702,14795866,14.795866
6500,3300,3700,21450000,2,29606,7403,1,461680000,461680000,11101,3700,7401,3700,0,1,3702,15329981,15.329981
6500,3300,3700,21450000,2,29606,7403,1,461680000,461680000,11101,3700,7401,3700,0,1,3702,14926080,14.92608
6500,3300,3700,21450000,2,29606,7403,1,461680000,461680000,11101,3700,7401,3700,0,1,3702,15169088,15.169088
6500,3300,3700,21450000,2,29606,7403,1,461680000,461680000,11101,3700,7401,3700,0,1,3702,14970416,14.970416
6500,3300,3700,21450000,2,29606,7403,1,461680000,461680000,11101,3700,7401,3700,0,1,3702,15314636,15.314636
6500,3300,4100,21450000,2,32806,8203,1,493040000,493040000,12301,4100,8201,4100,0,1,4102,16699425,16.699425
6500,3300,4100,21450000,2,32806,8203,1,493040000,493040000,12301,4100,8201,4100,0,1,4102,17215060,17.21506
6500,3300,4100,21450000,2,32806,8203,1,493040000,493040000,12301,4100,8201,4100,0,1,4102,16334437,16.334437
6500,3300,4100,21450000,2,32806,8203,1,493040000,493040000,12301,4100,8201,4100,0,1,4102,16927004,16.927004
6500,3300,4100,21450000,2,32806,8203,1,493040000,493040000,12301,4100,8201,4100,0,1,4102,16522830,16.52283
6500,3300,4100,21450000,2,32806,8203,1,493040000,493040000,12301,4100,8201,4100,0,1,4102,16739697,16.739697
6500,3300,4100,21450000,2,32806,8203,1,493040000,493040000,12301,4100,8201,4100,0,1,4102,16546618,16.546618
6500,3300,4100,21450000,2,32806,8203,1,493040000,493040000,12301,4100,8201,4100,0,1,4102,16941733,16.941733
6500,3300,4500,21450000,2,36006,9003,1,524400000,524400000,13501,4500,9001,4500,0,1,4502,18302446,18.302446
6500,3300,4500,21450000,2,36006,9003,1,524400000,524400000,13501,4500,9001,4500,0,1,4502,18881221,18.881221
6500,3300,4500,21450000,2,36006,9003,1,524400000,524400000,13501,4500,9001,4500,0,1,4502,17908351,17.908351
6500,3300,4500,21450000,2,36006,9003,1,524400000,524400000,13501,4500,9001,4500,0,1,4502,18565233,18.565233
6500,3300,4500,21450000,2,36006,9003,1,524400000,524400000,13501,4500,9001,4500,0,1,4502,18067780,18.06778
6500,3300,4500,21450000,2,36006,9003,1,524400000,524400000,13501,4500,9001,4500,0,1,4502,18378454,18.378454
6500,3300,4500,21450000,2,36006,9003,1,524400000,524400000,13501,4500,9001,4500,0,1,4502,18145376,18.145376
6500,3300,4500,21450000,2,36006,9003,1,524400000,524400000,13501,4500,9001,4500,0,1,4502,18580641,18.580641
6500,3300,4900,21450000,2,39206,9803,1,555760000,555760000,14701,4900,9801,4900,0,1,4902,19884214,19.884214
6500,3300,4900,21450000,2,39206,9803,1,555760000,555760000,14701,4900,9801,4900,0,1,4902,20571044,20.571044
6500,3300,4900,21450000,2,39206,9803,1,555760000,555760000,14701,4900,9801,4900,0,1,4902,19506791,19.506791
6500,3300,4900,21450000,2,39206,9803,1,555760000,555760000,14701,4900,9801,4900,0,1,4902,20219614,20.219614
6500,3300,4900,21450000,2,39206,9803,1,555760000,555760000,14701,4900,9801,4900,0,1,4902,19663812,19.663812
6500,3300,4900,21450000,2,39206,9803,1,555760000,555760000,14701,4900,9801,4900,0,1,4902,20031202,20.031202
6500,3300,4900,21450000,2,39206,9803,1,555760000,555760000,14701,4900,9801,4900,0,1,4902,19696173,19.696173
6500,3300,4900,21450000,2,39206,9803,1,555760000,555760000,14701,4900,9801,4900,0,1,4902,20250701,20.250701
6500,3300,5300,21450000,2,42406,10603,1,587120000,587120000,15901,5300,10601,5300,0,1,5302,21480178,21.480178
6500,3300,5300,21450000,2,42406,10603,1,587120000,587120000,15901,5300,10601,5300,0,1,5302,22248027,22.248027
6500,3300,5300,21450000,2,42406,10603,1,587120000,587120000,15901,5300,10601,5300,0,1,5302,21098216,21.098216
6500,3300,5300,21450000,2,42406,10603,1,587120000,587120000,15901,5300,10601,5300,0,1,5302,21900242,21.900242
6500,3300,5300,21450000,2,42406,10603,1,587120000,587120000,15901,5300,10601,5300,0,1,5302,21284310,21.28431
6500,3300,5300,21450000,2,42406,10603,1,587120000,587120000,15901,5300,10601,5300,0,1,5302,21674908,21.674908
6500,3300,5300,21450000,2,42406,10603,1,587120000,587120000,15901,5300,10601,5300,0,1,5302,21310829,21.310829
6500,3300,5300,21450000,2,42406,10603,1,587120000,587120000,15901,5300,10601,5300,0,1,5302,21884355,21.884355
6500,3300,5700,21450000,2,45606,11403,1,618480000,618480000,17101,5700,11401,5700,0,1,5702,23068989,23.068989
6500,3300,5700,21450000,2,45606,11403,1,618480000,618480000,17101,5700,11401,5700,0,1,5702,23905445,23.905445
6500,3300,5700,21450000,2,45606,11403,1,618480000,618480000,17101,5700,11401,5700,0,1,5702,22663024,22.663024
6500,3300,5700,21450000,2,45606,11403,1,618480000,618480000,17101,5700,11401,5700,0,1,5702,23474580,23.47458
6500,3300,5700,21450000,2,45606,11403,1,618480000,618480000,17101,5700,11401,5700,0,1,5702,22819554,22.819554
6500,3300,5700,21450000,2,45606,11403,1,618480000,618480000,17101,5700,11401,5700,0,1,5702,23260225,23.260225
6500,3300,5700,21450000,2,45606,11403,1,618480000,618480000,17101,5700,11401,5700,0,1,5702,22892605,22.892605
6500,3300,5700,21450000,2,45606,11403,1,618480000,618480000,17101,5700,11401,5700,0,1,5702,23507483,23.507483
6500,3300,6100,21450000,2,48806,12203,1,649840000,649840000,18301,6100,12201,6100,0,1,6102,24739586,24.739586
6500,3300,6100,21450000,2,48806,12203,1,649840000,649840000,18301,6100,12201,6100,0,1,6102,25530741,25.530741
6500,3300,6100,21450000,2,48806,12203,1,649840000,649840000,18301,6100,12201,6100,0,1,6102,24201477,24.201477
6500,3300,6100,21450000,2,48806,12203,1,649840000,649840000,18301,6100,12201,6100,0,1,6102,25204195,25.204195
6500,3300,6100,21450000,2,48806,12203,1,649840000,649840000,18301,6100,12201,6100,0,1,6102,24446780,24.44678
6500,3300,6100,21450000,2,48806,12203,1,649840000,649840000,18301,6100,12201,6100,0,1,6102,24909517,24.909517
6500,3300,6100,21450000,2,48806,12203,1,649840000,649840000,18301,6100,12201,6100,0,1,6102,24520792,24.520792
6500,3300,6100,21450000,2,48806,12203,1,649840000,649840000,18301,6100,12201,6100,0,1,6102,25111725,25.111725
6500,3300,6500,21450000,2,52006,13003,1,681200000,681200000,19501,6500,13001,6500,0,1,6502,26304634,26.304634
6500,3300,6500,21450000,2,52006,13003,1,681200000,681200000,19501,6500,13001,6500,0,1,6502,27230757,27.230757
6500,3300,6500,21450000,2,52006,13003,1,681200000,681200000,19501,6500,13001,6500,0,1,6502,25784956,25.784956
6500,3300,6500,21450000,2,52006,13003,1,681200000,681200000,19501,6500,13001,6500,0,1,6502,26846640,26.84664
6500,3300,6500,21450000,2,52006,13003,1,681200000,681200000,19501,6500,13001,6500,0,1,6502,26027291,26.027291
6500,3300,6500,21450000,2,52006,13003,1,681200000,681200000,19501,6500,13001,6500,0,1,6502,26466825,26.466825
6500,3300,6500,21450000,2,52006,13003,1,681200000,681200000,19501,6500,13001,6500,0,1,6502,26104718,26.104718
6500,3300,6500,21450000,2,52006,13003,1,681200000,681200000,19501,6500,13001,6500,0,1,6502,26779174,26.779174
6500,3300,6900,21450000,2,55206,13803,1,712560000,712560000,20701,6900,13801,6900,0,1,6902,27918776,27.918776
6500,3300,6900,21450000,2,55206,13803,1,712560000,712560000,20701,6900,13801,6900,0,1,6902,28859097,28.859097
6500,3300,6900,21450000,2,55206,13803,1,712560000,712560000,20701,6900,13801,6900,0,1,6902,27402521,27.402521
6500,3300,6900,21450000,2,55206,13803,1,712560000,712560000,20701,6900,13801,6900,0,1,6902,28497262,28.497262
6500,3300,6900,21450000,2,55206,13803,1,712560000,712560000,20701,6900,13801,6900,0,1,6902,27625085,27.625085
6500,3300,6900,21450000,2,55206,13803,1,712560000,712560000,20701,6900,13801,6900,0,1,6902,28127583,28.127583
6500,3300,6900,21450000,2,55206,13803,1,712560000,712560000,20701,6900,13801,6900,0,1,6902,27682743,27.682743
6500,3300,6900,21450000,2,55206,13803,1,712560000,712560000,20701,6900,13801,6900,0,1,6902,28392653,28.392653
6500,2900,500,18850000,2,4006,1003,1,188400000,188400000,1501,500,1001,500,0,1,502,2024083,2.024083
6500,2900,500,18850000,2,4006,1003,1,188400000,188400000,1501,500,1001,500,0,1,502,1986762,1.986762
6500,2900,500,18850000,2,4006,1003,1,188400000,188400000,1501,500,1001,500,0,1,502,2096951,2.096951
6500,2900,500,18850000,2,4006,1003,1,188400000,188400000,1501,500,1001,500,0,1,502,1972881,1.972881
6500,2900,500,18850000,2,4006,1003,1,188400000,188400000,1501,500,1001,500,0,1,502,1959162,1.959162
6500,2900,500,18850000,2,4006,1003,1,188400000,188400000,1501,500,1001,500,0,1,502,2048121,2.048121
6500,2900,500,18850000,2,4006,1003,1,188400000,188400000,1501,500,1001,500,0,1,502,2110008,2.110008
6500,2900,500,18850000,2,4006,1003,1,188400000,188400000,1501,500,1001,500,0,1,502,1945861,1.945861
6500,2900,900,18850000,2,7206,1803,1,218480000,218480000,2701,900,1801,900,0,1,902,3336384,3.336384
6500,2900,900,18850000,2,7206,1803,1,218480000,218480000,2701,900,1801,900,0,1,902,3536196,3.536196
6500,2900,900,18850000,2,7206,1803,1,218480000,218480000,2701,900,1801,900,0,1,902,3255942,3.255942
6500,2900,900,18850000,2,7206,1803,1,218480000,218480000,2701,900,1801,900,0,1,902,3524064,3.524064
6500,2900,900,18850000,2,7206,1803,1,218480000,218480000,2701,900,1801,900,0,1,902,3305602,3.305602
6500,2900,900,18850000,2,7206,1803,1,218480000,218480000,2701,900,1801,900,0,1,902,3350668,3.350668
6500,2900,900,18850000,2,7206,1803,1,218480000,218480000,2701,900,1801,900,0,1,902,3322692,3.322692
6500,2900,900,18850000,2,7206,1803,1,218480000,218480000,2701,900,1801,900,0,1,902,3481586,3.481586
6500,2900,1300,18850000,2,10406,2603,1,248560000,248560000,3901,1300,2601,1300,0,1,1302,4725375,4.725375
6500,2900,1300,18850000,2,10406,2603,1,248560000,248560000,3901,1300,2601,1300,0,1,1302,4877175,4.877175
6500,2900,1300,18850000,2,10406,2603,1,248560000,248560000,3901,1300,2601,1300,0,1,1302,4643198,4.643198
6500,2900,1300,18850000,2,10406,2603,1,248560000,248560000,3901,1300,2601,1300,0,1,1302,4842449,4.842449
6500,2900,1300,18850000,2,10406,2603,1,248560000,248560000,3901,1300,2601,1300,0,1,1302,4678571,4.678571
6500,2900,1300,18850000,2,10406,2603,1,248560000,248560000,3901,1300,2601,1300,0,1,1302,4754385,4.754385
6500,2900,1300,18850000,2,10406,2603,1,248560000,248560000,3901,1300,2601,1300,0,1,1302,4700475,4.700475
6500,2900,1300,18850000,2,10406,2603,1,248560000,248560000,3901,1300,2601,1300,0,1,1302,4807997,4.807997
6500,2900,1700,18850000,2,13606,3403,1,278640000,278640000,5101,1700,3401,1700,0,1,1702,6124641,6.124641
6500,2900,1700,18850000,2,13606,3403,1,278640000,278640000,5101,1700,3401,1700,0,1,1702,6329535,6.329535
6500,2900,1700,18850000,2,13606,3403,1,278640000,278640000,5101,1700,3401,1700,0,1,1702,6013179,6.013179
6500,2900,1700,18850000,2,13606,3403,1,278640000,278640000,5101,1700,3401,1700,0,1,1702,6256888,6.256888
6500,2900,1700,18850000,2,13606,3403,1,278640000,278640000,5101,1700,3401,1700,0,1,1702,6079593,6.079593
6500,2900,1700,18850000,2,13606,3403,1,278640000,278640000,5101,1700,3401,1700,0,1,1702,6169878,6.169878
6500,2900,1700,18850000,2,13606,3403,1,278640000,278640000,5101,1700,3401,1700,0,1,1702,6093412,6.093412
6500,2900,1700,18850000,2,13606,3403,1,278640000,278640000,5101,1700,3401,1700,0,1,1702,6225089,6.225089
6500,2900,2100,18850000,2,16806,4203,1,308720000,308720000,6301,2100,4201,2100,0,1,2102,7693296,7.693296
6500,2900,2100,18850000,2,16806,4203,1,308720000,308720000,6301,2100,4201,2100,0,1,2102,7781579,7.781579
6500,2900,2100,18850000,2,16806,4203,1,308720000,308720000,6301,2100,4201,2100,0,1,2102,7540945,7.540945
6500,2900,2100,18850000,2,16806,4203,1,308720000,308720000,6301,2100,4201,2100,0,1,2102,7669608,7.669608
6500,2900,2100,18850000,2,16806,4203,1,308720000,308720000,6301,2100,4201,2100,0,1,2102,7604759,7.604759
6500,2900,2100,18850000,2,16806,4203,1,308720000,308720000,6301,2100,4201,2100,0,1,2102,7705969,7.705969
6500,2900,2100,18850000,2,16806,4203,1,308720000,308720000,6301,2100,4201,2100,0,1,2102,7617643,7.617643
6500,2900,2100,18850000,2,16806,4203,1,308720000,308720000,6301,2100,4201,2100,0,1,2102,7648311,7.648311
6500,2900,2500,18850000,2,20006,5003,1,338800000,338800000,7501,2500,5001,2500,0,1,2502,8928563,8.928563
6500,2900,2500,18850000,2,20006,5003,1,338800000,338800000,7501,2500,5001,2500,0,1,2502,9328732,9.328732
6500,2900,2500,18850000,2,20006,5003,1,338800000,338800000,7501,2500,5001,2500,0,1,2502,8744637,8.744637
6500,2900,2500,18850000,2,20006,5003,1,338800000,338800000,7501,2500,5001,2500,0,1,2502,9177208,9.177208
6500,2900,2500,18850000,2,20006,5003,1,338800000,338800000,7501,2500,5001,2500,0,1,2502,8862000,8.862
6500,2900,2500,18850000,2,20006,5003,1,338800000,338800000,7501,2500,5001,2500,0,1,2502,9002879,9.002879
6500,2900,2500,18850000,2,20006,5003,1,338800000,338800000,7501,2500,5001,2500,0,1,2502,8843905,8.843905
6500,2900,2500,18850000,2,20006,5003,1,338800000,338800000,7501,2500,5001,2500,0,1,2502,9190735,9.190735
6500,2900,2900,18850000,2,23206,5803,1,368880000,368880000,8701,2900,5801,2900,0,1,2902,10507734,10.507734
6500,2900,2900,18850000,2,23206,5803,1,368880000,368880000,8701,2900,5801,2900,0,1,2902,10706376,10.706376
6500,2900,2900,18850000,2,23206,5803,1,368880000,368880000,8701,2900,5801,2900,0,1,2902,10295661,10.295661
6500,2900,2900,18850000,2,23206,5803,1,368880000,368880000,8701,2900,5801,2900,0,1,2902,10532759,10.532759
6500,2900,2900,18850000,2,23206,5803,1,368880000,368880000,8701,2900,5801,2900,0,1,2902,10397410,10.39741
6500,2900,2900,18850000,2,23206,5803,1,368880000,368880000,8701,2900,5801,2900,0,1,2902,10546679,10.546679
6500,2900,2900,18850000,2,23206,5803,1,368880000,368880000,8701,2900,5801,2900,0,1,2902,10410302,10.410302
6500,2900,2900,18850000,2,23206,5803,1,368880000,368880000,8701,2900,5801,2900,0,1,2902,10519913,10.519913
6500,2900,3300,18850000,2,26406,6603,1,398960000,398960000,9901,3300,6601,3300,0,1,3302,11733975,11.733975
6500,2900,3300,18850000,2,26406,6603,1,398960000,398960000,9901,3300,6601,3300,0,1,3302,12242822,12.242822
6500,2900,3300,18850000,2,26406,6603,1,398960000,398960000,9901,3300,6601,3300,0,1,3302,11479006,11.479006
6500,2900,3300,18850000,2,26406,6603,1,398960000,398960000,9901,3300,6601,3300,0,1,3302,12011093,12.011093
6500,2900,3300,18850000,2,26406,6603,1,398960000,398960000,9901,3300,6601,3300,0,1,3302,11644861,11.644861
6500,2900,3300,18850000,2,26406,6603,1,398960000,398960000,9901,3300,6601,3300,0,1,3302,11842368,11.842368
6500,2900,3300,18850000,2,26406,6603,1,398960000,398960000,9901,3300,6601,3300,0,1,3302,11625120,11.62512
6500,2900,3300,18850000,2,26406,6603,1,398960000,398960000,9901,3300,6601,3300,0,1,3302,12038156,12.038156
6500,2900,3700,18850000,2,29606,7403,1,429040000,429040000,11101,3700,7401,3700,0,1,3702,13282980,13.28298
6500,2900,3700,18850000,2,29606,7403,1,429040000,429040000,11101,3700,7401,3700,0,1,3702,13741750,13.74175
6500,2900,3700,18850000,2,29606,7403,1,429040000,429040000,11101,3700,7401,3700,0,1,3702,13043103,13.043103
6500,2900,3700,18850000,2,29606,7403,1,429040000,429040000,11101,3700,7401,3700,0,1,3702,13501958,13.501958
6500,2900,3700,18850000,2,29606,7403,1,429040000,429040000,11101,3700,7401,3700,0,1,3702,13161884,13.161884
6500,2900,3700,18850000,2,29606,7403,1,429040000,429040000,11101,3700,7401,3700,0,1,3702,13378526,13.378526
6500,2900,3700,18850000,2,29606,7403,1,429040000,429040000,11101,3700,7401,3700,0,1,3702,13174740,13.17474
6500,2900,3700,18850000,2,29606,7403,1,429040000,429040000,11101,3700,7401,3700,0,1,3702,13501513,13.501513
6500,2900,4100,18850000,2,32806,8203,1,459120000,459120000,12301,4100,8201,4100,0,1,4102,14720716,14.720716
6500,2900,4100,18850000,2,32806,8203,1,459120000,459120000,12301,4100,8201,4100,0,1,4102,15163618,15.163618
6500,2900,4100,18850000,2,32806,8203,1,459120000,459120000,12301,4100,8201,4100,0,1,4102,14428055,14.428055
6500,2900,4100,18850000,2,32806,8203,1,459120000,459120000,12301,4100,8201,4100,0,1,4102,14889653,14.889653
6500,2900,4100,18850000,2,32806,8203,1,459120000,459120000,12301,4100,8201,4100,0,1,4102,14529219,14.529219
6500,2900,4100,18850000,2,32806,8203,1,459120000,459120000,12301,4100,8201,4100,0,1,4102,14748961,14.748961
6500,2900,4100,18850000,2,32806,8203,1,459120000,459120000,12301,4100,8201,4100,0,1,4102,14575536,14.575536
6500,2900,4100,18850000,2,32806,8203,1,459120000,459120000,12301,4100,8201,4100,0,1,4102,14916906,14.916906
6500,2900,4500,18850000,2,36006,9003,1,489200000,489200000,13501,4500,9001,4500,0,1,4502,16143556,16.143556
6500,2900,4500,18850000,2,36006,9003,1,489200000,489200000,13501,4500,9001,4500,0,1,4502,16637881,16.637881
6500,2900,4500,18850000,2,36006,9003,1,489200000,489200000,13501,4500,9001,4500,0,1,4502,15812648,15.812648
6500,2900,4500,18850000,2,36006,9003,1,489200000,489200000,13501,4500,9001,4500,0,1,4502,16395425,16.395425
6500,2900,4500,18850000,2,36006,9003,1,489200000,489200000,13501,4500,9001,4500,0,1,4502,15896756,15.896756
6500,2900,4500,18850000,2,36006,9003,1,489200000,489200000,13501,4500,9001,4500,0,1,4502,16245800,16.2458
6500,2900,4500,18850000,2,36006,9003,1,489200000,489200000,13501,4500,9001,4500,0,1,4502,16006654,16.006654
6500,2900,4500,18850000,2,36006,9003,1,489200000,489200000,13501,4500,9001,4500,0,1,4502,16443557,16.443557
6300,7100,500,44730000,2,4006,1003,1,411440000,411440000,1501,500,1001,500,0,1,502,4697186,4.697186
6300,7100,500,44730000,2,4006,1003,1,411440000,411440000,1501,500,1001,500,0,1,502,4763539,4.763539
6300,7100,500,44730000,2,4006,1003,1,411440000,411440000,1501,500,1001,500,0,1,502,4697573,4.697573
6300,7100,500,44730000,2,4006,1003,1,411440000,411440000,1501,500,1001,500,0,1,502,4730350,4.73035
6300,7100,500,44730000,2,4006,1003,1,411440000,411440000,1501,500,1001,500,0,1,502,4698109,4.698109
6300,7100,500,44730000,2,4006,1003,1,411440000,411440000,1501,500,1001,500,0,1,502,4666428,4.666428
6300,7100,500,44730000,2,4006,1003,1,411440000,411440000,1501,500,1001,500,0,1,502,4762018,4.762018
6300,7100,900,44730000,2,7206,1803,1,454320000,454320000,2701,900,1801,900,0,1,902,7755778,7.755778
6300,7100,900,44730000,2,7206,1803,1,454320000,454320000,2701,900,1801,900,0,1,902,8110797,8.110797
6300,7100,900,44730000,2,7206,1803,1,454320000,454320000,2701,900,1801,900,0,1,902,7663873,7.663873
6300,7100,900,44730000,2,7206,1803,1,454320000,454320000,2701,900,1801,900,0,1,902,7944177,7.944177
6300,7100,900,44730000,2,7206,1803,1,454320000,454320000,2701,900,1801,900,0,1,902,7720545,7.720545
6300,7100,900,44730000,2,7206,1803,1,454320000,454320000,2701,900,1801,900,0,1,902,7786712,7.786712
6300,7100,900,44730000,2,7206,1803,1,454320000,454320000,2701,900,1801,900,0,1,902,7997205,7.997205
6300,7100,1300,44730000,2,10406,2603,1,497200000,497200000,3901,1300,2601,1300,0,1,1302,11215081,11.215081
6300,7100,1300,44730000,2,10406,2603,1,497200000,497200000,3901,1300,2601,1300,0,1,1302,11628565,11.628565
6300,7100,1300,44730000,2,10406,2603,1,497200000,497200000,3901,1300,2601,1300,0,1,1302,11034678,11.034678
6300,7100,1300,44730000,2,10406,2603,1,497200000,497200000,3901,1300,2601,1300,0,1,1302,11445521,11.445521
6300,7100,1300,44730000,2,10406,2603,1,497200000,497200000,3901,1300,2601,1300,0,1,1302,11120393,11.120393
6300,7100,1300,44730000,2,10406,2603,1,497200000,497200000,3901,1300,2601,1300,0,1,1302,11184922,11.184922
6300,7100,1300,44730000,2,10406,2603,1,497200000,497200000,3901,1300,2601,1300,0,1,1302,11475324,11.475324
6300,7100,1700,44730000,2,13606,3403,1,540080000,540080000,5101,1700,3401,1700,0,1,1702,14542750,14.54275
6300,7100,1700,44730000,2,13606,3403,1,540080000,540080000,5101,1700,3401,1700,0,1,1702,15092303,15.092303
6300,7100,1700,44730000,2,13606,3403,1,540080000,540080000,5101,1700,3401,1700,0,1,1702,14317668,14.317668
6300,7100,1700,44730000,2,13606,3403,1,540080000,540080000,5101,1700,3401,1700,0,1,1702,14821169,14.821169
6300,7100,1700,44730000,2,13606,3403,1,540080000,540080000,5101,1700,3401,1700,0,1,1702,14411145,14.411145
6300,7100,1700,44730000,2,13606,3403,1,540080000,540080000,5101,1700,3401,1700,0,1,1702,14441280,14.44128
6300,7100,1700,44730000,2,13606,3403,1,540080000,540080000,5101,1700,3401,1700,0,1,1702,14870219,14.870219
6300,7100,2100,44730000,2,16806,4203,1,582960000,582960000,6301,2100,4201,2100,0,1,2102,17947266,17.947266
6300,7100,2100,44730000,2,16806,4203,1,582960000,582960000,6301,2100,4201,2100,0,1,2102,18543117,18.543117
6300,7100,2100,44730000,2,16806,4203,1,582960000,582960000,6301,2100,4201,2100,0,1,2102,17577023,17.577023
6300,7100,2100,44730000,2,16806,4203,1,582960000,582960000,6301,2100,4201,2100,0,1,2102,18260947,18.260947
6300,7100,2100,44730000,2,16806,4203,1,582960000,582960000,6301,2100,4201,2100,0,1,2102,17818338,17.818338
6300,7100,2100,44730000,2,16806,4203,1,582960000,582960000,6301,2100,4201,2100,0,1,2102,17669362,17.669362
6300,7100,2100,44730000,2,16806,4203,1,582960000,582960000,6301,2100,4201,2100,0,1,2102,18319170,18.31917
6300,7100,2500,44730000,2,20006,5003,1,625840000,625840000,7501,2500,5001,2500,0,1,2502,21233184,21.233184
6300,7100,2500,44730000,2,20006,5003,1,625840000,625840000,7501,2500,5001,2500,0,1,2502,21930916,21.930916
6300,7100,2500,44730000,2,20006,5003,1,625840000,625840000,7501,2500,5001,2500,0,1,2502,20843597,20.843597
6300,7100,2500,44730000,2,20006,5003,1,625840000,625840000,7501,2500,5001,2500,0,1,2502,21704757,21.704757
6300,7100,2500,44730000,2,20006,5003,1,625840000,625840000,7501,2500,5001,2500,0,1,2502,21106041,21.106041
6300,7100,2500,44730000,2,20006,5003,1,625840000,625840000,7501,2500,5001,2500,0,1,2502,21064019,21.064019
6300,7100,2500,44730000,2,20006,5003,1,625840000,625840000,7501,2500,5001,2500,0,1,2502,21661798,21.661798
6300,7100,2900,44730000,2,23206,5803,1,668720000,668720000,8701,2900,5801,2900,0,1,2902,24597921,24.597921
6300,7100,2900,44730000,2,23206,5803,1,668720000,668720000,8701,2900,5801,2900,0,1,2902,25396345,25.396345
6300,7100,2900,44730000,2,23206,5803,1,668720000,668720000,8701,2900,5801,2900,0,1,2902,24089439,24.089439
6300,7100,2900,44730000,2,23206,5803,1,668720000,668720000,8701,2900,5801,2900,0,1,2902,25089375,25.089375
6300,7100,2900,44730000,2,23206,5803,1,668720000,668720000,8701,2900,5801,2900,0,1,2902,24402150,24.40215
6300,7100,2900,44730000,2,23206,5803,1,668720000,668720000,8701,2900,5801,2900,0,1,2902,24328670,24.32867
6300,7100,2900,44730000,2,23206,5803,1,668720000,668720000,8701,2900,5801,2900,0,1,2902,25058503,25.058503
6300,7100,3300,44730000,2,26406,6603,1,711600000,711600000,9901,3300,6601,3300,0,1,3302,27892520,27.89252
6300,7100,3300,44730000,2,26406,6603,1,711600000,711600000,9901,3300,6601,3300,0,1,3302,28834760,28.83476
6300,7100,3300,44730000,2,26406,6603,1,711600000,711600000,9901,3300,6601,3300,0,1,3302,27388228,27.388228
6300,7100,3300,44730000,2,26406,6603,1,711600000,711600000,9901,3300,6601,3300,0,1,3302,28508935,28.508935
6300,7100,3300,44730000,2,26406,6603,1,711600000,711600000,9901,3300,6601,3300,0,1,3302,27613459,27.613459
6300,7100,3300,44730000,2,26406,6603,1,711600000,711600000,9901,3300,6601,3300,0,1,3302,27677505,27.677505
6300,7100,3300,44730000,2,26406,6603,1,711600000,711600000,9901,3300,6601,3300,0,1,3302,28452547,28.452547
6300,7100,3700,44730000,2,29606,7403,1,754480000,754480000,11101,3700,7401,3700,0,1,3702,31194449,31.194449
6300,7100,3700,44730000,2,29606,7403,1,754480000,754480000,11101,3700,7401,3700,0,1,3702,32312782,32.312782
6300,7100,3700,44730000,2,29606,7403,1,754480000,754480000,11101,3700,7401,3700,0,1,3702,30568928,30.568928
6300,7100,3700,44730000,2,29606,7403,1,754480000,754480000,11101,3700,7401,3700,0,1,3702,31928628,31.928628
6300,7100,3700,44730000,2,29606,7403,1,754480000,754480000,11101,3700,7401,3700,0,1,3702,30858569,30.858569
6300,7100,3700,44730000,2,29606,7403,1,754480000,754480000,11101,3700,7401,3700,0,1,3702,30932764,30.932764
6300,7100,3700,44730000,2,29606,7403,1,754480000,754480000,11101,3700,7401,3700,0,1,3702,31797167,31.797167
6300,7100,4100,44730000,2,32806,8203,1,797360000,797360000,12301,4100,8201,4100,0,1,4102,34590101,34.590101
6300,7100,4100,44730000,2,32806,8203,1,797360000,797360000,12301,4100,8201,4100,0,1,4102,35817426,35.817426
6300,7100,4100,44730000,2,32806,8203,1,797360000,797360000,12301,4100,8201,4100,0,1,4102,33893319,33.893319
6300,7100,4100,44730000,2,32806,8203,1,797360000,797360000,12301,4100,8201,4100,0,1,4102,35384727,35.384727
6300,7100,4100,44730000,2,32806,8203,1,797360000,797360000,12301,4100,8201,4100,0,1,4102,34270215,34.270215
6300,7100,4100,44730000,2,32806,8203,1,797360000,797360000,12301,4100,8201,4100,0,1,4102,34325202,34.325202
6300,7100,4100,44730000,2,32806,8203,1,797360000,797360000,12301,4100,8201,4100,0,1,4102,35354742,35.354742
6300,7100,4500,44730000,2,36006,9003,1,840240000,840240000,13501,4500,9001,4500,0,1,4502,37977928,37.977928
6300,7100,4500,44730000,2,36006,9003,1,840240000,840240000,13501,4500,9001,4500,0,1,4502,39336468,39.336468
6300,7100,4500,44730000,2,36006,9003,1,840240000,840240000,13501,4500,9001,4500,0,1,4502,37141305,37.141305
6300,7100,4500,44730000,2,36006,9003,1,840240000,840240000,13501,4500,9001,4500,0,1,4502,38777511,38.777511
6300,7100,4500,44730000,2,36006,9003,1,840240000,840240000,13501,4500,9001,4500,0,1,4502,37633810,37.63381
6300,7100,4500,44730000,2,36006,9003,1,840240000,840240000,13501,4500,9001,4500,0,1,4502,37685277,37.685277
6300,7100,4500,44730000,2,36006,9003,1,840240000,840240000,13501,4500,9001,4500,0,1,4502,38568051,38.568051
6300,7100,4900,44730000,2,39206,9803,1,883120000,883120000,14701,4900,9801,4900,0,1,4902,41207087,41.207087
6300,7100,4900,44730000,2,39206,9803,1,883120000,883120000,14701,4900,9801,4900,0,1,4902,42688424,42.688424
6300,7100,4900,44730000,2,39206,9803,1,883120000,883120000,14701,4900,9801,4900,0,1,4902,40445686,40.445686
6300,7100,4900,44730000,2,39206,9803,1,883120000,883120000,14701,4900,9801,4900,0,1,4902,42210274,42.210274
6300,7100,4900,44730000,2,39206,9803,1,883120000,883120000,14701,4900,9801,4900,0,1,4902,40767466,40.767466
6300,7100,4900,44730000,2,39206,9803,1,883120000,883120000,14701,4900,9801,4900,0,1,4902,40892246,40.892246
6300,7100,4900,44730000,2,39206,9803,1,883120000,883120000,14701,4900,9801,4900,0,1,4902,42022656,42.022656
6300,7100,5300,44730000,2,42406,10603,1,926000000,926000000,15901,5300,10601,5300,0,1,5302,44586845,44.586845
6300,7100,5300,44730000,2,42406,10603,1,926000000,926000000,15901,5300,10601,5300,0,1,5302,46166508,46.166508
6300,7100,5300,44730000,2,42406,10603,1,926000000,926000000,15901,5300,10601,5300,0,1,5302,43722464,43.722464
6300,7100,5300,44730000,2,42406,10603,1,926000000,926000000,15901,5300,10601,5300,0,1,5302,45713798,45.713798
6300,7100,5300,44730000,2,42406,10603,1,926000000,926000000,15901,5300,10601,5300,0,1,5302,44207644,44.207644
6300,7100,5300,44730000,2,42406,10603,1,926000000,926000000,15901,5300,10601,5300,0,1,5302,44142887,44.142887
6300,7100,5300,44730000,2,42406,10603,1,926000000,926000000,15901,5300,10601,5300,0,1,5302,45396365,45.396365
6300,7100,5700,44730000,2,45606,11403,1,968880000,968880000,17101,5700,11401,5700,0,1,5702,47948723,47.948723
6300,7100,5700,44730000,2,45606,11403,1,968880000,968880000,17101,5700,11401,5700,0,1,5702,49652985,49.652985
6300,7100,5700,44730000,2,45606,11403,1,968880000,968880000,17101,5700,11401,5700,0,1,5702,47082321,47.082321
6300,7100,5700,44730000,2,45606,11403,1,968880000,968880000,17101,5700,11401,5700,0,1,5702,49225702,49.225702
6300,7100,5700,44730000,2,45606,11403,1,968880000,968880000,17101,5700,11401,5700,0,1,5702,47573122,47.573122
6300,7100,5700,44730000,2,45606,11403,1,968880000,968880000,17101,5700,11401,5700,0,1,5702,47652689,47.652689
6300,7100,5700,44730000,2,45606,11403,1,968880000,968880000,17101,5700,11401,5700,0,1,5702,48911428,48.911428
6300,7100,6100,44730000,2,48806,12203,1,1011760000,1011760000,18301,6100,12201,6100,0,1,6102,51346309,51.346309
6300,7100,6100,44730000,2,48806,12203,1,1011760000,1011760000,18301,6100,12201,6100,0,1,6102,53280732,53.280732
6300,7100,6100,44730000,2,48806,12203,1,1011760000,1011760000,18301,6100,12201,6100,0,1,6102,50430946,50.430946
6300,7100,6100,44730000,2,48806,12203,1,1011760000,1011760000,18301,6100,12201,6100,0,1,6102,52606084,52.606084
6300,7100,6100,44730000,2,48806,12203,1,1011760000,1011760000,18301,6100,12201,6100,0,1,6102,50957533,50.957533
6300,7100,6100,44730000,2,48806,12203,1,1011760000,1011760000,18301,6100,12201,6100,0,1,6102,50898639,50.898639
6300,7100,6100,44730000,2,48806,12203,1,1011760000,1011760000,18301,6100,12201,6100,0,1,6102,52430062,52.430062
6300,7100,6500,44730000,2,52006,13003,1,1054640000,1054640000,19501,6500,13001,6500,0,1,6502,54678596,54.678596
6300,7100,6500,44730000,2,52006,13003,1,1054640000,1054640000,19501,6500,13001,6500,0,1,6502,56725059,56.725059
6300,7100,6500,44730000,2,52006,13003,1,1054640000,1054640000,19501,6500,13001,6500,0,1,6502,53571790,53.57179
6300,7100,6500,44730000,2,52006,13003,1,1054640000,1054640000,19501,6500,13001,6500,0,1,6502,56042847,56.042847
6300,7100,6500,44730000,2,52006,13003,1,1054640000,1054640000,19501,6500,13001,6500,0,1,6502,54318004,54.318004
6300,7100,6500,44730000,2,52006,13003,1,1054640000,1054640000,19501,6500,13001,6500,0,1,6502,54284726,54.284726
6300,7100,6500,44730000,2,52006,13003,1,1054640000,1054640000,19501,6500,13001,6500,0,1,6502,55844679,55.844679
6300,7100,6900,44730000,2,55206,13803,1,1097520000,1097520000,20701,6900,13801,6900,0,1,6902,58023580,58.02358
6300,7100,6900,44730000,2,55206,13803,1,1097520000,1097520000,20701,6900,13801,6900,0,1,6902,60147496,60.147496
6300,7100,6900,44730000,2,55206,13803,1,1097520000,1097520000,20701,6900,13801,6900,0,1,6902,56853807,56.853807
6300,7100,6900,44730000,2,55206,13803,1,1097520000,1097520000,20701,6900,13801,6900,0,1,6902,59562131,59.562131
6300,7100,6900,44730000,2,55206,13803,1,1097520000,1097520000,20701,6900,13801,6900,0,1,6902,57617558,57.617558
6300,7100,6900,44730000,2,55206,13803,1,1097520000,1097520000,20701,6900,13801,6900,0,1,6902,57714258,57.714258
6300,7100,6900,44730000,2,55206,13803,1,1097520000,1097520000,20701,6900,13801,6900,0,1,6902,59161328,59.161328
6300,6700,500,42210000,2,4006,1003,1,389680000,389680000,1501,500,1001,500,0,1,502,4484362,4.484362
6300,6700,500,42210000,2,4006,1003,1,389680000,389680000,1501,500,1001,500,0,1,502,4548716,4.548716
6300,6700,500,42210000,2,4006,1003,1,389680000,389680000,1501,500,1001,500,0,1,502,4454044,4.454044
6300,6700,500,42210000,2,4006,1003,1,389680000,389680000,1501,500,1001,500,0,1,502,4546819,4.546819
6300,6700,500,42210000,2,4006,1003,1,389680000,389680000,1501,500,1001,500,0,1,502,4515773,4.515773
6300,6700,500,42210000,2,4006,1003,1,389680000,389680000,1501,500,1001,500,0,1,502,4484029,4.484029
6300,6700,500,42210000,2,4006,1003,1,389680000,389680000,1501,500,1001,500,0,1,502,4484990,4.48499
6300,6700,900,42210000,2,7206,1803,1,431280000,431280000,2701,900,1801,900,0,1,902,7438264,7.438264
6300,6700,900,42210000,2,7206,1803,1,431280000,431280000,2701,900,1801,900,0,1,902,7668281,7.668281
6300,6700,900,42210000,2,7206,1803,1,431280000,431280000,2701,900,1801,900,0,1,902,7305018,7.305018
6300,6700,900,42210000,2,7206,1803,1,431280000,431280000,2701,900,1801,900,0,1,902,7626818,7.626818
6300,6700,900,42210000,2,7206,1803,1,431280000,431280000,2701,900,1801,900,0,1,902,7407420,7.40742
6300,6700,900,42210000,2,7206,1803,1,431280000,431280000,2701,900,1801,900,0,1,902,7337369,7.337369
6300,6700,900,42210000,2,7206,1803,1,431280000,431280000,2701,900,1801,900,0,1,902,7535630,7.53563
6300,6700,1300,42210000,2,10406,2603,1,472880000,472880000,3901,1300,2601,1300,0,1,1302,10687675,10.687675
6300,6700,1300,42210000,2,10406,2603,1,472880000,472880000,3901,1300,2601,1300,0,1,1302,10984550,10.98455
6300,6700,1300,42210000,2,10406,2603,1,472880000,472880000,3901,1300,2601,1300,0,1,1302,10485874,10.485874
6300,6700,1300,42210000,2,10406,2603,1,472880000,472880000,3901,1300,2601,1300,0,1,1302,10908969,10.908969
6300,6700,1300,42210000,2,10406,2603,1,472880000,472880000,3901,1300,2601,1300,0,1,1302,10604369,10.604369
6300,6700,1300,42210000,2,10406,2603,1,472880000,472880000,3901,1300,2601,1300,0,1,1302,10605782,10.605782
6300,6700,1300,42210000,2,10406,2603,1,472880000,472880000,3901,1300,2601,1300,0,1,1302,10723407,10.723407
6300,6700,1700,42210000,2,13606,3403,1,514480000,514480000,5101,1700,3401,1700,0,1,1702,13663387,13.663387
6300,6700,1700,42210000,2,13606,3403,1,514480000,514480000,5101,1700,3401,1700,0,1,1702,14142949,14.142949
6300,6700,1700,42210000,2,13606,3403,1,514480000,514480000,5101,1700,3401,1700,0,1,1702,13393859,13.393859
6300,6700,1700,42210000,2,13606,3403,1,514480000,514480000,5101,1700,3401,1700,0,1,1702,13982286,13.982286
6300,6700,1700,42210000,2,13606,3403,1,514480000,514480000,5101,1700,3401,1700,0,1,1702,13599598,13.599598
6300,6700,1700,42210000,2,13606,3403,1,514480000,514480000,5101,1700,3401,1700,0,1,1702,13491756,13.491756
6300,6700,1700,42210000,2,13606,3403,1,514480000,514480000,5101,1700,3401,1700,0,1,1702,14011906,14.011906
6300,6700,2100,42210000,2,16806,4203,1,556080000,556080000,6301,2100,4201,2100,0,1,2102,16921479,16.921479
6300,6700,2100,42210000,2,16806,4203,1,556080000,556080000,6301,2100,4201,2100,0,1,2102,17475528,17.475528
6300,6700,2100,42210000,2,16806,4203,1,556080000,556080000,6301,2100,4201,2100,0,1,2102,16598975,16.598975
6300,6700,2100,42210000,2,16806,4203,1,556080000,556080000,6301,2100,4201,2100,0,1,2102,17269555,17.269555
6300,6700,2100,42210000,2,16806,4203,1,556080000,556080000,6301,2100,4201,2100,0,1,2102,16822900,16.8229
6300,6700,2100,42210000,2,16806,4203,1,556080000,556080000,6301,2100,4201,2100,0,1,2102,16719451,16.719451
6300,6700,2100,42210000,2,16806,4203,1,556080000,556080000,6301,2100,4201,2100,0,1,2102,17142318,17.142318
6300,6700,2500,42210000,2,20006,5003,1,597680000,597680000,7501,2500,5001,2500,0,1,2502,20064180,20.06418
6300,6700,2500,42210000,2,20006,5003,1,597680000,597680000,7501,2500,5001,2500,0,1,2502,20727930,20.72793
6300,6700,2500,42210000,2,20006,5003,1,597680000,597680000,7501,2500,5001,2500,0,1,2502,19663167,19.663167
6300,6700,2500,42210000,2,20006,5003,1,597680000,597680000,7501,2500,5001,2500,0,1,2502,20433285,20.433285
6300,6700,2500,42210000,2,20006,5003,1,597680000,597680000,7501,2500,5001,2500,0,1,2502,19925946,19.925946
6300,6700,2500,42210000,2,20006,5003,1,597680000,597680000,7501,2500,5001,2500,0,1,2502,19835883,19.835883
6300,6700,2500,42210000,2,20006,5003,1,597680000,597680000,7501,2500,5001,2500,0,1,2502,20375490,20.37549
6300,6700,2900,42210000,2,23206,5803,1,639280000,639280000,8701,2900,5801,2900,0,1,2902,23245629,23.245629
6300,6700,2900,42210000,2,23206,5803,1,639280000,639280000,8701,2900,5801,2900,0,1,2902,23947264,23.947264
6300,6700,2900,42210000,2,23206,5803,1,639280000,639280000,8701,2900,5801,2900,0,1,2902,22725379,22.725379
6300,6700,2900,42210000,2,23206,5803,1,639280000,639280000,8701,2900,5801,2900,0,1,2902,23701207,23.701207
6300,6700,2900,42210000,2,23206,5803,1,639280000,639280000,8701,2900,5801,2900,0,1,2902,23072637,23.072637
6300,6700,2900,42210000,2,23206,5803,1,639280000,639280000,8701,2900,5801,2900,0,1,2902,22952991,22.952991
6300,6700,2900,42210000,2,23206,5803,1,639280000,639280000,8701,2900,5801,2900,0,1,2902,23559263,23.559263
6300,6700,3300,42210000,2,26406,6603,1,680880000,680880000,9901,3300,6601,3300,0,1,3302,26351982,26.351982
6300,6700,3300,42210000,2,26406,6603,1,680880000,680880000,9901,3300,6601,3300,0,1,3302,27212423,27.212423
6300,6700,3300,42210000,2,26406,6603,1,680880000,680880000,9901,3300,6601,3300,0,1,3302,25875997,25.875997
6300,6700,3300,42210000,2,26406,6603,1,680880000,680880000,9901,3300,6601,3300,0,1,3302,26857145,26.857145
6300,6700,3300,42210000,2,26406,6603,1,680880000,680880000,9901,3300,6601,3300,0,1,3302,26175284,26.175284
6300,6700,3300,42210000,2,26406,6603,1,680880000,680880000,9901,3300,6601,3300,0,1,3302,26021128,26.021128
6300,6700,3300,42210000,2,26406,6603,1,680880000,680880000,9901,3300,6601,3300,0,1,3302,26804866,26.804866
6300,6700,3700,42210000,2,29606,7403,1,722480000,722480000,11101,3700,7401,3700,0,1,3702,29452244,29.452244
6300,6700,3700,42210000,2,29606,7403,1,722480000,722480000,11101,3700,7401,3700,0,1,3702,30496346,30.496346
6300,6700,3700,42210000,2,29606,7403,1,722480000,722480000,11101,3700,7401,3700,0,1,3702,28897674,28.897674
6300,6700,3700,42210000,2,29606,7403,1,722480000,722480000,11101,3700,7401,3700,0,1,3702,30173288,30.173288
6300,6700,3700,42210000,2,29606,7403,1,722480000,722480000,11101,3700,7401,3700,0,1,3702,29236940,29.23694
6300,6700,3700,42210000,2,29606,7403,1,722480000,722480000,11101,3700,7401,3700,0,1,3702,29169454,29.169454
6300,6700,3700,42210000,2,29606,7403,1,722480000,722480000,11101,3700,7401,3700,0,1,3702,29992337,29.992337
6300,6700,4100,42210000,2,32806,8203,1,764080000,764080000,12301,4100,8201,4100,0,1,4102,32618124,32.618124
6300,6700,4100,42210000,2,32806,8203,1,764080000,764080000,12301,4100,8201,4100,0,1,4102,33791441,33.791441
6300,6700,4100,42210000,2,32806,8203,1,764080000,764080000,12301,4100,8201,4100,0,1,4102,31935551,31.935551
6300,6700,4100,42210000,2,32806,8203,1,764080000,764080000,12301,4100,8201,4100,0,1,4102,33261973,33.261973
6300,6700,4100,42210000,2,32806,8203,1,764080000,764080000,12301,4100,8201,4100,0,1,4102,32407244,32.407244
6300,6700,4100,42210000,2,32806,8203,1,764080000,764080000,12301,4100,8201,4100,0,1,4102,32435690,32.43569
6300,6700,4100,42210000,2,32806,8203,1,764080000,764080000,12301,4100,8201,4100,0,1,4102,33213352,33.213352
6300,6700,4500,42210000,2,36006,9003,1,805680000,805680000,13501,4500,9001,4500,0,1,4502,35805371,35.805371
6300,6700,4500,42210000,2,36006,9003,1,805680000,805680000,13501,4500,9001,4500,0,1,4502,37016965,37.016965
6300,6700,4500,42210000,2,36006,9003,1,805680000,805680000,13501,4500,9001,4500,0,1,4502,35101017,35.101017
6300,6700,4500,42210000,2,36006,9003,1,805680000,805680000,13501,4500,9001,4500,0,1,4502,36646601,36.646601
6300,6700,4500,42210000,2,36006,9003,1,805680000,805680000,13501,4500,9001,4500,0,1,4502,35412076,35.412076
6300,6700,4500,42210000,2,36006,9003,1,805680000,805680000,13501,4500,9001,4500,0,1,4502,35491385,35.491385
6300,6700,4500,42210000,2,36006,9003,1,805680000,805680000,13501,4500,9001,4500,0,1,4502,36433737,36.433737
6300,6700,4900,42210000,2,39206,9803,1,847280000,847280000,14701,4900,9801,4900,0,1,4902,38913083,38.913083
6300,6700,4900,42210000,2,39206,9803,1,847280000,847280000,14701,4900,9801,4900,0,1,4902,40292690,40.29269
6300,6700,4900,42210000,2,39206,9803,1,847280000,847280000,14701,4900,9801,4900,0,1,4902,38203270,38.20327
6300,6700,4900,42210000,2,39206,9803,1,847280000,847280000,14701,4900,9801,4900,0,1,4902,39843198,39.843198
6300,6700,4900,42210000,2,39206,9803,1,847280000,847280000,14701,4900,9801,4900,0,1,4902,38462106,38.462106
6300,6700,4900,42210000,2,39206,9803,1,847280000,847280000,14701,4900,9801,4900,0,1,4902,38653404,38.653404
6300,6700,4900,42210000,2,39206,9803,1,847280000,847280000,14701,4900,9801,4900,0,1,4902,39678565,39.678565
6300,6700,5300,42210000,2,42406,10603,1,888880000,888880000,15901,5300,10601,5300,0,1,5302,42128201,42.128201
6300,6700,5300,42210000,2,42406,10603,1,888880000,888880000,15901,5300,10601,5300,0,1,5302,43583068,43.583068
6300,6700,5300,42210000,2,42406,10603,1,888880000,888880000,15901,5300,10601,5300,0,1,5302,41343998,41.343998
6300,6700,5300,42210000,2,42406,10603,1,888880000,888880000,15901,5300,10601,5300,0,1,5302,43177594,43.177594
6300,6700,5300,42210000,2,42406,10603,1,888880000,888880000,15901,5300,10601,5300,0,1,5302,41648877,41.648877
6300,6700,5300,42210000,2,42406,10603,1,888880000,888880000,15901,5300,10601,5300,0,1,5302,41825318,41.825318
6300,6700,5300,42210000,2,42406,10603,1,888880000,888880000,15901,5300,10601,5300,0,1,5302,42938302,42.938302
6300,6700,5700,42210000,2,45606,11403,1,930480000,930480000,17101,5700,11401,5700,0,1,5702,45237611,45.237611
6300,6700,5700,42210000,2,45606,11403,1,930480000,930480000,17101,5700,11401,5700,0,1,5702,46864767,46.864767
6300,6700,5700,42210000,2,45606,11403,1,930480000,930480000,17101,5700,11401,5700,0,1,5702,44466291,44.466291
6300,6700,5700,42210000,2,45606,11403,1,930480000,930480000,17101,5700,11401,5700,0,1,5702,46369012,46.369012
6300,6700,5700,42210000,2,45606,11403,1,930480000,930480000,17101,5700,11401,5700,0,1,5702,44763968,44.763968
6300,6700,5700,42210000,2,45606,11403,1,930480000,930480000,17101,5700,11401,5700,0,1,5702,44881844,44.881844
6300,6700,5700,42210000,2,45606,11403,1,930480000,930480000,17101,5700,11401,5700,0,1,5702,46136713,46.136713
6300,6700,6100,42210000,2,48806,12203,1,972080000,972080000,18301,6100,12201,6100,0,1,6102,48371734,48.371734
6300,6700,6100,42210000,2,48806,12203,1,972080000,972080000,18301,6100,12201,6100,0,1,6102,50165765,50.165765
6300,6700,6100,42210000,2,48806,12203,1,972080000,972080000,18301,6100,12201,6100,0,1,6102,47473020,47.47302
6300,6700,6100,42210000,2,48806,12203,1,972080000,972080000,18301,6100,12201,6100,0,1,6102,49716649,49.716649
6300,6700,6100,42210000,2,48806,12203,1,972080000,972080000,18301,6100,12201,6100,0,1,6102,47869170,47.86917
6300,6700,6100,42210000,2,48806,12203,1,972080000,972080000,18301,6100,12201,6100,0,1,6102,48154346,48.154346
6300,6700,6100,42210000,2,48806,12203,1,972080000,972080000,18301,6100,12201,6100,0,1,6102,49301283,49.301283
6300,6700,6500,42210000,2,52006,13003,1,1013680000,1013680000,19501,6500,13001,6500,0,1,6502,51574300,51.5743
6300,6700,6500,42210000,2,52006,13003,1,1013680000,1013680000,19501,6500,13001,6500,0,1,6502,53616122,53.616122
6300,6700,6500,42210000,2,52006,13003,1,1013680000,1013680000,19501,6500,13001,6500,0,1,6502,50546004,50.546004
6300,6700,6500,42210000,2,52006,13003,1,1013680000,1013680000,19501,6500,13001,6500,0,1,6502,52963749,52.963749
6300,6700,6500,42210000,2,52006,13003,1,1013680000,1013680000,19501,6500,13001,6500,0,1,6502,51059373,51.059373
6300,6700,6500,42210000,2,52006,13003,1,1013680000,1013680000,19501,6500,13001,6500,0,1,6502,51225542,51.225542
6300,6700,6500,42210000,2,52006,13003,1,1013680000,1013680000,19501,6500,13001,6500,0,1,6502,52577156,52.577156
6300,6700,6900,42210000,2,55206,13803,1,1055280000,1055280000,20701,6900,13801,6900,0,1,6902,54758660,54.75866
6300,6700,6900,42210000,2,55206,13803,1,1055280000,1055280000,20701,6900,13801,6900,0,1,6902,56738762,56.738762
6300,6700,6900,42210000,2,55206,13803,1,1055280000,1055280000,20701,6900,13801,6900,0,1,6902,53706256,53.706256
6300,6700,6900,42210000,2,55206,13803,1,1055280000,1055280000,20701,6900,13801,6900,0,1,6902,56293741,56.293741
6300,6700,6900,42210000,2,55206,13803,1,1055280000,1055280000,20701,6900,13801,6900,0,1,6902,54261812,54.261812
6300,6700,6900,42210000,2,55206,13803,1,1055280000,1055280000,20701,6900,13801,6900,0,1,6902,54415200,54.4152
6300,6700,6900,42210000,2,55206,13803,1,1055280000,1055280000,20701,6900,13801,6900,0,1,6902,55878095,55.878095
6300,6300,500,39690000,2,4006,1003,1,367920000,367920000,1501,500,1001,500,0,1,502,4225906,4.225906
6300,6300,500,39690000,2,4006,1003,1,367920000,367920000,1501,500,1001,500,0,1,502,4285248,4.285248
6300,6300,500,39690000,2,4006,1003,1,367920000,367920000,1501,500,1001,500,0,1,502,4158891,4.158891
6300,6300,500,39690000,2,4006,1003,1,367920000,367920000,1501,500,1001,500,0,1,502,4341318,4.341318
6300,6300,500,39690000,2,4006,1003,1,367920000,367920000,1501,500,1001,500,0,1,502,4226468,4.226468
6300,6300,500,39690000,2,4006,1003,1,367920000,367920000,1501,500,1001,500,0,1,502,4198204,4.198204
6300,6300,500,39690000,2,4006,1003,1,367920000,367920000,1501,500,1001,500,0,1,502,4313273,4.313273
6300,6300,900,39690000,2,7206,1803,1,408240000,408240000,2701,900,1801,900,0,1,902,6985359,6.985359
6300,6300,900,39690000,2,7206,1803,1,408240000,408240000,2701,900,1801,900,0,1,902,7228655,7.228655
6300,6300,900,39690000,2,7206,1803,1,408240000,408240000,2701,900,1801,900,0,1,902,6857490,6.85749
6300,6300,900,39690000,2,7206,1803,1,408240000,408240000,2701,900,1801,900,0,1,902,7193382,7.193382
6300,6300,900,39690000,2,7206,1803,1,408240000,408240000,2701,900,1801,900,0,1,902,6916917,6.916917
6300,6300,900,39690000,2,7206,1803,1,408240000,408240000,2701,900,1801,900,0,1,902,6889559,6.889559
6300,6300,900,39690000,2,7206,1803,1,408240000,408240000,2701,900,1801,900,0,1,902,7165314,7.165314
6300,6300,1300,39690000,2,10406,2603,1,448560000,448560000,3901,1300,2601,1300,0,1,1302,9942850,9.94285
6300,6300,1300,39690000,2,10406,2603,1,448560000,448560000,3901,1300,2601,1300,0,1,1302,10277012,10.277012
6300,6300,1300,39690000,2,10406,2603,1,448560000,448560000,3901,1300,2601,1300,0,1,1302,9713858,9.713858
6300,6300,1300,39690000,2,10406,2603,1,448560000,448560000,3901,1300,2601,1300,0,1,1302,10134995,10.134995
6300,6300,1300,39690000,2,10406,2603,1,448560000,448560000,3901,1300,2601,1300,0,1,1302,9910338,9.910338
6300,6300,1300,39690000,2,10406,2603,1,448560000,448560000,3901,1300,2601,1300,0,1,1302,9790335,9.790335
6300,6300,1300,39690000,2,10406,2603,1,448560000,448560000,3901,1300,2601,1300,0,1,1302,10163017,10.163017
6300,6300,1700,39690000,2,13606,3403,1,488880000,488880000,5101,1700,3401,1700,0,1,1702,12994995,12.994995
6300,6300,1700,39690000,2,13606,3403,1,488880000,488880000,5101,1700,3401,1700,0,1,1702,13439703,13.439703
6300,6300,1700,39690000,2,13606,3403,1,488880000,488880000,5101,1700,3401,1700,0,1,1702,12720578,12.720578
6300,6300,1700,39690000,2,13606,3403,1,488880000,488880000,5101,1700,3401,1700,0,1,1702,13234007,13.234007
6300,6300,1700,39690000,2,13606,3403,1,488880000,488880000,5101,1700,3401,1700,0,1,1702,12960641,12.960641
6300,6300,1700,39690000,2,13606,3403,1,488880000,488880000,5101,1700,3401,1700,0,1,1702,12846046,12.846046
6300,6300,1700,39690000,2,13606,3403,1,488880000,488880000,5101,1700,3401,1700,0,1,1702,13261948,13.261948
6300,6300,2100,39690000,2,16806,4203,1,529200000,529200000,6301,2100,4201,2100,0,1,2102,15922838,15.922838
6300,6300,2100,39690000,2,16806,4203,1,529200000,529200000,6301,2100,4201,2100,0,1,2102,16458372,16.458372
6300,6300,2100,39690000,2,16806,4203,1,529200000,529200000,6301,2100,4201,2100,0,1,2102,15658430,15.65843
6300,6300,2100,39690000,2,16806,4203,1,529200000,529200000,6301,2100,4201,2100,0,1,2102,16207398,16.207398
6300,6300,2100,39690000,2,16806,4203,1,529200000,529200000,6301,2100,4201,2100,0,1,2102,15845867,15.845867
6300,6300,2100,39690000,2,16806,4203,1,529200000,529200000,6301,2100,4201,2100,0,1,2102,15746032,15.746032
6300,6300,2100,39690000,2,16806,4203,1,529200000,529200000,6301,2100,4201,2100,0,1,2102,16233707,16.233707
6300,6300,2500,39690000,2,20006,5003,1,569520000,569520000,7501,2500,5001,2500,0,1,2502,18876385,18.876385
6300,6300,2500,39690000,2,20006,5003,1,569520000,569520000,7501,2500,5001,2500,0,1,2502,19487172,19.487172
6300,6300,2500,39690000,2,20006,5003,1,569520000,569520000,7501,2500,5001,2500,0,1,2502,18528427,18.528427
6300,6300,2500,39690000,2,20006,5003,1,569520000,569520000,7501,2500,5001,2500,0,1,2502,19177677,19.177677
6300,6300,2500,39690000,2,20006,5003,1,569520000,569520000,7501,2500,5001,2500,0,1,2502,18769885,18.769885
6300,6300,2500,39690000,2,20006,5003,1,569520000,569520000,7501,2500,5001,2500,0,1,2502,18618306,18.618306
6300,6300,2500,39690000,2,20006,5003,1,569520000,569520000,7501,2500,5001,2500,0,1,2502,19256755,19.256755
6300,6300,2900,39690000,2,23206,5803,1,609840000,609840000,8701,2900,5801,2900,0,1,2902,21837842,21.837842
6300,6300,2900,39690000,2,23206,5803,1,609840000,609840000,8701,2900,5801,2900,0,1,2902,22563883,22.563883
6300,6300,2900,39690000,2,23206,5803,1,609840000,609840000,8701,2900,5801,2900,0,1,2902,21376721,21.376721
6300,6300,2900,39690000,2,23206,5803,1,609840000,609840000,8701,2900,5801,2900,0,1,2902,22231697,22.231697
6300,6300,2900,39690000,2,23206,5803,1,609840000,609840000,8701,2900,5801,2900,0,1,2902,21683411,21.683411
6300,6300,2900,39690000,2,23206,5803,1,609840000,609840000,8701,2900,5801,2900,0,1,2902,21556154,21.556154
6300,6300,2900,39690000,2,23206,5803,1,609840000,609840000,8701,2900,5801,2900,0,1,2902,22280610,22.28061
6300,6300,3300,39690000,2,26406,6603,1,650160000,650160000,9901,3300,6601,3300,0,1,3302,24776274,24.776274
6300,6300,3300,39690000,2,26406,6603,1,650160000,650160000,9901,3300,6601,3300,0,1,3302,25583637,25.583637
6300,6300,3300,39690000,2,26406,6603,1,650160000,650160000,9901,3300,6601,3300,0,1,3302,24275504,24.275504
6300,6300,3300,39690000,2,26406,6603,1,650160000,650160000,9901,3300,6601,3300,0,1,3302,25298444,25.298444
6300,6300,3300,39690000,2,26406,6603,1,650160000,650160000,9901,3300,6601,3300,0,1,3302,24581921,24.581921
6300,6300,3300,39690000,2,26406,6603,1,650160000,650160000,9901,3300,6601,3300,0,1,3302,24501617,24.501617
6300,6300,3300,39690000,2,26406,6603,1,650160000,650160000,9901,3300,6601,3300,0,1,3302,25271089,25.271089
6300,6300,3700,39690000,2,29606,7403,1,690480000,690480000,11101,3700,7401,3700,0,1,3702,27676999,27.676999
6300,6300,3700,39690000,2,29606,7403,1,690480000,690480000,11101,3700,7401,3700,0,1,3702,28703114,28.703114
6300,6300,3700,39690000,2,29606,7403,1,690480000,690480000,11101,3700,7401,3700,0,1,3702,27197912,27.197912
6300,6300,3700,39690000,2,29606,7403,1,690480000,690480000,11101,3700,7401,3700,0,1,3702,28331350,28.33135
6300,6300,3700,39690000,2,29606,7403,1,690480000,690480000,11101,3700,7401,3700,0,1,3702,27547655,27.547655
6300,6300,3700,39690000,2,29606,7403,1,690480000,690480000,11101,3700,7401,3700,0,1,3702,27457174,27.457174
6300,6300,3700,39690000,2,29606,7403,1,690480000,690480000,11101,3700,7401,3700,0,1,3702,28217981,28.217981
6300,6300,4100,39690000,2,32806,8203,1,730800000,730800000,12301,4100,8201,4100,0,1,4102,30635862,30.635862
6300,6300,4100,39690000,2,32806,8203,1,730800000,730800000,12301,4100,8201,4100,0,1,4102,31731827,31.731827
6300,6300,4100,39690000,2,32806,8203,1,730800000,730800000,12301,4100,8201,4100,0,1,4102,30005109,30.005109
6300,6300,4100,39690000,2,32806,8203,1,730800000,730800000,12301,4100,8201,4100,0,1,4102,31338251,31.338251
6300,6300,4100,39690000,2,32806,8203,1,730800000,730800000,12301,4100,8201,4100,0,1,4102,30412980,30.41298
6300,6300,4100,39690000,2,32806,8203,1,730800000,730800000,12301,4100,8201,4100,0,1,4102,30352326,30.352326
6300,6300,4100,39690000,2,32806,8203,1,730800000,730800000,12301,4100,8201,4100,0,1,4102,31261401,31.261401
6300,6300,4500,39690000,2,36006,9003,1,771120000,771120000,13501,4500,9001,4500,0,1,4502,33625591,33.625591
6300,6300,4500,39690000,2,36006,9003,1,771120000,771120000,13501,4500,9001,4500,0,1,4502,34800556,34.800556
6300,6300,4500,39690000,2,36006,9003,1,771120000,771120000,13501,4500,9001,4500,0,1,4502,32991270,32.99127
6300,6300,4500,39690000,2,36006,9003,1,771120000,771120000,13501,4500,9001,4500,0,1,4502,34384604,34.384604
6300,6300,4500,39690000,2,36006,9003,1,771120000,771120000,13501,4500,9001,4500,0,1,4502,33275591,33.275591
6300,6300,4500,39690000,2,36006,9003,1,771120000,771120000,13501,4500,9001,4500,0,1,4502,33321239,33.321239
6300,6300,4500,39690000,2,36006,9003,1,771120000,771120000,13501,4500,9001,4500,0,1,4502,34285526,34.285526
6300,6300,4900,39690000,2,39206,9803,1,811440000,811440000,14701,4900,9801,4900,0,1,4902,36575745,36.575745
6300,6300,4900,39690000,2,39206,9803,1,811440000,811440000,14701,4900,9801,4900,0,1,4902,37949145,37.949145
6300,6300,4900,39690000,2,39206,9803,1,811440000,811440000,14701,4900,9801,4900,0,1,4902,35855355,35.855355
6300,6300,4900,39690000,2,39206,9803,1,811440000,811440000,14701,4900,9801,4900,0,1,4902,37461138,37.461138
6300,6300,4900,39690000,2,39206,9803,1,811440000,811440000,14701,4900,9801,4900,0,1,4902,36199736,36.199736
6300,6300,4900,39690000,2,39206,9803,1,811440000,811440000,14701,4900,9801,4900,0,1,4902,36301267,36.301267
6300,6300,4900,39690000,2,39206,9803,1,811440000,811440000,14701,4900,9801,4900,0,1,4902,37391476,37.391476
6300,6300,5300,39690000,2,42406,10603,1,851760000,851760000,15901,5300,10601,5300,0,1,5302,39540912,39.540912
6300,6300,5300,39690000,2,42406,10603,1,851760000,851760000,15901,5300,10601,5300,0,1,5302,40985367,40.985367
6300,6300,5300,39690000,2,42406,10603,1,851760000,851760000,15901,5300,10601,5300,0,1,5302,38824323,38.824323
6300,6300,5300,39690000,2,42406,10603,1,851760000,851760000,15901,5300,10601,5300,0,1,5302,40541027,40.541027
6300,6300,5300,39690000,2,42406,10603,1,851760000,851760000,15901,5300,10601,5300,0,1,5302,39177077,39.177077
6300,6300,5300,39690000,2,42406,10603,1,851760000,851760000,15901,5300,10601,5300,0,1,5302,39268878,39.268878
6300,6300,5300,39690000,2,42406,10603,1,851760000,851760000,15901,5300,10601,5300,0,1,5302,40374326,40.374326
6300,6300,5700,39690000,2,45606,11403,1,892080000,892080000,17101,5700,11401,5700,0,1,5702,42535120,42.53512
6300,6300,5700,39690000,2,45606,11403,1,892080000,892080000,17101,5700,11401,5700,0,1,5702,44049246,44.049246
6300,6300,5700,39690000,2,45606,11403,1,892080000,892080000,17101,5700,11401,5700,0,1,5702,41700764,41.700764
6300,6300,5700,39690000,2,45606,11403,1,892080000,892080000,17101,5700,11401,5700,0,1,5702,43495378,43.495378
6300,6300,5700,39690000,2,45606,11403,1,892080000,892080000,17101,5700,11401,5700,0,1,5702,42097615,42.097615
6300,6300,5700,39690000,2,45606,11403,1,892080000,892080000,17101,5700,11401,5700,0,1,5702,42209596,42.209596
6300,6300,5700,39690000,2,45606,11403,1,892080000,892080000,17101,5700,11401,5700,0,1,5702,43437434,43.437434
6300,6300,6100,39690000,2,48806,12203,1,932400000,932400000,18301,6100,12201,6100,0,1,6102,45515287,45.515287
6300,6300,6100,39690000,2,48806,12203,1,932400000,932400000,18301,6100,12201,6100,0,1,6102,47117944,47.117944
6300,6300,6100,39690000,2,48806,12203,1,932400000,932400000,18301,6100,12201,6100,0,1,6102,44602195,44.602195
6300,6300,6100,39690000,2,48806,12203,1,932400000,932400000,18301,6100,12201,6100,0,1,6102,46632305,46.632305
6300,6300,6100,39690000,2,48806,12203,1,932400000,932400000,18301,6100,12201,6100,0,1,6102,45042824,45.042824
6300,6300,6100,39690000,2,48806,12203,1,932400000,932400000,18301,6100,12201,6100,0,1,6102,45231637,45.231637
6300,6300,6100,39690000,2,48806,12203,1,932400000,932400000,18301,6100,12201,6100,0,1,6102,46528022,46.528022
6300,6300,6500,39690000,2,52006,13003,1,972720000,972720000,19501,6500,13001,6500,0,1,6502,48480635,48.480635
6300,6300,6500,39690000,2,52006,13003,1,972720000,972720000,19501,6500,13001,6500,0,1,6502,50237032,50.237032
6300,6300,6500,39690000,2,52006,13003,1,972720000,972720000,19501,6500,13001,6500,0,1,6502,47559360,47.55936
6300,6300,6500,39690000,2,52006,13003,1,972720000,972720000,19501,6500,13001,6500,0,1,6502,49707353,49.707353
6300,6300,6500,39690000,2,52006,13003,1,972720000,972720000,19501,6500,13001,6500,0,1,6502,48018470,48.01847
6300,6300,6500,39690000,2,52006,13003,1,972720000,972720000,19501,6500,13001,6500,0,1,6502,48122089,48.122089
6300,6300,6500,39690000,2,52006,13003,1,972720000,972720000,19501,6500,13001,6500,0,1,6502,49532903,49.532903
6300,6300,6900,39690000,2,55206,13803,1,1013040000,1013040000,20701,6900,13801,6900,0,1,6902,51462167,51.462167
6300,6300,6900,39690000,2,55206,13803,1,1013040000,1013040000,20701,6900,13801,6900,0,1,6902,53344752,53.344752
6300,6300,6900,39690000,2,55206,13803,1,1013040000,1013040000,20701,6900,13801,6900,0,1,6902,50469546,50.469546
6300,6300,6900,39690000,2,55206,13803,1,1013040000,1013040000,20701,6900,13801,6900,0,1,6902,52874546,52.874546
6300,6300,6900,39690000,2,55206,13803,1,1013040000,1013040000,20701,6900,13801,6900,0,1,6902,51038068,51.038068
6300,6300,6900,39690000,2,55206,13803,1,1013040000,1013040000,20701,6900,13801,6900,0,1,6902,51142814,51.142814
6300,6300,6900,39690000,2,55206,13803,1,1013040000,1013040000,20701,6900,13801,6900,0,1,6902,52496490,52.49649
6300,5900,500,37170000,2,4006,1003,1,346160000,346160000,1501,500,1001,500,0,1,502,3979443,3.979443
6300,5900,500,37170000,2,4006,1003,1,346160000,346160000,1501,500,1001,500,0,1,502,4033563,4.033563
6300,5900,500,37170000,2,4006,1003,1,346160000,346160000,1501,500,1001,500,0,1,502,3881744,3.881744
6300,5900,500,37170000,2,4006,1003,1,346160000,346160000,1501,500,1001,500,0,1,502,4060207,4.060207
6300,5900,500,37170000,2,4006,1003,1,346160000,346160000,1501,500,1001,500,0,1,502,4005302,4.005302
6300,5900,500,37170000,2,4006,1003,1,346160000,346160000,1501,500,1001,500,0,1,502,3909294,3.909294
6300,5900,500,37170000,2,4006,1003,1,346160000,346160000,1501,500,1001,500,0,1,502,3954044,3.954044
6300,5900,900,37170000,2,7206,1803,1,385200000,385200000,2701,900,1801,900,0,1,902,6531852,6.531852
6300,5900,900,37170000,2,7206,1803,1,385200000,385200000,2701,900,1801,900,0,1,902,6750536,6.750536
6300,5900,900,37170000,2,7206,1803,1,385200000,385200000,2701,900,1801,900,0,1,902,6401288,6.401288
6300,5900,900,37170000,2,7206,1803,1,385200000,385200000,2701,900,1801,900,0,1,902,6723155,6.723155
6300,5900,900,37170000,2,7206,1803,1,385200000,385200000,2701,900,1801,900,0,1,902,6497735,6.497735
6300,5900,900,37170000,2,7206,1803,1,385200000,385200000,2701,900,1801,900,0,1,902,6472182,6.472182
6300,5900,900,37170000,2,7206,1803,1,385200000,385200000,2701,900,1801,900,0,1,902,6655246,6.655246
6300,5900,1300,37170000,2,10406,2603,1,424240000,424240000,3901,1300,2601,1300,0,1,1302,9279853,9.279853
6300,5900,1300,37170000,2,10406,2603,1,424240000,424240000,3901,1300,2601,1300,0,1,1302,9594837,9.594837
6300,5900,1300,37170000,2,10406,2603,1,424240000,424240000,3901,1300,2601,1300,0,1,1302,9089564,9.089564
6300,5900,1300,37170000,2,10406,2603,1,424240000,424240000,3901,1300,2601,1300,0,1,1302,9513154,9.513154
6300,5900,1300,37170000,2,10406,2603,1,424240000,424240000,3901,1300,2601,1300,0,1,1302,9226683,9.226683
6300,5900,1300,37170000,2,10406,2603,1,424240000,424240000,3901,1300,2601,1300,0,1,1302,9200153,9.200153
6300,5900,1300,37170000,2,10406,2603,1,424240000,424240000,3901,1300,2601,1300,0,1,1302,9455598,9.455598
6300,5900,1700,37170000,2,13606,3403,1,463280000,463280000,5101,1700,3401,1700,0,1,1702,12186757,12.186757
6300,5900,1700,37170000,2,13606,3403,1,463280000,463280000,5101,1700,3401,1700,0,1,1702,12554425,12.554425
6300,5900,1700,37170000,2,13606,3403,1,463280000,463280000,5101,1700,3401,1700,0,1,1702,11958541,11.958541
6300,5900,1700,37170000,2,13606,3403,1,463280000,463280000,5101,1700,3401,1700,0,1,1702,12386416,12.386416
6300,5900,1700,37170000,2,13606,3403,1,463280000,463280000,5101,1700,3401,1700,0,1,1702,12103632,12.103632
6300,5900,1700,37170000,2,13606,3403,1,463280000,463280000,5101,1700,3401,1700,0,1,1702,12071175,12.071175
6300,5900,1700,37170000,2,13606,3403,1,463280000,463280000,5101,1700,3401,1700,0,1,1702,12339083,12.339083
6300,5900,2100,37170000,2,16806,4203,1,502320000,502320000,6301,2100,4201,2100,0,1,2102,14921389,14.921389
6300,5900,2100,37170000,2,16806,4203,1,502320000,502320000,6301,2100,4201,2100,0,1,2102,15393162,15.393162
6300,5900,2100,37170000,2,16806,4203,1,502320000,502320000,6301,2100,4201,2100,0,1,2102,14640334,14.640334
6300,5900,2100,37170000,2,16806,4203,1,502320000,502320000,6301,2100,4201,2100,0,1,2102,15154592,15.154592
6300,5900,2100,37170000,2,16806,4203,1,502320000,502320000,6301,2100,4201,2100,0,1,2102,14840970,14.84097
6300,5900,2100,37170000,2,16806,4203,1,502320000,502320000,6301,2100,4201,2100,0,1,2102,14792359,14.792359
6300,5900,2100,37170000,2,16806,4203,1,502320000,502320000,6301,2100,4201,2100,0,1,2102,15196625,15.196625
6300,5900,2500,37170000,2,20006,5003,1,541360000,541360000,7501,2500,5001,2500,0,1,2502,17659168,17.659168
6300,5900,2500,37170000,2,20006,5003,1,541360000,541360000,7501,2500,5001,2500,0,1,2502,18230816,18.230816
6300,5900,2500,37170000,2,20006,5003,1,541360000,541360000,7501,2500,5001,2500,0,1,2502,17336176,17.336176
6300,5900,2500,37170000,2,20006,5003,1,541360000,541360000,7501,2500,5001,2500,0,1,2502,18048286,18.048286
6300,5900,2500,37170000,2,20006,5003,1,541360000,541360000,7501,2500,5001,2500,0,1,2502,17557310,17.55731
6300,5900,2500,37170000,2,20006,5003,1,541360000,541360000,7501,2500,5001,2500,0,1,2502,17493811,17.493811
6300,5900,2500,37170000,2,20006,5003,1,541360000,541360000,7501,2500,5001,2500,0,1,2502,18006861,18.006861
6300,5900,2900,37170000,2,23206,5803,1,580400000,580400000,8701,2900,5801,2900,0,1,2902,20453384,20.453384
6300,5900,2900,37170000,2,23206,5803,1,580400000,580400000,8701,2900,5801,2900,0,1,2902,21112930,21.11293
6300,5900,2900,37170000,2,23206,5803,1,580400000,580400000,8701,2900,5801,2900,0,1,2902,20010746,20.010746
6300,5900,2900,37170000,2,23206,5803,1,580400000,580400000,8701,2900,5801,2900,0,1,2902,20859853,20.859853
6300,5900,2900,37170000,2,23206,5803,1,580400000,580400000,8701,2900,5801,2900,0,1,2902,20313945,20.313945
6300,5900,2900,37170000,2,23206,5803,1,580400000,580400000,8701,2900,5801,2900,0,1,2902,20203227,20.203227
6300,5900,2900,37170000,2,23206,5803,1,580400000,580400000,8701,2900,5801,2900,0,1,2902,20777546,20.777546
6300,5900,3300,37170000,2,26406,6603,1,619440000,619440000,9901,3300,6601,3300,0,1,3302,23240880,23.24088
6300,5900,3300,37170000,2,26406,6603,1,619440000,619440000,9901,3300,6601,3300,0,1,3302,23999750,23.99975
6300,5900,3300,37170000,2,26406,6603,1,619440000,619440000,9901,3300,6601,3300,0,1,3302,22706673,22.706673
6300,5900,3300,37170000,2,26406,6603,1,619440000,619440000,9901,3300,6601,3300,0,1,3302,23692891,23.692891
6300,5900,3300,37170000,2,26406,6603,1,619440000,619440000,9901,3300,6601,3300,0,1,3302,23010715,23.010715
6300,5900,3300,37170000,2,26406,6603,1,619440000,619440000,9901,3300,6601,3300,0,1,3302,22972674,22.972674
6300,5900,3300,37170000,2,26406,6603,1,619440000,619440000,9901,3300,6601,3300,0,1,3302,23601965,23.601965
6300,5900,3700,37170000,2,29606,7403,1,658480000,658480000,11101,3700,7401,3700,0,1,3702,25965934,25.965934
6300,5900,3700,37170000,2,29606,7403,1,658480000,658480000,11101,3700,7401,3700,0,1,3702,26842518,26.842518
6300,5900,3700,37170000,2,29606,7403,1,658480000,658480000,11101,3700,7401,3700,0,1,3702,25440034,25.440034
6300,5900,3700,37170000,2,29606,7403,1,658480000,658480000,11101,3700,7401,3700,0,1,3702,26521829,26.521829
6300,5900,3700,37170000,2,29606,7403,1,658480000,658480000,11101,3700,7401,3700,0,1,3702,25770313,25.770313
6300,5900,3700,37170000,2,29606,7403,1,658480000,658480000,11101,3700,7401,3700,0,1,3702,25744310,25.74431
6300,5900,3700,37170000,2,29606,7403,1,658480000,658480000,11101,3700,7401,3700,0,1,3702,26493296,26.493296
6300,5900,4100,37170000,2,32806,8203,1,697520000,697520000,12301,4100,8201,4100,0,1,4102,28778363,28.778363
6300,5900,4100,37170000,2,32806,8203,1,697520000,697520000,12301,4100,8201,4100,0,1,4102,29699745,29.699745
6300,5900,4100,37170000,2,32806,8203,1,697520000,697520000,12301,4100,8201,4100,0,1,4102,28250504,28.250504
6300,5900,4100,37170000,2,32806,8203,1,697520000,697520000,12301,4100,8201,4100,0,1,4102,29320958,29.320958
6300,5900,4100,37170000,2,32806,8203,1,697520000,697520000,12301,4100,8201,4100,0,1,4102,28455613,28.455613
6300,5900,4100,37170000,2,32806,8203,1,697520000,697520000,12301,4100,8201,4100,0,1,4102,28480654,28.480654
6300,5900,4100,37170000,2,32806,8203,1,697520000,697520000,12301,4100,8201,4100,0,1,4102,29295242,29.295242
6300,5900,4500,37170000,2,36006,9003,1,736560000,736560000,13501,4500,9001,4500,0,1,4502,31495110,31.49511
6300,5900,4500,37170000,2,36006,9003,1,736560000,736560000,13501,4500,9001,4500,0,1,4502,32603771,32.603771
6300,5900,4500,37170000,2,36006,9003,1,736560000,736560000,13501,4500,9001,4500,0,1,4502,30937763,30.937763
6300,5900,4500,37170000,2,36006,9003,1,736560000,736560000,13501,4500,9001,4500,0,1,4502,32171228,32.171228
6300,5900,4500,37170000,2,36006,9003,1,736560000,736560000,13501,4500,9001,4500,0,1,4502,31164115,31.164115
6300,5900,4500,37170000,2,36006,9003,1,736560000,736560000,13501,4500,9001,4500,0,1,4502,31270260,31.27026
6300,5900,4500,37170000,2,36006,9003,1,736560000,736560000,13501,4500,9001,4500,0,1,4502,32095582,32.095582
6300,5900,4900,37170000,2,39206,9803,1,775600000,775600000,14701,4900,9801,4900,0,1,4902,34389080,34.38908
6300,5900,4900,37170000,2,39206,9803,1,775600000,775600000,14701,4900,9801,4900,0,1,4902,35563516,35.563516
6300,5900,4900,37170000,2,39206,9803,1,775600000,775600000,14701,4900,9801,4900,0,1,4902,33548508,33.548508
6300,5900,4900,37170000,2,39206,9803,1,775600000,775600000,14701,4900,9801,4900,0,1,4902,35203801,35.203801
6300,5900,4900,37170000,2,39206,9803,1,775600000,775600000,14701,4900,9801,4900,0,1,4902,34048757,34.048757
6300,5900,4900,37170000,2,39206,9803,1,775600000,775600000,14701,4900,9801,4900,0,1,4902,34073940,34.07394
6300,5900,4900,37170000,2,39206,9803,1,775600000,775600000,14701,4900,9801,4900,0,1,4902,34893364,34.893364
6300,5900,5300,37170000,2,42406,10603,1,814640000,814640000,15901,5300,10601,5300,0,1,5302,37147937,37.147937
6300,5900,5300,37170000,2,42406,10603,1,814640000,814640000,15901,5300,10601,5300,0,1,5302,38470915,38.470915
6300,5900,5300,37170000,2,42406,10603,1,814640000,814640000,15901,5300,10601,5300,0,1,5302,36473010,36.47301
6300,5900,5300,37170000,2,42406,10603,1,814640000,814640000,15901,5300,10601,5300,0,1,5302,37939073,37.939073
6300,5900,5300,37170000,2,42406,10603,1,814640000,814640000,15901,5300,10601,5300,0,1,5302,36886786,36.886786
6300,5900,5300,37170000,2,42406,10603,1,814640000,814640000,15901,5300,10601,5300,0,1,5302,36745760,36.74576
6300,5900,5300,37170000,2,42406,10603,1,814640000,814640000,15901,5300,10601,5300,0,1,5302,37748717,37.748717
6300,5900,5700,37170000,2,45606,11403,1,853680000,853680000,17101,5700,11401,5700,0,1,5702,39853495,39.853495
6300,5900,5700,37170000,2,45606,11403,1,853680000,853680000,17101,5700,11401,5700,0,1,5702,41274263,41.274263
6300,5900,5700,37170000,2,45606,11403,1,853680000,853680000,17101,5700,11401,5700,0,1,5702,39096321,39.096321
6300,5900,5700,37170000,2,45606,11403,1,853680000,853680000,17101,5700,11401,5700,0,1,5702,40804828,40.804828
6300,5900,5700,37170000,2,45606,11403,1,853680000,853680000,17101,5700,11401,5700,0,1,5702,39520207,39.520207
6300,5900,5700,37170000,2,45606,11403,1,853680000,853680000,17101,5700,11401,5700,0,1,5702,39460791,39.460791
6300,5900,5700,37170000,2,45606,11403,1,853680000,853680000,17101,5700,11401,5700,0,1,5702,40588323,40.588323
6300,56300,5900,354690000,2,47206,11803,1,5792240000,5792240000,17701,5900,11801,5900,0,1,5902,96582620,96.58262
6300,56300,5900,354690000,2,47206,11803,1,5792240000,5792240000,17701,5900,11801,5900,0,1,5902,41886120,41.88612
6300,56300,5900,354690000,2,47206,11803,1,5792240000,5792240000,17701,5900,11801,5900,0,1,5902,43980351,43.980351
6300,56300,5900,354690000,2,47206,11803,1,5792240000,5792240000,17701,5900,11801,5900,0,1,5902,41951139,41.951139
6300,56300,5900,354690000,2,47206,11803,1,5792240000,5792240000,17701,5900,11801,5900,0,1,5902,44090041,44.090041
6300,56300,5900,354690000,2,47206,11803,1,5792240000,5792240000,17701,5900,11801,5900,0,1,5902,61537042,61.537042
6300,56300,5900,354690000,2,47206,11803,1,5792240000,5792240000,17701,5900,11801,5900,0,1,5902,41859847,41.859847
6300,5500,500,34650000,2,4006,1003,1,324400000,324400000,1501,500,1001,500,0,1,502,3685811,3.685811
6300,5500,500,34650000,2,4006,1003,1,324400000,324400000,1501,500,1001,500,0,1,502,3735512,3.735512
6300,5500,500,34650000,2,4006,1003,1,324400000,324400000,1501,500,1001,500,0,1,502,3598689,3.598689
6300,5500,500,34650000,2,4006,1003,1,324400000,324400000,1501,500,1001,500,0,1,502,3769017,3.769017
6300,5500,500,34650000,2,4006,1003,1,324400000,324400000,1501,500,1001,500,0,1,502,3662052,3.662052
6300,5500,500,34650000,2,4006,1003,1,324400000,324400000,1501,500,1001,500,0,1,502,3685961,3.685961
6300,5500,500,34650000,2,4006,1003,1,324400000,324400000,1501,500,1001,500,0,1,502,3687365,3.687365
6300,5500,900,34650000,2,7206,1803,1,362160000,362160000,2701,900,1801,900,0,1,902,6008660,6.00866
6300,5500,900,34650000,2,7206,1803,1,362160000,362160000,2701,900,1801,900,0,1,902,6240975,6.240975
6300,5500,900,34650000,2,7206,1803,1,362160000,362160000,2701,900,1801,900,0,1,902,5985154,5.985154
6300,5500,900,34650000,2,7206,1803,1,362160000,362160000,2701,900,1801,900,0,1,902,6279573,6.279573
6300,5500,900,34650000,2,7206,1803,1,362160000,362160000,2701,900,1801,900,0,1,902,6085256,6.085256
6300,5500,900,34650000,2,7206,1803,1,362160000,362160000,2701,900,1801,900,0,1,902,6009215,6.009215
6300,5500,900,34650000,2,7206,1803,1,362160000,362160000,2701,900,1801,900,0,1,902,6186535,6.186535
6300,5500,1300,34650000,2,10406,2603,1,399920000,399920000,3901,1300,2601,1300,0,1,1302,8683944,8.683944
6300,5500,1300,34650000,2,10406,2603,1,399920000,399920000,3901,1300,2601,1300,0,1,1302,8969444,8.969444
6300,5500,1300,34650000,2,10406,2603,1,399920000,399920000,3901,1300,2601,1300,0,1,1302,8660429,8.660429
6300,5500,1300,34650000,2,10406,2603,1,399920000,399920000,3901,1300,2601,1300,0,1,1302,9054366,9.054366
6300,5500,1300,34650000,2,10406,2603,1,399920000,399920000,3901,1300,2601,1300,0,1,1302,8777733,8.777733
6300,5500,1300,34650000,2,10406,2603,1,399920000,399920000,3901,1300,2601,1300,0,1,1302,8684514,8.684514
6300,5500,1300,34650000,2,10406,2603,1,399920000,399920000,3901,1300,2601,1300,0,1,1302,8919874,8.919874
6300,5500,1700,34650000,2,13606,3403,1,437680000,437680000,5101,1700,3401,1700,0,1,1702,11181652,11.181652
6300,5500,1700,34650000,2,13606,3403,1,437680000,437680000,5101,1700,3401,1700,0,1,1702,11501727,11.501727
6300,5500,1700,34650000,2,13606,3403,1,437680000,437680000,5101,1700,3401,1700,0,1,1702,11205035,11.205035
6300,5500,1700,34650000,2,13606,3403,1,437680000,437680000,5101,1700,3401,1700,0,1,1702,11600750,11.60075
6300,5500,1700,34650000,2,13606,3403,1,437680000,437680000,5101,1700,3401,1700,0,1,1702,11295067,11.295067
6300,5500,1700,34650000,2,13606,3403,1,437680000,437680000,5101,1700,3401,1700,0,1,1702,11136771,11.136771
6300,5500,1700,34650000,2,13606,3403,1,437680000,437680000,5101,1700,3401,1700,0,1,1702,11532022,11.532022
6300,5500,2100,34650000,2,16806,4203,1,475440000,475440000,6301,2100,4201,2100,0,1,2102,13510403,13.510403
6300,5500,2100,34650000,2,16806,4203,1,475440000,475440000,6301,2100,4201,2100,0,1,2102,14267236,14.267236
6300,5500,2100,34650000,2,16806,4203,1,475440000,475440000,6301,2100,4201,2100,0,1,2102,13557471,13.557471
6300,5500,2100,34650000,2,16806,4203,1,475440000,475440000,6301,2100,4201,2100,0,1,2102,14384778,14.384778
6300,5500,2100,34650000,2,16806,4203,1,475440000,475440000,6301,2100,4201,2100,0,1,2102,13761460,13.76146
6300,5500,2100,34650000,2,16806,4203,1,475440000,475440000,6301,2100,4201,2100,0,1,2102,13533885,13.533885
6300,5500,2100,34650000,2,16806,4203,1,475440000,475440000,6301,2100,4201,2100,0,1,2102,14009575,14.009575
6300,5500,2500,34650000,2,20006,5003,1,513200000,513200000,7501,2500,5001,2500,0,1,2502,16205032,16.205032
6300,5500,2500,34650000,2,20006,5003,1,513200000,513200000,7501,2500,5001,2500,0,1,2502,16934815,16.934815
6300,5500,2500,34650000,2,20006,5003,1,513200000,513200000,7501,2500,5001,2500,0,1,2502,16237665,16.237665
6300,5500,2500,34650000,2,20006,5003,1,513200000,513200000,7501,2500,5001,2500,0,1,2502,17009114,17.009114
6300,5500,2500,34650000,2,20006,5003,1,513200000,513200000,7501,2500,5001,2500,0,1,2502,16418762,16.418762
6300,5500,2500,34650000,2,20006,5003,1,513200000,513200000,7501,2500,5001,2500,0,1,2502,16295600,16.2956
6300,5500,2500,34650000,2,20006,5003,1,513200000,513200000,7501,2500,5001,2500,0,1,2502,16759592,16.759592
6300,5500,2900,34650000,2,23206,5803,1,550960000,550960000,8701,2900,5801,2900,0,1,2902,18742055,18.742055
6300,5500,2900,34650000,2,23206,5803,1,550960000,550960000,8701,2900,5801,2900,0,1,2902,19575487,19.575487
6300,5500,2900,34650000,2,23206,5803,1,550960000,550960000,8701,2900,5801,2900,0,1,2902,18717728,18.717728
6300,5500,2900,34650000,2,23206,5803,1,550960000,550960000,8701,2900,5801,2900,0,1,2902,19702498,19.702498
6300,5500,2900,34650000,2,23206,5803,1,550960000,550960000,8701,2900,5801,2900,0,1,2902,18865656,18.865656
6300,5500,2900,34650000,2,23206,5803,1,550960000,550960000,8701,2900,5801,2900,0,1,2902,18741396,18.741396
6300,5500,2900,34650000,2,23206,5803,1,550960000,550960000,8701,2900,5801,2900,0,1,2902,19340271,19.340271
6300,5500,3300,34650000,2,26406,6603,1,588720000,588720000,9901,3300,6601,3300,0,1,3302,21293895,21.293895
6300,5500,3300,34650000,2,26406,6603,1,588720000,588720000,9901,3300,6601,3300,0,1,3302,22270154,22.270154
6300,5500,3300,34650000,2,26406,6603,1,588720000,588720000,9901,3300,6601,3300,0,1,3302,21246654,21.246654
6300,5500,3300,34650000,2,26406,6603,1,588720000,588720000,9901,3300,6601,3300,0,1,3302,22374611,22.374611
6300,5500,3300,34650000,2,26406,6603,1,588720000,588720000,9901,3300,6601,3300,0,1,3302,21418927,21.418927
6300,5500,3300,34650000,2,26406,6603,1,588720000,588720000,9901,3300,6601,3300,0,1,3302,21270251,21.270251
6300,5500,3300,34650000,2,26406,6603,1,588720000,588720000,9901,3300,6601,3300,0,1,3302,21950849,21.950849
6300,5500,3700,34650000,2,29606,7403,1,626480000,626480000,11101,3700,7401,3700,0,1,3702,23785464,23.785464
6300,5500,3700,34650000,2,29606,7403,1,626480000,626480000,11101,3700,7401,3700,0,1,3702,24910220,24.91022
6300,5500,3700,34650000,2,29606,7403,1,626480000,626480000,11101,3700,7401,3700,0,1,3702,23832412,23.832412
6300,5500,3700,34650000,2,29606,7403,1,626480000,626480000,11101,3700,7401,3700,0,1,3702,25042821,25.042821
6300,5500,3700,34650000,2,29606,7403,1,626480000,626480000,11101,3700,7401,3700,0,1,3702,24017664,24.017664
6300,5500,3700,34650000,2,29606,7403,1,626480000,626480000,11101,3700,7401,3700,0,1,3702,23809115,23.809115
6300,5500,3700,34650000,2,29606,7403,1,626480000,626480000,11101,3700,7401,3700,0,1,3702,24582926,24.582926
6300,5500,4100,34650000,2,32806,8203,1,664240000,664240000,12301,4100,8201,4100,0,1,4102,26297908,26.297908
6300,5500,4100,34650000,2,32806,8203,1,664240000,664240000,12301,4100,8201,4100,0,1,4102,27562640,27.56264
6300,5500,4100,34650000,2,32806,8203,1,664240000,664240000,12301,4100,8201,4100,0,1,4102,26337842,26.337842
6300,5500,4100,34650000,2,32806,8203,1,664240000,664240000,12301,4100,8201,4100,0,1,4102,27707588,27.707588
6300,5500,4100,34650000,2,32806,8203,1,664240000,664240000,12301,4100,8201,4100,0,1,4102,26508944,26.508944
6300,5500,4100,34650000,2,32806,8203,1,664240000,664240000,12301,4100,8201,4100,0,1,4102,26299261,26.299261
6300,5500,4100,34650000,2,32806,8203,1,664240000,664240000,12301,4100,8201,4100,0,1,4102,27207455,27.207455
6300,5500,4500,34650000,2,36006,9003,1,702000000,702000000,13501,4500,9001,4500,0,1,4502,28863498,28.863498
6300,5500,4500,34650000,2,36006,9003,1,702000000,702000000,13501,4500,9001,4500,0,1,4502,30238787,30.238787
6300,5500,4500,34650000,2,36006,9003,1,702000000,702000000,13501,4500,9001,4500,0,1,4502,28909911,28.909911
6300,5500,4500,34650000,2,36006,9003,1,702000000,702000000,13501,4500,9001,4500,0,1,4502,30404516,30.404516
6300,5500,4500,34650000,2,36006,9003,1,702000000,702000000,13501,4500,9001,4500,0,1,4502,29105837,29.105837
6300,5500,4500,34650000,2,36006,9003,1,702000000,702000000,13501,4500,9001,4500,0,1,4502,28819361,28.819361
6300,5500,4500,34650000,2,36006,9003,1,702000000,702000000,13501,4500,9001,4500,0,1,4502,29878778,29.878778
6300,5500,4900,34650000,2,39206,9803,1,739760000,739760000,14701,4900,9801,4900,0,1,4902,31425689,31.425689
6300,5500,4900,34650000,2,39206,9803,1,739760000,739760000,14701,4900,9801,4900,0,1,4902,32912061,32.912061
6300,5500,4900,34650000,2,39206,9803,1,739760000,739760000,14701,4900,9801,4900,0,1,4902,31467129,31.467129
6300,5500,4900,34650000,2,39206,9803,1,739760000,739760000,14701,4900,9801,4900,0,1,4902,33056214,33.056214
6300,5500,4900,34650000,2,39206,9803,1,739760000,739760000,14701,4900,9801,4900,0,1,4902,31681122,31.681122
6300,5500,4900,34650000,2,39206,9803,1,739760000,739760000,14701,4900,9801,4900,0,1,4902,31384128,31.384128
6300,5500,4900,34650000,2,39206,9803,1,739760000,739760000,14701,4900,9801,4900,0,1,4902,32542416,32.542416
6300,5500,5300,34650000,2,42406,10603,1,777520000,777520000,15901,5300,10601,5300,0,1,5302,33979477,33.979477
6300,5500,5300,34650000,2,42406,10603,1,777520000,777520000,15901,5300,10601,5300,0,1,5302,35589106,35.589106
6300,5500,5300,34650000,2,42406,10603,1,777520000,777520000,15901,5300,10601,5300,0,1,5302,34023408,34.023408
6300,5500,5300,34650000,2,42406,10603,1,777520000,777520000,15901,5300,10601,5300,0,1,5302,35805775,35.805775
6300,5500,5300,34650000,2,42406,10603,1,777520000,777520000,15901,5300,10601,5300,0,1,5302,34213582,34.213582
6300,5500,5300,34650000,2,42406,10603,1,777520000,777520000,15901,5300,10601,5300,0,1,5302,33955316,33.955316
6300,5500,5300,34650000,2,42406,10603,1,777520000,777520000,15901,5300,10601,5300,0,1,5302,35127807,35.127807
6300,5500,5700,34650000,2,45606,11403,1,815280000,815280000,17101,5700,11401,5700,0,1,5702,36482853,36.482853
6300,5500,5700,34650000,2,45606,11403,1,815280000,815280000,17101,5700,11401,5700,0,1,5702,38227008,38.227008
6300,5500,5700,34650000,2,45606,11403,1,815280000,815280000,17101,5700,11401,5700,0,1,5702,36594441,36.594441
6300,5500,5700,34650000,2,45606,11403,1,815280000,815280000,17101,5700,11401,5700,0,1,5702,38430306,38.430306
6300,5500,5700,34650000,2,45606,11403,1,815280000,815280000,17101,5700,11401,5700,0,1,5702,36849787,36.849787
6300,5500,5700,34650000,2,45606,11403,1,815280000,815280000,17101,5700,11401,5700,0,1,5702,36507007,36.507007
6300,5500,5700,34650000,2,45606,11403,1,815280000,815280000,17101,5700,11401,5700,0,1,5702,37826331,37.826331
6300,5500,6100,34650000,2,48806,12203,1,853040000,853040000,18301,6100,12201,6100,0,1,6102,39081671,39.081671
6300,5500,6100,34650000,2,48806,12203,1,853040000,853040000,18301,6100,12201,6100,0,1,6102,40997678,40.997678
6300,5500,6100,34650000,2,48806,12203,1,853040000,853040000,18301,6100,12201,6100,0,1,6102,39156990,39.15699
6300,5500,6100,34650000,2,48806,12203,1,853040000,853040000,18301,6100,12201,6100,0,1,6102,41088185,41.088185
6300,5500,6100,34650000,2,48806,12203,1,853040000,853040000,18301,6100,12201,6100,0,1,6102,39321167,39.321167
6300,5500,6100,34650000,2,48806,12203,1,853040000,853040000,18301,6100,12201,6100,0,1,6102,39180592,39.180592
6300,5500,6100,34650000,2,48806,12203,1,853040000,853040000,18301,6100,12201,6100,0,1,6102,40452588,40.452588
6300,5500,6500,34650000,2,52006,13003,1,890800000,890800000,19501,6500,13001,6500,0,1,6502,41617197,41.617197
6300,5500,6500,34650000,2,52006,13003,1,890800000,890800000,19501,6500,13001,6500,0,1,6502,43808885,43.808885
6300,5500,6500,34650000,2,52006,13003,1,890800000,890800000,19501,6500,13001,6500,0,1,6502,41757257,41.757257
6300,5500,6500,34650000,2,52006,13003,1,890800000,890800000,19501,6500,13001,6500,0,1,6502,43783924,43.783924
6300,5500,6500,34650000,2,52006,13003,1,890800000,890800000,19501,6500,13001,6500,0,1,6502,41848110,41.84811
6300,5500,6500,34650000,2,52006,13003,1,890800000,890800000,19501,6500,13001,6500,0,1,6502,41708582,41.708582
6300,5500,6500,34650000,2,52006,13003,1,890800000,890800000,19501,6500,13001,6500,0,1,6502,43056437,43.056437
6300,5500,6900,34650000,2,55206,13803,1,928560000,928560000,20701,6900,13801,6900,0,1,6902,44247409,44.247409
6300,5500,6900,34650000,2,55206,13803,1,928560000,928560000,20701,6900,13801,6900,0,1,6902,46548955,46.548955
6300,5500,6900,34650000,2,55206,13803,1,928560000,928560000,20701,6900,13801,6900,0,1,6902,44379654,44.379654
6300,5500,6900,34650000,2,55206,13803,1,928560000,928560000,20701,6900,13801,6900,0,1,6902,46500335,46.500335
6300,5500,6900,34650000,2,55206,13803,1,928560000,928560000,20701,6900,13801,6900,0,1,6902,44474936,44.474936
6300,5500,6900,34650000,2,55206,13803,1,928560000,928560000,20701,6900,13801,6900,0,1,6902,44297701,44.297701
6300,5500,6900,34650000,2,55206,13803,1,928560000,928560000,20701,6900,13801,6900,0,1,6902,45916640,45.91664
6300,5100,500,32130000,2,4006,1003,1,302640000,302640000,1501,500,1001,500,0,1,502,3422409,3.422409
6300,5100,500,32130000,2,4006,1003,1,302640000,302640000,1501,500,1001,500,0,1,502,3447389,3.447389
6300,5100,500,32130000,2,4006,1003,1,302640000,302640000,1501,500,1001,500,0,1,502,3400214,3.400214
6300,5100,500,32130000,2,4006,1003,1,302640000,302640000,1501,500,1001,500,0,1,502,3486121,3.486121
6300,5100,500,32130000,2,4006,1003,1,302640000,302640000,1501,500,1001,500,0,1,502,3357676,3.357676
6300,5100,500,32130000,2,4006,1003,1,302640000,302640000,1501,500,1001,500,0,1,502,3508939,3.508939
6300,5100,500,32130000,2,4006,1003,1,302640000,302640000,1501,500,1001,500,0,1,502,3532625,3.532625
6300,5100,900,32130000,2,7206,1803,1,339120000,339120000,2701,900,1801,900,0,1,902,5552330,5.55233
6300,5100,900,32130000,2,7206,1803,1,339120000,339120000,2701,900,1801,900,0,1,902,5798652,5.798652
6300,5100,900,32130000,2,7206,1803,1,339120000,339120000,2701,900,1801,900,0,1,902,5573998,5.573998
6300,5100,900,32130000,2,7206,1803,1,339120000,339120000,2701,900,1801,900,0,1,902,5828703,5.828703
6300,5100,900,32130000,2,7206,1803,1,339120000,339120000,2701,900,1801,900,0,1,902,5625487,5.625487
6300,5100,900,32130000,2,7206,1803,1,339120000,339120000,2701,900,1801,900,0,1,902,5603300,5.6033
6300,5100,900,32130000,2,7206,1803,1,339120000,339120000,2701,900,1801,900,0,1,902,5775592,5.775592
6300,5100,1300,32130000,2,10406,2603,1,375600000,375600000,3901,1300,2601,1300,0,1,1302,8047013,8.047013
6300,5100,1300,32130000,2,10406,2603,1,375600000,375600000,3901,1300,2601,1300,0,1,1302,8336053,8.336053
6300,5100,1300,32130000,2,10406,2603,1,375600000,375600000,3901,1300,2601,1300,0,1,1302,8068785,8.068785
6300,5100,1300,32130000,2,10406,2603,1,375600000,375600000,3901,1300,2601,1300,0,1,1302,8428538,8.428538
6300,5100,1300,32130000,2,10406,2603,1,375600000,375600000,3901,1300,2601,1300,0,1,1302,8090958,8.090958
6300,5100,1300,32130000,2,10406,2603,1,375600000,375600000,3901,1300,2601,1300,0,1,1302,8117468,8.117468
6300,5100,1300,32130000,2,10406,2603,1,375600000,375600000,3901,1300,2601,1300,0,1,1302,8291310,8.29131
6300,5100,1700,32130000,2,13606,3403,1,412080000,412080000,5101,1700,3401,1700,0,1,1702,10191682,10.191682
6300,5100,1700,32130000,2,13606,3403,1,412080000,412080000,5101,1700,3401,1700,0,1,1702,10675461,10.675461
6300,5100,1700,32130000,2,13606,3403,1,412080000,412080000,5101,1700,3401,1700,0,1,1702,10268749,10.268749
6300,5100,1700,32130000,2,13606,3403,1,412080000,412080000,5101,1700,3401,1700,0,1,1702,10790912,10.790912
6300,5100,1700,32130000,2,13606,3403,1,412080000,412080000,5101,1700,3401,1700,0,1,1702,10350912,10.350912
6300,5100,1700,32130000,2,13606,3403,1,412080000,412080000,5101,1700,3401,1700,0,1,1702,10247016,10.247016
6300,5100,1700,32130000,2,13606,3403,1,412080000,412080000,5101,1700,3401,1700,0,1,1702,10628132,10.628132
6300,5100,2100,32130000,2,16806,4203,1,448560000,448560000,6301,2100,4201,2100,0,1,2102,12743704,12.743704
6300,5100,2100,32130000,2,16806,4203,1,448560000,448560000,6301,2100,4201,2100,0,1,2102,13202527,13.202527
6300,5100,2100,32130000,2,16806,4203,1,448560000,448560000,6301,2100,4201,2100,0,1,2102,12744112,12.744112
6300,5100,2100,32130000,2,16806,4203,1,448560000,448560000,6301,2100,4201,2100,0,1,2102,13308190,13.30819
6300,5100,2100,32130000,2,16806,4203,1,448560000,448560000,6301,2100,4201,2100,0,1,2102,12790773,12.790773
6300,5100,2100,32130000,2,16806,4203,1,448560000,448560000,6301,2100,4201,2100,0,1,2102,12720844,12.720844
6300,5100,2100,32130000,2,16806,4203,1,448560000,448560000,6301,2100,4201,2100,0,1,2102,13146708,13.146708
6300,5100,2500,32130000,2,20006,5003,1,485040000,485040000,7501,2500,5001,2500,0,1,2502,15085774,15.085774
6300,5100,2500,32130000,2,20006,5003,1,485040000,485040000,7501,2500,5001,2500,0,1,2502,15657489,15.657489
6300,5100,2500,32130000,2,20006,5003,1,485040000,485040000,7501,2500,5001,2500,0,1,2502,15107605,15.107605
6300,5100,2500,32130000,2,20006,5003,1,485040000,485040000,7501,2500,5001,2500,0,1,2502,15761181,15.761181
6300,5100,2500,32130000,2,20006,5003,1,485040000,485040000,7501,2500,5001,2500,0,1,2502,15233014,15.233014
6300,5100,2500,32130000,2,20006,5003,1,485040000,485040000,7501,2500,5001,2500,0,1,2502,15055496,15.055496
6300,5100,2500,32130000,2,20006,5003,1,485040000,485040000,7501,2500,5001,2500,0,1,2502,15583894,15.583894
6300,5100,2900,32130000,2,23206,5803,1,521520000,521520000,8701,2900,5801,2900,0,1,2902,17394432,17.394432
6300,5100,2900,32130000,2,23206,5803,1,521520000,521520000,8701,2900,5801,2900,0,1,2902,18150699,18.150699
6300,5100,2900,32130000,2,23206,5803,1,521520000,521520000,8701,2900,5801,2900,0,1,2902,17395028,17.395028
6300,5100,2900,32130000,2,23206,5803,1,521520000,521520000,8701,2900,5801,2900,0,1,2902,18271544,18.271544
6300,5100,2900,32130000,2,23206,5803,1,521520000,521520000,8701,2900,5801,2900,0,1,2902,17449886,17.449886
6300,5100,2900,32130000,2,23206,5803,1,521520000,521520000,8701,2900,5801,2900,0,1,2902,17372516,17.372516
6300,5100,2900,32130000,2,23206,5803,1,521520000,521520000,8701,2900,5801,2900,0,1,2902,17996707,17.996707
6300,5100,3300,32130000,2,26406,6603,1,558000000,558000000,9901,3300,6601,3300,0,1,3302,19761203,19.761203
6300,5100,3300,32130000,2,26406,6603,1,558000000,558000000,9901,3300,6601,3300,0,1,3302,20621851,20.621851
6300,5100,3300,32130000,2,26406,6603,1,558000000,558000000,9901,3300,6601,3300,0,1,3302,19739365,19.739365
6300,5100,3300,32130000,2,26406,6603,1,558000000,558000000,9901,3300,6601,3300,0,1,3302,20741769,20.741769
6300,5100,3300,32130000,2,26406,6603,1,558000000,558000000,9901,3300,6601,3300,0,1,3302,19835230,19.83523
6300,5100,3300,32130000,2,26406,6603,1,558000000,558000000,9901,3300,6601,3300,0,1,3302,19700523,19.700523
6300,5100,3300,32130000,2,26406,6603,1,558000000,558000000,9901,3300,6601,3300,0,1,3302,20465984,20.465984
6300,5100,3700,32130000,2,29606,7403,1,594480000,594480000,11101,3700,7401,3700,0,1,3702,22105172,22.105172
6300,5100,3700,32130000,2,29606,7403,1,594480000,594480000,11101,3700,7401,3700,0,1,3702,23099069,23.099069
6300,5100,3700,32130000,2,29606,7403,1,594480000,594480000,11101,3700,7401,3700,0,1,3702,22083317,22.083317
6300,5100,3700,32130000,2,29606,7403,1,594480000,594480000,11101,3700,7401,3700,0,1,3702,23196631,23.196631
6300,5100,3700,32130000,2,29606,7403,1,594480000,594480000,11101,3700,7401,3700,0,1,3702,22211691,22.211691
6300,5100,3700,32130000,2,29606,7403,1,594480000,594480000,11101,3700,7401,3700,0,1,3702,22000004,22.000004
6300,5100,3700,32130000,2,29606,7403,1,594480000,594480000,11101,3700,7401,3700,0,1,3702,22893220,22.89322
6300,5100,4100,32130000,2,32806,8203,1,630960000,630960000,12301,4100,8201,4100,0,1,4102,24417302,24.417302
6300,5100,4100,32130000,2,32806,8203,1,630960000,630960000,12301,4100,8201,4100,0,1,4102,25525994,25.525994
6300,5100,4100,32130000,2,32806,8203,1,630960000,630960000,12301,4100,8201,4100,0,1,4102,24439163,24.439163
6300,5100,4100,32130000,2,32806,8203,1,630960000,630960000,12301,4100,8201,4100,0,1,4102,25676563,25.676563
6300,5100,4100,32130000,2,32806,8203,1,630960000,630960000,12301,4100,8201,4100,0,1,4102,24490308,24.490308
6300,5100,4100,32130000,2,32806,8203,1,630960000,630960000,12301,4100,8201,4100,0,1,4102,24395421,24.395421
6300,5100,4100,32130000,2,32806,8203,1,630960000,630960000,12301,4100,8201,4100,0,1,4102,25328828,25.328828
6300,5100,4500,32130000,2,36006,9003,1,667440000,667440000,13501,4500,9001,4500,0,1,4502,26839252,26.839252
6300,5100,4500,32130000,2,36006,9003,1,667440000,667440000,13501,4500,9001,4500,0,1,4502,28097604,28.097604
6300,5100,4500,32130000,2,36006,9003,1,667440000,667440000,13501,4500,9001,4500,0,1,4502,26876426,26.876426
6300,5100,4500,32130000,2,36006,9003,1,667440000,667440000,13501,4500,9001,4500,0,1,4502,28121072,28.121072
6300,5100,4500,32130000,2,36006,9003,1,667440000,667440000,13501,4500,9001,4500,0,1,4502,26950125,26.950125
6300,5100,4500,32130000,2,36006,9003,1,667440000,667440000,13501,4500,9001,4500,0,1,4502,26710922,26.710922
6300,5100,4500,32130000,2,36006,9003,1,667440000,667440000,13501,4500,9001,4500,0,1,4502,27795356,27.795356
6300,5100,4900,32130000,2,39206,9803,1,703920000,703920000,14701,4900,9801,4900,0,1,4902,29192934,29.192934
6300,5100,4900,32130000,2,39206,9803,1,703920000,703920000,14701,4900,9801,4900,0,1,4902,30558877,30.558877
6300,5100,4900,32130000,2,39206,9803,1,703920000,703920000,14701,4900,9801,4900,0,1,4902,29214758,29.214758
6300,5100,4900,32130000,2,39206,9803,1,703920000,703920000,14701,4900,9801,4900,0,1,4902,30633348,30.633348
6300,5100,4900,32130000,2,39206,9803,1,703920000,703920000,14701,4900,9801,4900,0,1,4902,29300746,29.300746
6300,5100,4900,32130000,2,39206,9803,1,703920000,703920000,14701,4900,9801,4900,0,1,4902,29081779,29.081779
6300,5100,4900,32130000,2,39206,9803,1,703920000,703920000,14701,4900,9801,4900,0,1,4902,30234142,30.234142
6300,5100,5300,32130000,2,42406,10603,1,740400000,740400000,15901,5300,10601,5300,0,1,5302,31503049,31.503049
6300,5100,5300,32130000,2,42406,10603,1,740400000,740400000,15901,5300,10601,5300,0,1,5302,32977738,32.977738
6300,5100,5300,32130000,2,42406,10603,1,740400000,740400000,15901,5300,10601,5300,0,1,5302,31542846,31.542846
6300,5100,5300,32130000,2,42406,10603,1,740400000,740400000,15901,5300,10601,5300,0,1,5302,33185891,33.185891
6300,5100,5300,32130000,2,42406,10603,1,740400000,740400000,15901,5300,10601,5300,0,1,5302,31738271,31.738271
6300,5100,5300,32130000,2,42406,10603,1,740400000,740400000,15901,5300,10601,5300,0,1,5302,31479638,31.479638
6300,5100,5300,32130000,2,42406,10603,1,740400000,740400000,15901,5300,10601,5300,0,1,5302,32700032,32.700032
6300,5100,5700,32130000,2,45606,11403,1,776880000,776880000,17101,5700,11401,5700,0,1,5702,33847137,33.847137
6300,5100,5700,32130000,2,45606,11403,1,776880000,776880000,17101,5700,11401,5700,0,1,5702,35477976,35.477976
6300,5100,5700,32130000,2,45606,11403,1,776880000,776880000,17101,5700,11401,5700,0,1,5702,33911980,33.91198
6300,5100,5700,32130000,2,45606,11403,1,776880000,776880000,17101,5700,11401,5700,0,1,5702,35715973,35.715973
6300,5100,5700,32130000,2,45606,11403,1,776880000,776880000,17101,5700,11401,5700,0,1,5702,34029644,34.029644
6300,5100,5700,32130000,2,45606,11403,1,776880000,776880000,17101,5700,11401,5700,0,1,5702,33934943,33.934943
6300,5100,5700,32130000,2,45606,11403,1,776880000,776880000,17101,5700,11401,5700,0,1,5702,35163177,35.163177
6300,5100,6100,32130000,2,48806,12203,1,813360000,813360000,18301,6100,12201,6100,0,1,6102,36255252,36.255252
6300,5100,6100,32130000,2,48806,12203,1,813360000,813360000,18301,6100,12201,6100,0,1,6102,38017651,38.017651
6300,5100,6100,32130000,2,48806,12203,1,813360000,813360000,18301,6100,12201,6100,0,1,6102,36297835,36.297835
6300,5100,6100,32130000,2,48806,12203,1,813360000,813360000,18301,6100,12201,6100,0,1,6102,38148216,38.148216
6300,5100,6100,32130000,2,48806,12203,1,813360000,813360000,18301,6100,12201,6100,0,1,6102,36505194,36.505194
6300,5100,6100,32130000,2,48806,12203,1,813360000,813360000,18301,6100,12201,6100,0,1,6102,36233237,36.233237
6300,5100,6100,32130000,2,48806,12203,1,813360000,813360000,18301,6100,12201,6100,0,1,6102,37497276,37.497276
6300,5100,6500,32130000,2,52006,13003,1,849840000,849840000,19501,6500,13001,6500,0,1,6502,38607280,38.60728
6300,5100,6500,32130000,2,52006,13003,1,849840000,849840000,19501,6500,13001,6500,0,1,6502,40520969,40.520969
6300,5100,6500,32130000,2,52006,13003,1,849840000,849840000,19501,6500,13001,6500,0,1,6502,38686015,38.686015
6300,5100,6500,32130000,2,52006,13003,1,849840000,849840000,19501,6500,13001,6500,0,1,6502,40677153,40.677153
6300,5100,6500,32130000,2,52006,13003,1,849840000,849840000,19501,6500,13001,6500,0,1,6502,38862666,38.862666
6300,5100,6500,32130000,2,52006,13003,1,849840000,849840000,19501,6500,13001,6500,0,1,6502,38560350,38.56035
6300,5100,6500,32130000,2,52006,13003,1,849840000,849840000,19501,6500,13001,6500,0,1,6502,39989227,39.989227
6300,5100,6900,32130000,2,55206,13803,1,886320000,886320000,20701,6900,13801,6900,0,1,6902,40954645,40.954645
6300,5100,6900,32130000,2,55206,13803,1,886320000,886320000,20701,6900,13801,6900,0,1,6902,43105732,43.105732
6300,5100,6900,32130000,2,55206,13803,1,886320000,886320000,20701,6900,13801,6900,0,1,6902,41051263,41.051263
6300,5100,6900,32130000,2,55206,13803,1,886320000,886320000,20701,6900,13801,6900,0,1,6902,43160754,43.160754
6300,5100,6900,32130000,2,55206,13803,1,886320000,886320000,20701,6900,13801,6900,0,1,6902,41377581,41.377581
6300,5100,6900,32130000,2,55206,13803,1,886320000,886320000,20701,6900,13801,6900,0,1,6902,40930407,40.930407
6300,5100,6900,32130000,2,55206,13803,1,886320000,886320000,20701,6900,13801,6900,0,1,6902,42422525,42.422525
6300,4700,500,29610000,2,4006,1003,1,280880000,280880000,1501,500,1001,500,0,1,502,3138900,3.1389
6300,4700,500,29610000,2,4006,1003,1,280880000,280880000,1501,500,1001,500,0,1,502,3260538,3.260538
6300,4700,500,29610000,2,4006,1003,1,280880000,280880000,1501,500,1001,500,0,1,502,3118815,3.118815
6300,4700,500,29610000,2,4006,1003,1,280880000,280880000,1501,500,1001,500,0,1,502,3217578,3.217578
6300,4700,500,29610000,2,4006,1003,1,280880000,280880000,1501,500,1001,500,0,1,502,3238189,3.238189
6300,4700,500,29610000,2,4006,1003,1,280880000,280880000,1501,500,1001,500,0,1,502,3239121,3.239121
6300,4700,500,29610000,2,4006,1003,1,280880000,280880000,1501,500,1001,500,0,1,502,3169194,3.169194
6300,4700,900,29610000,2,7206,1803,1,316080000,316080000,2701,900,1801,900,0,1,902,5117608,5.117608
6300,4700,900,29610000,2,7206,1803,1,316080000,316080000,2701,900,1801,900,0,1,902,5349240,5.34924
6300,4700,900,29610000,2,7206,1803,1,316080000,316080000,2701,900,1801,900,0,1,902,5137726,5.137726
6300,4700,900,29610000,2,7206,1803,1,316080000,316080000,2701,900,1801,900,0,1,902,5380806,5.380806
6300,4700,900,29610000,2,7206,1803,1,316080000,316080000,2701,900,1801,900,0,1,902,5181357,5.181357
6300,4700,900,29610000,2,7206,1803,1,316080000,316080000,2701,900,1801,900,0,1,902,5138340,5.13834
6300,4700,900,29610000,2,7206,1803,1,316080000,316080000,2701,900,1801,900,0,1,902,5275129,5.275129
6300,4700,1300,29610000,2,10406,2603,1,351280000,351280000,3901,1300,2601,1300,0,1,1302,7434924,7.434924
6300,4700,1300,29610000,2,10406,2603,1,351280000,351280000,3901,1300,2601,1300,0,1,1302,7701632,7.701632
6300,4700,1300,29610000,2,10406,2603,1,351280000,351280000,3901,1300,2601,1300,0,1,1302,7410203,7.410203
6300,4700,1300,29610000,2,10406,2603,1,351280000,351280000,3901,1300,2601,1300,0,1,1302,7770055,7.770055
6300,4700,1300,29610000,2,10406,2603,1,351280000,351280000,3901,1300,2601,1300,0,1,1302,7496885,7.496885
6300,4700,1300,29610000,2,10406,2603,1,351280000,351280000,3901,1300,2601,1300,0,1,1302,7434370,7.43437
6300,4700,1300,29610000,2,10406,2603,1,351280000,351280000,3901,1300,2601,1300,0,1,1302,7614413,7.614413
6300,4700,1700,29610000,2,13606,3403,1,386480000,386480000,5101,1700,3401,1700,0,1,1702,9420054,9.420054
6300,4700,1700,29610000,2,13606,3403,1,386480000,386480000,5101,1700,3401,1700,0,1,1702,9837865,9.837865
6300,4700,1700,29610000,2,13606,3403,1,386480000,386480000,5101,1700,3401,1700,0,1,1702,9440267,9.440267
6300,4700,1700,29610000,2,13606,3403,1,386480000,386480000,5101,1700,3401,1700,0,1,1702,9915503,9.915503
6300,4700,1700,29610000,2,13606,3403,1,386480000,386480000,5101,1700,3401,1700,0,1,1702,9548679,9.548679
6300,4700,1700,29610000,2,13606,3403,1,386480000,386480000,5101,1700,3401,1700,0,1,1702,9440802,9.440802
6300,4700,1700,29610000,2,13606,3403,1,386480000,386480000,5101,1700,3401,1700,0,1,1702,9750966,9.750966
6300,4700,2100,29610000,2,16806,4203,1,421680000,421680000,6301,2100,4201,2100,0,1,2102,11740955,11.740955
6300,4700,2100,29610000,2,16806,4203,1,421680000,421680000,6301,2100,4201,2100,0,1,2102,12184176,12.184176
6300,4700,2100,29610000,2,16806,4203,1,421680000,421680000,6301,2100,4201,2100,0,1,2102,11761708,11.761708
6300,4700,2100,29610000,2,16806,4203,1,421680000,421680000,6301,2100,4201,2100,0,1,2102,12286094,12.286094
6300,4700,2100,29610000,2,16806,4203,1,421680000,421680000,6301,2100,4201,2100,0,1,2102,11815261,11.815261
6300,4700,2100,29610000,2,16806,4203,1,421680000,421680000,6301,2100,4201,2100,0,1,2102,11761157,11.761157
6300,4700,2100,29610000,2,16806,4203,1,421680000,421680000,6301,2100,4201,2100,0,1,2102,12099563,12.099563
6300,4700,2500,29610000,2,20006,5003,1,456880000,456880000,7501,2500,5001,2500,0,1,2502,13872382,13.872382
6300,4700,2500,29610000,2,20006,5003,1,456880000,456880000,7501,2500,5001,2500,0,1,2502,14480810,14.48081
6300,4700,2500,29610000,2,20006,5003,1,456880000,456880000,7501,2500,5001,2500,0,1,2502,13893857,13.893857
6300,4700,2500,29610000,2,20006,5003,1,456880000,456880000,7501,2500,5001,2500,0,1,2502,14550064,14.550064
6300,4700,2500,29610000,2,20006,5003,1,456880000,456880000,7501,2500,5001,2500,0,1,2502,13999539,13.999539
6300,4700,2500,29610000,2,20006,5003,1,456880000,456880000,7501,2500,5001,2500,0,1,2502,13893426,13.893426
6300,4700,2500,29610000,2,20006,5003,1,456880000,456880000,7501,2500,5001,2500,0,1,2502,14317906,14.317906
6300,4700,2900,29610000,2,23206,5803,1,492080000,492080000,8701,2900,5801,2900,0,1,2902,16050373,16.050373
6300,4700,2900,29610000,2,23206,5803,1,492080000,492080000,8701,2900,5801,2900,0,1,2902,16706245,16.706245
6300,4700,2900,29610000,2,23206,5803,1,492080000,492080000,8701,2900,5801,2900,0,1,2902,16091102,16.091102
6300,4700,2900,29610000,2,23206,5803,1,492080000,492080000,8701,2900,5801,2900,0,1,2902,16838449,16.838449
6300,4700,2900,29610000,2,23206,5803,1,492080000,492080000,8701,2900,5801,2900,0,1,2902,16111717,16.111717
6300,4700,2900,29610000,2,23206,5803,1,492080000,492080000,8701,2900,5801,2900,0,1,2902,16070560,16.07056
6300,4700,2900,29610000,2,23206,5803,1,492080000,492080000,8701,2900,5801,2900,0,1,2902,16571199,16.571199
6300,4700,3300,29610000,2,26406,6603,1,527280000,527280000,9901,3300,6601,3300,0,1,3302,18203520,18.20352
6300,4700,3300,29610000,2,26406,6603,1,527280000,527280000,9901,3300,6601,3300,0,1,3302,18988981,18.988981
6300,4700,3300,29610000,2,26406,6603,1,527280000,527280000,9901,3300,6601,3300,0,1,3302,18225136,18.225136
6300,4700,3300,29610000,2,26406,6603,1,527280000,527280000,9901,3300,6601,3300,0,1,3302,19115585,19.115585
6300,4700,3300,29610000,2,26406,6603,1,527280000,527280000,9901,3300,6601,3300,0,1,3302,18273362,18.273362
6300,4700,3300,29610000,2,26406,6603,1,527280000,527280000,9901,3300,6601,3300,0,1,3302,18223718,18.223718
6300,4700,3300,29610000,2,26406,6603,1,527280000,527280000,9901,3300,6601,3300,0,1,3302,18823442,18.823442
6300,4700,3700,29610000,2,29606,7403,1,562480000,562480000,11101,3700,7401,3700,0,1,3702,20385691,20.385691
6300,4700,3700,29610000,2,29606,7403,1,562480000,562480000,11101,3700,7401,3700,0,1,3702,21248142,21.248142
6300,4700,3700,29610000,2,29606,7403,1,562480000,562480000,11101,3700,7401,3700,0,1,3702,20386305,20.386305
6300,4700,3700,29610000,2,29606,7403,1,562480000,562480000,11101,3700,7401,3700,0,1,3702,21393465,21.393465
6300,4700,3700,29610000,2,29606,7403,1,562480000,562480000,11101,3700,7401,3700,0,1,3702,20429194,20.429194
6300,4700,3700,29610000,2,29606,7403,1,562480000,562480000,11101,3700,7401,3700,0,1,3702,20365341,20.365341
6300,4700,3700,29610000,2,29606,7403,1,562480000,562480000,11101,3700,7401,3700,0,1,3702,21058841,21.058841
6300,4700,4100,29610000,2,32806,8203,1,597680000,597680000,12301,4100,8201,4100,0,1,4102,22515772,22.515772
6300,4700,4100,29610000,2,32806,8203,1,597680000,597680000,12301,4100,8201,4100,0,1,4102,23475080,23.47508
6300,4700,4100,29610000,2,32806,8203,1,597680000,597680000,12301,4100,8201,4100,0,1,4102,22536092,22.536092
6300,4700,4100,29610000,2,32806,8203,1,597680000,597680000,12301,4100,8201,4100,0,1,4102,23652006,23.652006
6300,4700,4100,29610000,2,32806,8203,1,597680000,597680000,12301,4100,8201,4100,0,1,4102,22654651,22.654651
6300,4700,4100,29610000,2,32806,8203,1,597680000,597680000,12301,4100,8201,4100,0,1,4102,22536860,22.53686
6300,4700,4100,29610000,2,32806,8203,1,597680000,597680000,12301,4100,8201,4100,0,1,4102,23284925,23.284925
6300,4700,4500,29610000,2,36006,9003,1,632880000,632880000,13501,4500,9001,4500,0,1,4502,24720761,24.720761
6300,4700,4500,29610000,2,36006,9003,1,632880000,632880000,13501,4500,9001,4500,0,1,4502,25784405,25.784405
6300,4700,4500,29610000,2,36006,9003,1,632880000,632880000,13501,4500,9001,4500,0,1,4502,24700556,24.700556
6300,4700,4500,29610000,2,36006,9003,1,632880000,632880000,13501,4500,9001,4500,0,1,4502,25928859,25.928859
6300,4700,4500,29610000,2,36006,9003,1,632880000,632880000,13501,4500,9001,4500,0,1,4502,24862927,24.862927
6300,4700,4500,29610000,2,36006,9003,1,632880000,632880000,13501,4500,9001,4500,0,1,4502,24679782,24.679782
6300,4700,4500,29610000,2,36006,9003,1,632880000,632880000,13501,4500,9001,4500,0,1,4502,25536583,25.536583
6300,4700,4900,29610000,2,39206,9803,1,668080000,668080000,14701,4900,9801,4900,0,1,4902,26916452,26.916452
6300,4700,4900,29610000,2,39206,9803,1,668080000,668080000,14701,4900,9801,4900,0,1,4902,28091484,28.091484
6300,4700,4900,29610000,2,39206,9803,1,668080000,668080000,14701,4900,9801,4900,0,1,4902,26895975,26.895975
6300,4700,4900,29610000,2,39206,9803,1,668080000,668080000,14701,4900,9801,4900,0,1,4902,28237434,28.237434
6300,4700,4900,29610000,2,39206,9803,1,668080000,668080000,14701,4900,9801,4900,0,1,4902,27020131,27.020131
6300,4700,4900,29610000,2,39206,9803,1,668080000,668080000,14701,4900,9801,4900,0,1,4902,26860518,26.860518
6300,4700,4900,29610000,2,39206,9803,1,668080000,668080000,14701,4900,9801,4900,0,1,4902,27839073,27.839073
6300,4700,5300,29610000,2,42406,10603,1,703280000,703280000,15901,5300,10601,5300,0,1,5302,29041791,29.041791
6300,4700,5300,29610000,2,42406,10603,1,703280000,703280000,15901,5300,10601,5300,0,1,5302,30426479,30.426479
6300,4700,5300,29610000,2,42406,10603,1,703280000,703280000,15901,5300,10601,5300,0,1,5302,29061923,29.061923
6300,4700,5300,29610000,2,42406,10603,1,703280000,703280000,15901,5300,10601,5300,0,1,5302,30514464,30.514464
6300,4700,5300,29610000,2,42406,10603,1,703280000,703280000,15901,5300,10601,5300,0,1,5302,29239196,29.239196
6300,4700,5300,29610000,2,42406,10603,1,703280000,703280000,15901,5300,10601,5300,0,1,5302,29021501,29.021501
6300,4700,5300,29610000,2,42406,10603,1,703280000,703280000,15901,5300,10601,5300,0,1,5302,30096724,30.096724
6300,4700,5700,29610000,2,45606,11403,1,738480000,738480000,17101,5700,11401,5700,0,1,5702,31209565,31.209565
6300,4700,5700,29610000,2,45606,11403,1,738480000,738480000,17101,5700,11401,5700,0,1,5702,32747029,32.747029
6300,4700,5700,29610000,2,45606,11403,1,738480000,738480000,17101,5700,11401,5700,0,1,5702,31359881,31.359881
6300,4700,5700,29610000,2,45606,11403,1,738480000,738480000,17101,5700,11401,5700,0,1,5702,32904062,32.904062
6300,4700,5700,29610000,2,45606,11403,1,738480000,738480000,17101,5700,11401,5700,0,1,5702,31400866,31.400866
6300,4700,5700,29610000,2,45606,11403,1,738480000,738480000,17101,5700,11401,5700,0,1,5702,31380148,31.380148
6300,4700,5700,29610000,2,45606,11403,1,738480000,738480000,17101,5700,11401,5700,0,1,5702,32454216,32.454216
6300,4700,6100,29610000,2,48806,12203,1,773680000,773680000,18301,6100,12201,6100,0,1,6102,33511135,33.511135
6300,4700,6100,29610000,2,48806,12203,1,773680000,773680000,18301,6100,12201,6100,0,1,6102,35105605,35.105605
6300,4700,6100,29610000,2,48806,12203,1,773680000,773680000,18301,6100,12201,6100,0,1,6102,33570923,33.570923
6300,4700,6100,29610000,2,48806,12203,1,773680000,773680000,18301,6100,12201,6100,0,1,6102,35199946,35.199946
6300,4700,6100,29610000,2,48806,12203,1,773680000,773680000,18301,6100,12201,6100,0,1,6102,33648451,33.648451
6300,4700,6100,29610000,2,48806,12203,1,773680000,773680000,18301,6100,12201,6100,0,1,6102,33531376,33.531376
6300,4700,6100,29610000,2,48806,12203,1,773680000,773680000,18301,6100,12201,6100,0,1,6102,34711759,34.711759
6300,4700,6500,29610000,2,52006,13003,1,808880000,808880000,19501,6500,13001,6500,0,1,6502,35624535,35.624535
6300,4700,6500,29610000,2,52006,13003,1,808880000,808880000,19501,6500,13001,6500,0,1,6502,37373030,37.37303
6300,4700,6500,29610000,2,52006,13003,1,808880000,808880000,19501,6500,13001,6500,0,1,6502,35664977,35.664977
6300,4700,6500,29610000,2,52006,13003,1,808880000,808880000,19501,6500,13001,6500,0,1,6502,37490472,37.490472
6300,4700,6500,29610000,2,52006,13003,1,808880000,808880000,19501,6500,13001,6500,0,1,6502,35819158,35.819158
6300,4700,6500,29610000,2,52006,13003,1,808880000,808880000,19501,6500,13001,6500,0,1,6502,35705678,35.705678
6300,4700,6500,29610000,2,52006,13003,1,808880000,808880000,19501,6500,13001,6500,0,1,6502,36972418,36.972418
6300,4700,6900,29610000,2,55206,13803,1,844080000,844080000,20701,6900,13801,6900,0,1,6902,37864547,37.864547
6300,4700,6900,29610000,2,55206,13803,1,844080000,844080000,20701,6900,13801,6900,0,1,6902,39698132,39.698132
6300,4700,6900,29610000,2,55206,13803,1,844080000,844080000,20701,6900,13801,6900,0,1,6902,37976895,37.976895
6300,4700,6900,29610000,2,55206,13803,1,844080000,844080000,20701,6900,13801,6900,0,1,6902,39891907,39.891907
6300,4700,6900,29610000,2,55206,13803,1,844080000,844080000,20701,6900,13801,6900,0,1,6902,38223497,38.223497
6300,4700,6900,29610000,2,55206,13803,1,844080000,844080000,20701,6900,13801,6900,0,1,6902,37999460,37.99946
6300,4700,6900,29610000,2,55206,13803,1,844080000,844080000,20701,6900,13801,6900,0,1,6902,39343884,39.343884
6300,4300,500,27090000,2,4006,1003,1,259120000,259120000,1501,500,1001,500,0,1,502,2919591,2.919591
6300,4300,500,27090000,2,4006,1003,1,259120000,259120000,1501,500,1001,500,0,1,502,2963351,2.963351
6300,4300,500,27090000,2,4006,1003,1,259120000,259120000,1501,500,1001,500,0,1,502,2938256,2.938256
6300,4300,500,27090000,2,4006,1003,1,259120000,259120000,1501,500,1001,500,0,1,502,3001196,3.001196
6300,4300,500,27090000,2,4006,1003,1,259120000,259120000,1501,500,1001,500,0,1,502,2875043,2.875043
6300,4300,500,27090000,2,4006,1003,1,259120000,259120000,1501,500,1001,500,0,1,502,2981529,2.981529
6300,4300,500,27090000,2,4006,1003,1,259120000,259120000,1501,500,1001,500,0,1,502,3001612,3.001612
6300,4300,900,27090000,2,7206,1803,1,293040000,293040000,2701,900,1801,900,0,1,902,4701189,4.701189
6300,4300,900,27090000,2,7206,1803,1,293040000,293040000,2701,900,1801,900,0,1,902,4899352,4.899352
6300,4300,900,27090000,2,7206,1803,1,293040000,293040000,2701,900,1801,900,0,1,902,4719699,4.719699
6300,4300,900,27090000,2,7206,1803,1,293040000,293040000,2701,900,1801,900,0,1,902,4926086,4.926086
6300,4300,900,27090000,2,7206,1803,1,293040000,293040000,2701,900,1801,900,0,1,902,4738505,4.738505
6300,4300,900,27090000,2,7206,1803,1,293040000,293040000,2701,900,1801,900,0,1,902,4756838,4.756838
6300,4300,900,27090000,2,7206,1803,1,293040000,293040000,2701,900,1801,900,0,1,902,4879844,4.879844
6300,4300,1300,27090000,2,10406,2603,1,326960000,326960000,3901,1300,2601,1300,0,1,1302,6693904,6.693904
6300,4300,1300,27090000,2,10406,2603,1,326960000,326960000,3901,1300,2601,1300,0,1,1302,6944091,6.944091
6300,4300,1300,27090000,2,10406,2603,1,326960000,326960000,3901,1300,2601,1300,0,1,1302,6661128,6.661128
6300,4300,1300,27090000,2,10406,2603,1,326960000,326960000,3901,1300,2601,1300,0,1,1302,7022036,7.022036
6300,4300,1300,27090000,2,10406,2603,1,326960000,326960000,3901,1300,2601,1300,0,1,1302,6769277,6.769277
6300,4300,1300,27090000,2,10406,2603,1,326960000,326960000,3901,1300,2601,1300,0,1,1302,6716170,6.71617
6300,4300,1300,27090000,2,10406,2603,1,326960000,326960000,3901,1300,2601,1300,0,1,1302,6943739,6.943739
6300,4300,1700,27090000,2,13606,3403,1,360880000,360880000,5101,1700,3401,1700,0,1,1702,8815159,8.815159
6300,4300,1700,27090000,2,13606,3403,1,360880000,360880000,5101,1700,3401,1700,0,1,1702,9074138,9.074138
6300,4300,1700,27090000,2,13606,3403,1,360880000,360880000,5101,1700,3401,1700,0,1,1702,8768108,8.768108
6300,4300,1700,27090000,2,13606,3403,1,360880000,360880000,5101,1700,3401,1700,0,1,1702,9217164,9.217164
6300,4300,1700,27090000,2,13606,3403,1,360880000,360880000,5101,1700,3401,1700,0,1,1702,8882712,8.882712
6300,4300,1700,27090000,2,13606,3403,1,360880000,360880000,5101,1700,3401,1700,0,1,1702,8863905,8.863905
6300,4300,1700,27090000,2,13606,3403,1,360880000,360880000,5101,1700,3401,1700,0,1,1702,9093299,9.093299
6300,4300,2100,27090000,2,16806,4203,1,394800000,394800000,6301,2100,4201,2100,0,1,2102,10758817,10.758817
6300,4300,2100,27090000,2,16806,4203,1,394800000,394800000,6301,2100,4201,2100,0,1,2102,11193552,11.193552
6300,4300,2100,27090000,2,16806,4203,1,394800000,394800000,6301,2100,4201,2100,0,1,2102,10622342,10.622342
6300,4300,2100,27090000,2,16806,4203,1,394800000,394800000,6301,2100,4201,2100,0,1,2102,11256499,11.256499
6300,4300,2100,27090000,2,16806,4203,1,394800000,394800000,6301,2100,4201,2100,0,1,2102,10740468,10.740468
6300,4300,2100,27090000,2,16806,4203,1,394800000,394800000,6301,2100,4201,2100,0,1,2102,10640769,10.640769
6300,4300,2100,27090000,2,16806,4203,1,394800000,394800000,6301,2100,4201,2100,0,1,2102,11014519,11.014519
6300,4300,2500,27090000,2,20006,5003,1,428720000,428720000,7501,2500,5001,2500,0,1,2502,12568154,12.568154
6300,4300,2500,27090000,2,20006,5003,1,428720000,428720000,7501,2500,5001,2500,0,1,2502,13148580,13.14858
6300,4300,2500,27090000,2,20006,5003,1,428720000,428720000,7501,2500,5001,2500,0,1,2502,12761325,12.761325
6300,4300,2500,27090000,2,20006,5003,1,428720000,428720000,7501,2500,5001,2500,0,1,2502,13227818,13.227818
6300,4300,2500,27090000,2,20006,5003,1,428720000,428720000,7501,2500,5001,2500,0,1,2502,12798574,12.798574
6300,4300,2500,27090000,2,20006,5003,1,428720000,428720000,7501,2500,5001,2500,0,1,2502,12779729,12.779729
6300,4300,2500,27090000,2,20006,5003,1,428720000,428720000,7501,2500,5001,2500,0,1,2502,13181171,13.181171
6300,4300,2900,27090000,2,23206,5803,1,462640000,462640000,8701,2900,5801,2900,0,1,2902,14738756,14.738756
6300,4300,2900,27090000,2,23206,5803,1,462640000,462640000,8701,2900,5801,2900,0,1,2902,15378070,15.37807
6300,4300,2900,27090000,2,23206,5803,1,462640000,462640000,8701,2900,5801,2900,0,1,2902,14757200,14.7572
6300,4300,2900,27090000,2,23206,5803,1,462640000,462640000,8701,2900,5801,2900,0,1,2902,15484209,15.484209
6300,4300,2900,27090000,2,23206,5803,1,462640000,462640000,8701,2900,5801,2900,0,1,2902,14822390,14.82239
6300,4300,2900,27090000,2,23206,5803,1,462640000,462640000,8701,2900,5801,2900,0,1,2902,14803770,14.80377
6300,4300,2900,27090000,2,23206,5803,1,462640000,462640000,8701,2900,5801,2900,0,1,2902,15221937,15.221937
6300,4300,3300,27090000,2,26406,6603,1,496560000,496560000,9901,3300,6601,3300,0,1,3302,16682617,16.682617
6300,4300,3300,27090000,2,26406,6603,1,496560000,496560000,9901,3300,6601,3300,0,1,3302,17383770,17.38377
6300,4300,3300,27090000,2,26406,6603,1,496560000,496560000,9901,3300,6601,3300,0,1,3302,16701033,16.701033
6300,4300,3300,27090000,2,26406,6603,1,496560000,496560000,9901,3300,6601,3300,0,1,3302,17530736,17.530736
6300,4300,3300,27090000,2,26406,6603,1,496560000,496560000,9901,3300,6601,3300,0,1,3302,16731794,16.731794
6300,4300,3300,27090000,2,26406,6603,1,496560000,496560000,9901,3300,6601,3300,0,1,3302,16750205,16.750205
6300,4300,3300,27090000,2,26406,6603,1,496560000,496560000,9901,3300,6601,3300,0,1,3302,17282075,17.282075
6300,4300,3700,27090000,2,29606,7403,1,530480000,530480000,11101,3700,7401,3700,0,1,3702,18647661,18.647661
6300,4300,3700,27090000,2,29606,7403,1,530480000,530480000,11101,3700,7401,3700,0,1,3702,19513484,19.513484
6300,4300,3700,27090000,2,29606,7403,1,530480000,530480000,11101,3700,7401,3700,0,1,3702,18689349,18.689349
6300,4300,3700,27090000,2,29606,7403,1,530480000,530480000,11101,3700,7401,3700,0,1,3702,19597123,19.597123
6300,4300,3700,27090000,2,29606,7403,1,530480000,530480000,11101,3700,7401,3700,0,1,3702,18754741,18.754741
6300,4300,3700,27090000,2,29606,7403,1,530480000,530480000,11101,3700,7401,3700,0,1,3702,18725165,18.725165
6300,4300,3700,27090000,2,29606,7403,1,530480000,530480000,11101,3700,7401,3700,0,1,3702,19353516,19.353516
6300,4300,4100,27090000,2,32806,8203,1,564400000,564400000,12301,4100,8201,4100,0,1,4102,20632280,20.63228
6300,4300,4100,27090000,2,32806,8203,1,564400000,564400000,12301,4100,8201,4100,0,1,4102,21549430,21.54943
6300,4300,4100,27090000,2,32806,8203,1,564400000,564400000,12301,4100,8201,4100,0,1,4102,20707011,20.707011
6300,4300,4100,27090000,2,32806,8203,1,564400000,564400000,12301,4100,8201,4100,0,1,4102,21704599,21.704599
6300,4300,4100,27090000,2,32806,8203,1,564400000,564400000,12301,4100,8201,4100,0,1,4102,20688405,20.688405
6300,4300,4100,27090000,2,32806,8203,1,564400000,564400000,12301,4100,8201,4100,0,1,4102,20651226,20.651226
6300,4300,4100,27090000,2,32806,8203,1,564400000,564400000,12301,4100,8201,4100,0,1,4102,21436446,21.436446
6300,4300,4500,27090000,2,36006,9003,1,598320000,598320000,13501,4500,9001,4500,0,1,4502,22556785,22.556785
6300,4300,4500,27090000,2,36006,9003,1,598320000,598320000,13501,4500,9001,4500,0,1,4502,23628555,23.628555
6300,4300,4500,27090000,2,36006,9003,1,598320000,598320000,13501,4500,9001,4500,0,1,4502,22659009,22.659009
6300,4300,4500,27090000,2,36006,9003,1,598320000,598320000,13501,4500,9001,4500,0,1,4502,23745343,23.745343
6300,4300,4500,27090000,2,36006,9003,1,598320000,598320000,13501,4500,9001,4500,0,1,4502,22717800,22.7178
6300,4300,4500,27090000,2,36006,9003,1,598320000,598320000,13501,4500,9001,4500,0,1,4502,22599037,22.599037
6300,4300,4500,27090000,2,36006,9003,1,598320000,598320000,13501,4500,9001,4500,0,1,4502,23448943,23.448943
6300,4300,4900,27090000,2,39206,9803,1,632240000,632240000,14701,4900,9801,4900,0,1,4902,24692202,24.692202
6300,4300,4900,27090000,2,39206,9803,1,632240000,632240000,14701,4900,9801,4900,0,1,4902,25710092,25.710092
6300,4300,4900,27090000,2,39206,9803,1,632240000,632240000,14701,4900,9801,4900,0,1,4902,24745675,24.745675
6300,4300,4900,27090000,2,39206,9803,1,632240000,632240000,14701,4900,9801,4900,0,1,4902,25935226,25.935226
6300,4300,4900,27090000,2,39206,9803,1,632240000,632240000,14701,4900,9801,4900,0,1,4902,24692903,24.692903
6300,4300,4900,27090000,2,39206,9803,1,632240000,632240000,14701,4900,9801,4900,0,1,4902,24711450,24.71145
6300,4300,4900,27090000,2,39206,9803,1,632240000,632240000,14701,4900,9801,4900,0,1,4902,25557849,25.557849
6300,4300,5300,27090000,2,42406,10603,1,666160000,666160000,15901,5300,10601,5300,0,1,5302,26599466,26.599466
6300,4300,5300,27090000,2,42406,10603,1,666160000,666160000,15901,5300,10601,5300,0,1,5302,27844117,27.844117
6300,4300,5300,27090000,2,42406,10603,1,666160000,666160000,15901,5300,10601,5300,0,1,5302,26618202,26.618202
6300,4300,5300,27090000,2,42406,10603,1,666160000,666160000,15901,5300,10601,5300,0,1,5302,27985246,27.985246
6300,4300,5300,27090000,2,42406,10603,1,666160000,666160000,15901,5300,10601,5300,0,1,5302,26755415,26.755415
6300,4300,5300,27090000,2,42406,10603,1,666160000,666160000,15901,5300,10601,5300,0,1,5302,26580902,26.580902
6300,4300,5300,27090000,2,42406,10603,1,666160000,666160000,15901,5300,10601,5300,0,1,5302,27632214,27.632214
6300,4300,5700,27090000,2,45606,11403,1,700080000,700080000,17101,5700,11401,5700,0,1,5702,28598451,28.598451
6300,4300,5700,27090000,2,45606,11403,1,700080000,700080000,17101,5700,11401,5700,0,1,5702,29927216,29.927216
6300,4300,5700,27090000,2,45606,11403,1,700080000,700080000,17101,5700,11401,5700,0,1,5702,28647395,28.647395
6300,4300,5700,27090000,2,45606,11403,1,700080000,700080000,17101,5700,11401,5700,0,1,5702,30026566,30.026566
6300,4300,5700,27090000,2,45606,11403,1,700080000,700080000,17101,5700,11401,5700,0,1,5702,28692495,28.692495
6300,4300,5700,27090000,2,45606,11403,1,700080000,700080000,17101,5700,11401,5700,0,1,5702,28579821,28.579821
6300,4300,5700,27090000,2,45606,11403,1,700080000,700080000,17101,5700,11401,5700,0,1,5702,29707956,29.707956
6300,4300,6100,27090000,2,48806,12203,1,734000000,734000000,18301,6100,12201,6100,0,1,6102,30515784,30.515784
6300,4300,6100,27090000,2,48806,12203,1,734000000,734000000,18301,6100,12201,6100,0,1,6102,32116477,32.116477
6300,4300,6100,27090000,2,48806,12203,1,734000000,734000000,18301,6100,12201,6100,0,1,6102,30744136,30.744136
6300,4300,6100,27090000,2,48806,12203,1,734000000,734000000,18301,6100,12201,6100,0,1,6102,32249745,32.249745
6300,4300,6100,27090000,2,48806,12203,1,734000000,734000000,18301,6100,12201,6100,0,1,6102,30888412,30.888412
6300,4300,6100,27090000,2,48806,12203,1,734000000,734000000,18301,6100,12201,6100,0,1,6102,30571893,30.571893
6300,4300,6100,27090000,2,48806,12203,1,734000000,734000000,18301,6100,12201,6100,0,1,6102,31800249,31.800249
6300,4300,6500,27090000,2,52006,13003,1,767920000,767920000,19501,6500,13001,6500,0,1,6502,32637228,32.637228
6300,4300,6500,27090000,2,52006,13003,1,767920000,767920000,19501,6500,13001,6500,0,1,6502,34147003,34.147003
6300,4300,6500,27090000,2,52006,13003,1,767920000,767920000,19501,6500,13001,6500,0,1,6502,32674474,32.674474
6300,4300,6500,27090000,2,52006,13003,1,767920000,767920000,19501,6500,13001,6500,0,1,6502,34409667,34.409667
6300,4300,6500,27090000,2,52006,13003,1,767920000,767920000,19501,6500,13001,6500,0,1,6502,32819999,32.819999
6300,4300,6500,27090000,2,52006,13003,1,767920000,767920000,19501,6500,13001,6500,0,1,6502,32600084,32.600084
6300,4300,6500,27090000,2,52006,13003,1,767920000,767920000,19501,6500,13001,6500,0,1,6502,33913753,33.913753
6300,4300,6900,27090000,2,55206,13803,1,801840000,801840000,20701,6900,13801,6900,0,1,6902,34563510,34.56351
6300,4300,6900,27090000,2,55206,13803,1,801840000,801840000,20701,6900,13801,6900,0,1,6902,36333379,36.333379
6300,4300,6900,27090000,2,55206,13803,1,801840000,801840000,20701,6900,13801,6900,0,1,6902,34677198,34.677198
6300,4300,6900,27090000,2,55206,13803,1,801840000,801840000,20701,6900,13801,6900,0,1,6902,36415652,36.415652
6300,4300,6900,27090000,2,55206,13803,1,801840000,801840000,20701,6900,13801,6900,0,1,6902,34782411,34.782411
6300,4300,6900,27090000,2,55206,13803,1,801840000,801840000,20701,6900,13801,6900,0,1,6902,34603474,34.603474
6300,4300,6900,27090000,2,55206,13803,1,801840000,801840000,20701,6900,13801,6900,0,1,6902,35913167,35.913167
6300,3900,500,24570000,2,4006,1003,1,237360000,237360000,1501,500,1001,500,0,1,502,2683662,2.683662
6300,3900,500,24570000,2,4006,1003,1,237360000,237360000,1501,500,1001,500,0,1,502,2701725,2.701725
6300,3900,500,24570000,2,4006,1003,1,237360000,237360000,1501,500,1001,500,0,1,502,2596105,2.596105
6300,3900,500,24570000,2,4006,1003,1,237360000,237360000,1501,500,1001,500,0,1,502,2720445,2.720445
6300,3900,500,24570000,2,4006,1003,1,237360000,237360000,1501,500,1001,500,0,1,502,2638250,2.63825
6300,3900,500,24570000,2,4006,1003,1,237360000,237360000,1501,500,1001,500,0,1,502,2620826,2.620826
6300,3900,500,24570000,2,4006,1003,1,237360000,237360000,1501,500,1001,500,0,1,502,2720834,2.720834
6300,3900,900,24570000,2,7206,1803,1,270000000,270000000,2701,900,1801,900,0,1,902,4261540,4.26154
6300,3900,900,24570000,2,7206,1803,1,270000000,270000000,2701,900,1801,900,0,1,902,4457569,4.457569
6300,3900,900,24570000,2,7206,1803,1,270000000,270000000,2701,900,1801,900,0,1,902,4279146,4.279146
6300,3900,900,24570000,2,7206,1803,1,270000000,270000000,2701,900,1801,900,0,1,902,4476072,4.476072
6300,3900,900,24570000,2,7206,1803,1,270000000,270000000,2701,900,1801,900,0,1,902,4296572,4.296572
6300,3900,900,24570000,2,7206,1803,1,270000000,270000000,2701,900,1801,900,0,1,902,4279670,4.27967
6300,3900,900,24570000,2,7206,1803,1,270000000,270000000,2701,900,1801,900,0,1,902,4416797,4.416797
6300,3900,1300,24570000,2,10406,2603,1,302640000,302640000,3901,1300,2601,1300,0,1,1302,6067879,6.067879
6300,3900,1300,24570000,2,10406,2603,1,302640000,302640000,3901,1300,2601,1300,0,1,1302,6290822,6.290822
6300,3900,1300,24570000,2,10406,2603,1,302640000,302640000,3901,1300,2601,1300,0,1,1302,6068464,6.068464
6300,3900,1300,24570000,2,10406,2603,1,302640000,302640000,3901,1300,2601,1300,0,1,1302,6343070,6.34307
6300,3900,1300,24570000,2,10406,2603,1,302640000,302640000,3901,1300,2601,1300,0,1,1302,6105852,6.105852
6300,3900,1300,24570000,2,10406,2603,1,302640000,302640000,3901,1300,2601,1300,0,1,1302,6085164,6.085164
6300,3900,1300,24570000,2,10406,2603,1,302640000,302640000,3901,1300,2601,1300,0,1,1302,6266600,6.2666
6300,3900,1700,24570000,2,13606,3403,1,335280000,335280000,5101,1700,3401,1700,0,1,1702,8002779,8.002779
6300,3900,1700,24570000,2,13606,3403,1,335280000,335280000,5101,1700,3401,1700,0,1,1702,8309977,8.309977
6300,3900,1700,24570000,2,13606,3403,1,335280000,335280000,5101,1700,3401,1700,0,1,1702,8019489,8.019489
6300,3900,1700,24570000,2,13606,3403,1,335280000,335280000,5101,1700,3401,1700,0,1,1702,8390547,8.390547
6300,3900,1700,24570000,2,13606,3403,1,335280000,335280000,5101,1700,3401,1700,0,1,1702,8036964,8.036964
6300,3900,1700,24570000,2,13606,3403,1,335280000,335280000,5101,1700,3401,1700,0,1,1702,8036367,8.036367
6300,3900,1700,24570000,2,13606,3403,1,335280000,335280000,5101,1700,3401,1700,0,1,1702,8334168,8.334168
6300,3900,2100,24570000,2,16806,4203,1,367920000,367920000,6301,2100,4201,2100,0,1,2102,9608159,9.608159
6300,3900,2100,24570000,2,16806,4203,1,367920000,367920000,6301,2100,4201,2100,0,1,2102,10026598,10.026598
6300,3900,2100,24570000,2,16806,4203,1,367920000,367920000,6301,2100,4201,2100,0,1,2102,9642382,9.642382
6300,3900,2100,24570000,2,16806,4203,1,367920000,367920000,6301,2100,4201,2100,0,1,2102,10221917,10.221917
6300,3900,2100,24570000,2,16806,4203,1,367920000,367920000,6301,2100,4201,2100,0,1,2102,9735060,9.73506
6300,3900,2100,24570000,2,16806,4203,1,367920000,367920000,6301,2100,4201,2100,0,1,2102,9625914,9.625914
6300,3900,2100,24570000,2,16806,4203,1,367920000,367920000,6301,2100,4201,2100,0,1,2102,10114903,10.114903
6300,3900,2500,24570000,2,20006,5003,1,400560000,400560000,7501,2500,5001,2500,0,1,2502,11626445,11.626445
6300,3900,2500,24570000,2,20006,5003,1,400560000,400560000,7501,2500,5001,2500,0,1,2502,12021107,12.021107
6300,3900,2500,24570000,2,20006,5003,1,400560000,400560000,7501,2500,5001,2500,0,1,2502,11592776,11.592776
6300,3900,2500,24570000,2,20006,5003,1,400560000,400560000,7501,2500,5001,2500,0,1,2502,12003328,12.003328
6300,3900,2500,24570000,2,20006,5003,1,400560000,400560000,7501,2500,5001,2500,0,1,2502,11643604,11.643604
6300,3900,2500,24570000,2,20006,5003,1,400560000,400560000,7501,2500,5001,2500,0,1,2502,11609546,11.609546
6300,3900,2500,24570000,2,20006,5003,1,400560000,400560000,7501,2500,5001,2500,0,1,2502,11833336,11.833336
6300,3900,2900,24570000,2,23206,5803,1,433200000,433200000,8701,2900,5801,2900,0,1,2902,13380132,13.380132
6300,3900,2900,24570000,2,23206,5803,1,433200000,433200000,8701,2900,5801,2900,0,1,2902,13890602,13.890602
6300,3900,2900,24570000,2,23206,5803,1,433200000,433200000,8701,2900,5801,2900,0,1,2902,13338821,13.338821
6300,3900,2900,24570000,2,23206,5803,1,433200000,433200000,8701,2900,5801,2900,0,1,2902,13977639,13.977639
6300,3900,2900,24570000,2,23206,5803,1,433200000,433200000,8701,2900,5801,2900,0,1,2902,13417747,13.417747
6300,3900,2900,24570000,2,23206,5803,1,433200000,433200000,8701,2900,5801,2900,0,1,2902,13355635,13.355635
6300,3900,2900,24570000,2,23206,5803,1,433200000,433200000,8701,2900,5801,2900,0,1,2902,13808868,13.808868
6300,3900,3300,24570000,2,26406,6603,1,465840000,465840000,9901,3300,6601,3300,0,1,3302,15166639,15.166639
6300,3900,3300,24570000,2,26406,6603,1,465840000,465840000,9901,3300,6601,3300,0,1,3302,15775972,15.775972
6300,3900,3300,24570000,2,26406,6603,1,465840000,465840000,9901,3300,6601,3300,0,1,3302,15149698,15.149698
6300,3900,3300,24570000,2,26406,6603,1,465840000,465840000,9901,3300,6601,3300,0,1,3302,15899462,15.899462
6300,3900,3300,24570000,2,26406,6603,1,465840000,465840000,9901,3300,6601,3300,0,1,3302,15198063,15.198063
6300,3900,3300,24570000,2,26406,6603,1,465840000,465840000,9901,3300,6601,3300,0,1,3302,15167991,15.167991
6300,3900,3300,24570000,2,26406,6603,1,465840000,465840000,9901,3300,6601,3300,0,1,3302,15669968,15.669968
6300,3900,3700,24570000,2,29606,7403,1,498480000,498480000,11101,3700,7401,3700,0,1,3702,16971851,16.971851
6300,3900,3700,24570000,2,29606,7403,1,498480000,498480000,11101,3700,7401,3700,0,1,3702,17659007,17.659007
6300,3900,3700,24570000,2,29606,7403,1,498480000,498480000,11101,3700,7401,3700,0,1,3702,16938031,16.938031
6300,3900,3700,24570000,2,29606,7403,1,498480000,498480000,11101,3700,7401,3700,0,1,3702,17794853,17.794853
6300,3900,3700,24570000,2,29606,7403,1,498480000,498480000,11101,3700,7401,3700,0,1,3702,16989155,16.989155
6300,3900,3700,24570000,2,29606,7403,1,498480000,498480000,11101,3700,7401,3700,0,1,3702,16954974,16.954974
6300,3900,3700,24570000,2,29606,7403,1,498480000,498480000,11101,3700,7401,3700,0,1,3702,17520095,17.520095
6300,3900,4100,24570000,2,32806,8203,1,531120000,531120000,12301,4100,8201,4100,0,1,4102,18750247,18.750247
6300,3900,4100,24570000,2,32806,8203,1,531120000,531120000,12301,4100,8201,4100,0,1,4102,19517220,19.51722
6300,3900,4100,24570000,2,32806,8203,1,531120000,531120000,12301,4100,8201,4100,0,1,4102,18767045,18.767045
6300,3900,4100,24570000,2,32806,8203,1,531120000,531120000,12301,4100,8201,4100,0,1,4102,19655853,19.655853
6300,3900,4100,24570000,2,32806,8203,1,531120000,531120000,12301,4100,8201,4100,0,1,4102,18785560,18.78556
6300,3900,4100,24570000,2,32806,8203,1,531120000,531120000,12301,4100,8201,4100,0,1,4102,18802463,18.802463
6300,3900,4100,24570000,2,32806,8203,1,531120000,531120000,12301,4100,8201,4100,0,1,4102,19395056,19.395056
6300,3900,4500,24570000,2,36006,9003,1,563760000,563760000,13501,4500,9001,4500,0,1,4502,20494699,20.494699
6300,3900,4500,24570000,2,36006,9003,1,563760000,563760000,13501,4500,9001,4500,0,1,4502,21453830,21.45383
6300,3900,4500,24570000,2,36006,9003,1,563760000,563760000,13501,4500,9001,4500,0,1,4502,20523600,20.5236
6300,3900,4500,24570000,2,36006,9003,1,563760000,563760000,13501,4500,9001,4500,0,1,4502,21645848,21.645848
6300,3900,4500,24570000,2,36006,9003,1,563760000,563760000,13501,4500,9001,4500,0,1,4502,20581011,20.581011
6300,3900,4500,24570000,2,36006,9003,1,563760000,563760000,13501,4500,9001,4500,0,1,4502,20612901,20.612901
6300,3900,4500,24570000,2,36006,9003,1,563760000,563760000,13501,4500,9001,4500,0,1,4502,21310717,21.310717
6300,3900,4900,24570000,2,39206,9803,1,596400000,596400000,14701,4900,9801,4900,0,1,4902,22342868,22.342868
6300,3900,4900,24570000,2,39206,9803,1,596400000,596400000,14701,4900,9801,4900,0,1,4902,23314340,23.31434
6300,3900,4900,24570000,2,39206,9803,1,596400000,596400000,14701,4900,9801,4900,0,1,4902,22359672,22.359672
6300,3900,4900,24570000,2,39206,9803,1,596400000,596400000,14701,4900,9801,4900,0,1,4902,23465864,23.465864
6300,3900,4900,24570000,2,39206,9803,1,596400000,596400000,14701,4900,9801,4900,0,1,4902,22416631,22.416631
6300,3900,4900,24570000,2,39206,9803,1,596400000,596400000,14701,4900,9801,4900,0,1,4902,22301424,22.301424
6300,3900,4900,24570000,2,39206,9803,1,596400000,596400000,14701,4900,9801,4900,0,1,4902,23121521,23.121521
6300,3900,5300,24570000,2,42406,10603,1,629040000,629040000,15901,5300,10601,5300,0,1,5302,24146443,24.146443
6300,3900,5300,24570000,2,42406,10603,1,629040000,629040000,15901,5300,10601,5300,0,1,5302,25208612,25.208612
6300,3900,5300,24570000,2,42406,10603,1,629040000,629040000,15901,5300,10601,5300,0,1,5302,24129390,24.12939
6300,3900,5300,24570000,2,42406,10603,1,629040000,629040000,15901,5300,10601,5300,0,1,5302,25374301,25.374301
6300,3900,5300,24570000,2,42406,10603,1,629040000,629040000,15901,5300,10601,5300,0,1,5302,24298854,24.298854
6300,3900,5300,24570000,2,42406,10603,1,629040000,629040000,15901,5300,10601,5300,0,1,5302,24112505,24.112505
6300,3900,5300,24570000,2,42406,10603,1,629040000,629040000,15901,5300,10601,5300,0,1,5302,24986243,24.986243
6300,3900,5700,24570000,2,45606,11403,1,661680000,661680000,17101,5700,11401,5700,0,1,5702,25982403,25.982403
6300,3900,5700,24570000,2,45606,11403,1,661680000,661680000,17101,5700,11401,5700,0,1,5702,27112753,27.112753
6300,3900,5700,24570000,2,45606,11403,1,661680000,661680000,17101,5700,11401,5700,0,1,5702,25964001,25.964001
6300,3900,5700,24570000,2,45606,11403,1,661680000,661680000,17101,5700,11401,5700,0,1,5702,27302283,27.302283
6300,3900,5700,24570000,2,45606,11403,1,661680000,661680000,17101,5700,11401,5700,0,1,5702,26093034,26.093034
6300,3900,5700,24570000,2,45606,11403,1,661680000,661680000,17101,5700,11401,5700,0,1,5702,25963349,25.963349
6300,3900,5700,24570000,2,45606,11403,1,661680000,661680000,17101,5700,11401,5700,0,1,5702,26815552,26.815552
6300,3900,6100,24570000,2,48806,12203,1,694320000,694320000,18301,6100,12201,6100,0,1,6102,27764280,27.76428
6300,3900,6100,24570000,2,48806,12203,1,694320000,694320000,18301,6100,12201,6100,0,1,6102,29041675,29.041675
6300,3900,6100,24570000,2,48806,12203,1,694320000,694320000,18301,6100,12201,6100,0,1,6102,27781217,27.781217
6300,3900,6100,24570000,2,48806,12203,1,694320000,694320000,18301,6100,12201,6100,0,1,6102,29189947,29.189947
6300,3900,6100,24570000,2,48806,12203,1,694320000,694320000,18301,6100,12201,6100,0,1,6102,27952763,27.952763
6300,3900,6100,24570000,2,48806,12203,1,694320000,694320000,18301,6100,12201,6100,0,1,6102,27727328,27.727328
6300,3900,6100,24570000,2,48806,12203,1,694320000,694320000,18301,6100,12201,6100,0,1,6102,28725864,28.725864
6300,3900,6500,24570000,2,52006,13003,1,726960000,726960000,19501,6500,13001,6500,0,1,6502,29554811,29.554811
6300,3900,6500,24570000,2,52006,13003,1,726960000,726960000,19501,6500,13001,6500,0,1,6502,30935560,30.93556
6300,3900,6500,24570000,2,52006,13003,1,726960000,726960000,19501,6500,13001,6500,0,1,6502,29590006,29.590006
6300,3900,6500,24570000,2,52006,13003,1,726960000,726960000,19501,6500,13001,6500,0,1,6502,31132396,31.132396
6300,3900,6500,24570000,2,52006,13003,1,726960000,726960000,19501,6500,13001,6500,0,1,6502,29775811,29.775811
6300,3900,6500,24570000,2,52006,13003,1,726960000,726960000,19501,6500,13001,6500,0,1,6502,29572475,29.572475
6300,3900,6500,24570000,2,52006,13003,1,726960000,726960000,19501,6500,13001,6500,0,1,6502,30602888,30.602888
6300,3900,6900,24570000,2,55206,13803,1,759600000,759600000,20701,6900,13801,6900,0,1,6902,31386464,31.386464
6300,3900,6900,24570000,2,55206,13803,1,759600000,759600000,20701,6900,13801,6900,0,1,6902,32832356,32.832356
6300,3900,6900,24570000,2,55206,13803,1,759600000,759600000,20701,6900,13801,6900,0,1,6902,31422484,31.422484
6300,3900,6900,24570000,2,55206,13803,1,759600000,759600000,20701,6900,13801,6900,0,1,6902,32960805,32.960805
6300,3900,6900,24570000,2,55206,13803,1,759600000,759600000,20701,6900,13801,6900,0,1,6902,31612061,31.612061
6300,3900,6900,24570000,2,55206,13803,1,759600000,759600000,20701,6900,13801,6900,0,1,6902,31351454,31.351454
6300,3900,6900,24570000,2,55206,13803,1,759600000,759600000,20701,6900,13801,6900,0,1,6902,32460429,32.460429
6300,3500,500,22050000,2,4006,1003,1,215600000,215600000,1501,500,1001,500,0,1,502,2378912,2.378912
6300,3500,500,22050000,2,4006,1003,1,215600000,215600000,1501,500,1001,500,0,1,502,2440745,2.440745
6300,3500,500,22050000,2,4006,1003,1,215600000,215600000,1501,500,1001,500,0,1,502,2360714,2.360714
6300,3500,500,22050000,2,4006,1003,1,215600000,215600000,1501,500,1001,500,0,1,502,2457248,2.457248
6300,3500,500,22050000,2,4006,1003,1,215600000,215600000,1501,500,1001,500,0,1,502,2409745,2.409745
6300,3500,500,22050000,2,4006,1003,1,215600000,215600000,1501,500,1001,500,0,1,502,2394486,2.394486
6300,3500,500,22050000,2,4006,1003,1,215600000,215600000,1501,500,1001,500,0,1,502,2456650,2.45665
6300,3500,900,22050000,2,7206,1803,1,246960000,246960000,2701,900,1801,900,0,1,902,3819373,3.819373
6300,3500,900,22050000,2,7206,1803,1,246960000,246960000,2701,900,1801,900,0,1,902,3987288,3.987288
6300,3500,900,22050000,2,7206,1803,1,246960000,246960000,2701,900,1801,900,0,1,902,3819994,3.819994
6300,3500,900,22050000,2,7206,1803,1,246960000,246960000,2701,900,1801,900,0,1,902,4005975,4.005975
6300,3500,900,22050000,2,7206,1803,1,246960000,246960000,2701,900,1801,900,0,1,902,3856510,3.85651
6300,3500,900,22050000,2,7206,1803,1,246960000,246960000,2701,900,1801,900,0,1,902,3874514,3.874514
6300,3500,900,22050000,2,7206,1803,1,246960000,246960000,2701,900,1801,900,0,1,902,3947905,3.947905
6300,3500,1300,22050000,2,10406,2603,1,278320000,278320000,3901,1300,2601,1300,0,1,1302,5416051,5.416051
6300,3500,1300,22050000,2,10406,2603,1,278320000,278320000,3901,1300,2601,1300,0,1,1302,5663915,5.663915
6300,3500,1300,22050000,2,10406,2603,1,278320000,278320000,3901,1300,2601,1300,0,1,1302,5436711,5.436711
6300,3500,1300,22050000,2,10406,2603,1,278320000,278320000,3901,1300,2601,1300,0,1,1302,5694733,5.694733
6300,3500,1300,22050000,2,10406,2603,1,278320000,278320000,3901,1300,2601,1300,0,1,1302,5534306,5.534306
6300,3500,1300,22050000,2,10406,2603,1,278320000,278320000,3901,1300,2601,1300,0,1,1302,5483585,5.483585
6300,3500,1300,22050000,2,10406,2603,1,278320000,278320000,3901,1300,2601,1300,0,1,1302,5599772,5.599772
6300,3500,1700,22050000,2,13606,3403,1,309680000,309680000,5101,1700,3401,1700,0,1,1702,7190244,7.190244
6300,3500,1700,22050000,2,13606,3403,1,309680000,309680000,5101,1700,3401,1700,0,1,1702,7453770,7.45377
6300,3500,1700,22050000,2,13606,3403,1,309680000,309680000,5101,1700,3401,1700,0,1,1702,7175208,7.175208
6300,3500,1700,22050000,2,13606,3403,1,309680000,309680000,5101,1700,3401,1700,0,1,1702,7506343,7.506343
6300,3500,1700,22050000,2,13606,3403,1,309680000,309680000,5101,1700,3401,1700,0,1,1702,7260930,7.26093
6300,3500,1700,22050000,2,13606,3403,1,309680000,309680000,5101,1700,3401,1700,0,1,1702,7235988,7.235988
6300,3500,1700,22050000,2,13606,3403,1,309680000,309680000,5101,1700,3401,1700,0,1,1702,7359972,7.359972
6300,3500,2100,22050000,2,16806,4203,1,341040000,341040000,6301,2100,4201,2100,0,1,2102,8626230,8.62623
6300,3500,2100,22050000,2,16806,4203,1,341040000,341040000,6301,2100,4201,2100,0,1,2102,9016937,9.016937
6300,3500,2100,22050000,2,16806,4203,1,341040000,341040000,6301,2100,4201,2100,0,1,2102,8651944,8.651944
6300,3500,2100,22050000,2,16806,4203,1,341040000,341040000,6301,2100,4201,2100,0,1,2102,9089334,9.089334
6300,3500,2100,22050000,2,16806,4203,1,341040000,341040000,6301,2100,4201,2100,0,1,2102,8750916,8.750916
6300,3500,2100,22050000,2,16806,4203,1,341040000,341040000,6301,2100,4201,2100,0,1,2102,8692284,8.692284
6300,3500,2100,22050000,2,16806,4203,1,341040000,341040000,6301,2100,4201,2100,0,1,2102,8942144,8.942144
6300,3500,2500,22050000,2,20006,5003,1,372400000,372400000,7501,2500,5001,2500,0,1,2502,10425243,10.425243
6300,3500,2500,22050000,2,20006,5003,1,372400000,372400000,7501,2500,5001,2500,0,1,2502,10800699,10.800699
6300,3500,2500,22050000,2,20006,5003,1,372400000,372400000,7501,2500,5001,2500,0,1,2502,10440387,10.440387
6300,3500,2500,22050000,2,20006,5003,1,372400000,372400000,7501,2500,5001,2500,0,1,2502,10890517,10.890517
6300,3500,2500,22050000,2,20006,5003,1,372400000,372400000,7501,2500,5001,2500,0,1,2502,10508850,10.50885
6300,3500,2500,22050000,2,20006,5003,1,372400000,372400000,7501,2500,5001,2500,0,1,2502,10466177,10.466177
6300,3500,2500,22050000,2,20006,5003,1,372400000,372400000,7501,2500,5001,2500,0,1,2502,10721582,10.721582
6300,3500,2900,22050000,2,23206,5803,1,403760000,403760000,8701,2900,5801,2900,0,1,2902,11997530,11.99753
6300,3500,2900,22050000,2,23206,5803,1,403760000,403760000,8701,2900,5801,2900,0,1,2902,12523332,12.523332
6300,3500,2900,22050000,2,23206,5803,1,403760000,403760000,8701,2900,5801,2900,0,1,2902,12019644,12.019644
6300,3500,2900,22050000,2,23206,5803,1,403760000,403760000,8701,2900,5801,2900,0,1,2902,12606225,12.606225
6300,3500,2900,22050000,2,23206,5803,1,403760000,403760000,8701,2900,5801,2900,0,1,2902,12143000,12.143
6300,3500,2900,22050000,2,23206,5803,1,403760000,403760000,8701,2900,5801,2900,0,1,2902,12061708,12.061708
6300,3500,2900,22050000,2,23206,5803,1,403760000,403760000,8701,2900,5801,2900,0,1,2902,12364608,12.364608
6300,3500,3300,22050000,2,26406,6603,1,435120000,435120000,9901,3300,6601,3300,0,1,3302,13659561,13.659561
6300,3500,3300,22050000,2,26406,6603,1,435120000,435120000,9901,3300,6601,3300,0,1,3302,14185454,14.185454
6300,3500,3300,22050000,2,26406,6603,1,435120000,435120000,9901,3300,6601,3300,0,1,3302,13674744,13.674744
6300,3500,3300,22050000,2,26406,6603,1,435120000,435120000,9901,3300,6601,3300,0,1,3302,14270198,14.270198
6300,3500,3300,22050000,2,26406,6603,1,435120000,435120000,9901,3300,6601,3300,0,1,3302,13757379,13.757379
6300,3500,3300,22050000,2,26406,6603,1,435120000,435120000,9901,3300,6601,3300,0,1,3302,13741896,13.741896
6300,3500,3300,22050000,2,26406,6603,1,435120000,435120000,9901,3300,6601,3300,0,1,3302,14069790,14.06979
6300,3500,3700,22050000,2,29606,7403,1,466480000,466480000,11101,3700,7401,3700,0,1,3702,15199623,15.199623
6300,3500,3700,22050000,2,29606,7403,1,466480000,466480000,11101,3700,7401,3700,0,1,3702,15897979,15.897979
6300,3500,3700,22050000,2,29606,7403,1,466480000,466480000,11101,3700,7401,3700,0,1,3702,15300959,15.300959
6300,3500,3700,22050000,2,29606,7403,1,466480000,466480000,11101,3700,7401,3700,0,1,3702,15989695,15.989695
6300,3500,3700,22050000,2,29606,7403,1,466480000,466480000,11101,3700,7401,3700,0,1,3702,15359754,15.359754
6300,3500,3700,22050000,2,29606,7403,1,466480000,466480000,11101,3700,7401,3700,0,1,3702,15269035,15.269035
6300,3500,3700,22050000,2,29606,7403,1,466480000,466480000,11101,3700,7401,3700,0,1,3702,15678300,15.6783
6300,3500,4100,22050000,2,32806,8203,1,497840000,497840000,12301,4100,8201,4100,0,1,4102,16863503,16.863503
6300,3500,4100,22050000,2,32806,8203,1,497840000,497840000,12301,4100,8201,4100,0,1,4102,17568359,17.568359
6300,3500,4100,22050000,2,32806,8203,1,497840000,497840000,12301,4100,8201,4100,0,1,4102,16888284,16.888284
6300,3500,4100,22050000,2,32806,8203,1,497840000,497840000,12301,4100,8201,4100,0,1,4102,17679334,17.679334
6300,3500,4100,22050000,2,32806,8203,1,497840000,497840000,12301,4100,8201,4100,0,1,4102,16986432,16.986432
6300,3500,4100,22050000,2,32806,8203,1,497840000,497840000,12301,4100,8201,4100,0,1,4102,16961647,16.961647
6300,3500,4100,22050000,2,32806,8203,1,497840000,497840000,12301,4100,8201,4100,0,1,4102,17406232,17.406232
6300,3500,4500,22050000,2,36006,9003,1,529200000,529200000,13501,4500,9001,4500,0,1,4502,18452729,18.452729
6300,3500,4500,22050000,2,36006,9003,1,529200000,529200000,13501,4500,9001,4500,0,1,4502,19298012,19.298012
6300,3500,4500,22050000,2,36006,9003,1,529200000,529200000,13501,4500,9001,4500,0,1,4502,18478499,18.478499
6300,3500,4500,22050000,2,36006,9003,1,529200000,529200000,13501,4500,9001,4500,0,1,4502,19412325,19.412325
6300,3500,4500,22050000,2,36006,9003,1,529200000,529200000,13501,4500,9001,4500,0,1,4502,18593859,18.593859
6300,3500,4500,22050000,2,36006,9003,1,529200000,529200000,13501,4500,9001,4500,0,1,4502,18516503,18.516503
6300,3500,4500,22050000,2,36006,9003,1,529200000,529200000,13501,4500,9001,4500,0,1,4502,19043530,19.04353
6300,3500,4900,22050000,2,39206,9803,1,560560000,560560000,14701,4900,9801,4900,0,1,4902,20120699,20.120699
6300,3500,4900,22050000,2,39206,9803,1,560560000,560560000,14701,4900,9801,4900,0,1,4902,20997247,20.997247
6300,3500,4900,22050000,2,39206,9803,1,560560000,560560000,14701,4900,9801,4900,0,1,4902,20057342,20.057342
6300,3500,4900,22050000,2,39206,9803,1,560560000,560560000,14701,4900,9801,4900,0,1,4902,21106926,21.106926
6300,3500,4900,22050000,2,39206,9803,1,560560000,560560000,14701,4900,9801,4900,0,1,4902,20196839,20.196839
6300,3500,4900,22050000,2,39206,9803,1,560560000,560560000,14701,4900,9801,4900,0,1,4902,20181349,20.181349
6300,3500,4900,22050000,2,39206,9803,1,560560000,560560000,14701,4900,9801,4900,0,1,4902,20705906,20.705906
6300,3500,5300,22050000,2,42406,10603,1,591920000,591920000,15901,5300,10601,5300,0,1,5302,21707036,21.707036
6300,3500,5300,22050000,2,42406,10603,1,591920000,591920000,15901,5300,10601,5300,0,1,5302,22688373,22.688373
6300,3500,5300,22050000,2,42406,10603,1,591920000,591920000,15901,5300,10601,5300,0,1,5302,21734609,21.734609
6300,3500,5300,22050000,2,42406,10603,1,591920000,591920000,15901,5300,10601,5300,0,1,5302,22787207,22.787207
6300,3500,5300,22050000,2,42406,10603,1,591920000,591920000,15901,5300,10601,5300,0,1,5302,21911609,21.911609
6300,3500,5300,22050000,2,42406,10603,1,591920000,591920000,15901,5300,10601,5300,0,1,5302,21793293,21.793293
6300,3500,5300,22050000,2,42406,10603,1,591920000,591920000,15901,5300,10601,5300,0,1,5302,22428409,22.428409
6300,3500,5700,22050000,2,45606,11403,1,623280000,623280000,17101,5700,11401,5700,0,1,5702,23362137,23.362137
6300,3500,5700,22050000,2,45606,11403,1,623280000,623280000,17101,5700,11401,5700,0,1,5702,24420454,24.420454
6300,3500,5700,22050000,2,45606,11403,1,623280000,623280000,17101,5700,11401,5700,0,1,5702,23333613,23.333613
6300,3500,5700,22050000,2,45606,11403,1,623280000,623280000,17101,5700,11401,5700,0,1,5702,24491474,24.491474
6300,3500,5700,22050000,2,45606,11403,1,623280000,623280000,17101,5700,11401,5700,0,1,5702,23512860,23.51286
6300,3500,5700,22050000,2,45606,11403,1,623280000,623280000,17101,5700,11401,5700,0,1,5702,23480685,23.480685
6300,3500,5700,22050000,2,45606,11403,1,623280000,623280000,17101,5700,11401,5700,0,1,5702,24093996,24.093996
6300,3500,6100,22050000,2,48806,12203,1,654640000,654640000,18301,6100,12201,6100,0,1,6102,24934319,24.934319
6300,3500,6100,22050000,2,48806,12203,1,654640000,654640000,18301,6100,12201,6100,0,1,6102,26005924,26.005924
6300,3500,6100,22050000,2,48806,12203,1,654640000,654640000,18301,6100,12201,6100,0,1,6102,24970942,24.970942
6300,3500,6100,22050000,2,48806,12203,1,654640000,654640000,18301,6100,12201,6100,0,1,6102,26192088,26.192088
6300,3500,6100,22050000,2,48806,12203,1,654640000,654640000,18301,6100,12201,6100,0,1,6102,25106861,25.106861
6300,3500,6100,22050000,2,48806,12203,1,654640000,654640000,18301,6100,12201,6100,0,1,6102,25003948,25.003948
6300,3500,6100,22050000,2,48806,12203,1,654640000,654640000,18301,6100,12201,6100,0,1,6102,25809561,25.809561
6300,3500,6500,22050000,2,52006,13003,1,686000000,686000000,19501,6500,13001,6500,0,1,6502,26542771,26.542771
6300,3500,6500,22050000,2,52006,13003,1,686000000,686000000,19501,6500,13001,6500,0,1,6502,27758199,27.758199
6300,3500,6500,22050000,2,52006,13003,1,686000000,686000000,19501,6500,13001,6500,0,1,6502,26586775,26.586775
6300,3500,6500,22050000,2,52006,13003,1,686000000,686000000,19501,6500,13001,6500,0,1,6502,27953134,27.953134
6300,3500,6500,22050000,2,52006,13003,1,686000000,686000000,19501,6500,13001,6500,0,1,6502,26762256,26.762256
6300,3500,6500,22050000,2,52006,13003,1,686000000,686000000,19501,6500,13001,6500,0,1,6502,26602705,26.602705
6300,3500,6500,22050000,2,52006,13003,1,686000000,686000000,19501,6500,13001,6500,0,1,6502,27449016,27.449016
6300,3500,6900,22050000,2,55206,13803,1,717360000,717360000,20701,6900,13801,6900,0,1,6902,28228325,28.228325
6300,3500,6900,22050000,2,55206,13803,1,717360000,717360000,20701,6900,13801,6900,0,1,6902,29479287,29.479287
6300,3500,6900,22050000,2,55206,13803,1,717360000,717360000,20701,6900,13801,6900,0,1,6902,28259629,28.259629
6300,3500,6900,22050000,2,55206,13803,1,717360000,717360000,20701,6900,13801,6900,0,1,6902,29657387,29.657387
6300,3500,6900,22050000,2,55206,13803,1,717360000,717360000,20701,6900,13801,6900,0,1,6902,28423038,28.423038
6300,3500,6900,22050000,2,55206,13803,1,717360000,717360000,20701,6900,13801,6900,0,1,6902,28314612,28.314612
6300,3500,6900,22050000,2,55206,13803,1,717360000,717360000,20701,6900,13801,6900,0,1,6902,29180281,29.180281
6300,3100,500,19530000,2,4006,1003,1,193840000,193840000,1501,500,1001,500,0,1,502,2123856,2.123856
6300,3100,500,19530000,2,4006,1003,1,193840000,193840000,1501,500,1001,500,0,1,502,2198064,2.198064
6300,3100,500,19530000,2,4006,1003,1,193840000,193840000,1501,500,1001,500,0,1,502,2110114,2.110114
6300,3100,500,19530000,2,4006,1003,1,193840000,193840000,1501,500,1001,500,0,1,502,2181380,2.18138
6300,3100,500,19530000,2,4006,1003,1,193840000,193840000,1501,500,1001,500,0,1,502,2156266,2.156266
6300,3100,500,19530000,2,4006,1003,1,193840000,193840000,1501,500,1001,500,0,1,502,2197232,2.197232
6300,3100,500,19530000,2,4006,1003,1,193840000,193840000,1501,500,1001,500,0,1,502,2124764,2.124764
6300,3100,900,19530000,2,7206,1803,1,223920000,223920000,2701,900,1801,900,0,1,902,3400958,3.400958
6300,3100,900,19530000,2,7206,1803,1,223920000,223920000,2701,900,1801,900,0,1,902,3529560,3.52956
6300,3100,900,19530000,2,7206,1803,1,223920000,223920000,2701,900,1801,900,0,1,902,3387496,3.387496
6300,3100,900,19530000,2,7206,1803,1,223920000,223920000,2701,900,1801,900,0,1,902,3553291,3.553291
6300,3100,900,19530000,2,7206,1803,1,223920000,223920000,2701,900,1801,900,0,1,902,3449134,3.449134
6300,3100,900,19530000,2,7206,1803,1,223920000,223920000,2701,900,1801,900,0,1,902,3435474,3.435474
6300,3100,900,19530000,2,7206,1803,1,223920000,223920000,2701,900,1801,900,0,1,902,3490061,3.490061
6300,3100,1300,19530000,2,10406,2603,1,254000000,254000000,3901,1300,2601,1300,0,1,1302,4799234,4.799234
6300,3100,1300,19530000,2,10406,2603,1,254000000,254000000,3901,1300,2601,1300,0,1,1302,5022680,5.02268
6300,3100,1300,19530000,2,10406,2603,1,254000000,254000000,3901,1300,2601,1300,0,1,1302,4818248,4.818248
6300,3100,1300,19530000,2,10406,2603,1,254000000,254000000,3901,1300,2601,1300,0,1,1302,5040525,5.040525
6300,3100,1300,19530000,2,10406,2603,1,254000000,254000000,3901,1300,2601,1300,0,1,1302,4903323,4.903323
6300,3100,1300,19530000,2,10406,2603,1,254000000,254000000,3901,1300,2601,1300,0,1,1302,4849853,4.849853
6300,3100,1300,19530000,2,10406,2603,1,254000000,254000000,3901,1300,2601,1300,0,1,1302,4959079,4.959079
6300,3100,1700,19530000,2,13606,3403,1,284080000,284080000,5101,1700,3401,1700,0,1,1702,6447039,6.447039
6300,3100,1700,19530000,2,13606,3403,1,284080000,284080000,5101,1700,3401,1700,0,1,1702,6509666,6.509666
6300,3100,1700,19530000,2,13606,3403,1,284080000,284080000,5101,1700,3401,1700,0,1,1702,6390361,6.390361
6300,3100,1700,19530000,2,13606,3403,1,284080000,284080000,5101,1700,3401,1700,0,1,1702,6548587,6.548587
6300,3100,1700,19530000,2,13606,3403,1,284080000,284080000,5101,1700,3401,1700,0,1,1702,6336221,6.336221
6300,3100,1700,19530000,2,13606,3403,1,284080000,284080000,5101,1700,3401,1700,0,1,1702,6265058,6.265058
6300,3100,1700,19530000,2,13606,3403,1,284080000,284080000,5101,1700,3401,1700,0,1,1702,6433798,6.433798
6300,3100,2100,19530000,2,16806,4203,1,314160000,314160000,6301,2100,4201,2100,0,1,2102,7635850,7.63585
6300,3100,2100,19530000,2,16806,4203,1,314160000,314160000,6301,2100,4201,2100,0,1,2102,8096903,8.096903
6300,3100,2100,19530000,2,16806,4203,1,314160000,314160000,6301,2100,4201,2100,0,1,2102,7660855,7.660855
6300,3100,2100,19530000,2,16806,4203,1,314160000,314160000,6301,2100,4201,2100,0,1,2102,8130198,8.130198
6300,3100,2100,19530000,2,16806,4203,1,314160000,314160000,6301,2100,4201,2100,0,1,2102,7926665,7.926665
6300,3100,2100,19530000,2,16806,4203,1,314160000,314160000,6301,2100,4201,2100,0,1,2102,7861489,7.861489
6300,3100,2100,19530000,2,16806,4203,1,314160000,314160000,6301,2100,4201,2100,0,1,2102,8032811,8.032811
6300,3100,2500,19530000,2,20006,5003,1,344240000,344240000,7501,2500,5001,2500,0,1,2502,9244839,9.244839
6300,3100,2500,19530000,2,20006,5003,1,344240000,344240000,7501,2500,5001,2500,0,1,2502,9498654,9.498654
6300,3100,2500,19530000,2,20006,5003,1,344240000,344240000,7501,2500,5001,2500,0,1,2502,9277179,9.277179
6300,3100,2500,19530000,2,20006,5003,1,344240000,344240000,7501,2500,5001,2500,0,1,2502,9541084,9.541084
6300,3100,2500,19530000,2,20006,5003,1,344240000,344240000,7501,2500,5001,2500,0,1,2502,9258490,9.25849
6300,3100,2500,19530000,2,20006,5003,1,344240000,344240000,7501,2500,5001,2500,0,1,2502,9114494,9.114494
6300,3100,2500,19530000,2,20006,5003,1,344240000,344240000,7501,2500,5001,2500,0,1,2502,9384879,9.384879
6300,3100,2900,19530000,2,23206,5803,1,374320000,374320000,8701,2900,5801,2900,0,1,2902,10491837,10.491837
6300,3100,2900,19530000,2,23206,5803,1,374320000,374320000,8701,2900,5801,2900,0,1,2902,11080025,11.080025
6300,3100,2900,19530000,2,23206,5803,1,374320000,374320000,8701,2900,5801,2900,0,1,2902,10521091,10.521091
6300,3100,2900,19530000,2,23206,5803,1,374320000,374320000,8701,2900,5801,2900,0,1,2902,11159231,11.159231
6300,3100,2900,19530000,2,23206,5803,1,374320000,374320000,8701,2900,5801,2900,0,1,2902,10799215,10.799215
6300,3100,2900,19530000,2,23206,5803,1,374320000,374320000,8701,2900,5801,2900,0,1,2902,10728455,10.728455
6300,3100,2900,19530000,2,23206,5803,1,374320000,374320000,8701,2900,5801,2900,0,1,2902,10991034,10.991034
6300,3100,3300,19530000,2,26406,6603,1,404400000,404400000,9901,3300,6601,3300,0,1,3302,12100840,12.10084
6300,3100,3300,19530000,2,26406,6603,1,404400000,404400000,9901,3300,6601,3300,0,1,3302,12592799,12.592799
6300,3100,3300,19530000,2,26406,6603,1,404400000,404400000,9901,3300,6601,3300,0,1,3302,12114324,12.114324
6300,3100,3300,19530000,2,26406,6603,1,404400000,404400000,9901,3300,6601,3300,0,1,3302,12669734,12.669734
6300,3100,3300,19530000,2,26406,6603,1,404400000,404400000,9901,3300,6601,3300,0,1,3302,12230066,12.230066
6300,3100,3300,19530000,2,26406,6603,1,404400000,404400000,9901,3300,6601,3300,0,1,3302,12198112,12.198112
6300,3100,3300,19530000,2,26406,6603,1,404400000,404400000,9901,3300,6601,3300,0,1,3302,12484895,12.484895
6300,3100,3700,19530000,2,29606,7403,1,434480000,434480000,11101,3700,7401,3700,0,1,3702,13530703,13.530703
6300,3100,3700,19530000,2,29606,7403,1,434480000,434480000,11101,3700,7401,3700,0,1,3702,14059509,14.059509
6300,3100,3700,19530000,2,29606,7403,1,434480000,434480000,11101,3700,7401,3700,0,1,3702,13544143,13.544143
6300,3100,3700,19530000,2,29606,7403,1,434480000,434480000,11101,3700,7401,3700,0,1,3702,14151823,14.151823
6300,3100,3700,19530000,2,29606,7403,1,434480000,434480000,11101,3700,7401,3700,0,1,3702,13702625,13.702625
6300,3100,3700,19530000,2,29606,7403,1,434480000,434480000,11101,3700,7401,3700,0,1,3702,13591246,13.591246
6300,3100,3700,19530000,2,29606,7403,1,434480000,434480000,11101,3700,7401,3700,0,1,3702,13970774,13.970774
6300,3100,4100,19530000,2,32806,8203,1,464560000,464560000,12301,4100,8201,4100,0,1,4102,14961449,14.961449
6300,3100,4100,19530000,2,32806,8203,1,464560000,464560000,12301,4100,8201,4100,0,1,4102,15570703,15.570703
6300,3100,4100,19530000,2,32806,8203,1,464560000,464560000,12301,4100,8201,4100,0,1,4102,14983456,14.983456
6300,3100,4100,19530000,2,32806,8203,1,464560000,464560000,12301,4100,8201,4100,0,1,4102,15689106,15.689106
6300,3100,4100,19530000,2,32806,8203,1,464560000,464560000,12301,4100,8201,4100,0,1,4102,15078669,15.078669
6300,3100,4100,19530000,2,32806,8203,1,464560000,464560000,12301,4100,8201,4100,0,1,4102,15056618,15.056618
6300,3100,4100,19530000,2,32806,8203,1,464560000,464560000,12301,4100,8201,4100,0,1,4102,15453282,15.453282
6300,3100,4500,19530000,2,36006,9003,1,494640000,494640000,13501,4500,9001,4500,0,1,4502,16346275,16.346275
6300,3100,4500,19530000,2,36006,9003,1,494640000,494640000,13501,4500,9001,4500,0,1,4502,17100080,17.10008
6300,3100,4500,19530000,2,36006,9003,1,494640000,494640000,13501,4500,9001,4500,0,1,4502,16444851,16.444851
6300,3100,4500,19530000,2,36006,9003,1,494640000,494640000,13501,4500,9001,4500,0,1,4502,17211190,17.21119
6300,3100,4500,19530000,2,36006,9003,1,494640000,494640000,13501,4500,9001,4500,0,1,4502,16507552,16.507552
6300,3100,4500,19530000,2,36006,9003,1,494640000,494640000,13501,4500,9001,4500,0,1,4502,16416662,16.416662
6300,3100,4500,19530000,2,36006,9003,1,494640000,494640000,13501,4500,9001,4500,0,1,4502,16891256,16.891256
6300,3100,4900,19530000,2,39206,9803,1,524720000,524720000,14701,4900,9801,4900,0,1,4902,17826866,17.826866
6300,3100,4900,19530000,2,39206,9803,1,524720000,524720000,14701,4900,9801,4900,0,1,4902,18608794,18.608794
6300,3100,4900,19530000,2,39206,9803,1,524720000,524720000,14701,4900,9801,4900,0,1,4902,17771259,17.771259
6300,3100,4900,19530000,2,39206,9803,1,524720000,524720000,14701,4900,9801,4900,0,1,4902,18720803,18.720803
6300,3100,4900,19530000,2,39206,9803,1,524720000,524720000,14701,4900,9801,4900,0,1,4902,17962595,17.962595
6300,3100,4900,19530000,2,39206,9803,1,524720000,524720000,14701,4900,9801,4900,0,1,4902,17933725,17.933725
6300,3100,4900,19530000,2,39206,9803,1,524720000,524720000,14701,4900,9801,4900,0,1,4902,18384123,18.384123
6300,3100,5300,19530000,2,42406,10603,1,554800000,554800000,15901,5300,10601,5300,0,1,5302,19252443,19.252443
6300,3100,5300,19530000,2,42406,10603,1,554800000,554800000,15901,5300,10601,5300,0,1,5302,20109425,20.109425
6300,3100,5300,19530000,2,42406,10603,1,554800000,554800000,15901,5300,10601,5300,0,1,5302,19302159,19.302159
6300,3100,5300,19530000,2,42406,10603,1,554800000,554800000,15901,5300,10601,5300,0,1,5302,20210901,20.210901
6300,3100,5300,19530000,2,42406,10603,1,554800000,554800000,15901,5300,10601,5300,0,1,5302,19421753,19.421753
6300,3100,5300,19530000,2,42406,10603,1,554800000,554800000,15901,5300,10601,5300,0,1,5302,19326738,19.326738
6300,3100,5300,19530000,2,42406,10603,1,554800000,554800000,15901,5300,10601,5300,0,1,5302,19891506,19.891506
6300,3100,5700,19530000,2,45606,11403,1,584880000,584880000,17101,5700,11401,5700,0,1,5702,20676574,20.676574
6300,3100,5700,19530000,2,45606,11403,1,584880000,584880000,17101,5700,11401,5700,0,1,5702,21597490,21.59749
6300,3100,5700,19530000,2,45606,11403,1,584880000,584880000,17101,5700,11401,5700,0,1,5702,20777043,20.777043
6300,3100,5700,19530000,2,45606,11403,1,584880000,584880000,17101,5700,11401,5700,0,1,5702,21746307,21.746307
6300,3100,5700,19530000,2,45606,11403,1,584880000,584880000,17101,5700,11401,5700,0,1,5702,20823053,20.823053
6300,3100,5700,19530000,2,45606,11403,1,584880000,584880000,17101,5700,11401,5700,0,1,5702,20822442,20.822442
6300,3100,5700,19530000,2,45606,11403,1,584880000,584880000,17101,5700,11401,5700,0,1,5702,21366000,21.366
6300,3100,6100,19530000,2,48806,12203,1,614960000,614960000,18301,6100,12201,6100,0,1,6102,22088463,22.088463
6300,3100,6100,19530000,2,48806,12203,1,614960000,614960000,18301,6100,12201,6100,0,1,6102,23159610,23.15961
6300,3100,6100,19530000,2,48806,12203,1,614960000,614960000,18301,6100,12201,6100,0,1,6102,22217085,22.217085
6300,3100,6100,19530000,2,48806,12203,1,614960000,614960000,18301,6100,12201,6100,0,1,6102,23259743,23.259743
6300,3100,6100,19530000,2,48806,12203,1,614960000,614960000,18301,6100,12201,6100,0,1,6102,22303725,22.303725
6300,3100,6100,19530000,2,48806,12203,1,614960000,614960000,18301,6100,12201,6100,0,1,6102,22271242,22.271242
6300,3100,6100,19530000,2,48806,12203,1,614960000,614960000,18301,6100,12201,6100,0,1,6102,22839213,22.839213
6300,3100,6500,19530000,2,52006,13003,1,645040000,645040000,19501,6500,13001,6500,0,1,6502,23679854,23.679854
6300,3100,6500,19530000,2,52006,13003,1,645040000,645040000,19501,6500,13001,6500,0,1,6502,24670024,24.670024
6300,3100,6500,19530000,2,52006,13003,1,645040000,645040000,19501,6500,13001,6500,0,1,6502,23679165,23.679165
6300,3100,6500,19530000,2,52006,13003,1,645040000,645040000,19501,6500,13001,6500,0,1,6502,24754047,24.754047
6300,3100,6500,19530000,2,52006,13003,1,645040000,645040000,19501,6500,13001,6500,0,1,6502,23794669,23.794669
6300,3100,6500,19530000,2,52006,13003,1,645040000,645040000,19501,6500,13001,6500,0,1,6502,23715142,23.715142
6300,3100,6500,19530000,2,52006,13003,1,645040000,645040000,19501,6500,13001,6500,0,1,6502,24368261,24.368261
6300,3100,6900,19530000,2,55206,13803,1,675120000,675120000,20701,6900,13801,6900,0,1,6902,25065153,25.065153
6300,3100,6900,19530000,2,55206,13803,1,675120000,675120000,20701,6900,13801,6900,0,1,6902,26161559,26.161559
6300,3100,6900,19530000,2,55206,13803,1,675120000,675120000,20701,6900,13801,6900,0,1,6902,25093037,25.093037
6300,3100,6900,19530000,2,55206,13803,1,675120000,675120000,20701,6900,13801,6900,0,1,6902,26262102,26.262102
6300,3100,6900,19530000,2,55206,13803,1,675120000,675120000,20701,6900,13801,6900,0,1,6902,25196216,25.196216
6300,3100,6900,19530000,2,55206,13803,1,675120000,675120000,20701,6900,13801,6900,0,1,6902,25128007,25.128007
6300,3100,6900,19530000,2,55206,13803,1,675120000,675120000,20701,6900,13801,6900,0,1,6902,25837585,25.837585
6300,2700,500,17010000,2,4006,1003,1,172080000,172080000,1501,500,1001,500,0,1,502,1919180,1.91918
6300,2700,500,17010000,2,4006,1003,1,172080000,172080000,1501,500,1001,500,0,1,502,1919561,1.919561
6300,2700,500,17010000,2,4006,1003,1,172080000,172080000,1501,500,1001,500,0,1,502,1893466,1.893466
6300,2700,500,17010000,2,4006,1003,1,172080000,172080000,1501,500,1001,500,0,1,502,1918946,1.918946
6300,2700,500,17010000,2,4006,1003,1,172080000,172080000,1501,500,1001,500,0,1,502,1854350,1.85435
6300,2700,500,17010000,2,4006,1003,1,172080000,172080000,1501,500,1001,500,0,1,502,1942893,1.942893
6300,2700,500,17010000,2,4006,1003,1,172080000,172080000,1501,500,1001,500,0,1,502,1906554,1.906554
6300,2700,900,17010000,2,7206,1803,1,200880000,200880000,2701,900,1801,900,0,1,902,2972140,2.97214
6300,2700,900,17010000,2,7206,1803,1,200880000,200880000,2701,900,1801,900,0,1,902,3082623,3.082623
6300,2700,900,17010000,2,7206,1803,1,200880000,200880000,2701,900,1801,900,0,1,902,2959702,2.959702
6300,2700,900,17010000,2,7206,1803,1,200880000,200880000,2701,900,1801,900,0,1,902,3099293,3.099293
6300,2700,900,17010000,2,7206,1803,1,200880000,200880000,2701,900,1801,900,0,1,902,2971733,2.971733
6300,2700,900,17010000,2,7206,1803,1,200880000,200880000,2701,900,1801,900,0,1,902,3010763,3.010763
6300,2700,900,17010000,2,7206,1803,1,200880000,200880000,2701,900,1801,900,0,1,902,3040934,3.040934
6300,2700,1300,17010000,2,10406,2603,1,229680000,229680000,3901,1300,2601,1300,0,1,1302,4196010,4.19601
6300,2700,1300,17010000,2,10406,2603,1,229680000,229680000,3901,1300,2601,1300,0,1,1302,4372336,4.372336
6300,2700,1300,17010000,2,10406,2603,1,229680000,229680000,3901,1300,2601,1300,0,1,1302,4207524,4.207524
6300,2700,1300,17010000,2,10406,2603,1,229680000,229680000,3901,1300,2601,1300,0,1,1302,4401536,4.401536
6300,2700,1300,17010000,2,10406,2603,1,229680000,229680000,3901,1300,2601,1300,0,1,1302,4226088,4.226088
6300,2700,1300,17010000,2,10406,2603,1,229680000,229680000,3901,1300,2601,1300,0,1,1302,4237792,4.237792
6300,2700,1300,17010000,2,10406,2603,1,229680000,229680000,3901,1300,2601,1300,0,1,1302,4333062,4.333062
6300,2700,1700,17010000,2,13606,3403,1,258480000,258480000,5101,1700,3401,1700,0,1,1702,5458116,5.458116
6300,2700,1700,17010000,2,13606,3403,1,258480000,258480000,5101,1700,3401,1700,0,1,1702,5668177,5.668177
6300,2700,1700,17010000,2,13606,3403,1,258480000,258480000,5101,1700,3401,1700,0,1,1702,5446540,5.44654
6300,2700,1700,17010000,2,13606,3403,1,258480000,258480000,5101,1700,3401,1700,0,1,1702,5728651,5.728651
6300,2700,1700,17010000,2,13606,3403,1,258480000,258480000,5101,1700,3401,1700,0,1,1702,5524407,5.524407
6300,2700,1700,17010000,2,13606,3403,1,258480000,258480000,5101,1700,3401,1700,0,1,1702,5486977,5.486977
6300,2700,1700,17010000,2,13606,3403,1,258480000,258480000,5101,1700,3401,1700,0,1,1702,5625809,5.625809
6300,2700,2100,17010000,2,16806,4203,1,287280000,287280000,6301,2100,4201,2100,0,1,2102,6854931,6.854931
6300,2700,2100,17010000,2,16806,4203,1,287280000,287280000,6301,2100,4201,2100,0,1,2102,7049408,7.049408
6300,2700,2100,17010000,2,16806,4203,1,287280000,287280000,6301,2100,4201,2100,0,1,2102,6843162,6.843162
6300,2700,2100,17010000,2,16806,4203,1,287280000,287280000,6301,2100,4201,2100,0,1,2102,7139968,7.139968
6300,2700,2100,17010000,2,16806,4203,1,287280000,287280000,6301,2100,4201,2100,0,1,2102,6930723,6.930723
6300,2700,2100,17010000,2,16806,4203,1,287280000,287280000,6301,2100,4201,2100,0,1,2102,6890489,6.890489
6300,2700,2100,17010000,2,16806,4203,1,287280000,287280000,6301,2100,4201,2100,0,1,2102,7019709,7.019709
6300,2700,2500,17010000,2,20006,5003,1,316080000,316080000,7501,2500,5001,2500,0,1,2502,7929271,7.929271
6300,2700,2500,17010000,2,20006,5003,1,316080000,316080000,7501,2500,5001,2500,0,1,2502,8279746,8.279746
6300,2700,2500,17010000,2,20006,5003,1,316080000,316080000,7501,2500,5001,2500,0,1,2502,7940974,7.940974
6300,2700,2500,17010000,2,20006,5003,1,316080000,316080000,7501,2500,5001,2500,0,1,2502,8329871,8.329871
6300,2700,2500,17010000,2,20006,5003,1,316080000,316080000,7501,2500,5001,2500,0,1,2502,8062984,8.062984
6300,2700,2500,17010000,2,20006,5003,1,316080000,316080000,7501,2500,5001,2500,0,1,2502,7976449,7.976449
6300,2700,2500,17010000,2,20006,5003,1,316080000,316080000,7501,2500,5001,2500,0,1,2502,8192511,8.192511
6300,2700,2900,17010000,2,23206,5803,1,344880000,344880000,8701,2900,5801,2900,0,1,2902,9359514,9.359514
6300,2700,2900,17010000,2,23206,5803,1,344880000,344880000,8701,2900,5801,2900,0,1,2902,9714100,9.7141
6300,2700,2900,17010000,2,23206,5803,1,344880000,344880000,8701,2900,5801,2900,0,1,2902,9342436,9.342436
6300,2700,2900,17010000,2,23206,5803,1,344880000,344880000,8701,2900,5801,2900,0,1,2902,9763440,9.76344
6300,2700,2900,17010000,2,23206,5803,1,344880000,344880000,8701,2900,5801,2900,0,1,2902,9440962,9.440962
6300,2700,2900,17010000,2,23206,5803,1,344880000,344880000,8701,2900,5801,2900,0,1,2902,9395736,9.395736
6300,2700,2900,17010000,2,23206,5803,1,344880000,344880000,8701,2900,5801,2900,0,1,2902,9575154,9.575154
6300,2700,3300,17010000,2,26406,6603,1,373680000,373680000,9901,3300,6601,3300,0,1,3302,10556453,10.556453
6300,2700,3300,17010000,2,26406,6603,1,373680000,373680000,9901,3300,6601,3300,0,1,3302,11003872,11.003872
6300,2700,3300,17010000,2,26406,6603,1,373680000,373680000,9901,3300,6601,3300,0,1,3302,10568149,10.568149
6300,2700,3300,17010000,2,26406,6603,1,373680000,373680000,9901,3300,6601,3300,0,1,3302,11046722,11.046722
6300,2700,3300,17010000,2,26406,6603,1,373680000,373680000,9901,3300,6601,3300,0,1,3302,10727293,10.727293
6300,2700,3300,17010000,2,26406,6603,1,373680000,373680000,9901,3300,6601,3300,0,1,3302,10640680,10.64068
6300,2700,3300,17010000,2,26406,6603,1,373680000,373680000,9901,3300,6601,3300,0,1,3302,10882898,10.882898
6300,2700,3700,17010000,2,29606,7403,1,402480000,402480000,11101,3700,7401,3700,0,1,3702,11645921,11.645921
6300,2700,3700,17010000,2,29606,7403,1,402480000,402480000,11101,3700,7401,3700,0,1,3702,12196173,12.196173
6300,2700,3700,17010000,2,29606,7403,1,402480000,402480000,11101,3700,7401,3700,0,1,3702,11664746,11.664746
6300,2700,3700,17010000,2,29606,7403,1,402480000,402480000,11101,3700,7401,3700,0,1,3702,12275747,12.275747
6300,2700,3700,17010000,2,29606,7403,1,402480000,402480000,11101,3700,7401,3700,0,1,3702,11861642,11.861642
6300,2700,3700,17010000,2,29606,7403,1,402480000,402480000,11101,3700,7401,3700,0,1,3702,11732170,11.73217
6300,2700,3700,17010000,2,29606,7403,1,402480000,402480000,11101,3700,7401,3700,0,1,3702,12065877,12.065877
6300,2700,4100,17010000,2,32806,8203,1,431280000,431280000,12301,4100,8201,4100,0,1,4102,13068179,13.068179
6300,2700,4100,17010000,2,32806,8203,1,431280000,431280000,12301,4100,8201,4100,0,1,4102,13597540,13.59754
6300,2700,4100,17010000,2,32806,8203,1,431280000,431280000,12301,4100,8201,4100,0,1,4102,13080301,13.080301
6300,2700,4100,17010000,2,32806,8203,1,431280000,431280000,12301,4100,8201,4100,0,1,4102,13711064,13.711064
6300,2700,4100,17010000,2,32806,8203,1,431280000,431280000,12301,4100,8201,4100,0,1,4102,13178805,13.178805
6300,2700,4100,17010000,2,32806,8203,1,431280000,431280000,12301,4100,8201,4100,0,1,4102,13167044,13.167044
6300,2700,4100,17010000,2,32806,8203,1,431280000,431280000,12301,4100,8201,4100,0,1,4102,13487827,13.487827
6300,2700,4500,17010000,2,36006,9003,1,460080000,460080000,13501,4500,9001,4500,0,1,4502,14300863,14.300863
6300,2700,4500,17010000,2,36006,9003,1,460080000,460080000,13501,4500,9001,4500,0,1,4502,14923028,14.923028
6300,2700,4500,17010000,2,36006,9003,1,460080000,460080000,13501,4500,9001,4500,0,1,4502,14320914,14.320914
6300,2700,4500,17010000,2,36006,9003,1,460080000,460080000,13501,4500,9001,4500,0,1,4502,14988833,14.988833
6300,2700,4500,17010000,2,36006,9003,1,460080000,460080000,13501,4500,9001,4500,0,1,4502,14411818,14.411818
6300,2700,4500,17010000,2,36006,9003,1,460080000,460080000,13501,4500,9001,4500,0,1,4502,14369713,14.369713
6300,2700,4500,17010000,2,36006,9003,1,460080000,460080000,13501,4500,9001,4500,0,1,4502,14769850,14.76985
6300,2700,4900,17010000,2,39206,9803,1,488880000,488880000,14701,4900,9801,4900,0,1,4902,15593347,15.593347
6300,2700,4900,17010000,2,39206,9803,1,488880000,488880000,14701,4900,9801,4900,0,1,4902,16229060,16.22906
6300,2700,4900,17010000,2,39206,9803,1,488880000,488880000,14701,4900,9801,4900,0,1,4902,15592742,15.592742
6300,2700,4900,17010000,2,39206,9803,1,488880000,488880000,14701,4900,9801,4900,0,1,4902,16338911,16.338911
6300,2700,4900,17010000,2,39206,9803,1,488880000,488880000,14701,4900,9801,4900,0,1,4902,15683307,15.683307
6300,2700,4900,17010000,2,39206,9803,1,488880000,488880000,14701,4900,9801,4900,0,1,4902,15671510,15.67151
6300,2700,4900,17010000,2,39206,9803,1,488880000,488880000,14701,4900,9801,4900,0,1,4902,16083492,16.083492
6300,2700,5300,17010000,2,42406,10603,1,517680000,517680000,15901,5300,10601,5300,0,1,5302,16851505,16.851505
6300,2700,5300,17010000,2,42406,10603,1,517680000,517680000,15901,5300,10601,5300,0,1,5302,17547460,17.54746
6300,2700,5300,17010000,2,42406,10603,1,517680000,517680000,15901,5300,10601,5300,0,1,5302,16873068,16.873068
6300,2700,5300,17010000,2,42406,10603,1,517680000,517680000,15901,5300,10601,5300,0,1,5302,17656836,17.656836
6300,2700,5300,17010000,2,42406,10603,1,517680000,517680000,15901,5300,10601,5300,0,1,5302,16953877,16.953877
6300,2700,5300,17010000,2,42406,10603,1,517680000,517680000,15901,5300,10601,5300,0,1,5302,16923836,16.923836
6300,2700,5300,17010000,2,42406,10603,1,517680000,517680000,15901,5300,10601,5300,0,1,5302,17410200,17.4102
6300,2700,5700,17010000,2,45606,11403,1,546480000,546480000,17101,5700,11401,5700,0,1,5702,18082606,18.082606
6300,2700,5700,17010000,2,45606,11403,1,546480000,546480000,17101,5700,11401,5700,0,1,5702,18838105,18.838105
6300,2700,5700,17010000,2,45606,11403,1,546480000,546480000,17101,5700,11401,5700,0,1,5702,18110021,18.110021
6300,2700,5700,17010000,2,45606,11403,1,546480000,546480000,17101,5700,11401,5700,0,1,5702,18972412,18.972412
6300,2700,5700,17010000,2,45606,11403,1,546480000,546480000,17101,5700,11401,5700,0,1,5702,18217800,18.2178
6300,2700,5700,17010000,2,45606,11403,1,546480000,546480000,17101,5700,11401,5700,0,1,5702,18174612,18.174612
6300,2700,5700,17010000,2,45606,11403,1,546480000,546480000,17101,5700,11401,5700,0,1,5702,18713474,18.713474
6300,2700,6100,17010000,2,48806,12203,1,575280000,575280000,18301,6100,12201,6100,0,1,6102,19260981,19.260981
6300,2700,6100,17010000,2,48806,12203,1,575280000,575280000,18301,6100,12201,6100,0,1,6102,20123266,20.123266
6300,2700,6100,17010000,2,48806,12203,1,575280000,575280000,18301,6100,12201,6100,0,1,6102,19316059,19.316059
6300,2700,6100,17010000,2,48806,12203,1,575280000,575280000,18301,6100,12201,6100,0,1,6102,20275218,20.275218
6300,2700,6100,17010000,2,48806,12203,1,575280000,575280000,18301,6100,12201,6100,0,1,6102,19432040,19.43204
6300,2700,6100,17010000,2,48806,12203,1,575280000,575280000,18301,6100,12201,6100,0,1,6102,19380003,19.380003
6300,2700,6100,17010000,2,48806,12203,1,575280000,575280000,18301,6100,12201,6100,0,1,6102,19967374,19.967374
6300,2700,6500,17010000,2,52006,13003,1,604080000,604080000,19501,6500,13001,6500,0,1,6502,20590332,20.590332
6300,2700,6500,17010000,2,52006,13003,1,604080000,604080000,19501,6500,13001,6500,0,1,6502,21455500,21.4555
6300,2700,6500,17010000,2,52006,13003,1,604080000,604080000,19501,6500,13001,6500,0,1,6502,20602711,20.602711
6300,2700,6500,17010000,2,52006,13003,1,604080000,604080000,19501,6500,13001,6500,0,1,6502,21609670,21.60967
6300,2700,6500,17010000,2,52006,13003,1,604080000,604080000,19501,6500,13001,6500,0,1,6502,20712276,20.712276
6300,2700,6500,17010000,2,52006,13003,1,604080000,604080000,19501,6500,13001,6500,0,1,6502,20699725,20.699725
6300,2700,6500,17010000,2,52006,13003,1,604080000,604080000,19501,6500,13001,6500,0,1,6502,21228366,21.228366
6300,2700,6900,17010000,2,55206,13803,1,632880000,632880000,20701,6900,13801,6900,0,1,6902,21852229,21.852229
6300,2700,6900,17010000,2,55206,13803,1,632880000,632880000,20701,6900,13801,6900,0,1,6902,22804037,22.804037
6300,2700,6900,17010000,2,55206,13803,1,632880000,632880000,20701,6900,13801,6900,0,1,6902,21839068,21.839068
6300,2700,6900,17010000,2,55206,13803,1,632880000,632880000,20701,6900,13801,6900,0,1,6902,22884445,22.884445
6300,2700,6900,17010000,2,55206,13803,1,632880000,632880000,20701,6900,13801,6900,0,1,6902,21991225,21.991225
6300,2700,6900,17010000,2,55206,13803,1,632880000,632880000,20701,6900,13801,6900,0,1,6902,21966661,21.966661
6300,2700,6900,17010000,2,55206,13803,1,632880000,632880000,20701,6900,13801,6900,0,1,6902,22547766,22.547766
6300,2300,500,14490000,2,4006,1003,1,150320000,150320000,1501,500,1001,500,0,1,502,1640921,1.640921
6300,2300,500,14490000,2,4006,1003,1,150320000,150320000,1501,500,1001,500,0,1,502,1664117,1.664117
6300,2300,500,14490000,2,4006,1003,1,150320000,150320000,1501,500,1001,500,0,1,502,1622370,1.62237
6300,2300,500,14490000,2,4006,1003,1,150320000,150320000,1501,500,1001,500,0,1,502,1653044,1.653044
6300,2300,500,14490000,2,4006,1003,1,150320000,150320000,1501,500,1001,500,0,1,502,1604094,1.604094
6300,2300,500,14490000,2,4006,1003,1,150320000,150320000,1501,500,1001,500,0,1,502,1682495,1.682495
6300,2300,500,14490000,2,4006,1003,1,150320000,150320000,1501,500,1001,500,0,1,502,1653469,1.653469
6300,2300,900,14490000,2,7206,1803,1,177840000,177840000,2701,900,1801,900,0,1,902,2552208,2.552208
6300,2300,900,14490000,2,7206,1803,1,177840000,177840000,2701,900,1801,900,0,1,902,2631538,2.631538
6300,2300,900,14490000,2,7206,1803,1,177840000,177840000,2701,900,1801,900,0,1,902,2513856,2.513856
6300,2300,900,14490000,2,7206,1803,1,177840000,177840000,2701,900,1801,900,0,1,902,2642138,2.642138
6300,2300,900,14490000,2,7206,1803,1,177840000,177840000,2701,900,1801,900,0,1,902,2562439,2.562439
6300,2300,900,14490000,2,7206,1803,1,177840000,177840000,2701,900,1801,900,0,1,902,2607518,2.607518
6300,2300,900,14490000,2,7206,1803,1,177840000,177840000,2701,900,1801,900,0,1,902,2597358,2.597358
6300,2300,1300,14490000,2,10406,2603,1,205360000,205360000,3901,1300,2601,1300,0,1,1302,3587299,3.587299
6300,2300,1300,14490000,2,10406,2603,1,205360000,205360000,3901,1300,2601,1300,0,1,1302,3730603,3.730603
6300,2300,1300,14490000,2,10406,2603,1,205360000,205360000,3901,1300,2601,1300,0,1,1302,3577239,3.577239
6300,2300,1300,14490000,2,10406,2603,1,205360000,205360000,3901,1300,2601,1300,0,1,1302,3749741,3.749741
6300,2300,1300,14490000,2,10406,2603,1,205360000,205360000,3901,1300,2601,1300,0,1,1302,3647771,3.647771
6300,2300,1300,14490000,2,10406,2603,1,205360000,205360000,3901,1300,2601,1300,0,1,1302,3637549,3.637549
6300,2300,1300,14490000,2,10406,2603,1,205360000,205360000,3901,1300,2601,1300,0,1,1302,3691608,3.691608
6300,2300,1700,14490000,2,13606,3403,1,232880000,232880000,5101,1700,3401,1700,0,1,1702,4644042,4.644042
6300,2300,1700,14490000,2,13606,3403,1,232880000,232880000,5101,1700,3401,1700,0,1,1702,4842076,4.842076
6300,2300,1700,14490000,2,13606,3403,1,232880000,232880000,5101,1700,3401,1700,0,1,1702,4654080,4.65408
6300,2300,1700,14490000,2,13606,3403,1,232880000,232880000,5101,1700,3401,1700,0,1,1702,4868900,4.8689
6300,2300,1700,14490000,2,13606,3403,1,232880000,232880000,5101,1700,3401,1700,0,1,1702,4714225,4.714225
6300,2300,1700,14490000,2,13606,3403,1,232880000,232880000,5101,1700,3401,1700,0,1,1702,4673376,4.673376
6300,2300,1700,14490000,2,13606,3403,1,232880000,232880000,5101,1700,3401,1700,0,1,1702,4814073,4.814073
6300,2300,2100,14490000,2,16806,4203,1,260400000,260400000,6301,2100,4201,2100,0,1,2102,5880267,5.880267
6300,2300,2100,14490000,2,16806,4203,1,260400000,260400000,6301,2100,4201,2100,0,1,2102,6086928,6.086928
6300,2300,2100,14490000,2,16806,4203,1,260400000,260400000,6301,2100,4201,2100,0,1,2102,5864256,5.864256
6300,2300,2100,14490000,2,16806,4203,1,260400000,260400000,6301,2100,4201,2100,0,1,2102,6124805,6.124805
6300,2300,2100,14490000,2,16806,4203,1,260400000,260400000,6301,2100,4201,2100,0,1,2102,5925605,5.925605
6300,2300,2100,14490000,2,16806,4203,1,260400000,260400000,6301,2100,4201,2100,0,1,2102,5864682,5.864682
6300,2300,2100,14490000,2,16806,4203,1,260400000,260400000,6301,2100,4201,2100,0,1,2102,6010226,6.010226
6300,2300,2500,14490000,2,20006,5003,1,287920000,287920000,7501,2500,5001,2500,0,1,2502,6768018,6.768018
6300,2300,2500,14490000,2,20006,5003,1,287920000,287920000,7501,2500,5001,2500,0,1,2502,7050368,7.050368
6300,2300,2500,14490000,2,20006,5003,1,287920000,287920000,7501,2500,5001,2500,0,1,2502,6757928,6.757928
6300,2300,2500,14490000,2,20006,5003,1,287920000,287920000,7501,2500,5001,2500,0,1,2502,7107142,7.107142
6300,2300,2500,14490000,2,20006,5003,1,287920000,287920000,7501,2500,5001,2500,0,1,2502,6872600,6.8726
6300,2300,2500,14490000,2,20006,5003,1,287920000,287920000,7501,2500,5001,2500,0,1,2502,6794978,6.794978
6300,2300,2500,14490000,2,20006,5003,1,287920000,287920000,7501,2500,5001,2500,0,1,2502,6988365,6.988365
6300,2300,2900,14490000,2,23206,5803,1,315440000,315440000,8701,2900,5801,2900,0,1,2902,7818587,7.818587
6300,2300,2900,14490000,2,23206,5803,1,315440000,315440000,8701,2900,5801,2900,0,1,2902,8164139,8.164139
6300,2300,2900,14490000,2,23206,5803,1,315440000,315440000,8701,2900,5801,2900,0,1,2902,7828650,7.82865
6300,2300,2900,14490000,2,23206,5803,1,315440000,315440000,8701,2900,5801,2900,0,1,2902,8223950,8.22395
6300,2300,2900,14490000,2,23206,5803,1,315440000,315440000,8701,2900,5801,2900,0,1,2902,7947157,7.947157
6300,2300,2900,14490000,2,23206,5803,1,315440000,315440000,8701,2900,5801,2900,0,1,2902,7884707,7.884707
6300,2300,2900,14490000,2,23206,5803,1,315440000,315440000,8701,2900,5801,2900,0,1,2902,8096907,8.096907
6300,2300,3300,14490000,2,26406,6603,1,342960000,342960000,9901,3300,6601,3300,0,1,3302,9047800,9.0478
6300,2300,3300,14490000,2,26406,6603,1,342960000,342960000,9901,3300,6601,3300,0,1,3302,9382317,9.382317
6300,2300,3300,14490000,2,26406,6603,1,342960000,342960000,9901,3300,6601,3300,0,1,3302,9068078,9.068078
6300,2300,3300,14490000,2,26406,6603,1,342960000,342960000,9901,3300,6601,3300,0,1,3302,9463763,9.463763
6300,2300,3300,14490000,2,26406,6603,1,342960000,342960000,9901,3300,6601,3300,0,1,3302,9149756,9.149756
6300,2300,3300,14490000,2,26406,6603,1,342960000,342960000,9901,3300,6601,3300,0,1,3302,9057966,9.057966
6300,2300,3300,14490000,2,26406,6603,1,342960000,342960000,9901,3300,6601,3300,0,1,3302,9304210,9.30421
6300,2300,3700,14490000,2,29606,7403,1,370480000,370480000,11101,3700,7401,3700,0,1,3702,10134748,10.134748
6300,2300,3700,14490000,2,29606,7403,1,370480000,370480000,11101,3700,7401,3700,0,1,3702,10533471,10.533471
6300,2300,3700,14490000,2,29606,7403,1,370480000,370480000,11101,3700,7401,3700,0,1,3702,10124652,10.124652
6300,2300,3700,14490000,2,29606,7403,1,370480000,370480000,11101,3700,7401,3700,0,1,3702,10592103,10.592103
6300,2300,3700,14490000,2,29606,7403,1,370480000,370480000,11101,3700,7401,3700,0,1,3702,10240919,10.240919
6300,2300,3700,14490000,2,29606,7403,1,370480000,370480000,11101,3700,7401,3700,0,1,3702,10219678,10.219678
6300,2300,3700,14490000,2,29606,7403,1,370480000,370480000,11101,3700,7401,3700,0,1,3702,10388743,10.388743
6300,2300,4100,14490000,2,32806,8203,1,398000000,398000000,12301,4100,8201,4100,0,1,4102,11161180,11.16118
6300,2300,4100,14490000,2,32806,8203,1,398000000,398000000,12301,4100,8201,4100,0,1,4102,11626902,11.626902
6300,2300,4100,14490000,2,32806,8203,1,398000000,398000000,12301,4100,8201,4100,0,1,4102,11199882,11.199882
6300,2300,4100,14490000,2,32806,8203,1,398000000,398000000,12301,4100,8201,4100,0,1,4102,11709316,11.709316
6300,2300,4100,14490000,2,32806,8203,1,398000000,398000000,12301,4100,8201,4100,0,1,4102,11293441,11.293441
6300,2300,4100,14490000,2,32806,8203,1,398000000,398000000,12301,4100,8201,4100,0,1,4102,11251896,11.251896
6300,2300,4100,14490000,2,32806,8203,1,398000000,398000000,12301,4100,8201,4100,0,1,4102,11492277,11.492277
6300,2300,4500,14490000,2,36006,9003,1,425520000,425520000,13501,4500,9001,4500,0,1,4502,12078821,12.078821
6300,2300,4500,14490000,2,36006,9003,1,425520000,425520000,13501,4500,9001,4500,0,1,4502,12620892,12.620892
6300,2300,4500,14490000,2,36006,9003,1,425520000,425520000,13501,4500,9001,4500,0,1,4502,12107218,12.107218
6300,2300,4500,14490000,2,36006,9003,1,425520000,425520000,13501,4500,9001,4500,0,1,4502,12718169,12.718169
6300,2300,4500,14490000,2,36006,9003,1,425520000,425520000,13501,4500,9001,4500,0,1,4502,12241103,12.241103
6300,2300,4500,14490000,2,36006,9003,1,425520000,425520000,13501,4500,9001,4500,0,1,4502,12134131,12.134131
6300,2300,4500,14490000,2,36006,9003,1,425520000,425520000,13501,4500,9001,4500,0,1,4502,12497674,12.497674
6300,2300,4900,14490000,2,39206,9803,1,453040000,453040000,14701,4900,9801,4900,0,1,4902,13268449,13.268449
6300,2300,4900,14490000,2,39206,9803,1,453040000,453040000,14701,4900,9801,4900,0,1,4902,13796880,13.79688
6300,2300,4900,14490000,2,39206,9803,1,453040000,453040000,14701,4900,9801,4900,0,1,4902,13286254,13.286254
6300,2300,4900,14490000,2,39206,9803,1,453040000,453040000,14701,4900,9801,4900,0,1,4902,13926417,13.926417
6300,2300,4900,14490000,2,39206,9803,1,453040000,453040000,14701,4900,9801,4900,0,1,4902,13418095,13.418095
6300,2300,4900,14490000,2,39206,9803,1,453040000,453040000,14701,4900,9801,4900,0,1,4902,13353445,13.353445
6300,2300,4900,14490000,2,39206,9803,1,453040000,453040000,14701,4900,9801,4900,0,1,4902,13716435,13.716435
6300,2300,5300,14490000,2,42406,10603,1,480560000,480560000,15901,5300,10601,5300,0,1,5302,14410450,14.41045
6300,2300,5300,14490000,2,42406,10603,1,480560000,480560000,15901,5300,10601,5300,0,1,5302,14963767,14.963767
6300,2300,5300,14490000,2,42406,10603,1,480560000,480560000,15901,5300,10601,5300,0,1,5302,14420552,14.420552
6300,2300,5300,14490000,2,42406,10603,1,480560000,480560000,15901,5300,10601,5300,0,1,5302,15095030,15.09503
6300,2300,5300,14490000,2,42406,10603,1,480560000,480560000,15901,5300,10601,5300,0,1,5302,14448492,14.448492
6300,2300,5300,14490000,2,42406,10603,1,480560000,480560000,15901,5300,10601,5300,0,1,5302,14355646,14.355646
6300,2300,5300,14490000,2,42406,10603,1,480560000,480560000,15901,5300,10601,5300,0,1,5302,14837923,14.837923
6300,2300,5700,14490000,2,45606,11403,1,508080000,508080000,17101,5700,11401,5700,0,1,5702,15480504,15.480504
6300,2300,5700,14490000,2,45606,11403,1,508080000,508080000,17101,5700,11401,5700,0,1,5702,16080302,16.080302
6300,2300,5700,14490000,2,45606,11403,1,508080000,508080000,17101,5700,11401,5700,0,1,5702,15490665,15.490665
6300,2300,5700,14490000,2,45606,11403,1,508080000,508080000,17101,5700,11401,5700,0,1,5702,16220553,16.220553
6300,2300,5700,14490000,2,45606,11403,1,508080000,508080000,17101,5700,11401,5700,0,1,5702,15509675,15.509675
6300,2300,5700,14490000,2,45606,11403,1,508080000,508080000,17101,5700,11401,5700,0,1,5702,15422416,15.422416
6300,2300,5700,14490000,2,45606,11403,1,508080000,508080000,17101,5700,11401,5700,0,1,5702,15916053,15.916053
6300,2300,6100,14490000,2,48806,12203,1,535600000,535600000,18301,6100,12201,6100,0,1,6102,16535904,16.535904
6300,2300,6100,14490000,2,48806,12203,1,535600000,535600000,18301,6100,12201,6100,0,1,6102,17211404,17.211404
6300,2300,6100,14490000,2,48806,12203,1,535600000,535600000,18301,6100,12201,6100,0,1,6102,16555699,16.555699
6300,2300,6100,14490000,2,48806,12203,1,535600000,535600000,18301,6100,12201,6100,0,1,6102,17340163,17.340163
6300,2300,6100,14490000,2,48806,12203,1,535600000,535600000,18301,6100,12201,6100,0,1,6102,16584690,16.58469
6300,2300,6100,14490000,2,48806,12203,1,535600000,535600000,18301,6100,12201,6100,0,1,6102,16471695,16.471695
6300,2300,6100,14490000,2,48806,12203,1,535600000,535600000,18301,6100,12201,6100,0,1,6102,17025111,17.025111
6300,2300,6500,14490000,2,52006,13003,1,563120000,563120000,19501,6500,13001,6500,0,1,6502,17555421,17.555421
6300,2300,6500,14490000,2,52006,13003,1,563120000,563120000,19501,6500,13001,6500,0,1,6502,18315611,18.315611
6300,2300,6500,14490000,2,52006,13003,1,563120000,563120000,19501,6500,13001,6500,0,1,6502,17597131,17.597131
6300,2300,6500,14490000,2,52006,13003,1,563120000,563120000,19501,6500,13001,6500,0,1,6502,18462651,18.462651
6300,2300,6500,14490000,2,52006,13003,1,563120000,563120000,19501,6500,13001,6500,0,1,6502,17649841,17.649841
6300,2300,6500,14490000,2,52006,13003,1,563120000,563120000,19501,6500,13001,6500,0,1,6502,17576460,17.57646
6300,2300,6500,14490000,2,52006,13003,1,563120000,563120000,19501,6500,13001,6500,0,1,6502,18098873,18.098873
6300,2300,6900,14490000,2,55206,13803,1,590640000,590640000,20701,6900,13801,6900,0,1,6902,18641410,18.64141
6300,2300,6900,14490000,2,55206,13803,1,590640000,590640000,20701,6900,13801,6900,0,1,6902,19439811,19.439811
6300,2300,6900,14490000,2,55206,13803,1,590640000,590640000,20701,6900,13801,6900,0,1,6902,18662419,18.662419
6300,2300,6900,14490000,2,55206,13803,1,590640000,590640000,20701,6900,13801,6900,0,1,6902,19607541,19.607541
6300,2300,6900,14490000,2,55206,13803,1,590640000,590640000,20701,6900,13801,6900,0,1,6902,18760313,18.760313
6300,2300,6900,14490000,2,55206,13803,1,590640000,590640000,20701,6900,13801,6900,0,1,6902,18613426,18.613426
6300,2300,6900,14490000,2,55206,13803,1,590640000,590640000,20701,6900,13801,6900,0,1,6902,19248512,19.248512
6300,1900,500,11970000,2,4006,1003,1,128560000,128560000,1501,500,1001,500,0,1,502,1389018,1.389018
6300,1900,500,11970000,2,4006,1003,1,128560000,128560000,1501,500,1001,500,0,1,502,1416814,1.416814
6300,1900,500,11970000,2,4006,1003,1,128560000,128560000,1501,500,1001,500,0,1,502,1380218,1.380218
6300,1900,500,11970000,2,4006,1003,1,128560000,128560000,1501,500,1001,500,0,1,502,1407971,1.407971
6300,1900,500,11970000,2,4006,1003,1,128560000,128560000,1501,500,1001,500,0,1,502,1371695,1.371695
6300,1900,500,11970000,2,4006,1003,1,128560000,128560000,1501,500,1001,500,0,1,502,1353983,1.353983
6300,1900,500,11970000,2,4006,1003,1,128560000,128560000,1501,500,1001,500,0,1,502,1363286,1.363286
6300,1900,900,11970000,2,7206,1803,1,154800000,154800000,2701,900,1801,900,0,1,902,2102783,2.102783
6300,1900,900,11970000,2,7206,1803,1,154800000,154800000,2701,900,1801,900,0,1,902,2166826,2.166826
6300,1900,900,11970000,2,7206,1803,1,154800000,154800000,2701,900,1801,900,0,1,902,2087744,2.087744
6300,1900,900,11970000,2,7206,1803,1,154800000,154800000,2701,900,1801,900,0,1,902,2184509,2.184509
6300,1900,900,11970000,2,7206,1803,1,154800000,154800000,2701,900,1801,900,0,1,902,2111128,2.111128
6300,1900,900,11970000,2,7206,1803,1,154800000,154800000,2701,900,1801,900,0,1,902,2119531,2.119531
6300,1900,900,11970000,2,7206,1803,1,154800000,154800000,2701,900,1801,900,0,1,902,2175644,2.175644
6300,1900,1300,11970000,2,10406,2603,1,181040000,181040000,3901,1300,2601,1300,0,1,1302,2979751,2.979751
6300,1900,1300,11970000,2,10406,2603,1,181040000,181040000,3901,1300,2601,1300,0,1,1302,3085480,3.08548
6300,1900,1300,11970000,2,10406,2603,1,181040000,181040000,3901,1300,2601,1300,0,1,1302,2957582,2.957582
6300,1900,1300,11970000,2,10406,2603,1,181040000,181040000,3901,1300,2601,1300,0,1,1302,3102333,3.102333
6300,1900,1300,11970000,2,10406,2603,1,181040000,181040000,3901,1300,2601,1300,0,1,1302,2990514,2.990514
6300,1900,1300,11970000,2,10406,2603,1,181040000,181040000,3901,1300,2601,1300,0,1,1302,2971375,2.971375
6300,1900,1300,11970000,2,10406,2603,1,181040000,181040000,3901,1300,2601,1300,0,1,1302,3053235,3.053235
6300,1900,1700,11970000,2,13606,3403,1,207280000,207280000,5101,1700,3401,1700,0,1,1702,3848376,3.848376
6300,1900,1700,11970000,2,13606,3403,1,207280000,207280000,5101,1700,3401,1700,0,1,1702,4020580,4.02058
6300,1900,1700,11970000,2,13606,3403,1,207280000,207280000,5101,1700,3401,1700,0,1,1702,3828274,3.828274
6300,1900,1700,11970000,2,13606,3403,1,207280000,207280000,5101,1700,3401,1700,0,1,1702,4031823,4.031823
6300,1900,1700,11970000,2,13606,3403,1,207280000,207280000,5101,1700,3401,1700,0,1,1702,3899563,3.899563
6300,1900,1700,11970000,2,13606,3403,1,207280000,207280000,5101,1700,3401,1700,0,1,1702,3874526,3.874526
6300,1900,1700,11970000,2,13606,3403,1,207280000,207280000,5101,1700,3401,1700,0,1,1702,3956818,3.956818
6300,1900,2100,11970000,2,16806,4203,1,233520000,233520000,6301,2100,4201,2100,0,1,2102,4745702,4.745702
6300,1900,2100,11970000,2,16806,4203,1,233520000,233520000,6301,2100,4201,2100,0,1,2102,4915358,4.915358
6300,1900,2100,11970000,2,16806,4203,1,233520000,233520000,6301,2100,4201,2100,0,1,2102,4725654,4.725654
6300,1900,2100,11970000,2,16806,4203,1,233520000,233520000,6301,2100,4201,2100,0,1,2102,4953117,4.953117
6300,1900,2100,11970000,2,16806,4203,1,233520000,233520000,6301,2100,4201,2100,0,1,2102,4801485,4.801485
6300,1900,2100,11970000,2,16806,4203,1,233520000,233520000,6301,2100,4201,2100,0,1,2102,4754107,4.754107
6300,1900,2100,11970000,2,16806,4203,1,233520000,233520000,6301,2100,4201,2100,0,1,2102,4885634,4.885634
6300,1900,2500,11970000,2,20006,5003,1,259760000,259760000,7501,2500,5001,2500,0,1,2502,5794578,5.794578
6300,1900,2500,11970000,2,20006,5003,1,259760000,259760000,7501,2500,5001,2500,0,1,2502,5906322,5.906322
6300,1900,2500,11970000,2,20006,5003,1,259760000,259760000,7501,2500,5001,2500,0,1,2502,5777586,5.777586
6300,1900,2500,11970000,2,20006,5003,1,259760000,259760000,7501,2500,5001,2500,0,1,2502,5980443,5.980443
6300,1900,2500,11970000,2,20006,5003,1,259760000,259760000,7501,2500,5001,2500,0,1,2502,5823765,5.823765
6300,1900,2500,11970000,2,20006,5003,1,259760000,259760000,7501,2500,5001,2500,0,1,2502,5794078,5.794078
6300,1900,2500,11970000,2,20006,5003,1,259760000,259760000,7501,2500,5001,2500,0,1,2502,5897398,5.897398
6300,1900,2900,11970000,2,23206,5803,1,286000000,286000000,8701,2900,5801,2900,0,1,2902,6479598,6.479598
6300,1900,2900,11970000,2,23206,5803,1,286000000,286000000,8701,2900,5801,2900,0,1,2902,6773355,6.773355
6300,1900,2900,11970000,2,23206,5803,1,286000000,286000000,8701,2900,5801,2900,0,1,2902,6493876,6.493876
6300,1900,2900,11970000,2,23206,5803,1,286000000,286000000,8701,2900,5801,2900,0,1,2902,6800246,6.800246
6300,1900,2900,11970000,2,23206,5803,1,286000000,286000000,8701,2900,5801,2900,0,1,2902,6581685,6.581685
6300,1900,2900,11970000,2,23206,5803,1,286000000,286000000,8701,2900,5801,2900,0,1,2902,6502499,6.502499
6300,1900,2900,11970000,2,23206,5803,1,286000000,286000000,8701,2900,5801,2900,0,1,2902,6700437,6.700437
6300,1900,3300,11970000,2,26406,6603,1,312240000,312240000,9901,3300,6601,3300,0,1,3302,7529866,7.529866
6300,1900,3300,11970000,2,26406,6603,1,312240000,312240000,9901,3300,6601,3300,0,1,3302,7790920,7.79092
6300,1900,3300,11970000,2,26406,6603,1,312240000,312240000,9901,3300,6601,3300,0,1,3302,7510561,7.510561
6300,1900,3300,11970000,2,26406,6603,1,312240000,312240000,9901,3300,6601,3300,0,1,3302,7839967,7.839967
6300,1900,3300,11970000,2,26406,6603,1,312240000,312240000,9901,3300,6601,3300,0,1,3302,7542662,7.542662
6300,1900,3300,11970000,2,26406,6603,1,312240000,312240000,9901,3300,6601,3300,0,1,3302,7551154,7.551154
6300,1900,3300,11970000,2,26406,6603,1,312240000,312240000,9901,3300,6601,3300,0,1,3302,7755688,7.755688
6300,1900,3700,11970000,2,29606,7403,1,338480000,338480000,11101,3700,7401,3700,0,1,3702,8227404,8.227404
6300,1900,3700,11970000,2,29606,7403,1,338480000,338480000,11101,3700,7401,3700,0,1,3702,8608258,8.608258
6300,1900,3700,11970000,2,29606,7403,1,338480000,338480000,11101,3700,7401,3700,0,1,3702,8259451,8.259451
6300,1900,3700,11970000,2,29606,7403,1,338480000,338480000,11101,3700,7401,3700,0,1,3702,8660794,8.660794
6300,1900,3700,11970000,2,29606,7403,1,338480000,338480000,11101,3700,7401,3700,0,1,3702,8363466,8.363466
6300,1900,3700,11970000,2,29606,7403,1,338480000,338480000,11101,3700,7401,3700,0,1,3702,8251045,8.251045
6300,1900,3700,11970000,2,29606,7403,1,338480000,338480000,11101,3700,7401,3700,0,1,3702,8520507,8.520507
6300,1900,4100,11970000,2,32806,8203,1,364720000,364720000,12301,4100,8201,4100,0,1,4102,9247220,9.24722
6300,1900,4100,11970000,2,32806,8203,1,364720000,364720000,12301,4100,8201,4100,0,1,4102,9614998,9.614998
6300,1900,4100,11970000,2,32806,8203,1,364720000,364720000,12301,4100,8201,4100,0,1,4102,9203403,9.203403
6300,1900,4100,11970000,2,32806,8203,1,364720000,364720000,12301,4100,8201,4100,0,1,4102,9680569,9.680569
6300,1900,4100,11970000,2,32806,8203,1,364720000,364720000,12301,4100,8201,4100,0,1,4102,9346804,9.346804
6300,1900,4100,11970000,2,32806,8203,1,364720000,364720000,12301,4100,8201,4100,0,1,4102,9281014,9.281014
6300,1900,4100,11970000,2,32806,8203,1,364720000,364720000,12301,4100,8201,4100,0,1,4102,9549738,9.549738
6300,1900,4500,11970000,2,36006,9003,1,390960000,390960000,13501,4500,9001,4500,0,1,4502,10173009,10.173009
6300,1900,4500,11970000,2,36006,9003,1,390960000,390960000,13501,4500,9001,4500,0,1,4502,10554836,10.554836
6300,1900,4500,11970000,2,36006,9003,1,390960000,390960000,13501,4500,9001,4500,0,1,4502,10141629,10.141629
6300,1900,4500,11970000,2,36006,9003,1,390960000,390960000,13501,4500,9001,4500,0,1,4502,10637451,10.637451
6300,1900,4500,11970000,2,36006,9003,1,390960000,390960000,13501,4500,9001,4500,0,1,4502,10234689,10.234689
6300,1900,4500,11970000,2,36006,9003,1,390960000,390960000,13501,4500,9001,4500,0,1,4502,10142137,10.142137
6300,1900,4500,11970000,2,36006,9003,1,390960000,390960000,13501,4500,9001,4500,0,1,4502,10445044,10.445044
6300,1900,4900,11970000,2,39206,9803,1,417200000,417200000,14701,4900,9801,4900,0,1,4902,11053258,11.053258
6300,1900,4900,11970000,2,39206,9803,1,417200000,417200000,14701,4900,9801,4900,0,1,4902,11453929,11.453929
6300,1900,4900,11970000,2,39206,9803,1,417200000,417200000,14701,4900,9801,4900,0,1,4902,11068097,11.068097
6300,1900,4900,11970000,2,39206,9803,1,417200000,417200000,14701,4900,9801,4900,0,1,4902,11537789,11.537789
6300,1900,4900,11970000,2,39206,9803,1,417200000,417200000,14701,4900,9801,4900,0,1,4902,11149904,11.149904
6300,1900,4900,11970000,2,39206,9803,1,417200000,417200000,14701,4900,9801,4900,0,1,4902,11084817,11.084817
6300,1900,4900,11970000,2,39206,9803,1,417200000,417200000,14701,4900,9801,4900,0,1,4902,11364665,11.364665
6300,1900,5300,11970000,2,42406,10603,1,443440000,443440000,15901,5300,10601,5300,0,1,5302,11944748,11.944748
6300,1900,5300,11970000,2,42406,10603,1,443440000,443440000,15901,5300,10601,5300,0,1,5302,12399071,12.399071
6300,1900,5300,11970000,2,42406,10603,1,443440000,443440000,15901,5300,10601,5300,0,1,5302,11936299,11.936299
6300,1900,5300,11970000,2,42406,10603,1,443440000,443440000,15901,5300,10601,5300,0,1,5302,12489897,12.489897
6300,1900,5300,11970000,2,42406,10603,1,443440000,443440000,15901,5300,10601,5300,0,1,5302,12049677,12.049677
6300,1900,5300,11970000,2,42406,10603,1,443440000,443440000,15901,5300,10601,5300,0,1,5302,12011963,12.011963
6300,1900,5300,11970000,2,42406,10603,1,443440000,443440000,15901,5300,10601,5300,0,1,5302,12280515,12.280515
6300,1900,5700,11970000,2,45606,11403,1,469680000,469680000,17101,5700,11401,5700,0,1,5702,12859141,12.859141
6300,1900,5700,11970000,2,45606,11403,1,469680000,469680000,17101,5700,11401,5700,0,1,5702,13293460,13.29346
6300,1900,5700,11970000,2,45606,11403,1,469680000,469680000,17101,5700,11401,5700,0,1,5702,12850605,12.850605
6300,1900,5700,11970000,2,45606,11403,1,469680000,469680000,17101,5700,11401,5700,0,1,5702,13389222,13.389222
6300,1900,5700,11970000,2,45606,11403,1,469680000,469680000,17101,5700,11401,5700,0,1,5702,12939595,12.939595
6300,1900,5700,11970000,2,45606,11403,1,469680000,469680000,17101,5700,11401,5700,0,1,5702,12867622,12.867622
6300,1900,5700,11970000,2,45606,11403,1,469680000,469680000,17101,5700,11401,5700,0,1,5702,13204142,13.204142
6300,1900,6100,11970000,2,48806,12203,1,495920000,495920000,18301,6100,12201,6100,0,1,6102,13707068,13.707068
6300,1900,6100,11970000,2,48806,12203,1,495920000,495920000,18301,6100,12201,6100,0,1,6102,14230071,14.230071
6300,1900,6100,11970000,2,48806,12203,1,495920000,495920000,18301,6100,12201,6100,0,1,6102,13715528,13.715528
6300,1900,6100,11970000,2,48806,12203,1,495920000,495920000,18301,6100,12201,6100,0,1,6102,14332521,14.332521
6300,1900,6100,11970000,2,48806,12203,1,495920000,495920000,18301,6100,12201,6100,0,1,6102,13799962,13.799962
6300,1900,6100,11970000,2,48806,12203,1,495920000,495920000,18301,6100,12201,6100,0,1,6102,13767892,13.767892
6300,1900,6100,11970000,2,48806,12203,1,495920000,495920000,18301,6100,12201,6100,0,1,6102,14090091,14.090091
6300,1900,6500,11970000,2,52006,13003,1,522160000,522160000,19501,6500,13001,6500,0,1,6502,14578701,14.578701
6300,1900,6500,11970000,2,52006,13003,1,522160000,522160000,19501,6500,13001,6500,0,1,6502,15180035,15.180035
6300,1900,6500,11970000,2,52006,13003,1,522160000,522160000,19501,6500,13001,6500,0,1,6502,14587661,14.587661
6300,1900,6500,11970000,2,52006,13003,1,522160000,522160000,19501,6500,13001,6500,0,1,6502,15286862,15.286862
6300,1900,6500,11970000,2,52006,13003,1,522160000,522160000,19501,6500,13001,6500,0,1,6502,14694709,14.694709
6300,1900,6500,11970000,2,52006,13003,1,522160000,522160000,19501,6500,13001,6500,0,1,6502,14677750,14.67775
6300,1900,6500,11970000,2,52006,13003,1,522160000,522160000,19501,6500,13001,6500,0,1,6502,15003276,15.003276
6300,1900,6900,11970000,2,55206,13803,1,548400000,548400000,20701,6900,13801,6900,0,1,6902,15404555,15.404555
6300,1900,6900,11970000,2,55206,13803,1,548400000,548400000,20701,6900,13801,6900,0,1,6902,16061806,16.061806
6300,1900,6900,11970000,2,55206,13803,1,548400000,548400000,20701,6900,13801,6900,0,1,6902,15482216,15.482216
6300,1900,6900,11970000,2,55206,13803,1,548400000,548400000,20701,6900,13801,6900,0,1,6902,16225442,16.225442
6300,1900,6900,11970000,2,55206,13803,1,548400000,548400000,20701,6900,13801,6900,0,1,6902,15552218,15.552218
6300,1900,6900,11970000,2,55206,13803,1,548400000,548400000,20701,6900,13801,6900,0,1,6902,15463211,15.463211
6300,1900,6900,11970000,2,55206,13803,1,548400000,548400000,20701,6900,13801,6900,0,1,6902,15974528,15.974528
6300,1500,500,9450000,2,4006,1003,1,106800000,106800000,1501,500,1001,500,0,1,502,1104695,1.104695
6300,1500,500,9450000,2,4006,1003,1,106800000,106800000,1501,500,1001,500,0,1,502,1124554,1.124554
6300,1500,500,9450000,2,4006,1003,1,106800000,106800000,1501,500,1001,500,0,1,502,1082010,1.08201
6300,1500,500,9450000,2,4006,1003,1,106800000,106800000,1501,500,1001,500,0,1,502,1118279,1.118279
6300,1500,500,9450000,2,4006,1003,1,106800000,106800000,1501,500,1001,500,0,1,502,1150830,1.15083
6300,1500,500,9450000,2,4006,1003,1,106800000,106800000,1501,500,1001,500,0,1,502,1157873,1.157873
6300,1500,500,9450000,2,4006,1003,1,106800000,106800000,1501,500,1001,500,0,1,502,1131379,1.131379
6300,1500,900,9450000,2,7206,1803,1,131760000,131760000,2701,900,1801,900,0,1,902,1657531,1.657531
6300,1500,900,9450000,2,7206,1803,1,131760000,131760000,2701,900,1801,900,0,1,902,1719659,1.719659
6300,1500,900,9450000,2,7206,1803,1,131760000,131760000,2701,900,1801,900,0,1,902,1664227,1.664227
6300,1500,900,9450000,2,7206,1803,1,131760000,131760000,2701,900,1801,900,0,1,902,1727793,1.727793
6300,1500,900,9450000,2,7206,1803,1,131760000,131760000,2701,900,1801,900,0,1,902,1671067,1.671067
6300,1500,900,9450000,2,7206,1803,1,131760000,131760000,2701,900,1801,900,0,1,902,1704550,1.70455
6300,1500,900,9450000,2,7206,1803,1,131760000,131760000,2701,900,1801,900,0,1,902,1695404,1.695404
6300,1500,1300,9450000,2,10406,2603,1,156720000,156720000,3901,1300,2601,1300,0,1,1302,2359085,2.359085
6300,1500,1300,9450000,2,10406,2603,1,156720000,156720000,3901,1300,2601,1300,0,1,1302,2436826,2.436826
6300,1500,1300,9450000,2,10406,2603,1,156720000,156720000,3901,1300,2601,1300,0,1,1302,2344818,2.344818
6300,1500,1300,9450000,2,10406,2603,1,156720000,156720000,3901,1300,2601,1300,0,1,1302,2456747,2.456747
6300,1500,1300,9450000,2,10406,2603,1,156720000,156720000,3901,1300,2601,1300,0,1,1302,2370413,2.370413
6300,1500,1300,9450000,2,10406,2603,1,156720000,156720000,3901,1300,2601,1300,0,1,1302,2387399,2.387399
6300,1500,1300,9450000,2,10406,2603,1,156720000,156720000,3901,1300,2601,1300,0,1,1302,2416891,2.416891
6300,1500,1700,9450000,2,13606,3403,1,181680000,181680000,5101,1700,3401,1700,0,1,1702,3048163,3.048163
6300,1500,1700,9450000,2,13606,3403,1,181680000,181680000,5101,1700,3401,1700,0,1,1702,3174901,3.174901
6300,1500,1700,9450000,2,13606,3403,1,181680000,181680000,5101,1700,3401,1700,0,1,1702,3041417,3.041417
6300,1500,1700,9450000,2,13606,3403,1,181680000,181680000,5101,1700,3401,1700,0,1,1702,3190999,3.190999
6300,1500,1700,9450000,2,13606,3403,1,181680000,181680000,5101,1700,3401,1700,0,1,1702,3072710,3.07271
6300,1500,1700,9450000,2,13606,3403,1,181680000,181680000,5101,1700,3401,1700,0,1,1702,3086090,3.08609
6300,1500,1700,9450000,2,13606,3403,1,181680000,181680000,5101,1700,3401,1700,0,1,1702,3128335,3.128335
6300,1500,2100,9450000,2,16806,4203,1,206640000,206640000,6301,2100,4201,2100,0,1,2102,3739693,3.739693
6300,1500,2100,9450000,2,16806,4203,1,206640000,206640000,6301,2100,4201,2100,0,1,2102,3886217,3.886217
6300,1500,2100,9450000,2,16806,4203,1,206640000,206640000,6301,2100,4201,2100,0,1,2102,3746429,3.746429
6300,1500,2100,9450000,2,16806,4203,1,206640000,206640000,6301,2100,4201,2100,0,1,2102,3920680,3.92068
6300,1500,2100,9450000,2,16806,4203,1,206640000,206640000,6301,2100,4201,2100,0,1,2102,3756145,3.756145
6300,1500,2100,9450000,2,16806,4203,1,206640000,206640000,6301,2100,4201,2100,0,1,2102,3771940,3.77194
6300,1500,2100,9450000,2,16806,4203,1,206640000,206640000,6301,2100,4201,2100,0,1,2102,3853253,3.853253
6300,1500,2500,9450000,2,20006,5003,1,231600000,231600000,7501,2500,5001,2500,0,1,2502,4421945,4.421945
6300,1500,2500,9450000,2,20006,5003,1,231600000,231600000,7501,2500,5001,2500,0,1,2502,4613137,4.613137
6300,1500,2500,9450000,2,20006,5003,1,231600000,231600000,7501,2500,5001,2500,0,1,2502,4432190,4.43219
6300,1500,2500,9450000,2,20006,5003,1,231600000,231600000,7501,2500,5001,2500,0,1,2502,4642252,4.642252
6300,1500,2500,9450000,2,20006,5003,1,231600000,231600000,7501,2500,5001,2500,0,1,2502,4476034,4.476034
6300,1500,2500,9450000,2,20006,5003,1,231600000,231600000,7501,2500,5001,2500,0,1,2502,4469177,4.469177
6300,1500,2500,9450000,2,20006,5003,1,231600000,231600000,7501,2500,5001,2500,0,1,2502,4576299,4.576299
6300,1500,2900,9450000,2,23206,5803,1,256560000,256560000,8701,2900,5801,2900,0,1,2902,5324676,5.324676
6300,1500,2900,9450000,2,23206,5803,1,256560000,256560000,8701,2900,5801,2900,0,1,2902,5486990,5.48699
6300,1500,2900,9450000,2,23206,5803,1,256560000,256560000,8701,2900,5801,2900,0,1,2902,5284499,5.284499
6300,1500,2900,9450000,2,23206,5803,1,256560000,256560000,8701,2900,5801,2900,0,1,2902,5518258,5.518258
6300,1500,2900,9450000,2,23206,5803,1,256560000,256560000,8701,2900,5801,2900,0,1,2902,5338406,5.338406
6300,1500,2900,9450000,2,23206,5803,1,256560000,256560000,8701,2900,5801,2900,0,1,2902,5305039,5.305039
6300,1500,2900,9450000,2,23206,5803,1,256560000,256560000,8701,2900,5801,2900,0,1,2902,5417398,5.417398
6300,1500,3300,9450000,2,26406,6603,1,281520000,281520000,9901,3300,6601,3300,0,1,3302,5833324,5.833324
6300,1500,3300,9450000,2,26406,6603,1,281520000,281520000,9901,3300,6601,3300,0,1,3302,6072659,6.072659
6300,1500,3300,9450000,2,26406,6603,1,281520000,281520000,9901,3300,6601,3300,0,1,3302,5846779,5.846779
6300,1500,3300,9450000,2,26406,6603,1,281520000,281520000,9901,3300,6601,3300,0,1,3302,6126952,6.126952
6300,1500,3300,9450000,2,26406,6603,1,281520000,281520000,9901,3300,6601,3300,0,1,3302,5909656,5.909656
6300,1500,3300,9450000,2,26406,6603,1,281520000,281520000,9901,3300,6601,3300,0,1,3302,5840065,5.840065
6300,1500,3300,9450000,2,26406,6603,1,281520000,281520000,9901,3300,6601,3300,0,1,3302,6045413,6.045413
6300,1500,3700,9450000,2,29606,7403,1,306480000,306480000,11101,3700,7401,3700,0,1,3702,6547640,6.54764
6300,1500,3700,9450000,2,29606,7403,1,306480000,306480000,11101,3700,7401,3700,0,1,3702,6811984,6.811984
6300,1500,3700,9450000,2,29606,7403,1,306480000,306480000,11101,3700,7401,3700,0,1,3702,6554366,6.554366
6300,1500,3700,9450000,2,29606,7403,1,306480000,306480000,11101,3700,7401,3700,0,1,3702,6877661,6.877661
6300,1500,3700,9450000,2,29606,7403,1,306480000,306480000,11101,3700,7401,3700,0,1,3702,6621186,6.621186
6300,1500,3700,9450000,2,29606,7403,1,306480000,306480000,11101,3700,7401,3700,0,1,3702,6574292,6.574292
6300,1500,3700,9450000,2,29606,7403,1,306480000,306480000,11101,3700,7401,3700,0,1,3702,6754511,6.754511
6300,1500,4100,9450000,2,32806,8203,1,331440000,331440000,12301,4100,8201,4100,0,1,4102,7396585,7.396585
6300,1500,4100,9450000,2,32806,8203,1,331440000,331440000,12301,4100,8201,4100,0,1,4102,7648610,7.64861
6300,1500,4100,9450000,2,32806,8203,1,331440000,331440000,12301,4100,8201,4100,0,1,4102,7403319,7.403319
6300,1500,4100,9450000,2,32806,8203,1,331440000,331440000,12301,4100,8201,4100,0,1,4102,7713662,7.713662
6300,1500,4100,9450000,2,32806,8203,1,331440000,331440000,12301,4100,8201,4100,0,1,4102,7479716,7.479716
6300,1500,4100,9450000,2,32806,8203,1,331440000,331440000,12301,4100,8201,4100,0,1,4102,7452015,7.452015
6300,1500,4100,9450000,2,32806,8203,1,331440000,331440000,12301,4100,8201,4100,0,1,4102,7610918,7.610918
6300,1500,4500,9450000,2,36006,9003,1,356400000,356400000,13501,4500,9001,4500,0,1,4502,8065618,8.065618
6300,1500,4500,9450000,2,36006,9003,1,356400000,356400000,13501,4500,9001,4500,0,1,4502,8262083,8.262083
6300,1500,4500,9450000,2,36006,9003,1,356400000,356400000,13501,4500,9001,4500,0,1,4502,8066087,8.066087
6300,1500,4500,9450000,2,36006,9003,1,356400000,356400000,13501,4500,9001,4500,0,1,4502,8332252,8.332252
6300,1500,4500,9450000,2,36006,9003,1,356400000,356400000,13501,4500,9001,4500,0,1,4502,8034481,8.034481
6300,1500,4500,9450000,2,36006,9003,1,356400000,356400000,13501,4500,9001,4500,0,1,4502,8006353,8.006353
6300,1500,4500,9450000,2,36006,9003,1,356400000,356400000,13501,4500,9001,4500,0,1,4502,8187537,8.187537
6300,1500,4900,9450000,2,39206,9803,1,381360000,381360000,14701,4900,9801,4900,0,1,4902,8611687,8.611687
6300,1500,4900,9450000,2,39206,9803,1,381360000,381360000,14701,4900,9801,4900,0,1,4902,9090906,9.090906
6300,1500,4900,9450000,2,39206,9803,1,381360000,381360000,14701,4900,9801,4900,0,1,4902,8654991,8.654991
6300,1500,4900,9450000,2,39206,9803,1,381360000,381360000,14701,4900,9801,4900,0,1,4902,9167383,9.167383
6300,1500,4900,9450000,2,39206,9803,1,381360000,381360000,14701,4900,9801,4900,0,1,4902,8843480,8.84348
6300,1500,4900,9450000,2,39206,9803,1,381360000,381360000,14701,4900,9801,4900,0,1,4902,8648226,8.648226
6300,1500,4900,9450000,2,39206,9803,1,381360000,381360000,14701,4900,9801,4900,0,1,4902,9045329,9.045329
6300,1500,5300,9450000,2,42406,10603,1,406320000,406320000,15901,5300,10601,5300,0,1,5302,9490819,9.490819
6300,1500,5300,9450000,2,42406,10603,1,406320000,406320000,15901,5300,10601,5300,0,1,5302,9852972,9.852972
6300,1500,5300,9450000,2,42406,10603,1,406320000,406320000,15901,5300,10601,5300,0,1,5302,9460929,9.460929
6300,1500,5300,9450000,2,42406,10603,1,406320000,406320000,15901,5300,10601,5300,0,1,5302,9921780,9.92178
6300,1500,5300,9450000,2,42406,10603,1,406320000,406320000,15901,5300,10601,5300,0,1,5302,9593185,9.593185
6300,1500,5300,9450000,2,42406,10603,1,406320000,406320000,15901,5300,10601,5300,0,1,5302,9557870,9.55787
6300,1500,5300,9450000,2,42406,10603,1,406320000,406320000,15901,5300,10601,5300,0,1,5302,9707246,9.707246
6300,1500,5700,9450000,2,45606,11403,1,431280000,431280000,17101,5700,11401,5700,0,1,5702,10217843,10.217843
6300,1500,5700,9450000,2,45606,11403,1,431280000,431280000,17101,5700,11401,5700,0,1,5702,10556896,10.556896
6300,1500,5700,9450000,2,45606,11403,1,431280000,431280000,17101,5700,11401,5700,0,1,5702,10224617,10.224617
6300,1500,5700,9450000,2,45606,11403,1,431280000,431280000,17101,5700,11401,5700,0,1,5702,10628143,10.628143
6300,1500,5700,9450000,2,45606,11403,1,431280000,431280000,17101,5700,11401,5700,0,1,5702,10272347,10.272347
6300,1500,5700,9450000,2,45606,11403,1,431280000,431280000,17101,5700,11401,5700,0,1,5702,10237342,10.237342
6300,1500,5700,9450000,2,45606,11403,1,431280000,431280000,17101,5700,11401,5700,0,1,5702,10476224,10.476224
6300,1500,6100,9450000,2,48806,12203,1,456240000,456240000,18301,6100,12201,6100,0,1,6102,10866161,10.866161
6300,1500,6100,9450000,2,48806,12203,1,456240000,456240000,18301,6100,12201,6100,0,1,6102,11200770,11.20077
6300,1500,6100,9450000,2,48806,12203,1,456240000,456240000,18301,6100,12201,6100,0,1,6102,10918388,10.918388
6300,1500,6100,9450000,2,48806,12203,1,456240000,456240000,18301,6100,12201,6100,0,1,6102,11275650,11.27565
6300,1500,6100,9450000,2,48806,12203,1,456240000,456240000,18301,6100,12201,6100,0,1,6102,10843305,10.843305
6300,1500,6100,9450000,2,48806,12203,1,456240000,456240000,18301,6100,12201,6100,0,1,6102,10932268,10.932268
6300,1500,6100,9450000,2,48806,12203,1,456240000,456240000,18301,6100,12201,6100,0,1,6102,11083779,11.083779
6300,1500,6500,9450000,2,52006,13003,1,481200000,481200000,19501,6500,13001,6500,0,1,6502,11616239,11.616239
6300,1500,6500,9450000,2,52006,13003,1,481200000,481200000,19501,6500,13001,6500,0,1,6502,12009595,12.009595
6300,1500,6500,9450000,2,52006,13003,1,481200000,481200000,19501,6500,13001,6500,0,1,6502,11602227,11.602227
6300,1500,6500,9450000,2,52006,13003,1,481200000,481200000,19501,6500,13001,6500,0,1,6502,12099945,12.099945
6300,1500,6500,9450000,2,52006,13003,1,481200000,481200000,19501,6500,13001,6500,0,1,6502,11640312,11.640312
6300,1500,6500,9450000,2,52006,13003,1,481200000,481200000,19501,6500,13001,6500,0,1,6502,11659793,11.659793
6300,1500,6500,9450000,2,52006,13003,1,481200000,481200000,19501,6500,13001,6500,0,1,6502,11928733,11.928733
6300,1500,6900,9450000,2,55206,13803,1,506160000,506160000,20701,6900,13801,6900,0,1,6902,12288277,12.288277
6300,1500,6900,9450000,2,55206,13803,1,506160000,506160000,20701,6900,13801,6900,0,1,6902,12750126,12.750126
6300,1500,6900,9450000,2,55206,13803,1,506160000,506160000,20701,6900,13801,6900,0,1,6902,12307206,12.307206
6300,1500,6900,9450000,2,55206,13803,1,506160000,506160000,20701,6900,13801,6900,0,1,6902,12833795,12.833795
6300,1500,6900,9450000,2,55206,13803,1,506160000,506160000,20701,6900,13801,6900,0,1,6902,12366934,12.366934
6300,1500,6900,9450000,2,55206,13803,1,506160000,506160000,20701,6900,13801,6900,0,1,6902,12359253,12.359253
6300,1500,6900,9450000,2,55206,13803,1,506160000,506160000,20701,6900,13801,6900,0,1,6902,12644473,12.644473
6300,1100,500,6930000,2,4006,1003,1,85040000,85040000,1501,500,1001,500,0,1,502,702969,0.702969
6300,1100,500,6930000,2,4006,1003,1,85040000,85040000,1501,500,1001,500,0,1,502,878828,0.878828
6300,1100,500,6930000,2,4006,1003,1,85040000,85040000,1501,500,1001,500,0,1,502,707940,0.70794
6300,1100,500,6930000,2,4006,1003,1,85040000,85040000,1501,500,1001,500,0,1,502,873647,0.873647
6300,1100,500,6930000,2,4006,1003,1,85040000,85040000,1501,500,1001,500,0,1,502,844329,0.844329
6300,1100,500,6930000,2,4006,1003,1,85040000,85040000,1501,500,1001,500,0,1,502,717526,0.717526
6300,1100,500,6930000,2,4006,1003,1,85040000,85040000,1501,500,1001,500,0,1,502,838890,0.83889
6300,1100,900,6930000,2,7206,1803,1,108720000,108720000,2701,900,1801,900,0,1,902,1223126,1.223126
6300,1100,900,6930000,2,7206,1803,1,108720000,108720000,2701,900,1801,900,0,1,902,1265921,1.265921
6300,1100,900,6930000,2,7206,1803,1,108720000,108720000,2701,900,1801,900,0,1,902,1218035,1.218035
6300,1100,900,6930000,2,7206,1803,1,108720000,108720000,2701,900,1801,900,0,1,902,1260645,1.260645
6300,1100,900,6930000,2,7206,1803,1,108720000,108720000,2701,900,1801,900,0,1,902,1229170,1.22917
6300,1100,900,6930000,2,7206,1803,1,108720000,108720000,2701,900,1801,900,0,1,902,1255705,1.255705
6300,1100,900,6930000,2,7206,1803,1,108720000,108720000,2701,900,1801,900,0,1,902,1243140,1.24314
6300,1100,1300,6930000,2,10406,2603,1,132400000,132400000,3901,1300,2601,1300,0,1,1302,1738093,1.738093
6300,1100,1300,6930000,2,10406,2603,1,132400000,132400000,3901,1300,2601,1300,0,1,1302,1799775,1.799775
6300,1100,1300,6930000,2,10406,2603,1,132400000,132400000,3901,1300,2601,1300,0,1,1302,1733046,1.733046
6300,1100,1300,6930000,2,10406,2603,1,132400000,132400000,3901,1300,2601,1300,0,1,1302,1806476,1.806476
6300,1100,1300,6930000,2,10406,2603,1,132400000,132400000,3901,1300,2601,1300,0,1,1302,1751042,1.751042
6300,1100,1300,6930000,2,10406,2603,1,132400000,132400000,3901,1300,2601,1300,0,1,1302,1762592,1.762592
6300,1100,1300,6930000,2,10406,2603,1,132400000,132400000,3901,1300,2601,1300,0,1,1302,1777404,1.777404
6300,1100,1700,6930000,2,13606,3403,1,156080000,156080000,5101,1700,3401,1700,0,1,1702,2253722,2.253722
6300,1100,1700,6930000,2,13606,3403,1,156080000,156080000,5101,1700,3401,1700,0,1,1702,2336238,2.336238
6300,1100,1700,6930000,2,13606,3403,1,156080000,156080000,5101,1700,3401,1700,0,1,1702,2248674,2.248674
6300,1100,1700,6930000,2,13606,3403,1,156080000,156080000,5101,1700,3401,1700,0,1,1702,2349661,2.349661
6300,1100,1700,6930000,2,13606,3403,1,156080000,156080000,5101,1700,3401,1700,0,1,1702,2272570,2.27257
6300,1100,1700,6930000,2,13606,3403,1,156080000,156080000,5101,1700,3401,1700,0,1,1702,2277558,2.277558
6300,1100,1700,6930000,2,13606,3403,1,156080000,156080000,5101,1700,3401,1700,0,1,1702,2306694,2.306694
6300,1100,2100,6930000,2,16806,4203,1,179760000,179760000,6301,2100,4201,2100,0,1,2102,2759935,2.759935
6300,1100,2100,6930000,2,16806,4203,1,179760000,179760000,6301,2100,4201,2100,0,1,2102,2873037,2.873037
6300,1100,2100,6930000,2,16806,4203,1,179760000,179760000,6301,2100,4201,2100,0,1,2102,2764969,2.764969
6300,1100,2100,6930000,2,16806,4203,1,179760000,179760000,6301,2100,4201,2100,0,1,2102,2883215,2.883215
6300,1100,2100,6930000,2,16806,4203,1,179760000,179760000,6301,2100,4201,2100,0,1,2102,2791363,2.791363
6300,1100,2100,6930000,2,16806,4203,1,179760000,179760000,6301,2100,4201,2100,0,1,2102,2798434,2.798434
6300,1100,2100,6930000,2,16806,4203,1,179760000,179760000,6301,2100,4201,2100,0,1,2102,2835181,2.835181
6300,1100,2500,6930000,2,20006,5003,1,203440000,203440000,7501,2500,5001,2500,0,1,2502,3280099,3.280099
6300,1100,2500,6930000,2,20006,5003,1,203440000,203440000,7501,2500,5001,2500,0,1,2502,3402732,3.402732
6300,1100,2500,6930000,2,20006,5003,1,203440000,203440000,7501,2500,5001,2500,0,1,2502,3285131,3.285131
6300,1100,2500,6930000,2,20006,5003,1,203440000,203440000,7501,2500,5001,2500,0,1,2502,3425013,3.425013
6300,1100,2500,6930000,2,20006,5003,1,203440000,203440000,7501,2500,5001,2500,0,1,2502,3312515,3.312515
6300,1100,2500,6930000,2,20006,5003,1,203440000,203440000,7501,2500,5001,2500,0,1,2502,3317513,3.317513
6300,1100,2500,6930000,2,20006,5003,1,203440000,203440000,7501,2500,5001,2500,0,1,2502,3368533,3.368533
6300,1100,2900,6930000,2,23206,5803,1,227120000,227120000,8701,2900,5801,2900,0,1,2902,3999655,3.999655
6300,1100,2900,6930000,2,23206,5803,1,227120000,227120000,8701,2900,5801,2900,0,1,2902,3937478,3.937478
6300,1100,2900,6930000,2,23206,5803,1,227120000,227120000,8701,2900,5801,2900,0,1,2902,3968747,3.968747
6300,1100,2900,6930000,2,23206,5803,1,227120000,227120000,8701,2900,5801,2900,0,1,2902,3980188,3.980188
6300,1100,2900,6930000,2,23206,5803,1,227120000,227120000,8701,2900,5801,2900,0,1,2902,3835128,3.835128
6300,1100,2900,6930000,2,23206,5803,1,227120000,227120000,8701,2900,5801,2900,0,1,2902,3999249,3.999249
6300,1100,2900,6930000,2,23206,5803,1,227120000,227120000,8701,2900,5801,2900,0,1,2902,3903907,3.903907
6300,1100,3300,6930000,2,26406,6603,1,250800000,250800000,9901,3300,6601,3300,0,1,3302,4296586,4.296586
6300,1100,3300,6930000,2,26406,6603,1,250800000,250800000,9901,3300,6601,3300,0,1,3302,4479326,4.479326
6300,1100,3300,6930000,2,26406,6603,1,250800000,250800000,9901,3300,6601,3300,0,1,3302,4288827,4.288827
6300,1100,3300,6930000,2,26406,6603,1,250800000,250800000,9901,3300,6601,3300,0,1,3302,4506117,4.506117
6300,1100,3300,6930000,2,26406,6603,1,250800000,250800000,9901,3300,6601,3300,0,1,3302,4361407,4.361407
6300,1100,3300,6930000,2,26406,6603,1,250800000,250800000,9901,3300,6601,3300,0,1,3302,4321916,4.321916
6300,1100,3300,6930000,2,26406,6603,1,250800000,250800000,9901,3300,6601,3300,0,1,3302,4430491,4.430491
6300,1100,3700,6930000,2,29606,7403,1,274480000,274480000,11101,3700,7401,3700,0,1,3702,4811659,4.811659
6300,1100,3700,6930000,2,29606,7403,1,274480000,274480000,11101,3700,7401,3700,0,1,3702,5106595,5.106595
6300,1100,3700,6930000,2,29606,7403,1,274480000,274480000,11101,3700,7401,3700,0,1,3702,4805952,4.805952
6300,1100,3700,6930000,2,29606,7403,1,274480000,274480000,11101,3700,7401,3700,0,1,3702,5189764,5.189764
6300,1100,3700,6930000,2,29606,7403,1,274480000,274480000,11101,3700,7401,3700,0,1,3702,4997457,4.997457
6300,1100,3700,6930000,2,29606,7403,1,274480000,274480000,11101,3700,7401,3700,0,1,3702,4811212,4.811212
6300,1100,3700,6930000,2,29606,7403,1,274480000,274480000,11101,3700,7401,3700,0,1,3702,5089129,5.089129
6300,1100,4100,6930000,2,32806,8203,1,298160000,298160000,12301,4100,8201,4100,0,1,4102,5337727,5.337727
6300,1100,4100,6930000,2,32806,8203,1,298160000,298160000,12301,4100,8201,4100,0,1,4102,5555055,5.555055
6300,1100,4100,6930000,2,32806,8203,1,298160000,298160000,12301,4100,8201,4100,0,1,4102,5342764,5.342764
6300,1100,4100,6930000,2,32806,8203,1,298160000,298160000,12301,4100,8201,4100,0,1,4102,5594405,5.594405
6300,1100,4100,6930000,2,32806,8203,1,298160000,298160000,12301,4100,8201,4100,0,1,4102,5416316,5.416316
6300,1100,4100,6930000,2,32806,8203,1,298160000,298160000,12301,4100,8201,4100,0,1,4102,5388349,5.388349
6300,1100,4100,6930000,2,32806,8203,1,298160000,298160000,12301,4100,8201,4100,0,1,4102,5502370,5.50237
6300,1100,4500,6930000,2,36006,9003,1,321840000,321840000,13501,4500,9001,4500,0,1,4502,5996059,5.996059
6300,1100,4500,6930000,2,36006,9003,1,321840000,321840000,13501,4500,9001,4500,0,1,4502,6085937,6.085937
6300,1100,4500,6930000,2,36006,9003,1,321840000,321840000,13501,4500,9001,4500,0,1,4502,5967172,5.967172
6300,1100,4500,6930000,2,36006,9003,1,321840000,321840000,13501,4500,9001,4500,0,1,4502,6123657,6.123657
6300,1100,4500,6930000,2,36006,9003,1,321840000,321840000,13501,4500,9001,4500,0,1,4502,5913515,5.913515
6300,1100,4500,6930000,2,36006,9003,1,321840000,321840000,13501,4500,9001,4500,0,1,4502,6062866,6.062866
6300,1100,4500,6930000,2,36006,9003,1,321840000,321840000,13501,4500,9001,4500,0,1,4502,6041420,6.04142
6300,1100,4900,6930000,2,39206,9803,1,345520000,345520000,14701,4900,9801,4900,0,1,4902,6341814,6.341814
6300,1100,4900,6930000,2,39206,9803,1,345520000,345520000,14701,4900,9801,4900,0,1,4902,6732252,6.732252
6300,1100,4900,6930000,2,39206,9803,1,345520000,345520000,14701,4900,9801,4900,0,1,4902,6365473,6.365473
6300,1100,4900,6930000,2,39206,9803,1,345520000,345520000,14701,4900,9801,4900,0,1,4902,6768464,6.768464
6300,1100,4900,6930000,2,39206,9803,1,345520000,345520000,14701,4900,9801,4900,0,1,4902,6577624,6.577624
6300,1100,4900,6930000,2,39206,9803,1,345520000,345520000,14701,4900,9801,4900,0,1,4902,6382255,6.382255
6300,1100,4900,6930000,2,39206,9803,1,345520000,345520000,14701,4900,9801,4900,0,1,4902,6689057,6.689057
6300,1100,5300,6930000,2,42406,10603,1,369200000,369200000,15901,5300,10601,5300,0,1,5302,7046028,7.046028
6300,1100,5300,6930000,2,42406,10603,1,369200000,369200000,15901,5300,10601,5300,0,1,5302,7162568,7.162568
6300,1100,5300,6930000,2,42406,10603,1,369200000,369200000,15901,5300,10601,5300,0,1,5302,7025004,7.025004
6300,1100,5300,6930000,2,42406,10603,1,369200000,369200000,15901,5300,10601,5300,0,1,5302,7229781,7.229781
6300,1100,5300,6930000,2,42406,10603,1,369200000,369200000,15901,5300,10601,5300,0,1,5302,6953484,6.953484
6300,1100,5300,6930000,2,42406,10603,1,369200000,369200000,15901,5300,10601,5300,0,1,5302,7089815,7.089815
6300,1100,5300,6930000,2,42406,10603,1,369200000,369200000,15901,5300,10601,5300,0,1,5302,7106654,7.106654
6300,1100,5700,6930000,2,45606,11403,1,392880000,392880000,17101,5700,11401,5700,0,1,5702,7359418,7.359418
6300,1100,5700,6930000,2,45606,11403,1,392880000,392880000,17101,5700,11401,5700,0,1,5702,7812720,7.81272
6300,1100,5700,6930000,2,45606,11403,1,392880000,392880000,17101,5700,11401,5700,0,1,5702,7409368,7.409368
6300,1100,5700,6930000,2,45606,11403,1,392880000,392880000,17101,5700,11401,5700,0,1,5702,7877208,7.877208
6300,1100,5700,6930000,2,45606,11403,1,392880000,392880000,17101,5700,11401,5700,0,1,5702,7594470,7.59447
6300,1100,5700,6930000,2,45606,11403,1,392880000,392880000,17101,5700,11401,5700,0,1,5702,7399672,7.399672
6300,1100,5700,6930000,2,45606,11403,1,392880000,392880000,17101,5700,11401,5700,0,1,5702,7768328,7.768328
6300,1100,6100,6930000,2,48806,12203,1,416560000,416560000,18301,6100,12201,6100,0,1,6102,8085442,8.085442
6300,1100,6100,6930000,2,48806,12203,1,416560000,416560000,18301,6100,12201,6100,0,1,6102,8239810,8.23981
6300,1100,6100,6930000,2,48806,12203,1,416560000,416560000,18301,6100,12201,6100,0,1,6102,8080285,8.080285
6300,1100,6100,6930000,2,48806,12203,1,416560000,416560000,18301,6100,12201,6100,0,1,6102,8301249,8.301249
6300,1100,6100,6930000,2,48806,12203,1,416560000,416560000,18301,6100,12201,6100,0,1,6102,7997668,7.997668
6300,1100,6100,6930000,2,48806,12203,1,416560000,416560000,18301,6100,12201,6100,0,1,6102,8070241,8.070241
6300,1100,6100,6930000,2,48806,12203,1,416560000,416560000,18301,6100,12201,6100,0,1,6102,8165626,8.165626
6300,1100,6500,6930000,2,52006,13003,1,440240000,440240000,19501,6500,13001,6500,0,1,6502,8571798,8.571798
6300,1100,6500,6930000,2,52006,13003,1,440240000,440240000,19501,6500,13001,6500,0,1,6502,8889938,8.889938
6300,1100,6500,6930000,2,52006,13003,1,440240000,440240000,19501,6500,13001,6500,0,1,6502,8546829,8.546829
6300,1100,6500,6930000,2,52006,13003,1,440240000,440240000,19501,6500,13001,6500,0,1,6502,8958867,8.958867
6300,1100,6500,6930000,2,52006,13003,1,440240000,440240000,19501,6500,13001,6500,0,1,6502,8614499,8.614499
6300,1100,6500,6930000,2,52006,13003,1,440240000,440240000,19501,6500,13001,6500,0,1,6502,8589995,8.589995
6300,1100,6500,6930000,2,52006,13003,1,440240000,440240000,19501,6500,13001,6500,0,1,6502,8775249,8.775249
6300,1100,6900,6930000,2,55206,13803,1,463920000,463920000,20701,6900,13801,6900,0,1,6902,8918494,8.918494
6300,1100,6900,6930000,2,55206,13803,1,463920000,463920000,20701,6900,13801,6900,0,1,6902,9449430,9.44943
6300,1100,6900,6930000,2,55206,13803,1,463920000,463920000,20701,6900,13801,6900,0,1,6902,8961358,8.961358
6300,1100,6900,6930000,2,55206,13803,1,463920000,463920000,20701,6900,13801,6900,0,1,6902,9496454,9.496454
6300,1100,6900,6930000,2,55206,13803,1,463920000,463920000,20701,6900,13801,6900,0,1,6902,9092944,9.092944
6300,1100,6900,6930000,2,55206,13803,1,463920000,463920000,20701,6900,13801,6900,0,1,6902,8924286,8.924286
6300,1100,6900,6930000,2,55206,13803,1,463920000,463920000,20701,6900,13801,6900,0,1,6902,9346776,9.346776
6300,700,500,4410000,2,4006,1003,1,63280000,63280000,1501,500,1001,500,0,1,502,576616,0.576616
6300,700,500,4410000,2,4006,1003,1,63280000,63280000,1501,500,1001,500,0,1,502,459530,0.45953
6300,700,500,4410000,2,4006,1003,1,63280000,63280000,1501,500,1001,500,0,1,502,573067,0.573067
6300,700,500,4410000,2,4006,1003,1,63280000,63280000,1501,500,1001,500,0,1,502,463065,0.463065
6300,700,500,4410000,2,4006,1003,1,63280000,63280000,1501,500,1001,500,0,1,502,462854,0.462854
6300,700,500,4410000,2,4006,1003,1,63280000,63280000,1501,500,1001,500,0,1,502,485650,0.48565
6300,700,500,4410000,2,4006,1003,1,63280000,63280000,1501,500,1001,500,0,1,502,455817,0.455817
6300,700,900,4410000,2,7206,1803,1,85680000,85680000,2701,900,1801,900,0,1,902,817006,0.817006
6300,700,900,4410000,2,7206,1803,1,85680000,85680000,2701,900,1801,900,0,1,902,813661,0.813661
6300,700,900,4410000,2,7206,1803,1,85680000,85680000,2701,900,1801,900,0,1,902,809963,0.809963
6300,700,900,4410000,2,7206,1803,1,85680000,85680000,2701,900,1801,900,0,1,902,813907,0.813907
6300,700,900,4410000,2,7206,1803,1,85680000,85680000,2701,900,1801,900,0,1,902,785245,0.785245
6300,700,900,4410000,2,7206,1803,1,85680000,85680000,2701,900,1801,900,0,1,902,793106,0.793106
6300,700,900,4410000,2,7206,1803,1,85680000,85680000,2701,900,1801,900,0,1,902,799063,0.799063
6300,700,1300,4410000,2,10406,2603,1,108080000,108080000,3901,1300,2601,1300,0,1,1302,1128789,1.128789
6300,700,1300,4410000,2,10406,2603,1,108080000,108080000,3901,1300,2601,1300,0,1,1302,1147982,1.147982
6300,700,1300,4410000,2,10406,2603,1,108080000,108080000,3901,1300,2601,1300,0,1,1302,1108166,1.108166
6300,700,1300,4410000,2,10406,2603,1,108080000,108080000,3901,1300,2601,1300,0,1,1302,1157477,1.157477
6300,700,1300,4410000,2,10406,2603,1,108080000,108080000,3901,1300,2601,1300,0,1,1302,1114403,1.114403
6300,700,1300,4410000,2,10406,2603,1,108080000,108080000,3901,1300,2601,1300,0,1,1302,1128326,1.128326
6300,700,1300,4410000,2,10406,2603,1,108080000,108080000,3901,1300,2601,1300,0,1,1302,1139756,1.139756
6300,700,1700,4410000,2,13606,3403,1,130480000,130480000,5101,1700,3401,1700,0,1,1702,1452498,1.452498
6300,700,1700,4410000,2,13606,3403,1,130480000,130480000,5101,1700,3401,1700,0,1,1702,1489633,1.489633
6300,700,1700,4410000,2,13606,3403,1,130480000,130480000,5101,1700,3401,1700,0,1,1702,1438258,1.438258
6300,700,1700,4410000,2,13606,3403,1,130480000,130480000,5101,1700,3401,1700,0,1,1702,1502052,1.502052
6300,700,1700,4410000,2,13606,3403,1,130480000,130480000,5101,1700,3401,1700,0,1,1702,1446035,1.446035
6300,700,1700,4410000,2,13606,3403,1,130480000,130480000,5101,1700,3401,1700,0,1,1702,1463144,1.463144
6300,700,1700,4410000,2,13606,3403,1,130480000,130480000,5101,1700,3401,1700,0,1,1702,1476265,1.476265
6300,700,2100,4410000,2,16806,4203,1,152880000,152880000,6301,2100,4201,2100,0,1,2102,1778013,1.778013
6300,700,2100,4410000,2,16806,4203,1,152880000,152880000,6301,2100,4201,2100,0,1,2102,1837993,1.837993
6300,700,2100,4410000,2,16806,4203,1,152880000,152880000,6301,2100,4201,2100,0,1,2102,1767338,1.767338
6300,700,2100,4410000,2,16806,4203,1,152880000,152880000,6301,2100,4201,2100,0,1,2102,1846098,1.846098
6300,700,2100,4410000,2,16806,4203,1,152880000,152880000,6301,2100,4201,2100,0,1,2102,1787429,1.787429
6300,700,2100,4410000,2,16806,4203,1,152880000,152880000,6301,2100,4201,2100,0,1,2102,1800562,1.800562
6300,700,2100,4410000,2,16806,4203,1,152880000,152880000,6301,2100,4201,2100,0,1,2102,1812489,1.812489
6300,700,2500,4410000,2,20006,5003,1,175280000,175280000,7501,2500,5001,2500,0,1,2502,2108204,2.108204
6300,700,2500,4410000,2,20006,5003,1,175280000,175280000,7501,2500,5001,2500,0,1,2502,2189381,2.189381
6300,700,2500,4410000,2,20006,5003,1,175280000,175280000,7501,2500,5001,2500,0,1,2502,2098633,2.098633
6300,700,2500,4410000,2,20006,5003,1,175280000,175280000,7501,2500,5001,2500,0,1,2502,2195925,2.195925
6300,700,2500,4410000,2,20006,5003,1,175280000,175280000,7501,2500,5001,2500,0,1,2502,2130020,2.13002
6300,700,2500,4410000,2,20006,5003,1,175280000,175280000,7501,2500,5001,2500,0,1,2502,2126564,2.126564
6300,700,2500,4410000,2,20006,5003,1,175280000,175280000,7501,2500,5001,2500,0,1,2502,2160476,2.160476
6300,700,2900,4410000,2,23206,5803,1,197680000,197680000,8701,2900,5801,2900,0,1,2902,2436545,2.436545
6300,700,2900,4410000,2,23206,5803,1,197680000,197680000,8701,2900,5801,2900,0,1,2902,2524324,2.524324
6300,700,2900,4410000,2,23206,5803,1,197680000,197680000,8701,2900,5801,2900,0,1,2902,2429929,2.429929
6300,700,2900,4410000,2,23206,5803,1,197680000,197680000,8701,2900,5801,2900,0,1,2902,2544664,2.544664
6300,700,2900,4410000,2,23206,5803,1,197680000,197680000,8701,2900,5801,2900,0,1,2902,2466788,2.466788
6300,700,2900,4410000,2,23206,5803,1,197680000,197680000,8701,2900,5801,2900,0,1,2902,2447138,2.447138
6300,700,2900,4410000,2,23206,5803,1,197680000,197680000,8701,2900,5801,2900,0,1,2902,2502645,2.502645
6300,700,3300,4410000,2,26406,6603,1,220080000,220080000,9901,3300,6601,3300,0,1,3302,2753379,2.753379
6300,700,3300,4410000,2,26406,6603,1,220080000,220080000,9901,3300,6601,3300,0,1,3302,2988194,2.988194
6300,700,3300,4410000,2,26406,6603,1,220080000,220080000,9901,3300,6601,3300,0,1,3302,2770172,2.770172
6300,700,3300,4410000,2,26406,6603,1,220080000,220080000,9901,3300,6601,3300,0,1,3302,3007164,3.007164
6300,700,3300,4410000,2,26406,6603,1,220080000,220080000,9901,3300,6601,3300,0,1,3302,2935921,2.935921
6300,700,3300,4410000,2,26406,6603,1,220080000,220080000,9901,3300,6601,3300,0,1,3302,2764757,2.764757
6300,700,3300,4410000,2,26406,6603,1,220080000,220080000,9901,3300,6601,3300,0,1,3302,2984597,2.984597
6300,700,3700,4410000,2,29606,7403,1,242480000,242480000,11101,3700,7401,3700,0,1,3702,3108597,3.108597
6300,700,3700,4410000,2,29606,7403,1,242480000,242480000,11101,3700,7401,3700,0,1,3702,3216487,3.216487
6300,700,3700,4410000,2,29606,7403,1,242480000,242480000,11101,3700,7401,3700,0,1,3702,3101766,3.101766
6300,700,3700,4410000,2,29606,7403,1,242480000,242480000,11101,3700,7401,3700,0,1,3702,3246268,3.246268
6300,700,3700,4410000,2,29606,7403,1,242480000,242480000,11101,3700,7401,3700,0,1,3702,3137390,3.13739
6300,700,3700,4410000,2,29606,7403,1,242480000,242480000,11101,3700,7401,3700,0,1,3702,3105157,3.105157
6300,700,3700,4410000,2,29606,7403,1,242480000,242480000,11101,3700,7401,3700,0,1,3702,3202212,3.202212
6300,700,4100,4410000,2,32806,8203,1,264880000,264880000,12301,4100,8201,4100,0,1,4102,3597016,3.597016
6300,700,4100,4410000,2,32806,8203,1,264880000,264880000,12301,4100,8201,4100,0,1,4102,3565888,3.565888
6300,700,4100,4410000,2,32806,8203,1,264880000,264880000,12301,4100,8201,4100,0,1,4102,3572829,3.572829
6300,700,4100,4410000,2,32806,8203,1,264880000,264880000,12301,4100,8201,4100,0,1,4102,3600456,3.600456
6300,700,4100,4410000,2,32806,8203,1,264880000,264880000,12301,4100,8201,4100,0,1,4102,3475454,3.475454
6300,700,4100,4410000,2,32806,8203,1,264880000,264880000,12301,4100,8201,4100,0,1,4102,3637726,3.637726
6300,700,4100,4410000,2,32806,8203,1,264880000,264880000,12301,4100,8201,4100,0,1,4102,3526965,3.526965
6300,700,4500,4410000,2,36006,9003,1,287280000,287280000,13501,4500,9001,4500,0,1,4502,3780577,3.780577
6300,700,4500,4410000,2,36006,9003,1,287280000,287280000,13501,4500,9001,4500,0,1,4502,3909115,3.909115
6300,700,4500,4410000,2,36006,9003,1,287280000,287280000,13501,4500,9001,4500,0,1,4502,3784030,3.78403
6300,700,4500,4410000,2,36006,9003,1,287280000,287280000,13501,4500,9001,4500,0,1,4502,3940898,3.940898
6300,700,4500,4410000,2,36006,9003,1,287280000,287280000,13501,4500,9001,4500,0,1,4502,3825455,3.825455
6300,700,4500,4410000,2,36006,9003,1,287280000,287280000,13501,4500,9001,4500,0,1,4502,3803801,3.803801
6300,700,4500,4410000,2,36006,9003,1,287280000,287280000,13501,4500,9001,4500,0,1,4502,3883475,3.883475
6300,700,4900,4410000,2,39206,9803,1,309680000,309680000,14701,4900,9801,4900,0,1,4902,4081254,4.081254
6300,700,4900,4410000,2,39206,9803,1,309680000,309680000,14701,4900,9801,4900,0,1,4902,4256186,4.256186
6300,700,4900,4410000,2,39206,9803,1,309680000,309680000,14701,4900,9801,4900,0,1,4902,4105911,4.105911
6300,700,4900,4410000,2,39206,9803,1,309680000,309680000,14701,4900,9801,4900,0,1,4902,4294424,4.294424
6300,700,4900,4410000,2,39206,9803,1,309680000,309680000,14701,4900,9801,4900,0,1,4902,4150401,4.150401
6300,700,4900,4410000,2,39206,9803,1,309680000,309680000,14701,4900,9801,4900,0,1,4902,4114488,4.114488
6300,700,4900,4410000,2,39206,9803,1,309680000,309680000,14701,4900,9801,4900,0,1,4902,4225836,4.225836
6300,700,5300,4410000,2,42406,10603,1,332080000,332080000,15901,5300,10601,5300,0,1,5302,4426299,4.426299
6300,700,5300,4410000,2,42406,10603,1,332080000,332080000,15901,5300,10601,5300,0,1,5302,4682740,4.68274
6300,700,5300,4410000,2,42406,10603,1,332080000,332080000,15901,5300,10601,5300,0,1,5302,4444228,4.444228
6300,700,5300,4410000,2,42406,10603,1,332080000,332080000,15901,5300,10601,5300,0,1,5302,4743255,4.743255
6300,700,5300,4410000,2,42406,10603,1,332080000,332080000,15901,5300,10601,5300,0,1,5302,4594832,4.594832
6300,700,5300,4410000,2,42406,10603,1,332080000,332080000,15901,5300,10601,5300,0,1,5302,4429723,4.429723
6300,700,5300,4410000,2,42406,10603,1,332080000,332080000,15901,5300,10601,5300,0,1,5302,4679211,4.679211
6300,700,5700,4410000,2,45606,11403,1,354480000,354480000,17101,5700,11401,5700,0,1,5702,4960243,4.960243
6300,700,5700,4410000,2,45606,11403,1,354480000,354480000,17101,5700,11401,5700,0,1,5702,4939443,4.939443
6300,700,5700,4410000,2,45606,11403,1,354480000,354480000,17101,5700,11401,5700,0,1,5702,4956829,4.956829
6300,700,5700,4410000,2,45606,11403,1,354480000,354480000,17101,5700,11401,5700,0,1,5702,5014874,5.014874
6300,700,5700,4410000,2,45606,11403,1,354480000,354480000,17101,5700,11401,5700,0,1,5702,4829799,4.829799
6300,700,5700,4410000,2,45606,11403,1,354480000,354480000,17101,5700,11401,5700,0,1,5702,4948594,4.948594
6300,700,5700,4410000,2,45606,11403,1,354480000,354480000,17101,5700,11401,5700,0,1,5702,4922316,4.922316
6300,700,6100,4410000,2,48806,12203,1,376880000,376880000,18301,6100,12201,6100,0,1,6102,5093862,5.093862
6300,700,6100,4410000,2,48806,12203,1,376880000,376880000,18301,6100,12201,6100,0,1,6102,5310768,5.310768
6300,700,6100,4410000,2,48806,12203,1,376880000,376880000,18301,6100,12201,6100,0,1,6102,5126455,5.126455
6300,700,6100,4410000,2,48806,12203,1,376880000,376880000,18301,6100,12201,6100,0,1,6102,5342421,5.342421
6300,700,6100,4410000,2,48806,12203,1,376880000,376880000,18301,6100,12201,6100,0,1,6102,5177454,5.177454
6300,700,6100,4410000,2,48806,12203,1,376880000,376880000,18301,6100,12201,6100,0,1,6102,5100482,5.100482
6300,700,6100,4410000,2,48806,12203,1,376880000,376880000,18301,6100,12201,6100,0,1,6102,5257416,5.257416
6300,700,6500,4410000,2,52006,13003,1,399280000,399280000,19501,6500,13001,6500,0,1,6502,5431580,5.43158
6300,700,6500,4410000,2,52006,13003,1,399280000,399280000,19501,6500,13001,6500,0,1,6502,5763097,5.763097
6300,700,6500,4410000,2,52006,13003,1,399280000,399280000,19501,6500,13001,6500,0,1,6502,5438369,5.438369
6300,700,6500,4410000,2,52006,13003,1,399280000,399280000,19501,6500,13001,6500,0,1,6502,5806695,5.806695
6300,700,6500,4410000,2,52006,13003,1,399280000,399280000,19501,6500,13001,6500,0,1,6502,5656102,5.656102
6300,700,6500,4410000,2,52006,13003,1,399280000,399280000,19501,6500,13001,6500,0,1,6502,5419761,5.419761
6300,700,6500,4410000,2,52006,13003,1,399280000,399280000,19501,6500,13001,6500,0,1,6502,5684881,5.684881
6300,700,6900,4410000,2,55206,13803,1,421680000,421680000,20701,6900,13801,6900,0,1,6902,5894517,5.894517
6300,700,6900,4410000,2,55206,13803,1,421680000,421680000,20701,6900,13801,6900,0,1,6902,5981714,5.981714
6300,700,6900,4410000,2,55206,13803,1,421680000,421680000,20701,6900,13801,6900,0,1,6902,5947414,5.947414
6300,700,6900,4410000,2,55206,13803,1,421680000,421680000,20701,6900,13801,6900,0,1,6902,6037026,6.037026
6300,700,6900,4410000,2,55206,13803,1,421680000,421680000,20701,6900,13801,6900,0,1,6902,5814443,5.814443
6300,700,6900,4410000,2,55206,13803,1,421680000,421680000,20701,6900,13801,6900,0,1,6902,5935910,5.93591
6300,700,6900,4410000,2,55206,13803,1,421680000,421680000,20701,6900,13801,6900,0,1,6902,5954770,5.95477
6300,300,500,1890000,2,4006,1003,1,41520000,41520000,1501,500,1001,500,0,1,502,200309,0.200309
6300,300,500,1890000,2,4006,1003,1,41520000,41520000,1501,500,1001,500,0,1,502,207303,0.207303
6300,300,500,1890000,2,4006,1003,1,41520000,41520000,1501,500,1001,500,0,1,502,201609,0.201609
6300,300,500,1890000,2,4006,1003,1,41520000,41520000,1501,500,1001,500,0,1,502,203397,0.203397
6300,300,500,1890000,2,4006,1003,1,41520000,41520000,1501,500,1001,500,0,1,502,204782,0.204782
6300,300,500,1890000,2,4006,1003,1,41520000,41520000,1501,500,1001,500,0,1,502,201433,0.201433
6300,300,500,1890000,2,4006,1003,1,41520000,41520000,1501,500,1001,500,0,1,502,200721,0.200721
6300,300,900,1890000,2,7206,1803,1,62640000,62640000,2701,900,1801,900,0,1,902,337088,0.337088
6300,300,900,1890000,2,7206,1803,1,62640000,62640000,2701,900,1801,900,0,1,902,343664,0.343664
6300,300,900,1890000,2,7206,1803,1,62640000,62640000,2701,900,1801,900,0,1,902,341525,0.341525
6300,300,900,1890000,2,7206,1803,1,62640000,62640000,2701,900,1801,900,0,1,902,332235,0.332235
6300,300,900,1890000,2,7206,1803,1,62640000,62640000,2701,900,1801,900,0,1,902,350120,0.35012
6300,300,900,1890000,2,7206,1803,1,62640000,62640000,2701,900,1801,900,0,1,902,351572,0.351572
6300,300,900,1890000,2,7206,1803,1,62640000,62640000,2701,900,1801,900,0,1,902,330853,0.330853
6300,300,1300,1890000,2,10406,2603,1,83760000,83760000,3901,1300,2601,1300,0,1,1302,483088,0.483088
6300,300,1300,1890000,2,10406,2603,1,83760000,83760000,3901,1300,2601,1300,0,1,1302,494396,0.494396
6300,300,1300,1890000,2,10406,2603,1,83760000,83760000,3901,1300,2601,1300,0,1,1302,484634,0.484634
6300,300,1300,1890000,2,10406,2603,1,83760000,83760000,3901,1300,2601,1300,0,1,1302,497496,0.497496
6300,300,1300,1890000,2,10406,2603,1,83760000,83760000,3901,1300,2601,1300,0,1,1302,494152,0.494152
6300,300,1300,1890000,2,10406,2603,1,83760000,83760000,3901,1300,2601,1300,0,1,1302,490895,0.490895
6300,300,1300,1890000,2,10406,2603,1,83760000,83760000,3901,1300,2601,1300,0,1,1302,489339,0.489339
6300,300,1700,1890000,2,13606,3403,1,104880000,104880000,5101,1700,3401,1700,0,1,1702,632888,0.632888
6300,300,1700,1890000,2,13606,3403,1,104880000,104880000,5101,1700,3401,1700,0,1,1702,646243,0.646243
6300,300,1700,1890000,2,13606,3403,1,104880000,104880000,5101,1700,3401,1700,0,1,1702,641283,0.641283
6300,300,1700,1890000,2,13606,3403,1,104880000,104880000,5101,1700,3401,1700,0,1,1702,653869,0.653869
6300,300,1700,1890000,2,13606,3403,1,104880000,104880000,5101,1700,3401,1700,0,1,1702,640996,0.640996
6300,300,1700,1890000,2,13606,3403,1,104880000,104880000,5101,1700,3401,1700,0,1,1702,635819,0.635819
6300,300,1700,1890000,2,13606,3403,1,104880000,104880000,5101,1700,3401,1700,0,1,1702,643810,0.64381
6300,300,2100,1890000,2,16806,4203,1,126000000,126000000,6301,2100,4201,2100,0,1,2102,782923,0.782923
6300,300,2100,1890000,2,16806,4203,1,126000000,126000000,6301,2100,4201,2100,0,1,2102,804949,0.804949
6300,300,2100,1890000,2,16806,4203,1,126000000,126000000,6301,2100,4201,2100,0,1,2102,782427,0.782427
6300,300,2100,1890000,2,16806,4203,1,126000000,126000000,6301,2100,4201,2100,0,1,2102,807461,0.807461
6300,300,2100,1890000,2,16806,4203,1,126000000,126000000,6301,2100,4201,2100,0,1,2102,787006,0.787006
6300,300,2100,1890000,2,16806,4203,1,126000000,126000000,6301,2100,4201,2100,0,1,2102,795225,0.795225
6300,300,2100,1890000,2,16806,4203,1,126000000,126000000,6301,2100,4201,2100,0,1,2102,791123,0.791123
6300,300,2500,1890000,2,20006,5003,1,147120000,147120000,7501,2500,5001,2500,0,1,2502,931493,0.931493
6300,300,2500,1890000,2,20006,5003,1,147120000,147120000,7501,2500,5001,2500,0,1,2502,955364,0.955364
6300,300,2500,1890000,2,20006,5003,1,147120000,147120000,7501,2500,5001,2500,0,1,2502,926573,0.926573
6300,300,2500,1890000,2,20006,5003,1,147120000,147120000,7501,2500,5001,2500,0,1,2502,962234,0.962234
6300,300,2500,1890000,2,20006,5003,1,147120000,147120000,7501,2500,5001,2500,0,1,2502,938672,0.938672
6300,300,2500,1890000,2,20006,5003,1,147120000,147120000,7501,2500,5001,2500,0,1,2502,945290,0.94529
6300,300,2500,1890000,2,20006,5003,1,147120000,147120000,7501,2500,5001,2500,0,1,2502,952748,0.952748
6300,300,2900,1890000,2,23206,5803,1,168240000,168240000,8701,2900,5801,2900,0,1,2902,1081123,1.081123
6300,300,2900,1890000,2,23206,5803,1,168240000,168240000,8701,2900,5801,2900,0,1,2902,1109061,1.109061
6300,300,2900,1890000,2,23206,5803,1,168240000,168240000,8701,2900,5801,2900,0,1,2902,1076687,1.076687
6300,300,2900,1890000,2,23206,5803,1,168240000,168240000,8701,2900,5801,2900,0,1,2902,1117721,1.117721
6300,300,2900,1890000,2,23206,5803,1,168240000,168240000,8701,2900,5801,2900,0,1,2902,1087818,1.087818
6300,300,2900,1890000,2,23206,5803,1,168240000,168240000,8701,2900,5801,2900,0,1,2902,1100024,1.100024
6300,300,2900,1890000,2,23206,5803,1,168240000,168240000,8701,2900,5801,2900,0,1,2902,1096880,1.09688
6300,300,3300,1890000,2,26406,6603,1,189360000,189360000,9901,3300,6601,3300,0,1,3302,1229488,1.229488
6300,300,3300,1890000,2,26406,6603,1,189360000,189360000,9901,3300,6601,3300,0,1,3302,1260909,1.260909
6300,300,3300,1890000,2,26406,6603,1,189360000,189360000,9901,3300,6601,3300,0,1,3302,1231362,1.231362
6300,300,3300,1890000,2,26406,6603,1,189360000,189360000,9901,3300,6601,3300,0,1,3302,1274350,1.27435
6300,300,3300,1890000,2,26406,6603,1,189360000,189360000,9901,3300,6601,3300,0,1,3302,1239166,1.239166
6300,300,3300,1890000,2,26406,6603,1,189360000,189360000,9901,3300,6601,3300,0,1,3302,1254545,1.254545
6300,300,3300,1890000,2,26406,6603,1,189360000,189360000,9901,3300,6601,3300,0,1,3302,1259105,1.259105
6300,300,3700,1890000,2,29606,7403,1,210480000,210480000,11101,3700,7401,3700,0,1,3702,1381227,1.381227
6300,300,3700,1890000,2,29606,7403,1,210480000,210480000,11101,3700,7401,3700,0,1,3702,1544640,1.54464
6300,300,3700,1890000,2,29606,7403,1,210480000,210480000,11101,3700,7401,3700,0,1,3702,1383343,1.383343
6300,300,3700,1890000,2,29606,7403,1,210480000,210480000,11101,3700,7401,3700,0,1,3702,1552994,1.552994
6300,300,3700,1890000,2,29606,7403,1,210480000,210480000,11101,3700,7401,3700,0,1,3702,1542806,1.542806
6300,300,3700,1890000,2,29606,7403,1,210480000,210480000,11101,3700,7401,3700,0,1,3702,1382055,1.382055
6300,300,3700,1890000,2,29606,7403,1,210480000,210480000,11101,3700,7401,3700,0,1,3702,1539932,1.539932
6300,300,4100,1890000,2,32806,8203,1,231600000,231600000,12301,4100,8201,4100,0,1,4102,1530046,1.530046
6300,300,4100,1890000,2,32806,8203,1,231600000,231600000,12301,4100,8201,4100,0,1,4102,1581142,1.581142
6300,300,4100,1890000,2,32806,8203,1,231600000,231600000,12301,4100,8201,4100,0,1,4102,1532986,1.532986
6300,300,4100,1890000,2,32806,8203,1,231600000,231600000,12301,4100,8201,4100,0,1,4102,1588667,1.588667
6300,300,4100,1890000,2,32806,8203,1,231600000,231600000,12301,4100,8201,4100,0,1,4102,1543627,1.543627
6300,300,4100,1890000,2,32806,8203,1,231600000,231600000,12301,4100,8201,4100,0,1,4102,1540724,1.540724
6300,300,4100,1890000,2,32806,8203,1,231600000,231600000,12301,4100,8201,4100,0,1,4102,1563398,1.563398
6300,300,4500,1890000,2,36006,9003,1,252720000,252720000,13501,4500,9001,4500,0,1,4502,1677524,1.677524
6300,300,4500,1890000,2,36006,9003,1,252720000,252720000,13501,4500,9001,4500,0,1,4502,1736554,1.736554
6300,300,4500,1890000,2,36006,9003,1,252720000,252720000,13501,4500,9001,4500,0,1,4502,1672855,1.672855
6300,300,4500,1890000,2,36006,9003,1,252720000,252720000,13501,4500,9001,4500,0,1,4502,1744725,1.744725
6300,300,4500,1890000,2,36006,9003,1,252720000,252720000,13501,4500,9001,4500,0,1,4502,1702573,1.702573
6300,300,4500,1890000,2,36006,9003,1,252720000,252720000,13501,4500,9001,4500,0,1,4502,1854524,1.854524
6300,300,4500,1890000,2,36006,9003,1,252720000,252720000,13501,4500,9001,4500,0,1,4502,1725366,1.725366
6300,300,4900,1890000,2,39206,9803,1,273840000,273840000,14701,4900,9801,4900,0,1,4902,1979114,1.979114
6300,300,4900,1890000,2,39206,9803,1,273840000,273840000,14701,4900,9801,4900,0,1,4902,1886978,1.886978
6300,300,4900,1890000,2,39206,9803,1,273840000,273840000,14701,4900,9801,4900,0,1,4902,1962792,1.962792
6300,300,4900,1890000,2,39206,9803,1,273840000,273840000,14701,4900,9801,4900,0,1,4902,1895634,1.895634
6300,300,4900,1890000,2,39206,9803,1,273840000,273840000,14701,4900,9801,4900,0,1,4902,1837955,1.837955
6300,300,4900,1890000,2,39206,9803,1,273840000,273840000,14701,4900,9801,4900,0,1,4902,1831678,1.831678
6300,300,4900,1890000,2,39206,9803,1,273840000,273840000,14701,4900,9801,4900,0,1,4902,1862532,1.862532
6300,300,5300,1890000,2,42406,10603,1,294960000,294960000,15901,5300,10601,5300,0,1,5302,1987084,1.987084
6300,300,5300,1890000,2,42406,10603,1,294960000,294960000,15901,5300,10601,5300,0,1,5302,2035707,2.035707
6300,300,5300,1890000,2,42406,10603,1,294960000,294960000,15901,5300,10601,5300,0,1,5302,1972177,1.972177
6300,300,5300,1890000,2,42406,10603,1,294960000,294960000,15901,5300,10601,5300,0,1,5302,2106294,2.106294
6300,300,5300,1890000,2,42406,10603,1,294960000,294960000,15901,5300,10601,5300,0,1,5302,2004375,2.004375
6300,300,5300,1890000,2,42406,10603,1,294960000,294960000,15901,5300,10601,5300,0,1,5302,1980310,1.98031
6300,300,5300,1890000,2,42406,10603,1,294960000,294960000,15901,5300,10601,5300,0,1,5302,2023274,2.023274
6300,300,5700,1890000,2,45606,11403,1,316080000,316080000,17101,5700,11401,5700,0,1,5702,2111865,2.111865
6300,300,5700,1890000,2,45606,11403,1,316080000,316080000,17101,5700,11401,5700,0,1,5702,2187897,2.187897
6300,300,5700,1890000,2,45606,11403,1,316080000,316080000,17101,5700,11401,5700,0,1,5702,2122543,2.122543
6300,300,5700,1890000,2,45606,11403,1,316080000,316080000,17101,5700,11401,5700,0,1,5702,2205272,2.205272
6300,300,5700,1890000,2,45606,11403,1,316080000,316080000,17101,5700,11401,5700,0,1,5702,2153699,2.153699
6300,300,5700,1890000,2,45606,11403,1,316080000,316080000,17101,5700,11401,5700,0,1,5702,2115101,2.115101
6300,300,5700,1890000,2,45606,11403,1,316080000,316080000,17101,5700,11401,5700,0,1,5702,2179373,2.179373
6300,300,6100,1890000,2,48806,12203,1,337200000,337200000,18301,6100,12201,6100,0,1,6102,2270388,2.270388
6300,300,6100,1890000,2,48806,12203,1,337200000,337200000,18301,6100,12201,6100,0,1,6102,2356468,2.356468
6300,300,6100,1890000,2,48806,12203,1,337200000,337200000,18301,6100,12201,6100,0,1,6102,2273812,2.273812
6300,300,6100,1890000,2,48806,12203,1,337200000,337200000,18301,6100,12201,6100,0,1,6102,2368206,2.368206
6300,300,6100,1890000,2,48806,12203,1,337200000,337200000,18301,6100,12201,6100,0,1,6102,2322837,2.322837
6300,300,6100,1890000,2,48806,12203,1,337200000,337200000,18301,6100,12201,6100,0,1,6102,2350357,2.350357
6300,300,6100,1890000,2,48806,12203,1,337200000,337200000,18301,6100,12201,6100,0,1,6102,2330534,2.330534
6300,300,6500,1890000,2,52006,13003,1,358320000,358320000,19501,6500,13001,6500,0,1,6502,2417108,2.417108
6300,300,6500,1890000,2,52006,13003,1,358320000,358320000,19501,6500,13001,6500,0,1,6502,2504711,2.504711
6300,300,6500,1890000,2,52006,13003,1,358320000,358320000,19501,6500,13001,6500,0,1,6502,2420651,2.420651
6300,300,6500,1890000,2,52006,13003,1,358320000,358320000,19501,6500,13001,6500,0,1,6502,2521782,2.521782
6300,300,6500,1890000,2,52006,13003,1,358320000,358320000,19501,6500,13001,6500,0,1,6502,2481590,2.48159
6300,300,6500,1890000,2,52006,13003,1,358320000,358320000,19501,6500,13001,6500,0,1,6502,2483746,2.483746
6300,300,6500,1890000,2,52006,13003,1,358320000,358320000,19501,6500,13001,6500,0,1,6502,2487282,2.487282
6300,300,6900,1890000,2,55206,13803,1,379440000,379440000,20701,6900,13801,6900,0,1,6902,2547375,2.547375
6300,300,6900,1890000,2,55206,13803,1,379440000,379440000,20701,6900,13801,6900,0,1,6902,2771465,2.771465
6300,300,6900,1890000,2,55206,13803,1,379440000,379440000,20701,6900,13801,6900,0,1,6902,2568316,2.568316
6300,300,6900,1890000,2,55206,13803,1,379440000,379440000,20701,6900,13801,6900,0,1,6902,2800718,2.800718
6300,300,6900,1890000,2,55206,13803,1,379440000,379440000,20701,6900,13801,6900,0,1,6902,2739817,2.739817
6300,300,6900,1890000,2,55206,13803,1,379440000,379440000,20701,6900,13801,6900,0,1,6902,2587026,2.587026
6300,300,6900,1890000,2,55206,13803,1,379440000,379440000,20701,6900,13801,6900,0,1,6902,2775546,2.775546
5900,7100,500,41890000,2,4006,1003,1,387120000,387120000,1501,500,1001,500,0,1,502,4220783,4.220783
5900,7100,500,41890000,2,4006,1003,1,387120000,387120000,1501,500,1001,500,0,1,502,4419721,4.419721
5900,7100,500,41890000,2,4006,1003,1,387120000,387120000,1501,500,1001,500,0,1,502,4192041,4.192041
5900,7100,500,41890000,2,4006,1003,1,387120000,387120000,1501,500,1001,500,0,1,502,4389742,4.389742
5900,7100,500,41890000,2,4006,1003,1,387120000,387120000,1501,500,1001,500,0,1,502,4346792,4.346792
5900,7100,500,41890000,2,4006,1003,1,387120000,387120000,1501,500,1001,500,0,1,502,4348117,4.348117
5900,7100,500,41890000,2,4006,1003,1,387120000,387120000,1501,500,1001,500,0,1,502,4318043,4.318043
5900,7100,900,41890000,2,7206,1803,1,428720000,428720000,2701,900,1801,900,0,1,902,7428017,7.428017
5900,7100,900,41890000,2,7206,1803,1,428720000,428720000,2701,900,1801,900,0,1,902,7573815,7.573815
5900,7100,900,41890000,2,7206,1803,1,428720000,428720000,2701,900,1801,900,0,1,902,7398411,7.398411
5900,7100,900,41890000,2,7206,1803,1,428720000,428720000,2701,900,1801,900,0,1,902,7608217,7.608217
5900,7100,900,41890000,2,7206,1803,1,428720000,428720000,2701,900,1801,900,0,1,902,7370157,7.370157
5900,7100,900,41890000,2,7206,1803,1,428720000,428720000,2701,900,1801,900,0,1,902,7512319,7.512319
5900,7100,900,41890000,2,7206,1803,1,428720000,428720000,2701,900,1801,900,0,1,902,7483120,7.48312
5900,7100,1300,41890000,2,10406,2603,1,470320000,470320000,3901,1300,2601,1300,0,1,1302,10296636,10.296636
5900,7100,1300,41890000,2,10406,2603,1,470320000,470320000,3901,1300,2601,1300,0,1,1302,10858198,10.858198
5900,7100,1300,41890000,2,10406,2603,1,470320000,470320000,3901,1300,2601,1300,0,1,1302,10268318,10.268318
5900,7100,1300,41890000,2,10406,2603,1,470320000,470320000,3901,1300,2601,1300,0,1,1302,10894450,10.89445
5900,7100,1300,41890000,2,10406,2603,1,470320000,470320000,3901,1300,2601,1300,0,1,1302,10548910,10.54891
5900,7100,1300,41890000,2,10406,2603,1,470320000,470320000,3901,1300,2601,1300,0,1,1302,10297382,10.297382
5900,7100,1300,41890000,2,10406,2603,1,470320000,470320000,3901,1300,2601,1300,0,1,1302,10732774,10.732774
5900,7100,1700,41890000,2,13606,3403,1,511920000,511920000,5101,1700,3401,1700,0,1,1702,13478118,13.478118
5900,7100,1700,41890000,2,13606,3403,1,511920000,511920000,5101,1700,3401,1700,0,1,1702,14070852,14.070852
5900,7100,1700,41890000,2,13606,3403,1,511920000,511920000,5101,1700,3401,1700,0,1,1702,13449905,13.449905
5900,7100,1700,41890000,2,13606,3403,1,511920000,511920000,5101,1700,3401,1700,0,1,1702,14099533,14.099533
5900,7100,1700,41890000,2,13606,3403,1,511920000,511920000,5101,1700,3401,1700,0,1,1702,13588676,13.588676
5900,7100,1700,41890000,2,13606,3403,1,511920000,511920000,5101,1700,3401,1700,0,1,1702,13405458,13.405458
5900,7100,1700,41890000,2,13606,3403,1,511920000,511920000,5101,1700,3401,1700,0,1,1702,13879468,13.879468
5900,7100,2100,41890000,2,16806,4203,1,553520000,553520000,6301,2100,4201,2100,0,1,2102,16486711,16.486711
5900,7100,2100,41890000,2,16806,4203,1,553520000,553520000,6301,2100,4201,2100,0,1,2102,17272958,17.272958
5900,7100,2100,41890000,2,16806,4203,1,553520000,553520000,6301,2100,4201,2100,0,1,2102,16514987,16.514987
5900,7100,2100,41890000,2,16806,4203,1,553520000,553520000,6301,2100,4201,2100,0,1,2102,17310829,17.310829
5900,7100,2100,41890000,2,16806,4203,1,553520000,553520000,6301,2100,4201,2100,0,1,2102,16679340,16.67934
5900,7100,2100,41890000,2,16806,4203,1,553520000,553520000,6301,2100,4201,2100,0,1,2102,16516234,16.516234
5900,7100,2100,41890000,2,16806,4203,1,553520000,553520000,6301,2100,4201,2100,0,1,2102,17049208,17.049208
5900,7100,2500,41890000,2,20006,5003,1,595120000,595120000,7501,2500,5001,2500,0,1,2502,19526138,19.526138
5900,7100,2500,41890000,2,20006,5003,1,595120000,595120000,7501,2500,5001,2500,0,1,2502,20451935,20.451935
5900,7100,2500,41890000,2,20006,5003,1,595120000,595120000,7501,2500,5001,2500,0,1,2502,19555307,19.555307
5900,7100,2500,41890000,2,20006,5003,1,595120000,595120000,7501,2500,5001,2500,0,1,2502,20555801,20.555801
5900,7100,2500,41890000,2,20006,5003,1,595120000,595120000,7501,2500,5001,2500,0,1,2502,19781503,19.781503
5900,7100,2500,41890000,2,20006,5003,1,595120000,595120000,7501,2500,5001,2500,0,1,2502,19583293,19.583293
5900,7100,2500,41890000,2,20006,5003,1,595120000,595120000,7501,2500,5001,2500,0,1,2502,20193805,20.193805
5900,7100,2900,41890000,2,23206,5803,1,636720000,636720000,8701,2900,5801,2900,0,1,2902,22613561,22.613561
5900,7100,2900,41890000,2,23206,5803,1,636720000,636720000,8701,2900,5801,2900,0,1,2902,23682805,23.682805
5900,7100,2900,41890000,2,23206,5803,1,636720000,636720000,8701,2900,5801,2900,0,1,2902,22584789,22.584789
5900,7100,2900,41890000,2,23206,5803,1,636720000,636720000,8701,2900,5801,2900,0,1,2902,23778382,23.778382
5900,7100,2900,41890000,2,23206,5803,1,636720000,636720000,8701,2900,5801,2900,0,1,2902,22828472,22.828472
5900,7100,2900,41890000,2,23206,5803,1,636720000,636720000,8701,2900,5801,2900,0,1,2902,22641470,22.64147
5900,7100,2900,41890000,2,23206,5803,1,636720000,636720000,8701,2900,5801,2900,0,1,2902,23399546,23.399546
5900,7100,3300,41890000,2,26406,6603,1,678320000,678320000,9901,3300,6601,3300,0,1,3302,25684893,25.684893
5900,7100,3300,41890000,2,26406,6603,1,678320000,678320000,9901,3300,6601,3300,0,1,3302,26876283,26.876283
5900,7100,3300,41890000,2,26406,6603,1,678320000,678320000,9901,3300,6601,3300,0,1,3302,25684381,25.684381
5900,7100,3300,41890000,2,26406,6603,1,678320000,678320000,9901,3300,6601,3300,0,1,3302,26939918,26.939918
5900,7100,3300,41890000,2,26406,6603,1,678320000,678320000,9901,3300,6601,3300,0,1,3302,25897887,25.897887
5900,7100,3300,41890000,2,26406,6603,1,678320000,678320000,9901,3300,6601,3300,0,1,3302,25639770,25.63977
5900,7100,3300,41890000,2,26406,6603,1,678320000,678320000,9901,3300,6601,3300,0,1,3302,26559182,26.559182
5900,7100,3700,41890000,2,29606,7403,1,719920000,719920000,11101,3700,7401,3700,0,1,3702,28721641,28.721641
5900,7100,3700,41890000,2,29606,7403,1,719920000,719920000,11101,3700,7401,3700,0,1,3702,30064340,30.06434
5900,7100,3700,41890000,2,29606,7403,1,719920000,719920000,11101,3700,7401,3700,0,1,3702,28750023,28.750023
5900,7100,3700,41890000,2,29606,7403,1,719920000,719920000,11101,3700,7401,3700,0,1,3702,30214917,30.214917
5900,7100,3700,41890000,2,29606,7403,1,719920000,719920000,11101,3700,7401,3700,0,1,3702,28983609,28.983609
5900,7100,3700,41890000,2,29606,7403,1,719920000,719920000,11101,3700,7401,3700,0,1,3702,28676013,28.676013
5900,7100,3700,41890000,2,29606,7403,1,719920000,719920000,11101,3700,7401,3700,0,1,3702,29739675,29.739675
5900,7100,4100,41890000,2,32806,8203,1,761520000,761520000,12301,4100,8201,4100,0,1,4102,31786692,31.786692
5900,7100,4100,41890000,2,32806,8203,1,761520000,761520000,12301,4100,8201,4100,0,1,4102,33211295,33.211295
5900,7100,4100,41890000,2,32806,8203,1,761520000,761520000,12301,4100,8201,4100,0,1,4102,31860918,31.860918
5900,7100,4100,41890000,2,32806,8203,1,761520000,761520000,12301,4100,8201,4100,0,1,4102,33453210,33.45321
5900,7100,4100,41890000,2,32806,8203,1,761520000,761520000,12301,4100,8201,4100,0,1,4102,32038658,32.038658
5900,7100,4100,41890000,2,32806,8203,1,761520000,761520000,12301,4100,8201,4100,0,1,4102,31726651,31.726651
5900,7100,4100,41890000,2,32806,8203,1,761520000,761520000,12301,4100,8201,4100,0,1,4102,32911368,32.911368
5900,7100,4500,41890000,2,36006,9003,1,803120000,803120000,13501,4500,9001,4500,0,1,4502,34880985,34.880985
5900,7100,4500,41890000,2,36006,9003,1,803120000,803120000,13501,4500,9001,4500,0,1,4502,36565394,36.565394
5900,7100,4500,41890000,2,36006,9003,1,803120000,803120000,13501,4500,9001,4500,0,1,4502,34952757,34.952757
5900,7100,4500,41890000,2,36006,9003,1,803120000,803120000,13501,4500,9001,4500,0,1,4502,36734938,36.734938
5900,7100,4500,41890000,2,36006,9003,1,803120000,803120000,13501,4500,9001,4500,0,1,4502,35192090,35.19209
5900,7100,4500,41890000,2,36006,9003,1,803120000,803120000,13501,4500,9001,4500,0,1,4502,34852621,34.852621
5900,7100,4500,41890000,2,36006,9003,1,803120000,803120000,13501,4500,9001,4500,0,1,4502,36080085,36.080085
5900,7100,4900,41890000,2,39206,9803,1,844720000,844720000,14701,4900,9801,4900,0,1,4902,37875504,37.875504
5900,7100,4900,41890000,2,39206,9803,1,844720000,844720000,14701,4900,9801,4900,0,1,4902,39895549,39.895549
5900,7100,4900,41890000,2,39206,9803,1,844720000,844720000,14701,4900,9801,4900,0,1,4902,38054551,38.054551
5900,7100,4900,41890000,2,39206,9803,1,844720000,844720000,14701,4900,9801,4900,0,1,4902,39986257,39.986257
5900,7100,4900,41890000,2,39206,9803,1,844720000,844720000,14701,4900,9801,4900,0,1,4902,38262989,38.262989
5900,7100,4900,41890000,2,39206,9803,1,844720000,844720000,14701,4900,9801,4900,0,1,4902,37926740,37.92674
5900,7100,4900,41890000,2,39206,9803,1,844720000,844720000,14701,4900,9801,4900,0,1,4902,39267148,39.267148
5900,7100,5300,41890000,2,42406,10603,1,886320000,886320000,15901,5300,10601,5300,0,1,5302,41069417,41.069417
5900,7100,5300,41890000,2,42406,10603,1,886320000,886320000,15901,5300,10601,5300,0,1,5302,43170349,43.170349
5900,7100,5300,41890000,2,42406,10603,1,886320000,886320000,15901,5300,10601,5300,0,1,5302,41151014,41.151014
5900,7100,5300,41890000,2,42406,10603,1,886320000,886320000,15901,5300,10601,5300,0,1,5302,43279951,43.279951
5900,7100,5300,41890000,2,42406,10603,1,886320000,886320000,15901,5300,10601,5300,0,1,5302,41380325,41.380325
5900,7100,5300,41890000,2,42406,10603,1,886320000,886320000,15901,5300,10601,5300,0,1,5302,41097760,41.09776
5900,7100,5300,41890000,2,42406,10603,1,886320000,886320000,15901,5300,10601,5300,0,1,5302,42633030,42.63303
5900,7100,5700,41890000,2,45606,11403,1,927920000,927920000,17101,5700,11401,5700,0,1,5702,44103423,44.103423
5900,7100,5700,41890000,2,45606,11403,1,927920000,927920000,17101,5700,11401,5700,0,1,5702,46375457,46.375457
5900,7100,5700,41890000,2,45606,11403,1,927920000,927920000,17101,5700,11401,5700,0,1,5702,44361225,44.361225
5900,7100,5700,41890000,2,45606,11403,1,927920000,927920000,17101,5700,11401,5700,0,1,5702,46488547,46.488547
5900,7100,5700,41890000,2,45606,11403,1,927920000,927920000,17101,5700,11401,5700,0,1,5702,44550975,44.550975
5900,7100,5700,41890000,2,45606,11403,1,927920000,927920000,17101,5700,11401,5700,0,1,5702,44158431,44.158431
5900,7100,5700,41890000,2,45606,11403,1,927920000,927920000,17101,5700,11401,5700,0,1,5702,45854251,45.854251
5900,7100,6100,41890000,2,48806,12203,1,969520000,969520000,18301,6100,12201,6100,0,1,6102,47278867,47.278867
5900,7100,6100,41890000,2,48806,12203,1,969520000,969520000,18301,6100,12201,6100,0,1,6102,49783358,49.783358
5900,7100,6100,41890000,2,48806,12203,1,969520000,969520000,18301,6100,12201,6100,0,1,6102,47508680,47.50868
5900,7100,6100,41890000,2,48806,12203,1,969520000,969520000,18301,6100,12201,6100,0,1,6102,49725240,49.72524
5900,7100,6100,41890000,2,48806,12203,1,969520000,969520000,18301,6100,12201,6100,0,1,6102,47702666,47.702666
5900,7100,6100,41890000,2,48806,12203,1,969520000,969520000,18301,6100,12201,6100,0,1,6102,47337637,47.337637
5900,7100,6100,41890000,2,48806,12203,1,969520000,969520000,18301,6100,12201,6100,0,1,6102,48989886,48.989886
5900,7100,6500,41890000,2,52006,13003,1,1011120000,1011120000,19501,6500,13001,6500,0,1,6502,50330591,50.330591
5900,7100,6500,41890000,2,52006,13003,1,1011120000,1011120000,19501,6500,13001,6500,0,1,6502,52930273,52.930273
5900,7100,6500,41890000,2,52006,13003,1,1011120000,1011120000,19501,6500,13001,6500,0,1,6502,50464884,50.464884
5900,7100,6500,41890000,2,52006,13003,1,1011120000,1011120000,19501,6500,13001,6500,0,1,6502,53045218,53.045218
5900,7100,6500,41890000,2,52006,13003,1,1011120000,1011120000,19501,6500,13001,6500,0,1,6502,50686689,50.686689
5900,7100,6500,41890000,2,52006,13003,1,1011120000,1011120000,19501,6500,13001,6500,0,1,6502,50362863,50.362863
5900,7100,6500,41890000,2,52006,13003,1,1011120000,1011120000,19501,6500,13001,6500,0,1,6502,52257052,52.257052
5900,7100,6900,41890000,2,55206,13803,1,1052720000,1052720000,20701,6900,13801,6900,0,1,6902,53341205,53.341205
5900,7100,6900,41890000,2,55206,13803,1,1052720000,1052720000,20701,6900,13801,6900,0,1,6902,56181131,56.181131
5900,7100,6900,41890000,2,55206,13803,1,1052720000,1052720000,20701,6900,13801,6900,0,1,6902,53573250,53.57325
5900,7100,6900,41890000,2,55206,13803,1,1052720000,1052720000,20701,6900,13801,6900,0,1,6902,56300703,56.300703
5900,7100,6900,41890000,2,55206,13803,1,1052720000,1052720000,20701,6900,13801,6900,0,1,6902,53883875,53.883875
5900,7100,6900,41890000,2,55206,13803,1,1052720000,1052720000,20701,6900,13801,6900,0,1,6902,53470733,53.470733
5900,7100,6900,41890000,2,55206,13803,1,1052720000,1052720000,20701,6900,13801,6900,0,1,6902,55389210,55.38921
5900,6700,500,39530000,2,4006,1003,1,366640000,366640000,1501,500,1001,500,0,1,502,4176399,4.176399
5900,6700,500,39530000,2,4006,1003,1,366640000,366640000,1501,500,1001,500,0,1,502,4236865,4.236865
5900,6700,500,39530000,2,4006,1003,1,366640000,366640000,1501,500,1001,500,0,1,502,4072200,4.0722
5900,6700,500,39530000,2,4006,1003,1,366640000,366640000,1501,500,1001,500,0,1,502,4291916,4.291916
5900,6700,500,39530000,2,4006,1003,1,366640000,366640000,1501,500,1001,500,0,1,502,4149587,4.149587
5900,6700,500,39530000,2,4006,1003,1,366640000,366640000,1501,500,1001,500,0,1,502,4263451,4.263451
5900,6700,500,39530000,2,4006,1003,1,366640000,366640000,1501,500,1001,500,0,1,502,4208477,4.208477
5900,6700,900,39530000,2,7206,1803,1,406960000,406960000,2701,900,1801,900,0,1,902,6851652,6.851652
5900,6700,900,39530000,2,7206,1803,1,406960000,406960000,2701,900,1801,900,0,1,902,7112090,7.11209
5900,6700,900,39530000,2,7206,1803,1,406960000,406960000,2701,900,1801,900,0,1,902,6878226,6.878226
5900,6700,900,39530000,2,7206,1803,1,406960000,406960000,2701,900,1801,900,0,1,902,7187518,7.187518
5900,6700,900,39530000,2,7206,1803,1,406960000,406960000,2701,900,1801,900,0,1,902,6968336,6.968336
5900,6700,900,39530000,2,7206,1803,1,406960000,406960000,2701,900,1801,900,0,1,902,6904917,6.904917
5900,6700,900,39530000,2,7206,1803,1,406960000,406960000,2701,900,1801,900,0,1,902,7040847,7.040847
5900,6700,1300,39530000,2,10406,2603,1,447280000,447280000,3901,1300,2601,1300,0,1,1302,9877175,9.877175
5900,6700,1300,39530000,2,10406,2603,1,447280000,447280000,3901,1300,2601,1300,0,1,1302,10235801,10.235801
5900,6700,1300,39530000,2,10406,2603,1,447280000,447280000,3901,1300,2601,1300,0,1,1302,9850440,9.85044
5900,6700,1300,39530000,2,10406,2603,1,447280000,447280000,3901,1300,2601,1300,0,1,1302,10309688,10.309688
5900,6700,1300,39530000,2,10406,2603,1,447280000,447280000,3901,1300,2601,1300,0,1,1302,10002693,10.002693
5900,6700,1300,39530000,2,10406,2603,1,447280000,447280000,3901,1300,2601,1300,0,1,1302,9949638,9.949638
5900,6700,1300,39530000,2,10406,2603,1,447280000,447280000,3901,1300,2601,1300,0,1,1302,10155940,10.15594
5900,6700,1700,39530000,2,13606,3403,1,487600000,487600000,5101,1700,3401,1700,0,1,1702,12718388,12.718388
5900,6700,1700,39530000,2,13606,3403,1,487600000,487600000,5101,1700,3401,1700,0,1,1702,13210063,13.210063
5900,6700,1700,39530000,2,13606,3403,1,487600000,487600000,5101,1700,3401,1700,0,1,1702,12752643,12.752643
5900,6700,1700,39530000,2,13606,3403,1,487600000,487600000,5101,1700,3401,1700,0,1,1702,13303600,13.3036
5900,6700,1700,39530000,2,13606,3403,1,487600000,487600000,5101,1700,3401,1700,0,1,1702,12929020,12.92902
5900,6700,1700,39530000,2,13606,3403,1,487600000,487600000,5101,1700,3401,1700,0,1,1702,12819040,12.81904
5900,6700,1700,39530000,2,13606,3403,1,487600000,487600000,5101,1700,3401,1700,0,1,1702,13097727,13.097727
5900,6700,2100,39530000,2,16806,4203,1,527920000,527920000,6301,2100,4201,2100,0,1,2102,15628417,15.628417
5900,6700,2100,39530000,2,16806,4203,1,527920000,527920000,6301,2100,4201,2100,0,1,2102,16258979,16.258979
5900,6700,2100,39530000,2,16806,4203,1,527920000,527920000,6301,2100,4201,2100,0,1,2102,15592469,15.592469
5900,6700,2100,39530000,2,16806,4203,1,527920000,527920000,6301,2100,4201,2100,0,1,2102,16364730,16.36473
5900,6700,2100,39530000,2,16806,4203,1,527920000,527920000,6301,2100,4201,2100,0,1,2102,15778451,15.778451
5900,6700,2100,39530000,2,16806,4203,1,527920000,527920000,6301,2100,4201,2100,0,1,2102,15699863,15.699863
5900,6700,2100,39530000,2,16806,4203,1,527920000,527920000,6301,2100,4201,2100,0,1,2102,16062426,16.062426
5900,6700,2500,39530000,2,20006,5003,1,568240000,568240000,7501,2500,5001,2500,0,1,2502,18437577,18.437577
5900,6700,2500,39530000,2,20006,5003,1,568240000,568240000,7501,2500,5001,2500,0,1,2502,19265508,19.265508
5900,6700,2500,39530000,2,20006,5003,1,568240000,568240000,7501,2500,5001,2500,0,1,2502,18499644,18.499644
5900,6700,2500,39530000,2,20006,5003,1,568240000,568240000,7501,2500,5001,2500,0,1,2502,19364562,19.364562
5900,6700,2500,39530000,2,20006,5003,1,568240000,568240000,7501,2500,5001,2500,0,1,2502,18691214,18.691214
5900,6700,2500,39530000,2,20006,5003,1,568240000,568240000,7501,2500,5001,2500,0,1,2502,18551520,18.55152
5900,6700,2500,39530000,2,20006,5003,1,568240000,568240000,7501,2500,5001,2500,0,1,2502,19061972,19.061972
5900,6700,2900,39530000,2,23206,5803,1,608560000,608560000,8701,2900,5801,2900,0,1,2902,21344437,21.344437
5900,6700,2900,39530000,2,23206,5803,1,608560000,608560000,8701,2900,5801,2900,0,1,2902,22298890,22.29889
5900,6700,2900,39530000,2,23206,5803,1,608560000,608560000,8701,2900,5801,2900,0,1,2902,21402771,21.402771
5900,6700,2900,39530000,2,23206,5803,1,608560000,608560000,8701,2900,5801,2900,0,1,2902,22453217,22.453217
5900,6700,2900,39530000,2,23206,5803,1,608560000,608560000,8701,2900,5801,2900,0,1,2902,21594864,21.594864
5900,6700,2900,39530000,2,23206,5803,1,608560000,608560000,8701,2900,5801,2900,0,1,2902,21429555,21.429555
5900,6700,2900,39530000,2,23206,5803,1,608560000,608560000,8701,2900,5801,2900,0,1,2902,22042205,22.042205
5900,6700,3300,39530000,2,26406,6603,1,648880000,648880000,9901,3300,6601,3300,0,1,3302,24253191,24.253191
5900,6700,3300,39530000,2,26406,6603,1,648880000,648880000,9901,3300,6601,3300,0,1,3302,25424383,25.424383
5900,6700,3300,39530000,2,26406,6603,1,648880000,648880000,9901,3300,6601,3300,0,1,3302,24280032,24.280032
5900,6700,3300,39530000,2,26406,6603,1,648880000,648880000,9901,3300,6601,3300,0,1,3302,25495091,25.495091
5900,6700,3300,39530000,2,26406,6603,1,648880000,648880000,9901,3300,6601,3300,0,1,3302,24488690,24.48869
5900,6700,3300,39530000,2,26406,6603,1,648880000,648880000,9901,3300,6601,3300,0,1,3302,24375501,24.375501
5900,6700,3300,39530000,2,26406,6603,1,648880000,648880000,9901,3300,6601,3300,0,1,3302,25078145,25.078145
5900,6700,3700,39530000,2,29606,7403,1,689200000,689200000,11101,3700,7401,3700,0,1,3702,27166458,27.166458
5900,6700,3700,39530000,2,29606,7403,1,689200000,689200000,11101,3700,7401,3700,0,1,3702,28358696,28.358696
5900,6700,3700,39530000,2,29606,7403,1,689200000,689200000,11101,3700,7401,3700,0,1,3702,27193308,27.193308
5900,6700,3700,39530000,2,29606,7403,1,689200000,689200000,11101,3700,7401,3700,0,1,3702,28516929,28.516929
5900,6700,3700,39530000,2,29606,7403,1,689200000,689200000,11101,3700,7401,3700,0,1,3702,27457712,27.457712
5900,6700,3700,39530000,2,29606,7403,1,689200000,689200000,11101,3700,7401,3700,0,1,3702,27093020,27.09302
5900,6700,3700,39530000,2,29606,7403,1,689200000,689200000,11101,3700,7401,3700,0,1,3702,28066950,28.06695
5900,6700,4100,39530000,2,32806,8203,1,729520000,729520000,12301,4100,8201,4100,0,1,4102,30082463,30.082463
5900,6700,4100,39530000,2,32806,8203,1,729520000,729520000,12301,4100,8201,4100,0,1,4102,31364925,31.364925
5900,6700,4100,39530000,2,32806,8203,1,729520000,729520000,12301,4100,8201,4100,0,1,4102,30136051,30.136051
5900,6700,4100,39530000,2,32806,8203,1,729520000,729520000,12301,4100,8201,4100,0,1,4102,31709747,31.709747
5900,6700,4100,39530000,2,32806,8203,1,729520000,729520000,12301,4100,8201,4100,0,1,4102,30282700,30.2827
5900,6700,4100,39530000,2,32806,8203,1,729520000,729520000,12301,4100,8201,4100,0,1,4102,30109236,30.109236
5900,6700,4100,39530000,2,32806,8203,1,729520000,729520000,12301,4100,8201,4100,0,1,4102,31051953,31.051953
5900,6700,4500,39530000,2,36006,9003,1,769840000,769840000,13501,4500,9001,4500,0,1,4502,32852771,32.852771
5900,6700,4500,39530000,2,36006,9003,1,769840000,769840000,13501,4500,9001,4500,0,1,4502,34579402,34.579402
5900,6700,4500,39530000,2,36006,9003,1,769840000,769840000,13501,4500,9001,4500,0,1,4502,33000847,33.000847
5900,6700,4500,39530000,2,36006,9003,1,769840000,769840000,13501,4500,9001,4500,0,1,4502,34712458,34.712458
5900,6700,4500,39530000,2,36006,9003,1,769840000,769840000,13501,4500,9001,4500,0,1,4502,33285970,33.28597
5900,6700,4500,39530000,2,36006,9003,1,769840000,769840000,13501,4500,9001,4500,0,1,4502,33086574,33.086574
5900,6700,4500,39530000,2,36006,9003,1,769840000,769840000,13501,4500,9001,4500,0,1,4502,34188185,34.188185
5900,6700,4900,39530000,2,39206,9803,1,810160000,810160000,14701,4900,9801,4900,0,1,4902,35815763,35.815763
5900,6700,4900,39530000,2,39206,9803,1,810160000,810160000,14701,4900,9801,4900,0,1,4902,37562426,37.562426
5900,6700,4900,39530000,2,39206,9803,1,810160000,810160000,14701,4900,9801,4900,0,1,4902,35962567,35.962567
5900,6700,4900,39530000,2,39206,9803,1,810160000,810160000,14701,4900,9801,4900,0,1,4902,37747942,37.747942
5900,6700,4900,39530000,2,39206,9803,1,810160000,810160000,14701,4900,9801,4900,0,1,4902,36185209,36.185209
5900,6700,4900,39530000,2,39206,9803,1,810160000,810160000,14701,4900,9801,4900,0,1,4902,35935742,35.935742
5900,6700,4900,39530000,2,39206,9803,1,810160000,810160000,14701,4900,9801,4900,0,1,4902,37094026,37.094026
5900,6700,5300,39530000,2,42406,10603,1,850480000,850480000,15901,5300,10601,5300,0,1,5302,38694176,38.694176
5900,6700,5300,39530000,2,42406,10603,1,850480000,850480000,15901,5300,10601,5300,0,1,5302,40641468,40.641468
5900,6700,5300,39530000,2,42406,10603,1,850480000,850480000,15901,5300,10601,5300,0,1,5302,38824221,38.824221
5900,6700,5300,39530000,2,42406,10603,1,850480000,850480000,15901,5300,10601,5300,0,1,5302,40780763,40.780763
5900,6700,5300,39530000,2,42406,10603,1,850480000,850480000,15901,5300,10601,5300,0,1,5302,39089560,39.08956
5900,6700,5300,39530000,2,42406,10603,1,850480000,850480000,15901,5300,10601,5300,0,1,5302,38852043,38.852043
5900,6700,5300,39530000,2,42406,10603,1,850480000,850480000,15901,5300,10601,5300,0,1,5302,40137705,40.137705
5900,6700,5700,39530000,2,45606,11403,1,890800000,890800000,17101,5700,11401,5700,0,1,5702,41634004,41.634004
5900,6700,5700,39530000,2,45606,11403,1,890800000,890800000,17101,5700,11401,5700,0,1,5702,43680954,43.680954
5900,6700,5700,39530000,2,45606,11403,1,890800000,890800000,17101,5700,11401,5700,0,1,5702,41802887,41.802887
5900,6700,5700,39530000,2,45606,11403,1,890800000,890800000,17101,5700,11401,5700,0,1,5702,43837028,43.837028
5900,6700,5700,39530000,2,45606,11403,1,890800000,890800000,17101,5700,11401,5700,0,1,5702,42050913,42.050913
5900,6700,5700,39530000,2,45606,11403,1,890800000,890800000,17101,5700,11401,5700,0,1,5702,41776330,41.77633
5900,6700,5700,39530000,2,45606,11403,1,890800000,890800000,17101,5700,11401,5700,0,1,5702,43132070,43.13207
5900,6700,6100,39530000,2,48806,12203,1,931120000,931120000,18301,6100,12201,6100,0,1,6102,44526669,44.526669
5900,6700,6100,39530000,2,48806,12203,1,931120000,931120000,18301,6100,12201,6100,0,1,6102,46920584,46.920584
5900,6700,6100,39530000,2,48806,12203,1,931120000,931120000,18301,6100,12201,6100,0,1,6102,44712970,44.71297
5900,6700,6100,39530000,2,48806,12203,1,931120000,931120000,18301,6100,12201,6100,0,1,6102,46866651,46.866651
5900,6700,6100,39530000,2,48806,12203,1,931120000,931120000,18301,6100,12201,6100,0,1,6102,44976157,44.976157
5900,6700,6100,39530000,2,48806,12203,1,931120000,931120000,18301,6100,12201,6100,0,1,6102,44659060,44.65906
5900,6700,6100,39530000,2,48806,12203,1,931120000,931120000,18301,6100,12201,6100,0,1,6102,46167598,46.167598
5900,6700,6500,39530000,2,52006,13003,1,971440000,971440000,19501,6500,13001,6500,0,1,6502,47630237,47.630237
5900,6700,6500,39530000,2,52006,13003,1,971440000,971440000,19501,6500,13001,6500,0,1,6502,49927198,49.927198
5900,6700,6500,39530000,2,52006,13003,1,971440000,971440000,19501,6500,13001,6500,0,1,6502,47687469,47.687469
5900,6700,6500,39530000,2,52006,13003,1,971440000,971440000,19501,6500,13001,6500,0,1,6502,50048677,50.048677
5900,6700,6500,39530000,2,52006,13003,1,971440000,971440000,19501,6500,13001,6500,0,1,6502,48011246,48.011246
5900,6700,6500,39530000,2,52006,13003,1,971440000,971440000,19501,6500,13001,6500,0,1,6502,47686674,47.686674
5900,6700,6500,39530000,2,52006,13003,1,971440000,971440000,19501,6500,13001,6500,0,1,6502,49408845,49.408845
5900,6700,6900,39530000,2,55206,13803,1,1011760000,1011760000,20701,6900,13801,6900,0,1,6902,50423558,50.423558
5900,6700,6900,39530000,2,55206,13803,1,1011760000,1011760000,20701,6900,13801,6900,0,1,6902,53008610,53.00861
5900,6700,6900,39530000,2,55206,13803,1,1011760000,1011760000,20701,6900,13801,6900,0,1,6902,50758497,50.758497
5900,6700,6900,39530000,2,55206,13803,1,1011760000,1011760000,20701,6900,13801,6900,0,1,6902,53192896,53.192896
5900,6700,6900,39530000,2,55206,13803,1,1011760000,1011760000,20701,6900,13801,6900,0,1,6902,50903005,50.903005
5900,6700,6900,39530000,2,55206,13803,1,1011760000,1011760000,20701,6900,13801,6900,0,1,6902,50592839,50.592839
5900,6700,6900,39530000,2,55206,13803,1,1011760000,1011760000,20701,6900,13801,6900,0,1,6902,52380445,52.380445
5900,6300,500,37170000,2,4006,1003,1,346160000,346160000,1501,500,1001,500,0,1,502,3887348,3.887348
5900,6300,500,37170000,2,4006,1003,1,346160000,346160000,1501,500,1001,500,0,1,502,4040949,4.040949
5900,6300,500,37170000,2,4006,1003,1,346160000,346160000,1501,500,1001,500,0,1,502,3912472,3.912472
5900,6300,500,37170000,2,4006,1003,1,346160000,346160000,1501,500,1001,500,0,1,502,4011519,4.011519
5900,6300,500,37170000,2,4006,1003,1,346160000,346160000,1501,500,1001,500,0,1,502,3980580,3.98058
5900,6300,500,37170000,2,4006,1003,1,346160000,346160000,1501,500,1001,500,0,1,502,4038960,4.03896
5900,6300,500,37170000,2,4006,1003,1,346160000,346160000,1501,500,1001,500,0,1,502,4067297,4.067297
5900,6300,900,37170000,2,7206,1803,1,385200000,385200000,2701,900,1801,900,0,1,902,6421118,6.421118
5900,6300,900,37170000,2,7206,1803,1,385200000,385200000,2701,900,1801,900,0,1,902,6743721,6.743721
5900,6300,900,37170000,2,7206,1803,1,385200000,385200000,2701,900,1801,900,0,1,902,6446212,6.446212
5900,6300,900,37170000,2,7206,1803,1,385200000,385200000,2701,900,1801,900,0,1,902,6743268,6.743268
5900,6300,900,37170000,2,7206,1803,1,385200000,385200000,2701,900,1801,900,0,1,902,6556193,6.556193
5900,6300,900,37170000,2,7206,1803,1,385200000,385200000,2701,900,1801,900,0,1,902,6476712,6.476712
5900,6300,900,37170000,2,7206,1803,1,385200000,385200000,2701,900,1801,900,0,1,902,6716350,6.71635
5900,6300,1300,37170000,2,10406,2603,1,424240000,424240000,3901,1300,2601,1300,0,1,1302,9262545,9.262545
5900,6300,1300,37170000,2,10406,2603,1,424240000,424240000,3901,1300,2601,1300,0,1,1302,9649888,9.649888
5900,6300,1300,37170000,2,10406,2603,1,424240000,424240000,3901,1300,2601,1300,0,1,1302,9287649,9.287649
5900,6300,1300,37170000,2,10406,2603,1,424240000,424240000,3901,1300,2601,1300,0,1,1302,9676617,9.676617
5900,6300,1300,37170000,2,10406,2603,1,424240000,424240000,3901,1300,2601,1300,0,1,1302,9417074,9.417074
5900,6300,1300,37170000,2,10406,2603,1,424240000,424240000,3901,1300,2601,1300,0,1,1302,9341048,9.341048
5900,6300,1300,37170000,2,10406,2603,1,424240000,424240000,3901,1300,2601,1300,0,1,1302,9623020,9.62302
5900,6300,1700,37170000,2,13606,3403,1,463280000,463280000,5101,1700,3401,1700,0,1,1702,11955851,11.955851
5900,6300,1700,37170000,2,13606,3403,1,463280000,463280000,5101,1700,3401,1700,0,1,1702,12477442,12.477442
5900,6300,1700,37170000,2,13606,3403,1,463280000,463280000,5101,1700,3401,1700,0,1,1702,11980958,11.980958
5900,6300,1700,37170000,2,13606,3403,1,463280000,463280000,5101,1700,3401,1700,0,1,1702,12514265,12.514265
5900,6300,1700,37170000,2,13606,3403,1,463280000,463280000,5101,1700,3401,1700,0,1,1702,12115086,12.115086
5900,6300,1700,37170000,2,13606,3403,1,463280000,463280000,5101,1700,3401,1700,0,1,1702,12054999,12.054999
5900,6300,1700,37170000,2,13606,3403,1,463280000,463280000,5101,1700,3401,1700,0,1,1702,12407566,12.407566
5900,6300,2100,37170000,2,16806,4203,1,502320000,502320000,6301,2100,4201,2100,0,1,2102,14640029,14.640029
5900,6300,2100,37170000,2,16806,4203,1,502320000,502320000,6301,2100,4201,2100,0,1,2102,15281866,15.281866
5900,6300,2100,37170000,2,16806,4203,1,502320000,502320000,6301,2100,4201,2100,0,1,2102,14691479,14.691479
5900,6300,2100,37170000,2,16806,4203,1,502320000,502320000,6301,2100,4201,2100,0,1,2102,15461694,15.461694
5900,6300,2100,37170000,2,16806,4203,1,502320000,502320000,6301,2100,4201,2100,0,1,2102,14785482,14.785482
5900,6300,2100,37170000,2,16806,4203,1,502320000,502320000,6301,2100,4201,2100,0,1,2102,14745191,14.745191
5900,6300,2100,37170000,2,16806,4203,1,502320000,502320000,6301,2100,4201,2100,0,1,2102,15209261,15.209261
5900,6300,2500,37170000,2,20006,5003,1,541360000,541360000,7501,2500,5001,2500,0,1,2502,17376197,17.376197
5900,6300,2500,37170000,2,20006,5003,1,541360000,541360000,7501,2500,5001,2500,0,1,2502,18163427,18.163427
5900,6300,2500,37170000,2,20006,5003,1,541360000,541360000,7501,2500,5001,2500,0,1,2502,17401356,17.401356
5900,6300,2500,37170000,2,20006,5003,1,541360000,541360000,7501,2500,5001,2500,0,1,2502,18282989,18.282989
5900,6300,2500,37170000,2,20006,5003,1,541360000,541360000,7501,2500,5001,2500,0,1,2502,17475649,17.475649
5900,6300,2500,37170000,2,20006,5003,1,541360000,541360000,7501,2500,5001,2500,0,1,2502,17501184,17.501184
5900,6300,2500,37170000,2,20006,5003,1,541360000,541360000,7501,2500,5001,2500,0,1,2502,18047287,18.047287
5900,6300,2900,37170000,2,23206,5803,1,580400000,580400000,8701,2900,5801,2900,0,1,2902,20071378,20.071378
5900,6300,2900,37170000,2,23206,5803,1,580400000,580400000,8701,2900,5801,2900,0,1,2902,20985352,20.985352
5900,6300,2900,37170000,2,23206,5803,1,580400000,580400000,8701,2900,5801,2900,0,1,2902,20181240,20.18124
5900,6300,2900,37170000,2,23206,5803,1,580400000,580400000,8701,2900,5801,2900,0,1,2902,21143199,21.143199
5900,6300,2900,37170000,2,23206,5803,1,580400000,580400000,8701,2900,5801,2900,0,1,2902,20207699,20.207699
5900,6300,2900,37170000,2,23206,5803,1,580400000,580400000,8701,2900,5801,2900,0,1,2902,20232721,20.232721
5900,6300,2900,37170000,2,23206,5803,1,580400000,580400000,8701,2900,5801,2900,0,1,2902,20899557,20.899557
5900,6300,3300,37170000,2,26406,6603,1,619440000,619440000,9901,3300,6601,3300,0,1,3302,22789966,22.789966
5900,6300,3300,37170000,2,26406,6603,1,619440000,619440000,9901,3300,6601,3300,0,1,3302,23839874,23.839874
5900,6300,3300,37170000,2,26406,6603,1,619440000,619440000,9901,3300,6601,3300,0,1,3302,22832970,22.83297
5900,6300,3300,37170000,2,26406,6603,1,619440000,619440000,9901,3300,6601,3300,0,1,3302,24022993,24.022993
5900,6300,3300,37170000,2,26406,6603,1,619440000,619440000,9901,3300,6601,3300,0,1,3302,22925636,22.925636
5900,6300,3300,37170000,2,26406,6603,1,619440000,619440000,9901,3300,6601,3300,0,1,3302,22872047,22.872047
5900,6300,3300,37170000,2,26406,6603,1,619440000,619440000,9901,3300,6601,3300,0,1,3302,23667751,23.667751
5900,6300,3700,37170000,2,29606,7403,1,658480000,658480000,11101,3700,7401,3700,0,1,3702,25552681,25.552681
5900,6300,3700,37170000,2,29606,7403,1,658480000,658480000,11101,3700,7401,3700,0,1,3702,26733424,26.733424
5900,6300,3700,37170000,2,29606,7403,1,658480000,658480000,11101,3700,7401,3700,0,1,3702,25593306,25.593306
5900,6300,3700,37170000,2,29606,7403,1,658480000,658480000,11101,3700,7401,3700,0,1,3702,26869920,26.86992
5900,6300,3700,37170000,2,29606,7403,1,658480000,658480000,11101,3700,7401,3700,0,1,3702,25670665,25.670665
5900,6300,3700,37170000,2,29606,7403,1,658480000,658480000,11101,3700,7401,3700,0,1,3702,25594223,25.594223
5900,6300,3700,37170000,2,29606,7403,1,658480000,658480000,11101,3700,7401,3700,0,1,3702,26470215,26.470215
5900,6300,4100,37170000,2,32806,8203,1,697520000,697520000,12301,4100,8201,4100,0,1,4102,28238479,28.238479
5900,6300,4100,37170000,2,32806,8203,1,697520000,697520000,12301,4100,8201,4100,0,1,4102,29541518,29.541518
5900,6300,4100,37170000,2,32806,8203,1,697520000,697520000,12301,4100,8201,4100,0,1,4102,28298325,28.298325
5900,6300,4100,37170000,2,32806,8203,1,697520000,697520000,12301,4100,8201,4100,0,1,4102,29715800,29.7158
5900,6300,4100,37170000,2,32806,8203,1,697520000,697520000,12301,4100,8201,4100,0,1,4102,28382544,28.382544
5900,6300,4100,37170000,2,32806,8203,1,697520000,697520000,12301,4100,8201,4100,0,1,4102,28324156,28.324156
5900,6300,4100,37170000,2,32806,8203,1,697520000,697520000,12301,4100,8201,4100,0,1,4102,29343723,29.343723
5900,6300,4500,37170000,2,36006,9003,1,736560000,736560000,13501,4500,9001,4500,0,1,4502,30974166,30.974166
5900,6300,4500,37170000,2,36006,9003,1,736560000,736560000,13501,4500,9001,4500,0,1,4502,32433611,32.433611
5900,6300,4500,37170000,2,36006,9003,1,736560000,736560000,13501,4500,9001,4500,0,1,4502,31018981,31.018981
5900,6300,4500,37170000,2,36006,9003,1,736560000,736560000,13501,4500,9001,4500,0,1,4502,32587640,32.58764
5900,6300,4500,37170000,2,36006,9003,1,736560000,736560000,13501,4500,9001,4500,0,1,4502,31076255,31.076255
5900,6300,4500,37170000,2,36006,9003,1,736560000,736560000,13501,4500,9001,4500,0,1,4502,31018294,31.018294
5900,6300,4500,37170000,2,36006,9003,1,736560000,736560000,13501,4500,9001,4500,0,1,4502,32100250,32.10025
5900,6300,4900,37170000,2,39206,9803,1,775600000,775600000,14701,4900,9801,4900,0,1,4902,33747156,33.747156
5900,6300,4900,37170000,2,39206,9803,1,775600000,775600000,14701,4900,9801,4900,0,1,4902,35277105,35.277105
5900,6300,4900,37170000,2,39206,9803,1,775600000,775600000,14701,4900,9801,4900,0,1,4902,33805441,33.805441
5900,6300,4900,37170000,2,39206,9803,1,775600000,775600000,14701,4900,9801,4900,0,1,4902,35536869,35.536869
5900,6300,4900,37170000,2,39206,9803,1,775600000,775600000,14701,4900,9801,4900,0,1,4902,34025516,34.025516
5900,6300,4900,37170000,2,39206,9803,1,775600000,775600000,14701,4900,9801,4900,0,1,4902,33655414,33.655414
5900,6300,4900,37170000,2,39206,9803,1,775600000,775600000,14701,4900,9801,4900,0,1,4902,34999680,34.99968
5900,6300,5300,37170000,2,42406,10603,1,814640000,814640000,15901,5300,10601,5300,0,1,5302,36392049,36.392049
5900,6300,5300,37170000,2,42406,10603,1,814640000,814640000,15901,5300,10601,5300,0,1,5302,38224191,38.224191
5900,6300,5300,37170000,2,42406,10603,1,814640000,814640000,15901,5300,10601,5300,0,1,5302,36539023,36.539023
5900,6300,5300,37170000,2,42406,10603,1,814640000,814640000,15901,5300,10601,5300,0,1,5302,38352012,38.352012
5900,6300,5300,37170000,2,42406,10603,1,814640000,814640000,15901,5300,10601,5300,0,1,5302,36628651,36.628651
5900,6300,5300,37170000,2,42406,10603,1,814640000,814640000,15901,5300,10601,5300,0,1,5302,36439282,36.439282
5900,6300,5300,37170000,2,42406,10603,1,814640000,814640000,15901,5300,10601,5300,0,1,5302,37817404,37.817404
5900,6300,5700,37170000,2,45606,11403,1,853680000,853680000,17101,5700,11401,5700,0,1,5702,39095308,39.095308
5900,6300,5700,37170000,2,45606,11403,1,853680000,853680000,17101,5700,11401,5700,0,1,5702,41054496,41.054496
5900,6300,5700,37170000,2,45606,11403,1,853680000,853680000,17101,5700,11401,5700,0,1,5702,39265140,39.26514
5900,6300,5700,37170000,2,45606,11403,1,853680000,853680000,17101,5700,11401,5700,0,1,5702,41240913,41.240913
5900,6300,5700,37170000,2,45606,11403,1,853680000,853680000,17101,5700,11401,5700,0,1,5702,39416563,39.416563
5900,6300,5700,37170000,2,45606,11403,1,853680000,853680000,17101,5700,11401,5700,0,1,5702,39144342,39.144342
5900,6300,5700,37170000,2,45606,11403,1,853680000,853680000,17101,5700,11401,5700,0,1,5702,40673199,40.673199
5900,6300,6100,37170000,2,48806,12203,1,892720000,892720000,18301,6100,12201,6100,0,1,6102,42003329,42.003329
5900,6300,6100,37170000,2,48806,12203,1,892720000,892720000,18301,6100,12201,6100,0,1,6102,44066511,44.066511
5900,6300,6100,37170000,2,48806,12203,1,892720000,892720000,18301,6100,12201,6100,0,1,6102,42075192,42.075192
5900,6300,6100,37170000,2,48806,12203,1,892720000,892720000,18301,6100,12201,6100,0,1,6102,44281611,44.281611
5900,6300,6100,37170000,2,48806,12203,1,892720000,892720000,18301,6100,12201,6100,0,1,6102,42233669,42.233669
5900,6300,6100,37170000,2,48806,12203,1,892720000,892720000,18301,6100,12201,6100,0,1,6102,41902410,41.90241
5900,6300,6100,37170000,2,48806,12203,1,892720000,892720000,18301,6100,12201,6100,0,1,6102,43606492,43.606492
5900,6300,6500,37170000,2,52006,13003,1,931760000,931760000,19501,6500,13001,6500,0,1,6502,44604395,44.604395
5900,6300,6500,37170000,2,52006,13003,1,931760000,931760000,19501,6500,13001,6500,0,1,6502,46828618,46.828618
5900,6300,6500,37170000,2,52006,13003,1,931760000,931760000,19501,6500,13001,6500,0,1,6502,44716527,44.716527
5900,6300,6500,37170000,2,52006,13003,1,931760000,931760000,19501,6500,13001,6500,0,1,6502,47046510,47.04651
5900,6300,6500,37170000,2,52006,13003,1,931760000,931760000,19501,6500,13001,6500,0,1,6502,44904443,44.904443
5900,6300,6500,37170000,2,52006,13003,1,931760000,931760000,19501,6500,13001,6500,0,1,6502,44603475,44.603475
5900,6300,6500,37170000,2,52006,13003,1,931760000,931760000,19501,6500,13001,6500,0,1,6502,46307606,46.307606
5900,6300,6900,37170000,2,55206,13803,1,970800000,970800000,20701,6900,13801,6900,0,1,6902,47423940,47.42394
5900,6300,6900,37170000,2,55206,13803,1,970800000,970800000,20701,6900,13801,6900,0,1,6902,49735177,49.735177
5900,6300,6900,37170000,2,55206,13803,1,970800000,970800000,20701,6900,13801,6900,0,1,6902,47503834,47.503834
5900,6300,6900,37170000,2,55206,13803,1,970800000,970800000,20701,6900,13801,6900,0,1,6902,49957730,49.95773
5900,6300,6900,37170000,2,55206,13803,1,970800000,970800000,20701,6900,13801,6900,0,1,6902,47796078,47.796078
5900,6300,6900,37170000,2,55206,13803,1,970800000,970800000,20701,6900,13801,6900,0,1,6902,47394250,47.39425
5900,6300,6900,37170000,2,55206,13803,1,970800000,970800000,20701,6900,13801,6900,0,1,6902,49211317,49.211317
5900,5900,500,34810000,2,4006,1003,1,325680000,325680000,1501,500,1001,500,0,1,502,3676910,3.67691
5900,5900,500,34810000,2,4006,1003,1,325680000,325680000,1501,500,1001,500,0,1,502,3763753,3.763753
5900,5900,500,34810000,2,4006,1003,1,325680000,325680000,1501,500,1001,500,0,1,502,3614699,3.614699
5900,5900,500,34810000,2,4006,1003,1,325680000,325680000,1501,500,1001,500,0,1,502,3726273,3.726273
5900,5900,500,34810000,2,4006,1003,1,325680000,325680000,1501,500,1001,500,0,1,502,3676243,3.676243
5900,5900,500,34810000,2,4006,1003,1,325680000,325680000,1501,500,1001,500,0,1,502,3652226,3.652226
5900,5900,500,34810000,2,4006,1003,1,325680000,325680000,1501,500,1001,500,0,1,502,3788294,3.788294
5900,5900,900,34810000,2,7206,1803,1,363440000,363440000,2701,900,1801,900,0,1,902,6030914,6.030914
5900,5900,900,34810000,2,7206,1803,1,363440000,363440000,2701,900,1801,900,0,1,902,6305576,6.305576
5900,5900,900,34810000,2,7206,1803,1,363440000,363440000,2701,900,1801,900,0,1,902,6006458,6.006458
5900,5900,900,34810000,2,7206,1803,1,363440000,363440000,2701,900,1801,900,0,1,902,6334536,6.334536
5900,5900,900,34810000,2,7206,1803,1,363440000,363440000,2701,900,1801,900,0,1,902,6121522,6.121522
5900,5900,900,34810000,2,7206,1803,1,363440000,363440000,2701,900,1801,900,0,1,902,6030356,6.030356
5900,5900,900,34810000,2,7206,1803,1,363440000,363440000,2701,900,1801,900,0,1,902,6252169,6.252169
5900,5900,1300,34810000,2,10406,2603,1,401200000,401200000,3901,1300,2601,1300,0,1,1302,8678531,8.678531
5900,5900,1300,34810000,2,10406,2603,1,401200000,401200000,3901,1300,2601,1300,0,1,1302,8984549,8.984549
5900,5900,1300,34810000,2,10406,2603,1,401200000,401200000,3901,1300,2601,1300,0,1,1302,8709914,8.709914
5900,5900,1300,34810000,2,10406,2603,1,401200000,401200000,3901,1300,2601,1300,0,1,1302,9112217,9.112217
5900,5900,1300,34810000,2,10406,2603,1,401200000,401200000,3901,1300,2601,1300,0,1,1302,8770192,8.770192
5900,5900,1300,34810000,2,10406,2603,1,401200000,401200000,3901,1300,2601,1300,0,1,1302,8733382,8.733382
5900,5900,1300,34810000,2,10406,2603,1,401200000,401200000,3901,1300,2601,1300,0,1,1302,8947489,8.947489
5900,5900,1700,34810000,2,13606,3403,1,438960000,438960000,5101,1700,3401,1700,0,1,1702,11246397,11.246397
5900,5900,1700,34810000,2,13606,3403,1,438960000,438960000,5101,1700,3401,1700,0,1,1702,11587058,11.587058
5900,5900,1700,34810000,2,13606,3403,1,438960000,438960000,5101,1700,3401,1700,0,1,1702,11221834,11.221834
5900,5900,1700,34810000,2,13606,3403,1,438960000,438960000,5101,1700,3401,1700,0,1,1702,11646016,11.646016
5900,5900,1700,34810000,2,13606,3403,1,438960000,438960000,5101,1700,3401,1700,0,1,1702,11348199,11.348199
5900,5900,1700,34810000,2,13606,3403,1,438960000,438960000,5101,1700,3401,1700,0,1,1702,11246898,11.246898
5900,5900,1700,34810000,2,13606,3403,1,438960000,438960000,5101,1700,3401,1700,0,1,1702,11610467,11.610467
5900,5900,2100,34810000,2,16806,4203,1,476720000,476720000,6301,2100,4201,2100,0,1,2102,13574802,13.574802
5900,5900,2100,34810000,2,16806,4203,1,476720000,476720000,6301,2100,4201,2100,0,1,2102,14281704,14.281704
5900,5900,2100,34810000,2,16806,4203,1,476720000,476720000,6301,2100,4201,2100,0,1,2102,13630036,13.630036
5900,5900,2100,34810000,2,16806,4203,1,476720000,476720000,6301,2100,4201,2100,0,1,2102,14429363,14.429363
5900,5900,2100,34810000,2,16806,4203,1,476720000,476720000,6301,2100,4201,2100,0,1,2102,13803627,13.803627
5900,5900,2100,34810000,2,16806,4203,1,476720000,476720000,6301,2100,4201,2100,0,1,2102,13606577,13.606577
5900,5900,2100,34810000,2,16806,4203,1,476720000,476720000,6301,2100,4201,2100,0,1,2102,14126565,14.126565
5900,5900,2500,34810000,2,20006,5003,1,514480000,514480000,7501,2500,5001,2500,0,1,2502,16289714,16.289714
5900,5900,2500,34810000,2,20006,5003,1,514480000,514480000,7501,2500,5001,2500,0,1,2502,16982866,16.982866
5900,5900,2500,34810000,2,20006,5003,1,514480000,514480000,7501,2500,5001,2500,0,1,2502,16334753,16.334753
5900,5900,2500,34810000,2,20006,5003,1,514480000,514480000,7501,2500,5001,2500,0,1,2502,17064258,17.064258
5900,5900,2500,34810000,2,20006,5003,1,514480000,514480000,7501,2500,5001,2500,0,1,2502,16449446,16.449446
5900,5900,2500,34810000,2,20006,5003,1,514480000,514480000,7501,2500,5001,2500,0,1,2502,16266099,16.266099
5900,5900,2500,34810000,2,20006,5003,1,514480000,514480000,7501,2500,5001,2500,0,1,2502,16884136,16.884136
5900,5900,2900,34810000,2,23206,5803,1,552240000,552240000,8701,2900,5801,2900,0,1,2902,18850071,18.850071
5900,5900,2900,34810000,2,23206,5803,1,552240000,552240000,8701,2900,5801,2900,0,1,2902,19652588,19.652588
5900,5900,2900,34810000,2,23206,5803,1,552240000,552240000,8701,2900,5801,2900,0,1,2902,18802855,18.802855
5900,5900,2900,34810000,2,23206,5803,1,552240000,552240000,8701,2900,5801,2900,0,1,2902,19769121,19.769121
5900,5900,2900,34810000,2,23206,5803,1,552240000,552240000,8701,2900,5801,2900,0,1,2902,18982474,18.982474
5900,5900,2900,34810000,2,23206,5803,1,552240000,552240000,8701,2900,5801,2900,0,1,2902,18826373,18.826373
5900,5900,2900,34810000,2,23206,5803,1,552240000,552240000,8701,2900,5801,2900,0,1,2902,19506788,19.506788
5900,5900,3300,34810000,2,26406,6603,1,590000000,590000000,9901,3300,6601,3300,0,1,3302,21399664,21.399664
5900,5900,3300,34810000,2,26406,6603,1,590000000,590000000,9901,3300,6601,3300,0,1,3302,22332033,22.332033
5900,5900,3300,34810000,2,26406,6603,1,590000000,590000000,9901,3300,6601,3300,0,1,3302,21375858,21.375858
5900,5900,3300,34810000,2,26406,6603,1,590000000,590000000,9901,3300,6601,3300,0,1,3302,22438334,22.438334
5900,5900,3300,34810000,2,26406,6603,1,590000000,590000000,9901,3300,6601,3300,0,1,3302,21550872,21.550872
5900,5900,3300,34810000,2,26406,6603,1,590000000,590000000,9901,3300,6601,3300,0,1,3302,21352251,21.352251
5900,5900,3300,34810000,2,26406,6603,1,590000000,590000000,9901,3300,6601,3300,0,1,3302,22153834,22.153834
5900,5900,3700,34810000,2,29606,7403,1,627760000,627760000,11101,3700,7401,3700,0,1,3702,23925347,23.925347
5900,5900,3700,34810000,2,29606,7403,1,627760000,627760000,11101,3700,7401,3700,0,1,3702,25018716,25.018716
5900,5900,3700,34810000,2,29606,7403,1,627760000,627760000,11101,3700,7401,3700,0,1,3702,23927014,23.927014
5900,5900,3700,34810000,2,29606,7403,1,627760000,627760000,11101,3700,7401,3700,0,1,3702,25151612,25.151612
5900,5900,3700,34810000,2,29606,7403,1,627760000,627760000,11101,3700,7401,3700,0,1,3702,24085874,24.085874
5900,5900,3700,34810000,2,29606,7403,1,627760000,627760000,11101,3700,7401,3700,0,1,3702,23901564,23.901564
5900,5900,3700,34810000,2,29606,7403,1,627760000,627760000,11101,3700,7401,3700,0,1,3702,24816326,24.816326
5900,5900,4100,34810000,2,32806,8203,1,665520000,665520000,12301,4100,8201,4100,0,1,4102,26509194,26.509194
5900,5900,4100,34810000,2,32806,8203,1,665520000,665520000,12301,4100,8201,4100,0,1,4102,27655400,27.6554
5900,5900,4100,34810000,2,32806,8203,1,665520000,665520000,12301,4100,8201,4100,0,1,4102,26484004,26.484004
5900,5900,4100,34810000,2,32806,8203,1,665520000,665520000,12301,4100,8201,4100,0,1,4102,27863941,27.863941
5900,5900,4100,34810000,2,32806,8203,1,665520000,665520000,12301,4100,8201,4100,0,1,4102,26619490,26.61949
5900,5900,4100,34810000,2,32806,8203,1,665520000,665520000,12301,4100,8201,4100,0,1,4102,26508610,26.50861
5900,5900,4100,34810000,2,32806,8203,1,665520000,665520000,12301,4100,8201,4100,0,1,4102,27456265,27.456265
5900,5900,4500,34810000,2,36006,9003,1,703280000,703280000,13501,4500,9001,4500,0,1,4502,28930127,28.930127
5900,5900,4500,34810000,2,36006,9003,1,703280000,703280000,13501,4500,9001,4500,0,1,4502,30349996,30.349996
5900,5900,4500,34810000,2,36006,9003,1,703280000,703280000,13501,4500,9001,4500,0,1,4502,29056347,29.056347
5900,5900,4500,34810000,2,36006,9003,1,703280000,703280000,13501,4500,9001,4500,0,1,4502,30537823,30.537823
5900,5900,4500,34810000,2,36006,9003,1,703280000,703280000,13501,4500,9001,4500,0,1,4502,29152991,29.152991
5900,5900,4500,34810000,2,36006,9003,1,703280000,703280000,13501,4500,9001,4500,0,1,4502,28971899,28.971899
5900,5900,4500,34810000,2,36006,9003,1,703280000,703280000,13501,4500,9001,4500,0,1,4502,30082825,30.082825
5900,5900,4900,34810000,2,39206,9803,1,741040000,741040000,14701,4900,9801,4900,0,1,4902,31651777,31.651777
5900,5900,4900,34810000,2,39206,9803,1,741040000,741040000,14701,4900,9801,4900,0,1,4902,33112317,33.112317
5900,5900,4900,34810000,2,39206,9803,1,741040000,741040000,14701,4900,9801,4900,0,1,4902,31627917,31.627917
5900,5900,4900,34810000,2,39206,9803,1,741040000,741040000,14701,4900,9801,4900,0,1,4902,33287171,33.287171
5900,5900,4900,34810000,2,39206,9803,1,741040000,741040000,14701,4900,9801,4900,0,1,4902,31768641,31.768641
5900,5900,4900,34810000,2,39206,9803,1,741040000,741040000,14701,4900,9801,4900,0,1,4902,31559243,31.559243
5900,5900,4900,34810000,2,39206,9803,1,741040000,741040000,14701,4900,9801,4900,0,1,4902,32798946,32.798946
5900,5900,5300,34810000,2,42406,10603,1,778800000,778800000,15901,5300,10601,5300,0,1,5302,34178483,34.178483
5900,5900,5300,34810000,2,42406,10603,1,778800000,778800000,15901,5300,10601,5300,0,1,5302,35743006,35.743006
5900,5900,5300,34810000,2,42406,10603,1,778800000,778800000,15901,5300,10601,5300,0,1,5302,34252842,34.252842
5900,5900,5300,34810000,2,42406,10603,1,778800000,778800000,15901,5300,10601,5300,0,1,5302,35993253,35.993253
5900,5900,5300,34810000,2,42406,10603,1,778800000,778800000,15901,5300,10601,5300,0,1,5302,34398225,34.398225
5900,5900,5300,34810000,2,42406,10603,1,778800000,778800000,15901,5300,10601,5300,0,1,5302,34133967,34.133967
5900,5900,5300,34810000,2,42406,10603,1,778800000,778800000,15901,5300,10601,5300,0,1,5302,35407882,35.407882
5900,5900,5700,34810000,2,45606,11403,1,816560000,816560000,17101,5700,11401,5700,0,1,5702,36701359,36.701359
5900,5900,5700,34810000,2,45606,11403,1,816560000,816560000,17101,5700,11401,5700,0,1,5702,38390846,38.390846
5900,5900,5700,34810000,2,45606,11403,1,816560000,816560000,17101,5700,11401,5700,0,1,5702,36763852,36.763852
5900,5900,5700,34810000,2,45606,11403,1,816560000,816560000,17101,5700,11401,5700,0,1,5702,38630375,38.630375
5900,5900,5700,34810000,2,45606,11403,1,816560000,816560000,17101,5700,11401,5700,0,1,5702,36997898,36.997898
5900,5900,5700,34810000,2,45606,11403,1,816560000,816560000,17101,5700,11401,5700,0,1,5702,36675658,36.675658
5900,5900,5700,34810000,2,45606,11403,1,816560000,816560000,17101,5700,11401,5700,0,1,5702,38120577,38.120577
5900,5900,6100,34810000,2,48806,12203,1,854320000,854320000,18301,6100,12201,6100,0,1,6102,39246296,39.246296
5900,5900,6100,34810000,2,48806,12203,1,854320000,854320000,18301,6100,12201,6100,0,1,6102,41163191,41.163191
5900,5900,6100,34810000,2,48806,12203,1,854320000,854320000,18301,6100,12201,6100,0,1,6102,39381518,39.381518
5900,5900,6100,34810000,2,48806,12203,1,854320000,854320000,18301,6100,12201,6100,0,1,6102,41374517,41.374517
5900,5900,6100,34810000,2,48806,12203,1,854320000,854320000,18301,6100,12201,6100,0,1,6102,39605869,39.605869
5900,5900,6100,34810000,2,48806,12203,1,854320000,854320000,18301,6100,12201,6100,0,1,6102,39333897,39.333897
5900,5900,6100,34810000,2,48806,12203,1,854320000,854320000,18301,6100,12201,6100,0,1,6102,40671062,40.671062
5900,5900,6500,34810000,2,52006,13003,1,892080000,892080000,19501,6500,13001,6500,0,1,6502,41756587,41.756587
5900,5900,6500,34810000,2,52006,13003,1,892080000,892080000,19501,6500,13001,6500,0,1,6502,43879582,43.879582
5900,5900,6500,34810000,2,52006,13003,1,892080000,892080000,19501,6500,13001,6500,0,1,6502,41923958,41.923958
5900,5900,6500,34810000,2,52006,13003,1,892080000,892080000,19501,6500,13001,6500,0,1,6502,44038219,44.038219
5900,5900,6500,34810000,2,52006,13003,1,892080000,892080000,19501,6500,13001,6500,0,1,6502,42151221,42.151221
5900,5900,6500,34810000,2,52006,13003,1,892080000,892080000,19501,6500,13001,6500,0,1,6502,41874924,41.874924
5900,5900,6500,34810000,2,52006,13003,1,892080000,892080000,19501,6500,13001,6500,0,1,6502,43301389,43.301389
5900,5900,6900,34810000,2,55206,13803,1,929840000,929840000,20701,6900,13801,6900,0,1,6902,44362698,44.362698
5900,5900,6900,34810000,2,55206,13803,1,929840000,929840000,20701,6900,13801,6900,0,1,6902,46701520,46.70152
5900,5900,6900,34810000,2,55206,13803,1,929840000,929840000,20701,6900,13801,6900,0,1,6902,44678190,44.67819
5900,5900,6900,34810000,2,55206,13803,1,929840000,929840000,20701,6900,13801,6900,0,1,6902,46758908,46.758908
5900,5900,6900,34810000,2,55206,13803,1,929840000,929840000,20701,6900,13801,6900,0,1,6902,44807313,44.807313
5900,5900,6900,34810000,2,55206,13803,1,929840000,929840000,20701,6900,13801,6900,0,1,6902,44476870,44.47687
5900,5900,6900,34810000,2,55206,13803,1,929840000,929840000,20701,6900,13801,6900,0,1,6902,46123010,46.12301
5900,5500,500,32450000,2,4006,1003,1,305200000,305200000,1501,500,1001,500,0,1,502,3414164,3.414164
5900,5500,500,32450000,2,4006,1003,1,305200000,305200000,1501,500,1001,500,0,1,502,3503042,3.503042
5900,5500,500,32450000,2,4006,1003,1,305200000,305200000,1501,500,1001,500,0,1,502,3436963,3.436963
5900,5500,500,32450000,2,4006,1003,1,305200000,305200000,1501,500,1001,500,0,1,502,3585968,3.585968
5900,5500,500,32450000,2,4006,1003,1,305200000,305200000,1501,500,1001,500,0,1,502,3503543,3.503543
5900,5500,500,32450000,2,4006,1003,1,305200000,305200000,1501,500,1001,500,0,1,502,3537650,3.53765
5900,5500,500,32450000,2,4006,1003,1,305200000,305200000,1501,500,1001,500,0,1,502,3562599,3.562599
5900,5500,900,32450000,2,7206,1803,1,341680000,341680000,2701,900,1801,900,0,1,902,5601506,5.601506
5900,5500,900,32450000,2,7206,1803,1,341680000,341680000,2701,900,1801,900,0,1,902,5880126,5.880126
5900,5500,900,32450000,2,7206,1803,1,341680000,341680000,2701,900,1801,900,0,1,902,5623451,5.623451
5900,5500,900,32450000,2,7206,1803,1,341680000,341680000,2701,900,1801,900,0,1,902,5906906,5.906906
5900,5500,900,32450000,2,7206,1803,1,341680000,341680000,2701,900,1801,900,0,1,902,5717638,5.717638
5900,5500,900,32450000,2,7206,1803,1,341680000,341680000,2701,900,1801,900,0,1,902,5663650,5.66365
5900,5500,900,32450000,2,7206,1803,1,341680000,341680000,2701,900,1801,900,0,1,902,5852864,5.852864
5900,5500,1300,32450000,2,10406,2603,1,378160000,378160000,3901,1300,2601,1300,0,1,1302,8121573,8.121573
5900,5500,1300,32450000,2,10406,2603,1,378160000,378160000,3901,1300,2601,1300,0,1,1302,8432498,8.432498
5900,5500,1300,32450000,2,10406,2603,1,378160000,378160000,3901,1300,2601,1300,0,1,1302,8148776,8.148776
5900,5500,1300,32450000,2,10406,2603,1,378160000,378160000,3901,1300,2601,1300,0,1,1302,8524411,8.524411
5900,5500,1300,32450000,2,10406,2603,1,378160000,378160000,3901,1300,2601,1300,0,1,1302,8251651,8.251651
5900,5500,1300,32450000,2,10406,2603,1,378160000,378160000,3901,1300,2601,1300,0,1,1302,8170828,8.170828
5900,5500,1300,32450000,2,10406,2603,1,378160000,378160000,3901,1300,2601,1300,0,1,1302,8407807,8.407807
5900,5500,1700,32450000,2,13606,3403,1,414640000,414640000,5101,1700,3401,1700,0,1,1702,10365197,10.365197
5900,5500,1700,32450000,2,13606,3403,1,414640000,414640000,5101,1700,3401,1700,0,1,1702,10775322,10.775322
5900,5500,1700,32450000,2,13606,3403,1,414640000,414640000,5101,1700,3401,1700,0,1,1702,10387181,10.387181
5900,5500,1700,32450000,2,13606,3403,1,414640000,414640000,5101,1700,3401,1700,0,1,1702,10883842,10.883842
5900,5500,1700,32450000,2,13606,3403,1,414640000,414640000,5101,1700,3401,1700,0,1,1702,10525464,10.525464
5900,5500,1700,32450000,2,13606,3403,1,414640000,414640000,5101,1700,3401,1700,0,1,1702,10415491,10.415491
5900,5500,1700,32450000,2,13606,3403,1,414640000,414640000,5101,1700,3401,1700,0,1,1702,10750998,10.750998
5900,5500,2100,32450000,2,16806,4203,1,451120000,451120000,6301,2100,4201,2100,0,1,2102,12825797,12.825797
5900,5500,2100,32450000,2,16806,4203,1,451120000,451120000,6301,2100,4201,2100,0,1,2102,13358636,13.358636
5900,5500,2100,32450000,2,16806,4203,1,451120000,451120000,6301,2100,4201,2100,0,1,2102,12860248,12.860248
5900,5500,2100,32450000,2,16806,4203,1,451120000,451120000,6301,2100,4201,2100,0,1,2102,13486673,13.486673
5900,5500,2100,32450000,2,16806,4203,1,451120000,451120000,6301,2100,4201,2100,0,1,2102,13008215,13.008215
5900,5500,2100,32450000,2,16806,4203,1,451120000,451120000,6301,2100,4201,2100,0,1,2102,12911944,12.911944
5900,5500,2100,32450000,2,16806,4203,1,451120000,451120000,6301,2100,4201,2100,0,1,2102,13295767,13.295767
5900,5500,2500,32450000,2,20006,5003,1,487600000,487600000,7501,2500,5001,2500,0,1,2502,15241051,15.241051
5900,5500,2500,32450000,2,20006,5003,1,487600000,487600000,7501,2500,5001,2500,0,1,2502,15808994,15.808994
5900,5500,2500,32450000,2,20006,5003,1,487600000,487600000,7501,2500,5001,2500,0,1,2502,15200127,15.200127
5900,5500,2500,32450000,2,20006,5003,1,487600000,487600000,7501,2500,5001,2500,0,1,2502,15967346,15.967346
5900,5500,2500,32450000,2,20006,5003,1,487600000,487600000,7501,2500,5001,2500,0,1,2502,15361209,15.361209
5900,5500,2500,32450000,2,20006,5003,1,487600000,487600000,7501,2500,5001,2500,0,1,2502,15262976,15.262976
5900,5500,2500,32450000,2,20006,5003,1,487600000,487600000,7501,2500,5001,2500,0,1,2502,15773615,15.773615
5900,5500,2900,32450000,2,23206,5803,1,524080000,524080000,8701,2900,5801,2900,0,1,2902,17519813,17.519813
5900,5500,2900,32450000,2,23206,5803,1,524080000,524080000,8701,2900,5801,2900,0,1,2902,18373006,18.373006
5900,5500,2900,32450000,2,23206,5803,1,524080000,524080000,8701,2900,5801,2900,0,1,2902,17564636,17.564636
5900,5500,2900,32450000,2,23206,5803,1,524080000,524080000,8701,2900,5801,2900,0,1,2902,18470669,18.470669
5900,5500,2900,32450000,2,23206,5803,1,524080000,524080000,8701,2900,5801,2900,0,1,2902,17770805,17.770805
5900,5500,2900,32450000,2,23206,5803,1,524080000,524080000,8701,2900,5801,2900,0,1,2902,17636875,17.636875
5900,5500,2900,32450000,2,23206,5803,1,524080000,524080000,8701,2900,5801,2900,0,1,2902,18202562,18.202562
5900,5500,3300,32450000,2,26406,6603,1,560560000,560560000,9901,3300,6601,3300,0,1,3302,19929032,19.929032
5900,5500,3300,32450000,2,26406,6603,1,560560000,560560000,9901,3300,6601,3300,0,1,3302,20854661,20.854661
5900,5500,3300,32450000,2,26406,6603,1,560560000,560560000,9901,3300,6601,3300,0,1,3302,19977112,19.977112
5900,5500,3300,32450000,2,26406,6603,1,560560000,560560000,9901,3300,6601,3300,0,1,3302,21003307,21.003307
5900,5500,3300,32450000,2,26406,6603,1,560560000,560560000,9901,3300,6601,3300,0,1,3302,20218314,20.218314
5900,5500,3300,32450000,2,26406,6603,1,560560000,560560000,9901,3300,6601,3300,0,1,3302,20138344,20.138344
5900,5500,3300,32450000,2,26406,6603,1,560560000,560560000,9901,3300,6601,3300,0,1,3302,20760484,20.760484
5900,5500,3700,32450000,2,29606,7403,1,597040000,597040000,11101,3700,7401,3700,0,1,3702,22395693,22.395693
5900,5500,3700,32450000,2,29606,7403,1,597040000,597040000,11101,3700,7401,3700,0,1,3702,23333281,23.333281
5900,5500,3700,32450000,2,29606,7403,1,597040000,597040000,11101,3700,7401,3700,0,1,3702,22355044,22.355044
5900,5500,3700,32450000,2,29606,7403,1,597040000,597040000,11101,3700,7401,3700,0,1,3702,23500816,23.500816
5900,5500,3700,32450000,2,29606,7403,1,597040000,597040000,11101,3700,7401,3700,0,1,3702,22565829,22.565829
5900,5500,3700,32450000,2,29606,7403,1,597040000,597040000,11101,3700,7401,3700,0,1,3702,22431152,22.431152
5900,5500,3700,32450000,2,29606,7403,1,597040000,597040000,11101,3700,7401,3700,0,1,3702,23163260,23.16326
5900,5500,4100,32450000,2,32806,8203,1,633520000,633520000,12301,4100,8201,4100,0,1,4102,24635785,24.635785
5900,5500,4100,32450000,2,32806,8203,1,633520000,633520000,12301,4100,8201,4100,0,1,4102,25760195,25.760195
5900,5500,4100,32450000,2,32806,8203,1,633520000,633520000,12301,4100,8201,4100,0,1,4102,24703140,24.70314
5900,5500,4100,32450000,2,32806,8203,1,633520000,633520000,12301,4100,8201,4100,0,1,4102,25984032,25.984032
5900,5500,4100,32450000,2,32806,8203,1,633520000,633520000,12301,4100,8201,4100,0,1,4102,24869020,24.86902
5900,5500,4100,32450000,2,32806,8203,1,633520000,633520000,12301,4100,8201,4100,0,1,4102,24742708,24.742708
5900,5500,4100,32450000,2,32806,8203,1,633520000,633520000,12301,4100,8201,4100,0,1,4102,25610799,25.610799
5900,5500,4500,32450000,2,36006,9003,1,670000000,670000000,13501,4500,9001,4500,0,1,4502,27063311,27.063311
5900,5500,4500,32450000,2,36006,9003,1,670000000,670000000,13501,4500,9001,4500,0,1,4502,28300021,28.300021
5900,5500,4500,32450000,2,36006,9003,1,670000000,670000000,13501,4500,9001,4500,0,1,4502,27085627,27.085627
5900,5500,4500,32450000,2,36006,9003,1,670000000,670000000,13501,4500,9001,4500,0,1,4502,28532354,28.532354
5900,5500,4500,32450000,2,36006,9003,1,670000000,670000000,13501,4500,9001,4500,0,1,4502,27336444,27.336444
5900,5500,4500,32450000,2,36006,9003,1,670000000,670000000,13501,4500,9001,4500,0,1,4502,27167898,27.167898
5900,5500,4500,32450000,2,36006,9003,1,670000000,670000000,13501,4500,9001,4500,0,1,4502,28105672,28.105672
5900,5500,4900,32450000,2,39206,9803,1,706480000,706480000,14701,4900,9801,4900,0,1,4902,29422601,29.422601
5900,5500,4900,32450000,2,39206,9803,1,706480000,706480000,14701,4900,9801,4900,0,1,4902,30822953,30.822953
5900,5500,4900,32450000,2,39206,9803,1,706480000,706480000,14701,4900,9801,4900,0,1,4902,29462573,29.462573
5900,5500,4900,32450000,2,39206,9803,1,706480000,706480000,14701,4900,9801,4900,0,1,4902,30985270,30.98527
5900,5500,4900,32450000,2,39206,9803,1,706480000,706480000,14701,4900,9801,4900,0,1,4902,29686387,29.686387
5900,5500,4900,32450000,2,39206,9803,1,706480000,706480000,14701,4900,9801,4900,0,1,4902,29522636,29.522636
5900,5500,4900,32450000,2,39206,9803,1,706480000,706480000,14701,4900,9801,4900,0,1,4902,30562279,30.562279
5900,5500,5300,32450000,2,42406,10603,1,742960000,742960000,15901,5300,10601,5300,0,1,5302,31827576,31.827576
5900,5500,5300,32450000,2,42406,10603,1,742960000,742960000,15901,5300,10601,5300,0,1,5302,33407917,33.407917
5900,5500,5300,32450000,2,42406,10603,1,742960000,742960000,15901,5300,10601,5300,0,1,5302,31979433,31.979433
5900,5500,5300,32450000,2,42406,10603,1,742960000,742960000,15901,5300,10601,5300,0,1,5302,33610351,33.610351
5900,5500,5300,32450000,2,42406,10603,1,742960000,742960000,15901,5300,10601,5300,0,1,5302,32078099,32.078099
5900,5500,5300,32450000,2,42406,10603,1,742960000,742960000,15901,5300,10601,5300,0,1,5302,31957335,31.957335
5900,5500,5300,32450000,2,42406,10603,1,742960000,742960000,15901,5300,10601,5300,0,1,5302,33076997,33.076997
5900,5500,5700,32450000,2,45606,11403,1,779440000,779440000,17101,5700,11401,5700,0,1,5702,34198715,34.198715
5900,5500,5700,32450000,2,45606,11403,1,779440000,779440000,17101,5700,11401,5700,0,1,5702,35906515,35.906515
5900,5500,5700,32450000,2,45606,11403,1,779440000,779440000,17101,5700,11401,5700,0,1,5702,34286937,34.286937
5900,5500,5700,32450000,2,45606,11403,1,779440000,779440000,17101,5700,11401,5700,0,1,5702,36175304,36.175304
5900,5500,5700,32450000,2,45606,11403,1,779440000,779440000,17101,5700,11401,5700,0,1,5702,34635115,34.635115
5900,5500,5700,32450000,2,45606,11403,1,779440000,779440000,17101,5700,11401,5700,0,1,5702,34442690,34.44269
5900,5500,5700,32450000,2,45606,11403,1,779440000,779440000,17101,5700,11401,5700,0,1,5702,35633284,35.633284
5900,5500,6100,32450000,2,48806,12203,1,815920000,815920000,18301,6100,12201,6100,0,1,6102,36593888,36.593888
5900,5500,6100,32450000,2,48806,12203,1,815920000,815920000,18301,6100,12201,6100,0,1,6102,38487572,38.487572
5900,5500,6100,32450000,2,48806,12203,1,815920000,815920000,18301,6100,12201,6100,0,1,6102,36651813,36.651813
5900,5500,6100,32450000,2,48806,12203,1,815920000,815920000,18301,6100,12201,6100,0,1,6102,38641470,38.64147
5900,5500,6100,32450000,2,48806,12203,1,815920000,815920000,18301,6100,12201,6100,0,1,6102,36969069,36.969069
5900,5500,6100,32450000,2,48806,12203,1,815920000,815920000,18301,6100,12201,6100,0,1,6102,36752064,36.752064
5900,5500,6100,32450000,2,48806,12203,1,815920000,815920000,18301,6100,12201,6100,0,1,6102,38034784,38.034784
5900,5500,6500,32450000,2,52006,13003,1,852400000,852400000,19501,6500,13001,6500,0,1,6502,39087945,39.087945
5900,5500,6500,32450000,2,52006,13003,1,852400000,852400000,19501,6500,13001,6500,0,1,6502,40981747,40.981747
5900,5500,6500,32450000,2,52006,13003,1,852400000,852400000,19501,6500,13001,6500,0,1,6502,39062020,39.06202
5900,5500,6500,32450000,2,52006,13003,1,852400000,852400000,19501,6500,13001,6500,0,1,6502,41140373,41.140373
5900,5500,6500,32450000,2,52006,13003,1,852400000,852400000,19501,6500,13001,6500,0,1,6502,39378197,39.378197
5900,5500,6500,32450000,2,52006,13003,1,852400000,852400000,19501,6500,13001,6500,0,1,6502,39144405,39.144405
5900,5500,6500,32450000,2,52006,13003,1,852400000,852400000,19501,6500,13001,6500,0,1,6502,40343824,40.343824
5900,5500,6900,32450000,2,55206,13803,1,888880000,888880000,20701,6900,13801,6900,0,1,6902,41411321,41.411321
5900,5500,6900,32450000,2,55206,13803,1,888880000,888880000,20701,6900,13801,6900,0,1,6902,43463809,43.463809
5900,5500,6900,32450000,2,55206,13803,1,888880000,888880000,20701,6900,13801,6900,0,1,6902,41572926,41.572926
5900,5500,6900,32450000,2,55206,13803,1,888880000,888880000,20701,6900,13801,6900,0,1,6902,43730510,43.73051
5900,5500,6900,32450000,2,55206,13803,1,888880000,888880000,20701,6900,13801,6900,0,1,6902,41772452,41.772452
5900,5500,6900,32450000,2,55206,13803,1,888880000,888880000,20701,6900,13801,6900,0,1,6902,41520612,41.520612
5900,5500,6900,32450000,2,55206,13803,1,888880000,888880000,20701,6900,13801,6900,0,1,6902,43019983,43.019983
5900,5100,500,30090000,2,4006,1003,1,284720000,284720000,1501,500,1001,500,0,1,502,3215471,3.215471
5900,5100,500,30090000,2,4006,1003,1,284720000,284720000,1501,500,1001,500,0,1,502,3257950,3.25795
5900,5100,500,30090000,2,4006,1003,1,284720000,284720000,1501,500,1001,500,0,1,502,3151720,3.15172
5900,5100,500,30090000,2,4006,1003,1,284720000,284720000,1501,500,1001,500,0,1,502,3320944,3.320944
5900,5100,500,30090000,2,4006,1003,1,284720000,284720000,1501,500,1001,500,0,1,502,3192066,3.192066
5900,5100,500,30090000,2,4006,1003,1,284720000,284720000,1501,500,1001,500,0,1,502,3278229,3.278229
5900,5100,500,30090000,2,4006,1003,1,284720000,284720000,1501,500,1001,500,0,1,502,3299589,3.299589
5900,5100,900,30090000,2,7206,1803,1,319920000,319920000,2701,900,1801,900,0,1,902,5204482,5.204482
5900,5100,900,30090000,2,7206,1803,1,319920000,319920000,2701,900,1801,900,0,1,902,5429682,5.429682
5900,5100,900,30090000,2,7206,1803,1,319920000,319920000,2701,900,1801,900,0,1,902,5224913,5.224913
5900,5100,900,30090000,2,7206,1803,1,319920000,319920000,2701,900,1801,900,0,1,902,5479810,5.47981
5900,5100,900,30090000,2,7206,1803,1,319920000,319920000,2701,900,1801,900,0,1,902,5245688,5.245688
5900,5100,900,30090000,2,7206,1803,1,319920000,319920000,2701,900,1801,900,0,1,902,5265942,5.265942
5900,5100,900,30090000,2,7206,1803,1,319920000,319920000,2701,900,1801,900,0,1,902,5450893,5.450893
5900,5100,1300,30090000,2,10406,2603,1,355120000,355120000,3901,1300,2601,1300,0,1,1302,7554191,7.554191
5900,5100,1300,30090000,2,10406,2603,1,355120000,355120000,3901,1300,2601,1300,0,1,1302,7827939,7.827939
5900,5100,1300,30090000,2,10406,2603,1,355120000,355120000,3901,1300,2601,1300,0,1,1302,7510014,7.510014
5900,5100,1300,30090000,2,10406,2603,1,355120000,355120000,3901,1300,2601,1300,0,1,1302,7897657,7.897657
5900,5100,1300,30090000,2,10406,2603,1,355120000,355120000,3901,1300,2601,1300,0,1,1302,7575198,7.575198
5900,5100,1300,30090000,2,10406,2603,1,355120000,355120000,3901,1300,2601,1300,0,1,1302,7599954,7.599954
5900,5100,1300,30090000,2,10406,2603,1,355120000,355120000,3901,1300,2601,1300,0,1,1302,7849135,7.849135
5900,5100,1700,30090000,2,13606,3403,1,390320000,390320000,5101,1700,3401,1700,0,1,1702,9538658,9.538658
5900,5100,1700,30090000,2,13606,3403,1,390320000,390320000,5101,1700,3401,1700,0,1,1702,10029618,10.029618
5900,5100,1700,30090000,2,13606,3403,1,390320000,390320000,5101,1700,3401,1700,0,1,1702,9567361,9.567361
5900,5100,1700,30090000,2,13606,3403,1,390320000,390320000,5101,1700,3401,1700,0,1,1702,10084983,10.084983
5900,5100,1700,30090000,2,13606,3403,1,390320000,390320000,5101,1700,3401,1700,0,1,1702,9718042,9.718042
5900,5100,1700,30090000,2,13606,3403,1,390320000,390320000,5101,1700,3401,1700,0,1,1702,9663204,9.663204
5900,5100,1700,30090000,2,13606,3403,1,390320000,390320000,5101,1700,3401,1700,0,1,1702,9975502,9.975502
5900,5100,2100,30090000,2,16806,4203,1,425520000,425520000,6301,2100,4201,2100,0,1,2102,11907423,11.907423
5900,5100,2100,30090000,2,16806,4203,1,425520000,425520000,6301,2100,4201,2100,0,1,2102,12376570,12.37657
5900,5100,2100,30090000,2,16806,4203,1,425520000,425520000,6301,2100,4201,2100,0,1,2102,11927846,11.927846
5900,5100,2100,30090000,2,16806,4203,1,425520000,425520000,6301,2100,4201,2100,0,1,2102,12480093,12.480093
5900,5100,2100,30090000,2,16806,4203,1,425520000,425520000,6301,2100,4201,2100,0,1,2102,12021654,12.021654
5900,5100,2100,30090000,2,16806,4203,1,425520000,425520000,6301,2100,4201,2100,0,1,2102,12000179,12.000179
5900,5100,2100,30090000,2,16806,4203,1,425520000,425520000,6301,2100,4201,2100,0,1,2102,12346603,12.346603
5900,5100,2500,30090000,2,20006,5003,1,460720000,460720000,7501,2500,5001,2500,0,1,2502,14102663,14.102663
5900,5100,2500,30090000,2,20006,5003,1,460720000,460720000,7501,2500,5001,2500,0,1,2502,14704137,14.704137
5900,5100,2500,30090000,2,20006,5003,1,460720000,460720000,7501,2500,5001,2500,0,1,2502,14103309,14.103309
5900,5100,2500,30090000,2,20006,5003,1,460720000,460720000,7501,2500,5001,2500,0,1,2502,14801266,14.801266
5900,5100,2500,30090000,2,20006,5003,1,460720000,460720000,7501,2500,5001,2500,0,1,2502,14146587,14.146587
5900,5100,2500,30090000,2,20006,5003,1,460720000,460720000,7501,2500,5001,2500,0,1,2502,14192749,14.192749
5900,5100,2500,30090000,2,20006,5003,1,460720000,460720000,7501,2500,5001,2500,0,1,2502,14629793,14.629793
5900,5100,2900,30090000,2,23206,5803,1,495920000,495920000,8701,2900,5801,2900,0,1,2902,16283129,16.283129
5900,5100,2900,30090000,2,23206,5803,1,495920000,495920000,8701,2900,5801,2900,0,1,2902,17007321,17.007321
5900,5100,2900,30090000,2,23206,5803,1,495920000,495920000,8701,2900,5801,2900,0,1,2902,16305083,16.305083
5900,5100,2900,30090000,2,23206,5803,1,495920000,495920000,8701,2900,5801,2900,0,1,2902,17138981,17.138981
5900,5100,2900,30090000,2,23206,5803,1,495920000,495920000,8701,2900,5801,2900,0,1,2902,16398010,16.39801
5900,5100,2900,30090000,2,23206,5803,1,495920000,495920000,8701,2900,5801,2900,0,1,2902,16378021,16.378021
5900,5100,2900,30090000,2,23206,5803,1,495920000,495920000,8701,2900,5801,2900,0,1,2902,16904240,16.90424
5900,5100,3300,30090000,2,26406,6603,1,531120000,531120000,9901,3300,6601,3300,0,1,3302,18444775,18.444775
5900,5100,3300,30090000,2,26406,6603,1,531120000,531120000,9901,3300,6601,3300,0,1,3302,19288202,19.288202
5900,5100,3300,30090000,2,26406,6603,1,531120000,531120000,9901,3300,6601,3300,0,1,3302,18542790,18.54279
5900,5100,3300,30090000,2,26406,6603,1,531120000,531120000,9901,3300,6601,3300,0,1,3302,19424138,19.424138
5900,5100,3300,30090000,2,26406,6603,1,531120000,531120000,9901,3300,6601,3300,0,1,3302,18574948,18.574948
5900,5100,3300,30090000,2,26406,6603,1,531120000,531120000,9901,3300,6601,3300,0,1,3302,18595212,18.595212
5900,5100,3300,30090000,2,26406,6603,1,531120000,531120000,9901,3300,6601,3300,0,1,3302,19178278,19.178278
5900,5100,3700,30090000,2,29606,7403,1,566320000,566320000,11101,3700,7401,3700,0,1,3702,20676605,20.676605
5900,5100,3700,30090000,2,29606,7403,1,566320000,566320000,11101,3700,7401,3700,0,1,3702,21610895,21.610895
5900,5100,3700,30090000,2,29606,7403,1,566320000,566320000,11101,3700,7401,3700,0,1,3702,20728567,20.728567
5900,5100,3700,30090000,2,29606,7403,1,566320000,566320000,11101,3700,7401,3700,0,1,3702,21744286,21.744286
5900,5100,3700,30090000,2,29606,7403,1,566320000,566320000,11101,3700,7401,3700,0,1,3702,20808983,20.808983
5900,5100,3700,30090000,2,29606,7403,1,566320000,566320000,11101,3700,7401,3700,0,1,3702,20787912,20.787912
5900,5100,3700,30090000,2,29606,7403,1,566320000,566320000,11101,3700,7401,3700,0,1,3702,21463468,21.463468
5900,5100,4100,30090000,2,32806,8203,1,601520000,601520000,12301,4100,8201,4100,0,1,4102,22909718,22.909718
5900,5100,4100,30090000,2,32806,8203,1,601520000,601520000,12301,4100,8201,4100,0,1,4102,23895252,23.895252
5900,5100,4100,30090000,2,32806,8203,1,601520000,601520000,12301,4100,8201,4100,0,1,4102,22930264,22.930264
5900,5100,4100,30090000,2,32806,8203,1,601520000,601520000,12301,4100,8201,4100,0,1,4102,24088582,24.088582
5900,5100,4100,30090000,2,32806,8203,1,601520000,601520000,12301,4100,8201,4100,0,1,4102,22952405,22.952405
5900,5100,4100,30090000,2,32806,8203,1,601520000,601520000,12301,4100,8201,4100,0,1,4102,22952978,22.952978
5900,5100,4100,30090000,2,32806,8203,1,601520000,601520000,12301,4100,8201,4100,0,1,4102,23726571,23.726571
5900,5100,4500,30090000,2,36006,9003,1,636720000,636720000,13501,4500,9001,4500,0,1,4502,25067194,25.067194
5900,5100,4500,30090000,2,36006,9003,1,636720000,636720000,13501,4500,9001,4500,0,1,4502,26230938,26.230938
5900,5100,4500,30090000,2,36006,9003,1,636720000,636720000,13501,4500,9001,4500,0,1,4502,25127375,25.127375
5900,5100,4500,30090000,2,36006,9003,1,636720000,636720000,13501,4500,9001,4500,0,1,4502,26377087,26.377087
5900,5100,4500,30090000,2,36006,9003,1,636720000,636720000,13501,4500,9001,4500,0,1,4502,25218440,25.21844
5900,5100,4500,30090000,2,36006,9003,1,636720000,636720000,13501,4500,9001,4500,0,1,4502,25169812,25.169812
5900,5100,4500,30090000,2,36006,9003,1,636720000,636720000,13501,4500,9001,4500,0,1,4502,26049234,26.049234
5900,5100,4900,30090000,2,39206,9803,1,671920000,671920000,14701,4900,9801,4900,0,1,4902,27263128,27.263128
5900,5100,4900,30090000,2,39206,9803,1,671920000,671920000,14701,4900,9801,4900,0,1,4902,28525367,28.525367
5900,5100,4900,30090000,2,39206,9803,1,671920000,671920000,14701,4900,9801,4900,0,1,4902,27352406,27.352406
5900,5100,4900,30090000,2,39206,9803,1,671920000,671920000,14701,4900,9801,4900,0,1,4902,28708464,28.708464
5900,5100,4900,30090000,2,39206,9803,1,671920000,671920000,14701,4900,9801,4900,0,1,4902,27427318,27.427318
5900,5100,4900,30090000,2,39206,9803,1,671920000,671920000,14701,4900,9801,4900,0,1,4902,27389653,27.389653
5900,5100,4900,30090000,2,39206,9803,1,671920000,671920000,14701,4900,9801,4900,0,1,4902,28304512,28.304512
5900,5100,5300,30090000,2,42406,10603,1,707120000,707120000,15901,5300,10601,5300,0,1,5302,29512926,29.512926
5900,5100,5300,30090000,2,42406,10603,1,707120000,707120000,15901,5300,10601,5300,0,1,5302,30925657,30.925657
5900,5100,5300,30090000,2,42406,10603,1,707120000,707120000,15901,5300,10601,5300,0,1,5302,29551350,29.55135
5900,5100,5300,30090000,2,42406,10603,1,707120000,707120000,15901,5300,10601,5300,0,1,5302,31030806,31.030806
5900,5100,5300,30090000,2,42406,10603,1,707120000,707120000,15901,5300,10601,5300,0,1,5302,29659911,29.659911
5900,5100,5300,30090000,2,42406,10603,1,707120000,707120000,15901,5300,10601,5300,0,1,5302,29620541,29.620541
5900,5100,5300,30090000,2,42406,10603,1,707120000,707120000,15901,5300,10601,5300,0,1,5302,30625795,30.625795
5900,5100,5700,30090000,2,45606,11403,1,742320000,742320000,17101,5700,11401,5700,0,1,5702,31697422,31.697422
5900,5100,5700,30090000,2,45606,11403,1,742320000,742320000,17101,5700,11401,5700,0,1,5702,33258034,33.258034
5900,5100,5700,30090000,2,45606,11403,1,742320000,742320000,17101,5700,11401,5700,0,1,5702,31787285,31.787285
5900,5100,5700,30090000,2,45606,11403,1,742320000,742320000,17101,5700,11401,5700,0,1,5702,33405095,33.405095
5900,5100,5700,30090000,2,45606,11403,1,742320000,742320000,17101,5700,11401,5700,0,1,5702,31891618,31.891618
5900,5100,5700,30090000,2,45606,11403,1,742320000,742320000,17101,5700,11401,5700,0,1,5702,31845039,31.845039
5900,5100,5700,30090000,2,45606,11403,1,742320000,742320000,17101,5700,11401,5700,0,1,5702,32943626,32.943626
5900,5100,6100,30090000,2,48806,12203,1,777520000,777520000,18301,6100,12201,6100,0,1,6102,33956702,33.956702
5900,5100,6100,30090000,2,48806,12203,1,777520000,777520000,18301,6100,12201,6100,0,1,6102,35598239,35.598239
5900,5100,6100,30090000,2,48806,12203,1,777520000,777520000,18301,6100,12201,6100,0,1,6102,34045989,34.045989
5900,5100,6100,30090000,2,48806,12203,1,777520000,777520000,18301,6100,12201,6100,0,1,6102,35765308,35.765308
5900,5100,6100,30090000,2,48806,12203,1,777520000,777520000,18301,6100,12201,6100,0,1,6102,34244338,34.244338
5900,5100,6100,30090000,2,48806,12203,1,777520000,777520000,18301,6100,12201,6100,0,1,6102,34004910,34.00491
5900,5100,6100,30090000,2,48806,12203,1,777520000,777520000,18301,6100,12201,6100,0,1,6102,35201827,35.201827
5900,5100,6500,30090000,2,52006,13003,1,812720000,812720000,19501,6500,13001,6500,0,1,6502,36120775,36.120775
5900,5100,6500,30090000,2,52006,13003,1,812720000,812720000,19501,6500,13001,6500,0,1,6502,37956583,37.956583
5900,5100,6500,30090000,2,52006,13003,1,812720000,812720000,19501,6500,13001,6500,0,1,6502,36341575,36.341575
5900,5100,6500,30090000,2,52006,13003,1,812720000,812720000,19501,6500,13001,6500,0,1,6502,38122542,38.122542
5900,5100,6500,30090000,2,52006,13003,1,812720000,812720000,19501,6500,13001,6500,0,1,6502,36384712,36.384712
5900,5100,6500,30090000,2,52006,13003,1,812720000,812720000,19501,6500,13001,6500,0,1,6502,36318765,36.318765
5900,5100,6500,30090000,2,52006,13003,1,812720000,812720000,19501,6500,13001,6500,0,1,6502,37613256,37.613256
5900,5100,6900,30090000,2,55206,13803,1,847920000,847920000,20701,6900,13801,6900,0,1,6902,38437081,38.437081
5900,5100,6900,30090000,2,55206,13803,1,847920000,847920000,20701,6900,13801,6900,0,1,6902,40336416,40.336416
5900,5100,6900,30090000,2,55206,13803,1,847920000,847920000,20701,6900,13801,6900,0,1,6902,38515859,38.515859
5900,5100,6900,30090000,2,55206,13803,1,847920000,847920000,20701,6900,13801,6900,0,1,6902,40470649,40.470649
5900,5100,6900,30090000,2,55206,13803,1,847920000,847920000,20701,6900,13801,6900,0,1,6902,38683339,38.683339
5900,5100,6900,30090000,2,55206,13803,1,847920000,847920000,20701,6900,13801,6900,0,1,6902,38391622,38.391622
5900,5100,6900,30090000,2,55206,13803,1,847920000,847920000,20701,6900,13801,6900,0,1,6902,39886578,39.886578
5900,4700,500,27730000,2,4006,1003,1,264240000,264240000,1501,500,1001,500,0,1,502,2981592,2.981592
5900,4700,500,27730000,2,4006,1003,1,264240000,264240000,1501,500,1001,500,0,1,502,3031996,3.031996
5900,4700,500,27730000,2,4006,1003,1,264240000,264240000,1501,500,1001,500,0,1,502,2936734,2.936734
5900,4700,500,27730000,2,4006,1003,1,264240000,264240000,1501,500,1001,500,0,1,502,3011922,3.011922
5900,4700,500,27730000,2,4006,1003,1,264240000,264240000,1501,500,1001,500,0,1,502,2918031,2.918031
5900,4700,500,27730000,2,4006,1003,1,264240000,264240000,1501,500,1001,500,0,1,502,2962459,2.962459
5900,4700,500,27730000,2,4006,1003,1,264240000,264240000,1501,500,1001,500,0,1,502,3051673,3.051673
5900,4700,900,27730000,2,7206,1803,1,298160000,298160000,2701,900,1801,900,0,1,902,4781465,4.781465
5900,4700,900,27730000,2,7206,1803,1,298160000,298160000,2701,900,1801,900,0,1,902,5009136,5.009136
5900,4700,900,27730000,2,7206,1803,1,298160000,298160000,2701,900,1801,900,0,1,902,4819585,4.819585
5900,4700,900,27730000,2,7206,1803,1,298160000,298160000,2701,900,1801,900,0,1,902,5041946,5.041946
5900,4700,900,27730000,2,7206,1803,1,298160000,298160000,2701,900,1801,900,0,1,902,4838870,4.83887
5900,4700,900,27730000,2,7206,1803,1,298160000,298160000,2701,900,1801,900,0,1,902,4800763,4.800763
5900,4700,900,27730000,2,7206,1803,1,298160000,298160000,2701,900,1801,900,0,1,902,4989733,4.989733
5900,4700,1300,27730000,2,10406,2603,1,332080000,332080000,3901,1300,2601,1300,0,1,1302,6974313,6.974313
5900,4700,1300,27730000,2,10406,2603,1,332080000,332080000,3901,1300,2601,1300,0,1,1302,7097231,7.097231
5900,4700,1300,27730000,2,10406,2603,1,332080000,332080000,3901,1300,2601,1300,0,1,1302,6973793,6.973793
5900,4700,1300,27730000,2,10406,2603,1,332080000,332080000,3901,1300,2601,1300,0,1,1302,7182092,7.182092
5900,4700,1300,27730000,2,10406,2603,1,332080000,332080000,3901,1300,2601,1300,0,1,1302,7027845,7.027845
5900,4700,1300,27730000,2,10406,2603,1,332080000,332080000,3901,1300,2601,1300,0,1,1302,6954864,6.954864
5900,4700,1300,27730000,2,10406,2603,1,332080000,332080000,3901,1300,2601,1300,0,1,1302,7131128,7.131128
5900,4700,1700,27730000,2,13606,3403,1,366000000,366000000,5101,1700,3401,1700,0,1,1702,8848075,8.848075
5900,4700,1700,27730000,2,13606,3403,1,366000000,366000000,5101,1700,3401,1700,0,1,1702,9338987,9.338987
5900,4700,1700,27730000,2,13606,3403,1,366000000,366000000,5101,1700,3401,1700,0,1,1702,8829236,8.829236
5900,4700,1700,27730000,2,13606,3403,1,366000000,366000000,5101,1700,3401,1700,0,1,1702,9413380,9.41338
5900,4700,1700,27730000,2,13606,3403,1,366000000,366000000,5101,1700,3401,1700,0,1,1702,8999844,8.999844
5900,4700,1700,27730000,2,13606,3403,1,366000000,366000000,5101,1700,3401,1700,0,1,1702,8810372,8.810372
5900,4700,1700,27730000,2,13606,3403,1,366000000,366000000,5101,1700,3401,1700,0,1,1702,9319100,9.3191
5900,4700,2100,27730000,2,16806,4203,1,399920000,399920000,6301,2100,4201,2100,0,1,2102,10986596,10.986596
5900,4700,2100,27730000,2,16806,4203,1,399920000,399920000,6301,2100,4201,2100,0,1,2102,11450168,11.450168
5900,4700,2100,27730000,2,16806,4203,1,399920000,399920000,6301,2100,4201,2100,0,1,2102,11024338,11.024338
5900,4700,2100,27730000,2,16806,4203,1,399920000,399920000,6301,2100,4201,2100,0,1,2102,11565224,11.565224
5900,4700,2100,27730000,2,16806,4203,1,399920000,399920000,6301,2100,4201,2100,0,1,2102,11123530,11.12353
5900,4700,2100,27730000,2,16806,4203,1,399920000,399920000,6301,2100,4201,2100,0,1,2102,11005451,11.005451
5900,4700,2100,27730000,2,16806,4203,1,399920000,399920000,6301,2100,4201,2100,0,1,2102,11366920,11.36692
5900,4700,2500,27730000,2,20006,5003,1,433840000,433840000,7501,2500,5001,2500,0,1,2502,13008091,13.008091
5900,4700,2500,27730000,2,20006,5003,1,433840000,433840000,7501,2500,5001,2500,0,1,2502,13437705,13.437705
5900,4700,2500,27730000,2,20006,5003,1,433840000,433840000,7501,2500,5001,2500,0,1,2502,13027122,13.027122
5900,4700,2500,27730000,2,20006,5003,1,433840000,433840000,7501,2500,5001,2500,0,1,2502,13547351,13.547351
5900,4700,2500,27730000,2,20006,5003,1,433840000,433840000,7501,2500,5001,2500,0,1,2502,13134982,13.134982
5900,4700,2500,27730000,2,20006,5003,1,433840000,433840000,7501,2500,5001,2500,0,1,2502,13028486,13.028486
5900,4700,2500,27730000,2,20006,5003,1,433840000,433840000,7501,2500,5001,2500,0,1,2502,13354301,13.354301
5900,4700,2900,27730000,2,23206,5803,1,467760000,467760000,8701,2900,5801,2900,0,1,2902,15059757,15.059757
5900,4700,2900,27730000,2,23206,5803,1,467760000,467760000,8701,2900,5801,2900,0,1,2902,15682439,15.682439
5900,4700,2900,27730000,2,23206,5803,1,467760000,467760000,8701,2900,5801,2900,0,1,2902,15040737,15.040737
5900,4700,2900,27730000,2,23206,5803,1,467760000,467760000,8701,2900,5801,2900,0,1,2902,15774550,15.77455
5900,4700,2900,27730000,2,23206,5803,1,467760000,467760000,8701,2900,5801,2900,0,1,2902,15193600,15.1936
5900,4700,2900,27730000,2,23206,5803,1,467760000,467760000,8701,2900,5801,2900,0,1,2902,15060407,15.060407
5900,4700,2900,27730000,2,23206,5803,1,467760000,467760000,8701,2900,5801,2900,0,1,2902,15530742,15.530742
5900,4700,3300,27730000,2,26406,6603,1,501680000,501680000,9901,3300,6601,3300,0,1,3302,17066007,17.066007
5900,4700,3300,27730000,2,26406,6603,1,501680000,501680000,9901,3300,6601,3300,0,1,3302,17747677,17.747677
5900,4700,3300,27730000,2,26406,6603,1,501680000,501680000,9901,3300,6601,3300,0,1,3302,17085605,17.085605
5900,4700,3300,27730000,2,26406,6603,1,501680000,501680000,9901,3300,6601,3300,0,1,3302,17908291,17.908291
5900,4700,3300,27730000,2,26406,6603,1,501680000,501680000,9901,3300,6601,3300,0,1,3302,17200359,17.200359
5900,4700,3300,27730000,2,26406,6603,1,501680000,501680000,9901,3300,6601,3300,0,1,3302,17085006,17.085006
5900,4700,3300,27730000,2,26406,6603,1,501680000,501680000,9901,3300,6601,3300,0,1,3302,17686709,17.686709
5900,4700,3700,27730000,2,29606,7403,1,535600000,535600000,11101,3700,7401,3700,0,1,3702,19055851,19.055851
5900,4700,3700,27730000,2,29606,7403,1,535600000,535600000,11101,3700,7401,3700,0,1,3702,19922320,19.92232
5900,4700,3700,27730000,2,29606,7403,1,535600000,535600000,11101,3700,7401,3700,0,1,3702,19107311,19.107311
5900,4700,3700,27730000,2,29606,7403,1,535600000,535600000,11101,3700,7401,3700,0,1,3702,20036685,20.036685
5900,4700,3700,27730000,2,29606,7403,1,535600000,535600000,11101,3700,7401,3700,0,1,3702,19188259,19.188259
5900,4700,3700,27730000,2,29606,7403,1,535600000,535600000,11101,3700,7401,3700,0,1,3702,19088394,19.088394
5900,4700,3700,27730000,2,29606,7403,1,535600000,535600000,11101,3700,7401,3700,0,1,3702,19751770,19.75177
5900,4700,4100,27730000,2,32806,8203,1,569520000,569520000,12301,4100,8201,4100,0,1,4102,21099488,21.099488
5900,4700,4100,27730000,2,32806,8203,1,569520000,569520000,12301,4100,8201,4100,0,1,4102,22031952,22.031952
5900,4700,4100,27730000,2,32806,8203,1,569520000,569520000,12301,4100,8201,4100,0,1,4102,21137501,21.137501
5900,4700,4100,27730000,2,32806,8203,1,569520000,569520000,12301,4100,8201,4100,0,1,4102,22168285,22.168285
5900,4700,4100,27730000,2,32806,8203,1,569520000,569520000,12301,4100,8201,4100,0,1,4102,21156924,21.156924
5900,4700,4100,27730000,2,32806,8203,1,569520000,569520000,12301,4100,8201,4100,0,1,4102,21118427,21.118427
5900,4700,4100,27730000,2,32806,8203,1,569520000,569520000,12301,4100,8201,4100,0,1,4102,21876003,21.876003
5900,4700,4500,27730000,2,36006,9003,1,603440000,603440000,13501,4500,9001,4500,0,1,4502,23254499,23.254499
5900,4700,4500,27730000,2,36006,9003,1,603440000,603440000,13501,4500,9001,4500,0,1,4502,24194707,24.194707
5900,4700,4500,27730000,2,36006,9003,1,603440000,603440000,13501,4500,9001,4500,0,1,4502,23201769,23.201769
5900,4700,4500,27730000,2,36006,9003,1,603440000,603440000,13501,4500,9001,4500,0,1,4502,24403687,24.403687
5900,4700,4500,27730000,2,36006,9003,1,603440000,603440000,13501,4500,9001,4500,0,1,4502,23221368,23.221368
5900,4700,4500,27730000,2,36006,9003,1,603440000,603440000,13501,4500,9001,4500,0,1,4502,23129407,23.129407
5900,4700,4500,27730000,2,36006,9003,1,603440000,603440000,13501,4500,9001,4500,0,1,4502,24066228,24.066228
5900,4700,4900,27730000,2,39206,9803,1,637360000,637360000,14701,4900,9801,4900,0,1,4902,25212069,25.212069
5900,4700,4900,27730000,2,39206,9803,1,637360000,637360000,14701,4900,9801,4900,0,1,4902,26313809,26.313809
5900,4700,4900,27730000,2,39206,9803,1,637360000,637360000,14701,4900,9801,4900,0,1,4902,25192906,25.192906
5900,4700,4900,27730000,2,39206,9803,1,637360000,637360000,14701,4900,9801,4900,0,1,4902,26449354,26.449354
5900,4700,4900,27730000,2,39206,9803,1,637360000,637360000,14701,4900,9801,4900,0,1,4902,25274194,25.274194
5900,4700,4900,27730000,2,39206,9803,1,637360000,637360000,14701,4900,9801,4900,0,1,4902,25173917,25.173917
5900,4700,4900,27730000,2,39206,9803,1,637360000,637360000,14701,4900,9801,4900,0,1,4902,26098680,26.09868
5900,4700,5300,27730000,2,42406,10603,1,671280000,671280000,15901,5300,10601,5300,0,1,5302,27216216,27.216216
5900,4700,5300,27730000,2,42406,10603,1,671280000,671280000,15901,5300,10601,5300,0,1,5302,28526065,28.526065
5900,4700,5300,27730000,2,42406,10603,1,671280000,671280000,15901,5300,10601,5300,0,1,5302,27255042,27.255042
5900,4700,5300,27730000,2,42406,10603,1,671280000,671280000,15901,5300,10601,5300,0,1,5302,28600448,28.600448
5900,4700,5300,27730000,2,42406,10603,1,671280000,671280000,15901,5300,10601,5300,0,1,5302,27310881,27.310881
5900,4700,5300,27730000,2,42406,10603,1,671280000,671280000,15901,5300,10601,5300,0,1,5302,27236584,27.236584
5900,4700,5300,27730000,2,42406,10603,1,671280000,671280000,15901,5300,10601,5300,0,1,5302,28182902,28.182902
5900,4700,5700,27730000,2,45606,11403,1,705200000,705200000,17101,5700,11401,5700,0,1,5702,29240445,29.240445
5900,4700,5700,27730000,2,45606,11403,1,705200000,705200000,17101,5700,11401,5700,0,1,5702,30555988,30.555988
5900,4700,5700,27730000,2,45606,11403,1,705200000,705200000,17101,5700,11401,5700,0,1,5702,29278543,29.278543
5900,4700,5700,27730000,2,45606,11403,1,705200000,705200000,17101,5700,11401,5700,0,1,5702,30775203,30.775203
5900,4700,5700,27730000,2,45606,11403,1,705200000,705200000,17101,5700,11401,5700,0,1,5702,29352126,29.352126
5900,4700,5700,27730000,2,45606,11403,1,705200000,705200000,17101,5700,11401,5700,0,1,5702,29259427,29.259427
5900,4700,5700,27730000,2,45606,11403,1,705200000,705200000,17101,5700,11401,5700,0,1,5702,30240356,30.240356
5900,4700,6100,27730000,2,48806,12203,1,739120000,739120000,18301,6100,12201,6100,0,1,6102,31306746,31.306746
5900,4700,6100,27730000,2,48806,12203,1,739120000,739120000,18301,6100,12201,6100,0,1,6102,32694527,32.694527
5900,4700,6100,27730000,2,48806,12203,1,739120000,739120000,18301,6100,12201,6100,0,1,6102,31326542,31.326542
5900,4700,6100,27730000,2,48806,12203,1,739120000,739120000,18301,6100,12201,6100,0,1,6102,32915879,32.915879
5900,4700,6100,27730000,2,48806,12203,1,739120000,739120000,18301,6100,12201,6100,0,1,6102,31447484,31.447484
5900,4700,6100,27730000,2,48806,12203,1,739120000,739120000,18301,6100,12201,6100,0,1,6102,31286961,31.286961
5900,4700,6100,27730000,2,48806,12203,1,739120000,739120000,18301,6100,12201,6100,0,1,6102,32395228,32.395228
5900,4700,6500,27730000,2,52006,13003,1,773040000,773040000,19501,6500,13001,6500,0,1,6502,33348759,33.348759
5900,4700,6500,27730000,2,52006,13003,1,773040000,773040000,19501,6500,13001,6500,0,1,6502,34931271,34.931271
5900,4700,6500,27730000,2,52006,13003,1,773040000,773040000,19501,6500,13001,6500,0,1,6502,33387972,33.387972
5900,4700,6500,27730000,2,52006,13003,1,773040000,773040000,19501,6500,13001,6500,0,1,6502,35064012,35.064012
5900,4700,6500,27730000,2,52006,13003,1,773040000,773040000,19501,6500,13001,6500,0,1,6502,33500897,33.500897
5900,4700,6500,27730000,2,52006,13003,1,773040000,773040000,19501,6500,13001,6500,0,1,6502,33437764,33.437764
5900,4700,6500,27730000,2,52006,13003,1,773040000,773040000,19501,6500,13001,6500,0,1,6502,34522487,34.522487
5900,4700,6900,27730000,2,55206,13803,1,806960000,806960000,20701,6900,13801,6900,0,1,6902,35400773,35.400773
5900,4700,6900,27730000,2,55206,13803,1,806960000,806960000,20701,6900,13801,6900,0,1,6902,37051427,37.051427
5900,4700,6900,27730000,2,55206,13803,1,806960000,806960000,20701,6900,13801,6900,0,1,6902,35441286,35.441286
5900,4700,6900,27730000,2,55206,13803,1,806960000,806960000,20701,6900,13801,6900,0,1,6902,37233537,37.233537
5900,4700,6900,27730000,2,55206,13803,1,806960000,806960000,20701,6900,13801,6900,0,1,6902,35601786,35.601786
5900,4700,6900,27730000,2,55206,13803,1,806960000,806960000,20701,6900,13801,6900,0,1,6902,35481923,35.481923
5900,4700,6900,27730000,2,55206,13803,1,806960000,806960000,20701,6900,13801,6900,0,1,6902,36623935,36.623935
5900,4300,500,25370000,2,4006,1003,1,243760000,243760000,1501,500,1001,500,0,1,502,2700687,2.700687
5900,4300,500,25370000,2,4006,1003,1,243760000,243760000,1501,500,1001,500,0,1,502,2781894,2.781894
5900,4300,500,25370000,2,4006,1003,1,243760000,243760000,1501,500,1001,500,0,1,502,2718849,2.718849
5900,4300,500,25370000,2,4006,1003,1,243760000,243760000,1501,500,1001,500,0,1,502,2800610,2.80061
5900,4300,500,25370000,2,4006,1003,1,243760000,243760000,1501,500,1001,500,0,1,502,2718254,2.718254
5900,4300,500,25370000,2,4006,1003,1,243760000,243760000,1501,500,1001,500,0,1,502,2799279,2.799279
5900,4300,500,25370000,2,4006,1003,1,243760000,243760000,1501,500,1001,500,0,1,502,2736814,2.736814
5900,4300,900,25370000,2,7206,1803,1,276400000,276400000,2701,900,1801,900,0,1,902,4398977,4.398977
5900,4300,900,25370000,2,7206,1803,1,276400000,276400000,2701,900,1801,900,0,1,902,4582049,4.582049
5900,4300,900,25370000,2,7206,1803,1,276400000,276400000,2701,900,1801,900,0,1,902,4416901,4.416901
5900,4300,900,25370000,2,7206,1803,1,276400000,276400000,2701,900,1801,900,0,1,902,4600317,4.600317
5900,4300,900,25370000,2,7206,1803,1,276400000,276400000,2701,900,1801,900,0,1,902,4441535,4.441535
5900,4300,900,25370000,2,7206,1803,1,276400000,276400000,2701,900,1801,900,0,1,902,4416376,4.416376
5900,4300,900,25370000,2,7206,1803,1,276400000,276400000,2701,900,1801,900,0,1,902,4525163,4.525163
5900,4300,1300,25370000,2,10406,2603,1,309040000,309040000,3901,1300,2601,1300,0,1,1302,6260568,6.260568
5900,4300,1300,25370000,2,10406,2603,1,309040000,309040000,3901,1300,2601,1300,0,1,1302,6505978,6.505978
5900,4300,1300,25370000,2,10406,2603,1,309040000,309040000,3901,1300,2601,1300,0,1,1302,6242711,6.242711
5900,4300,1300,25370000,2,10406,2603,1,309040000,309040000,3901,1300,2601,1300,0,1,1302,6531726,6.531726
5900,4300,1300,25370000,2,10406,2603,1,309040000,309040000,3901,1300,2601,1300,0,1,1302,6318857,6.318857
5900,4300,1300,25370000,2,10406,2603,1,309040000,309040000,3901,1300,2601,1300,0,1,1302,6283440,6.28344
5900,4300,1300,25370000,2,10406,2603,1,309040000,309040000,3901,1300,2601,1300,0,1,1302,6436011,6.436011
5900,4300,1700,25370000,2,13606,3403,1,341680000,341680000,5101,1700,3401,1700,0,1,1702,8247594,8.247594
5900,4300,1700,25370000,2,13606,3403,1,341680000,341680000,5101,1700,3401,1700,0,1,1702,8555809,8.555809
5900,4300,1700,25370000,2,13606,3403,1,341680000,341680000,5101,1700,3401,1700,0,1,1702,8264909,8.264909
5900,4300,1700,25370000,2,13606,3403,1,341680000,341680000,5101,1700,3401,1700,0,1,1702,8638166,8.638166
5900,4300,1700,25370000,2,13606,3403,1,341680000,341680000,5101,1700,3401,1700,0,1,1702,8283124,8.283124
5900,4300,1700,25370000,2,13606,3403,1,341680000,341680000,5101,1700,3401,1700,0,1,1702,8265469,8.265469
5900,4300,1700,25370000,2,13606,3403,1,341680000,341680000,5101,1700,3401,1700,0,1,1702,8463870,8.46387
5900,4300,2100,25370000,2,16806,4203,1,374320000,374320000,6301,2100,4201,2100,0,1,2102,9923188,9.923188
5900,4300,2100,25370000,2,16806,4203,1,374320000,374320000,6301,2100,4201,2100,0,1,2102,10364938,10.364938
5900,4300,2100,25370000,2,16806,4203,1,374320000,374320000,6301,2100,4201,2100,0,1,2102,9946568,9.946568
5900,4300,2100,25370000,2,16806,4203,1,374320000,374320000,6301,2100,4201,2100,0,1,2102,10460574,10.460574
5900,4300,2100,25370000,2,16806,4203,1,374320000,374320000,6301,2100,4201,2100,0,1,2102,10099871,10.099871
5900,4300,2100,25370000,2,16806,4203,1,374320000,374320000,6301,2100,4201,2100,0,1,2102,9980237,9.980237
5900,4300,2100,25370000,2,16806,4203,1,374320000,374320000,6301,2100,4201,2100,0,1,2102,10273196,10.273196
5900,4300,2500,25370000,2,20006,5003,1,406960000,406960000,7501,2500,5001,2500,0,1,2502,11930147,11.930147
5900,4300,2500,25370000,2,20006,5003,1,406960000,406960000,7501,2500,5001,2500,0,1,2502,12431456,12.431456
5900,4300,2500,25370000,2,20006,5003,1,406960000,406960000,7501,2500,5001,2500,0,1,2502,11912792,11.912792
5900,4300,2500,25370000,2,20006,5003,1,406960000,406960000,7501,2500,5001,2500,0,1,2502,12512442,12.512442
5900,4300,2500,25370000,2,20006,5003,1,406960000,406960000,7501,2500,5001,2500,0,1,2502,12007287,12.007287
5900,4300,2500,25370000,2,20006,5003,1,406960000,406960000,7501,2500,5001,2500,0,1,2502,11982301,11.982301
5900,4300,2500,25370000,2,20006,5003,1,406960000,406960000,7501,2500,5001,2500,0,1,2502,12313260,12.31326
5900,4300,2900,25370000,2,23206,5803,1,439600000,439600000,8701,2900,5801,2900,0,1,2902,13808362,13.808362
5900,4300,2900,25370000,2,23206,5803,1,439600000,439600000,8701,2900,5801,2900,0,1,2902,14341828,14.341828
5900,4300,2900,25370000,2,23206,5803,1,439600000,439600000,8701,2900,5801,2900,0,1,2902,13791042,13.791042
5900,4300,2900,25370000,2,23206,5803,1,439600000,439600000,8701,2900,5801,2900,0,1,2902,14450814,14.450814
5900,4300,2900,25370000,2,23206,5803,1,439600000,439600000,8701,2900,5801,2900,0,1,2902,13891101,13.891101
5900,4300,2900,25370000,2,23206,5803,1,439600000,439600000,8701,2900,5801,2900,0,1,2902,13855316,13.855316
5900,4300,2900,25370000,2,23206,5803,1,439600000,439600000,8701,2900,5801,2900,0,1,2902,14206771,14.206771
5900,4300,3300,25370000,2,26406,6603,1,472240000,472240000,9901,3300,6601,3300,0,1,3302,15678530,15.67853
5900,4300,3300,25370000,2,26406,6603,1,472240000,472240000,9901,3300,6601,3300,0,1,3302,16279569,16.279569
5900,4300,3300,25370000,2,26406,6603,1,472240000,472240000,9901,3300,6601,3300,0,1,3302,15651646,15.651646
5900,4300,3300,25370000,2,26406,6603,1,472240000,472240000,9901,3300,6601,3300,0,1,3302,16422482,16.422482
5900,4300,3300,25370000,2,26406,6603,1,472240000,472240000,9901,3300,6601,3300,0,1,3302,15722967,15.722967
5900,4300,3300,25370000,2,26406,6603,1,472240000,472240000,9901,3300,6601,3300,0,1,3302,15705314,15.705314
5900,4300,3300,25370000,2,26406,6603,1,472240000,472240000,9901,3300,6601,3300,0,1,3302,16128209,16.128209
5900,4300,3700,25370000,2,29606,7403,1,504880000,504880000,11101,3700,7401,3700,0,1,3702,17470774,17.470774
5900,4300,3700,25370000,2,29606,7403,1,504880000,504880000,11101,3700,7401,3700,0,1,3702,18253060,18.25306
5900,4300,3700,25370000,2,29606,7403,1,504880000,504880000,11101,3700,7401,3700,0,1,3702,17498705,17.498705
5900,4300,3700,25370000,2,29606,7403,1,504880000,504880000,11101,3700,7401,3700,0,1,3702,18340274,18.340274
5900,4300,3700,25370000,2,29606,7403,1,504880000,504880000,11101,3700,7401,3700,0,1,3702,17550912,17.550912
5900,4300,3700,25370000,2,29606,7403,1,504880000,504880000,11101,3700,7401,3700,0,1,3702,17533113,17.533113
5900,4300,3700,25370000,2,29606,7403,1,504880000,504880000,11101,3700,7401,3700,0,1,3702,18077687,18.077687
5900,4300,4100,25370000,2,32806,8203,1,537520000,537520000,12301,4100,8201,4100,0,1,4102,19385949,19.385949
5900,4300,4100,25370000,2,32806,8203,1,537520000,537520000,12301,4100,8201,4100,0,1,4102,20163576,20.163576
5900,4300,4100,25370000,2,32806,8203,1,537520000,537520000,12301,4100,8201,4100,0,1,4102,19404198,19.404198
5900,4300,4100,25370000,2,32806,8203,1,537520000,537520000,12301,4100,8201,4100,0,1,4102,20324895,20.324895
5900,4300,4100,25370000,2,32806,8203,1,537520000,537520000,12301,4100,8201,4100,0,1,4102,19415509,19.415509
5900,4300,4100,25370000,2,32806,8203,1,537520000,537520000,12301,4100,8201,4100,0,1,4102,19452063,19.452063
5900,4300,4100,25370000,2,32806,8203,1,537520000,537520000,12301,4100,8201,4100,0,1,4102,20040050,20.04005
5900,4300,4500,25370000,2,36006,9003,1,570160000,570160000,13501,4500,9001,4500,0,1,4502,21210090,21.21009
5900,4300,4500,25370000,2,36006,9003,1,570160000,570160000,13501,4500,9001,4500,0,1,4502,22123928,22.123928
5900,4300,4500,25370000,2,36006,9003,1,570160000,570160000,13501,4500,9001,4500,0,1,4502,21227598,21.227598
5900,4300,4500,25370000,2,36006,9003,1,570160000,570160000,13501,4500,9001,4500,0,1,4502,22266899,22.266899
5900,4300,4500,25370000,2,36006,9003,1,570160000,570160000,13501,4500,9001,4500,0,1,4502,21258341,21.258341
5900,4300,4500,25370000,2,36006,9003,1,570160000,570160000,13501,4500,9001,4500,0,1,4502,21288898,21.288898
5900,4300,4500,25370000,2,36006,9003,1,570160000,570160000,13501,4500,9001,4500,0,1,4502,21891535,21.891535
5900,4300,4900,25370000,2,39206,9803,1,602800000,602800000,14701,4900,9801,4900,0,1,4902,23151116,23.151116
5900,4300,4900,25370000,2,39206,9803,1,602800000,602800000,14701,4900,9801,4900,0,1,4902,24072381,24.072381
5900,4300,4900,25370000,2,39206,9803,1,602800000,602800000,14701,4900,9801,4900,0,1,4902,23111920,23.11192
5900,4300,4900,25370000,2,39206,9803,1,602800000,602800000,14701,4900,9801,4900,0,1,4902,24224982,24.224982
5900,4300,4900,25370000,2,39206,9803,1,602800000,602800000,14701,4900,9801,4900,0,1,4902,23199551,23.199551
5900,4300,4900,25370000,2,39206,9803,1,602800000,602800000,14701,4900,9801,4900,0,1,4902,23094415,23.094415
5900,4300,4900,25370000,2,39206,9803,1,602800000,602800000,14701,4900,9801,4900,0,1,4902,23986650,23.98665
5900,4300,5300,25370000,2,42406,10603,1,635440000,635440000,15901,5300,10601,5300,0,1,5302,24931382,24.931382
5900,4300,5300,25370000,2,42406,10603,1,635440000,635440000,15901,5300,10601,5300,0,1,5302,26015452,26.015452
5900,4300,5300,25370000,2,42406,10603,1,635440000,635440000,15901,5300,10601,5300,0,1,5302,24992374,24.992374
5900,4300,5300,25370000,2,42406,10603,1,635440000,635440000,15901,5300,10601,5300,0,1,5302,26225363,26.225363
5900,4300,5300,25370000,2,42406,10603,1,635440000,635440000,15901,5300,10601,5300,0,1,5302,25109880,25.10988
5900,4300,5300,25370000,2,42406,10603,1,635440000,635440000,15901,5300,10601,5300,0,1,5302,25025059,25.025059
5900,4300,5300,25370000,2,42406,10603,1,635440000,635440000,15901,5300,10601,5300,0,1,5302,25809524,25.809524
5900,4300,5700,25370000,2,45606,11403,1,668080000,668080000,17101,5700,11401,5700,0,1,5702,26838534,26.838534
5900,4300,5700,25370000,2,45606,11403,1,668080000,668080000,17101,5700,11401,5700,0,1,5702,28067077,28.067077
5900,4300,5700,25370000,2,45606,11403,1,668080000,668080000,17101,5700,11401,5700,0,1,5702,26873785,26.873785
5900,4300,5700,25370000,2,45606,11403,1,668080000,668080000,17101,5700,11401,5700,0,1,5702,28275297,28.275297
5900,4300,5700,25370000,2,45606,11403,1,668080000,668080000,17101,5700,11401,5700,0,1,5702,26938525,26.938525
5900,4300,5700,25370000,2,45606,11403,1,668080000,668080000,17101,5700,11401,5700,0,1,5702,26920243,26.920243
5900,4300,5700,25370000,2,45606,11403,1,668080000,668080000,17101,5700,11401,5700,0,1,5702,27718284,27.718284
5900,4300,6100,25370000,2,48806,12203,1,700720000,700720000,18301,6100,12201,6100,0,1,6102,28621007,28.621007
5900,4300,6100,25370000,2,48806,12203,1,700720000,700720000,18301,6100,12201,6100,0,1,6102,30004403,30.004403
5900,4300,6100,25370000,2,48806,12203,1,700720000,700720000,18301,6100,12201,6100,0,1,6102,28725919,28.725919
5900,4300,6100,25370000,2,48806,12203,1,700720000,700720000,18301,6100,12201,6100,0,1,6102,30189777,30.189777
5900,4300,6100,25370000,2,48806,12203,1,700720000,700720000,18301,6100,12201,6100,0,1,6102,28825141,28.825141
5900,4300,6100,25370000,2,48806,12203,1,700720000,700720000,18301,6100,12201,6100,0,1,6102,28760752,28.760752
5900,4300,6100,25370000,2,48806,12203,1,700720000,700720000,18301,6100,12201,6100,0,1,6102,29656576,29.656576
5900,4300,6500,25370000,2,52006,13003,1,733360000,733360000,19501,6500,13001,6500,0,1,6502,30618836,30.618836
5900,4300,6500,25370000,2,52006,13003,1,733360000,733360000,19501,6500,13001,6500,0,1,6502,31961138,31.961138
5900,4300,6500,25370000,2,52006,13003,1,733360000,733360000,19501,6500,13001,6500,0,1,6502,30659415,30.659415
5900,4300,6500,25370000,2,52006,13003,1,733360000,733360000,19501,6500,13001,6500,0,1,6502,32183100,32.1831
5900,4300,6500,25370000,2,52006,13003,1,733360000,733360000,19501,6500,13001,6500,0,1,6502,30782609,30.782609
5900,4300,6500,25370000,2,52006,13003,1,733360000,733360000,19501,6500,13001,6500,0,1,6502,30678660,30.67866
5900,4300,6500,25370000,2,52006,13003,1,733360000,733360000,19501,6500,13001,6500,0,1,6502,31686310,31.68631
5900,4300,6900,25370000,2,55206,13803,1,766000000,766000000,20701,6900,13801,6900,0,1,6902,32353392,32.353392
5900,4300,6900,25370000,2,55206,13803,1,766000000,766000000,20701,6900,13801,6900,0,1,6902,33948780,33.94878
5900,4300,6900,25370000,2,55206,13803,1,766000000,766000000,20701,6900,13801,6900,0,1,6902,32494357,32.494357
5900,4300,6900,25370000,2,55206,13803,1,766000000,766000000,20701,6900,13801,6900,0,1,6902,34188977,34.188977
5900,4300,6900,25370000,2,55206,13803,1,766000000,766000000,20701,6900,13801,6900,0,1,6902,32656052,32.656052
5900,4300,6900,25370000,2,55206,13803,1,766000000,766000000,20701,6900,13801,6900,0,1,6902,32515615,32.515615
5900,4300,6900,25370000,2,55206,13803,1,766000000,766000000,20701,6900,13801,6900,0,1,6902,33608058,33.608058
5900,3900,500,23010000,2,4006,1003,1,223280000,223280000,1501,500,1001,500,0,1,502,2538953,2.538953
5900,3900,500,23010000,2,4006,1003,1,223280000,223280000,1501,500,1001,500,0,1,502,2555867,2.555867
5900,3900,500,23010000,2,4006,1003,1,223280000,223280000,1501,500,1001,500,0,1,502,2460058,2.460058
5900,3900,500,23010000,2,4006,1003,1,223280000,223280000,1501,500,1001,500,0,1,502,2522835,2.522835
5900,3900,500,23010000,2,4006,1003,1,223280000,223280000,1501,500,1001,500,0,1,502,2522099,2.522099
5900,3900,500,23010000,2,4006,1003,1,223280000,223280000,1501,500,1001,500,0,1,502,2556309,2.556309
5900,3900,500,23010000,2,4006,1003,1,223280000,223280000,1501,500,1001,500,0,1,502,2506122,2.506122
5900,3900,900,23010000,2,7206,1803,1,254640000,254640000,2701,900,1801,900,0,1,902,4017778,4.017778
5900,3900,900,23010000,2,7206,1803,1,254640000,254640000,2701,900,1801,900,0,1,902,4153197,4.153197
5900,3900,900,23010000,2,7206,1803,1,254640000,254640000,2701,900,1801,900,0,1,902,3983121,3.983121
5900,3900,900,23010000,2,7206,1803,1,254640000,254640000,2701,900,1801,900,0,1,902,4201081,4.201081
5900,3900,900,23010000,2,7206,1803,1,254640000,254640000,2701,900,1801,900,0,1,902,4062490,4.06249
5900,3900,900,23010000,2,7206,1803,1,254640000,254640000,2701,900,1801,900,0,1,902,4046557,4.046557
5900,3900,900,23010000,2,7206,1803,1,254640000,254640000,2701,900,1801,900,0,1,902,4102045,4.102045
5900,3900,1300,23010000,2,10406,2603,1,286000000,286000000,3901,1300,2601,1300,0,1,1302,5664358,5.664358
5900,3900,1300,23010000,2,10406,2603,1,286000000,286000000,3901,1300,2601,1300,0,1,1302,5909657,5.909657
5900,3900,1300,23010000,2,10406,2603,1,286000000,286000000,3901,1300,2601,1300,0,1,1302,5680046,5.680046
5900,3900,1300,23010000,2,10406,2603,1,286000000,286000000,3901,1300,2601,1300,0,1,1302,5949560,5.94956
5900,3900,1300,23010000,2,10406,2603,1,286000000,286000000,3901,1300,2601,1300,0,1,1302,5754707,5.754707
5900,3900,1300,23010000,2,10406,2603,1,286000000,286000000,3901,1300,2601,1300,0,1,1302,5706388,5.706388
5900,3900,1300,23010000,2,10406,2603,1,286000000,286000000,3901,1300,2601,1300,0,1,1302,5841197,5.841197
5900,3900,1700,23010000,2,13606,3403,1,317360000,317360000,5101,1700,3401,1700,0,1,1702,7524160,7.52416
5900,3900,1700,23010000,2,13606,3403,1,317360000,317360000,5101,1700,3401,1700,0,1,1702,7759924,7.759924
5900,3900,1700,23010000,2,13606,3403,1,317360000,317360000,5101,1700,3401,1700,0,1,1702,7428707,7.428707
5900,3900,1700,23010000,2,13606,3403,1,317360000,317360000,5101,1700,3401,1700,0,1,1702,7815045,7.815045
5900,3900,1700,23010000,2,13606,3403,1,317360000,317360000,5101,1700,3401,1700,0,1,1702,7584060,7.58406
5900,3900,1700,23010000,2,13606,3403,1,317360000,317360000,5101,1700,3401,1700,0,1,1702,7563159,7.563159
5900,3900,1700,23010000,2,13606,3403,1,317360000,317360000,5101,1700,3401,1700,0,1,1702,7713899,7.713899
5900,3900,2100,23010000,2,16806,4203,1,348720000,348720000,6301,2100,4201,2100,0,1,2102,8988436,8.988436
5900,3900,2100,23010000,2,16806,4203,1,348720000,348720000,6301,2100,4201,2100,0,1,2102,9420736,9.420736
5900,3900,2100,23010000,2,16806,4203,1,348720000,348720000,6301,2100,4201,2100,0,1,2102,9030995,9.030995
5900,3900,2100,23010000,2,16806,4203,1,348720000,348720000,6301,2100,4201,2100,0,1,2102,9479817,9.479817
5900,3900,2100,23010000,2,16806,4203,1,348720000,348720000,6301,2100,4201,2100,0,1,2102,9162178,9.162178
5900,3900,2100,23010000,2,16806,4203,1,348720000,348720000,6301,2100,4201,2100,0,1,2102,9069222,9.069222
5900,3900,2100,23010000,2,16806,4203,1,348720000,348720000,6301,2100,4201,2100,0,1,2102,9318567,9.318567
5900,3900,2500,23010000,2,20006,5003,1,380080000,380080000,7501,2500,5001,2500,0,1,2502,10849872,10.849872
5900,3900,2500,23010000,2,20006,5003,1,380080000,380080000,7501,2500,5001,2500,0,1,2502,11302013,11.302013
5900,3900,2500,23010000,2,20006,5003,1,380080000,380080000,7501,2500,5001,2500,0,1,2502,10865626,10.865626
5900,3900,2500,23010000,2,20006,5003,1,380080000,380080000,7501,2500,5001,2500,0,1,2502,11347856,11.347856
5900,3900,2500,23010000,2,20006,5003,1,380080000,380080000,7501,2500,5001,2500,0,1,2502,10974739,10.974739
5900,3900,2500,23010000,2,20006,5003,1,380080000,380080000,7501,2500,5001,2500,0,1,2502,10896325,10.896325
5900,3900,2500,23010000,2,20006,5003,1,380080000,380080000,7501,2500,5001,2500,0,1,2502,11180557,11.180557
5900,3900,2900,23010000,2,23206,5803,1,411440000,411440000,8701,2900,5801,2900,0,1,2902,12516524,12.516524
5900,3900,2900,23010000,2,23206,5803,1,411440000,411440000,8701,2900,5801,2900,0,1,2902,13057916,13.057916
5900,3900,2900,23010000,2,23206,5803,1,411440000,411440000,8701,2900,5801,2900,0,1,2902,12545678,12.545678
5900,3900,2900,23010000,2,23206,5803,1,411440000,411440000,8701,2900,5801,2900,0,1,2902,13121191,13.121191
5900,3900,2900,23010000,2,23206,5803,1,411440000,411440000,8701,2900,5801,2900,0,1,2902,12650169,12.650169
5900,3900,2900,23010000,2,23206,5803,1,411440000,411440000,8701,2900,5801,2900,0,1,2902,12568988,12.568988
5900,3900,2900,23010000,2,23206,5803,1,411440000,411440000,8701,2900,5801,2900,0,1,2902,12930295,12.930295
5900,3900,3300,23010000,2,26406,6603,1,442800000,442800000,9901,3300,6601,3300,0,1,3302,14199262,14.199262
5900,3900,3300,23010000,2,26406,6603,1,442800000,442800000,9901,3300,6601,3300,0,1,3302,14787773,14.787773
5900,3900,3300,23010000,2,26406,6603,1,442800000,442800000,9901,3300,6601,3300,0,1,3302,14183394,14.183394
5900,3900,3300,23010000,2,26406,6603,1,442800000,442800000,9901,3300,6601,3300,0,1,3302,14903912,14.903912
5900,3900,3300,23010000,2,26406,6603,1,442800000,442800000,9901,3300,6601,3300,0,1,3302,14318003,14.318003
5900,3900,3300,23010000,2,26406,6603,1,442800000,442800000,9901,3300,6601,3300,0,1,3302,14293704,14.293704
5900,3900,3300,23010000,2,26406,6603,1,442800000,442800000,9901,3300,6601,3300,0,1,3302,14702639,14.702639
5900,3900,3700,23010000,2,29606,7403,1,474160000,474160000,11101,3700,7401,3700,0,1,3702,15908254,15.908254
5900,3900,3700,23010000,2,29606,7403,1,474160000,474160000,11101,3700,7401,3700,0,1,3702,16551182,16.551182
5900,3900,3700,23010000,2,29606,7403,1,474160000,474160000,11101,3700,7401,3700,0,1,3702,15882804,15.882804
5900,3900,3700,23010000,2,29606,7403,1,474160000,474160000,11101,3700,7401,3700,0,1,3702,16703067,16.703067
5900,3900,3700,23010000,2,29606,7403,1,474160000,474160000,11101,3700,7401,3700,0,1,3702,15993678,15.993678
5900,3900,3700,23010000,2,29606,7403,1,474160000,474160000,11101,3700,7401,3700,0,1,3702,15966681,15.966681
5900,3900,3700,23010000,2,29606,7403,1,474160000,474160000,11101,3700,7401,3700,0,1,3702,16390160,16.39016
5900,3900,4100,23010000,2,32806,8203,1,505520000,505520000,12301,4100,8201,4100,0,1,4102,17538117,17.538117
5900,3900,4100,23010000,2,32806,8203,1,505520000,505520000,12301,4100,8201,4100,0,1,4102,18260439,18.260439
5900,3900,4100,23010000,2,32806,8203,1,505520000,505520000,12301,4100,8201,4100,0,1,4102,17582075,17.582075
5900,3900,4100,23010000,2,32806,8203,1,505520000,505520000,12301,4100,8201,4100,0,1,4102,18436147,18.436147
5900,3900,4100,23010000,2,32806,8203,1,505520000,505520000,12301,4100,8201,4100,0,1,4102,17653290,17.65329
5900,3900,4100,23010000,2,32806,8203,1,505520000,505520000,12301,4100,8201,4100,0,1,4102,17622462,17.622462
5900,3900,4100,23010000,2,32806,8203,1,505520000,505520000,12301,4100,8201,4100,0,1,4102,18143094,18.143094
5900,3900,4500,23010000,2,36006,9003,1,536880000,536880000,13501,4500,9001,4500,0,1,4502,19290948,19.290948
5900,3900,4500,23010000,2,36006,9003,1,536880000,536880000,13501,4500,9001,4500,0,1,4502,20092037,20.092037
5900,3900,4500,23010000,2,36006,9003,1,536880000,536880000,13501,4500,9001,4500,0,1,4502,19275438,19.275438
5900,3900,4500,23010000,2,36006,9003,1,536880000,536880000,13501,4500,9001,4500,0,1,4502,20205167,20.205167
5900,3900,4500,23010000,2,36006,9003,1,536880000,536880000,13501,4500,9001,4500,0,1,4502,19362341,19.362341
5900,3900,4500,23010000,2,36006,9003,1,536880000,536880000,13501,4500,9001,4500,0,1,4502,19245014,19.245014
5900,3900,4500,23010000,2,36006,9003,1,536880000,536880000,13501,4500,9001,4500,0,1,4502,19912148,19.912148
5900,3900,4900,23010000,2,39206,9803,1,568240000,568240000,14701,4900,9801,4900,0,1,4902,21002217,21.002217
5900,3900,4900,23010000,2,39206,9803,1,568240000,568240000,14701,4900,9801,4900,0,1,4902,21831772,21.831772
5900,3900,4900,23010000,2,39206,9803,1,568240000,568240000,14701,4900,9801,4900,0,1,4902,21042830,21.04283
5900,3900,4900,23010000,2,39206,9803,1,568240000,568240000,14701,4900,9801,4900,0,1,4902,22095431,22.095431
5900,3900,4900,23010000,2,39206,9803,1,568240000,568240000,14701,4900,9801,4900,0,1,4902,21058820,21.05882
5900,3900,4900,23010000,2,39206,9803,1,568240000,568240000,14701,4900,9801,4900,0,1,4902,20948571,20.948571
5900,3900,4900,23010000,2,39206,9803,1,568240000,568240000,14701,4900,9801,4900,0,1,4902,21735541,21.735541
5900,3900,5300,23010000,2,42406,10603,1,599600000,599600000,15901,5300,10601,5300,0,1,5302,22646296,22.646296
5900,3900,5300,23010000,2,42406,10603,1,599600000,599600000,15901,5300,10601,5300,0,1,5302,23694344,23.694344
5900,3900,5300,23010000,2,42406,10603,1,599600000,599600000,15901,5300,10601,5300,0,1,5302,22630491,22.630491
5900,3900,5300,23010000,2,42406,10603,1,599600000,599600000,15901,5300,10601,5300,0,1,5302,23802778,23.802778
5900,3900,5300,23010000,2,42406,10603,1,599600000,599600000,15901,5300,10601,5300,0,1,5302,22742721,22.742721
5900,3900,5300,23010000,2,42406,10603,1,599600000,599600000,15901,5300,10601,5300,0,1,5302,22600840,22.60084
5900,3900,5300,23010000,2,42406,10603,1,599600000,599600000,15901,5300,10601,5300,0,1,5302,23372790,23.37279
5900,3900,5700,23010000,2,45606,11403,1,630960000,630960000,17101,5700,11401,5700,0,1,5702,24290302,24.290302
5900,3900,5700,23010000,2,45606,11403,1,630960000,630960000,17101,5700,11401,5700,0,1,5702,25431364,25.431364
5900,3900,5700,23010000,2,45606,11403,1,630960000,630960000,17101,5700,11401,5700,0,1,5702,24361348,24.361348
5900,3900,5700,23010000,2,45606,11403,1,630960000,630960000,17101,5700,11401,5700,0,1,5702,25576833,25.576833
5900,3900,5700,23010000,2,45606,11403,1,630960000,630960000,17101,5700,11401,5700,0,1,5702,24426667,24.426667
5900,3900,5700,23010000,2,45606,11403,1,630960000,630960000,17101,5700,11401,5700,0,1,5702,24306132,24.306132
5900,3900,5700,23010000,2,45606,11403,1,630960000,630960000,17101,5700,11401,5700,0,1,5702,25092462,25.092462
5900,3900,6100,23010000,2,48806,12203,1,662320000,662320000,18301,6100,12201,6100,0,1,6102,26037468,26.037468
5900,3900,6100,23010000,2,48806,12203,1,662320000,662320000,18301,6100,12201,6100,0,1,6102,27199367,27.199367
5900,3900,6100,23010000,2,48806,12203,1,662320000,662320000,18301,6100,12201,6100,0,1,6102,26005596,26.005596
5900,3900,6100,23010000,2,48806,12203,1,662320000,662320000,18301,6100,12201,6100,0,1,6102,27340835,27.340835
5900,3900,6100,23010000,2,48806,12203,1,662320000,662320000,18301,6100,12201,6100,0,1,6102,26192633,26.192633
5900,3900,6100,23010000,2,48806,12203,1,662320000,662320000,18301,6100,12201,6100,0,1,6102,25989126,25.989126
5900,3900,6100,23010000,2,48806,12203,1,662320000,662320000,18301,6100,12201,6100,0,1,6102,26883963,26.883963
5900,3900,6500,23010000,2,52006,13003,1,693680000,693680000,19501,6500,13001,6500,0,1,6502,27710824,27.710824
5900,3900,6500,23010000,2,52006,13003,1,693680000,693680000,19501,6500,13001,6500,0,1,6502,28959219,28.959219
5900,3900,6500,23010000,2,52006,13003,1,693680000,693680000,19501,6500,13001,6500,0,1,6502,27764673,27.764673
5900,3900,6500,23010000,2,52006,13003,1,693680000,693680000,19501,6500,13001,6500,0,1,6502,29133554,29.133554
5900,3900,6500,23010000,2,52006,13003,1,693680000,693680000,19501,6500,13001,6500,0,1,6502,27886985,27.886985
5900,3900,6500,23010000,2,52006,13003,1,693680000,693680000,19501,6500,13001,6500,0,1,6502,27668834,27.668834
5900,3900,6500,23010000,2,52006,13003,1,693680000,693680000,19501,6500,13001,6500,0,1,6502,28660398,28.660398
5900,3900,6900,23010000,2,55206,13803,1,725040000,725040000,20701,6900,13801,6900,0,1,6902,29465853,29.465853
5900,3900,6900,23010000,2,55206,13803,1,725040000,725040000,20701,6900,13801,6900,0,1,6902,30731084,30.731084
5900,3900,6900,23010000,2,55206,13803,1,725040000,725040000,20701,6900,13801,6900,0,1,6902,29499734,29.499734
5900,3900,6900,23010000,2,55206,13803,1,725040000,725040000,20701,6900,13801,6900,0,1,6902,30948537,30.948537
5900,3900,6900,23010000,2,55206,13803,1,725040000,725040000,20701,6900,13801,6900,0,1,6902,29670949,29.670949
5900,3900,6900,23010000,2,55206,13803,1,725040000,725040000,20701,6900,13801,6900,0,1,6902,29447237,29.447237
5900,3900,6900,23010000,2,55206,13803,1,725040000,725040000,20701,6900,13801,6900,0,1,6902,30386525,30.386525
5900,3500,500,20650000,2,4006,1003,1,202800000,202800000,1501,500,1001,500,0,1,502,2273088,2.273088
5900,3500,500,20650000,2,4006,1003,1,202800000,202800000,1501,500,1001,500,0,1,502,2273706,2.273706
5900,3500,500,20650000,2,4006,1003,1,202800000,202800000,1501,500,1001,500,0,1,502,2238218,2.238218
5900,3500,500,20650000,2,4006,1003,1,202800000,202800000,1501,500,1001,500,0,1,502,2310187,2.310187
5900,3500,500,20650000,2,4006,1003,1,202800000,202800000,1501,500,1001,500,0,1,502,2224069,2.224069
5900,3500,500,20650000,2,4006,1003,1,202800000,202800000,1501,500,1001,500,0,1,502,2258113,2.258113
5900,3500,500,20650000,2,4006,1003,1,202800000,202800000,1501,500,1001,500,0,1,502,2288564,2.288564
5900,3500,900,20650000,2,7206,1803,1,232880000,232880000,2701,900,1801,900,0,1,902,3606648,3.606648
5900,3500,900,20650000,2,7206,1803,1,232880000,232880000,2701,900,1801,900,0,1,902,3718626,3.718626
5900,3500,900,20650000,2,7206,1803,1,232880000,232880000,2701,900,1801,900,0,1,902,3568150,3.56815
5900,3500,900,20650000,2,7206,1803,1,232880000,232880000,2701,900,1801,900,0,1,902,3765856,3.765856
5900,3500,900,20650000,2,7206,1803,1,232880000,232880000,2701,900,1801,900,0,1,902,3621527,3.621527
5900,3500,900,20650000,2,7206,1803,1,232880000,232880000,2701,900,1801,900,0,1,902,3620742,3.620742
5900,3500,900,20650000,2,7206,1803,1,232880000,232880000,2701,900,1801,900,0,1,902,3693233,3.693233
5900,3500,1300,20650000,2,10406,2603,1,262960000,262960000,3901,1300,2601,1300,0,1,1302,5090281,5.090281
5900,3500,1300,20650000,2,10406,2603,1,262960000,262960000,3901,1300,2601,1300,0,1,1302,5286084,5.286084
5900,3500,1300,20650000,2,10406,2603,1,262960000,262960000,3901,1300,2601,1300,0,1,1302,5076114,5.076114
5900,3500,1300,20650000,2,10406,2603,1,262960000,262960000,3901,1300,2601,1300,0,1,1302,5347051,5.347051
5900,3500,1300,20650000,2,10406,2603,1,262960000,262960000,3901,1300,2601,1300,0,1,1302,5144526,5.144526
5900,3500,1300,20650000,2,10406,2603,1,262960000,262960000,3901,1300,2601,1300,0,1,1302,5104383,5.104383
5900,3500,1300,20650000,2,10406,2603,1,262960000,262960000,3901,1300,2601,1300,0,1,1302,5246326,5.246326
5900,3500,1700,20650000,2,13606,3403,1,293040000,293040000,5101,1700,3401,1700,0,1,1702,6762620,6.76262
5900,3500,1700,20650000,2,13606,3403,1,293040000,293040000,5101,1700,3401,1700,0,1,1702,6989950,6.98995
5900,3500,1700,20650000,2,13606,3403,1,293040000,293040000,5101,1700,3401,1700,0,1,1702,6709487,6.709487
5900,3500,1700,20650000,2,13606,3403,1,293040000,293040000,5101,1700,3401,1700,0,1,1702,7058834,7.058834
5900,3500,1700,20650000,2,13606,3403,1,293040000,293040000,5101,1700,3401,1700,0,1,1702,6815741,6.815741
5900,3500,1700,20650000,2,13606,3403,1,293040000,293040000,5101,1700,3401,1700,0,1,1702,6801349,6.801349
5900,3500,1700,20650000,2,13606,3403,1,293040000,293040000,5101,1700,3401,1700,0,1,1702,6908873,6.908873
5900,3500,2100,20650000,2,16806,4203,1,323120000,323120000,6301,2100,4201,2100,0,1,2102,8096433,8.096433
5900,3500,2100,20650000,2,16806,4203,1,323120000,323120000,6301,2100,4201,2100,0,1,2102,8446835,8.446835
5900,3500,2100,20650000,2,16806,4203,1,323120000,323120000,6301,2100,4201,2100,0,1,2102,8095955,8.095955
5900,3500,2100,20650000,2,16806,4203,1,323120000,323120000,6301,2100,4201,2100,0,1,2102,8522946,8.522946
5900,3500,2100,20650000,2,16806,4203,1,323120000,323120000,6301,2100,4201,2100,0,1,2102,8213056,8.213056
5900,3500,2100,20650000,2,16806,4203,1,323120000,323120000,6301,2100,4201,2100,0,1,2102,8130383,8.130383
5900,3500,2100,20650000,2,16806,4203,1,323120000,323120000,6301,2100,4201,2100,0,1,2102,8390359,8.390359
5900,3500,2500,20650000,2,20006,5003,1,353200000,353200000,7501,2500,5001,2500,0,1,2502,9778021,9.778021
5900,3500,2500,20650000,2,20006,5003,1,353200000,353200000,7501,2500,5001,2500,0,1,2502,10144622,10.144622
5900,3500,2500,20650000,2,20006,5003,1,353200000,353200000,7501,2500,5001,2500,0,1,2502,9738885,9.738885
5900,3500,2500,20650000,2,20006,5003,1,353200000,353200000,7501,2500,5001,2500,0,1,2502,10223668,10.223668
5900,3500,2500,20650000,2,20006,5003,1,353200000,353200000,7501,2500,5001,2500,0,1,2502,9852510,9.85251
5900,3500,2500,20650000,2,20006,5003,1,353200000,353200000,7501,2500,5001,2500,0,1,2502,9792245,9.792245
5900,3500,2500,20650000,2,20006,5003,1,353200000,353200000,7501,2500,5001,2500,0,1,2502,10129547,10.129547
5900,3500,2900,20650000,2,23206,5803,1,383280000,383280000,8701,2900,5801,2900,0,1,2902,11269815,11.269815
5900,3500,2900,20650000,2,23206,5803,1,383280000,383280000,8701,2900,5801,2900,0,1,2902,11709965,11.709965
5900,3500,2900,20650000,2,23206,5803,1,383280000,383280000,8701,2900,5801,2900,0,1,2902,11343112,11.343112
5900,3500,2900,20650000,2,23206,5803,1,383280000,383280000,8701,2900,5801,2900,0,1,2902,11830758,11.830758
5900,3500,2900,20650000,2,23206,5803,1,383280000,383280000,8701,2900,5801,2900,0,1,2902,11357429,11.357429
5900,3500,2900,20650000,2,23206,5803,1,383280000,383280000,8701,2900,5801,2900,0,1,2902,11327957,11.327957
5900,3500,2900,20650000,2,23206,5803,1,383280000,383280000,8701,2900,5801,2900,0,1,2902,11665100,11.6651
5900,3500,3300,20650000,2,26406,6603,1,413360000,413360000,9901,3300,6601,3300,0,1,3302,12792059,12.792059
5900,3500,3300,20650000,2,26406,6603,1,413360000,413360000,9901,3300,6601,3300,0,1,3302,13303849,13.303849
5900,3500,3300,20650000,2,26406,6603,1,413360000,413360000,9901,3300,6601,3300,0,1,3302,12770057,12.770057
5900,3500,3300,20650000,2,26406,6603,1,413360000,413360000,9901,3300,6601,3300,0,1,3302,13391468,13.391468
5900,3500,3300,20650000,2,26406,6603,1,413360000,413360000,9901,3300,6601,3300,0,1,3302,12870545,12.870545
5900,3500,3300,20650000,2,26406,6603,1,413360000,413360000,9901,3300,6601,3300,0,1,3302,12834558,12.834558
5900,3500,3300,20650000,2,26406,6603,1,413360000,413360000,9901,3300,6601,3300,0,1,3302,13194604,13.194604
5900,3500,3700,20650000,2,29606,7403,1,443440000,443440000,11101,3700,7401,3700,0,1,3702,14382708,14.382708
5900,3500,3700,20650000,2,29606,7403,1,443440000,443440000,11101,3700,7401,3700,0,1,3702,14917046,14.917046
5900,3500,3700,20650000,2,29606,7403,1,443440000,443440000,11101,3700,7401,3700,0,1,3702,14357514,14.357514
5900,3500,3700,20650000,2,29606,7403,1,443440000,443440000,11101,3700,7401,3700,0,1,3702,14994206,14.994206
5900,3500,3700,20650000,2,29606,7403,1,443440000,443440000,11101,3700,7401,3700,0,1,3702,14465438,14.465438
5900,3500,3700,20650000,2,29606,7403,1,443440000,443440000,11101,3700,7401,3700,0,1,3702,14334617,14.334617
5900,3500,3700,20650000,2,29606,7403,1,443440000,443440000,11101,3700,7401,3700,0,1,3702,14835061,14.835061
5900,3500,4100,20650000,2,32806,8203,1,473520000,473520000,12301,4100,8201,4100,0,1,4102,15799852,15.799852
5900,3500,4100,20650000,2,32806,8203,1,473520000,473520000,12301,4100,8201,4100,0,1,4102,16433366,16.433366
5900,3500,4100,20650000,2,32806,8203,1,473520000,473520000,12301,4100,8201,4100,0,1,4102,15823718,15.823718
5900,3500,4100,20650000,2,32806,8203,1,473520000,473520000,12301,4100,8201,4100,0,1,4102,16596147,16.596147
5900,3500,4100,20650000,2,32806,8203,1,473520000,473520000,12301,4100,8201,4100,0,1,4102,15861894,15.861894
5900,3500,4100,20650000,2,32806,8203,1,473520000,473520000,12301,4100,8201,4100,0,1,4102,15837929,15.837929
5900,3500,4100,20650000,2,32806,8203,1,473520000,473520000,12301,4100,8201,4100,0,1,4102,16337897,16.337897
5900,3500,4500,20650000,2,36006,9003,1,503600000,503600000,13501,4500,9001,4500,0,1,4502,17293458,17.293458
5900,3500,4500,20650000,2,36006,9003,1,503600000,503600000,13501,4500,9001,4500,0,1,4502,17998607,17.998607
5900,3500,4500,20650000,2,36006,9003,1,503600000,503600000,13501,4500,9001,4500,0,1,4502,17351000,17.351
5900,3500,4500,20650000,2,36006,9003,1,503600000,503600000,13501,4500,9001,4500,0,1,4502,18163238,18.163238
5900,3500,4500,20650000,2,36006,9003,1,503600000,503600000,13501,4500,9001,4500,0,1,4502,17383713,17.383713
5900,3500,4500,20650000,2,36006,9003,1,503600000,503600000,13501,4500,9001,4500,0,1,4502,17336797,17.336797
5900,3500,4500,20650000,2,36006,9003,1,503600000,503600000,13501,4500,9001,4500,0,1,4502,17930247,17.930247
5900,3500,4900,20650000,2,39206,9803,1,533680000,533680000,14701,4900,9801,4900,0,1,4902,18813130,18.81313
5900,3500,4900,20650000,2,39206,9803,1,533680000,533680000,14701,4900,9801,4900,0,1,4902,19587862,19.587862
5900,3500,4900,20650000,2,39206,9803,1,533680000,533680000,14701,4900,9801,4900,0,1,4902,18857689,18.857689
5900,3500,4900,20650000,2,39206,9803,1,533680000,533680000,14701,4900,9801,4900,0,1,4902,19757533,19.757533
5900,3500,4900,20650000,2,39206,9803,1,533680000,533680000,14701,4900,9801,4900,0,1,4902,18883848,18.883848
5900,3500,4900,20650000,2,39206,9803,1,533680000,533680000,14701,4900,9801,4900,0,1,4902,18898014,18.898014
5900,3500,4900,20650000,2,39206,9803,1,533680000,533680000,14701,4900,9801,4900,0,1,4902,19478175,19.478175
5900,3500,5300,20650000,2,42406,10603,1,563760000,563760000,15901,5300,10601,5300,0,1,5302,20273742,20.273742
5900,3500,5300,20650000,2,42406,10603,1,563760000,563760000,15901,5300,10601,5300,0,1,5302,21192826,21.192826
5900,3500,5300,20650000,2,42406,10603,1,563760000,563760000,15901,5300,10601,5300,0,1,5302,20338605,20.338605
5900,3500,5300,20650000,2,42406,10603,1,563760000,563760000,15901,5300,10601,5300,0,1,5302,21375224,21.375224
5900,3500,5300,20650000,2,42406,10603,1,563760000,563760000,15901,5300,10601,5300,0,1,5302,20352922,20.352922
5900,3500,5300,20650000,2,42406,10603,1,563760000,563760000,15901,5300,10601,5300,0,1,5302,20311755,20.311755
5900,3500,5300,20650000,2,42406,10603,1,563760000,563760000,15901,5300,10601,5300,0,1,5302,21042021,21.042021
5900,3500,5700,20650000,2,45606,11403,1,593840000,593840000,17101,5700,11401,5700,0,1,5702,21829557,21.829557
5900,3500,5700,20650000,2,45606,11403,1,593840000,593840000,17101,5700,11401,5700,0,1,5702,22820681,22.820681
5900,3500,5700,20650000,2,45606,11403,1,593840000,593840000,17101,5700,11401,5700,0,1,5702,21887844,21.887844
5900,3500,5700,20650000,2,45606,11403,1,593840000,593840000,17101,5700,11401,5700,0,1,5702,22995627,22.995627
5900,3500,5700,20650000,2,45606,11403,1,593840000,593840000,17101,5700,11401,5700,0,1,5702,21915601,21.915601
5900,3500,5700,20650000,2,45606,11403,1,593840000,593840000,17101,5700,11401,5700,0,1,5702,21860202,21.860202
5900,3500,5700,20650000,2,45606,11403,1,593840000,593840000,17101,5700,11401,5700,0,1,5702,22591070,22.59107
5900,3500,6100,20650000,2,48806,12203,1,623920000,623920000,18301,6100,12201,6100,0,1,6102,23351366,23.351366
5900,3500,6100,20650000,2,48806,12203,1,623920000,623920000,18301,6100,12201,6100,0,1,6102,24385365,24.385365
5900,3500,6100,20650000,2,48806,12203,1,623920000,623920000,18301,6100,12201,6100,0,1,6102,23417985,23.417985
5900,3500,6100,20650000,2,48806,12203,1,623920000,623920000,18301,6100,12201,6100,0,1,6102,24557437,24.557437
5900,3500,6100,20650000,2,48806,12203,1,623920000,623920000,18301,6100,12201,6100,0,1,6102,23457993,23.457993
5900,3500,6100,20650000,2,48806,12203,1,623920000,623920000,18301,6100,12201,6100,0,1,6102,23403027,23.403027
5900,3500,6100,20650000,2,48806,12203,1,623920000,623920000,18301,6100,12201,6100,0,1,6102,24195135,24.195135
5900,3500,6500,20650000,2,52006,13003,1,654000000,654000000,19501,6500,13001,6500,0,1,6502,24832428,24.832428
5900,3500,6500,20650000,2,52006,13003,1,654000000,654000000,19501,6500,13001,6500,0,1,6502,25960284,25.960284
5900,3500,6500,20650000,2,52006,13003,1,654000000,654000000,19501,6500,13001,6500,0,1,6502,24969477,24.969477
5900,3500,6500,20650000,2,52006,13003,1,654000000,654000000,19501,6500,13001,6500,0,1,6502,26187081,26.187081
5900,3500,6500,20650000,2,52006,13003,1,654000000,654000000,19501,6500,13001,6500,0,1,6502,24939850,24.93985
5900,3500,6500,20650000,2,52006,13003,1,654000000,654000000,19501,6500,13001,6500,0,1,6502,24887316,24.887316
5900,3500,6500,20650000,2,52006,13003,1,654000000,654000000,19501,6500,13001,6500,0,1,6502,25797794,25.797794
5900,3500,6900,20650000,2,55206,13803,1,684080000,684080000,20701,6900,13801,6900,0,1,6902,26404225,26.404225
5900,3500,6900,20650000,2,55206,13803,1,684080000,684080000,20701,6900,13801,6900,0,1,6902,27596864,27.596864
5900,3500,6900,20650000,2,55206,13803,1,684080000,684080000,20701,6900,13801,6900,0,1,6902,26453475,26.453475
5900,3500,6900,20650000,2,55206,13803,1,684080000,684080000,20701,6900,13801,6900,0,1,6902,27804050,27.80405
5900,3500,6900,20650000,2,55206,13803,1,684080000,684080000,20701,6900,13801,6900,0,1,6902,26601763,26.601763
5900,3500,6900,20650000,2,55206,13803,1,684080000,684080000,20701,6900,13801,6900,0,1,6902,26403501,26.403501
5900,3500,6900,20650000,2,55206,13803,1,684080000,684080000,20701,6900,13801,6900,0,1,6902,27410489,27.410489
5900,3100,500,18290000,2,4006,1003,1,182320000,182320000,1501,500,1001,500,0,1,502,2046847,2.046847
5900,3100,500,18290000,2,4006,1003,1,182320000,182320000,1501,500,1001,500,0,1,502,2073643,2.073643
5900,3100,500,18290000,2,4006,1003,1,182320000,182320000,1501,500,1001,500,0,1,502,2026410,2.02641
5900,3100,500,18290000,2,4006,1003,1,182320000,182320000,1501,500,1001,500,0,1,502,2075357,2.075357
5900,3100,500,18290000,2,4006,1003,1,182320000,182320000,1501,500,1001,500,0,1,502,2025884,2.025884
5900,3100,500,18290000,2,4006,1003,1,182320000,182320000,1501,500,1001,500,0,1,502,2013353,2.013353
5900,3100,500,18290000,2,4006,1003,1,182320000,182320000,1501,500,1001,500,0,1,502,2060032,2.060032
5900,3100,900,18290000,2,7206,1803,1,211120000,211120000,2701,900,1801,900,0,1,902,3191736,3.191736
5900,3100,900,18290000,2,7206,1803,1,211120000,211120000,2701,900,1801,900,0,1,902,3306984,3.306984
5900,3100,900,18290000,2,7206,1803,1,211120000,211120000,2701,900,1801,900,0,1,902,3179202,3.179202
5900,3100,900,18290000,2,7206,1803,1,211120000,211120000,2701,900,1801,900,0,1,902,3333417,3.333417
5900,3100,900,18290000,2,7206,1803,1,211120000,211120000,2701,900,1801,900,0,1,902,3216938,3.216938
5900,3100,900,18290000,2,7206,1803,1,211120000,211120000,2701,900,1801,900,0,1,902,3204370,3.20437
5900,3100,900,18290000,2,7206,1803,1,211120000,211120000,2701,900,1801,900,0,1,902,3293621,3.293621
5900,3100,1300,18290000,2,10406,2603,1,239920000,239920000,3901,1300,2601,1300,0,1,1302,4501461,4.501461
5900,3100,1300,18290000,2,10406,2603,1,239920000,239920000,3901,1300,2601,1300,0,1,1302,4689743,4.689743
5900,3100,1300,18290000,2,10406,2603,1,239920000,239920000,3901,1300,2601,1300,0,1,1302,4521552,4.521552
5900,3100,1300,18290000,2,10406,2603,1,239920000,239920000,3901,1300,2601,1300,0,1,1302,4740875,4.740875
5900,3100,1300,18290000,2,10406,2603,1,239920000,239920000,3901,1300,2601,1300,0,1,1302,4550281,4.550281
5900,3100,1300,18290000,2,10406,2603,1,239920000,239920000,3901,1300,2601,1300,0,1,1302,4534136,4.534136
5900,3100,1300,18290000,2,10406,2603,1,239920000,239920000,3901,1300,2601,1300,0,1,1302,4664905,4.664905
5900,3100,1700,18290000,2,13606,3403,1,268720000,268720000,5101,1700,3401,1700,0,1,1702,5886328,5.886328
5900,3100,1700,18290000,2,13606,3403,1,268720000,268720000,5101,1700,3401,1700,0,1,1702,6087983,6.087983
5900,3100,1700,18290000,2,13606,3403,1,268720000,268720000,5101,1700,3401,1700,0,1,1702,5886657,5.886657
5900,3100,1700,18290000,2,13606,3403,1,268720000,268720000,5101,1700,3401,1700,0,1,1702,6146380,6.14638
5900,3100,1700,18290000,2,13606,3403,1,268720000,268720000,5101,1700,3401,1700,0,1,1702,5924962,5.924962
5900,3100,1700,18290000,2,13606,3403,1,268720000,268720000,5101,1700,3401,1700,0,1,1702,5872904,5.872904
5900,3100,1700,18290000,2,13606,3403,1,268720000,268720000,5101,1700,3401,1700,0,1,1702,6068832,6.068832
5900,3100,2100,18290000,2,16806,4203,1,297520000,297520000,6301,2100,4201,2100,0,1,2102,7330077,7.330077
5900,3100,2100,18290000,2,16806,4203,1,297520000,297520000,6301,2100,4201,2100,0,1,2102,7606511,7.606511
5900,3100,2100,18290000,2,16806,4203,1,297520000,297520000,6301,2100,4201,2100,0,1,2102,7365522,7.365522
5900,3100,2100,18290000,2,16806,4203,1,297520000,297520000,6301,2100,4201,2100,0,1,2102,7668652,7.668652
5900,3100,2100,18290000,2,16806,4203,1,297520000,297520000,6301,2100,4201,2100,0,1,2102,7382992,7.382992
5900,3100,2100,18290000,2,16806,4203,1,297520000,297520000,6301,2100,4201,2100,0,1,2102,7348492,7.348492
5900,3100,2100,18290000,2,16806,4203,1,297520000,297520000,6301,2100,4201,2100,0,1,2102,7559175,7.559175
5900,3100,2500,18290000,2,20006,5003,1,326320000,326320000,7501,2500,5001,2500,0,1,2502,8492686,8.492686
5900,3100,2500,18290000,2,20006,5003,1,326320000,326320000,7501,2500,5001,2500,0,1,2502,8875440,8.87544
5900,3100,2500,18290000,2,20006,5003,1,326320000,326320000,7501,2500,5001,2500,0,1,2502,8542326,8.542326
5900,3100,2500,18290000,2,20006,5003,1,326320000,326320000,7501,2500,5001,2500,0,1,2502,8958849,8.958849
5900,3100,2500,18290000,2,20006,5003,1,326320000,326320000,7501,2500,5001,2500,0,1,2502,8622278,8.622278
5900,3100,2500,18290000,2,20006,5003,1,326320000,326320000,7501,2500,5001,2500,0,1,2502,8524473,8.524473
5900,3100,2500,18290000,2,20006,5003,1,326320000,326320000,7501,2500,5001,2500,0,1,2502,8832689,8.832689
5900,3100,2900,18290000,2,23206,5803,1,355120000,355120000,8701,2900,5801,2900,0,1,2902,10020185,10.020185
5900,3100,2900,18290000,2,23206,5803,1,355120000,355120000,8701,2900,5801,2900,0,1,2902,10379319,10.379319
5900,3100,2900,18290000,2,23206,5803,1,355120000,355120000,8701,2900,5801,2900,0,1,2902,10032856,10.032856
5900,3100,2900,18290000,2,23206,5803,1,355120000,355120000,8701,2900,5801,2900,0,1,2902,10481812,10.481812
5900,3100,2900,18290000,2,23206,5803,1,355120000,355120000,8701,2900,5801,2900,0,1,2902,10129506,10.129506
5900,3100,2900,18290000,2,23206,5803,1,355120000,355120000,8701,2900,5801,2900,0,1,2902,9983082,9.983082
5900,3100,2900,18290000,2,23206,5803,1,355120000,355120000,8701,2900,5801,2900,0,1,2902,10338635,10.338635
5900,3100,3300,18290000,2,26406,6603,1,383920000,383920000,9901,3300,6601,3300,0,1,3302,11347161,11.347161
5900,3100,3300,18290000,2,26406,6603,1,383920000,383920000,9901,3300,6601,3300,0,1,3302,11767400,11.7674
5900,3100,3300,18290000,2,26406,6603,1,383920000,383920000,9901,3300,6601,3300,0,1,3302,11327601,11.327601
5900,3100,3300,18290000,2,26406,6603,1,383920000,383920000,9901,3300,6601,3300,0,1,3302,11868822,11.868822
5900,3100,3300,18290000,2,26406,6603,1,383920000,383920000,9901,3300,6601,3300,0,1,3302,11456554,11.456554
5900,3100,3300,18290000,2,26406,6603,1,383920000,383920000,9901,3300,6601,3300,0,1,3302,11370153,11.370153
5900,3100,3300,18290000,2,26406,6603,1,383920000,383920000,9901,3300,6601,3300,0,1,3302,11704582,11.704582
5900,3100,3700,18290000,2,29606,7403,1,412720000,412720000,11101,3700,7401,3700,0,1,3702,12733630,12.73363
5900,3100,3700,18290000,2,29606,7403,1,412720000,412720000,11101,3700,7401,3700,0,1,3702,13192768,13.192768
5900,3100,3700,18290000,2,29606,7403,1,412720000,412720000,11101,3700,7401,3700,0,1,3702,12698066,12.698066
5900,3100,3700,18290000,2,29606,7403,1,412720000,412720000,11101,3700,7401,3700,0,1,3702,13297676,13.297676
5900,3100,3700,18290000,2,29606,7403,1,412720000,412720000,11101,3700,7401,3700,0,1,3702,12846261,12.846261
5900,3100,3700,18290000,2,29606,7403,1,412720000,412720000,11101,3700,7401,3700,0,1,3702,12746232,12.746232
5900,3100,3700,18290000,2,29606,7403,1,412720000,412720000,11101,3700,7401,3700,0,1,3702,13130711,13.130711
5900,3100,4100,18290000,2,32806,8203,1,441520000,441520000,12301,4100,8201,4100,0,1,4102,14044457,14.044457
5900,3100,4100,18290000,2,32806,8203,1,441520000,441520000,12301,4100,8201,4100,0,1,4102,14619654,14.619654
5900,3100,4100,18290000,2,32806,8203,1,441520000,441520000,12301,4100,8201,4100,0,1,4102,13983279,13.983279
5900,3100,4100,18290000,2,32806,8203,1,441520000,441520000,12301,4100,8201,4100,0,1,4102,14675352,14.675352
5900,3100,4100,18290000,2,32806,8203,1,441520000,441520000,12301,4100,8201,4100,0,1,4102,14147597,14.147597
5900,3100,4100,18290000,2,32806,8203,1,441520000,441520000,12301,4100,8201,4100,0,1,4102,14116746,14.116746
5900,3100,4100,18290000,2,32806,8203,1,441520000,441520000,12301,4100,8201,4100,0,1,4102,14487974,14.487974
5900,3100,4500,18290000,2,36006,9003,1,470320000,470320000,13501,4500,9001,4500,0,1,4502,15405447,15.405447
5900,3100,4500,18290000,2,36006,9003,1,470320000,470320000,13501,4500,9001,4500,0,1,4502,15977381,15.977381
5900,3100,4500,18290000,2,36006,9003,1,470320000,470320000,13501,4500,9001,4500,0,1,4502,15346618,15.346618
5900,3100,4500,18290000,2,36006,9003,1,470320000,470320000,13501,4500,9001,4500,0,1,4502,16103619,16.103619
5900,3100,4500,18290000,2,36006,9003,1,470320000,470320000,13501,4500,9001,4500,0,1,4502,15509610,15.50961
5900,3100,4500,18290000,2,36006,9003,1,470320000,470320000,13501,4500,9001,4500,0,1,4502,15451446,15.451446
5900,3100,4500,18290000,2,36006,9003,1,470320000,470320000,13501,4500,9001,4500,0,1,4502,15915502,15.915502
5900,3100,4900,18290000,2,39206,9803,1,499120000,499120000,14701,4900,9801,4900,0,1,4902,16722200,16.7222
5900,3100,4900,18290000,2,39206,9803,1,499120000,499120000,14701,4900,9801,4900,0,1,4902,17422244,17.422244
5900,3100,4900,18290000,2,39206,9803,1,499120000,499120000,14701,4900,9801,4900,0,1,4902,16677131,16.677131
5900,3100,4900,18290000,2,39206,9803,1,499120000,499120000,14701,4900,9801,4900,0,1,4902,17504892,17.504892
5900,3100,4900,18290000,2,39206,9803,1,499120000,499120000,14701,4900,9801,4900,0,1,4902,16830941,16.830941
5900,3100,4900,18290000,2,39206,9803,1,499120000,499120000,14701,4900,9801,4900,0,1,4902,16789384,16.789384
5900,3100,4900,18290000,2,39206,9803,1,499120000,499120000,14701,4900,9801,4900,0,1,4902,17335527,17.335527
5900,3100,5300,18290000,2,42406,10603,1,527920000,527920000,15901,5300,10601,5300,0,1,5302,18061682,18.061682
5900,3100,5300,18290000,2,42406,10603,1,527920000,527920000,15901,5300,10601,5300,0,1,5302,18820296,18.820296
5900,3100,5300,18290000,2,42406,10603,1,527920000,527920000,15901,5300,10601,5300,0,1,5302,18031565,18.031565
5900,3100,5300,18290000,2,42406,10603,1,527920000,527920000,15901,5300,10601,5300,0,1,5302,18930883,18.930883
5900,3100,5300,18290000,2,42406,10603,1,527920000,527920000,15901,5300,10601,5300,0,1,5302,18133713,18.133713
5900,3100,5300,18290000,2,42406,10603,1,527920000,527920000,15901,5300,10601,5300,0,1,5302,18146294,18.146294
5900,3100,5300,18290000,2,42406,10603,1,527920000,527920000,15901,5300,10601,5300,0,1,5302,18695151,18.695151
5900,3100,5700,18290000,2,45606,11403,1,556720000,556720000,17101,5700,11401,5700,0,1,5702,19408680,19.40868
5900,3100,5700,18290000,2,45606,11403,1,556720000,556720000,17101,5700,11401,5700,0,1,5702,20200464,20.200464
5900,3100,5700,18290000,2,45606,11403,1,556720000,556720000,17101,5700,11401,5700,0,1,5702,19395919,19.395919
5900,3100,5700,18290000,2,45606,11403,1,556720000,556720000,17101,5700,11401,5700,0,1,5702,20379759,20.379759
5900,3100,5700,18290000,2,45606,11403,1,556720000,556720000,17101,5700,11401,5700,0,1,5702,19456655,19.456655
5900,3100,5700,18290000,2,45606,11403,1,556720000,556720000,17101,5700,11401,5700,0,1,5702,19481461,19.481461
5900,3100,5700,18290000,2,45606,11403,1,556720000,556720000,17101,5700,11401,5700,0,1,5702,20104900,20.1049
5900,3100,6100,18290000,2,48806,12203,1,585520000,585520000,18301,6100,12201,6100,0,1,6102,20712453,20.712453
5900,3100,6100,18290000,2,48806,12203,1,585520000,585520000,18301,6100,12201,6100,0,1,6102,21656959,21.656959
5900,3100,6100,18290000,2,48806,12203,1,585520000,585520000,18301,6100,12201,6100,0,1,6102,20823294,20.823294
5900,3100,6100,18290000,2,48806,12203,1,585520000,585520000,18301,6100,12201,6100,0,1,6102,21834558,21.834558
5900,3100,6100,18290000,2,48806,12203,1,585520000,585520000,18301,6100,12201,6100,0,1,6102,20867748,20.867748
5900,3100,6100,18290000,2,48806,12203,1,585520000,585520000,18301,6100,12201,6100,0,1,6102,20789492,20.789492
5900,3100,6100,18290000,2,48806,12203,1,585520000,585520000,18301,6100,12201,6100,0,1,6102,21465566,21.465566
5900,3100,6500,18290000,2,52006,13003,1,614320000,614320000,19501,6500,13001,6500,0,1,6502,22040480,22.04048
5900,3100,6500,18290000,2,52006,13003,1,614320000,614320000,19501,6500,13001,6500,0,1,6502,23015864,23.015864
5900,3100,6500,18290000,2,52006,13003,1,614320000,614320000,19501,6500,13001,6500,0,1,6502,22073110,22.07311
5900,3100,6500,18290000,2,52006,13003,1,614320000,614320000,19501,6500,13001,6500,0,1,6502,23190998,23.190998
5900,3100,6500,18290000,2,52006,13003,1,614320000,614320000,19501,6500,13001,6500,0,1,6502,22119093,22.119093
5900,3100,6500,18290000,2,52006,13003,1,614320000,614320000,19501,6500,13001,6500,0,1,6502,22145420,22.14542
5900,3100,6500,18290000,2,52006,13003,1,614320000,614320000,19501,6500,13001,6500,0,1,6502,22867778,22.867778
5900,3100,6900,18290000,2,55206,13803,1,643120000,643120000,20701,6900,13801,6900,0,1,6902,23453389,23.453389
5900,3100,6900,18290000,2,55206,13803,1,643120000,643120000,20701,6900,13801,6900,0,1,6902,24452022,24.452022
5900,3100,6900,18290000,2,55206,13803,1,643120000,643120000,20701,6900,13801,6900,0,1,6902,23454084,23.454084
5900,3100,6900,18290000,2,55206,13803,1,643120000,643120000,20701,6900,13801,6900,0,1,6902,24640458,24.640458
5900,3100,6900,18290000,2,55206,13803,1,643120000,643120000,20701,6900,13801,6900,0,1,6902,23426281,23.426281
5900,3100,6900,18290000,2,55206,13803,1,643120000,643120000,20701,6900,13801,6900,0,1,6902,23502849,23.502849
5900,3100,6900,18290000,2,55206,13803,1,643120000,643120000,20701,6900,13801,6900,0,1,6902,24279016,24.279016
5900,2700,500,15930000,2,4006,1003,1,161840000,161840000,1501,500,1001,500,0,1,502,1775838,1.775838
5900,2700,500,15930000,2,4006,1003,1,161840000,161840000,1501,500,1001,500,0,1,502,1822817,1.822817
5900,2700,500,15930000,2,4006,1003,1,161840000,161840000,1501,500,1001,500,0,1,502,1786860,1.78686
5900,2700,500,15930000,2,4006,1003,1,161840000,161840000,1501,500,1001,500,0,1,502,1799242,1.799242
5900,2700,500,15930000,2,4006,1003,1,161840000,161840000,1501,500,1001,500,0,1,502,1729384,1.729384
5900,2700,500,15930000,2,4006,1003,1,161840000,161840000,1501,500,1001,500,0,1,502,1823238,1.823238
5900,2700,500,15930000,2,4006,1003,1,161840000,161840000,1501,500,1001,500,0,1,502,1811042,1.811042
5900,2700,900,15930000,2,7206,1803,1,189360000,189360000,2701,900,1801,900,0,1,902,2778925,2.778925
5900,2700,900,15930000,2,7206,1803,1,189360000,189360000,2701,900,1801,900,0,1,902,2889390,2.88939
5900,2700,900,15930000,2,7206,1803,1,189360000,189360000,2701,900,1801,900,0,1,902,2767389,2.767389
5900,2700,900,15930000,2,7206,1803,1,189360000,189360000,2701,900,1801,900,0,1,902,2901050,2.90105
5900,2700,900,15930000,2,7206,1803,1,189360000,189360000,2701,900,1801,900,0,1,902,2778527,2.778527
5900,2700,900,15930000,2,7206,1803,1,189360000,189360000,2701,900,1801,900,0,1,902,2822344,2.822344
5900,2700,900,15930000,2,7206,1803,1,189360000,189360000,2701,900,1801,900,0,1,902,2875959,2.875959
5900,2700,1300,15930000,2,10406,2603,1,216880000,216880000,3901,1300,2601,1300,0,1,1302,3938404,3.938404
5900,2700,1300,15930000,2,10406,2603,1,216880000,216880000,3901,1300,2601,1300,0,1,1302,4099672,4.099672
5900,2700,1300,15930000,2,10406,2603,1,216880000,216880000,3901,1300,2601,1300,0,1,1302,3927260,3.92726
5900,2700,1300,15930000,2,10406,2603,1,216880000,216880000,3901,1300,2601,1300,0,1,1302,4115115,4.115115
5900,2700,1300,15930000,2,10406,2603,1,216880000,216880000,3901,1300,2601,1300,0,1,1302,3949985,3.949985
5900,2700,1300,15930000,2,10406,2603,1,216880000,216880000,3901,1300,2601,1300,0,1,1302,3938980,3.93898
5900,2700,1300,15930000,2,10406,2603,1,216880000,216880000,3901,1300,2601,1300,0,1,1302,4085417,4.085417
5900,2700,1700,15930000,2,13606,3403,1,244400000,244400000,5101,1700,3401,1700,0,1,1702,5095247,5.095247
5900,2700,1700,15930000,2,13606,3403,1,244400000,244400000,5101,1700,3401,1700,0,1,1702,5310246,5.310246
5900,2700,1700,15930000,2,13606,3403,1,244400000,244400000,5101,1700,3401,1700,0,1,1702,5094775,5.094775
5900,2700,1700,15930000,2,13606,3403,1,244400000,244400000,5101,1700,3401,1700,0,1,1702,5349894,5.349894
5900,2700,1700,15930000,2,13606,3403,1,244400000,244400000,5101,1700,3401,1700,0,1,1702,5135155,5.135155
5900,2700,1700,15930000,2,13606,3403,1,244400000,244400000,5101,1700,3401,1700,0,1,1702,5146806,5.146806
5900,2700,1700,15930000,2,13606,3403,1,244400000,244400000,5101,1700,3401,1700,0,1,1702,5285681,5.285681
5900,2700,2100,15930000,2,16806,4203,1,271920000,271920000,6301,2100,4201,2100,0,1,2102,6440206,6.440206
5900,2700,2100,15930000,2,16806,4203,1,271920000,271920000,6301,2100,4201,2100,0,1,2102,6657841,6.657841
5900,2700,2100,15930000,2,16806,4203,1,271920000,271920000,6301,2100,4201,2100,0,1,2102,6451226,6.451226
5900,2700,2100,15930000,2,16806,4203,1,271920000,271920000,6301,2100,4201,2100,0,1,2102,6738193,6.738193
5900,2700,2100,15930000,2,16806,4203,1,271920000,271920000,6301,2100,4201,2100,0,1,2102,6429167,6.429167
5900,2700,2100,15930000,2,16806,4203,1,271920000,271920000,6301,2100,4201,2100,0,1,2102,6468234,6.468234
5900,2700,2100,15930000,2,16806,4203,1,271920000,271920000,6301,2100,4201,2100,0,1,2102,6604606,6.604606
5900,2700,2500,15930000,2,20006,5003,1,299440000,299440000,7501,2500,5001,2500,0,1,2502,7418073,7.418073
5900,2700,2500,15930000,2,20006,5003,1,299440000,299440000,7501,2500,5001,2500,0,1,2502,7756728,7.756728
5900,2700,2500,15930000,2,20006,5003,1,299440000,299440000,7501,2500,5001,2500,0,1,2502,7435140,7.43514
5900,2700,2500,15930000,2,20006,5003,1,299440000,299440000,7501,2500,5001,2500,0,1,2502,7806041,7.806041
5900,2700,2500,15930000,2,20006,5003,1,299440000,299440000,7501,2500,5001,2500,0,1,2502,7484753,7.484753
5900,2700,2500,15930000,2,20006,5003,1,299440000,299440000,7501,2500,5001,2500,0,1,2502,7464743,7.464743
5900,2700,2500,15930000,2,20006,5003,1,299440000,299440000,7501,2500,5001,2500,0,1,2502,7717248,7.717248
5900,2700,2900,15930000,2,23206,5803,1,326960000,326960000,8701,2900,5801,2900,0,1,2902,8741765,8.741765
5900,2700,2900,15930000,2,23206,5803,1,326960000,326960000,8701,2900,5801,2900,0,1,2902,9124996,9.124996
5900,2700,2900,15930000,2,23206,5803,1,326960000,326960000,8701,2900,5801,2900,0,1,2902,8775779,8.775779
5900,2700,2900,15930000,2,23206,5803,1,326960000,326960000,8701,2900,5801,2900,0,1,2902,9136610,9.13661
5900,2700,2900,15930000,2,23206,5803,1,326960000,326960000,8701,2900,5801,2900,0,1,2902,8806622,8.806622
5900,2700,2900,15930000,2,23206,5803,1,326960000,326960000,8701,2900,5801,2900,0,1,2902,8826804,8.826804
5900,2700,2900,15930000,2,23206,5803,1,326960000,326960000,8701,2900,5801,2900,0,1,2902,9015922,9.015922
5900,2700,3300,15930000,2,26406,6603,1,354480000,354480000,9901,3300,6601,3300,0,1,3302,9739788,9.739788
5900,2700,3300,15930000,2,26406,6603,1,354480000,354480000,9901,3300,6601,3300,0,1,3302,10185704,10.185704
5900,2700,3300,15930000,2,26406,6603,1,354480000,354480000,9901,3300,6601,3300,0,1,3302,9770921,9.770921
5900,2700,3300,15930000,2,26406,6603,1,354480000,354480000,9901,3300,6601,3300,0,1,3302,10270085,10.270085
5900,2700,3300,15930000,2,26406,6603,1,354480000,354480000,9901,3300,6601,3300,0,1,3302,9955642,9.955642
5900,2700,3300,15930000,2,26406,6603,1,354480000,354480000,9901,3300,6601,3300,0,1,3302,9791408,9.791408
5900,2700,3300,15930000,2,26406,6603,1,354480000,354480000,9901,3300,6601,3300,0,1,3302,10088892,10.088892
5900,2700,3700,15930000,2,29606,7403,1,382000000,382000000,11101,3700,7401,3700,0,1,3702,11119116,11.119116
5900,2700,3700,15930000,2,29606,7403,1,382000000,382000000,11101,3700,7401,3700,0,1,3702,11517826,11.517826
5900,2700,3700,15930000,2,29606,7403,1,382000000,382000000,11101,3700,7401,3700,0,1,3702,11070723,11.070723
5900,2700,3700,15930000,2,29606,7403,1,382000000,382000000,11101,3700,7401,3700,0,1,3702,11602923,11.602923
5900,2700,3700,15930000,2,29606,7403,1,382000000,382000000,11101,3700,7401,3700,0,1,3702,11059646,11.059646
5900,2700,3700,15930000,2,29606,7403,1,382000000,382000000,11101,3700,7401,3700,0,1,3702,11161619,11.161619
5900,2700,3700,15930000,2,29606,7403,1,382000000,382000000,11101,3700,7401,3700,0,1,3702,11426850,11.42685
5900,2700,4100,15930000,2,32806,8203,1,409520000,409520000,12301,4100,8201,4100,0,1,4102,12236770,12.23677
5900,2700,4100,15930000,2,32806,8203,1,409520000,409520000,12301,4100,8201,4100,0,1,4102,12733600,12.7336
5900,2700,4100,15930000,2,32806,8203,1,409520000,409520000,12301,4100,8201,4100,0,1,4102,12225670,12.22567
5900,2700,4100,15930000,2,32806,8203,1,409520000,409520000,12301,4100,8201,4100,0,1,4102,12817501,12.817501
5900,2700,4100,15930000,2,32806,8203,1,409520000,409520000,12301,4100,8201,4100,0,1,4102,12255588,12.255588
5900,2700,4100,15930000,2,32806,8203,1,409520000,409520000,12301,4100,8201,4100,0,1,4102,12308961,12.308961
5900,2700,4100,15930000,2,32806,8203,1,409520000,409520000,12301,4100,8201,4100,0,1,4102,12621777,12.621777
5900,2700,4500,15930000,2,36006,9003,1,437040000,437040000,13501,4500,9001,4500,0,1,4502,13419159,13.419159
5900,2700,4500,15930000,2,36006,9003,1,437040000,437040000,13501,4500,9001,4500,0,1,4502,13941821,13.941821
5900,2700,4500,15930000,2,36006,9003,1,437040000,437040000,13501,4500,9001,4500,0,1,4502,13430355,13.430355
5900,2700,4500,15930000,2,36006,9003,1,437040000,437040000,13501,4500,9001,4500,0,1,4502,14075110,14.07511
5900,2700,4500,15930000,2,36006,9003,1,437040000,437040000,13501,4500,9001,4500,0,1,4502,13430989,13.430989
5900,2700,4500,15930000,2,36006,9003,1,437040000,437040000,13501,4500,9001,4500,0,1,4502,13460374,13.460374
5900,2700,4500,15930000,2,36006,9003,1,437040000,437040000,13501,4500,9001,4500,0,1,4502,13850807,13.850807
5900,2700,4900,15930000,2,39206,9803,1,464560000,464560000,14701,4900,9801,4900,0,1,4902,14620397,14.620397
5900,2700,4900,15930000,2,39206,9803,1,464560000,464560000,14701,4900,9801,4900,0,1,4902,15226102,15.226102
5900,2700,4900,15930000,2,39206,9803,1,464560000,464560000,14701,4900,9801,4900,0,1,4902,14620955,14.620955
5900,2700,4900,15930000,2,39206,9803,1,464560000,464560000,14701,4900,9801,4900,0,1,4902,15333504,15.333504
5900,2700,4900,15930000,2,39206,9803,1,464560000,464560000,14701,4900,9801,4900,0,1,4902,14545911,14.545911
5900,2700,4900,15930000,2,39206,9803,1,464560000,464560000,14701,4900,9801,4900,0,1,4902,14600297,14.600297
5900,2700,4900,15930000,2,39206,9803,1,464560000,464560000,14701,4900,9801,4900,0,1,4902,15131467,15.131467
5900,2700,5300,15930000,2,42406,10603,1,492080000,492080000,15901,5300,10601,5300,0,1,5302,15776522,15.776522
5900,2700,5300,15930000,2,42406,10603,1,492080000,492080000,15901,5300,10601,5300,0,1,5302,16477607,16.477607
5900,2700,5300,15930000,2,42406,10603,1,492080000,492080000,15901,5300,10601,5300,0,1,5302,15818125,15.818125
5900,2700,5300,15930000,2,42406,10603,1,492080000,492080000,15901,5300,10601,5300,0,1,5302,16526939,16.526939
5900,2700,5300,15930000,2,42406,10603,1,492080000,492080000,15901,5300,10601,5300,0,1,5302,15807023,15.807023
5900,2700,5300,15930000,2,42406,10603,1,492080000,492080000,15901,5300,10601,5300,0,1,5302,15843629,15.843629
5900,2700,5300,15930000,2,42406,10603,1,492080000,492080000,15901,5300,10601,5300,0,1,5302,16332716,16.332716
5900,2700,5700,15930000,2,45606,11403,1,519600000,519600000,17101,5700,11401,5700,0,1,5702,16948785,16.948785
5900,2700,5700,15930000,2,45606,11403,1,519600000,519600000,17101,5700,11401,5700,0,1,5702,17683575,17.683575
5900,2700,5700,15930000,2,45606,11403,1,519600000,519600000,17101,5700,11401,5700,0,1,5702,16959905,16.959905
5900,2700,5700,15930000,2,45606,11403,1,519600000,519600000,17101,5700,11401,5700,0,1,5702,17770258,17.770258
5900,2700,5700,15930000,2,45606,11403,1,519600000,519600000,17101,5700,11401,5700,0,1,5702,16971393,16.971393
5900,2700,5700,15930000,2,45606,11403,1,519600000,519600000,17101,5700,11401,5700,0,1,5702,17005954,17.005954
5900,2700,5700,15930000,2,45606,11403,1,519600000,519600000,17101,5700,11401,5700,0,1,5702,17548225,17.548225
5900,2700,6100,15930000,2,48806,12203,1,547120000,547120000,18301,6100,12201,6100,0,1,6102,18093122,18.093122
5900,2700,6100,15930000,2,48806,12203,1,547120000,547120000,18301,6100,12201,6100,0,1,6102,18856831,18.856831
5900,2700,6100,15930000,2,48806,12203,1,547120000,547120000,18301,6100,12201,6100,0,1,6102,18153452,18.153452
5900,2700,6100,15930000,2,48806,12203,1,547120000,547120000,18301,6100,12201,6100,0,1,6102,18990409,18.990409
5900,2700,6100,15930000,2,48806,12203,1,547120000,547120000,18301,6100,12201,6100,0,1,6102,18198900,18.1989
5900,2700,6100,15930000,2,48806,12203,1,547120000,547120000,18301,6100,12201,6100,0,1,6102,18165162,18.165162
5900,2700,6100,15930000,2,48806,12203,1,547120000,547120000,18301,6100,12201,6100,0,1,6102,18734532,18.734532
5900,2700,6500,15930000,2,52006,13003,1,574640000,574640000,19501,6500,13001,6500,0,1,6502,19382866,19.382866
5900,2700,6500,15930000,2,52006,13003,1,574640000,574640000,19501,6500,13001,6500,0,1,6502,20115952,20.115952
5900,2700,6500,15930000,2,52006,13003,1,574640000,574640000,19501,6500,13001,6500,0,1,6502,19359822,19.359822
5900,2700,6500,15930000,2,52006,13003,1,574640000,574640000,19501,6500,13001,6500,0,1,6502,20252488,20.252488
5900,2700,6500,15930000,2,52006,13003,1,574640000,574640000,19501,6500,13001,6500,0,1,6502,19463534,19.463534
5900,2700,6500,15930000,2,52006,13003,1,574640000,574640000,19501,6500,13001,6500,0,1,6502,19395260,19.39526
5900,2700,6500,15930000,2,52006,13003,1,574640000,574640000,19501,6500,13001,6500,0,1,6502,20048518,20.048518
5900,2700,6900,15930000,2,55206,13803,1,602160000,602160000,20701,6900,13801,6900,0,1,6902,20456299,20.456299
5900,2700,6900,15930000,2,55206,13803,1,602160000,602160000,20701,6900,13801,6900,0,1,6902,21370536,21.370536
5900,2700,6900,15930000,2,55206,13803,1,602160000,602160000,20701,6900,13801,6900,0,1,6902,20519518,20.519518
5900,2700,6900,15930000,2,55206,13803,1,602160000,602160000,20701,6900,13801,6900,0,1,6902,21521438,21.521438
5900,2700,6900,15930000,2,55206,13803,1,602160000,602160000,20701,6900,13801,6900,0,1,6902,20617739,20.617739
5900,2700,6900,15930000,2,55206,13803,1,602160000,602160000,20701,6900,13801,6900,0,1,6902,20593634,20.593634
5900,2700,6900,15930000,2,55206,13803,1,602160000,602160000,20701,6900,13801,6900,0,1,6902,21236521,21.236521
5900,2300,500,13570000,2,4006,1003,1,141360000,141360000,1501,500,1001,500,0,1,502,1575286,1.575286
5900,2300,500,13570000,2,4006,1003,1,141360000,141360000,1501,500,1001,500,0,1,502,1554647,1.554647
5900,2300,500,13570000,2,4006,1003,1,141360000,141360000,1501,500,1001,500,0,1,502,1516227,1.516227
5900,2300,500,13570000,2,4006,1003,1,141360000,141360000,1501,500,1001,500,0,1,502,1565470,1.56547
5900,2300,500,13570000,2,4006,1003,1,141360000,141360000,1501,500,1001,500,0,1,502,1565152,1.565152
5900,2300,500,13570000,2,4006,1003,1,141360000,141360000,1501,500,1001,500,0,1,502,1603544,1.603544
5900,2300,500,13570000,2,4006,1003,1,141360000,141360000,1501,500,1001,500,0,1,502,1592742,1.592742
5900,2300,900,13570000,2,7206,1803,1,167600000,167600000,2701,900,1801,900,0,1,902,2383015,2.383015
5900,2300,900,13570000,2,7206,1803,1,167600000,167600000,2701,900,1801,900,0,1,902,2458860,2.45886
5900,2300,900,13570000,2,7206,1803,1,167600000,167600000,2701,900,1801,900,0,1,902,2364841,2.364841
5900,2300,900,13570000,2,7206,1803,1,167600000,167600000,2701,900,1801,900,0,1,902,2478753,2.478753
5900,2300,900,13570000,2,7206,1803,1,167600000,167600000,2701,900,1801,900,0,1,902,2403234,2.403234
5900,2300,900,13570000,2,7206,1803,1,167600000,167600000,2701,900,1801,900,0,1,902,2419817,2.419817
5900,2300,900,13570000,2,7206,1803,1,167600000,167600000,2701,900,1801,900,0,1,902,2468746,2.468746
5900,2300,1300,13570000,2,10406,2603,1,193840000,193840000,3901,1300,2601,1300,0,1,1302,3359775,3.359775
5900,2300,1300,13570000,2,10406,2603,1,193840000,193840000,3901,1300,2601,1300,0,1,1302,3514393,3.514393
5900,2300,1300,13570000,2,10406,2603,1,193840000,193840000,3901,1300,2601,1300,0,1,1302,3383745,3.383745
5900,2300,1300,13570000,2,10406,2603,1,193840000,193840000,3901,1300,2601,1300,0,1,1302,3526548,3.526548
5900,2300,1300,13570000,2,10406,2603,1,193840000,193840000,3901,1300,2601,1300,0,1,1302,3374256,3.374256
5900,2300,1300,13570000,2,10406,2603,1,193840000,193840000,3901,1300,2601,1300,0,1,1302,3402739,3.402739
5900,2300,1300,13570000,2,10406,2603,1,193840000,193840000,3901,1300,2601,1300,0,1,1302,3492127,3.492127
5900,2300,1700,13570000,2,13606,3403,1,220080000,220080000,5101,1700,3401,1700,0,1,1702,4360596,4.360596
5900,2300,1700,13570000,2,13606,3403,1,220080000,220080000,5101,1700,3401,1700,0,1,1702,4540875,4.540875
5900,2300,1700,13570000,2,13606,3403,1,220080000,220080000,5101,1700,3401,1700,0,1,1702,4370044,4.370044
5900,2300,1700,13570000,2,13606,3403,1,220080000,220080000,5101,1700,3401,1700,0,1,1702,4577313,4.577313
5900,2300,1700,13570000,2,13606,3403,1,220080000,220080000,5101,1700,3401,1700,0,1,1702,4424605,4.424605
5900,2300,1700,13570000,2,13606,3403,1,220080000,220080000,5101,1700,3401,1700,0,1,1702,4415006,4.415006
5900,2300,1700,13570000,2,13606,3403,1,220080000,220080000,5101,1700,3401,1700,0,1,1702,4521584,4.521584
5900,2300,2100,13570000,2,16806,4203,1,246320000,246320000,6301,2100,4201,2100,0,1,2102,5453943,5.453943
5900,2300,2100,13570000,2,16806,4203,1,246320000,246320000,6301,2100,4201,2100,0,1,2102,5578113,5.578113
5900,2300,2100,13570000,2,16806,4203,1,246320000,246320000,6301,2100,4201,2100,0,1,2102,5355675,5.355675
5900,2300,2100,13570000,2,16806,4203,1,246320000,246320000,6301,2100,4201,2100,0,1,2102,5623454,5.623454
5900,2300,2100,13570000,2,16806,4203,1,246320000,246320000,6301,2100,4201,2100,0,1,2102,5421813,5.421813
5900,2300,2100,13570000,2,16806,4203,1,246320000,246320000,6301,2100,4201,2100,0,1,2102,5382026,5.382026
5900,2300,2100,13570000,2,16806,4203,1,246320000,246320000,6301,2100,4201,2100,0,1,2102,5562400,5.5624
5900,2300,2500,13570000,2,20006,5003,1,272560000,272560000,7501,2500,5001,2500,0,1,2502,6336328,6.336328
5900,2300,2500,13570000,2,20006,5003,1,272560000,272560000,7501,2500,5001,2500,0,1,2502,6734359,6.734359
5900,2300,2500,13570000,2,20006,5003,1,272560000,272560000,7501,2500,5001,2500,0,1,2502,6471481,6.471481
5900,2300,2500,13570000,2,20006,5003,1,272560000,272560000,7501,2500,5001,2500,0,1,2502,6782152,6.782152
5900,2300,2500,13570000,2,20006,5003,1,272560000,272560000,7501,2500,5001,2500,0,1,2502,6594470,6.59447
5900,2300,2500,13570000,2,20006,5003,1,272560000,272560000,7501,2500,5001,2500,0,1,2502,6584853,6.584853
5900,2300,2500,13570000,2,20006,5003,1,272560000,272560000,7501,2500,5001,2500,0,1,2502,6718068,6.718068
5900,2300,2900,13570000,2,23206,5803,1,298800000,298800000,8701,2900,5801,2900,0,1,2902,7343799,7.343799
5900,2300,2900,13570000,2,23206,5803,1,298800000,298800000,8701,2900,5801,2900,0,1,2902,7662141,7.662141
5900,2300,2900,13570000,2,23206,5803,1,298800000,298800000,8701,2900,5801,2900,0,1,2902,7353272,7.353272
5900,2300,2900,13570000,2,23206,5803,1,298800000,298800000,8701,2900,5801,2900,0,1,2902,7712500,7.7125
5900,2300,2900,13570000,2,23206,5803,1,298800000,298800000,8701,2900,5801,2900,0,1,2902,7451554,7.451554
5900,2300,2900,13570000,2,23206,5803,1,298800000,298800000,8701,2900,5801,2900,0,1,2902,7383697,7.383697
5900,2300,2900,13570000,2,23206,5803,1,298800000,298800000,8701,2900,5801,2900,0,1,2902,7632465,7.632465
5900,2300,3300,13570000,2,26406,6603,1,325040000,325040000,9901,3300,6601,3300,0,1,3302,8524462,8.524462
5900,2300,3300,13570000,2,26406,6603,1,325040000,325040000,9901,3300,6601,3300,0,1,3302,8869167,8.869167
5900,2300,3300,13570000,2,26406,6603,1,325040000,325040000,9901,3300,6601,3300,0,1,3302,8437595,8.437595
5900,2300,3300,13570000,2,26406,6603,1,325040000,325040000,9901,3300,6601,3300,0,1,3302,8879145,8.879145
5900,2300,3300,13570000,2,26406,6603,1,325040000,325040000,9901,3300,6601,3300,0,1,3302,8556273,8.556273
5900,2300,3300,13570000,2,26406,6603,1,325040000,325040000,9901,3300,6601,3300,0,1,3302,8541448,8.541448
5900,2300,3300,13570000,2,26406,6603,1,325040000,325040000,9901,3300,6601,3300,0,1,3302,8783277,8.783277
5900,2300,3700,13570000,2,29606,7403,1,351280000,351280000,11101,3700,7401,3700,0,1,3702,9500474,9.500474
5900,2300,3700,13570000,2,29606,7403,1,351280000,351280000,11101,3700,7401,3700,0,1,3702,9743008,9.743008
5900,2300,3700,13570000,2,29606,7403,1,351280000,351280000,11101,3700,7401,3700,0,1,3702,9343123,9.343123
5900,2300,3700,13570000,2,29606,7403,1,351280000,351280000,11101,3700,7401,3700,0,1,3702,9819115,9.819115
5900,2300,3700,13570000,2,29606,7403,1,351280000,351280000,11101,3700,7401,3700,0,1,3702,9399174,9.399174
5900,2300,3700,13570000,2,29606,7403,1,351280000,351280000,11101,3700,7401,3700,0,1,3702,9377364,9.377364
5900,2300,3700,13570000,2,29606,7403,1,351280000,351280000,11101,3700,7401,3700,0,1,3702,9689921,9.689921
5900,2300,4100,13570000,2,32806,8203,1,377520000,377520000,12301,4100,8201,4100,0,1,4102,10308584,10.308584
5900,2300,4100,13570000,2,32806,8203,1,377520000,377520000,12301,4100,8201,4100,0,1,4102,10874539,10.874539
5900,2300,4100,13570000,2,32806,8203,1,377520000,377520000,12301,4100,8201,4100,0,1,4102,10479285,10.479285
5900,2300,4100,13570000,2,32806,8203,1,377520000,377520000,12301,4100,8201,4100,0,1,4102,11012881,11.012881
5900,2300,4100,13570000,2,32806,8203,1,377520000,377520000,12301,4100,8201,4100,0,1,4102,10463404,10.463404
5900,2300,4100,13570000,2,32806,8203,1,377520000,377520000,12301,4100,8201,4100,0,1,4102,10525472,10.525472
5900,2300,4100,13570000,2,32806,8203,1,377520000,377520000,12301,4100,8201,4100,0,1,4102,10821370,10.82137
5900,2300,4500,13570000,2,36006,9003,1,403760000,403760000,13501,4500,9001,4500,0,1,4502,11489477,11.489477
5900,2300,4500,13570000,2,36006,9003,1,403760000,403760000,13501,4500,9001,4500,0,1,4502,11925380,11.92538
5900,2300,4500,13570000,2,36006,9003,1,403760000,403760000,13501,4500,9001,4500,0,1,4502,11517533,11.517533
5900,2300,4500,13570000,2,36006,9003,1,403760000,403760000,13501,4500,9001,4500,0,1,4502,12003578,12.003578
5900,2300,4500,13570000,2,36006,9003,1,403760000,403760000,13501,4500,9001,4500,0,1,4502,11480042,11.480042
5900,2300,4500,13570000,2,36006,9003,1,403760000,403760000,13501,4500,9001,4500,0,1,4502,11534960,11.53496
5900,2300,4500,13570000,2,36006,9003,1,403760000,403760000,13501,4500,9001,4500,0,1,4502,11861434,11.861434
5900,2300,4900,13570000,2,39206,9803,1,430000000,430000000,14701,4900,9801,4900,0,1,4902,12505113,12.505113
5900,2300,4900,13570000,2,39206,9803,1,430000000,430000000,14701,4900,9801,4900,0,1,4902,12974421,12.974421
5900,2300,4900,13570000,2,39206,9803,1,430000000,430000000,14701,4900,9801,4900,0,1,4902,12523560,12.52356
5900,2300,4900,13570000,2,39206,9803,1,430000000,430000000,14701,4900,9801,4900,0,1,4902,13072216,13.072216
5900,2300,4900,13570000,2,39206,9803,1,430000000,430000000,14701,4900,9801,4900,0,1,4902,12477807,12.477807
5900,2300,4900,13570000,2,39206,9803,1,430000000,430000000,14701,4900,9801,4900,0,1,4902,12533009,12.533009
5900,2300,4900,13570000,2,39206,9803,1,430000000,430000000,14701,4900,9801,4900,0,1,4902,12889372,12.889372
5900,2300,5300,13570000,2,42406,10603,1,456240000,456240000,15901,5300,10601,5300,0,1,5302,13531974,13.531974
5900,2300,5300,13570000,2,42406,10603,1,456240000,456240000,15901,5300,10601,5300,0,1,5302,14065862,14.065862
5900,2300,5300,13570000,2,42406,10603,1,456240000,456240000,15901,5300,10601,5300,0,1,5302,13589012,13.589012
5900,2300,5300,13570000,2,42406,10603,1,456240000,456240000,15901,5300,10601,5300,0,1,5302,14177488,14.177488
5900,2300,5300,13570000,2,42406,10603,1,456240000,456240000,15901,5300,10601,5300,0,1,5302,13541586,13.541586
5900,2300,5300,13570000,2,42406,10603,1,456240000,456240000,15901,5300,10601,5300,0,1,5302,13559379,13.559379
5900,2300,5300,13570000,2,42406,10603,1,456240000,456240000,15901,5300,10601,5300,0,1,5302,13954783,13.954783
5900,2300,5700,13570000,2,45606,11403,1,482480000,482480000,17101,5700,11401,5700,0,1,5702,14447988,14.447988
5900,2300,5700,13570000,2,45606,11403,1,482480000,482480000,17101,5700,11401,5700,0,1,5702,15064535,15.064535
5900,2300,5700,13570000,2,45606,11403,1,482480000,482480000,17101,5700,11401,5700,0,1,5702,14518369,14.518369
5900,2300,5700,13570000,2,45606,11403,1,482480000,482480000,17101,5700,11401,5700,0,1,5702,15175837,15.175837
5900,2300,5700,13570000,2,45606,11403,1,482480000,482480000,17101,5700,11401,5700,0,1,5702,14467162,14.467162
5900,2300,5700,13570000,2,45606,11403,1,482480000,482480000,17101,5700,11401,5700,0,1,5702,14536767,14.536767
5900,2300,5700,13570000,2,45606,11403,1,482480000,482480000,17101,5700,11401,5700,0,1,5702,14970790,14.97079
5900,2300,6100,13570000,2,48806,12203,1,508720000,508720000,18301,6100,12201,6100,0,1,6102,15488555,15.488555
5900,2300,6100,13570000,2,48806,12203,1,508720000,508720000,18301,6100,12201,6100,0,1,6102,16135697,16.135697
5900,2300,6100,13570000,2,48806,12203,1,508720000,508720000,18301,6100,12201,6100,0,1,6102,15478541,15.478541
5900,2300,6100,13570000,2,48806,12203,1,508720000,508720000,18301,6100,12201,6100,0,1,6102,16246790,16.24679
5900,2300,6100,13570000,2,48806,12203,1,508720000,508720000,18301,6100,12201,6100,0,1,6102,15507868,15.507868
5900,2300,6100,13570000,2,48806,12203,1,508720000,508720000,18301,6100,12201,6100,0,1,6102,15556930,15.55693
5900,2300,6100,13570000,2,48806,12203,1,508720000,508720000,18301,6100,12201,6100,0,1,6102,16026949,16.026949
5900,2300,6500,13570000,2,52006,13003,1,534960000,534960000,19501,6500,13001,6500,0,1,6502,16490084,16.490084
5900,2300,6500,13570000,2,52006,13003,1,534960000,534960000,19501,6500,13001,6500,0,1,6502,17183627,17.183627
5900,2300,6500,13570000,2,52006,13003,1,534960000,534960000,19501,6500,13001,6500,0,1,6502,16500771,16.500771
5900,2300,6500,13570000,2,52006,13003,1,534960000,534960000,19501,6500,13001,6500,0,1,6502,17312095,17.312095
5900,2300,6500,13570000,2,52006,13003,1,534960000,534960000,19501,6500,13001,6500,0,1,6502,16436355,16.436355
5900,2300,6500,13570000,2,52006,13003,1,534960000,534960000,19501,6500,13001,6500,0,1,6502,16511484,16.511484
5900,2300,6500,13570000,2,52006,13003,1,534960000,534960000,19501,6500,13001,6500,0,1,6502,17013028,17.013028
5900,2300,6900,13570000,2,55206,13803,1,561200000,561200000,20701,6900,13801,6900,0,1,6902,17466590,17.46659
5900,2300,6900,13570000,2,55206,13803,1,561200000,561200000,20701,6900,13801,6900,0,1,6902,18219901,18.219901
5900,2300,6900,13570000,2,55206,13803,1,561200000,561200000,20701,6900,13801,6900,0,1,6902,17559969,17.559969
5900,2300,6900,13570000,2,55206,13803,1,561200000,561200000,20701,6900,13801,6900,0,1,6902,18379298,18.379298
5900,2300,6900,13570000,2,55206,13803,1,561200000,561200000,20701,6900,13801,6900,0,1,6902,17512593,17.512593
5900,2300,6900,13570000,2,55206,13803,1,561200000,561200000,20701,6900,13801,6900,0,1,6902,17532982,17.532982
5900,2300,6900,13570000,2,55206,13803,1,561200000,561200000,20701,6900,13801,6900,0,1,6902,18101821,18.101821
5900,1900,500,11210000,2,4006,1003,1,120880000,120880000,1501,500,1001,500,0,1,502,1308521,1.308521
5900,1900,500,11210000,2,4006,1003,1,120880000,120880000,1501,500,1001,500,0,1,502,1309017,1.309017
5900,1900,500,11210000,2,4006,1003,1,120880000,120880000,1501,500,1001,500,0,1,502,1233943,1.233943
5900,1900,500,11210000,2,4006,1003,1,120880000,120880000,1501,500,1001,500,0,1,502,1300538,1.300538
5900,1900,500,11210000,2,4006,1003,1,120880000,120880000,1501,500,1001,500,0,1,502,1279855,1.279855
5900,1900,500,11210000,2,4006,1003,1,120880000,120880000,1501,500,1001,500,0,1,502,1338658,1.338658
5900,1900,500,11210000,2,4006,1003,1,120880000,120880000,1501,500,1001,500,0,1,502,1330342,1.330342
5900,1900,900,11210000,2,7206,1803,1,145840000,145840000,2701,900,1801,900,0,1,902,1973233,1.973233
5900,1900,900,11210000,2,7206,1803,1,145840000,145840000,2701,900,1801,900,0,1,902,2038924,2.038924
5900,1900,900,11210000,2,7206,1803,1,145840000,145840000,2701,900,1801,900,0,1,902,1956956,1.956956
5900,1900,900,11210000,2,7206,1803,1,145840000,145840000,2701,900,1801,900,0,1,902,2039559,2.039559
5900,1900,900,11210000,2,7206,1803,1,145840000,145840000,2701,900,1801,900,0,1,902,1949156,1.949156
5900,1900,900,11210000,2,7206,1803,1,145840000,145840000,2701,900,1801,900,0,1,902,2005483,2.005483
5900,1900,900,11210000,2,7206,1803,1,145840000,145840000,2701,900,1801,900,0,1,902,2047767,2.047767
5900,1900,1300,11210000,2,10406,2603,1,170800000,170800000,3901,1300,2601,1300,0,1,1302,2787816,2.787816
5900,1900,1300,11210000,2,10406,2603,1,170800000,170800000,3901,1300,2601,1300,0,1,1302,2900178,2.900178
5900,1900,1300,11210000,2,10406,2603,1,170800000,170800000,3901,1300,2601,1300,0,1,1302,2778226,2.778226
5900,1900,1300,11210000,2,10406,2603,1,170800000,170800000,3901,1300,2601,1300,0,1,1302,2908503,2.908503
5900,1900,1300,11210000,2,10406,2603,1,170800000,170800000,3901,1300,2601,1300,0,1,1302,2770358,2.770358
5900,1900,1300,11210000,2,10406,2603,1,170800000,170800000,3901,1300,2601,1300,0,1,1302,2811251,2.811251
5900,1900,1300,11210000,2,10406,2603,1,170800000,170800000,3901,1300,2601,1300,0,1,1302,2891781,2.891781
5900,1900,1700,11210000,2,13606,3403,1,195760000,195760000,5101,1700,3401,1700,0,1,1702,3594661,3.594661
5900,1900,1700,11210000,2,13606,3403,1,195760000,195760000,5101,1700,3401,1700,0,1,1702,3751349,3.751349
5900,1900,1700,11210000,2,13606,3403,1,195760000,195760000,5101,1700,3401,1700,0,1,1702,3603209,3.603209
5900,1900,1700,11210000,2,13606,3403,1,195760000,195760000,5101,1700,3401,1700,0,1,1702,3767548,3.767548
5900,1900,1700,11210000,2,13606,3403,1,195760000,195760000,5101,1700,3401,1700,0,1,1702,3602841,3.602841
5900,1900,1700,11210000,2,13606,3403,1,195760000,195760000,5101,1700,3401,1700,0,1,1702,3634797,3.634797
5900,1900,1700,11210000,2,13606,3403,1,195760000,195760000,5101,1700,3401,1700,0,1,1702,3737496,3.737496
5900,1900,2100,11210000,2,16806,4203,1,220720000,220720000,6301,2100,4201,2100,0,1,2102,4431323,4.431323
5900,1900,2100,11210000,2,16806,4203,1,220720000,220720000,6301,2100,4201,2100,0,1,2102,4612832,4.612832
5900,1900,2100,11210000,2,16806,4203,1,220720000,220720000,6301,2100,4201,2100,0,1,2102,4420570,4.42057
5900,1900,2100,11210000,2,16806,4203,1,220720000,220720000,6301,2100,4201,2100,0,1,2102,4633919,4.633919
5900,1900,2100,11210000,2,16806,4203,1,220720000,220720000,6301,2100,4201,2100,0,1,2102,4452304,4.452304
5900,1900,2100,11210000,2,16806,4203,1,220720000,220720000,6301,2100,4201,2100,0,1,2102,4460198,4.460198
5900,1900,2100,11210000,2,16806,4203,1,220720000,220720000,6301,2100,4201,2100,0,1,2102,4596031,4.596031
5900,1900,2500,11210000,2,20006,5003,1,245680000,245680000,7501,2500,5001,2500,0,1,2502,5393601,5.393601
5900,1900,2500,11210000,2,20006,5003,1,245680000,245680000,7501,2500,5001,2500,0,1,2502,5570988,5.570988
5900,1900,2500,11210000,2,20006,5003,1,245680000,245680000,7501,2500,5001,2500,0,1,2502,5249895,5.249895
5900,1900,2500,11210000,2,20006,5003,1,245680000,245680000,7501,2500,5001,2500,0,1,2502,5603328,5.603328
5900,1900,2500,11210000,2,20006,5003,1,245680000,245680000,7501,2500,5001,2500,0,1,2502,5401663,5.401663
5900,1900,2500,11210000,2,20006,5003,1,245680000,245680000,7501,2500,5001,2500,0,1,2502,5265472,5.265472
5900,1900,2500,11210000,2,20006,5003,1,245680000,245680000,7501,2500,5001,2500,0,1,2502,5562590,5.56259
5900,1900,2900,11210000,2,23206,5803,1,270640000,270640000,8701,2900,5801,2900,0,1,2902,6058749,6.058749
5900,1900,2900,11210000,2,23206,5803,1,270640000,270640000,8701,2900,5801,2900,0,1,2902,6337836,6.337836
5900,1900,2900,11210000,2,23206,5803,1,270640000,270640000,8701,2900,5801,2900,0,1,2902,6214347,6.214347
5900,1900,2900,11210000,2,23206,5803,1,270640000,270640000,8701,2900,5801,2900,0,1,2902,6375917,6.375917
5900,1900,2900,11210000,2,23206,5803,1,270640000,270640000,8701,2900,5801,2900,0,1,2902,6129114,6.129114
5900,1900,2900,11210000,2,23206,5803,1,270640000,270640000,8701,2900,5801,2900,0,1,2902,6307799,6.307799
5900,1900,2900,11210000,2,23206,5803,1,270640000,270640000,8701,2900,5801,2900,0,1,2902,6316183,6.316183
5900,1900,3300,11210000,2,26406,6603,1,295600000,295600000,9901,3300,6601,3300,0,1,3302,6875029,6.875029
5900,1900,3300,11210000,2,26406,6603,1,295600000,295600000,9901,3300,6601,3300,0,1,3302,7202375,7.202375
5900,1900,3300,11210000,2,26406,6603,1,295600000,295600000,9901,3300,6601,3300,0,1,3302,6902167,6.902167
5900,1900,3300,11210000,2,26406,6603,1,295600000,295600000,9901,3300,6601,3300,0,1,3302,7247896,7.247896
5900,1900,3300,11210000,2,26406,6603,1,295600000,295600000,9901,3300,6601,3300,0,1,3302,6967096,6.967096
5900,1900,3300,11210000,2,26406,6603,1,295600000,295600000,9901,3300,6601,3300,0,1,3302,6928698,6.928698
5900,1900,3300,11210000,2,26406,6603,1,295600000,295600000,9901,3300,6601,3300,0,1,3302,7147256,7.147256
5900,1900,3700,11210000,2,29606,7403,1,320560000,320560000,11101,3700,7401,3700,0,1,3702,7882992,7.882992
5900,1900,3700,11210000,2,29606,7403,1,320560000,320560000,11101,3700,7401,3700,0,1,3702,8215806,8.215806
5900,1900,3700,11210000,2,29606,7403,1,320560000,320560000,11101,3700,7401,3700,0,1,3702,7891363,7.891363
5900,1900,3700,11210000,2,29606,7403,1,320560000,320560000,11101,3700,7401,3700,0,1,3702,8229293,8.229293
5900,1900,3700,11210000,2,29606,7403,1,320560000,320560000,11101,3700,7401,3700,0,1,3702,7904396,7.904396
5900,1900,3700,11210000,2,29606,7403,1,320560000,320560000,11101,3700,7401,3700,0,1,3702,7912292,7.912292
5900,1900,3700,11210000,2,29606,7403,1,320560000,320560000,11101,3700,7401,3700,0,1,3702,8132596,8.132596
5900,1900,4100,11210000,2,32806,8203,1,345520000,345520000,12301,4100,8201,4100,0,1,4102,8708141,8.708141
5900,1900,4100,11210000,2,32806,8203,1,345520000,345520000,12301,4100,8201,4100,0,1,4102,9060202,9.060202
5900,1900,4100,11210000,2,32806,8203,1,345520000,345520000,12301,4100,8201,4100,0,1,4102,8574578,8.574578
5900,1900,4100,11210000,2,32806,8203,1,345520000,345520000,12301,4100,8201,4100,0,1,4102,9022427,9.022427
5900,1900,4100,11210000,2,32806,8203,1,345520000,345520000,12301,4100,8201,4100,0,1,4102,8750670,8.75067
5900,1900,4100,11210000,2,32806,8203,1,345520000,345520000,12301,4100,8201,4100,0,1,4102,8543261,8.543261
5900,1900,4100,11210000,2,32806,8203,1,345520000,345520000,12301,4100,8201,4100,0,1,4102,8981932,8.981932
5900,1900,4500,11210000,2,36006,9003,1,370480000,370480000,13501,4500,9001,4500,0,1,4502,9417604,9.417604
5900,1900,4500,11210000,2,36006,9003,1,370480000,370480000,13501,4500,9001,4500,0,1,4502,9800245,9.800245
5900,1900,4500,11210000,2,36006,9003,1,370480000,370480000,13501,4500,9001,4500,0,1,4502,9549659,9.549659
5900,1900,4500,11210000,2,36006,9003,1,370480000,370480000,13501,4500,9001,4500,0,1,4502,9987623,9.987623
5900,1900,4500,11210000,2,36006,9003,1,370480000,370480000,13501,4500,9001,4500,0,1,4502,9472189,9.472189
5900,1900,4500,11210000,2,36006,9003,1,370480000,370480000,13501,4500,9001,4500,0,1,4502,9591553,9.591553
5900,1900,4500,11210000,2,36006,9003,1,370480000,370480000,13501,4500,9001,4500,0,1,4502,9729889,9.729889
5900,1900,4900,11210000,2,39206,9803,1,395440000,395440000,14701,4900,9801,4900,0,1,4902,10367262,10.367262
5900,1900,4900,11210000,2,39206,9803,1,395440000,395440000,14701,4900,9801,4900,0,1,4902,10749430,10.74943
5900,1900,4900,11210000,2,39206,9803,1,395440000,395440000,14701,4900,9801,4900,0,1,4902,10375272,10.375272
5900,1900,4900,11210000,2,39206,9803,1,395440000,395440000,14701,4900,9801,4900,0,1,4902,10832474,10.832474
5900,1900,4900,11210000,2,39206,9803,1,395440000,395440000,14701,4900,9801,4900,0,1,4902,10432827,10.432827
5900,1900,4900,11210000,2,39206,9803,1,395440000,395440000,14701,4900,9801,4900,0,1,4902,10440752,10.440752
5900,1900,4900,11210000,2,39206,9803,1,395440000,395440000,14701,4900,9801,4900,0,1,4902,10689973,10.689973
5900,1900,5300,11210000,2,42406,10603,1,420400000,420400000,15901,5300,10601,5300,0,1,5302,11213267,11.213267
5900,1900,5300,11210000,2,42406,10603,1,420400000,420400000,15901,5300,10601,5300,0,1,5302,11644632,11.644632
5900,1900,5300,11210000,2,42406,10603,1,420400000,420400000,15901,5300,10601,5300,0,1,5302,11171057,11.171057
5900,1900,5300,11210000,2,42406,10603,1,420400000,420400000,15901,5300,10601,5300,0,1,5302,11732118,11.732118
5900,1900,5300,11210000,2,42406,10603,1,420400000,420400000,15901,5300,10601,5300,0,1,5302,11301127,11.301127
5900,1900,5300,11210000,2,42406,10603,1,420400000,420400000,15901,5300,10601,5300,0,1,5302,11309020,11.30902
5900,1900,5300,11210000,2,42406,10603,1,420400000,420400000,15901,5300,10601,5300,0,1,5302,11484637,11.484637
5900,1900,5700,11210000,2,45606,11403,1,445360000,445360000,17101,5700,11401,5700,0,1,5702,12034256,12.034256
5900,1900,5700,11210000,2,45606,11403,1,445360000,445360000,17101,5700,11401,5700,0,1,5702,12527399,12.527399
5900,1900,5700,11210000,2,45606,11403,1,445360000,445360000,17101,5700,11401,5700,0,1,5702,11999861,11.999861
5900,1900,5700,11210000,2,45606,11403,1,445360000,445360000,17101,5700,11401,5700,0,1,5702,12605687,12.605687
5900,1900,5700,11210000,2,45606,11403,1,445360000,445360000,17101,5700,11401,5700,0,1,5702,12127651,12.127651
5900,1900,5700,11210000,2,45606,11403,1,445360000,445360000,17101,5700,11401,5700,0,1,5702,12135785,12.135785
5900,1900,5700,11210000,2,45606,11403,1,445360000,445360000,17101,5700,11401,5700,0,1,5702,12337825,12.337825
5900,1900,6100,11210000,2,48806,12203,1,470320000,470320000,18301,6100,12201,6100,0,1,6102,12824834,12.824834
5900,1900,6100,11210000,2,48806,12203,1,470320000,470320000,18301,6100,12201,6100,0,1,6102,13361086,13.361086
5900,1900,6100,11210000,2,48806,12203,1,470320000,470320000,18301,6100,12201,6100,0,1,6102,12840767,12.840767
5900,1900,6100,11210000,2,48806,12203,1,470320000,470320000,18301,6100,12201,6100,0,1,6102,13432895,13.432895
5900,1900,6100,11210000,2,48806,12203,1,470320000,470320000,18301,6100,12201,6100,0,1,6102,12911090,12.91109
5900,1900,6100,11210000,2,48806,12203,1,470320000,470320000,18301,6100,12201,6100,0,1,6102,12926980,12.92698
5900,1900,6100,11210000,2,48806,12203,1,470320000,470320000,18301,6100,12201,6100,0,1,6102,13212171,13.212171
5900,1900,6500,11210000,2,52006,13003,1,495280000,495280000,19501,6500,13001,6500,0,1,6502,13669282,13.669282
5900,1900,6500,11210000,2,52006,13003,1,495280000,495280000,19501,6500,13001,6500,0,1,6502,14218688,14.218688
5900,1900,6500,11210000,2,52006,13003,1,495280000,495280000,19501,6500,13001,6500,0,1,6502,13678192,13.678192
5900,1900,6500,11210000,2,52006,13003,1,495280000,495280000,19501,6500,13001,6500,0,1,6502,14324617,14.324617
5900,1900,6500,11210000,2,52006,13003,1,495280000,495280000,19501,6500,13001,6500,0,1,6502,13741447,13.741447
5900,1900,6500,11210000,2,52006,13003,1,495280000,495280000,19501,6500,13001,6500,0,1,6502,13759976,13.759976
5900,1900,6500,11210000,2,52006,13003,1,495280000,495280000,19501,6500,13001,6500,0,1,6502,14086155,14.086155
5900,1900,6900,11210000,2,55206,13803,1,520240000,520240000,20701,6900,13801,6900,0,1,6902,14470988,14.470988
5900,1900,6900,11210000,2,55206,13803,1,520240000,520240000,20701,6900,13801,6900,0,1,6902,15062246,15.062246
5900,1900,6900,11210000,2,55206,13803,1,520240000,520240000,20701,6900,13801,6900,0,1,6902,14511442,14.511442
5900,1900,6900,11210000,2,55206,13803,1,520240000,520240000,20701,6900,13801,6900,0,1,6902,15178574,15.178574
5900,1900,6900,11210000,2,55206,13803,1,520240000,520240000,20701,6900,13801,6900,0,1,6902,14528386,14.528386
5900,1900,6900,11210000,2,55206,13803,1,520240000,520240000,20701,6900,13801,6900,0,1,6902,14492309,14.492309
5900,1900,6900,11210000,2,55206,13803,1,520240000,520240000,20701,6900,13801,6900,0,1,6902,14928106,14.928106
5900,1500,500,8850000,2,4006,1003,1,100400000,100400000,1501,500,1001,500,0,1,502,1075251,1.075251
5900,1500,500,8850000,2,4006,1003,1,100400000,100400000,1501,500,1001,500,0,1,502,1068143,1.068143
5900,1500,500,8850000,2,4006,1003,1,100400000,100400000,1501,500,1001,500,0,1,502,899033,0.899033
5900,1500,500,8850000,2,4006,1003,1,100400000,100400000,1501,500,1001,500,0,1,502,1074644,1.074644
5900,1500,500,8850000,2,4006,1003,1,100400000,100400000,1501,500,1001,500,0,1,502,1080912,1.080912
5900,1500,500,8850000,2,4006,1003,1,100400000,100400000,1501,500,1001,500,0,1,502,914799,0.914799
5900,1500,500,8850000,2,4006,1003,1,100400000,100400000,1501,500,1001,500,0,1,502,1075105,1.075105
5900,1500,900,8850000,2,7206,1803,1,124080000,124080000,2701,900,1801,900,0,1,902,1571631,1.571631
5900,1500,900,8850000,2,7206,1803,1,124080000,124080000,2701,900,1801,900,0,1,902,1618698,1.618698
5900,1500,900,8850000,2,7206,1803,1,124080000,124080000,2701,900,1801,900,0,1,902,1543004,1.543004
5900,1500,900,8850000,2,7206,1803,1,124080000,124080000,2701,900,1801,900,0,1,902,1608290,1.60829
5900,1500,900,8850000,2,7206,1803,1,124080000,124080000,2701,900,1801,900,0,1,902,1564098,1.564098
5900,1500,900,8850000,2,7206,1803,1,124080000,124080000,2701,900,1801,900,0,1,902,1587448,1.587448
5900,1500,900,8850000,2,7206,1803,1,124080000,124080000,2701,900,1801,900,0,1,902,1594046,1.594046
5900,1500,1300,8850000,2,10406,2603,1,147760000,147760000,3901,1300,2601,1300,0,1,1302,2210798,2.210798
5900,1500,1300,8850000,2,10406,2603,1,147760000,147760000,3901,1300,2601,1300,0,1,1302,2281041,2.281041
5900,1500,1300,8850000,2,10406,2603,1,147760000,147760000,3901,1300,2601,1300,0,1,1302,2342561,2.342561
5900,1500,1300,8850000,2,10406,2603,1,147760000,147760000,3901,1300,2601,1300,0,1,1302,2305783,2.305783
5900,1500,1300,8850000,2,10406,2603,1,147760000,147760000,3901,1300,2601,1300,0,1,1302,2217081,2.217081
5900,1500,1300,8850000,2,10406,2603,1,147760000,147760000,3901,1300,2601,1300,0,1,1302,2381618,2.381618
5900,1500,1300,8850000,2,10406,2603,1,147760000,147760000,3901,1300,2601,1300,0,1,1302,2251131,2.251131
5900,1500,1700,8850000,2,13606,3403,1,171440000,171440000,5101,1700,3401,1700,0,1,1702,2854197,2.854197
5900,1500,1700,8850000,2,13606,3403,1,171440000,171440000,5101,1700,3401,1700,0,1,1702,2962925,2.962925
5900,1500,1700,8850000,2,13606,3403,1,171440000,171440000,5101,1700,3401,1700,0,1,1702,2846062,2.846062
5900,1500,1700,8850000,2,13606,3403,1,171440000,171440000,5101,1700,3401,1700,0,1,1702,2990245,2.990245
5900,1500,1700,8850000,2,13606,3403,1,171440000,171440000,5101,1700,3401,1700,0,1,1702,2860644,2.860644
5900,1500,1700,8850000,2,13606,3403,1,171440000,171440000,5101,1700,3401,1700,0,1,1702,2896774,2.896774
5900,1500,1700,8850000,2,13606,3403,1,171440000,171440000,5101,1700,3401,1700,0,1,1702,2932919,2.932919
5900,1500,2100,8850000,2,16806,4203,1,195120000,195120000,6301,2100,4201,2100,0,1,2102,3513984,3.513984
5900,1500,2100,8850000,2,16806,4203,1,195120000,195120000,6301,2100,4201,2100,0,1,2102,3630849,3.630849
5900,1500,2100,8850000,2,16806,4203,1,195120000,195120000,6301,2100,4201,2100,0,1,2102,3520364,3.520364
5900,1500,2100,8850000,2,16806,4203,1,195120000,195120000,6301,2100,4201,2100,0,1,2102,3677965,3.677965
5900,1500,2100,8850000,2,16806,4203,1,195120000,195120000,6301,2100,4201,2100,0,1,2102,3527295,3.527295
5900,1500,2100,8850000,2,16806,4203,1,195120000,195120000,6301,2100,4201,2100,0,1,2102,3526861,3.526861
5900,1500,2100,8850000,2,16806,4203,1,195120000,195120000,6301,2100,4201,2100,0,1,2102,3621546,3.621546
5900,1500,2500,8850000,2,20006,5003,1,218800000,218800000,7501,2500,5001,2500,0,1,2502,4156842,4.156842
5900,1500,2500,8850000,2,20006,5003,1,218800000,218800000,7501,2500,5001,2500,0,1,2502,4326719,4.326719
5900,1500,2500,8850000,2,20006,5003,1,218800000,218800000,7501,2500,5001,2500,0,1,2502,4163164,4.163164
5900,1500,2500,8850000,2,20006,5003,1,218800000,218800000,7501,2500,5001,2500,0,1,2502,4349934,4.349934
5900,1500,2500,8850000,2,20006,5003,1,218800000,218800000,7501,2500,5001,2500,0,1,2502,4197428,4.197428
5900,1500,2500,8850000,2,20006,5003,1,218800000,218800000,7501,2500,5001,2500,0,1,2502,4150921,4.150921
5900,1500,2500,8850000,2,20006,5003,1,218800000,218800000,7501,2500,5001,2500,0,1,2502,4280751,4.280751
5900,1500,2900,8850000,2,23206,5803,1,242480000,242480000,8701,2900,5801,2900,0,1,2902,4949195,4.949195
5900,1500,2900,8850000,2,23206,5803,1,242480000,242480000,8701,2900,5801,2900,0,1,2902,5141458,5.141458
5900,1500,2900,8850000,2,23206,5803,1,242480000,242480000,8701,2900,5801,2900,0,1,2902,4810471,4.810471
5900,1500,2900,8850000,2,23206,5803,1,242480000,242480000,8701,2900,5801,2900,0,1,2902,5178336,5.178336
5900,1500,2900,8850000,2,23206,5803,1,242480000,242480000,8701,2900,5801,2900,0,1,2902,5007710,5.00771
5900,1500,2900,8850000,2,23206,5803,1,242480000,242480000,8701,2900,5801,2900,0,1,2902,4819832,4.819832
5900,1500,2900,8850000,2,23206,5803,1,242480000,242480000,8701,2900,5801,2900,0,1,2902,5077291,5.077291
5900,1500,3300,8850000,2,26406,6603,1,266160000,266160000,9901,3300,6601,3300,0,1,3302,5445428,5.445428
5900,1500,3300,8850000,2,26406,6603,1,266160000,266160000,9901,3300,6601,3300,0,1,3302,5711017,5.711017
5900,1500,3300,8850000,2,26406,6603,1,266160000,266160000,9901,3300,6601,3300,0,1,3302,5585107,5.585107
5900,1500,3300,8850000,2,26406,6603,1,266160000,266160000,9901,3300,6601,3300,0,1,3302,5750098,5.750098
5900,1500,3300,8850000,2,26406,6603,1,266160000,266160000,9901,3300,6601,3300,0,1,3302,5505897,5.505897
5900,1500,3300,8850000,2,26406,6603,1,266160000,266160000,9901,3300,6601,3300,0,1,3302,5704105,5.704105
5900,1500,3300,8850000,2,26406,6603,1,266160000,266160000,9901,3300,6601,3300,0,1,3302,5693353,5.693353
5900,1500,3700,8850000,2,29606,7403,1,289840000,289840000,11101,3700,7401,3700,0,1,3702,6121035,6.121035
5900,1500,3700,8850000,2,29606,7403,1,289840000,289840000,11101,3700,7401,3700,0,1,3702,6377268,6.377268
5900,1500,3700,8850000,2,29606,7403,1,289840000,289840000,11101,3700,7401,3700,0,1,3702,6131258,6.131258
5900,1500,3700,8850000,2,29606,7403,1,289840000,289840000,11101,3700,7401,3700,0,1,3702,6421138,6.421138
5900,1500,3700,8850000,2,29606,7403,1,289840000,289840000,11101,3700,7401,3700,0,1,3702,6176152,6.176152
5900,1500,3700,8850000,2,29606,7403,1,289840000,289840000,11101,3700,7401,3700,0,1,3702,6148575,6.148575
5900,1500,3700,8850000,2,29606,7403,1,289840000,289840000,11101,3700,7401,3700,0,1,3702,6344915,6.344915
5900,1500,4100,8850000,2,32806,8203,1,313520000,313520000,12301,4100,8201,4100,0,1,4102,6948450,6.94845
5900,1500,4100,8850000,2,32806,8203,1,313520000,313520000,12301,4100,8201,4100,0,1,4102,7188266,7.188266
5900,1500,4100,8850000,2,32806,8203,1,313520000,313520000,12301,4100,8201,4100,0,1,4102,6910294,6.910294
5900,1500,4100,8850000,2,32806,8203,1,313520000,313520000,12301,4100,8201,4100,0,1,4102,7239615,7.239615
5900,1500,4100,8850000,2,32806,8203,1,313520000,313520000,12301,4100,8201,4100,0,1,4102,6974988,6.974988
5900,1500,4100,8850000,2,32806,8203,1,313520000,313520000,12301,4100,8201,4100,0,1,4102,7008135,7.008135
5900,1500,4100,8850000,2,32806,8203,1,313520000,313520000,12301,4100,8201,4100,0,1,4102,7154962,7.154962
5900,1500,4500,8850000,2,36006,9003,1,337200000,337200000,13501,4500,9001,4500,0,1,4502,7418690,7.41869
5900,1500,4500,8850000,2,36006,9003,1,337200000,337200000,13501,4500,9001,4500,0,1,4502,7740376,7.740376
5900,1500,4500,8850000,2,36006,9003,1,337200000,337200000,13501,4500,9001,4500,0,1,4502,7435104,7.435104
5900,1500,4500,8850000,2,36006,9003,1,337200000,337200000,13501,4500,9001,4500,0,1,4502,7811163,7.811163
5900,1500,4500,8850000,2,36006,9003,1,337200000,337200000,13501,4500,9001,4500,0,1,4502,7475033,7.475033
5900,1500,4500,8850000,2,36006,9003,1,337200000,337200000,13501,4500,9001,4500,0,1,4502,7459073,7.459073
5900,1500,4500,8850000,2,36006,9003,1,337200000,337200000,13501,4500,9001,4500,0,1,4502,7723341,7.723341
5900,1500,4900,8850000,2,39206,9803,1,360880000,360880000,14701,4900,9801,4900,0,1,4902,8191898,8.191898
5900,1500,4900,8850000,2,39206,9803,1,360880000,360880000,14701,4900,9801,4900,0,1,4902,8565190,8.56519
5900,1500,4900,8850000,2,39206,9803,1,360880000,360880000,14701,4900,9801,4900,0,1,4902,8237062,8.237062
5900,1500,4900,8850000,2,39206,9803,1,360880000,360880000,14701,4900,9801,4900,0,1,4902,8587034,8.587034
5900,1500,4900,8850000,2,39206,9803,1,360880000,360880000,14701,4900,9801,4900,0,1,4902,8230747,8.230747
5900,1500,4900,8850000,2,39206,9803,1,360880000,360880000,14701,4900,9801,4900,0,1,4902,8266904,8.266904
5900,1500,4900,8850000,2,39206,9803,1,360880000,360880000,14701,4900,9801,4900,0,1,4902,8487673,8.487673
5900,1500,5300,8850000,2,42406,10603,1,384560000,384560000,15901,5300,10601,5300,0,1,5302,8894554,8.894554
5900,1500,5300,8850000,2,42406,10603,1,384560000,384560000,15901,5300,10601,5300,0,1,5302,9184816,9.184816
5900,1500,5300,8850000,2,42406,10603,1,384560000,384560000,15901,5300,10601,5300,0,1,5302,8910862,8.910862
5900,1500,5300,8850000,2,42406,10603,1,384560000,384560000,15901,5300,10601,5300,0,1,5302,9281523,9.281523
5900,1500,5300,8850000,2,42406,10603,1,384560000,384560000,15901,5300,10601,5300,0,1,5302,8894023,8.894023
5900,1500,5300,8850000,2,42406,10603,1,384560000,384560000,15901,5300,10601,5300,0,1,5302,8931157,8.931157
5900,1500,5300,8850000,2,42406,10603,1,384560000,384560000,15901,5300,10601,5300,0,1,5302,9191342,9.191342
5900,1500,5700,8850000,2,45606,11403,1,408240000,408240000,17101,5700,11401,5700,0,1,5702,9393873,9.393873
5900,1500,5700,8850000,2,45606,11403,1,408240000,408240000,17101,5700,11401,5700,0,1,5702,9802512,9.802512
5900,1500,5700,8850000,2,45606,11403,1,408240000,408240000,17101,5700,11401,5700,0,1,5702,9425415,9.425415
5900,1500,5700,8850000,2,45606,11403,1,408240000,408240000,17101,5700,11401,5700,0,1,5702,9873035,9.873035
5900,1500,5700,8850000,2,45606,11403,1,408240000,408240000,17101,5700,11401,5700,0,1,5702,9444341,9.444341
5900,1500,5700,8850000,2,45606,11403,1,408240000,408240000,17101,5700,11401,5700,0,1,5702,9437772,9.437772
5900,1500,5700,8850000,2,45606,11403,1,408240000,408240000,17101,5700,11401,5700,0,1,5702,9756785,9.756785
5900,1500,6100,8850000,2,48806,12203,1,431920000,431920000,18301,6100,12201,6100,0,1,6102,10185513,10.185513
5900,1500,6100,8850000,2,48806,12203,1,431920000,431920000,18301,6100,12201,6100,0,1,6102,10592958,10.592958
5900,1500,6100,8850000,2,48806,12203,1,431920000,431920000,18301,6100,12201,6100,0,1,6102,10143093,10.143093
5900,1500,6100,8850000,2,48806,12203,1,431920000,431920000,18301,6100,12201,6100,0,1,6102,10680491,10.680491
5900,1500,6100,8850000,2,48806,12203,1,431920000,431920000,18301,6100,12201,6100,0,1,6102,10205359,10.205359
5900,1500,6100,8850000,2,48806,12203,1,431920000,431920000,18301,6100,12201,6100,0,1,6102,10262107,10.262107
5900,1500,6100,8850000,2,48806,12203,1,431920000,431920000,18301,6100,12201,6100,0,1,6102,10552097,10.552097
5900,1500,6500,8850000,2,52006,13003,1,455600000,455600000,19501,6500,13001,6500,0,1,6502,10874007,10.874007
5900,1500,6500,8850000,2,52006,13003,1,455600000,455600000,19501,6500,13001,6500,0,1,6502,11292904,11.292904
5900,1500,6500,8850000,2,52006,13003,1,455600000,455600000,19501,6500,13001,6500,0,1,6502,10903770,10.90377
5900,1500,6500,8850000,2,52006,13003,1,455600000,455600000,19501,6500,13001,6500,0,1,6502,11365232,11.365232
5900,1500,6500,8850000,2,52006,13003,1,455600000,455600000,19501,6500,13001,6500,0,1,6502,10881289,10.881289
5900,1500,6500,8850000,2,52006,13003,1,455600000,455600000,19501,6500,13001,6500,0,1,6502,10910992,10.910992
5900,1500,6500,8850000,2,52006,13003,1,455600000,455600000,19501,6500,13001,6500,0,1,6502,11220412,11.220412
5900,1500,6900,8850000,2,55206,13803,1,479280000,479280000,20701,6900,13801,6900,0,1,6902,11533369,11.533369
5900,1500,6900,8850000,2,55206,13803,1,479280000,479280000,20701,6900,13801,6900,0,1,6902,11958027,11.958027
5900,1500,6900,8850000,2,55206,13803,1,479280000,479280000,20701,6900,13801,6900,0,1,6902,11475877,11.475877
5900,1500,6900,8850000,2,55206,13803,1,479280000,479280000,20701,6900,13801,6900,0,1,6902,12060027,12.060027
5900,1500,6900,8850000,2,55206,13803,1,479280000,479280000,20701,6900,13801,6900,0,1,6902,11541102,11.541102
5900,1500,6900,8850000,2,55206,13803,1,479280000,479280000,20701,6900,13801,6900,0,1,6902,11572910,11.57291
5900,1500,6900,8850000,2,55206,13803,1,479280000,479280000,20701,6900,13801,6900,0,1,6902,11909905,11.909905
5900,1100,500,6490000,2,4006,1003,1,79920000,79920000,1501,500,1001,500,0,1,502,668541,0.668541
5900,1100,500,6490000,2,4006,1003,1,79920000,79920000,1501,500,1001,500,0,1,502,685620,0.68562
5900,1100,500,6490000,2,4006,1003,1,79920000,79920000,1501,500,1001,500,0,1,502,663770,0.66377
5900,1100,500,6490000,2,4006,1003,1,79920000,79920000,1501,500,1001,500,0,1,502,691680,0.69168
5900,1100,500,6490000,2,4006,1003,1,79920000,79920000,1501,500,1001,500,0,1,502,659026,0.659026
5900,1100,500,6490000,2,4006,1003,1,79920000,79920000,1501,500,1001,500,0,1,502,696364,0.696364
5900,1100,500,6490000,2,4006,1003,1,79920000,79920000,1501,500,1001,500,0,1,502,701236,0.701236
5900,1100,900,6490000,2,7206,1803,1,102320000,102320000,2701,900,1801,900,0,1,902,1155781,1.155781
5900,1100,900,6490000,2,7206,1803,1,102320000,102320000,2701,900,1801,900,0,1,902,1184303,1.184303
5900,1100,900,6490000,2,7206,1803,1,102320000,102320000,2701,900,1801,900,0,1,902,1140576,1.140576
5900,1100,900,6490000,2,7206,1803,1,102320000,102320000,2701,900,1801,900,0,1,902,1192145,1.192145
5900,1100,900,6490000,2,7206,1803,1,102320000,102320000,2701,900,1801,900,0,1,902,1134040,1.13404
5900,1100,900,6490000,2,7206,1803,1,102320000,102320000,2701,900,1801,900,0,1,902,1174249,1.174249
5900,1100,900,6490000,2,7206,1803,1,102320000,102320000,2701,900,1801,900,0,1,902,1197113,1.197113
5900,1100,1300,6490000,2,10406,2603,1,124720000,124720000,3901,1300,2601,1300,0,1,1302,1631140,1.63114
5900,1100,1300,6490000,2,10406,2603,1,124720000,124720000,3901,1300,2601,1300,0,1,1302,1690544,1.690544
5900,1100,1300,6490000,2,10406,2603,1,124720000,124720000,3901,1300,2601,1300,0,1,1302,1621848,1.621848
5900,1100,1300,6490000,2,10406,2603,1,124720000,124720000,3901,1300,2601,1300,0,1,1302,1695539,1.695539
5900,1100,1300,6490000,2,10406,2603,1,124720000,124720000,3901,1300,2601,1300,0,1,1302,1612819,1.612819
5900,1100,1300,6490000,2,10406,2603,1,124720000,124720000,3901,1300,2601,1300,0,1,1302,1660803,1.660803
5900,1100,1300,6490000,2,10406,2603,1,124720000,124720000,3901,1300,2601,1300,0,1,1302,1682447,1.682447
5900,1100,1700,6490000,2,13606,3403,1,147120000,147120000,5101,1700,3401,1700,0,1,1702,2116092,2.116092
5900,1100,1700,6490000,2,13606,3403,1,147120000,147120000,5101,1700,3401,1700,0,1,1702,2187811,2.187811
5900,1100,1700,6490000,2,13606,3403,1,147120000,147120000,5101,1700,3401,1700,0,1,1702,2111308,2.111308
5900,1100,1700,6490000,2,13606,3403,1,147120000,147120000,5101,1700,3401,1700,0,1,1702,2204701,2.204701
5900,1100,1700,6490000,2,13606,3403,1,147120000,147120000,5101,1700,3401,1700,0,1,1702,2095516,2.095516
5900,1100,1700,6490000,2,13606,3403,1,147120000,147120000,5101,1700,3401,1700,0,1,1702,2128116,2.128116
5900,1100,1700,6490000,2,13606,3403,1,147120000,147120000,5101,1700,3401,1700,0,1,1702,2182788,2.182788
5900,1100,2100,6490000,2,16806,4203,1,169520000,169520000,6301,2100,4201,2100,0,1,2102,2776552,2.776552
5900,1100,2100,6490000,2,16806,4203,1,169520000,169520000,6301,2100,4201,2100,0,1,2102,2822477,2.822477
5900,1100,2100,6490000,2,16806,4203,1,169520000,169520000,6301,2100,4201,2100,0,1,2102,2732557,2.732557
5900,1100,2100,6490000,2,16806,4203,1,169520000,169520000,6301,2100,4201,2100,0,1,2102,2719332,2.719332
5900,1100,2100,6490000,2,16806,4203,1,169520000,169520000,6301,2100,4201,2100,0,1,2102,2718612,2.718612
5900,1100,2100,6490000,2,16806,4203,1,169520000,169520000,6301,2100,4201,2100,0,1,2102,2777058,2.777058
5900,1100,2100,6490000,2,16806,4203,1,169520000,169520000,6301,2100,4201,2100,0,1,2102,2790716,2.790716
5900,1100,2500,6490000,2,20006,5003,1,191920000,191920000,7501,2500,5001,2500,0,1,2502,3078019,3.078019
5900,1100,2500,6490000,2,20006,5003,1,191920000,191920000,7501,2500,5001,2500,0,1,2502,3185718,3.185718
5900,1100,2500,6490000,2,20006,5003,1,191920000,191920000,7501,2500,5001,2500,0,1,2502,3078497,3.078497
5900,1100,2500,6490000,2,20006,5003,1,191920000,191920000,7501,2500,5001,2500,0,1,2502,3212177,3.212177
5900,1100,2500,6490000,2,20006,5003,1,191920000,191920000,7501,2500,5001,2500,0,1,2502,3083343,3.083343
5900,1100,2500,6490000,2,20006,5003,1,191920000,191920000,7501,2500,5001,2500,0,1,2502,3091603,3.091603
5900,1100,2500,6490000,2,20006,5003,1,191920000,191920000,7501,2500,5001,2500,0,1,2502,3168933,3.168933
5900,1100,2900,6490000,2,23206,5803,1,214320000,214320000,8701,2900,5801,2900,0,1,2902,3555510,3.55551
5900,1100,2900,6490000,2,23206,5803,1,214320000,214320000,8701,2900,5801,2900,0,1,2902,3687867,3.687867
5900,1100,2900,6490000,2,23206,5803,1,214320000,214320000,8701,2900,5801,2900,0,1,2902,3547142,3.547142
5900,1100,2900,6490000,2,23206,5803,1,214320000,214320000,8701,2900,5801,2900,0,1,2902,3733526,3.733526
5900,1100,2900,6490000,2,23206,5803,1,214320000,214320000,8701,2900,5801,2900,0,1,2902,3560383,3.560383
5900,1100,2900,6490000,2,23206,5803,1,214320000,214320000,8701,2900,5801,2900,0,1,2902,3581613,3.581613
5900,1100,2900,6490000,2,23206,5803,1,214320000,214320000,8701,2900,5801,2900,0,1,2902,3655640,3.65564
5900,1100,3300,6490000,2,26406,6603,1,236720000,236720000,9901,3300,6601,3300,0,1,3302,4047546,4.047546
5900,1100,3300,6490000,2,26406,6603,1,236720000,236720000,9901,3300,6601,3300,0,1,3302,4182301,4.182301
5900,1100,3300,6490000,2,26406,6603,1,236720000,236720000,9901,3300,6601,3300,0,1,3302,4054951,4.054951
5900,1100,3300,6490000,2,26406,6603,1,236720000,236720000,9901,3300,6601,3300,0,1,3302,4228636,4.228636
5900,1100,3300,6490000,2,26406,6603,1,236720000,236720000,9901,3300,6601,3300,0,1,3302,4067845,4.067845
5900,1100,3300,6490000,2,26406,6603,1,236720000,236720000,9901,3300,6601,3300,0,1,3302,4042585,4.042585
5900,1100,3300,6490000,2,26406,6603,1,236720000,236720000,9901,3300,6601,3300,0,1,3302,4173500,4.1735
5900,1100,3700,6490000,2,29606,7403,1,259120000,259120000,11101,3700,7401,3700,0,1,3702,4509210,4.50921
5900,1100,3700,6490000,2,29606,7403,1,259120000,259120000,11101,3700,7401,3700,0,1,3702,4706735,4.706735
5900,1100,3700,6490000,2,29606,7403,1,259120000,259120000,11101,3700,7401,3700,0,1,3702,4501532,4.501532
5900,1100,3700,6490000,2,29606,7403,1,259120000,259120000,11101,3700,7401,3700,0,1,3702,4732960,4.73296
5900,1100,3700,6490000,2,29606,7403,1,259120000,259120000,11101,3700,7401,3700,0,1,3702,4548210,4.54821
5900,1100,3700,6490000,2,29606,7403,1,259120000,259120000,11101,3700,7401,3700,0,1,3702,4543376,4.543376
5900,1100,3700,6490000,2,29606,7403,1,259120000,259120000,11101,3700,7401,3700,0,1,3702,4668619,4.668619
5900,1100,4100,6490000,2,32806,8203,1,281520000,281520000,12301,4100,8201,4100,0,1,4102,5138285,5.138285
5900,1100,4100,6490000,2,32806,8203,1,281520000,281520000,12301,4100,8201,4100,0,1,4102,5286353,5.286353
5900,1100,4100,6490000,2,32806,8203,1,281520000,281520000,12301,4100,8201,4100,0,1,4102,5133490,5.13349
5900,1100,4100,6490000,2,32806,8203,1,281520000,281520000,12301,4100,8201,4100,0,1,4102,5346516,5.346516
5900,1100,4100,6490000,2,32806,8203,1,281520000,281520000,12301,4100,8201,4100,0,1,4102,5125476,5.125476
5900,1100,4100,6490000,2,32806,8203,1,281520000,281520000,12301,4100,8201,4100,0,1,4102,5183638,5.183638
5900,1100,4100,6490000,2,32806,8203,1,281520000,281520000,12301,4100,8201,4100,0,1,4102,5266301,5.266301
5900,1100,4500,6490000,2,36006,9003,1,303920000,303920000,13501,4500,9001,4500,0,1,4502,5469547,5.469547
5900,1100,4500,6490000,2,36006,9003,1,303920000,303920000,13501,4500,9001,4500,0,1,4502,5692420,5.69242
5900,1100,4500,6490000,2,36006,9003,1,303920000,303920000,13501,4500,9001,4500,0,1,4502,5464719,5.464719
5900,1100,4500,6490000,2,36006,9003,1,303920000,303920000,13501,4500,9001,4500,0,1,4502,5738160,5.73816
5900,1100,4500,6490000,2,36006,9003,1,303920000,303920000,13501,4500,9001,4500,0,1,4502,5519276,5.519276
5900,1100,4500,6490000,2,36006,9003,1,303920000,303920000,13501,4500,9001,4500,0,1,4502,5492827,5.492827
5900,1100,4500,6490000,2,36006,9003,1,303920000,303920000,13501,4500,9001,4500,0,1,4502,5645154,5.645154
5900,1100,4900,6490000,2,39206,9803,1,326320000,326320000,14701,4900,9801,4900,0,1,4902,6108860,6.10886
5900,1100,4900,6490000,2,39206,9803,1,326320000,326320000,14701,4900,9801,4900,0,1,4902,6197240,6.19724
5900,1100,4900,6490000,2,39206,9803,1,326320000,326320000,14701,4900,9801,4900,0,1,4902,6091352,6.091352
5900,1100,4900,6490000,2,39206,9803,1,326320000,326320000,14701,4900,9801,4900,0,1,4902,6355329,6.355329
5900,1100,4900,6490000,2,39206,9803,1,326320000,326320000,14701,4900,9801,4900,0,1,4902,6007275,6.007275
5900,1100,4900,6490000,2,39206,9803,1,326320000,326320000,14701,4900,9801,4900,0,1,4902,6145905,6.145905
5900,1100,4900,6490000,2,39206,9803,1,326320000,326320000,14701,4900,9801,4900,0,1,4902,6265081,6.265081
5900,1100,5300,6490000,2,42406,10603,1,348720000,348720000,15901,5300,10601,5300,0,1,5302,6427761,6.427761
5900,1100,5300,6490000,2,42406,10603,1,348720000,348720000,15901,5300,10601,5300,0,1,5302,6809798,6.809798
5900,1100,5300,6490000,2,42406,10603,1,348720000,348720000,15901,5300,10601,5300,0,1,5302,6432596,6.432596
5900,1100,5300,6490000,2,42406,10603,1,348720000,348720000,15901,5300,10601,5300,0,1,5302,6757903,6.757903
5900,1100,5300,6490000,2,42406,10603,1,348720000,348720000,15901,5300,10601,5300,0,1,5302,6567027,6.567027
5900,1100,5300,6490000,2,42406,10603,1,348720000,348720000,15901,5300,10601,5300,0,1,5302,6474530,6.47453
5900,1100,5300,6490000,2,42406,10603,1,348720000,348720000,15901,5300,10601,5300,0,1,5302,6643122,6.643122
5900,1100,5700,6490000,2,45606,11403,1,371120000,371120000,17101,5700,11401,5700,0,1,5702,7113948,7.113948
5900,1100,5700,6490000,2,45606,11403,1,371120000,371120000,17101,5700,11401,5700,0,1,5702,7223219,7.223219
5900,1100,5700,6490000,2,45606,11403,1,371120000,371120000,17101,5700,11401,5700,0,1,5702,7058181,7.058181
5900,1100,5700,6490000,2,45606,11403,1,371120000,371120000,17101,5700,11401,5700,0,1,5702,7366220,7.36622
5900,1100,5700,6490000,2,45606,11403,1,371120000,371120000,17101,5700,11401,5700,0,1,5702,6946101,6.946101
5900,1100,5700,6490000,2,45606,11403,1,371120000,371120000,17101,5700,11401,5700,0,1,5702,7109143,7.109143
5900,1100,5700,6490000,2,45606,11403,1,371120000,371120000,17101,5700,11401,5700,0,1,5702,7254369,7.254369
5900,1100,6100,6490000,2,48806,12203,1,393520000,393520000,18301,6100,12201,6100,0,1,6102,7400037,7.400037
5900,1100,6100,6490000,2,48806,12203,1,393520000,393520000,18301,6100,12201,6100,0,1,6102,7838054,7.838054
5900,1100,6100,6490000,2,48806,12203,1,393520000,393520000,18301,6100,12201,6100,0,1,6102,7418699,7.418699
5900,1100,6100,6490000,2,48806,12203,1,393520000,393520000,18301,6100,12201,6100,0,1,6102,7789866,7.789866
5900,1100,6100,6490000,2,48806,12203,1,393520000,393520000,18301,6100,12201,6100,0,1,6102,7576221,7.576221
5900,1100,6100,6490000,2,48806,12203,1,393520000,393520000,18301,6100,12201,6100,0,1,6102,7449728,7.449728
5900,1100,6100,6490000,2,48806,12203,1,393520000,393520000,18301,6100,12201,6100,0,1,6102,7653413,7.653413
5900,1100,6500,6490000,2,52006,13003,1,415920000,415920000,19501,6500,13001,6500,0,1,6502,8032791,8.032791
5900,1100,6500,6490000,2,52006,13003,1,415920000,415920000,19501,6500,13001,6500,0,1,6502,8216919,8.216919
5900,1100,6500,6490000,2,52006,13003,1,415920000,415920000,19501,6500,13001,6500,0,1,6502,8042713,8.042713
5900,1100,6500,6490000,2,52006,13003,1,415920000,415920000,19501,6500,13001,6500,0,1,6502,8407068,8.407068
5900,1100,6500,6490000,2,52006,13003,1,415920000,415920000,19501,6500,13001,6500,0,1,6502,7899943,7.899943
5900,1100,6500,6490000,2,52006,13003,1,415920000,415920000,19501,6500,13001,6500,0,1,6502,8094356,8.094356
5900,1100,6500,6490000,2,52006,13003,1,415920000,415920000,19501,6500,13001,6500,0,1,6502,8270367,8.270367
5900,1100,6900,6490000,2,55206,13803,1,438320000,438320000,20701,6900,13801,6900,0,1,6902,8533238,8.533238
5900,1100,6900,6490000,2,55206,13803,1,438320000,438320000,20701,6900,13801,6900,0,1,6902,8837958,8.837958
5900,1100,6900,6490000,2,55206,13803,1,438320000,438320000,20701,6900,13801,6900,0,1,6902,8370031,8.370031
5900,1100,6900,6490000,2,55206,13803,1,438320000,438320000,20701,6900,13801,6900,0,1,6902,8930505,8.930505
5900,1100,6900,6490000,2,55206,13803,1,438320000,438320000,20701,6900,13801,6900,0,1,6902,8543417,8.543417
5900,1100,6900,6490000,2,55206,13803,1,438320000,438320000,20701,6900,13801,6900,0,1,6902,8591735,8.591735
5900,1100,6900,6490000,2,55206,13803,1,438320000,438320000,20701,6900,13801,6900,0,1,6902,8733662,8.733662
5900,700,500,4130000,2,4006,1003,1,59440000,59440000,1501,500,1001,500,0,1,502,426452,0.426452
5900,700,500,4130000,2,4006,1003,1,59440000,59440000,1501,500,1001,500,0,1,502,434810,0.43481
5900,700,500,4130000,2,4006,1003,1,59440000,59440000,1501,500,1001,500,0,1,502,565515,0.565515
5900,700,500,4130000,2,4006,1003,1,59440000,59440000,1501,500,1001,500,0,1,502,437946,0.437946
5900,700,500,4130000,2,4006,1003,1,59440000,59440000,1501,500,1001,500,0,1,502,423731,0.423731
5900,700,500,4130000,2,4006,1003,1,59440000,59440000,1501,500,1001,500,0,1,502,435086,0.435086
5900,700,500,4130000,2,4006,1003,1,59440000,59440000,1501,500,1001,500,0,1,502,431360,0.43136
5900,700,900,4130000,2,7206,1803,1,80560000,80560000,2701,900,1801,900,0,1,902,741040,0.74104
5900,700,900,4130000,2,7206,1803,1,80560000,80560000,2701,900,1801,900,0,1,902,750710,0.75071
5900,700,900,4130000,2,7206,1803,1,80560000,80560000,2701,900,1801,900,0,1,902,758850,0.75885
5900,700,900,4130000,2,7206,1803,1,80560000,80560000,2701,900,1801,900,0,1,902,755650,0.75565
5900,700,900,4130000,2,7206,1803,1,80560000,80560000,2701,900,1801,900,0,1,902,727972,0.727972
5900,700,900,4130000,2,7206,1803,1,80560000,80560000,2701,900,1801,900,0,1,902,755859,0.755859
5900,700,900,4130000,2,7206,1803,1,80560000,80560000,2701,900,1801,900,0,1,902,744496,0.744496
5900,700,1300,4130000,2,10406,2603,1,101680000,101680000,3901,1300,2601,1300,0,1,1302,1052701,1.052701
5900,700,1300,4130000,2,10406,2603,1,101680000,101680000,3901,1300,2601,1300,0,1,1302,1078923,1.078923
5900,700,1300,4130000,2,10406,2603,1,101680000,101680000,3901,1300,2601,1300,0,1,1302,1036783,1.036783
5900,700,1300,4130000,2,10406,2603,1,101680000,101680000,3901,1300,2601,1300,0,1,1302,1083094,1.083094
5900,700,1300,4130000,2,10406,2603,1,101680000,101680000,3901,1300,2601,1300,0,1,1302,1033607,1.033607
5900,700,1300,4130000,2,10406,2603,1,101680000,101680000,3901,1300,2601,1300,0,1,1302,1082586,1.082586
5900,700,1300,4130000,2,10406,2603,1,101680000,101680000,3901,1300,2601,1300,0,1,1302,1057049,1.057049
5900,700,1700,4130000,2,13606,3403,1,122800000,122800000,5101,1700,3401,1700,0,1,1702,1367971,1.367971
5900,700,1700,4130000,2,13606,3403,1,122800000,122800000,5101,1700,3401,1700,0,1,1702,1400390,1.40039
5900,700,1700,4130000,2,13606,3403,1,122800000,122800000,5101,1700,3401,1700,0,1,1702,1344954,1.344954
5900,700,1700,4130000,2,13606,3403,1,122800000,122800000,5101,1700,3401,1700,0,1,1702,1405496,1.405496
5900,700,1700,4130000,2,13606,3403,1,122800000,122800000,5101,1700,3401,1700,0,1,1702,1339550,1.33955
5900,700,1700,4130000,2,13606,3403,1,122800000,122800000,5101,1700,3401,1700,0,1,1702,1387828,1.387828
5900,700,1700,4130000,2,13606,3403,1,122800000,122800000,5101,1700,3401,1700,0,1,1702,1391188,1.391188
5900,700,2100,4130000,2,16806,4203,1,143920000,143920000,6301,2100,4201,2100,0,1,2102,1665803,1.665803
5900,700,2100,4130000,2,16806,4203,1,143920000,143920000,6301,2100,4201,2100,0,1,2102,1720725,1.720725
5900,700,2100,4130000,2,16806,4203,1,143920000,143920000,6301,2100,4201,2100,0,1,2102,1653526,1.653526
5900,700,2100,4130000,2,16806,4203,1,143920000,143920000,6301,2100,4201,2100,0,1,2102,1733906,1.733906
5900,700,2100,4130000,2,16806,4203,1,143920000,143920000,6301,2100,4201,2100,0,1,2102,1650341,1.650341
5900,700,2100,4130000,2,16806,4203,1,143920000,143920000,6301,2100,4201,2100,0,1,2102,1688414,1.688414
5900,700,2100,4130000,2,16806,4203,1,143920000,143920000,6301,2100,4201,2100,0,1,2102,1699939,1.699939
5900,700,2500,4130000,2,20006,5003,1,165040000,165040000,7501,2500,5001,2500,0,1,2502,1958955,1.958955
5900,700,2500,4130000,2,20006,5003,1,165040000,165040000,7501,2500,5001,2500,0,1,2502,2181793,2.181793
5900,700,2500,4130000,2,20006,5003,1,165040000,165040000,7501,2500,5001,2500,0,1,2502,1962179,1.962179
5900,700,2500,4130000,2,20006,5003,1,165040000,165040000,7501,2500,5001,2500,0,1,2502,2060235,2.060235
5900,700,2500,4130000,2,20006,5003,1,165040000,165040000,7501,2500,5001,2500,0,1,2502,2063427,2.063427
5900,700,2500,4130000,2,20006,5003,1,165040000,165040000,7501,2500,5001,2500,0,1,2502,1989966,1.989966
5900,700,2500,4130000,2,20006,5003,1,165040000,165040000,7501,2500,5001,2500,0,1,2502,2017557,2.017557
5900,700,2900,4130000,2,23206,5803,1,186160000,186160000,8701,2900,5801,2900,0,1,2902,2311183,2.311183
5900,700,2900,4130000,2,23206,5803,1,186160000,186160000,8701,2900,5801,2900,0,1,2902,2393266,2.393266
5900,700,2900,4130000,2,23206,5803,1,186160000,186160000,8701,2900,5801,2900,0,1,2902,2295826,2.295826
5900,700,2900,4130000,2,23206,5803,1,186160000,186160000,8701,2900,5801,2900,0,1,2902,2402526,2.402526
5900,700,2900,4130000,2,23206,5803,1,186160000,186160000,8701,2900,5801,2900,0,1,2902,2295413,2.295413
5900,700,2900,4130000,2,23206,5803,1,186160000,186160000,8701,2900,5801,2900,0,1,2902,2329797,2.329797
5900,700,2900,4130000,2,23206,5803,1,186160000,186160000,8701,2900,5801,2900,0,1,2902,2360301,2.360301
5900,700,3300,4130000,2,26406,6603,1,207280000,207280000,9901,3300,6601,3300,0,1,3302,2594474,2.594474
5900,700,3300,4130000,2,26406,6603,1,207280000,207280000,9901,3300,6601,3300,0,1,3302,2687971,2.687971
5900,700,3300,4130000,2,26406,6603,1,207280000,207280000,9901,3300,6601,3300,0,1,3302,2583585,2.583585
5900,700,3300,4130000,2,26406,6603,1,207280000,207280000,9901,3300,6601,3300,0,1,3302,2714344,2.714344
5900,700,3300,4130000,2,26406,6603,1,207280000,207280000,9901,3300,6601,3300,0,1,3302,2597768,2.597768
5900,700,3300,4130000,2,26406,6603,1,207280000,207280000,9901,3300,6601,3300,0,1,3302,2614931,2.614931
5900,700,3300,4130000,2,26406,6603,1,207280000,207280000,9901,3300,6601,3300,0,1,3302,2667252,2.667252
5900,700,3700,4130000,2,29606,7403,1,228400000,228400000,11101,3700,7401,3700,0,1,3702,3107070,3.10707
5900,700,3700,4130000,2,29606,7403,1,228400000,228400000,11101,3700,7401,3700,0,1,3702,3016392,3.016392
5900,700,3700,4130000,2,29606,7403,1,228400000,228400000,11101,3700,7401,3700,0,1,3702,2894222,2.894222
5900,700,3700,4130000,2,29606,7403,1,228400000,228400000,11101,3700,7401,3700,0,1,3702,3163934,3.163934
5900,700,3700,4130000,2,29606,7403,1,228400000,228400000,11101,3700,7401,3700,0,1,3702,2917461,2.917461
5900,700,3700,4130000,2,29606,7403,1,228400000,228400000,11101,3700,7401,3700,0,1,3702,3112516,3.112516
5900,700,3700,4130000,2,29606,7403,1,228400000,228400000,11101,3700,7401,3700,0,1,3702,3103950,3.10395
5900,700,4100,4130000,2,32806,8203,1,249520000,249520000,12301,4100,8201,4100,0,1,4102,3218366,3.218366
5900,700,4100,4130000,2,32806,8203,1,249520000,249520000,12301,4100,8201,4100,0,1,4102,3338064,3.338064
5900,700,4100,4130000,2,32806,8203,1,249520000,249520000,12301,4100,8201,4100,0,1,4102,3324066,3.324066
5900,700,4100,4130000,2,32806,8203,1,249520000,249520000,12301,4100,8201,4100,0,1,4102,3367341,3.367341
5900,700,4100,4130000,2,32806,8203,1,249520000,249520000,12301,4100,8201,4100,0,1,4102,3221661,3.221661
5900,700,4100,4130000,2,32806,8203,1,249520000,249520000,12301,4100,8201,4100,0,1,4102,3237254,3.237254
5900,700,4100,4130000,2,32806,8203,1,249520000,249520000,12301,4100,8201,4100,0,1,4102,3305030,3.30503
5900,700,4500,4130000,2,36006,9003,1,270640000,270640000,13501,4500,9001,4500,0,1,4502,3525129,3.525129
5900,700,4500,4130000,2,36006,9003,1,270640000,270640000,13501,4500,9001,4500,0,1,4502,3663031,3.663031
5900,700,4500,4130000,2,36006,9003,1,270640000,270640000,13501,4500,9001,4500,0,1,4502,3518247,3.518247
5900,700,4500,4130000,2,36006,9003,1,270640000,270640000,13501,4500,9001,4500,0,1,4502,3698712,3.698712
5900,700,4500,4130000,2,36006,9003,1,270640000,270640000,13501,4500,9001,4500,0,1,4502,3538945,3.538945
5900,700,4500,4130000,2,36006,9003,1,270640000,270640000,13501,4500,9001,4500,0,1,4502,3559031,3.559031
5900,700,4500,4130000,2,36006,9003,1,270640000,270640000,13501,4500,9001,4500,0,1,4502,3631626,3.631626
5900,700,4900,4130000,2,39206,9803,1,291760000,291760000,14701,4900,9801,4900,0,1,4902,3814710,3.81471
5900,700,4900,4130000,2,39206,9803,1,291760000,291760000,14701,4900,9801,4900,0,1,4902,4091127,4.091127
5900,700,4900,4130000,2,39206,9803,1,291760000,291760000,14701,4900,9801,4900,0,1,4902,3826033,3.826033
5900,700,4900,4130000,2,39206,9803,1,291760000,291760000,14701,4900,9801,4900,0,1,4902,4018400,4.0184
5900,700,4900,4130000,2,39206,9803,1,291760000,291760000,14701,4900,9801,4900,0,1,4902,3975803,3.975803
5900,700,4900,4130000,2,39206,9803,1,291760000,291760000,14701,4900,9801,4900,0,1,4902,3861889,3.861889
5900,700,4900,4130000,2,39206,9803,1,291760000,291760000,14701,4900,9801,4900,0,1,4902,3948062,3.948062
5900,700,5300,4130000,2,42406,10603,1,312880000,312880000,15901,5300,10601,5300,0,1,5302,4145694,4.145694
5900,700,5300,4130000,2,42406,10603,1,312880000,312880000,15901,5300,10601,5300,0,1,5302,4310134,4.310134
5900,700,5300,4130000,2,42406,10603,1,312880000,312880000,15901,5300,10601,5300,0,1,5302,4140808,4.140808
5900,700,5300,4130000,2,42406,10603,1,312880000,312880000,15901,5300,10601,5300,0,1,5302,4445132,4.445132
5900,700,5300,4130000,2,42406,10603,1,312880000,312880000,15901,5300,10601,5300,0,1,5302,4176947,4.176947
5900,700,5300,4130000,2,42406,10603,1,312880000,312880000,15901,5300,10601,5300,0,1,5302,4343277,4.343277
5900,700,5300,4130000,2,42406,10603,1,312880000,312880000,15901,5300,10601,5300,0,1,5302,4271079,4.271079
5900,700,5700,4130000,2,45606,11403,1,334000000,334000000,17101,5700,11401,5700,0,1,5702,4671397,4.671397
5900,700,5700,4130000,2,45606,11403,1,334000000,334000000,17101,5700,11401,5700,0,1,5702,4643768,4.643768
5900,700,5700,4130000,2,45606,11403,1,334000000,334000000,17101,5700,11401,5700,0,1,5702,4608575,4.608575
5900,700,5700,4130000,2,45606,11403,1,334000000,334000000,17101,5700,11401,5700,0,1,5702,4686610,4.68661
5900,700,5700,4130000,2,45606,11403,1,334000000,334000000,17101,5700,11401,5700,0,1,5702,4484762,4.484762
5900,700,5700,4130000,2,45606,11403,1,334000000,334000000,17101,5700,11401,5700,0,1,5702,4470576,4.470576
5900,700,5700,4130000,2,45606,11403,1,334000000,334000000,17101,5700,11401,5700,0,1,5702,4710534,4.710534
5900,700,6100,4130000,2,48806,12203,1,355120000,355120000,18301,6100,12201,6100,0,1,6102,4777495,4.777495
5900,700,6100,4130000,2,48806,12203,1,355120000,355120000,18301,6100,12201,6100,0,1,6102,4979429,4.979429
5900,700,6100,4130000,2,48806,12203,1,355120000,355120000,18301,6100,12201,6100,0,1,6102,4776944,4.776944
5900,700,6100,4130000,2,48806,12203,1,355120000,355120000,18301,6100,12201,6100,0,1,6102,5011674,5.011674
5900,700,6100,4130000,2,48806,12203,1,355120000,355120000,18301,6100,12201,6100,0,1,6102,4813654,4.813654
5900,700,6100,4130000,2,48806,12203,1,355120000,355120000,18301,6100,12201,6100,0,1,6102,4805222,4.805222
5900,700,6100,4130000,2,48806,12203,1,355120000,355120000,18301,6100,12201,6100,0,1,6102,4936153,4.936153
5900,700,6500,4130000,2,52006,13003,1,376240000,376240000,19501,6500,13001,6500,0,1,6502,5069174,5.069174
5900,700,6500,4130000,2,52006,13003,1,376240000,376240000,19501,6500,13001,6500,0,1,6502,5425605,5.425605
5900,700,6500,4130000,2,52006,13003,1,376240000,376240000,19501,6500,13001,6500,0,1,6502,5084134,5.084134
5900,700,6500,4130000,2,52006,13003,1,376240000,376240000,19501,6500,13001,6500,0,1,6502,5331901,5.331901
5900,700,6500,4130000,2,52006,13003,1,376240000,376240000,19501,6500,13001,6500,0,1,6502,5266572,5.266572
5900,700,6500,4130000,2,52006,13003,1,376240000,376240000,19501,6500,13001,6500,0,1,6502,5124444,5.124444
5900,700,6500,4130000,2,52006,13003,1,376240000,376240000,19501,6500,13001,6500,0,1,6502,5273692,5.273692
5900,700,6900,4130000,2,55206,13803,1,397360000,397360000,20701,6900,13801,6900,0,1,6902,5582064,5.582064
5900,700,6900,4130000,2,55206,13803,1,397360000,397360000,20701,6900,13801,6900,0,1,6902,5628241,5.628241
5900,700,6900,4130000,2,55206,13803,1,397360000,397360000,20701,6900,13801,6900,0,1,6902,5560199,5.560199
5900,700,6900,4130000,2,55206,13803,1,397360000,397360000,20701,6900,13801,6900,0,1,6902,5784732,5.784732
5900,700,6900,4130000,2,55206,13803,1,397360000,397360000,20701,6900,13801,6900,0,1,6902,5423862,5.423862
5900,700,6900,4130000,2,55206,13803,1,397360000,397360000,20701,6900,13801,6900,0,1,6902,5621340,5.62134
5900,700,6900,4130000,2,55206,13803,1,397360000,397360000,20701,6900,13801,6900,0,1,6902,5731471,5.731471
5900,300,500,1770000,2,4006,1003,1,38960000,38960000,1501,500,1001,500,0,1,502,184148,0.184148
5900,300,500,1770000,2,4006,1003,1,38960000,38960000,1501,500,1001,500,0,1,502,188635,0.188635
5900,300,500,1770000,2,4006,1003,1,38960000,38960000,1501,500,1001,500,0,1,502,188884,0.188884
5900,300,500,1770000,2,4006,1003,1,38960000,38960000,1501,500,1001,500,0,1,502,187231,0.187231
5900,300,500,1770000,2,4006,1003,1,38960000,38960000,1501,500,1001,500,0,1,502,182679,0.182679
5900,300,500,1770000,2,4006,1003,1,38960000,38960000,1501,500,1001,500,0,1,502,191862,0.191862
5900,300,500,1770000,2,4006,1003,1,38960000,38960000,1501,500,1001,500,0,1,502,197534,0.197534
5900,300,900,1770000,2,7206,1803,1,58800000,58800000,2701,900,1801,900,0,1,902,314411,0.314411
5900,300,900,1770000,2,7206,1803,1,58800000,58800000,2701,900,1801,900,0,1,902,321802,0.321802
5900,300,900,1770000,2,7206,1803,1,58800000,58800000,2701,900,1801,900,0,1,902,318443,0.318443
5900,300,900,1770000,2,7206,1803,1,58800000,58800000,2701,900,1801,900,0,1,902,316920,0.31692
5900,300,900,1770000,2,7206,1803,1,58800000,58800000,2701,900,1801,900,0,1,902,311465,0.311465
5900,300,900,1770000,2,7206,1803,1,58800000,58800000,2701,900,1801,900,0,1,902,328209,0.328209
5900,300,900,1770000,2,7206,1803,1,58800000,58800000,2701,900,1801,900,0,1,902,326840,0.32684
5900,300,1300,1770000,2,10406,2603,1,78640000,78640000,3901,1300,2601,1300,0,1,1302,450111,0.450111
5900,300,1300,1770000,2,10406,2603,1,78640000,78640000,3901,1300,2601,1300,0,1,1302,465688,0.465688
5900,300,1300,1770000,2,10406,2603,1,78640000,78640000,3901,1300,2601,1300,0,1,1302,453598,0.453598
5900,300,1300,1770000,2,10406,2603,1,78640000,78640000,3901,1300,2601,1300,0,1,1302,462606,0.462606
5900,300,1300,1770000,2,10406,2603,1,78640000,78640000,3901,1300,2601,1300,0,1,1302,449722,0.449722
5900,300,1300,1770000,2,10406,2603,1,78640000,78640000,3901,1300,2601,1300,0,1,1302,469125,0.469125
5900,300,1300,1770000,2,10406,2603,1,78640000,78640000,3901,1300,2601,1300,0,1,1302,470608,0.470608
5900,300,1700,1770000,2,13606,3403,1,98480000,98480000,5101,1700,3401,1700,0,1,1702,594362,0.594362
5900,300,1700,1770000,2,13606,3403,1,98480000,98480000,5101,1700,3401,1700,0,1,1702,620577,0.620577
5900,300,1700,1770000,2,13606,3403,1,98480000,98480000,5101,1700,3401,1700,0,1,1702,594088,0.594088
5900,300,1700,1770000,2,13606,3403,1,98480000,98480000,5101,1700,3401,1700,0,1,1702,620849,0.620849
5900,300,1700,1770000,2,13606,3403,1,98480000,98480000,5101,1700,3401,1700,0,1,1702,593765,0.593765
5900,300,1700,1770000,2,13606,3403,1,98480000,98480000,5101,1700,3401,1700,0,1,1702,612102,0.612102
5900,300,1700,1770000,2,13606,3403,1,98480000,98480000,5101,1700,3401,1700,0,1,1702,619242,0.619242
5900,300,2100,1770000,2,16806,4203,1,118320000,118320000,6301,2100,4201,2100,0,1,2102,733899,0.733899
5900,300,2100,1770000,2,16806,4203,1,118320000,118320000,6301,2100,4201,2100,0,1,2102,763466,0.763466
5900,300,2100,1770000,2,16806,4203,1,118320000,118320000,6301,2100,4201,2100,0,1,2102,727749,0.727749
5900,300,2100,1770000,2,16806,4203,1,118320000,118320000,6301,2100,4201,2100,0,1,2102,765121,0.765121
5900,300,2100,1770000,2,16806,4203,1,118320000,118320000,6301,2100,4201,2100,0,1,2102,725035,0.725035
5900,300,2100,1770000,2,16806,4203,1,118320000,118320000,6301,2100,4201,2100,0,1,2102,755357,0.755357
5900,300,2100,1770000,2,16806,4203,1,118320000,118320000,6301,2100,4201,2100,0,1,2102,759428,0.759428
5900,300,2500,1770000,2,20006,5003,1,138160000,138160000,7501,2500,5001,2500,0,1,2502,872531,0.872531
5900,300,2500,1770000,2,20006,5003,1,138160000,138160000,7501,2500,5001,2500,0,1,2502,913191,0.913191
5900,300,2500,1770000,2,20006,5003,1,138160000,138160000,7501,2500,5001,2500,0,1,2502,867290,0.86729
5900,300,2500,1770000,2,20006,5003,1,138160000,138160000,7501,2500,5001,2500,0,1,2502,912638,0.912638
5900,300,2500,1770000,2,20006,5003,1,138160000,138160000,7501,2500,5001,2500,0,1,2502,861989,0.861989
5900,300,2500,1770000,2,20006,5003,1,138160000,138160000,7501,2500,5001,2500,0,1,2502,911091,0.911091
5900,300,2500,1770000,2,20006,5003,1,138160000,138160000,7501,2500,5001,2500,0,1,2502,912957,0.912957
5900,300,2900,1770000,2,23206,5803,1,158000000,158000000,8701,2900,5801,2900,0,1,2902,1019486,1.019486
5900,300,2900,1770000,2,23206,5803,1,158000000,158000000,8701,2900,5801,2900,0,1,2902,1059885,1.059885
5900,300,2900,1770000,2,23206,5803,1,158000000,158000000,8701,2900,5801,2900,0,1,2902,1002880,1.00288
5900,300,2900,1770000,2,23206,5803,1,158000000,158000000,8701,2900,5801,2900,0,1,2902,1062378,1.062378
5900,300,2900,1770000,2,23206,5803,1,158000000,158000000,8701,2900,5801,2900,0,1,2902,1001260,1.00126
5900,300,2900,1770000,2,23206,5803,1,158000000,158000000,8701,2900,5801,2900,0,1,2902,1055657,1.055657
5900,300,2900,1770000,2,23206,5803,1,158000000,158000000,8701,2900,5801,2900,0,1,2902,1050254,1.050254
5900,300,3300,1770000,2,26406,6603,1,177840000,177840000,9901,3300,6601,3300,0,1,3302,1154769,1.154769
5900,300,3300,1770000,2,26406,6603,1,177840000,177840000,9901,3300,6601,3300,0,1,3302,1200833,1.200833
5900,300,3300,1770000,2,26406,6603,1,177840000,177840000,9901,3300,6601,3300,0,1,3302,1135226,1.135226
5900,300,3300,1770000,2,26406,6603,1,177840000,177840000,9901,3300,6601,3300,0,1,3302,1205111,1.205111
5900,300,3300,1770000,2,26406,6603,1,177840000,177840000,9901,3300,6601,3300,0,1,3302,1140623,1.140623
5900,300,3300,1770000,2,26406,6603,1,177840000,177840000,9901,3300,6601,3300,0,1,3302,1175112,1.175112
5900,300,3300,1770000,2,26406,6603,1,177840000,177840000,9901,3300,6601,3300,0,1,3302,1187747,1.187747
5900,300,3700,1770000,2,29606,7403,1,197680000,197680000,11101,3700,7401,3700,0,1,3702,1300748,1.300748
5900,300,3700,1770000,2,29606,7403,1,197680000,197680000,11101,3700,7401,3700,0,1,3702,1347984,1.347984
5900,300,3700,1770000,2,29606,7403,1,197680000,197680000,11101,3700,7401,3700,0,1,3702,1275982,1.275982
5900,300,3700,1770000,2,29606,7403,1,197680000,197680000,11101,3700,7401,3700,0,1,3702,1355000,1.355
5900,300,3700,1770000,2,29606,7403,1,197680000,197680000,11101,3700,7401,3700,0,1,3702,1279502,1.279502
5900,300,3700,1770000,2,29606,7403,1,197680000,197680000,11101,3700,7401,3700,0,1,3702,1331381,1.331381
5900,300,3700,1770000,2,29606,7403,1,197680000,197680000,11101,3700,7401,3700,0,1,3702,1340527,1.340527
5900,300,4100,1770000,2,32806,8203,1,217520000,217520000,12301,4100,8201,4100,0,1,4102,1434887,1.434887
5900,300,4100,1770000,2,32806,8203,1,217520000,217520000,12301,4100,8201,4100,0,1,4102,1594213,1.594213
5900,300,4100,1770000,2,32806,8203,1,217520000,217520000,12301,4100,8201,4100,0,1,4102,1418755,1.418755
5900,300,4100,1770000,2,32806,8203,1,217520000,217520000,12301,4100,8201,4100,0,1,4102,1484002,1.484002
5900,300,4100,1770000,2,32806,8203,1,217520000,217520000,12301,4100,8201,4100,0,1,4102,1557780,1.55778
5900,300,4100,1770000,2,32806,8203,1,217520000,217520000,12301,4100,8201,4100,0,1,4102,1451589,1.451589
5900,300,4100,1770000,2,32806,8203,1,217520000,217520000,12301,4100,8201,4100,0,1,4102,1478088,1.478088
5900,300,4500,1770000,2,36006,9003,1,237360000,237360000,13501,4500,9001,4500,0,1,4502,1576062,1.576062
5900,300,4500,1770000,2,36006,9003,1,237360000,237360000,13501,4500,9001,4500,0,1,4502,1610375,1.610375
5900,300,4500,1770000,2,36006,9003,1,237360000,237360000,13501,4500,9001,4500,0,1,4502,1556174,1.556174
5900,300,4500,1770000,2,36006,9003,1,237360000,237360000,13501,4500,9001,4500,0,1,4502,1629041,1.629041
5900,300,4500,1770000,2,36006,9003,1,237360000,237360000,13501,4500,9001,4500,0,1,4502,1561081,1.561081
5900,300,4500,1770000,2,36006,9003,1,237360000,237360000,13501,4500,9001,4500,0,1,4502,1585011,1.585011
5900,300,4500,1770000,2,36006,9003,1,237360000,237360000,13501,4500,9001,4500,0,1,4502,1613878,1.613878
5900,300,4900,1770000,2,39206,9803,1,257200000,257200000,14701,4900,9801,4900,0,1,4902,1868829,1.868829
5900,300,4900,1770000,2,39206,9803,1,257200000,257200000,14701,4900,9801,4900,0,1,4902,1781324,1.781324
5900,300,4900,1770000,2,39206,9803,1,257200000,257200000,14701,4900,9801,4900,0,1,4902,1856556,1.856556
5900,300,4900,1770000,2,39206,9803,1,257200000,257200000,14701,4900,9801,4900,0,1,4902,1904597,1.904597
5900,300,4900,1770000,2,39206,9803,1,257200000,257200000,14701,4900,9801,4900,0,1,4902,1699764,1.699764
5900,300,4900,1770000,2,39206,9803,1,257200000,257200000,14701,4900,9801,4900,0,1,4902,1791641,1.791641
5900,300,4900,1770000,2,39206,9803,1,257200000,257200000,14701,4900,9801,4900,0,1,4902,1801269,1.801269
5900,300,5300,1770000,2,42406,10603,1,277040000,277040000,15901,5300,10601,5300,0,1,5302,1856704,1.856704
5900,300,5300,1770000,2,42406,10603,1,277040000,277040000,15901,5300,10601,5300,0,1,5302,1939174,1.939174
5900,300,5300,1770000,2,42406,10603,1,277040000,277040000,15901,5300,10601,5300,0,1,5302,1839009,1.839009
5900,300,5300,1770000,2,42406,10603,1,277040000,277040000,15901,5300,10601,5300,0,1,5302,1940937,1.940937
5900,300,5300,1770000,2,42406,10603,1,277040000,277040000,15901,5300,10601,5300,0,1,5302,1840772,1.840772
5900,300,5300,1770000,2,42406,10603,1,277040000,277040000,15901,5300,10601,5300,0,1,5302,1900686,1.900686
5900,300,5300,1770000,2,42406,10603,1,277040000,277040000,15901,5300,10601,5300,0,1,5302,1923846,1.923846
5900,300,5700,1770000,2,45606,11403,1,296880000,296880000,17101,5700,11401,5700,0,1,5702,1983240,1.98324
5900,300,5700,1770000,2,45606,11403,1,296880000,296880000,17101,5700,11401,5700,0,1,5702,2084709,2.084709
5900,300,5700,1770000,2,45606,11403,1,296880000,296880000,17101,5700,11401,5700,0,1,5702,1981401,1.981401
5900,300,5700,1770000,2,45606,11403,1,296880000,296880000,17101,5700,11401,5700,0,1,5702,2095350,2.09535
5900,300,5700,1770000,2,45606,11403,1,296880000,296880000,17101,5700,11401,5700,0,1,5702,1986390,1.98639
5900,300,5700,1770000,2,45606,11403,1,296880000,296880000,17101,5700,11401,5700,0,1,5702,2029492,2.029492
5900,300,5700,1770000,2,45606,11403,1,296880000,296880000,17101,5700,11401,5700,0,1,5702,2063073,2.063073
5900,300,6100,1770000,2,48806,12203,1,316720000,316720000,18301,6100,12201,6100,0,1,6102,2160186,2.160186
5900,300,6100,1770000,2,48806,12203,1,316720000,316720000,18301,6100,12201,6100,0,1,6102,2237686,2.237686
5900,300,6100,1770000,2,48806,12203,1,316720000,316720000,18301,6100,12201,6100,0,1,6102,2120573,2.120573
5900,300,6100,1770000,2,48806,12203,1,316720000,316720000,18301,6100,12201,6100,0,1,6102,2246138,2.246138
5900,300,6100,1770000,2,48806,12203,1,316720000,316720000,18301,6100,12201,6100,0,1,6102,2137696,2.137696
5900,300,6100,1770000,2,48806,12203,1,316720000,316720000,18301,6100,12201,6100,0,1,6102,2177956,2.177956
5900,300,6100,1770000,2,48806,12203,1,316720000,316720000,18301,6100,12201,6100,0,1,6102,2216236,2.216236
5900,300,6500,1770000,2,52006,13003,1,336560000,336560000,19501,6500,13001,6500,0,1,6502,2280390,2.28039
5900,300,6500,1770000,2,52006,13003,1,336560000,336560000,19501,6500,13001,6500,0,1,6502,2381921,2.381921
5900,300,6500,1770000,2,52006,13003,1,336560000,336560000,19501,6500,13001,6500,0,1,6502,2261057,2.261057
5900,300,6500,1770000,2,52006,13003,1,336560000,336560000,19501,6500,13001,6500,0,1,6502,2383984,2.383984
5900,300,6500,1770000,2,52006,13003,1,336560000,336560000,19501,6500,13001,6500,0,1,6502,2264468,2.264468
5900,300,6500,1770000,2,52006,13003,1,336560000,336560000,19501,6500,13001,6500,0,1,6502,2305790,2.30579
5900,300,6500,1770000,2,52006,13003,1,336560000,336560000,19501,6500,13001,6500,0,1,6502,2351265,2.351265
5900,300,6900,1770000,2,55206,13803,1,356400000,356400000,20701,6900,13801,6900,0,1,6902,2421788,2.421788
5900,300,6900,1770000,2,55206,13803,1,356400000,356400000,20701,6900,13801,6900,0,1,6902,2523289,2.523289
5900,300,6900,1770000,2,55206,13803,1,356400000,356400000,20701,6900,13801,6900,0,1,6902,2400064,2.400064
5900,300,6900,1770000,2,55206,13803,1,356400000,356400000,20701,6900,13801,6900,0,1,6902,2529655,2.529655
5900,300,6900,1770000,2,55206,13803,1,356400000,356400000,20701,6900,13801,6900,0,1,6902,2411356,2.411356
5900,300,6900,1770000,2,55206,13803,1,356400000,356400000,20701,6900,13801,6900,0,1,6902,2458237,2.458237
5900,300,6900,1770000,2,55206,13803,1,356400000,356400000,20701,6900,13801,6900,0,1,6902,2496631,2.496631
5500,7100,500,39050000,2,4006,1003,1,362800000,362800000,1501,500,1001,500,0,1,502,3913306,3.913306
5500,7100,500,39050000,2,4006,1003,1,362800000,362800000,1501,500,1001,500,0,1,502,4222390,4.22239
5500,7100,500,39050000,2,4006,1003,1,362800000,362800000,1501,500,1001,500,0,1,502,3939531,3.939531
5500,7100,500,39050000,2,4006,1003,1,362800000,362800000,1501,500,1001,500,0,1,502,4124755,4.124755
5500,7100,500,39050000,2,4006,1003,1,362800000,362800000,1501,500,1001,500,0,1,502,3966442,3.966442
5500,7100,500,39050000,2,4006,1003,1,362800000,362800000,1501,500,1001,500,0,1,502,3995511,3.995511
5500,7100,500,39050000,2,4006,1003,1,362800000,362800000,1501,500,1001,500,0,1,502,4153162,4.153162
5500,7100,900,39050000,2,7206,1803,1,403120000,403120000,2701,900,1801,900,0,1,902,6934426,6.934426
5500,7100,900,39050000,2,7206,1803,1,403120000,403120000,2701,900,1801,900,0,1,902,7055859,7.055859
5500,7100,900,39050000,2,7206,1803,1,403120000,403120000,2701,900,1801,900,0,1,902,6872828,6.872828
5500,7100,900,39050000,2,7206,1803,1,403120000,403120000,2701,900,1801,900,0,1,902,7222438,7.222438
5500,7100,900,39050000,2,7206,1803,1,403120000,403120000,2701,900,1801,900,0,1,902,6810696,6.810696
5500,7100,900,39050000,2,7206,1803,1,403120000,403120000,2701,900,1801,900,0,1,902,6992747,6.992747
5500,7100,900,39050000,2,7206,1803,1,403120000,403120000,2701,900,1801,900,0,1,902,7170974,7.170974
5500,7100,1300,39050000,2,10406,2603,1,443440000,443440000,3901,1300,2601,1300,0,1,1302,9566458,9.566458
5500,7100,1300,39050000,2,10406,2603,1,443440000,443440000,3901,1300,2601,1300,0,1,1302,10118293,10.118293
5500,7100,1300,39050000,2,10406,2603,1,443440000,443440000,3901,1300,2601,1300,0,1,1302,9616232,9.616232
5500,7100,1300,39050000,2,10406,2603,1,443440000,443440000,3901,1300,2601,1300,0,1,1302,10086993,10.086993
5500,7100,1300,39050000,2,10406,2603,1,443440000,443440000,3901,1300,2601,1300,0,1,1302,9773304,9.773304
5500,7100,1300,39050000,2,10406,2603,1,443440000,443440000,3901,1300,2601,1300,0,1,1302,9661704,9.661704
5500,7100,1300,39050000,2,10406,2603,1,443440000,443440000,3901,1300,2601,1300,0,1,1302,9977304,9.977304
5500,7100,1700,39050000,2,13606,3403,1,483760000,483760000,5101,1700,3401,1700,0,1,1702,12652446,12.652446
5500,7100,1700,39050000,2,13606,3403,1,483760000,483760000,5101,1700,3401,1700,0,1,1702,12966598,12.966598
5500,7100,1700,39050000,2,13606,3403,1,483760000,483760000,5101,1700,3401,1700,0,1,1702,12567787,12.567787
5500,7100,1700,39050000,2,13606,3403,1,483760000,483760000,5101,1700,3401,1700,0,1,1702,13188365,13.188365
5500,7100,1700,39050000,2,13606,3403,1,483760000,483760000,5101,1700,3401,1700,0,1,1702,12501008,12.501008
5500,7100,1700,39050000,2,13606,3403,1,483760000,483760000,5101,1700,3401,1700,0,1,1702,12678866,12.678866
5500,7100,1700,39050000,2,13606,3403,1,483760000,483760000,5101,1700,3401,1700,0,1,1702,13002473,13.002473
5500,7100,2100,39050000,2,16806,4203,1,524080000,524080000,6301,2100,4201,2100,0,1,2102,15439116,15.439116
5500,7100,2100,39050000,2,16806,4203,1,524080000,524080000,6301,2100,4201,2100,0,1,2102,16004494,16.004494
5500,7100,2100,39050000,2,16806,4203,1,524080000,524080000,6301,2100,4201,2100,0,1,2102,15388934,15.388934
5500,7100,2100,39050000,2,16806,4203,1,524080000,524080000,6301,2100,4201,2100,0,1,2102,16161868,16.161868
5500,7100,2100,39050000,2,16806,4203,1,524080000,524080000,6301,2100,4201,2100,0,1,2102,15466096,15.466096
5500,7100,2100,39050000,2,16806,4203,1,524080000,524080000,6301,2100,4201,2100,0,1,2102,15502360,15.50236
5500,7100,2100,39050000,2,16806,4203,1,524080000,524080000,6301,2100,4201,2100,0,1,2102,15876613,15.876613
5500,7100,2500,39050000,2,20006,5003,1,564400000,564400000,7501,2500,5001,2500,0,1,2502,18222446,18.222446
5500,7100,2500,39050000,2,20006,5003,1,564400000,564400000,7501,2500,5001,2500,0,1,2502,19044508,19.044508
5500,7100,2500,39050000,2,20006,5003,1,564400000,564400000,7501,2500,5001,2500,0,1,2502,18281065,18.281065
5500,7100,2500,39050000,2,20006,5003,1,564400000,564400000,7501,2500,5001,2500,0,1,2502,19174343,19.174343
5500,7100,2500,39050000,2,20006,5003,1,564400000,564400000,7501,2500,5001,2500,0,1,2502,18335065,18.335065
5500,7100,2500,39050000,2,20006,5003,1,564400000,564400000,7501,2500,5001,2500,0,1,2502,18308112,18.308112
5500,7100,2500,39050000,2,20006,5003,1,564400000,564400000,7501,2500,5001,2500,0,1,2502,18856778,18.856778
5500,7100,2900,39050000,2,23206,5803,1,604720000,604720000,8701,2900,5801,2900,0,1,2902,21120081,21.120081
5500,7100,2900,39050000,2,23206,5803,1,604720000,604720000,8701,2900,5801,2900,0,1,2902,22040408,22.040408
5500,7100,2900,39050000,2,23206,5803,1,604720000,604720000,8701,2900,5801,2900,0,1,2902,21092812,21.092812
5500,7100,2900,39050000,2,23206,5803,1,604720000,604720000,8701,2900,5801,2900,0,1,2902,22137217,22.137217
5500,7100,2900,39050000,2,23206,5803,1,604720000,604720000,8701,2900,5801,2900,0,1,2902,21169958,21.169958
5500,7100,2900,39050000,2,23206,5803,1,604720000,604720000,8701,2900,5801,2900,0,1,2902,21196281,21.196281
5500,7100,2900,39050000,2,23206,5803,1,604720000,604720000,8701,2900,5801,2900,0,1,2902,21796972,21.796972
5500,7100,3300,39050000,2,26406,6603,1,645040000,645040000,9901,3300,6601,3300,0,1,3302,23932735,23.932735
5500,7100,3300,39050000,2,26406,6603,1,645040000,645040000,9901,3300,6601,3300,0,1,3302,25024198,25.024198
5500,7100,3300,39050000,2,26406,6603,1,645040000,645040000,9901,3300,6601,3300,0,1,3302,23974534,23.974534
5500,7100,3300,39050000,2,26406,6603,1,645040000,645040000,9901,3300,6601,3300,0,1,3302,25196343,25.196343
5500,7100,3300,39050000,2,26406,6603,1,645040000,645040000,9901,3300,6601,3300,0,1,3302,24103490,24.10349
5500,7100,3300,39050000,2,26406,6603,1,645040000,645040000,9901,3300,6601,3300,0,1,3302,24040960,24.04096
5500,7100,3300,39050000,2,26406,6603,1,645040000,645040000,9901,3300,6601,3300,0,1,3302,24753684,24.753684
5500,7100,3700,39050000,2,29606,7403,1,685360000,685360000,11101,3700,7401,3700,0,1,3702,26743337,26.743337
5500,7100,3700,39050000,2,29606,7403,1,685360000,685360000,11101,3700,7401,3700,0,1,3702,28031780,28.03178
5500,7100,3700,39050000,2,29606,7403,1,685360000,685360000,11101,3700,7401,3700,0,1,3702,26832994,26.832994
5500,7100,3700,39050000,2,29606,7403,1,685360000,685360000,11101,3700,7401,3700,0,1,3702,28182522,28.182522
5500,7100,3700,39050000,2,29606,7403,1,685360000,685360000,11101,3700,7401,3700,0,1,3702,26921874,26.921874
5500,7100,3700,39050000,2,29606,7403,1,685360000,685360000,11101,3700,7401,3700,0,1,3702,26877910,26.87791
5500,7100,3700,39050000,2,29606,7403,1,685360000,685360000,11101,3700,7401,3700,0,1,3702,27725323,27.725323
5500,7100,4100,39050000,2,32806,8203,1,725680000,725680000,12301,4100,8201,4100,0,1,4102,29651345,29.651345
5500,7100,4100,39050000,2,32806,8203,1,725680000,725680000,12301,4100,8201,4100,0,1,4102,31016744,31.016744
5500,7100,4100,39050000,2,32806,8203,1,725680000,725680000,12301,4100,8201,4100,0,1,4102,29696939,29.696939
5500,7100,4100,39050000,2,32806,8203,1,725680000,725680000,12301,4100,8201,4100,0,1,4102,31239474,31.239474
5500,7100,4100,39050000,2,32806,8203,1,725680000,725680000,12301,4100,8201,4100,0,1,4102,29820836,29.820836
5500,7100,4100,39050000,2,32806,8203,1,725680000,725680000,12301,4100,8201,4100,0,1,4102,29723661,29.723661
5500,7100,4100,39050000,2,32806,8203,1,725680000,725680000,12301,4100,8201,4100,0,1,4102,30715118,30.715118
5500,7100,4500,39050000,2,36006,9003,1,766000000,766000000,13501,4500,9001,4500,0,1,4502,32514669,32.514669
5500,7100,4500,39050000,2,36006,9003,1,766000000,766000000,13501,4500,9001,4500,0,1,4502,34004016,34.004016
5500,7100,4500,39050000,2,36006,9003,1,766000000,766000000,13501,4500,9001,4500,0,1,4502,32562136,32.562136
5500,7100,4500,39050000,2,36006,9003,1,766000000,766000000,13501,4500,9001,4500,0,1,4502,34226001,34.226001
5500,7100,4500,39050000,2,36006,9003,1,766000000,766000000,13501,4500,9001,4500,0,1,4502,32616077,32.616077
5500,7100,4500,39050000,2,36006,9003,1,766000000,766000000,13501,4500,9001,4500,0,1,4502,32588866,32.588866
5500,7100,4500,39050000,2,36006,9003,1,766000000,766000000,13501,4500,9001,4500,0,1,4502,33665231,33.665231
5500,7100,4900,39050000,2,39206,9803,1,806320000,806320000,14701,4900,9801,4900,0,1,4902,35349014,35.349014
5500,7100,4900,39050000,2,39206,9803,1,806320000,806320000,14701,4900,9801,4900,0,1,4902,36988145,36.988145
5500,7100,4900,39050000,2,39206,9803,1,806320000,806320000,14701,4900,9801,4900,0,1,4902,35443205,35.443205
5500,7100,4900,39050000,2,39206,9803,1,806320000,806320000,14701,4900,9801,4900,0,1,4902,37280656,37.280656
5500,7100,4900,39050000,2,39206,9803,1,806320000,806320000,14701,4900,9801,4900,0,1,4902,35564111,35.564111
5500,7100,4900,39050000,2,39206,9803,1,806320000,806320000,14701,4900,9801,4900,0,1,4902,35469486,35.469486
5500,7100,4900,39050000,2,39206,9803,1,806320000,806320000,14701,4900,9801,4900,0,1,4902,36674490,36.67449
5500,7100,5300,39050000,2,42406,10603,1,846640000,846640000,15901,5300,10601,5300,0,1,5302,38257274,38.257274
5500,7100,5300,39050000,2,42406,10603,1,846640000,846640000,15901,5300,10601,5300,0,1,5302,40063658,40.063658
5500,7100,5300,39050000,2,42406,10603,1,846640000,846640000,15901,5300,10601,5300,0,1,5302,38383970,38.38397
5500,7100,5300,39050000,2,42406,10603,1,846640000,846640000,15901,5300,10601,5300,0,1,5302,40290749,40.290749
5500,7100,5300,39050000,2,42406,10603,1,846640000,846640000,15901,5300,10601,5300,0,1,5302,38469689,38.469689
5500,7100,5300,39050000,2,42406,10603,1,846640000,846640000,15901,5300,10601,5300,0,1,5302,38357351,38.357351
5500,7100,5300,39050000,2,42406,10603,1,846640000,846640000,15901,5300,10601,5300,0,1,5302,39650301,39.650301
5500,7100,5700,39050000,2,45606,11403,1,886960000,886960000,17101,5700,11401,5700,0,1,5702,41143361,41.143361
5500,7100,5700,39050000,2,45606,11403,1,886960000,886960000,17101,5700,11401,5700,0,1,5702,43206790,43.20679
5500,7100,5700,39050000,2,45606,11403,1,886960000,886960000,17101,5700,11401,5700,0,1,5702,41217592,41.217592
5500,7100,5700,39050000,2,45606,11403,1,886960000,886960000,17101,5700,11401,5700,0,1,5702,43355738,43.355738
5500,7100,5700,39050000,2,45606,11403,1,886960000,886960000,17101,5700,11401,5700,0,1,5702,41373531,41.373531
5500,7100,5700,39050000,2,45606,11403,1,886960000,886960000,17101,5700,11401,5700,0,1,5702,41245260,41.24526
5500,7100,5700,39050000,2,45606,11403,1,886960000,886960000,17101,5700,11401,5700,0,1,5702,42626780,42.62678
5500,7100,6100,39050000,2,48806,12203,1,927280000,927280000,18301,6100,12201,6100,0,1,6102,43978738,43.978738
5500,7100,6100,39050000,2,48806,12203,1,927280000,927280000,18301,6100,12201,6100,0,1,6102,46250835,46.250835
5500,7100,6100,39050000,2,48806,12203,1,927280000,927280000,18301,6100,12201,6100,0,1,6102,44161076,44.161076
5500,7100,6100,39050000,2,48806,12203,1,927280000,927280000,18301,6100,12201,6100,0,1,6102,46413737,46.413737
5500,7100,6100,39050000,2,48806,12203,1,927280000,927280000,18301,6100,12201,6100,0,1,6102,44302904,44.302904
5500,7100,6100,39050000,2,48806,12203,1,927280000,927280000,18301,6100,12201,6100,0,1,6102,44094815,44.094815
5500,7100,6100,39050000,2,48806,12203,1,927280000,927280000,18301,6100,12201,6100,0,1,6102,45610604,45.610604
5500,7100,6500,39050000,2,52006,13003,1,967600000,967600000,19501,6500,13001,6500,0,1,6502,46892439,46.892439
5500,7100,6500,39050000,2,52006,13003,1,967600000,967600000,19501,6500,13001,6500,0,1,6502,49269371,49.269371
5500,7100,6500,39050000,2,52006,13003,1,967600000,967600000,19501,6500,13001,6500,0,1,6502,47113360,47.11336
5500,7100,6500,39050000,2,52006,13003,1,967600000,967600000,19501,6500,13001,6500,0,1,6502,49435474,49.435474
5500,7100,6500,39050000,2,52006,13003,1,967600000,967600000,19501,6500,13001,6500,0,1,6502,47263873,47.263873
5500,7100,6500,39050000,2,52006,13003,1,967600000,967600000,19501,6500,13001,6500,0,1,6502,47017415,47.017415
5500,7100,6500,39050000,2,52006,13003,1,967600000,967600000,19501,6500,13001,6500,0,1,6502,48647176,48.647176
5500,7100,6900,39050000,2,55206,13803,1,1007920000,1007920000,20701,6900,13801,6900,0,1,6902,49769966,49.769966
5500,7100,6900,39050000,2,55206,13803,1,1007920000,1007920000,20701,6900,13801,6900,0,1,6902,52361492,52.361492
5500,7100,6900,39050000,2,55206,13803,1,1007920000,1007920000,20701,6900,13801,6900,0,1,6902,50020554,50.020554
5500,7100,6900,39050000,2,55206,13803,1,1007920000,1007920000,20701,6900,13801,6900,0,1,6902,52502246,52.502246
5500,7100,6900,39050000,2,55206,13803,1,1007920000,1007920000,20701,6900,13801,6900,0,1,6902,50147297,50.147297
5500,7100,6900,39050000,2,55206,13803,1,1007920000,1007920000,20701,6900,13801,6900,0,1,6902,49938493,49.938493
5500,7100,6900,39050000,2,55206,13803,1,1007920000,1007920000,20701,6900,13801,6900,0,1,6902,51654051,51.654051
5500,6700,500,36850000,2,4006,1003,1,343600000,343600000,1501,500,1001,500,0,1,502,3913638,3.913638
5500,6700,500,36850000,2,4006,1003,1,343600000,343600000,1501,500,1001,500,0,1,502,3967384,3.967384
5500,6700,500,36850000,2,4006,1003,1,343600000,343600000,1501,500,1001,500,0,1,502,3846014,3.846014
5500,6700,500,36850000,2,4006,1003,1,343600000,343600000,1501,500,1001,500,0,1,502,3993730,3.99373
5500,6700,500,36850000,2,4006,1003,1,343600000,343600000,1501,500,1001,500,0,1,502,3818974,3.818974
5500,6700,500,36850000,2,4006,1003,1,343600000,343600000,1501,500,1001,500,0,1,502,3939126,3.939126
5500,6700,500,36850000,2,4006,1003,1,343600000,343600000,1501,500,1001,500,0,1,502,3940539,3.940539
5500,6700,900,36850000,2,7206,1803,1,382640000,382640000,2701,900,1801,900,0,1,902,6376487,6.376487
5500,6700,900,36850000,2,7206,1803,1,382640000,382640000,2701,900,1801,900,0,1,902,6626008,6.626008
5500,6700,900,36850000,2,7206,1803,1,382640000,382640000,2701,900,1801,900,0,1,902,6401522,6.401522
5500,6700,900,36850000,2,7206,1803,1,382640000,382640000,2701,900,1801,900,0,1,902,6690484,6.690484
5500,6700,900,36850000,2,7206,1803,1,382640000,382640000,2701,900,1801,900,0,1,902,6430920,6.43092
5500,6700,900,36850000,2,7206,1803,1,382640000,382640000,2701,900,1801,900,0,1,902,6431460,6.43146
5500,6700,900,36850000,2,7206,1803,1,382640000,382640000,2701,900,1801,900,0,1,902,6567502,6.567502
5500,6700,1300,36850000,2,10406,2603,1,421680000,421680000,3901,1300,2601,1300,0,1,1302,9201911,9.201911
5500,6700,1300,36850000,2,10406,2603,1,421680000,421680000,3901,1300,2601,1300,0,1,1302,9518427,9.518427
5500,6700,1300,36850000,2,10406,2603,1,421680000,421680000,3901,1300,2601,1300,0,1,1302,9150855,9.150855
5500,6700,1300,36850000,2,10406,2603,1,421680000,421680000,3901,1300,2601,1300,0,1,1302,9616050,9.61605
5500,6700,1300,36850000,2,10406,2603,1,421680000,421680000,3901,1300,2601,1300,0,1,1302,9257546,9.257546
5500,6700,1300,36850000,2,10406,2603,1,421680000,421680000,3901,1300,2601,1300,0,1,1302,9232789,9.232789
5500,6700,1300,36850000,2,10406,2603,1,421680000,421680000,3901,1300,2601,1300,0,1,1302,9465483,9.465483
5500,6700,1700,36850000,2,13606,3403,1,460720000,460720000,5101,1700,3401,1700,0,1,1702,11858792,11.858792
5500,6700,1700,36850000,2,13606,3403,1,460720000,460720000,5101,1700,3401,1700,0,1,1702,12350481,12.350481
5500,6700,1700,36850000,2,13606,3403,1,460720000,460720000,5101,1700,3401,1700,0,1,1702,11883603,11.883603
5500,6700,1700,36850000,2,13606,3403,1,460720000,460720000,5101,1700,3401,1700,0,1,1702,12476074,12.476074
5500,6700,1700,36850000,2,13606,3403,1,460720000,460720000,5101,1700,3401,1700,0,1,1702,11984815,11.984815
5500,6700,1700,36850000,2,13606,3403,1,460720000,460720000,5101,1700,3401,1700,0,1,1702,11925378,11.925378
5500,6700,1700,36850000,2,13606,3403,1,460720000,460720000,5101,1700,3401,1700,0,1,1702,12234619,12.234619
5500,6700,2100,36850000,2,16806,4203,1,499760000,499760000,6301,2100,4201,2100,0,1,2102,14545461,14.545461
5500,6700,2100,36850000,2,16806,4203,1,499760000,499760000,6301,2100,4201,2100,0,1,2102,15118590,15.11859
5500,6700,2100,36850000,2,16806,4203,1,499760000,499760000,6301,2100,4201,2100,0,1,2102,14511142,14.511142
5500,6700,2100,36850000,2,16806,4203,1,499760000,499760000,6301,2100,4201,2100,0,1,2102,15262147,15.262147
5500,6700,2100,36850000,2,16806,4203,1,499760000,499760000,6301,2100,4201,2100,0,1,2102,14707066,14.707066
5500,6700,2100,36850000,2,16806,4203,1,499760000,499760000,6301,2100,4201,2100,0,1,2102,14620359,14.620359
5500,6700,2100,36850000,2,16806,4203,1,499760000,499760000,6301,2100,4201,2100,0,1,2102,15016469,15.016469
5500,6700,2500,36850000,2,20006,5003,1,538800000,538800000,7501,2500,5001,2500,0,1,2502,17245340,17.24534
5500,6700,2500,36850000,2,20006,5003,1,538800000,538800000,7501,2500,5001,2500,0,1,2502,17936710,17.93671
5500,6700,2500,36850000,2,20006,5003,1,538800000,538800000,7501,2500,5001,2500,0,1,2502,17220278,17.220278
5500,6700,2500,36850000,2,20006,5003,1,538800000,538800000,7501,2500,5001,2500,0,1,2502,18105698,18.105698
5500,6700,2500,36850000,2,20006,5003,1,538800000,538800000,7501,2500,5001,2500,0,1,2502,17369804,17.369804
5500,6700,2500,36850000,2,20006,5003,1,538800000,538800000,7501,2500,5001,2500,0,1,2502,17295414,17.295414
5500,6700,2500,36850000,2,20006,5003,1,538800000,538800000,7501,2500,5001,2500,0,1,2502,17794792,17.794792
5500,6700,2900,36850000,2,23206,5803,1,577840000,577840000,8701,2900,5801,2900,0,1,2902,19919482,19.919482
5500,6700,2900,36850000,2,23206,5803,1,577840000,577840000,8701,2900,5801,2900,0,1,2902,20765184,20.765184
5500,6700,2900,36850000,2,23206,5803,1,577840000,577840000,8701,2900,5801,2900,0,1,2902,19957344,19.957344
5500,6700,2900,36850000,2,23206,5803,1,577840000,577840000,8701,2900,5801,2900,0,1,2902,20928991,20.928991
5500,6700,2900,36850000,2,23206,5803,1,577840000,577840000,8701,2900,5801,2900,0,1,2902,20096007,20.096007
5500,6700,2900,36850000,2,23206,5803,1,577840000,577840000,8701,2900,5801,2900,0,1,2902,20002552,20.002552
5500,6700,2900,36850000,2,23206,5803,1,577840000,577840000,8701,2900,5801,2900,0,1,2902,20595480,20.59548
5500,6700,3300,36850000,2,26406,6603,1,616880000,616880000,9901,3300,6601,3300,0,1,3302,22620809,22.620809
5500,6700,3300,36850000,2,26406,6603,1,616880000,616880000,9901,3300,6601,3300,0,1,3302,23546002,23.546002
5500,6700,3300,36850000,2,26406,6603,1,616880000,616880000,9901,3300,6601,3300,0,1,3302,22646096,22.646096
5500,6700,3300,36850000,2,26406,6603,1,616880000,616880000,9901,3300,6601,3300,0,1,3302,23721731,23.721731
5500,6700,3300,36850000,2,26406,6603,1,616880000,616880000,9901,3300,6601,3300,0,1,3302,22741872,22.741872
5500,6700,3300,36850000,2,26406,6603,1,616880000,616880000,9901,3300,6601,3300,0,1,3302,22671487,22.671487
5500,6700,3300,36850000,2,26406,6603,1,616880000,616880000,9901,3300,6601,3300,0,1,3302,23358806,23.358806
5500,6700,3700,36850000,2,29606,7403,1,655920000,655920000,11101,3700,7401,3700,0,1,3702,25312569,25.312569
5500,6700,3700,36850000,2,29606,7403,1,655920000,655920000,11101,3700,7401,3700,0,1,3702,26433123,26.433123
5500,6700,3700,36850000,2,29606,7403,1,655920000,655920000,11101,3700,7401,3700,0,1,3702,25313979,25.313979
5500,6700,3700,36850000,2,29606,7403,1,655920000,655920000,11101,3700,7401,3700,0,1,3702,26608181,26.608181
5500,6700,3700,36850000,2,29606,7403,1,655920000,655920000,11101,3700,7401,3700,0,1,3702,25397276,25.397276
5500,6700,3700,36850000,2,29606,7403,1,655920000,655920000,11101,3700,7401,3700,0,1,3702,25355441,25.355441
5500,6700,3700,36850000,2,29606,7403,1,655920000,655920000,11101,3700,7401,3700,0,1,3702,26179249,26.179249
5500,6700,4100,36850000,2,32806,8203,1,694960000,694960000,12301,4100,8201,4100,0,1,4102,27988519,27.988519
5500,6700,4100,36850000,2,32806,8203,1,694960000,694960000,12301,4100,8201,4100,0,1,4102,29252008,29.252008
5500,6700,4100,36850000,2,32806,8203,1,694960000,694960000,12301,4100,8201,4100,0,1,4102,28013456,28.013456
5500,6700,4100,36850000,2,32806,8203,1,694960000,694960000,12301,4100,8201,4100,0,1,4102,29430759,29.430759
5500,6700,4100,36850000,2,32806,8203,1,694960000,694960000,12301,4100,8201,4100,0,1,4102,28081549,28.081549
5500,6700,4100,36850000,2,32806,8203,1,694960000,694960000,12301,4100,8201,4100,0,1,4102,28038513,28.038513
5500,6700,4100,36850000,2,32806,8203,1,694960000,694960000,12301,4100,8201,4100,0,1,4102,28966308,28.966308
5500,6700,4500,36850000,2,36006,9003,1,734000000,734000000,13501,4500,9001,4500,0,1,4502,30660595,30.660595
5500,6700,4500,36850000,2,36006,9003,1,734000000,734000000,13501,4500,9001,4500,0,1,4502,32070872,32.070872
5500,6700,4500,36850000,2,36006,9003,1,734000000,734000000,13501,4500,9001,4500,0,1,4502,30712629,30.712629
5500,6700,4500,36850000,2,36006,9003,1,734000000,734000000,13501,4500,9001,4500,0,1,4502,32230543,32.230543
5500,6700,4500,36850000,2,36006,9003,1,734000000,734000000,13501,4500,9001,4500,0,1,4502,30818667,30.818667
5500,6700,4500,36850000,2,36006,9003,1,734000000,734000000,13501,4500,9001,4500,0,1,4502,30737710,30.73771
5500,6700,4500,36850000,2,36006,9003,1,734000000,734000000,13501,4500,9001,4500,0,1,4502,31739321,31.739321
5500,6700,4900,36850000,2,39206,9803,1,773040000,773040000,14701,4900,9801,4900,0,1,4902,33406468,33.406468
5500,6700,4900,36850000,2,39206,9803,1,773040000,773040000,14701,4900,9801,4900,0,1,4902,34954738,34.954738
5500,6700,4900,36850000,2,39206,9803,1,773040000,773040000,14701,4900,9801,4900,0,1,4902,33433858,33.433858
5500,6700,4900,36850000,2,39206,9803,1,773040000,773040000,14701,4900,9801,4900,0,1,4902,35154743,35.154743
5500,6700,4900,36850000,2,39206,9803,1,773040000,773040000,14701,4900,9801,4900,0,1,4902,33551518,33.551518
5500,6700,4900,36850000,2,39206,9803,1,773040000,773040000,14701,4900,9801,4900,0,1,4902,33433147,33.433147
5500,6700,4900,36850000,2,39206,9803,1,773040000,773040000,14701,4900,9801,4900,0,1,4902,34589601,34.589601
5500,6700,5300,36850000,2,42406,10603,1,812080000,812080000,15901,5300,10601,5300,0,1,5302,36100512,36.100512
5500,6700,5300,36850000,2,42406,10603,1,812080000,812080000,15901,5300,10601,5300,0,1,5302,37769098,37.769098
5500,6700,5300,36850000,2,42406,10603,1,812080000,812080000,15901,5300,10601,5300,0,1,5302,36166481,36.166481
5500,6700,5300,36850000,2,42406,10603,1,812080000,812080000,15901,5300,10601,5300,0,1,5302,37994595,37.994595
5500,6700,5300,36850000,2,42406,10603,1,812080000,812080000,15901,5300,10601,5300,0,1,5302,36320619,36.320619
5500,6700,5300,36850000,2,42406,10603,1,812080000,812080000,15901,5300,10601,5300,0,1,5302,36191584,36.191584
5500,6700,5300,36850000,2,42406,10603,1,812080000,812080000,15901,5300,10601,5300,0,1,5302,37383124,37.383124
5500,6700,5700,36850000,2,45606,11403,1,851120000,851120000,17101,5700,11401,5700,0,1,5702,38815547,38.815547
5500,6700,5700,36850000,2,45606,11403,1,851120000,851120000,17101,5700,11401,5700,0,1,5702,40730636,40.730636
5500,6700,5700,36850000,2,45606,11403,1,851120000,851120000,17101,5700,11401,5700,0,1,5702,38867930,38.86793
5500,6700,5700,36850000,2,45606,11403,1,851120000,851120000,17101,5700,11401,5700,0,1,5702,40925441,40.925441
5500,6700,5700,36850000,2,45606,11403,1,851120000,851120000,17101,5700,11401,5700,0,1,5702,39045359,39.045359
5500,6700,5700,36850000,2,45606,11403,1,851120000,851120000,17101,5700,11401,5700,0,1,5702,38894051,38.894051
5500,6700,5700,36850000,2,45606,11403,1,851120000,851120000,17101,5700,11401,5700,0,1,5702,40290075,40.290075
5500,6700,6100,36850000,2,48806,12203,1,890160000,890160000,18301,6100,12201,6100,0,1,6102,41562580,41.56258
5500,6700,6100,36850000,2,48806,12203,1,890160000,890160000,18301,6100,12201,6100,0,1,6102,43550098,43.550098
5500,6700,6100,36850000,2,48806,12203,1,890160000,890160000,18301,6100,12201,6100,0,1,6102,41669695,41.669695
5500,6700,6100,36850000,2,48806,12203,1,890160000,890160000,18301,6100,12201,6100,0,1,6102,43793555,43.793555
5500,6700,6100,36850000,2,48806,12203,1,890160000,890160000,18301,6100,12201,6100,0,1,6102,41775439,41.775439
5500,6700,6100,36850000,2,48806,12203,1,890160000,890160000,18301,6100,12201,6100,0,1,6102,41641808,41.641808
5500,6700,6100,36850000,2,48806,12203,1,890160000,890160000,18301,6100,12201,6100,0,1,6102,43104788,43.104788
5500,6700,6500,36850000,2,52006,13003,1,929200000,929200000,19501,6500,13001,6500,0,1,6502,44228052,44.228052
5500,6700,6500,36850000,2,52006,13003,1,929200000,929200000,19501,6500,13001,6500,0,1,6502,46450370,46.45037
5500,6700,6500,36850000,2,52006,13003,1,929200000,929200000,19501,6500,13001,6500,0,1,6502,44352745,44.352745
5500,6700,6500,36850000,2,52006,13003,1,929200000,929200000,19501,6500,13001,6500,0,1,6502,46624310,46.62431
5500,6700,6500,36850000,2,52006,13003,1,929200000,929200000,19501,6500,13001,6500,0,1,6502,44537146,44.537146
5500,6700,6500,36850000,2,52006,13003,1,929200000,929200000,19501,6500,13001,6500,0,1,6502,44407731,44.407731
5500,6700,6500,36850000,2,52006,13003,1,929200000,929200000,19501,6500,13001,6500,0,1,6502,45957564,45.957564
5500,6700,6900,36850000,2,55206,13803,1,968240000,968240000,20701,6900,13801,6900,0,1,6902,47083828,47.083828
5500,6700,6900,36850000,2,55206,13803,1,968240000,968240000,20701,6900,13801,6900,0,1,6902,49354841,49.354841
5500,6700,6900,36850000,2,55206,13803,1,968240000,968240000,20701,6900,13801,6900,0,1,6902,47196560,47.19656
5500,6700,6900,36850000,2,55206,13803,1,968240000,968240000,20701,6900,13801,6900,0,1,6902,49577616,49.577616
5500,6700,6900,36850000,2,55206,13803,1,968240000,968240000,20701,6900,13801,6900,0,1,6902,47461232,47.461232
5500,6700,6900,36850000,2,55206,13803,1,968240000,968240000,20701,6900,13801,6900,0,1,6902,47140894,47.140894
5500,6700,6900,36850000,2,55206,13803,1,968240000,968240000,20701,6900,13801,6900,0,1,6902,48847144,48.847144
5500,6300,500,34650000,2,4006,1003,1,324400000,324400000,1501,500,1001,500,0,1,502,3658437,3.658437
5500,6300,500,34650000,2,4006,1003,1,324400000,324400000,1501,500,1001,500,0,1,502,3753774,3.753774
5500,6300,500,34650000,2,4006,1003,1,324400000,324400000,1501,500,1001,500,0,1,502,3633834,3.633834
5500,6300,500,34650000,2,4006,1003,1,324400000,324400000,1501,500,1001,500,0,1,502,3755817,3.755817
5500,6300,500,34650000,2,4006,1003,1,324400000,324400000,1501,500,1001,500,0,1,502,3634890,3.63489
5500,6300,500,34650000,2,4006,1003,1,324400000,324400000,1501,500,1001,500,0,1,502,3730294,3.730294
5500,6300,500,34650000,2,4006,1003,1,324400000,324400000,1501,500,1001,500,0,1,502,3704662,3.704662
5500,6300,900,34650000,2,7206,1803,1,362160000,362160000,2701,900,1801,900,0,1,902,5991478,5.991478
5500,6300,900,34650000,2,7206,1803,1,362160000,362160000,2701,900,1801,900,0,1,902,6246976,6.246976
5500,6300,900,34650000,2,7206,1803,1,362160000,362160000,2701,900,1801,900,0,1,902,6018718,6.018718
5500,6300,900,34650000,2,7206,1803,1,362160000,362160000,2701,900,1801,900,0,1,902,6276253,6.276253
5500,6300,900,34650000,2,7206,1803,1,362160000,362160000,2701,900,1801,900,0,1,902,6080373,6.080373
5500,6300,900,34650000,2,7206,1803,1,362160000,362160000,2701,900,1801,900,0,1,902,6052974,6.052974
5500,6300,900,34650000,2,7206,1803,1,362160000,362160000,2701,900,1801,900,0,1,902,6176850,6.17685
5500,6300,1300,34650000,2,10406,2603,1,399920000,399920000,3901,1300,2601,1300,0,1,1302,8695152,8.695152
5500,6300,1300,34650000,2,10406,2603,1,399920000,399920000,3901,1300,2601,1300,0,1,1302,8980785,8.980785
5500,6300,1300,34650000,2,10406,2603,1,399920000,399920000,3901,1300,2601,1300,0,1,1302,8671757,8.671757
5500,6300,1300,34650000,2,10406,2603,1,399920000,399920000,3901,1300,2601,1300,0,1,1302,9059631,9.059631
5500,6300,1300,34650000,2,10406,2603,1,399920000,399920000,3901,1300,2601,1300,0,1,1302,8753715,8.753715
5500,6300,1300,34650000,2,10406,2603,1,399920000,399920000,3901,1300,2601,1300,0,1,1302,8729760,8.72976
5500,6300,1300,34650000,2,10406,2603,1,399920000,399920000,3901,1300,2601,1300,0,1,1302,8942436,8.942436
5500,6300,1700,34650000,2,13606,3403,1,437680000,437680000,5101,1700,3401,1700,0,1,1702,11179359,11.179359
5500,6300,1700,34650000,2,13606,3403,1,437680000,437680000,5101,1700,3401,1700,0,1,1702,11596319,11.596319
5500,6300,1700,34650000,2,13606,3403,1,437680000,437680000,5101,1700,3401,1700,0,1,1702,11178640,11.17864
5500,6300,1700,34650000,2,13606,3403,1,437680000,437680000,5101,1700,3401,1700,0,1,1702,11704917,11.704917
5500,6300,1700,34650000,2,13606,3403,1,437680000,437680000,5101,1700,3401,1700,0,1,1702,11281654,11.281654
5500,6300,1700,34650000,2,13606,3403,1,437680000,437680000,5101,1700,3401,1700,0,1,1702,11155123,11.155123
5500,6300,1700,34650000,2,13606,3403,1,437680000,437680000,5101,1700,3401,1700,0,1,1702,11553481,11.553481
5500,6300,2100,34650000,2,16806,4203,1,475440000,475440000,6301,2100,4201,2100,0,1,2102,13517012,13.517012
5500,6300,2100,34650000,2,16806,4203,1,475440000,475440000,6301,2100,4201,2100,0,1,2102,14151441,14.151441
5500,6300,2100,34650000,2,16806,4203,1,475440000,475440000,6301,2100,4201,2100,0,1,2102,13540465,13.540465
5500,6300,2100,34650000,2,16806,4203,1,475440000,475440000,6301,2100,4201,2100,0,1,2102,14262038,14.262038
5500,6300,2100,34650000,2,16806,4203,1,475440000,475440000,6301,2100,4201,2100,0,1,2102,13746901,13.746901
5500,6300,2100,34650000,2,16806,4203,1,475440000,475440000,6301,2100,4201,2100,0,1,2102,13597710,13.59771
5500,6300,2100,34650000,2,16806,4203,1,475440000,475440000,6301,2100,4201,2100,0,1,2102,14013524,14.013524
5500,6300,2500,34650000,2,20006,5003,1,513200000,513200000,7501,2500,5001,2500,0,1,2502,16208076,16.208076
5500,6300,2500,34650000,2,20006,5003,1,513200000,513200000,7501,2500,5001,2500,0,1,2502,16893583,16.893583
5500,6300,2500,34650000,2,20006,5003,1,513200000,513200000,7501,2500,5001,2500,0,1,2502,16166260,16.16626
5500,6300,2500,34650000,2,20006,5003,1,513200000,513200000,7501,2500,5001,2500,0,1,2502,17025011,17.025011
5500,6300,2500,34650000,2,20006,5003,1,513200000,513200000,7501,2500,5001,2500,0,1,2502,16388250,16.38825
5500,6300,2500,34650000,2,20006,5003,1,513200000,513200000,7501,2500,5001,2500,0,1,2502,16256721,16.256721
5500,6300,2500,34650000,2,20006,5003,1,513200000,513200000,7501,2500,5001,2500,0,1,2502,16758428,16.758428
5500,6300,2900,34650000,2,23206,5803,1,550960000,550960000,8701,2900,5801,2900,0,1,2902,18720234,18.720234
5500,6300,2900,34650000,2,23206,5803,1,550960000,550960000,8701,2900,5801,2900,0,1,2902,19530249,19.530249
5500,6300,2900,34650000,2,23206,5803,1,550960000,550960000,8701,2900,5801,2900,0,1,2902,18757222,18.757222
5500,6300,2900,34650000,2,23206,5803,1,550960000,550960000,8701,2900,5801,2900,0,1,2902,19688639,19.688639
5500,6300,2900,34650000,2,23206,5803,1,550960000,550960000,8701,2900,5801,2900,0,1,2902,18903243,18.903243
5500,6300,2900,34650000,2,23206,5803,1,550960000,550960000,8701,2900,5801,2900,0,1,2902,18799377,18.799377
5500,6300,2900,34650000,2,23206,5803,1,550960000,550960000,8701,2900,5801,2900,0,1,2902,19353651,19.353651
5500,6300,3300,34650000,2,26406,6603,1,588720000,588720000,9901,3300,6601,3300,0,1,3302,21257009,21.257009
5500,6300,3300,34650000,2,26406,6603,1,588720000,588720000,9901,3300,6601,3300,0,1,3302,22218976,22.218976
5500,6300,3300,34650000,2,26406,6603,1,588720000,588720000,9901,3300,6601,3300,0,1,3302,21296453,21.296453
5500,6300,3300,34650000,2,26406,6603,1,588720000,588720000,9901,3300,6601,3300,0,1,3302,22358049,22.358049
5500,6300,3300,34650000,2,26406,6603,1,588720000,588720000,9901,3300,6601,3300,0,1,3302,21466208,21.466208
5500,6300,3300,34650000,2,26406,6603,1,588720000,588720000,9901,3300,6601,3300,0,1,3302,21333834,21.333834
5500,6300,3300,34650000,2,26406,6603,1,588720000,588720000,9901,3300,6601,3300,0,1,3302,21992817,21.992817
5500,6300,3700,34650000,2,29606,7403,1,626480000,626480000,11101,3700,7401,3700,0,1,3702,23797794,23.797794
5500,6300,3700,34650000,2,29606,7403,1,626480000,626480000,11101,3700,7401,3700,0,1,3702,24866346,24.866346
5500,6300,3700,34650000,2,29606,7403,1,626480000,626480000,11101,3700,7401,3700,0,1,3702,23853719,23.853719
5500,6300,3700,34650000,2,29606,7403,1,626480000,626480000,11101,3700,7401,3700,0,1,3702,25039722,25.039722
5500,6300,3700,34650000,2,29606,7403,1,626480000,626480000,11101,3700,7401,3700,0,1,3702,24022525,24.022525
5500,6300,3700,34650000,2,29606,7403,1,626480000,626480000,11101,3700,7401,3700,0,1,3702,23892784,23.892784
5500,6300,3700,34650000,2,29606,7403,1,626480000,626480000,11101,3700,7401,3700,0,1,3702,24609165,24.609165
5500,6300,4100,34650000,2,32806,8203,1,664240000,664240000,12301,4100,8201,4100,0,1,4102,26276543,26.276543
5500,6300,4100,34650000,2,32806,8203,1,664240000,664240000,12301,4100,8201,4100,0,1,4102,27528051,27.528051
5500,6300,4100,34650000,2,32806,8203,1,664240000,664240000,12301,4100,8201,4100,0,1,4102,26379646,26.379646
5500,6300,4100,34650000,2,32806,8203,1,664240000,664240000,12301,4100,8201,4100,0,1,4102,27673798,27.673798
5500,6300,4100,34650000,2,32806,8203,1,664240000,664240000,12301,4100,8201,4100,0,1,4102,26461496,26.461496
5500,6300,4100,34650000,2,32806,8203,1,664240000,664240000,12301,4100,8201,4100,0,1,4102,26420377,26.420377
5500,6300,4100,34650000,2,32806,8203,1,664240000,664240000,12301,4100,8201,4100,0,1,4102,27200494,27.200494
5500,6300,4500,34650000,2,36006,9003,1,702000000,702000000,13501,4500,9001,4500,0,1,4502,28831155,28.831155
5500,6300,4500,34650000,2,36006,9003,1,702000000,702000000,13501,4500,9001,4500,0,1,4502,30168701,30.168701
5500,6300,4500,34650000,2,36006,9003,1,702000000,702000000,13501,4500,9001,4500,0,1,4502,28923911,28.923911
5500,6300,4500,34650000,2,36006,9003,1,702000000,702000000,13501,4500,9001,4500,0,1,4502,30374412,30.374412
5500,6300,4500,34650000,2,36006,9003,1,702000000,702000000,13501,4500,9001,4500,0,1,4502,29075656,29.075656
5500,6300,4500,34650000,2,36006,9003,1,702000000,702000000,13501,4500,9001,4500,0,1,4502,29000158,29.000158
5500,6300,4500,34650000,2,36006,9003,1,702000000,702000000,13501,4500,9001,4500,0,1,4502,29862015,29.862015
5500,6300,4900,34650000,2,39206,9803,1,739760000,739760000,14701,4900,9801,4900,0,1,4902,31423910,31.42391
5500,6300,4900,34650000,2,39206,9803,1,739760000,739760000,14701,4900,9801,4900,0,1,4902,32935314,32.935314
5500,6300,4900,34650000,2,39206,9803,1,739760000,739760000,14701,4900,9801,4900,0,1,4902,31516343,31.516343
5500,6300,4900,34650000,2,39206,9803,1,739760000,739760000,14701,4900,9801,4900,0,1,4902,33104334,33.104334
5500,6300,4900,34650000,2,39206,9803,1,739760000,739760000,14701,4900,9801,4900,0,1,4902,31704133,31.704133
5500,6300,4900,34650000,2,39206,9803,1,739760000,739760000,14701,4900,9801,4900,0,1,4902,31561701,31.561701
5500,6300,4900,34650000,2,39206,9803,1,739760000,739760000,14701,4900,9801,4900,0,1,4902,32670820,32.67082
5500,6300,5300,34650000,2,42406,10603,1,777520000,777520000,15901,5300,10601,5300,0,1,5302,34112065,34.112065
5500,6300,5300,34650000,2,42406,10603,1,777520000,777520000,15901,5300,10601,5300,0,1,5302,35669659,35.669659
5500,6300,5300,34650000,2,42406,10603,1,777520000,777520000,15901,5300,10601,5300,0,1,5302,34033344,34.033344
5500,6300,5300,34650000,2,42406,10603,1,777520000,777520000,15901,5300,10601,5300,0,1,5302,35812350,35.81235
5500,6300,5300,34650000,2,42406,10603,1,777520000,777520000,15901,5300,10601,5300,0,1,5302,34275877,34.275877
5500,6300,5300,34650000,2,42406,10603,1,777520000,777520000,15901,5300,10601,5300,0,1,5302,34088246,34.088246
5500,6300,5300,34650000,2,42406,10603,1,777520000,777520000,15901,5300,10601,5300,0,1,5302,35162702,35.162702
5500,6300,5700,34650000,2,45606,11403,1,815280000,815280000,17101,5700,11401,5700,0,1,5702,36552404,36.552404
5500,6300,5700,34650000,2,45606,11403,1,815280000,815280000,17101,5700,11401,5700,0,1,5702,38246768,38.246768
5500,6300,5700,34650000,2,45606,11403,1,815280000,815280000,17101,5700,11401,5700,0,1,5702,36660239,36.660239
5500,6300,5700,34650000,2,45606,11403,1,815280000,815280000,17101,5700,11401,5700,0,1,5702,38499198,38.499198
5500,6300,5700,34650000,2,45606,11403,1,815280000,815280000,17101,5700,11401,5700,0,1,5702,36827115,36.827115
5500,6300,5700,34650000,2,45606,11403,1,815280000,815280000,17101,5700,11401,5700,0,1,5702,36610397,36.610397
5500,6300,5700,34650000,2,45606,11403,1,815280000,815280000,17101,5700,11401,5700,0,1,5702,37921743,37.921743
5500,6300,6100,34650000,2,48806,12203,1,853040000,853040000,18301,6100,12201,6100,0,1,6102,39121121,39.121121
5500,6300,6100,34650000,2,48806,12203,1,853040000,853040000,18301,6100,12201,6100,0,1,6102,40983178,40.983178
5500,6300,6100,34650000,2,48806,12203,1,853040000,853040000,18301,6100,12201,6100,0,1,6102,39208734,39.208734
5500,6300,6100,34650000,2,48806,12203,1,853040000,853040000,18301,6100,12201,6100,0,1,6102,41210479,41.210479
5500,6300,6100,34650000,2,48806,12203,1,853040000,853040000,18301,6100,12201,6100,0,1,6102,39422504,39.422504
5500,6300,6100,34650000,2,48806,12203,1,853040000,853040000,18301,6100,12201,6100,0,1,6102,39235082,39.235082
5500,6300,6100,34650000,2,48806,12203,1,853040000,853040000,18301,6100,12201,6100,0,1,6102,40621465,40.621465
5500,6300,6500,34650000,2,52006,13003,1,890800000,890800000,19501,6500,13001,6500,0,1,6502,41584855,41.584855
5500,6300,6500,34650000,2,52006,13003,1,890800000,890800000,19501,6500,13001,6500,0,1,6502,43746107,43.746107
5500,6300,6500,34650000,2,52006,13003,1,890800000,890800000,19501,6500,13001,6500,0,1,6502,41867371,41.867371
5500,6300,6500,34650000,2,52006,13003,1,890800000,890800000,19501,6500,13001,6500,0,1,6502,43859560,43.85956
5500,6300,6500,34650000,2,52006,13003,1,890800000,890800000,19501,6500,13001,6500,0,1,6502,42076558,42.076558
5500,6300,6500,34650000,2,52006,13003,1,890800000,890800000,19501,6500,13001,6500,0,1,6502,41712854,41.712854
5500,6300,6500,34650000,2,52006,13003,1,890800000,890800000,19501,6500,13001,6500,0,1,6502,43248107,43.248107
5500,6300,6900,34650000,2,55206,13803,1,928560000,928560000,20701,6900,13801,6900,0,1,6902,44178424,44.178424
5500,6300,6900,34650000,2,55206,13803,1,928560000,928560000,20701,6900,13801,6900,0,1,6902,46402437,46.402437
5500,6300,6900,34650000,2,55206,13803,1,928560000,928560000,20701,6900,13801,6900,0,1,6902,44316998,44.316998
5500,6300,6900,34650000,2,55206,13803,1,928560000,928560000,20701,6900,13801,6900,0,1,6902,46541815,46.541815
5500,6300,6900,34650000,2,55206,13803,1,928560000,928560000,20701,6900,13801,6900,0,1,6902,44582400,44.5824
5500,6300,6900,34650000,2,55206,13803,1,928560000,928560000,20701,6900,13801,6900,0,1,6902,44251499,44.251499
5500,6300,6900,34650000,2,55206,13803,1,928560000,928560000,20701,6900,13801,6900,0,1,6902,45782226,45.782226
5500,5900,500,32450000,2,4006,1003,1,305200000,305200000,1501,500,1001,500,0,1,502,3450689,3.450689
5500,5900,500,32450000,2,4006,1003,1,305200000,305200000,1501,500,1001,500,0,1,502,3519731,3.519731
5500,5900,500,32450000,2,4006,1003,1,305200000,305200000,1501,500,1001,500,0,1,502,3390571,3.390571
5500,5900,500,32450000,2,4006,1003,1,305200000,305200000,1501,500,1001,500,0,1,502,3520319,3.520319
5500,5900,500,32450000,2,4006,1003,1,305200000,305200000,1501,500,1001,500,0,1,502,3413117,3.413117
5500,5900,500,32450000,2,4006,1003,1,305200000,305200000,1501,500,1001,500,0,1,502,3495839,3.495839
5500,5900,500,32450000,2,4006,1003,1,305200000,305200000,1501,500,1001,500,0,1,502,3473774,3.473774
5500,5900,900,32450000,2,7206,1803,1,341680000,341680000,2701,900,1801,900,0,1,902,5597552,5.597552
5500,5900,900,32450000,2,7206,1803,1,341680000,341680000,2701,900,1801,900,0,1,902,5893304,5.893304
5500,5900,900,32450000,2,7206,1803,1,341680000,341680000,2701,900,1801,900,0,1,902,5619474,5.619474
5500,5900,900,32450000,2,7206,1803,1,341680000,341680000,2701,900,1801,900,0,1,902,5915066,5.915066
5500,5900,900,32450000,2,7206,1803,1,341680000,341680000,2701,900,1801,900,0,1,902,5738585,5.738585
5500,5900,900,32450000,2,7206,1803,1,341680000,341680000,2701,900,1801,900,0,1,902,5697436,5.697436
5500,5900,900,32450000,2,7206,1803,1,341680000,341680000,2701,900,1801,900,0,1,902,5783469,5.783469
5500,5900,1300,32450000,2,10406,2603,1,378160000,378160000,3901,1300,2601,1300,0,1,1302,8170517,8.170517
5500,5900,1300,32450000,2,10406,2603,1,378160000,378160000,3901,1300,2601,1300,0,1,1302,8432724,8.432724
5500,5900,1300,32450000,2,10406,2603,1,378160000,378160000,3901,1300,2601,1300,0,1,1302,8112751,8.112751
5500,5900,1300,32450000,2,10406,2603,1,378160000,378160000,3901,1300,2601,1300,0,1,1302,8494248,8.494248
5500,5900,1300,32450000,2,10406,2603,1,378160000,378160000,3901,1300,2601,1300,0,1,1302,8241821,8.241821
5500,5900,1300,32450000,2,10406,2603,1,378160000,378160000,3901,1300,2601,1300,0,1,1302,8219194,8.219194
5500,5900,1300,32450000,2,10406,2603,1,378160000,378160000,3901,1300,2601,1300,0,1,1302,8348050,8.34805
5500,5900,1700,32450000,2,13606,3403,1,414640000,414640000,5101,1700,3401,1700,0,1,1702,10344884,10.344884
5500,5900,1700,32450000,2,13606,3403,1,414640000,414640000,5101,1700,3401,1700,0,1,1702,10798905,10.798905
5500,5900,1700,32450000,2,13606,3403,1,414640000,414640000,5101,1700,3401,1700,0,1,1702,10322906,10.322906
5500,5900,1700,32450000,2,13606,3403,1,414640000,414640000,5101,1700,3401,1700,0,1,1702,10853263,10.853263
5500,5900,1700,32450000,2,13606,3403,1,414640000,414640000,5101,1700,3401,1700,0,1,1702,10522618,10.522618
5500,5900,1700,32450000,2,13606,3403,1,414640000,414640000,5101,1700,3401,1700,0,1,1702,10396259,10.396259
5500,5900,1700,32450000,2,13606,3403,1,414640000,414640000,5101,1700,3401,1700,0,1,1702,10667409,10.667409
5500,5900,2100,32450000,2,16806,4203,1,451120000,451120000,6301,2100,4201,2100,0,1,2102,12867210,12.86721
5500,5900,2100,32450000,2,16806,4203,1,451120000,451120000,6301,2100,4201,2100,0,1,2102,13442271,13.442271
5500,5900,2100,32450000,2,16806,4203,1,451120000,451120000,6301,2100,4201,2100,0,1,2102,12818041,12.818041
5500,5900,2100,32450000,2,16806,4203,1,451120000,451120000,6301,2100,4201,2100,0,1,2102,13488994,13.488994
5500,5900,2100,32450000,2,16806,4203,1,451120000,451120000,6301,2100,4201,2100,0,1,2102,13049990,13.04999
5500,5900,2100,32450000,2,16806,4203,1,451120000,451120000,6301,2100,4201,2100,0,1,2102,12976290,12.97629
5500,5900,2100,32450000,2,16806,4203,1,451120000,451120000,6301,2100,4201,2100,0,1,2102,13219101,13.219101
6100,6900,500,42090000,2,4006,1003,1,388720000,388720000,1501,500,1001,500,0,1,502,4391833,4.391833
6100,6900,500,42090000,2,4006,1003,1,388720000,388720000,1501,500,1001,500,0,1,502,4426454,4.426454
6100,6900,500,42090000,2,4006,1003,1,388720000,388720000,1501,500,1001,500,0,1,502,4393945,4.393945
6100,6900,500,42090000,2,4006,1003,1,388720000,388720000,1501,500,1001,500,0,1,502,4456192,4.456192
6100,6900,500,42090000,2,4006,1003,1,388720000,388720000,1501,500,1001,500,0,1,502,4364003,4.364003
6100,6900,500,42090000,2,4006,1003,1,388720000,388720000,1501,500,1001,500,0,1,502,4486911,4.486911
6100,6900,500,42090000,2,4006,1003,1,388720000,388720000,1501,500,1001,500,0,1,502,4392606,4.392606
6100,6900,500,42090000,2,4006,1003,1,388720000,388720000,1501,500,1001,500,0,1,502,4519354,4.519354
6100,6900,900,42090000,2,7206,1803,1,430320000,430320000,2701,900,1801,900,0,1,902,7232221,7.232221
6100,6900,900,42090000,2,7206,1803,1,430320000,430320000,2701,900,1801,900,0,1,902,7590358,7.590358
6100,6900,900,42090000,2,7206,1803,1,430320000,430320000,2701,900,1801,900,0,1,902,7290087,7.290087
6100,6900,900,42090000,2,7206,1803,1,430320000,430320000,2701,900,1801,900,0,1,902,7518800,7.5188
6100,6900,900,42090000,2,7206,1803,1,430320000,430320000,2701,900,1801,900,0,1,902,7262127,7.262127
6100,6900,900,42090000,2,7206,1803,1,430320000,430320000,2701,900,1801,900,0,1,902,7561330,7.56133
6100,6900,900,42090000,2,7206,1803,1,430320000,430320000,2701,900,1801,900,0,1,902,7260616,7.260616
6100,6900,900,42090000,2,7206,1803,1,430320000,430320000,2701,900,1801,900,0,1,902,7643097,7.643097
6100,6900,1300,42090000,2,10406,2603,1,471920000,471920000,3901,1300,2601,1300,0,1,1302,10383338,10.383338
6100,6900,1300,42090000,2,10406,2603,1,471920000,471920000,3901,1300,2601,1300,0,1,1302,10885807,10.885807
6100,6900,1300,42090000,2,10406,2603,1,471920000,471920000,3901,1300,2601,1300,0,1,1302,10515240,10.51524
6100,6900,1300,42090000,2,10406,2603,1,471920000,471920000,3901,1300,2601,1300,0,1,1302,10759561,10.759561
6100,6900,1300,42090000,2,10406,2603,1,471920000,471920000,3901,1300,2601,1300,0,1,1302,10467239,10.467239
6100,6900,1300,42090000,2,10406,2603,1,471920000,471920000,3901,1300,2601,1300,0,1,1302,10915930,10.91593
6100,6900,1300,42090000,2,10406,2603,1,471920000,471920000,3901,1300,2601,1300,0,1,1302,10438692,10.438692
6100,6900,1300,42090000,2,10406,2603,1,471920000,471920000,3901,1300,2601,1300,0,1,1302,10987873,10.987873
6100,6900,1700,42090000,2,13606,3403,1,513520000,513520000,5101,1700,3401,1700,0,1,1702,13594078,13.594078
6100,6900,1700,42090000,2,13606,3403,1,513520000,513520000,5101,1700,3401,1700,0,1,1702,14087966,14.087966
6100,6900,1700,42090000,2,13606,3403,1,513520000,513520000,5101,1700,3401,1700,0,1,1702,13623061,13.623061
6100,6900,1700,42090000,2,13606,3403,1,513520000,513520000,5101,1700,3401,1700,0,1,1702,13926928,13.926928
6100,6900,1700,42090000,2,13606,3403,1,513520000,513520000,5101,1700,3401,1700,0,1,1702,13517576,13.517576
6100,6900,1700,42090000,2,13606,3403,1,513520000,513520000,5101,1700,3401,1700,0,1,1702,14120006,14.120006
6100,6900,1700,42090000,2,13606,3403,1,513520000,513520000,5101,1700,3401,1700,0,1,1702,13471462,13.471462
6100,6900,1700,42090000,2,13606,3403,1,513520000,513520000,5101,1700,3401,1700,0,1,1702,14227598,14.227598
6100,6900,2100,42090000,2,16806,4203,1,555120000,555120000,6301,2100,4201,2100,0,1,2102,16698666,16.698666
6100,6900,2100,42090000,2,16806,4203,1,555120000,555120000,6301,2100,4201,2100,0,1,2102,17250709,17.250709
6100,6900,2100,42090000,2,16806,4203,1,555120000,555120000,6301,2100,4201,2100,0,1,2102,16846670,16.84667
6100,6900,2100,42090000,2,16806,4203,1,555120000,555120000,6301,2100,4201,2100,0,1,2102,17176054,17.176054
6100,6900,2100,42090000,2,16806,4203,1,555120000,555120000,6301,2100,4201,2100,0,1,2102,16635012,16.635012
6100,6900,2100,42090000,2,16806,4203,1,555120000,555120000,6301,2100,4201,2100,0,1,2102,17304957,17.304957
6100,6900,2100,42090000,2,16806,4203,1,555120000,555120000,6301,2100,4201,2100,0,1,2102,16593662,16.593662
6100,6900,2100,42090000,2,16806,4203,1,555120000,555120000,6301,2100,4201,2100,0,1,2102,17548877,17.548877
6100,6900,2500,42090000,2,20006,5003,1,596720000,596720000,7501,2500,5001,2500,0,1,2502,19772355,19.772355
6100,6900,2500,42090000,2,20006,5003,1,596720000,596720000,7501,2500,5001,2500,0,1,2502,20520445,20.520445
6100,6900,2500,42090000,2,20006,5003,1,596720000,596720000,7501,2500,5001,2500,0,1,2502,19982127,19.982127
6100,6900,2500,42090000,2,20006,5003,1,596720000,596720000,7501,2500,5001,2500,0,1,2502,20394910,20.39491
6100,6900,2500,42090000,2,20006,5003,1,596720000,596720000,7501,2500,5001,2500,0,1,2502,19695531,19.695531
6100,6900,2500,42090000,2,20006,5003,1,596720000,596720000,7501,2500,5001,2500,0,1,2502,20569461,20.569461
6100,6900,2500,42090000,2,20006,5003,1,596720000,596720000,7501,2500,5001,2500,0,1,2502,19667235,19.667235
6100,6900,2500,42090000,2,20006,5003,1,596720000,596720000,7501,2500,5001,2500,0,1,2502,20783163,20.783163
6100,6900,2900,42090000,2,23206,5803,1,638320000,638320000,8701,2900,5801,2900,0,1,2902,22947144,22.947144
6100,6900,2900,42090000,2,23206,5803,1,638320000,638320000,8701,2900,5801,2900,0,1,2902,23752839,23.752839
6100,6900,2900,42090000,2,23206,5803,1,638320000,638320000,8701,2900,5801,2900,0,1,2902,23058621,23.058621
6100,6900,2900,42090000,2,23206,5803,1,638320000,638320000,8701,2900,5801,2900,0,1,2902,23600502,23.600502
6100,6900,2900,42090000,2,23206,5803,1,638320000,638320000,8701,2900,5801,2900,0,1,2902,22734382,22.734382
6100,6900,2900,42090000,2,23206,5803,1,638320000,638320000,8701,2900,5801,2900,0,1,2902,23815624,23.815624
6100,6900,2900,42090000,2,23206,5803,1,638320000,638320000,8701,2900,5801,2900,0,1,2902,22669797,22.669797
6100,6900,2900,42090000,2,23206,5803,1,638320000,638320000,8701,2900,5801,2900,0,1,2902,24013895,24.013895
6100,6900,3300,42090000,2,26406,6603,1,679920000,679920000,9901,3300,6601,3300,0,1,3302,26015368,26.015368
6100,6900,3300,42090000,2,26406,6603,1,679920000,679920000,9901,3300,6601,3300,0,1,3302,27027867,27.027867
6100,6900,3300,42090000,2,26406,6603,1,679920000,679920000,9901,3300,6601,3300,0,1,3302,26275604,26.275604
6100,6900,3300,42090000,2,26406,6603,1,679920000,679920000,9901,3300,6601,3300,0,1,3302,26854271,26.854271
6100,6900,3300,42090000,2,26406,6603,1,679920000,679920000,9901,3300,6601,3300,0,1,3302,25893736,25.893736
6100,6900,3300,42090000,2,26406,6603,1,679920000,679920000,9901,3300,6601,3300,0,1,3302,27091456,27.091456
6100,6900,3300,42090000,2,26406,6603,1,679920000,679920000,9901,3300,6601,3300,0,1,3302,25753506,25.753506
6100,6900,3300,42090000,2,26406,6603,1,679920000,679920000,9901,3300,6601,3300,0,1,3302,27261747,27.261747
6100,6900,3700,42090000,2,29606,7403,1,721520000,721520000,11101,3700,7401,3700,0,1,3702,29094395,29.094395
6100,6900,3700,42090000,2,29606,7403,1,721520000,721520000,11101,3700,7401,3700,0,1,3702,30182180,30.18218
6100,6900,3700,42090000,2,29606,7403,1,721520000,721520000,11101,3700,7401,3700,0,1,3702,29316419,29.316419
6100,6900,3700,42090000,2,29606,7403,1,721520000,721520000,11101,3700,7401,3700,0,1,3702,29980945,29.980945
6100,6900,3700,42090000,2,29606,7403,1,721520000,721520000,11101,3700,7401,3700,0,1,3702,28942286,28.942286
6100,6900,3700,42090000,2,29606,7403,1,721520000,721520000,11101,3700,7401,3700,0,1,3702,30251875,30.251875
6100,6900,3700,42090000,2,29606,7403,1,721520000,721520000,11101,3700,7401,3700,0,1,3702,28796848,28.796848
6100,6900,3700,42090000,2,29606,7403,1,721520000,721520000,11101,3700,7401,3700,0,1,3702,30529930,30.52993
6100,6900,4100,42090000,2,32806,8203,1,763120000,763120000,12301,4100,8201,4100,0,1,4102,32174705,32.174705
6100,6900,4100,42090000,2,32806,8203,1,763120000,763120000,12301,4100,8201,4100,0,1,4102,33377324,33.377324
6100,6900,4100,42090000,2,32806,8203,1,763120000,763120000,12301,4100,8201,4100,0,1,4102,32449461,32.449461
6100,6900,4100,42090000,2,32806,8203,1,763120000,763120000,12301,4100,8201,4100,0,1,4102,33155579,33.155579
6100,6900,4100,42090000,2,32806,8203,1,763120000,763120000,12301,4100,8201,4100,0,1,4102,32040416,32.040416
6100,6900,4100,42090000,2,32806,8203,1,763120000,763120000,12301,4100,8201,4100,0,1,4102,33529057,33.529057
6100,6900,4100,42090000,2,32806,8203,1,763120000,763120000,12301,4100,8201,4100,0,1,4102,31891506,31.891506
6100,6900,4100,42090000,2,32806,8203,1,763120000,763120000,12301,4100,8201,4100,0,1,4102,33822871,33.822871
6100,6900,4500,42090000,2,36006,9003,1,804720000,804720000,13501,4500,9001,4500,0,1,4502,35334675,35.334675
6100,6900,4500,42090000,2,36006,9003,1,804720000,804720000,13501,4500,9001,4500,0,1,4502,36692721,36.692721
6100,6900,4500,42090000,2,36006,9003,1,804720000,804720000,13501,4500,9001,4500,0,1,4502,35570170,35.57017
6100,6900,4500,42090000,2,36006,9003,1,804720000,804720000,13501,4500,9001,4500,0,1,4502,36422622,36.422622
6100,6900,4500,42090000,2,36006,9003,1,804720000,804720000,13501,4500,9001,4500,0,1,4502,35203423,35.203423
6100,6900,4500,42090000,2,36006,9003,1,804720000,804720000,13501,4500,9001,4500,0,1,4502,36810469,36.810469
6100,6900,4500,42090000,2,36006,9003,1,804720000,804720000,13501,4500,9001,4500,0,1,4502,35041750,35.04175
6100,6900,4500,42090000,2,36006,9003,1,804720000,804720000,13501,4500,9001,4500,0,1,4502,37158974,37.158974
6100,6900,4900,42090000,2,39206,9803,1,846320000,846320000,14701,4900,9801,4900,0,1,4902,38388382,38.388382
6100,6900,4900,42090000,2,39206,9803,1,846320000,846320000,14701,4900,9801,4900,0,1,4902,40024353,40.024353
6100,6900,4900,42090000,2,39206,9803,1,846320000,846320000,14701,4900,9801,4900,0,1,4902,38709685,38.709685
6100,6900,4900,42090000,2,39206,9803,1,846320000,846320000,14701,4900,9801,4900,0,1,4902,39650587,39.650587
6100,6900,4900,42090000,2,39206,9803,1,846320000,846320000,14701,4900,9801,4900,0,1,4902,38293377,38.293377
6100,6900,4900,42090000,2,39206,9803,1,846320000,846320000,14701,4900,9801,4900,0,1,4902,39993775,39.993775
6100,6900,4900,42090000,2,39206,9803,1,846320000,846320000,14701,4900,9801,4900,0,1,4902,38140262,38.140262
6100,6900,4900,42090000,2,39206,9803,1,846320000,846320000,14701,4900,9801,4900,0,1,4902,40386262,40.386262
6100,6900,5300,42090000,2,42406,10603,1,887920000,887920000,15901,5300,10601,5300,0,1,5302,41527583,41.527583
6100,6900,5300,42090000,2,42406,10603,1,887920000,887920000,15901,5300,10601,5300,0,1,5302,43238840,43.23884
6100,6900,5300,42090000,2,42406,10603,1,887920000,887920000,15901,5300,10601,5300,0,1,5302,41859125,41.859125
6100,6900,5300,42090000,2,42406,10603,1,887920000,887920000,15901,5300,10601,5300,0,1,5302,42940603,42.940603
6100,6900,5300,42090000,2,42406,10603,1,887920000,887920000,15901,5300,10601,5300,0,1,5302,41379818,41.379818
6100,6900,5300,42090000,2,42406,10603,1,887920000,887920000,15901,5300,10601,5300,0,1,5302,43268128,43.268128
6100,6900,5300,42090000,2,42406,10603,1,887920000,887920000,15901,5300,10601,5300,0,1,5302,41273641,41.273641
6100,6900,5300,42090000,2,42406,10603,1,887920000,887920000,15901,5300,10601,5300,0,1,5302,43636356,43.636356
6100,6900,5700,42090000,2,45606,11403,1,929520000,929520000,17101,5700,11401,5700,0,1,5702,44669776,44.669776
6100,6900,5700,42090000,2,45606,11403,1,929520000,929520000,17101,5700,11401,5700,0,1,5702,46645257,46.645257
6100,6900,5700,42090000,2,45606,11403,1,929520000,929520000,17101,5700,11401,5700,0,1,5702,45077516,45.077516
6100,6900,5700,42090000,2,45606,11403,1,929520000,929520000,17101,5700,11401,5700,0,1,5702,46125297,46.125297
6100,6900,5700,42090000,2,45606,11403,1,929520000,929520000,17101,5700,11401,5700,0,1,5702,44526684,44.526684
6100,6900,5700,42090000,2,45606,11403,1,929520000,929520000,17101,5700,11401,5700,0,1,5702,46585924,46.585924
6100,6900,5700,42090000,2,45606,11403,1,929520000,929520000,17101,5700,11401,5700,0,1,5702,44380781,44.380781
6100,6900,5700,42090000,2,45606,11403,1,929520000,929520000,17101,5700,11401,5700,0,1,5702,46988721,46.988721
6100,6900,6100,42090000,2,48806,12203,1,971120000,971120000,18301,6100,12201,6100,0,1,6102,47750189,47.750189
6100,6900,6100,42090000,2,48806,12203,1,971120000,971120000,18301,6100,12201,6100,0,1,6102,49868980,49.86898
6100,6900,6100,42090000,2,48806,12203,1,971120000,971120000,18301,6100,12201,6100,0,1,6102,48194885,48.194885
6100,6900,6100,42090000,2,48806,12203,1,971120000,971120000,18301,6100,12201,6100,0,1,6102,49449432,49.449432
6100,6900,6100,42090000,2,48806,12203,1,971120000,971120000,18301,6100,12201,6100,0,1,6102,47654684,47.654684
6100,6900,6100,42090000,2,48806,12203,1,971120000,971120000,18301,6100,12201,6100,0,1,6102,49837212,49.837212
6100,6900,6100,42090000,2,48806,12203,1,971120000,971120000,18301,6100,12201,6100,0,1,6102,47449047,47.449047
6100,6900,6100,42090000,2,48806,12203,1,971120000,971120000,18301,6100,12201,6100,0,1,6102,50223839,50.223839
6100,6900,6500,42090000,2,52006,13003,1,1012720000,1012720000,19501,6500,13001,6500,0,1,6502,50926841,50.926841
6100,6900,6500,42090000,2,52006,13003,1,1012720000,1012720000,19501,6500,13001,6500,0,1,6502,53156858,53.156858
6100,6900,6500,42090000,2,52006,13003,1,1012720000,1012720000,19501,6500,13001,6500,0,1,6502,51374219,51.374219
6100,6900,6500,42090000,2,52006,13003,1,1012720000,1012720000,19501,6500,13001,6500,0,1,6502,52775108,52.775108
6100,6900,6500,42090000,2,52006,13003,1,1012720000,1012720000,19501,6500,13001,6500,0,1,6502,50829520,50.82952
6100,6900,6500,42090000,2,52006,13003,1,1012720000,1012720000,19501,6500,13001,6500,0,1,6502,53123047,53.123047
6100,6900,6500,42090000,2,52006,13003,1,1012720000,1012720000,19501,6500,13001,6500,0,1,6502,50609886,50.609886
6100,6900,6500,42090000,2,52006,13003,1,1012720000,1012720000,19501,6500,13001,6500,0,1,6502,53583711,53.583711
6100,6900,6900,42090000,2,55206,13803,1,1054320000,1054320000,20701,6900,13801,6900,0,1,6902,54162538,54.162538
6100,6900,6900,42090000,2,55206,13803,1,1054320000,1054320000,20701,6900,13801,6900,0,1,6902,56483558,56.483558
6100,6900,6900,42090000,2,55206,13803,1,1054320000,1054320000,20701,6900,13801,6900,0,1,6902,54471373,54.471373
6100,6900,6900,42090000,2,55206,13803,1,1054320000,1054320000,20701,6900,13801,6900,0,1,6902,56093146,56.093146
6100,6900,6900,42090000,2,55206,13803,1,1054320000,1054320000,20701,6900,13801,6900,0,1,6902,53948284,53.948284
6100,6900,6900,42090000,2,55206,13803,1,1054320000,1054320000,20701,6900,13801,6900,0,1,6902,56392555,56.392555
6100,6900,6900,42090000,2,55206,13803,1,1054320000,1054320000,20701,6900,13801,6900,0,1,6902,53806617,53.806617
6100,6900,6900,42090000,2,55206,13803,1,1054320000,1054320000,20701,6900,13801,6900,0,1,6902,56907197,56.907197
6100,6500,500,39650000,2,4006,1003,1,367600000,367600000,1501,500,1001,500,0,1,502,4201520,4.20152
6100,6500,500,39650000,2,4006,1003,1,367600000,367600000,1501,500,1001,500,0,1,502,4361531,4.361531
6100,6500,500,39650000,2,4006,1003,1,367600000,367600000,1501,500,1001,500,0,1,502,4201779,4.201779
6100,6500,500,39650000,2,4006,1003,1,367600000,367600000,1501,500,1001,500,0,1,502,4231017,4.231017
6100,6500,500,39650000,2,4006,1003,1,367600000,367600000,1501,500,1001,500,0,1,502,4229746,4.229746
6100,6500,500,39650000,2,4006,1003,1,367600000,367600000,1501,500,1001,500,0,1,502,4295156,4.295156
6100,6500,500,39650000,2,4006,1003,1,367600000,367600000,1501,500,1001,500,0,1,502,4173472,4.173472
6100,6500,500,39650000,2,4006,1003,1,367600000,367600000,1501,500,1001,500,0,1,502,4232084,4.232084
6100,6500,900,39650000,2,7206,1803,1,407920000,407920000,2701,900,1801,900,0,1,902,6885624,6.885624
6100,6500,900,39650000,2,7206,1803,1,407920000,407920000,2701,900,1801,900,0,1,902,7244627,7.244627
6100,6500,900,39650000,2,7206,1803,1,407920000,407920000,2701,900,1801,900,0,1,902,6944438,6.944438
6100,6500,900,39650000,2,7206,1803,1,407920000,407920000,2701,900,1801,900,0,1,902,7216094,7.216094
6100,6500,900,39650000,2,7206,1803,1,407920000,407920000,2701,900,1801,900,0,1,902,6912210,6.91221
6100,6500,900,39650000,2,7206,1803,1,407920000,407920000,2701,900,1801,900,0,1,902,7187705,7.187705
6100,6500,900,39650000,2,7206,1803,1,407920000,407920000,2701,900,1801,900,0,1,902,6843949,6.843949
6100,6500,900,39650000,2,7206,1803,1,407920000,407920000,2701,900,1801,900,0,1,902,7245995,7.245995
6100,6500,1300,39650000,2,10406,2603,1,448240000,448240000,3901,1300,2601,1300,0,1,1302,9794167,9.794167
6100,6500,1300,39650000,2,10406,2603,1,448240000,448240000,3901,1300,2601,1300,0,1,1302,10237723,10.237723
6100,6500,1300,39650000,2,10406,2603,1,448240000,448240000,3901,1300,2601,1300,0,1,1302,9876514,9.876514
6100,6500,1300,39650000,2,10406,2603,1,448240000,448240000,3901,1300,2601,1300,0,1,1302,10092961,10.092961
6100,6500,1300,39650000,2,10406,2603,1,448240000,448240000,3901,1300,2601,1300,0,1,1302,9748868,9.748868
6100,6500,1300,39650000,2,10406,2603,1,448240000,448240000,3901,1300,2601,1300,0,1,1302,10209190,10.20919
6100,6500,1300,39650000,2,10406,2603,1,448240000,448240000,3901,1300,2601,1300,0,1,1302,9722195,9.722195
6100,6500,1300,39650000,2,10406,2603,1,448240000,448240000,3901,1300,2601,1300,0,1,1302,10302230,10.30223
6100,6500,1700,39650000,2,13606,3403,1,488560000,488560000,5101,1700,3401,1700,0,1,1702,12828907,12.828907
6100,6500,1700,39650000,2,13606,3403,1,488560000,488560000,5101,1700,3401,1700,0,1,1702,13379220,13.37922
6100,6500,1700,39650000,2,13606,3403,1,488560000,488560000,5101,1700,3401,1700,0,1,1702,12930383,12.930383
6100,6500,1700,39650000,2,13606,3403,1,488560000,488560000,5101,1700,3401,1700,0,1,1702,13191102,13.191102
6100,6500,1700,39650000,2,13606,3403,1,488560000,488560000,5101,1700,3401,1700,0,1,1702,12804110,12.80411
6100,6500,1700,39650000,2,13606,3403,1,488560000,488560000,5101,1700,3401,1700,0,1,1702,13350560,13.35056
6100,6500,1700,39650000,2,13606,3403,1,488560000,488560000,5101,1700,3401,1700,0,1,1702,12754225,12.754225
6100,6500,1700,39650000,2,13606,3403,1,488560000,488560000,5101,1700,3401,1700,0,1,1702,13429765,13.429765
6100,6500,2100,39650000,2,16806,4203,1,528880000,528880000,6301,2100,4201,2100,0,1,2102,15744379,15.744379
6100,6500,2100,39650000,2,16806,4203,1,528880000,528880000,6301,2100,4201,2100,0,1,2102,16300916,16.300916
6100,6500,2100,39650000,2,16806,4203,1,528880000,528880000,6301,2100,4201,2100,0,1,2102,15851523,15.851523
6100,6500,2100,39650000,2,16806,4203,1,528880000,528880000,6301,2100,4201,2100,0,1,2102,16127035,16.127035
6100,6500,2100,39650000,2,16806,4203,1,528880000,528880000,6301,2100,4201,2100,0,1,2102,15682076,15.682076
6100,6500,2100,39650000,2,16806,4203,1,528880000,528880000,6301,2100,4201,2100,0,1,2102,16347933,16.347933
6100,6500,2100,39650000,2,16806,4203,1,528880000,528880000,6301,2100,4201,2100,0,1,2102,15587227,15.587227
6100,6500,2100,39650000,2,16806,4203,1,528880000,528880000,6301,2100,4201,2100,0,1,2102,16482362,16.482362
6100,6500,2500,39650000,2,20006,5003,1,569200000,569200000,7501,2500,5001,2500,0,1,2502,18668683,18.668683
6100,6500,2500,39650000,2,20006,5003,1,569200000,569200000,7501,2500,5001,2500,0,1,2502,19337873,19.337873
6100,6500,2500,39650000,2,20006,5003,1,569200000,569200000,7501,2500,5001,2500,0,1,2502,18828305,18.828305
6100,6500,2500,39650000,2,20006,5003,1,569200000,569200000,7501,2500,5001,2500,0,1,2502,19199019,19.199019
6100,6500,2500,39650000,2,20006,5003,1,569200000,569200000,7501,2500,5001,2500,0,1,2502,18526439,18.526439
6100,6500,2500,39650000,2,20006,5003,1,569200000,569200000,7501,2500,5001,2500,0,1,2502,19378062,19.378062
6100,6500,2500,39650000,2,20006,5003,1,569200000,569200000,7501,2500,5001,2500,0,1,2502,18473502,18.473502
6100,6500,2500,39650000,2,20006,5003,1,569200000,569200000,7501,2500,5001,2500,0,1,2502,19561407,19.561407
6100,6500,2900,39650000,2,23206,5803,1,609520000,609520000,8701,2900,5801,2900,0,1,2902,21538369,21.538369
6100,6500,2900,39650000,2,23206,5803,1,609520000,609520000,8701,2900,5801,2900,0,1,2902,22393201,22.393201
6100,6500,2900,39650000,2,23206,5803,1,609520000,609520000,8701,2900,5801,2900,0,1,2902,21730400,21.7304
6100,6500,2900,39650000,2,23206,5803,1,609520000,609520000,8701,2900,5801,2900,0,1,2902,22217459,22.217459
6100,6500,2900,39650000,2,23206,5803,1,609520000,609520000,8701,2900,5801,2900,0,1,2902,21439181,21.439181
6100,6500,2900,39650000,2,23206,5803,1,609520000,609520000,8701,2900,5801,2900,0,1,2902,22422866,22.422866
6100,6500,2900,39650000,2,23206,5803,1,609520000,609520000,8701,2900,5801,2900,0,1,2902,21371102,21.371102
6100,6500,2900,39650000,2,23206,5803,1,609520000,609520000,8701,2900,5801,2900,0,1,2902,22650062,22.650062
6100,6500,3300,39650000,2,26406,6603,1,649840000,649840000,9901,3300,6601,3300,0,1,3302,24480681,24.480681
6100,6500,3300,39650000,2,26406,6603,1,649840000,649840000,9901,3300,6601,3300,0,1,3302,25412223,25.412223
6100,6500,3300,39650000,2,26406,6603,1,649840000,649840000,9901,3300,6601,3300,0,1,3302,24664532,24.664532
6100,6500,3300,39650000,2,26406,6603,1,649840000,649840000,9901,3300,6601,3300,0,1,3302,25247094,25.247094
6100,6500,3300,39650000,2,26406,6603,1,649840000,649840000,9901,3300,6601,3300,0,1,3302,24342321,24.342321
6100,6500,3300,39650000,2,26406,6603,1,649840000,649840000,9901,3300,6601,3300,0,1,3302,25468097,25.468097
6100,6500,3300,39650000,2,26406,6603,1,649840000,649840000,9901,3300,6601,3300,0,1,3302,24254688,24.254688
6100,6500,3300,39650000,2,26406,6603,1,649840000,649840000,9901,3300,6601,3300,0,1,3302,25670146,25.670146
6100,6500,3700,39650000,2,29606,7403,1,690160000,690160000,11101,3700,7401,3700,0,1,3702,27463033,27.463033
6100,6500,3700,39650000,2,29606,7403,1,690160000,690160000,11101,3700,7401,3700,0,1,3702,28409676,28.409676
6100,6500,3700,39650000,2,29606,7403,1,690160000,690160000,11101,3700,7401,3700,0,1,3702,27573167,27.573167
6100,6500,3700,39650000,2,29606,7403,1,690160000,690160000,11101,3700,7401,3700,0,1,3702,28218303,28.218303
6100,6500,3700,39650000,2,29606,7403,1,690160000,690160000,11101,3700,7401,3700,0,1,3702,27271503,27.271503
6100,6500,3700,39650000,2,29606,7403,1,690160000,690160000,11101,3700,7401,3700,0,1,3702,28527254,28.527254
6100,6500,3700,39650000,2,29606,7403,1,690160000,690160000,11101,3700,7401,3700,0,1,3702,27158982,27.158982
6100,6500,3700,39650000,2,29606,7403,1,690160000,690160000,11101,3700,7401,3700,0,1,3702,28730936,28.730936
6100,6500,4100,39650000,2,32806,8203,1,730480000,730480000,12301,4100,8201,4100,0,1,4102,30318441,30.318441
6100,6500,4100,39650000,2,32806,8203,1,730480000,730480000,12301,4100,8201,4100,0,1,4102,31452799,31.452799
6100,6500,4100,39650000,2,32806,8203,1,730480000,730480000,12301,4100,8201,4100,0,1,4102,30512461,30.512461
6100,6500,4100,39650000,2,32806,8203,1,730480000,730480000,12301,4100,8201,4100,0,1,4102,31220354,31.220354
6100,6500,4100,39650000,2,32806,8203,1,730480000,730480000,12301,4100,8201,4100,0,1,4102,30196319,30.196319
6100,6500,4100,39650000,2,32806,8203,1,730480000,730480000,12301,4100,8201,4100,0,1,4102,31526185,31.526185
6100,6500,4100,39650000,2,32806,8203,1,730480000,730480000,12301,4100,8201,4100,0,1,4102,30074178,30.074178
6100,6500,4100,39650000,2,32806,8203,1,730480000,730480000,12301,4100,8201,4100,0,1,4102,31807588,31.807588
6100,6500,4500,39650000,2,36006,9003,1,770800000,770800000,13501,4500,9001,4500,0,1,4502,33243094,33.243094
6100,6500,4500,39650000,2,36006,9003,1,770800000,770800000,13501,4500,9001,4500,0,1,4502,34522816,34.522816
6100,6500,4500,39650000,2,36006,9003,1,770800000,770800000,13501,4500,9001,4500,0,1,4502,33439872,33.439872
6100,6500,4500,39650000,2,36006,9003,1,770800000,770800000,13501,4500,9001,4500,0,1,4502,34303751,34.303751
6100,6500,4500,39650000,2,36006,9003,1,770800000,770800000,13501,4500,9001,4500,0,1,4502,33069556,33.069556
6100,6500,4500,39650000,2,36006,9003,1,770800000,770800000,13501,4500,9001,4500,0,1,4502,34568780,34.56878
6100,6500,4500,39650000,2,36006,9003,1,770800000,770800000,13501,4500,9001,4500,0,1,4502,32968467,32.968467
6100,6500,4500,39650000,2,36006,9003,1,770800000,770800000,13501,4500,9001,4500,0,1,4502,34944112,34.944112
6100,6500,4900,39650000,2,39206,9803,1,811120000,811120000,14701,4900,9801,4900,0,1,4902,36192660,36.19266
6100,6500,4900,39650000,2,39206,9803,1,811120000,811120000,14701,4900,9801,4900,0,1,4902,37634512,37.634512
6100,6500,4900,39650000,2,39206,9803,1,811120000,811120000,14701,4900,9801,4900,0,1,4902,36374695,36.374695
6100,6500,4900,39650000,2,39206,9803,1,811120000,811120000,14701,4900,9801,4900,0,1,4902,37375217,37.375217
6100,6500,4900,39650000,2,39206,9803,1,811120000,811120000,14701,4900,9801,4900,0,1,4902,36040594,36.040594
6100,6500,4900,39650000,2,39206,9803,1,811120000,811120000,14701,4900,9801,4900,0,1,4902,37682481,37.682481
6100,6500,4900,39650000,2,39206,9803,1,811120000,811120000,14701,4900,9801,4900,0,1,4902,35881540,35.88154
6100,6500,4900,39650000,2,39206,9803,1,811120000,811120000,14701,4900,9801,4900,0,1,4902,37997630,37.99763
6100,6500,5300,39650000,2,42406,10603,1,851440000,851440000,15901,5300,10601,5300,0,1,5302,39151085,39.151085
6100,6500,5300,39650000,2,42406,10603,1,851440000,851440000,15901,5300,10601,5300,0,1,5302,40661138,40.661138
6100,6500,5300,39650000,2,42406,10603,1,851440000,851440000,15901,5300,10601,5300,0,1,5302,39396024,39.396024
6100,6500,5300,39650000,2,42406,10603,1,851440000,851440000,15901,5300,10601,5300,0,1,5302,40498207,40.498207
6100,6500,5300,39650000,2,42406,10603,1,851440000,851440000,15901,5300,10601,5300,0,1,5302,38952204,38.952204
6100,6500,5300,39650000,2,42406,10603,1,851440000,851440000,15901,5300,10601,5300,0,1,5302,40761002,40.761002
6100,6500,5300,39650000,2,42406,10603,1,851440000,851440000,15901,5300,10601,5300,0,1,5302,38813676,38.813676
6100,6500,5300,39650000,2,42406,10603,1,851440000,851440000,15901,5300,10601,5300,0,1,5302,41078355,41.078355
6100,6500,5700,39650000,2,45606,11403,1,891760000,891760000,17101,5700,11401,5700,0,1,5702,42066904,42.066904
6100,6500,5700,39650000,2,45606,11403,1,891760000,891760000,17101,5700,11401,5700,0,1,5702,43740465,43.740465
6100,6500,5700,39650000,2,45606,11403,1,891760000,891760000,17101,5700,11401,5700,0,1,5702,42401719,42.401719
6100,6500,5700,39650000,2,45606,11403,1,891760000,891760000,17101,5700,11401,5700,0,1,5702,43494064,43.494064
6100,6500,5700,39650000,2,45606,11403,1,891760000,891760000,17101,5700,11401,5700,0,1,5702,41940283,41.940283
6100,6500,5700,39650000,2,45606,11403,1,891760000,891760000,17101,5700,11401,5700,0,1,5702,43834344,43.834344
6100,6500,5700,39650000,2,45606,11403,1,891760000,891760000,17101,5700,11401,5700,0,1,5702,41774582,41.774582
6100,6500,5700,39650000,2,45606,11403,1,891760000,891760000,17101,5700,11401,5700,0,1,5702,44245915,44.245915
6100,6500,6100,39650000,2,48806,12203,1,932080000,932080000,18301,6100,12201,6100,0,1,6102,45011616,45.011616
6100,6500,6100,39650000,2,48806,12203,1,932080000,932080000,18301,6100,12201,6100,0,1,6102,46797340,46.79734
6100,6500,6100,39650000,2,48806,12203,1,932080000,932080000,18301,6100,12201,6100,0,1,6102,45325239,45.325239
6100,6500,6100,39650000,2,48806,12203,1,932080000,932080000,18301,6100,12201,6100,0,1,6102,46699407,46.699407
6100,6500,6100,39650000,2,48806,12203,1,932080000,932080000,18301,6100,12201,6100,0,1,6102,44926662,44.926662
6100,6500,6100,39650000,2,48806,12203,1,932080000,932080000,18301,6100,12201,6100,0,1,6102,46886855,46.886855
6100,6500,6100,39650000,2,48806,12203,1,932080000,932080000,18301,6100,12201,6100,0,1,6102,44733037,44.733037
6100,6500,6100,39650000,2,48806,12203,1,932080000,932080000,18301,6100,12201,6100,0,1,6102,47383166,47.383166
6100,6500,6500,39650000,2,52006,13003,1,972400000,972400000,19501,6500,13001,6500,0,1,6502,47935144,47.935144
6100,6500,6500,39650000,2,52006,13003,1,972400000,972400000,19501,6500,13001,6500,0,1,6502,49848552,49.848552
6100,6500,6500,39650000,2,52006,13003,1,972400000,972400000,19501,6500,13001,6500,0,1,6502,48260814,48.260814
6100,6500,6500,39650000,2,52006,13003,1,972400000,972400000,19501,6500,13001,6500,0,1,6502,49512137,49.512137
6100,6500,6500,39650000,2,52006,13003,1,972400000,972400000,19501,6500,13001,6500,0,1,6502,47761994,47.761994
6100,6500,6500,39650000,2,52006,13003,1,972400000,972400000,19501,6500,13001,6500,0,1,6502,49927901,49.927901
6100,6500,6500,39650000,2,52006,13003,1,972400000,972400000,19501,6500,13001,6500,0,1,6502,47659935,47.659935
6100,6500,6500,39650000,2,52006,13003,1,972400000,972400000,19501,6500,13001,6500,0,1,6502,50369403,50.369403
6100,6500,6900,39650000,2,55206,13803,1,1012720000,1012720000,20701,6900,13801,6900,0,1,6902,50885037,50.885037
6100,6500,6900,39650000,2,55206,13803,1,1012720000,1012720000,20701,6900,13801,6900,0,1,6902,52996572,52.996572
6100,6500,6900,39650000,2,55206,13803,1,1012720000,1012720000,20701,6900,13801,6900,0,1,6902,51257577,51.257577
6100,6500,6900,39650000,2,55206,13803,1,1012720000,1012720000,20701,6900,13801,6900,0,1,6902,52699278,52.699278
6100,6500,6900,39650000,2,55206,13803,1,1012720000,1012720000,20701,6900,13801,6900,0,1,6902,50760540,50.76054
6100,6500,6900,39650000,2,55206,13803,1,1012720000,1012720000,20701,6900,13801,6900,0,1,6902,53027845,53.027845
6100,6500,6900,39650000,2,55206,13803,1,1012720000,1012720000,20701,6900,13801,6900,0,1,6902,50630226,50.630226
6100,6500,6900,39650000,2,55206,13803,1,1012720000,1012720000,20701,6900,13801,6900,0,1,6902,53549076,53.549076
6100,6100,500,37210000,2,4006,1003,1,346480000,346480000,1501,500,1001,500,0,1,502,3906029,3.906029
6100,6100,500,37210000,2,4006,1003,1,346480000,346480000,1501,500,1001,500,0,1,502,4056450,4.05645
6100,6100,500,37210000,2,4006,1003,1,346480000,346480000,1501,500,1001,500,0,1,502,3957534,3.957534
6100,6100,500,37210000,2,4006,1003,1,346480000,346480000,1501,500,1001,500,0,1,502,4123617,4.123617
6100,6100,500,37210000,2,4006,1003,1,346480000,346480000,1501,500,1001,500,0,1,502,3956519,3.956519
6100,6100,500,37210000,2,4006,1003,1,346480000,346480000,1501,500,1001,500,0,1,502,4028688,4.028688
6100,6100,500,37210000,2,4006,1003,1,346480000,346480000,1501,500,1001,500,0,1,502,3931388,3.931388
6100,6100,500,37210000,2,4006,1003,1,346480000,346480000,1501,500,1001,500,0,1,502,4083953,4.083953
6100,6100,900,37210000,2,7206,1803,1,385520000,385520000,2701,900,1801,900,0,1,902,6477820,6.47782
6100,6100,900,37210000,2,7206,1803,1,385520000,385520000,2701,900,1801,900,0,1,902,6698595,6.698595
6100,6100,900,37210000,2,7206,1803,1,385520000,385520000,2701,900,1801,900,0,1,902,6532760,6.53276
6100,6100,900,37210000,2,7206,1803,1,385520000,385520000,2701,900,1801,900,0,1,902,6724850,6.72485
6100,6100,900,37210000,2,7206,1803,1,385520000,385520000,2701,900,1801,900,0,1,902,6452262,6.452262
6100,6100,900,37210000,2,7206,1803,1,385520000,385520000,2701,900,1801,900,0,1,902,6725759,6.725759
6100,6100,900,37210000,2,7206,1803,1,385520000,385520000,2701,900,1801,900,0,1,902,6421649,6.421649
6100,6100,900,37210000,2,7206,1803,1,385520000,385520000,2701,900,1801,900,0,1,902,6787888,6.787888
6100,6100,1300,37210000,2,10406,2603,1,424560000,424560000,3901,1300,2601,1300,0,1,1302,9187073,9.187073
6100,6100,1300,37210000,2,10406,2603,1,424560000,424560000,3901,1300,2601,1300,0,1,1302,9524063,9.524063
6100,6100,1300,37210000,2,10406,2603,1,424560000,424560000,3901,1300,2601,1300,0,1,1302,9282926,9.282926
6100,6100,1300,37210000,2,10406,2603,1,424560000,424560000,3901,1300,2601,1300,0,1,1302,9469866,9.469866
6100,6100,1300,37210000,2,10406,2603,1,424560000,424560000,3901,1300,2601,1300,0,1,1302,9145680,9.14568
6100,6100,1300,37210000,2,10406,2603,1,424560000,424560000,3901,1300,2601,1300,0,1,1302,9556379,9.556379
6100,6100,1300,37210000,2,10406,2603,1,424560000,424560000,3901,1300,2601,1300,0,1,1302,9109167,9.109167
6100,6100,1300,37210000,2,10406,2603,1,424560000,424560000,3901,1300,2601,1300,0,1,1302,9657922,9.657922
6100,6100,1700,37210000,2,13606,3403,1,463600000,463600000,5101,1700,3401,1700,0,1,1702,12066122,12.066122
6100,6100,1700,37210000,2,13606,3403,1,463600000,463600000,5101,1700,3401,1700,0,1,1702,12477667,12.477667
6100,6100,1700,37210000,2,13606,3403,1,463600000,463600000,5101,1700,3401,1700,0,1,1702,12176645,12.176645
6100,6100,1700,37210000,2,13606,3403,1,463600000,463600000,5101,1700,3401,1700,0,1,1702,12354671,12.354671
6100,6100,1700,37210000,2,13606,3403,1,463600000,463600000,5101,1700,3401,1700,0,1,1702,12028292,12.028292
6100,6100,1700,37210000,2,13606,3403,1,463600000,463600000,5101,1700,3401,1700,0,1,1702,12511406,12.511406
6100,6100,1700,37210000,2,13606,3403,1,463600000,463600000,5101,1700,3401,1700,0,1,1702,11957016,11.957016
6100,6100,1700,37210000,2,13606,3403,1,463600000,463600000,5101,1700,3401,1700,0,1,1702,12647741,12.647741
6100,6100,2100,37210000,2,16806,4203,1,502640000,502640000,6301,2100,4201,2100,0,1,2102,14823634,14.823634
6100,6100,2100,37210000,2,16806,4203,1,502640000,502640000,6301,2100,4201,2100,0,1,2102,15308517,15.308517
6100,6100,2100,37210000,2,16806,4203,1,502640000,502640000,6301,2100,4201,2100,0,1,2102,14914690,14.91469
6100,6100,2100,37210000,2,16806,4203,1,502640000,502640000,6301,2100,4201,2100,0,1,2102,15186232,15.186232
6100,6100,2100,37210000,2,16806,4203,1,502640000,502640000,6301,2100,4201,2100,0,1,2102,14742725,14.742725
6100,6100,2100,37210000,2,16806,4203,1,502640000,502640000,6301,2100,4201,2100,0,1,2102,15344674,15.344674
6100,6100,2100,37210000,2,16806,4203,1,502640000,502640000,6301,2100,4201,2100,0,1,2102,14644365,14.644365
6100,6100,2100,37210000,2,16806,4203,1,502640000,502640000,6301,2100,4201,2100,0,1,2102,15515790,15.51579
6100,6100,2500,37210000,2,20006,5003,1,541680000,541680000,7501,2500,5001,2500,0,1,2502,17508547,17.508547
6100,6100,2500,37210000,2,20006,5003,1,541680000,541680000,7501,2500,5001,2500,0,1,2502,18105256,18.105256
6100,6100,2500,37210000,2,20006,5003,1,541680000,541680000,7501,2500,5001,2500,0,1,2502,17711517,17.711517
6100,6100,2500,37210000,2,20006,5003,1,541680000,541680000,7501,2500,5001,2500,0,1,2502,17980465,17.980465
6100,6100,2500,37210000,2,20006,5003,1,541680000,541680000,7501,2500,5001,2500,0,1,2502,17482897,17.482897
6100,6100,2500,37210000,2,20006,5003,1,541680000,541680000,7501,2500,5001,2500,0,1,2502,18223520,18.22352
6100,6100,2500,37210000,2,20006,5003,1,541680000,541680000,7501,2500,5001,2500,0,1,2502,17363831,17.363831
6100,6100,2500,37210000,2,20006,5003,1,541680000,541680000,7501,2500,5001,2500,0,1,2502,18353256,18.353256
6100,6100,2900,37210000,2,23206,5803,1,580720000,580720000,8701,2900,5801,2900,0,1,2902,20284941,20.284941
6100,6100,2900,37210000,2,23206,5803,1,580720000,580720000,8701,2900,5801,2900,0,1,2902,20956109,20.956109
6100,6100,2900,37210000,2,23206,5803,1,580720000,580720000,8701,2900,5801,2900,0,1,2902,20409114,20.409114
6100,6100,2900,37210000,2,23206,5803,1,580720000,580720000,8701,2900,5801,2900,0,1,2902,20861544,20.861544
6100,6100,2900,37210000,2,23206,5803,1,580720000,580720000,8701,2900,5801,2900,0,1,2902,20182389,20.182389
6100,6100,2900,37210000,2,23206,5803,1,580720000,580720000,8701,2900,5801,2900,0,1,2902,21051426,21.051426
6100,6100,2900,37210000,2,23206,5803,1,580720000,580720000,8701,2900,5801,2900,0,1,2902,20059623,20.059623
6100,6100,2900,37210000,2,23206,5803,1,580720000,580720000,8701,2900,5801,2900,0,1,2902,21200636,21.200636
6100,6100,3300,37210000,2,26406,6603,1,619760000,619760000,9901,3300,6601,3300,0,1,3302,22982959,22.982959
6100,6100,3300,37210000,2,26406,6603,1,619760000,619760000,9901,3300,6601,3300,0,1,3302,23803956,23.803956
6100,6100,3300,37210000,2,26406,6603,1,619760000,619760000,9901,3300,6601,3300,0,1,3302,23237462,23.237462
6100,6100,3300,37210000,2,26406,6603,1,619760000,619760000,9901,3300,6601,3300,0,1,3302,23698902,23.698902
6100,6100,3300,37210000,2,26406,6603,1,619760000,619760000,9901,3300,6601,3300,0,1,3302,22957487,22.957487
6100,6100,3300,37210000,2,26406,6603,1,619760000,619760000,9901,3300,6601,3300,0,1,3302,23900253,23.900253
6100,6100,3300,37210000,2,26406,6603,1,619760000,619760000,9901,3300,6601,3300,0,1,3302,22755226,22.755226
6100,6100,3300,37210000,2,26406,6603,1,619760000,619760000,9901,3300,6601,3300,0,1,3302,24102133,24.102133
6100,6100,3700,37210000,2,29606,7403,1,658800000,658800000,11101,3700,7401,3700,0,1,3702,25722939,25.722939
6100,6100,3700,37210000,2,29606,7403,1,658800000,658800000,11101,3700,7401,3700,0,1,3702,26680564,26.680564
6100,6100,3700,37210000,2,29606,7403,1,658800000,658800000,11101,3700,7401,3700,0,1,3702,25953543,25.953543
6100,6100,3700,37210000,2,29606,7403,1,658800000,658800000,11101,3700,7401,3700,0,1,3702,26517189,26.517189
6100,6100,3700,37210000,2,29606,7403,1,658800000,658800000,11101,3700,7401,3700,0,1,3702,25612554,25.612554
6100,6100,3700,37210000,2,29606,7403,1,658800000,658800000,11101,3700,7401,3700,0,1,3702,26765352,26.765352
6100,6100,3700,37210000,2,29606,7403,1,658800000,658800000,11101,3700,7401,3700,0,1,3702,25494092,25.494092
6100,6100,3700,37210000,2,29606,7403,1,658800000,658800000,11101,3700,7401,3700,0,1,3702,26998946,26.998946
6100,6100,4100,37210000,2,32806,8203,1,697840000,697840000,12301,4100,8201,4100,0,1,4102,28464825,28.464825
6100,6100,4100,37210000,2,32806,8203,1,697840000,697840000,12301,4100,8201,4100,0,1,4102,29512012,29.512012
6100,6100,4100,37210000,2,32806,8203,1,697840000,697840000,12301,4100,8201,4100,0,1,4102,28711477,28.711477
6100,6100,4100,37210000,2,32806,8203,1,697840000,697840000,12301,4100,8201,4100,0,1,4102,29319786,29.319786
6100,6100,4100,37210000,2,32806,8203,1,697840000,697840000,12301,4100,8201,4100,0,1,4102,28366968,28.366968
6100,6100,4100,37210000,2,32806,8203,1,697840000,697840000,12301,4100,8201,4100,0,1,4102,29650088,29.650088
6100,6100,4100,37210000,2,32806,8203,1,697840000,697840000,12301,4100,8201,4100,0,1,4102,28221781,28.221781
6100,6100,4100,37210000,2,32806,8203,1,697840000,697840000,12301,4100,8201,4100,0,1,4102,29942759,29.942759
6100,6100,4500,37210000,2,36006,9003,1,736880000,736880000,13501,4500,9001,4500,0,1,4502,31266558,31.266558
6100,6100,4500,37210000,2,36006,9003,1,736880000,736880000,13501,4500,9001,4500,0,1,4502,32485615,32.485615
6100,6100,4500,37210000,2,36006,9003,1,736880000,736880000,13501,4500,9001,4500,0,1,4502,31469387,31.469387
6100,6100,4500,37210000,2,36006,9003,1,736880000,736880000,13501,4500,9001,4500,0,1,4502,32271883,32.271883
6100,6100,4500,37210000,2,36006,9003,1,736880000,736880000,13501,4500,9001,4500,0,1,4502,31183691,31.183691
6100,6100,4500,37210000,2,36006,9003,1,736880000,736880000,13501,4500,9001,4500,0,1,4502,32604915,32.604915
6100,6100,4500,37210000,2,36006,9003,1,736880000,736880000,13501,4500,9001,4500,0,1,4502,31006647,31.006647
6100,6100,4500,37210000,2,36006,9003,1,736880000,736880000,13501,4500,9001,4500,0,1,4502,32850365,32.850365
6100,6100,4900,37210000,2,39206,9803,1,775920000,775920000,14701,4900,9801,4900,0,1,4902,33974100,33.9741
6100,6100,4900,37210000,2,39206,9803,1,775920000,775920000,14701,4900,9801,4900,0,1,4902,35303891,35.303891
6100,6100,4900,37210000,2,39206,9803,1,775920000,775920000,14701,4900,9801,4900,0,1,4902,34248125,34.248125
6100,6100,4900,37210000,2,39206,9803,1,775920000,775920000,14701,4900,9801,4900,0,1,4902,35098701,35.098701
6100,6100,4900,37210000,2,39206,9803,1,775920000,775920000,14701,4900,9801,4900,0,1,4902,33844388,33.844388
6100,6100,4900,37210000,2,39206,9803,1,775920000,775920000,14701,4900,9801,4900,0,1,4902,35331904,35.331904
6100,6100,4900,37210000,2,39206,9803,1,775920000,775920000,14701,4900,9801,4900,0,1,4902,33709207,33.709207
6100,6100,4900,37210000,2,39206,9803,1,775920000,775920000,14701,4900,9801,4900,0,1,4902,35683710,35.68371
6100,6100,5300,37210000,2,42406,10603,1,814960000,814960000,15901,5300,10601,5300,0,1,5302,36781094,36.781094
6100,6100,5300,37210000,2,42406,10603,1,814960000,814960000,15901,5300,10601,5300,0,1,5302,38264386,38.264386
6100,6100,5300,37210000,2,42406,10603,1,814960000,814960000,15901,5300,10601,5300,0,1,5302,36999429,36.999429
6100,6100,5300,37210000,2,42406,10603,1,814960000,814960000,15901,5300,10601,5300,0,1,5302,37976839,37.976839
6100,6100,5300,37210000,2,42406,10603,1,814960000,814960000,15901,5300,10601,5300,0,1,5302,36695553,36.695553
6100,6100,5300,37210000,2,42406,10603,1,814960000,814960000,15901,5300,10601,5300,0,1,5302,38293825,38.293825
6100,6100,5300,37210000,2,42406,10603,1,814960000,814960000,15901,5300,10601,5300,0,1,5302,36470137,36.470137
6100,6100,5300,37210000,2,42406,10603,1,814960000,814960000,15901,5300,10601,5300,0,1,5302,38663610,38.66361
6100,6100,5700,37210000,2,45606,11403,1,854000000,854000000,17101,5700,11401,5700,0,1,5702,39523557,39.523557
6100,6100,5700,37210000,2,45606,11403,1,854000000,854000000,17101,5700,11401,5700,0,1,5702,41011907,41.011907
6100,6100,5700,37210000,2,45606,11403,1,854000000,854000000,17101,5700,11401,5700,0,1,5702,39805551,39.805551
6100,6100,5700,37210000,2,45606,11403,1,854000000,854000000,17101,5700,11401,5700,0,1,5702,40802842,40.802842
6100,6100,5700,37210000,2,45606,11403,1,854000000,854000000,17101,5700,11401,5700,0,1,5702,39397134,39.397134
6100,6100,5700,37210000,2,45606,11403,1,854000000,854000000,17101,5700,11401,5700,0,1,5702,41134815,41.134815
6100,6100,5700,37210000,2,45606,11403,1,854000000,854000000,17101,5700,11401,5700,0,1,5702,39203939,39.203939
6100,6100,5700,37210000,2,45606,11403,1,854000000,854000000,17101,5700,11401,5700,0,1,5702,41531136,41.531136
6100,6100,6100,37210000,2,48806,12203,1,893040000,893040000,18301,6100,12201,6100,0,1,6102,42279875,42.279875
6100,6100,6100,37210000,2,48806,12203,1,893040000,893040000,18301,6100,12201,6100,0,1,6102,43940878,43.940878
6100,6100,6100,37210000,2,48806,12203,1,893040000,893040000,18301,6100,12201,6100,0,1,6102,42615600,42.6156
6100,6100,6100,37210000,2,48806,12203,1,893040000,893040000,18301,6100,12201,6100,0,1,6102,43680340,43.68034
6100,6100,6100,37210000,2,48806,12203,1,893040000,893040000,18301,6100,12201,6100,0,1,6102,42111555,42.111555
6100,6100,6100,37210000,2,48806,12203,1,893040000,893040000,18301,6100,12201,6100,0,1,6102,43967059,43.967059
6100,6100,6100,37210000,2,48806,12203,1,893040000,893040000,18301,6100,12201,6100,0,1,6102,41943760,41.94376
6100,6100,6100,37210000,2,48806,12203,1,893040000,893040000,18301,6100,12201,6100,0,1,6102,44498203,44.498203
6100,6100,6500,37210000,2,52006,13003,1,932080000,932080000,19501,6500,13001,6500,0,1,6502,45036589,45.036589
6100,6100,6500,37210000,2,52006,13003,1,932080000,932080000,19501,6500,13001,6500,0,1,6502,46871872,46.871872
6100,6100,6500,37210000,2,52006,13003,1,932080000,932080000,19501,6500,13001,6500,0,1,6502,45371330,45.37133
6100,6100,6500,37210000,2,52006,13003,1,932080000,932080000,19501,6500,13001,6500,0,1,6502,46611795,46.611795
6100,6100,6500,37210000,2,52006,13003,1,932080000,932080000,19501,6500,13001,6500,0,1,6502,44899290,44.89929
6100,6100,6500,37210000,2,52006,13003,1,932080000,932080000,19501,6500,13001,6500,0,1,6502,46900395,46.900395
6100,6100,6500,37210000,2,52006,13003,1,932080000,932080000,19501,6500,13001,6500,0,1,6502,44709569,44.709569
6100,6100,6500,37210000,2,52006,13003,1,932080000,932080000,19501,6500,13001,6500,0,1,6502,47409595,47.409595
6100,6100,6900,37210000,2,55206,13803,1,971120000,971120000,20701,6900,13801,6900,0,1,6902,47869102,47.869102
6100,6100,6900,37210000,2,55206,13803,1,971120000,971120000,20701,6900,13801,6900,0,1,6902,49865812,49.865812
6100,6100,6900,37210000,2,55206,13803,1,971120000,971120000,20701,6900,13801,6900,0,1,6902,48193192,48.193192
6100,6100,6900,37210000,2,55206,13803,1,971120000,971120000,20701,6900,13801,6900,0,1,6902,49480195,49.480195
6100,6100,6900,37210000,2,55206,13803,1,971120000,971120000,20701,6900,13801,6900,0,1,6902,47748882,47.748882
6100,6100,6900,37210000,2,55206,13803,1,971120000,971120000,20701,6900,13801,6900,0,1,6902,49803627,49.803627
6100,6100,6900,37210000,2,55206,13803,1,971120000,971120000,20701,6900,13801,6900,0,1,6902,47454113,47.454113
6100,6100,6900,37210000,2,55206,13803,1,971120000,971120000,20701,6900,13801,6900,0,1,6902,50301117,50.301117
6100,5700,500,34770000,2,4006,1003,1,325360000,325360000,1501,500,1001,500,0,1,502,3673146,3.673146
6100,5700,500,34770000,2,4006,1003,1,325360000,325360000,1501,500,1001,500,0,1,502,3817047,3.817047
6100,5700,500,34770000,2,4006,1003,1,325360000,325360000,1501,500,1001,500,0,1,502,3717119,3.717119
6100,5700,500,34770000,2,4006,1003,1,325360000,325360000,1501,500,1001,500,0,1,502,3741094,3.741094
6100,5700,500,34770000,2,4006,1003,1,325360000,325360000,1501,500,1001,500,0,1,502,3766856,3.766856
6100,5700,500,34770000,2,4006,1003,1,325360000,325360000,1501,500,1001,500,0,1,502,3766151,3.766151
6100,5700,500,34770000,2,4006,1003,1,325360000,325360000,1501,500,1001,500,0,1,502,3649094,3.649094
6100,5700,500,34770000,2,4006,1003,1,325360000,325360000,1501,500,1001,500,0,1,502,3791669,3.791669
6100,5700,900,34770000,2,7206,1803,1,363120000,363120000,2701,900,1801,900,0,1,902,6075258,6.075258
6100,5700,900,34770000,2,7206,1803,1,363120000,363120000,2701,900,1801,900,0,1,902,6302238,6.302238
6100,5700,900,34770000,2,7206,1803,1,363120000,363120000,2701,900,1801,900,0,1,902,6127891,6.127891
6100,5700,900,34770000,2,7206,1803,1,363120000,363120000,2701,900,1801,900,0,1,902,6258922,6.258922
6100,5700,900,34770000,2,7206,1803,1,363120000,363120000,2701,900,1801,900,0,1,902,6098670,6.09867
6100,5700,900,34770000,2,7206,1803,1,363120000,363120000,2701,900,1801,900,0,1,902,6346258,6.346258
6100,5700,900,34770000,2,7206,1803,1,363120000,363120000,2701,900,1801,900,0,1,902,5983306,5.983306
6100,5700,900,34770000,2,7206,1803,1,363120000,363120000,2701,900,1801,900,0,1,902,6409662,6.409662
6100,5700,1300,34770000,2,10406,2603,1,400880000,400880000,3901,1300,2601,1300,0,1,1302,8628923,8.628923
6100,5700,1300,34770000,2,10406,2603,1,400880000,400880000,3901,1300,2601,1300,0,1,1302,8949290,8.94929
6100,5700,1300,34770000,2,10406,2603,1,400880000,400880000,3901,1300,2601,1300,0,1,1302,8696905,8.696905
6100,5700,1300,34770000,2,10406,2603,1,400880000,400880000,3901,1300,2601,1300,0,1,1302,8846164,8.846164
6100,5700,1300,34770000,2,10406,2603,1,400880000,400880000,3901,1300,2601,1300,0,1,1302,8605037,8.605037
6100,5700,1300,34770000,2,10406,2603,1,400880000,400880000,3901,1300,2601,1300,0,1,1302,8997265,8.997265
6100,5700,1300,34770000,2,10406,2603,1,400880000,400880000,3901,1300,2601,1300,0,1,1302,8475260,8.47526
6100,5700,1300,34770000,2,10406,2603,1,400880000,400880000,3901,1300,2601,1300,0,1,1302,9075098,9.075098
6100,5700,1700,34770000,2,13606,3403,1,438640000,438640000,5101,1700,3401,1700,0,1,1702,11301578,11.301578
6100,5700,1700,34770000,2,13606,3403,1,438640000,438640000,5101,1700,3401,1700,0,1,1702,11710309,11.710309
6100,5700,1700,34770000,2,13606,3403,1,438640000,438640000,5101,1700,3401,1700,0,1,1702,11378426,11.378426
6100,5700,1700,34770000,2,13606,3403,1,438640000,438640000,5101,1700,3401,1700,0,1,1702,11544574,11.544574
6100,5700,1700,34770000,2,13606,3403,1,438640000,438640000,5101,1700,3401,1700,0,1,1702,11278000,11.278
6100,5700,1700,34770000,2,13606,3403,1,438640000,438640000,5101,1700,3401,1700,0,1,1702,11754823,11.754823
6100,5700,1700,34770000,2,13606,3403,1,438640000,438640000,5101,1700,3401,1700,0,1,1702,11217818,11.217818
6100,5700,1700,34770000,2,13606,3403,1,438640000,438640000,5101,1700,3401,1700,0,1,1702,11786381,11.786381
6100,5700,2100,34770000,2,16806,4203,1,476400000,476400000,6301,2100,4201,2100,0,1,2102,13828971,13.828971
6100,5700,2100,34770000,2,16806,4203,1,476400000,476400000,6301,2100,4201,2100,0,1,2102,14327573,14.327573
6100,5700,2100,34770000,2,16806,4203,1,476400000,476400000,6301,2100,4201,2100,0,1,2102,13972677,13.972677
6100,5700,2100,34770000,2,16806,4203,1,476400000,476400000,6301,2100,4201,2100,0,1,2102,14202189,14.202189
6100,5700,2100,34770000,2,16806,4203,1,476400000,476400000,6301,2100,4201,2100,0,1,2102,13864247,13.864247
6100,5700,2100,34770000,2,16806,4203,1,476400000,476400000,6301,2100,4201,2100,0,1,2102,14385969,14.385969
6100,5700,2100,34770000,2,16806,4203,1,476400000,476400000,6301,2100,4201,2100,0,1,2102,13702160,13.70216
6100,5700,2100,34770000,2,16806,4203,1,476400000,476400000,6301,2100,4201,2100,0,1,2102,14459192,14.459192
6100,5700,2500,34770000,2,20006,5003,1,514160000,514160000,7501,2500,5001,2500,0,1,2502,16397881,16.397881
6100,5700,2500,34770000,2,20006,5003,1,514160000,514160000,7501,2500,5001,2500,0,1,2502,16930498,16.930498
6100,5700,2500,34770000,2,20006,5003,1,514160000,514160000,7501,2500,5001,2500,0,1,2502,16541136,16.541136
6100,5700,2500,34770000,2,20006,5003,1,514160000,514160000,7501,2500,5001,2500,0,1,2502,16831183,16.831183
6100,5700,2500,34770000,2,20006,5003,1,514160000,514160000,7501,2500,5001,2500,0,1,2502,16361352,16.361352
6100,5700,2500,34770000,2,20006,5003,1,514160000,514160000,7501,2500,5001,2500,0,1,2502,17082247,17.082247
6100,5700,2500,34770000,2,20006,5003,1,514160000,514160000,7501,2500,5001,2500,0,1,2502,16210629,16.210629
6100,5700,2500,34770000,2,20006,5003,1,514160000,514160000,7501,2500,5001,2500,0,1,2502,17117032,17.117032
6100,5700,2900,34770000,2,23206,5803,1,551920000,551920000,8701,2900,5801,2900,0,1,2902,18972442,18.972442
6100,5700,2900,34770000,2,23206,5803,1,551920000,551920000,8701,2900,5801,2900,0,1,2902,19609659,19.609659
6100,5700,2900,34770000,2,23206,5803,1,551920000,551920000,8701,2900,5801,2900,0,1,2902,19135306,19.135306
6100,5700,2900,34770000,2,23206,5803,1,551920000,551920000,8701,2900,5801,2900,0,1,2902,19508971,19.508971
6100,5700,2900,34770000,2,23206,5803,1,551920000,551920000,8701,2900,5801,2900,0,1,2902,18917014,18.917014
6100,5700,2900,34770000,2,23206,5803,1,551920000,551920000,8701,2900,5801,2900,0,1,2902,19698917,19.698917
6100,5700,2900,34770000,2,23206,5803,1,551920000,551920000,8701,2900,5801,2900,0,1,2902,18760855,18.760855
6100,5700,2900,34770000,2,23206,5803,1,551920000,551920000,8701,2900,5801,2900,0,1,2902,19815541,19.815541
6100,5700,3300,34770000,2,26406,6603,1,589680000,589680000,9901,3300,6601,3300,0,1,3302,21503644,21.503644
6100,5700,3300,34770000,2,26406,6603,1,589680000,589680000,9901,3300,6601,3300,0,1,3302,22305847,22.305847
6100,5700,3300,34770000,2,26406,6603,1,589680000,589680000,9901,3300,6601,3300,0,1,3302,21657740,21.65774
6100,5700,3300,34770000,2,26406,6603,1,589680000,589680000,9901,3300,6601,3300,0,1,3302,22118948,22.118948
6100,5700,3300,34770000,2,26406,6603,1,589680000,589680000,9901,3300,6601,3300,0,1,3302,21444792,21.444792
6100,5700,3300,34770000,2,26406,6603,1,589680000,589680000,9901,3300,6601,3300,0,1,3302,22350944,22.350944
6100,5700,3300,34770000,2,26406,6603,1,589680000,589680000,9901,3300,6601,3300,0,1,3302,21232677,21.232677
6100,5700,3300,34770000,2,26406,6603,1,589680000,589680000,9901,3300,6601,3300,0,1,3302,22533484,22.533484
6100,5700,3700,34770000,2,29606,7403,1,627440000,627440000,11101,3700,7401,3700,0,1,3702,24095176,24.095176
6100,5700,3700,34770000,2,29606,7403,1,627440000,627440000,11101,3700,7401,3700,0,1,3702,24985606,24.985606
6100,5700,3700,34770000,2,29606,7403,1,627440000,627440000,11101,3700,7401,3700,0,1,3702,24255265,24.255265
6100,5700,3700,34770000,2,29606,7403,1,627440000,627440000,11101,3700,7401,3700,0,1,3702,24735941,24.735941
6100,5700,3700,34770000,2,29606,7403,1,627440000,627440000,11101,3700,7401,3700,0,1,3702,23970867,23.970867
6100,5700,3700,34770000,2,29606,7403,1,627440000,627440000,11101,3700,7401,3700,0,1,3702,25070989,25.070989
6100,5700,3700,34770000,2,29606,7403,1,627440000,627440000,11101,3700,7401,3700,0,1,3702,23784168,23.784168
6100,5700,3700,34770000,2,29606,7403,1,627440000,627440000,11101,3700,7401,3700,0,1,3702,25222182,25.222182
6100,5700,4100,34770000,2,32806,8203,1,665200000,665200000,12301,4100,8201,4100,0,1,4102,26635351,26.635351
6100,5700,4100,34770000,2,32806,8203,1,665200000,665200000,12301,4100,8201,4100,0,1,4102,27585048,27.585048
6100,5700,4100,34770000,2,32806,8203,1,665200000,665200000,12301,4100,8201,4100,0,1,4102,26806212,26.806212
6100,5700,4100,34770000,2,32806,8203,1,665200000,665200000,12301,4100,8201,4100,0,1,4102,27377845,27.377845
6100,5700,4100,34770000,2,32806,8203,1,665200000,665200000,12301,4100,8201,4100,0,1,4102,26569133,26.569133
6100,5700,4100,34770000,2,32806,8203,1,665200000,665200000,12301,4100,8201,4100,0,1,4102,27759427,27.759427
6100,5700,4100,34770000,2,32806,8203,1,665200000,665200000,12301,4100,8201,4100,0,1,4102,26325012,26.325012
6100,5700,4100,34770000,2,32806,8203,1,665200000,665200000,12301,4100,8201,4100,0,1,4102,27876751,27.876751
6100,5700,4500,34770000,2,36006,9003,1,702960000,702960000,13501,4500,9001,4500,0,1,4502,29225750,29.22575
6100,5700,4500,34770000,2,36006,9003,1,702960000,702960000,13501,4500,9001,4500,0,1,4502,30299221,30.299221
6100,5700,4500,34770000,2,36006,9003,1,702960000,702960000,13501,4500,9001,4500,0,1,4502,29397760,29.39776
6100,5700,4500,34770000,2,36006,9003,1,702960000,702960000,13501,4500,9001,4500,0,1,4502,30123145,30.123145
6100,5700,4500,34770000,2,36006,9003,1,702960000,702960000,13501,4500,9001,4500,0,1,4502,29132221,29.132221
6100,5700,4500,34770000,2,36006,9003,1,702960000,702960000,13501,4500,9001,4500,0,1,4502,30405920,30.40592
6100,5700,4500,34770000,2,36006,9003,1,702960000,702960000,13501,4500,9001,4500,0,1,4502,28915252,28.915252
6100,5700,4500,34770000,2,36006,9003,1,702960000,702960000,13501,4500,9001,4500,0,1,4502,30605638,30.605638
6100,5700,4900,34770000,2,39206,9803,1,740720000,740720000,14701,4900,9801,4900,0,1,4902,31805469,31.805469
6100,5700,4900,34770000,2,39206,9803,1,740720000,740720000,14701,4900,9801,4900,0,1,4902,33011435,33.011435
6100,5700,4900,34770000,2,39206,9803,1,740720000,740720000,14701,4900,9801,4900,0,1,4902,31987896,31.987896
6100,5700,4900,34770000,2,39206,9803,1,740720000,740720000,14701,4900,9801,4900,0,1,4902,32666951,32.666951
6100,5700,4900,34770000,2,39206,9803,1,740720000,740720000,14701,4900,9801,4900,0,1,4902,31689961,31.689961
6100,5700,4900,34770000,2,39206,9803,1,740720000,740720000,14701,4900,9801,4900,0,1,4902,33120302,33.120302
6100,5700,4900,34770000,2,39206,9803,1,740720000,740720000,14701,4900,9801,4900,0,1,4902,31553993,31.553993
6100,5700,4900,34770000,2,39206,9803,1,740720000,740720000,14701,4900,9801,4900,0,1,4902,33313914,33.313914
6100,5700,5300,34770000,2,42406,10603,1,778480000,778480000,15901,5300,10601,5300,0,1,5302,34334734,34.334734
6100,5700,5300,34770000,2,42406,10603,1,778480000,778480000,15901,5300,10601,5300,0,1,5302,35701487,35.701487
6100,5700,5300,34770000,2,42406,10603,1,778480000,778480000,15901,5300,10601,5300,0,1,5302,34589808,34.589808
6100,5700,5300,34770000,2,42406,10603,1,778480000,778480000,15901,5300,10601,5300,0,1,5302,35366888,35.366888
6100,5700,5300,34770000,2,42406,10603,1,778480000,778480000,15901,5300,10601,5300,0,1,5302,34192510,34.19251
6100,5700,5300,34770000,2,42406,10603,1,778480000,778480000,15901,5300,10601,5300,0,1,5302,35793950,35.79395
6100,5700,5300,34770000,2,42406,10603,1,778480000,778480000,15901,5300,10601,5300,0,1,5302,34050617,34.050617
6100,5700,5300,34770000,2,42406,10603,1,778480000,778480000,15901,5300,10601,5300,0,1,5302,36023130,36.02313
6100,5700,5700,34770000,2,45606,11403,1,816240000,816240000,17101,5700,11401,5700,0,1,5702,36931671,36.931671
6100,5700,5700,34770000,2,45606,11403,1,816240000,816240000,17101,5700,11401,5700,0,1,5702,38392929,38.392929
6100,5700,5700,34770000,2,45606,11403,1,816240000,816240000,17101,5700,11401,5700,0,1,5702,37075437,37.075437
6100,5700,5700,34770000,2,45606,11403,1,816240000,816240000,17101,5700,11401,5700,0,1,5702,37958873,37.958873
6100,5700,5700,34770000,2,45606,11403,1,816240000,816240000,17101,5700,11401,5700,0,1,5702,36774470,36.77447
6100,5700,5700,34770000,2,45606,11403,1,816240000,816240000,17101,5700,11401,5700,0,1,5702,38480308,38.480308
6100,5700,5700,34770000,2,45606,11403,1,816240000,816240000,17101,5700,11401,5700,0,1,5702,36556503,36.556503
6100,5700,5700,34770000,2,45606,11403,1,816240000,816240000,17101,5700,11401,5700,0,1,5702,38838160,38.83816
6100,5700,6100,34770000,2,48806,12203,1,854000000,854000000,18301,6100,12201,6100,0,1,6102,39515077,39.515077
6100,5700,6100,34770000,2,48806,12203,1,854000000,854000000,18301,6100,12201,6100,0,1,6102,41098522,41.098522
6100,5700,6100,34770000,2,48806,12203,1,854000000,854000000,18301,6100,12201,6100,0,1,6102,39811018,39.811018
6100,5700,6100,34770000,2,48806,12203,1,854000000,854000000,18301,6100,12201,6100,0,1,6102,40781219,40.781219
6100,5700,6100,34770000,2,48806,12203,1,854000000,854000000,18301,6100,12201,6100,0,1,6102,39364804,39.364804
6100,5700,6100,34770000,2,48806,12203,1,854000000,854000000,18301,6100,12201,6100,0,1,6102,41176507,41.176507
6100,5700,6100,34770000,2,48806,12203,1,854000000,854000000,18301,6100,12201,6100,0,1,6102,39150146,39.150146
6100,5700,6100,34770000,2,48806,12203,1,854000000,854000000,18301,6100,12201,6100,0,1,6102,41455552,41.455552
6100,5700,6500,34770000,2,52006,13003,1,891760000,891760000,19501,6500,13001,6500,0,1,6502,42123304,42.123304
6100,5700,6500,34770000,2,52006,13003,1,891760000,891760000,19501,6500,13001,6500,0,1,6502,43780002,43.780002
6100,5700,6500,34770000,2,52006,13003,1,891760000,891760000,19501,6500,13001,6500,0,1,6502,42420835,42.420835
6100,5700,6500,34770000,2,52006,13003,1,891760000,891760000,19501,6500,13001,6500,0,1,6502,43458545,43.458545
6100,5700,6500,34770000,2,52006,13003,1,891760000,891760000,19501,6500,13001,6500,0,1,6502,42055491,42.055491
6100,5700,6500,34770000,2,52006,13003,1,891760000,891760000,19501,6500,13001,6500,0,1,6502,43934936,43.934936
6100,5700,6500,34770000,2,52006,13003,1,891760000,891760000,19501,6500,13001,6500,0,1,6502,41728474,41.728474
6100,5700,6500,34770000,2,52006,13003,1,891760000,891760000,19501,6500,13001,6500,0,1,6502,44191759,44.191759
6100,5700,6900,34770000,2,55206,13803,1,929520000,929520000,20701,6900,13801,6900,0,1,6902,44701714,44.701714
6100,5700,6900,34770000,2,55206,13803,1,929520000,929520000,20701,6900,13801,6900,0,1,6902,46475103,46.475103
6100,5700,6900,34770000,2,55206,13803,1,929520000,929520000,20701,6900,13801,6900,0,1,6902,44977664,44.977664
6100,5700,6900,34770000,2,55206,13803,1,929520000,929520000,20701,6900,13801,6900,0,1,6902,46219911,46.219911
6100,5700,6900,34770000,2,55206,13803,1,929520000,929520000,20701,6900,13801,6900,0,1,6902,44625011,44.625011
6100,5700,6900,34770000,2,55206,13803,1,929520000,929520000,20701,6900,13801,6900,0,1,6902,46614436,46.614436
6100,5700,6900,34770000,2,55206,13803,1,929520000,929520000,20701,6900,13801,6900,0,1,6902,44409877,44.409877
6100,5700,6900,34770000,2,55206,13803,1,929520000,929520000,20701,6900,13801,6900,0,1,6902,46875752,46.875752
6100,5300,500,32330000,2,4006,1003,1,304240000,304240000,1501,500,1001,500,0,1,502,3475354,3.475354
6100,5300,500,32330000,2,4006,1003,1,304240000,304240000,1501,500,1001,500,0,1,502,3560596,3.560596
6100,5300,500,32330000,2,4006,1003,1,304240000,304240000,1501,500,1001,500,0,1,502,3476140,3.47614
6100,5300,500,32330000,2,4006,1003,1,304240000,304240000,1501,500,1001,500,0,1,502,3513622,3.513622
6100,5300,500,32330000,2,4006,1003,1,304240000,304240000,1501,500,1001,500,0,1,502,3476786,3.476786
6100,5300,500,32330000,2,4006,1003,1,304240000,304240000,1501,500,1001,500,0,1,502,3536951,3.536951
6100,5300,500,32330000,2,4006,1003,1,304240000,304240000,1501,500,1001,500,0,1,502,3453585,3.453585
6100,5300,500,32330000,2,4006,1003,1,304240000,304240000,1501,500,1001,500,0,1,502,3431001,3.431001
6100,5300,900,32330000,2,7206,1803,1,340720000,340720000,2701,900,1801,900,0,1,902,5643162,5.643162
6100,5300,900,32330000,2,7206,1803,1,340720000,340720000,2701,900,1801,900,0,1,902,5861019,5.861019
6100,5300,900,32330000,2,7206,1803,1,340720000,340720000,2701,900,1801,900,0,1,902,5692537,5.692537
6100,5300,900,32330000,2,7206,1803,1,340720000,340720000,2701,900,1801,900,0,1,902,5817415,5.817415
6100,5300,900,32330000,2,7206,1803,1,340720000,340720000,2701,900,1801,900,0,1,902,5665458,5.665458
6100,5300,900,32330000,2,7206,1803,1,340720000,340720000,2701,900,1801,900,0,1,902,5888513,5.888513
6100,5300,900,32330000,2,7206,1803,1,340720000,340720000,2701,900,1801,900,0,1,902,5566656,5.566656
6100,5300,900,32330000,2,7206,1803,1,340720000,340720000,2701,900,1801,900,0,1,902,5888051,5.888051
6100,5300,1300,32330000,2,10406,2603,1,377200000,377200000,3901,1300,2601,1300,0,1,1302,8032538,8.032538
6100,5300,1300,32330000,2,10406,2603,1,377200000,377200000,3901,1300,2601,1300,0,1,1302,8301787,8.301787
6100,5300,1300,32330000,2,10406,2603,1,377200000,377200000,3901,1300,2601,1300,0,1,1302,8070325,8.070325
6100,5300,1300,32330000,2,10406,2603,1,377200000,377200000,3901,1300,2601,1300,0,1,1302,8229192,8.229192
6100,5300,1300,32330000,2,10406,2603,1,377200000,377200000,3901,1300,2601,1300,0,1,1302,8009318,8.009318
6100,5300,1300,32330000,2,10406,2603,1,377200000,377200000,3901,1300,2601,1300,0,1,1302,8359602,8.359602
6100,5300,1300,32330000,2,10406,2603,1,377200000,377200000,3901,1300,2601,1300,0,1,1302,7893985,7.893985
6100,5300,1300,32330000,2,10406,2603,1,377200000,377200000,3901,1300,2601,1300,0,1,1302,8395158,8.395158
6100,5300,1700,32330000,2,13606,3403,1,413680000,413680000,5101,1700,3401,1700,0,1,1702,10493055,10.493055
6100,5300,1700,32330000,2,13606,3403,1,413680000,413680000,5101,1700,3401,1700,0,1,1702,10889869,10.889869
6100,5300,1700,32330000,2,13606,3403,1,413680000,413680000,5101,1700,3401,1700,0,1,1702,10644078,10.644078
6100,5300,1700,32330000,2,13606,3403,1,413680000,413680000,5101,1700,3401,1700,0,1,1702,10740410,10.74041
6100,5300,1700,32330000,2,13606,3403,1,413680000,413680000,5101,1700,3401,1700,0,1,1702,10527897,10.527897
6100,5300,1700,32330000,2,13606,3403,1,413680000,413680000,5101,1700,3401,1700,0,1,1702,10935180,10.93518
6100,5300,1700,32330000,2,13606,3403,1,413680000,413680000,5101,1700,3401,1700,0,1,1702,10418186,10.418186
6100,5300,1700,32330000,2,13606,3403,1,413680000,413680000,5101,1700,3401,1700,0,1,1702,10965721,10.965721
6100,5300,2100,32330000,2,16806,4203,1,450160000,450160000,6301,2100,4201,2100,0,1,2102,12897724,12.897724
6100,5300,2100,32330000,2,16806,4203,1,450160000,450160000,6301,2100,4201,2100,0,1,2102,13328830,13.32883
6100,5300,2100,32330000,2,16806,4203,1,450160000,450160000,6301,2100,4201,2100,0,1,2102,12998802,12.998802
6100,5300,2100,32330000,2,16806,4203,1,450160000,450160000,6301,2100,4201,2100,0,1,2102,13220314,13.220314
6100,5300,2100,32330000,2,16806,4203,1,450160000,450160000,6301,2100,4201,2100,0,1,2102,12855517,12.855517
6100,5300,2100,32330000,2,16806,4203,1,450160000,450160000,6301,2100,4201,2100,0,1,2102,13399556,13.399556
6100,5300,2100,32330000,2,16806,4203,1,450160000,450160000,6301,2100,4201,2100,0,1,2102,12740195,12.740195
6100,5300,2100,32330000,2,16806,4203,1,450160000,450160000,6301,2100,4201,2100,0,1,2102,13438050,13.43805
6100,5300,2500,32330000,2,20006,5003,1,486640000,486640000,7501,2500,5001,2500,0,1,2502,15117853,15.117853
6100,5300,2500,32330000,2,20006,5003,1,486640000,486640000,7501,2500,5001,2500,0,1,2502,15684369,15.684369
6100,5300,2500,32330000,2,20006,5003,1,486640000,486640000,7501,2500,5001,2500,0,1,2502,15253973,15.253973
6100,5300,2500,32330000,2,20006,5003,1,486640000,486640000,7501,2500,5001,2500,0,1,2502,15566648,15.566648
6100,5300,2500,32330000,2,20006,5003,1,486640000,486640000,7501,2500,5001,2500,0,1,2502,15029232,15.029232
6100,5300,2500,32330000,2,20006,5003,1,486640000,486640000,7501,2500,5001,2500,0,1,2502,15758806,15.758806
6100,5300,2500,32330000,2,20006,5003,1,486640000,486640000,7501,2500,5001,2500,0,1,2502,14932289,14.932289
6100,5300,2500,32330000,2,20006,5003,1,486640000,486640000,7501,2500,5001,2500,0,1,2502,15856321,15.856321
6100,5300,2900,32330000,2,23206,5803,1,523120000,523120000,8701,2900,5801,2900,0,1,2902,17651704,17.651704
6100,5300,2900,32330000,2,23206,5803,1,523120000,523120000,8701,2900,5801,2900,0,1,2902,18263851,18.263851
6100,5300,2900,32330000,2,23206,5803,1,523120000,523120000,8701,2900,5801,2900,0,1,2902,17788632,17.788632
6100,5300,2900,32330000,2,23206,5803,1,523120000,523120000,8701,2900,5801,2900,0,1,2902,18166986,18.166986
6100,5300,2900,32330000,2,23206,5803,1,523120000,523120000,8701,2900,5801,2900,0,1,2902,17551987,17.551987
6100,5300,2900,32330000,2,23206,5803,1,523120000,523120000,8701,2900,5801,2900,0,1,2902,18354007,18.354007
6100,5300,2900,32330000,2,23206,5803,1,523120000,523120000,8701,2900,5801,2900,0,1,2902,17530108,17.530108
6100,5300,2900,32330000,2,23206,5803,1,523120000,523120000,8701,2900,5801,2900,0,1,2902,18482940,18.48294
6100,5300,3300,32330000,2,26406,6603,1,559600000,559600000,9901,3300,6601,3300,0,1,3302,20008392,20.008392
6100,5300,3300,32330000,2,26406,6603,1,559600000,559600000,9901,3300,6601,3300,0,1,3302,20755344,20.755344
6100,5300,3300,32330000,2,26406,6603,1,559600000,559600000,9901,3300,6601,3300,0,1,3302,20192899,20.192899
6100,5300,3300,32330000,2,26406,6603,1,559600000,559600000,9901,3300,6601,3300,0,1,3302,20653309,20.653309
6100,5300,3300,32330000,2,26406,6603,1,559600000,559600000,9901,3300,6601,3300,0,1,3302,19965895,19.965895
6100,5300,3300,32330000,2,26406,6603,1,559600000,559600000,9901,3300,6601,3300,0,1,3302,20850285,20.850285
6100,5300,3300,32330000,2,26406,6603,1,559600000,559600000,9901,3300,6601,3300,0,1,3302,19797196,19.797196
6100,5300,3300,32330000,2,26406,6603,1,559600000,559600000,9901,3300,6601,3300,0,1,3302,20947664,20.947664
6100,5300,3700,32330000,2,29606,7403,1,596080000,596080000,11101,3700,7401,3700,0,1,3702,22371231,22.371231
6100,5300,3700,32330000,2,29606,7403,1,596080000,596080000,11101,3700,7401,3700,0,1,3702,23216311,23.216311
6100,5300,3700,32330000,2,29606,7403,1,596080000,596080000,11101,3700,7401,3700,0,1,3702,22563737,22.563737
6100,5300,3700,32330000,2,29606,7403,1,596080000,596080000,11101,3700,7401,3700,0,1,3702,22987715,22.987715
6100,5300,3700,32330000,2,29606,7403,1,596080000,596080000,11101,3700,7401,3700,0,1,3702,22322447,22.322447
6100,5300,3700,32330000,2,29606,7403,1,596080000,596080000,11101,3700,7401,3700,0,1,3702,23322250,23.32225
6100,5300,3700,32330000,2,29606,7403,1,596080000,596080000,11101,3700,7401,3700,0,1,3702,22137963,22.137963
6100,5300,3700,32330000,2,29606,7403,1,596080000,596080000,11101,3700,7401,3700,0,1,3702,23446778,23.446778
6100,5300,4100,32330000,2,32806,8203,1,632560000,632560000,12301,4100,8201,4100,0,1,4102,24778251,24.778251
6100,5300,4100,32330000,2,32806,8203,1,632560000,632560000,12301,4100,8201,4100,0,1,4102,25662314,25.662314
6100,5300,4100,32330000,2,32806,8203,1,632560000,632560000,12301,4100,8201,4100,0,1,4102,24911945,24.911945
6100,5300,4100,32330000,2,32806,8203,1,632560000,632560000,12301,4100,8201,4100,0,1,4102,25470965,25.470965
6100,5300,4100,32330000,2,32806,8203,1,632560000,632560000,12301,4100,8201,4100,0,1,4102,24711398,24.711398
6100,5300,4100,32330000,2,32806,8203,1,632560000,632560000,12301,4100,8201,4100,0,1,4102,25767345,25.767345
6100,5300,4100,32330000,2,32806,8203,1,632560000,632560000,12301,4100,8201,4100,0,1,4102,24477744,24.477744
6100,5300,4100,32330000,2,32806,8203,1,632560000,632560000,12301,4100,8201,4100,0,1,4102,25930916,25.930916
6100,5300,4500,32330000,2,36006,9003,1,669040000,669040000,13501,4500,9001,4500,0,1,4502,27181378,27.181378
6100,5300,4500,32330000,2,36006,9003,1,669040000,669040000,13501,4500,9001,4500,0,1,4502,28207077,28.207077
6100,5300,4500,32330000,2,36006,9003,1,669040000,669040000,13501,4500,9001,4500,0,1,4502,27363241,27.363241
6100,5300,4500,32330000,2,36006,9003,1,669040000,669040000,13501,4500,9001,4500,0,1,4502,27960663,27.960663
6100,5300,4500,32330000,2,36006,9003,1,669040000,669040000,13501,4500,9001,4500,0,1,4502,27104891,27.104891
6100,5300,4500,32330000,2,36006,9003,1,669040000,669040000,13501,4500,9001,4500,0,1,4502,28347280,28.34728
6100,5300,4500,32330000,2,36006,9003,1,669040000,669040000,13501,4500,9001,4500,0,1,4502,26909560,26.90956
6100,5300,4500,32330000,2,36006,9003,1,669040000,669040000,13501,4500,9001,4500,0,1,4502,28466593,28.466593
6100,5300,4900,32330000,2,39206,9803,1,705520000,705520000,14701,4900,9801,4900,0,1,4902,29551983,29.551983
6100,5300,4900,32330000,2,39206,9803,1,705520000,705520000,14701,4900,9801,4900,0,1,4902,30643893,30.643893
6100,5300,4900,32330000,2,39206,9803,1,705520000,705520000,14701,4900,9801,4900,0,1,4902,29738691,29.738691
6100,5300,4900,32330000,2,39206,9803,1,705520000,705520000,14701,4900,9801,4900,0,1,4902,30434922,30.434922
6100,5300,4900,32330000,2,39206,9803,1,705520000,705520000,14701,4900,9801,4900,0,1,4902,29472929,29.472929
6100,5300,4900,32330000,2,39206,9803,1,705520000,705520000,14701,4900,9801,4900,0,1,4902,30735344,30.735344
6100,5300,4900,32330000,2,39206,9803,1,705520000,705520000,14701,4900,9801,4900,0,1,4902,29264000,29.264
6100,5300,4900,32330000,2,39206,9803,1,705520000,705520000,14701,4900,9801,4900,0,1,4902,30988895,30.988895
6100,5300,5300,32330000,2,42406,10603,1,742000000,742000000,15901,5300,10601,5300,0,1,5302,31959530,31.95953
6100,5300,5300,32330000,2,42406,10603,1,742000000,742000000,15901,5300,10601,5300,0,1,5302,33166276,33.166276
6100,5300,5300,32330000,2,42406,10603,1,742000000,742000000,15901,5300,10601,5300,0,1,5302,32205913,32.205913
6100,5300,5300,32330000,2,42406,10603,1,742000000,742000000,15901,5300,10601,5300,0,1,5302,32898169,32.898169
6100,5300,5300,32330000,2,42406,10603,1,742000000,742000000,15901,5300,10601,5300,0,1,5302,31862636,31.862636
6100,5300,5300,32330000,2,42406,10603,1,742000000,742000000,15901,5300,10601,5300,0,1,5302,33210182,33.210182
6100,5300,5300,32330000,2,42406,10603,1,742000000,742000000,15901,5300,10601,5300,0,1,5302,31667663,31.667663
6100,5300,5300,32330000,2,42406,10603,1,742000000,742000000,15901,5300,10601,5300,0,1,5302,33535498,33.535498
6100,5300,5700,32330000,2,45606,11403,1,778480000,778480000,17101,5700,11401,5700,0,1,5702,34364615,34.364615
6100,5300,5700,32330000,2,45606,11403,1,778480000,778480000,17101,5700,11401,5700,0,1,5702,35673109,35.673109
6100,5300,5700,32330000,2,45606,11403,1,778480000,778480000,17101,5700,11401,5700,0,1,5702,34482925,34.482925
6100,5300,5700,32330000,2,45606,11403,1,778480000,778480000,17101,5700,11401,5700,0,1,5702,35430655,35.430655
6100,5300,5700,32330000,2,45606,11403,1,778480000,778480000,17101,5700,11401,5700,0,1,5702,34195633,34.195633
6100,5300,5700,32330000,2,45606,11403,1,778480000,778480000,17101,5700,11401,5700,0,1,5702,35696315,35.696315
6100,5300,5700,32330000,2,45606,11403,1,778480000,778480000,17101,5700,11401,5700,0,1,5702,33978675,33.978675
6100,5300,5700,32330000,2,45606,11403,1,778480000,778480000,17101,5700,11401,5700,0,1,5702,36040059,36.040059
6100,5300,6100,32330000,2,48806,12203,1,814960000,814960000,18301,6100,12201,6100,0,1,6102,36828225,36.828225
6100,5300,6100,32330000,2,48806,12203,1,814960000,814960000,18301,6100,12201,6100,0,1,6102,38209529,38.209529
6100,5300,6100,32330000,2,48806,12203,1,814960000,814960000,18301,6100,12201,6100,0,1,6102,36972328,36.972328
6100,5300,6100,32330000,2,48806,12203,1,814960000,814960000,18301,6100,12201,6100,0,1,6102,37913303,37.913303
6100,5300,6100,32330000,2,48806,12203,1,814960000,814960000,18301,6100,12201,6100,0,1,6102,36619905,36.619905
6100,5300,6100,32330000,2,48806,12203,1,814960000,814960000,18301,6100,12201,6100,0,1,6102,38255409,38.255409
6100,5300,6100,32330000,2,48806,12203,1,814960000,814960000,18301,6100,12201,6100,0,1,6102,36412396,36.412396
6100,5300,6100,32330000,2,48806,12203,1,814960000,814960000,18301,6100,12201,6100,0,1,6102,38555667,38.555667
6100,5300,6500,32330000,2,52006,13003,1,851440000,851440000,19501,6500,13001,6500,0,1,6502,39164658,39.164658
6100,5300,6500,32330000,2,52006,13003,1,851440000,851440000,19501,6500,13001,6500,0,1,6502,40694497,40.694497
6100,5300,6500,32330000,2,52006,13003,1,851440000,851440000,19501,6500,13001,6500,0,1,6502,39358670,39.35867
6100,5300,6500,32330000,2,52006,13003,1,851440000,851440000,19501,6500,13001,6500,0,1,6502,40286474,40.286474
6100,5300,6500,32330000,2,52006,13003,1,851440000,851440000,19501,6500,13001,6500,0,1,6502,38977750,38.97775
6100,5300,6500,32330000,2,52006,13003,1,851440000,851440000,19501,6500,13001,6500,0,1,6502,40742106,40.742106
6100,5300,6500,32330000,2,52006,13003,1,851440000,851440000,19501,6500,13001,6500,0,1,6502,38806964,38.806964
6100,5300,6500,32330000,2,52006,13003,1,851440000,851440000,19501,6500,13001,6500,0,1,6502,41062629,41.062629
6100,5300,6900,32330000,2,55206,13803,1,887920000,887920000,20701,6900,13801,6900,0,1,6902,41561973,41.561973
6100,5300,6900,32330000,2,55206,13803,1,887920000,887920000,20701,6900,13801,6900,0,1,6902,43185746,43.185746
6100,5300,6900,32330000,2,55206,13803,1,887920000,887920000,20701,6900,13801,6900,0,1,6902,41828112,41.828112
6100,5300,6900,32330000,2,55206,13803,1,887920000,887920000,20701,6900,13801,6900,0,1,6902,42817309,42.817309
6100,5300,6900,32330000,2,55206,13803,1,887920000,887920000,20701,6900,13801,6900,0,1,6902,41362765,41.362765
6100,5300,6900,32330000,2,55206,13803,1,887920000,887920000,20701,6900,13801,6900,0,1,6902,43233707,43.233707
6100,5300,6900,32330000,2,55206,13803,1,887920000,887920000,20701,6900,13801,6900,0,1,6902,41209982,41.209982
6100,5300,6900,32330000,2,55206,13803,1,887920000,887920000,20701,6900,13801,6900,0,1,6902,43615993,43.615993
6100,4900,500,29890000,2,4006,1003,1,283120000,283120000,1501,500,1001,500,0,1,502,3129574,3.129574
6100,4900,500,29890000,2,4006,1003,1,283120000,283120000,1501,500,1001,500,0,1,502,3294414,3.294414
6100,4900,500,29890000,2,4006,1003,1,283120000,283120000,1501,500,1001,500,0,1,502,3177320,3.17732
6100,4900,500,29890000,2,4006,1003,1,283120000,283120000,1501,500,1001,500,0,1,502,3156085,3.156085
6100,4900,500,29890000,2,4006,1003,1,283120000,283120000,1501,500,1001,500,0,1,502,3251630,3.25163
6100,4900,500,29890000,2,4006,1003,1,283120000,283120000,1501,500,1001,500,0,1,502,3199559,3.199559
6100,4900,500,29890000,2,4006,1003,1,283120000,283120000,1501,500,1001,500,0,1,502,3176792,3.176792
6100,4900,500,29890000,2,4006,1003,1,283120000,283120000,1501,500,1001,500,0,1,502,3316043,3.316043
6100,4900,900,29890000,2,7206,1803,1,318320000,318320000,2701,900,1801,900,0,1,902,5219072,5.219072
6100,4900,900,29890000,2,7206,1803,1,318320000,318320000,2701,900,1801,900,0,1,902,5411530,5.41153
6100,4900,900,29890000,2,7206,1803,1,318320000,318320000,2701,900,1801,900,0,1,902,5262831,5.262831
6100,4900,900,29890000,2,7206,1803,1,318320000,318320000,2701,900,1801,900,0,1,902,5388099,5.388099
6100,4900,900,29890000,2,7206,1803,1,318320000,318320000,2701,900,1801,900,0,1,902,5239248,5.239248
6100,4900,900,29890000,2,7206,1803,1,318320000,318320000,2701,900,1801,900,0,1,902,5389414,5.389414
6100,4900,900,29890000,2,7206,1803,1,318320000,318320000,2701,900,1801,900,0,1,902,5198460,5.19846
6100,4900,900,29890000,2,7206,1803,1,318320000,318320000,2701,900,1801,900,0,1,902,5497222,5.497222
6100,4900,1300,29890000,2,10406,2603,1,353520000,353520000,3901,1300,2601,1300,0,1,1302,7414749,7.414749
6100,4900,1300,29890000,2,10406,2603,1,353520000,353520000,3901,1300,2601,1300,0,1,1302,7681649,7.681649
6100,4900,1300,29890000,2,10406,2603,1,353520000,353520000,3901,1300,2601,1300,0,1,1302,7491252,7.491252
6100,4900,1300,29890000,2,10406,2603,1,353520000,353520000,3901,1300,2601,1300,0,1,1302,7600781,7.600781
6100,4900,1300,29890000,2,10406,2603,1,353520000,353520000,3901,1300,2601,1300,0,1,1302,7387825,7.387825
6100,4900,1300,29890000,2,10406,2603,1,353520000,353520000,3901,1300,2601,1300,0,1,1302,7702391,7.702391
6100,4900,1300,29890000,2,10406,2603,1,353520000,353520000,3901,1300,2601,1300,0,1,1302,7316590,7.31659
6100,4900,1300,29890000,2,10406,2603,1,353520000,353520000,3901,1300,2601,1300,0,1,1302,7798493,7.798493
6100,4900,1700,29890000,2,13606,3403,1,388720000,388720000,5101,1700,3401,1700,0,1,1702,9706695,9.706695
6100,4900,1700,29890000,2,13606,3403,1,388720000,388720000,5101,1700,3401,1700,0,1,1702,10051692,10.051692
6100,4900,1700,29890000,2,13606,3403,1,388720000,388720000,5101,1700,3401,1700,0,1,1702,9842405,9.842405
6100,4900,1700,29890000,2,13606,3403,1,388720000,388720000,5101,1700,3401,1700,0,1,1702,9964108,9.964108
6100,4900,1700,29890000,2,13606,3403,1,388720000,388720000,5101,1700,3401,1700,0,1,1702,9770069,9.770069
6100,4900,1700,29890000,2,13606,3403,1,388720000,388720000,5101,1700,3401,1700,0,1,1702,10073122,10.073122
6100,4900,1700,29890000,2,13606,3403,1,388720000,388720000,5101,1700,3401,1700,0,1,1702,9644727,9.644727
6100,4900,1700,29890000,2,13606,3403,1,388720000,388720000,5101,1700,3401,1700,0,1,1702,10200005,10.200005
6100,4900,2100,29890000,2,16806,4203,1,423920000,423920000,6301,2100,4201,2100,0,1,2102,11804286,11.804286
6100,4900,2100,29890000,2,16806,4203,1,423920000,423920000,6301,2100,4201,2100,0,1,2102,12245681,12.245681
6100,4900,2100,29890000,2,16806,4203,1,423920000,423920000,6301,2100,4201,2100,0,1,2102,11899536,11.899536
6100,4900,2100,29890000,2,16806,4203,1,423920000,423920000,6301,2100,4201,2100,0,1,2102,12110846,12.110846
6100,4900,2100,29890000,2,16806,4203,1,423920000,423920000,6301,2100,4201,2100,0,1,2102,11749075,11.749075
6100,4900,2100,29890000,2,16806,4203,1,423920000,423920000,6301,2100,4201,2100,0,1,2102,12267196,12.267196
6100,4900,2100,29890000,2,16806,4203,1,423920000,423920000,6301,2100,4201,2100,0,1,2102,11638164,11.638164
6100,4900,2100,29890000,2,16806,4203,1,423920000,423920000,6301,2100,4201,2100,0,1,2102,12401471,12.401471
6100,4900,2500,29890000,2,20006,5003,1,459120000,459120000,7501,2500,5001,2500,0,1,2502,14140462,14.140462
6100,4900,2500,29890000,2,20006,5003,1,459120000,459120000,7501,2500,5001,2500,0,1,2502,14647089,14.647089
6100,4900,2500,29890000,2,20006,5003,1,459120000,459120000,7501,2500,5001,2500,0,1,2502,14227495,14.227495
6100,4900,2500,29890000,2,20006,5003,1,459120000,459120000,7501,2500,5001,2500,0,1,2502,14500682,14.500682
6100,4900,2500,29890000,2,20006,5003,1,459120000,459120000,7501,2500,5001,2500,0,1,2502,14080219,14.080219
6100,4900,2500,29890000,2,20006,5003,1,459120000,459120000,7501,2500,5001,2500,0,1,2502,14625433,14.625433
6100,4900,2500,29890000,2,20006,5003,1,459120000,459120000,7501,2500,5001,2500,0,1,2502,14006938,14.006938
6100,4900,2500,29890000,2,20006,5003,1,459120000,459120000,7501,2500,5001,2500,0,1,2502,14780140,14.78014
6100,4900,2900,29890000,2,23206,5803,1,494320000,494320000,8701,2900,5801,2900,0,1,2902,16333553,16.333553
6100,4900,2900,29890000,2,23206,5803,1,494320000,494320000,8701,2900,5801,2900,0,1,2902,16944297,16.944297
6100,4900,2900,29890000,2,23206,5803,1,494320000,494320000,8701,2900,5801,2900,0,1,2902,16435151,16.435151
6100,4900,2900,29890000,2,23206,5803,1,494320000,494320000,8701,2900,5801,2900,0,1,2902,16705306,16.705306
6100,4900,2900,29890000,2,23206,5803,1,494320000,494320000,8701,2900,5801,2900,0,1,2902,16286657,16.286657
6100,4900,2900,29890000,2,23206,5803,1,494320000,494320000,8701,2900,5801,2900,0,1,2902,16922810,16.92281
6100,4900,2900,29890000,2,23206,5803,1,494320000,494320000,8701,2900,5801,2900,0,1,2902,16138199,16.138199
6100,4900,2900,29890000,2,23206,5803,1,494320000,494320000,8701,2900,5801,2900,0,1,2902,17106773,17.106773
6100,4900,3300,29890000,2,26406,6603,1,529520000,529520000,9901,3300,6601,3300,0,1,3302,18534135,18.534135
6100,4900,3300,29890000,2,26406,6603,1,529520000,529520000,9901,3300,6601,3300,0,1,3302,19204127,19.204127
6100,4900,3300,29890000,2,26406,6603,1,529520000,529520000,9901,3300,6601,3300,0,1,3302,18639827,18.639827
6100,4900,3300,29890000,2,26406,6603,1,529520000,529520000,9901,3300,6601,3300,0,1,3302,18973940,18.97394
6100,4900,3300,29890000,2,26406,6603,1,529520000,529520000,9901,3300,6601,3300,0,1,3302,18452500,18.4525
6100,4900,3300,29890000,2,26406,6603,1,529520000,529520000,9901,3300,6601,3300,0,1,3302,19236550,19.23655
6100,4900,3300,29890000,2,26406,6603,1,529520000,529520000,9901,3300,6601,3300,0,1,3302,18355597,18.355597
6100,4900,3300,29890000,2,26406,6603,1,529520000,529520000,9901,3300,6601,3300,0,1,3302,19398116,19.398116
6100,4900,3700,29890000,2,29606,7403,1,564720000,564720000,11101,3700,7401,3700,0,1,3702,20731017,20.731017
6100,4900,3700,29890000,2,29606,7403,1,564720000,564720000,11101,3700,7401,3700,0,1,3702,21467607,21.467607
6100,4900,3700,29890000,2,29606,7403,1,564720000,564720000,11101,3700,7401,3700,0,1,3702,20884802,20.884802
6100,4900,3700,29890000,2,29606,7403,1,564720000,564720000,11101,3700,7401,3700,0,1,3702,21328583,21.328583
6100,4900,3700,29890000,2,29606,7403,1,564720000,564720000,11101,3700,7401,3700,0,1,3702,20645026,20.645026
6100,4900,3700,29890000,2,29606,7403,1,564720000,564720000,11101,3700,7401,3700,0,1,3702,21499955,21.499955
6100,4900,3700,29890000,2,29606,7403,1,564720000,564720000,11101,3700,7401,3700,0,1,3702,20500477,20.500477
6100,4900,3700,29890000,2,29606,7403,1,564720000,564720000,11101,3700,7401,3700,0,1,3702,21760247,21.760247
6100,4900,4100,29890000,2,32806,8203,1,599920000,599920000,12301,4100,8201,4100,0,1,4102,22884187,22.884187
6100,4900,4100,29890000,2,32806,8203,1,599920000,599920000,12301,4100,8201,4100,0,1,4102,23767490,23.76749
6100,4900,4100,29890000,2,32806,8203,1,599920000,599920000,12301,4100,8201,4100,0,1,4102,23083333,23.083333
6100,4900,4100,29890000,2,32806,8203,1,599920000,599920000,12301,4100,8201,4100,0,1,4102,23595113,23.595113
6100,4900,4100,29890000,2,32806,8203,1,599920000,599920000,12301,4100,8201,4100,0,1,4102,22904874,22.904874
6100,4900,4100,29890000,2,32806,8203,1,599920000,599920000,12301,4100,8201,4100,0,1,4102,23868070,23.86807
6100,4900,4100,29890000,2,32806,8203,1,599920000,599920000,12301,4100,8201,4100,0,1,4102,22672218,22.672218
6100,4900,4100,29890000,2,32806,8203,1,599920000,599920000,12301,4100,8201,4100,0,1,4102,24137079,24.137079
6100,4900,4500,29890000,2,36006,9003,1,635120000,635120000,13501,4500,9001,4500,0,1,4502,25131524,25.131524
6100,4900,4500,29890000,2,36006,9003,1,635120000,635120000,13501,4500,9001,4500,0,1,4502,26101472,26.101472
6100,4900,4500,29890000,2,36006,9003,1,635120000,635120000,13501,4500,9001,4500,0,1,4502,25278890,25.27889
6100,4900,4500,29890000,2,36006,9003,1,635120000,635120000,13501,4500,9001,4500,0,1,4502,25803866,25.803866
6100,4900,4500,29890000,2,36006,9003,1,635120000,635120000,13501,4500,9001,4500,0,1,4502,25061645,25.061645
6100,4900,4500,29890000,2,36006,9003,1,635120000,635120000,13501,4500,9001,4500,0,1,4502,26121488,26.121488
6100,4900,4500,29890000,2,36006,9003,1,635120000,635120000,13501,4500,9001,4500,0,1,4502,24828082,24.828082
6100,4900,4500,29890000,2,36006,9003,1,635120000,635120000,13501,4500,9001,4500,0,1,4502,26380183,26.380183
6100,4900,4900,29890000,2,39206,9803,1,670320000,670320000,14701,4900,9801,4900,0,1,4902,27351019,27.351019
6100,4900,4900,29890000,2,39206,9803,1,670320000,670320000,14701,4900,9801,4900,0,1,4902,28394009,28.394009
6100,4900,4900,29890000,2,39206,9803,1,670320000,670320000,14701,4900,9801,4900,0,1,4902,27486924,27.486924
6100,4900,4900,29890000,2,39206,9803,1,670320000,670320000,14701,4900,9801,4900,0,1,4902,28065044,28.065044
6100,4900,4900,29890000,2,39206,9803,1,670320000,670320000,14701,4900,9801,4900,0,1,4902,27260320,27.26032
6100,4900,4900,29890000,2,39206,9803,1,670320000,670320000,14701,4900,9801,4900,0,1,4902,28415370,28.41537
6100,4900,4900,29890000,2,39206,9803,1,670320000,670320000,14701,4900,9801,4900,0,1,4902,27004623,27.004623
6100,4900,4900,29890000,2,39206,9803,1,670320000,670320000,14701,4900,9801,4900,0,1,4902,28690011,28.690011
6100,4900,5300,29890000,2,42406,10603,1,705520000,705520000,15901,5300,10601,5300,0,1,5302,29587938,29.587938
6100,4900,5300,29890000,2,42406,10603,1,705520000,705520000,15901,5300,10601,5300,0,1,5302,30690176,30.690176
6100,4900,5300,29890000,2,42406,10603,1,705520000,705520000,15901,5300,10601,5300,0,1,5302,29721503,29.721503
6100,4900,5300,29890000,2,42406,10603,1,705520000,705520000,15901,5300,10601,5300,0,1,5302,30380576,30.380576
6100,4900,5300,29890000,2,42406,10603,1,705520000,705520000,15901,5300,10601,5300,0,1,5302,29464350,29.46435
6100,4900,5300,29890000,2,42406,10603,1,705520000,705520000,15901,5300,10601,5300,0,1,5302,30748393,30.748393
6100,4900,5300,29890000,2,42406,10603,1,705520000,705520000,15901,5300,10601,5300,0,1,5302,29248017,29.248017
6100,4900,5300,29890000,2,42406,10603,1,705520000,705520000,15901,5300,10601,5300,0,1,5302,30982430,30.98243
6100,4900,5700,29890000,2,45606,11403,1,740720000,740720000,17101,5700,11401,5700,0,1,5702,31798083,31.798083
6100,4900,5700,29890000,2,45606,11403,1,740720000,740720000,17101,5700,11401,5700,0,1,5702,33086898,33.086898
6100,4900,5700,29890000,2,45606,11403,1,740720000,740720000,17101,5700,11401,5700,0,1,5702,32012746,32.012746
6100,4900,5700,29890000,2,45606,11403,1,740720000,740720000,17101,5700,11401,5700,0,1,5702,32728763,32.728763
6100,4900,5700,29890000,2,45606,11403,1,740720000,740720000,17101,5700,11401,5700,0,1,5702,31648391,31.648391
6100,4900,5700,29890000,2,45606,11403,1,740720000,740720000,17101,5700,11401,5700,0,1,5702,33067599,33.067599
6100,4900,5700,29890000,2,45606,11403,1,740720000,740720000,17101,5700,11401,5700,0,1,5702,31445424,31.445424
6100,4900,5700,29890000,2,45606,11403,1,740720000,740720000,17101,5700,11401,5700,0,1,5702,33425756,33.425756
6100,4900,6100,29890000,2,48806,12203,1,775920000,775920000,18301,6100,12201,6100,0,1,6102,34003136,34.003136
6100,4900,6100,29890000,2,48806,12203,1,775920000,775920000,18301,6100,12201,6100,0,1,6102,35279531,35.279531
6100,4900,6100,29890000,2,48806,12203,1,775920000,775920000,18301,6100,12201,6100,0,1,6102,34185415,34.185415
6100,4900,6100,29890000,2,48806,12203,1,775920000,775920000,18301,6100,12201,6100,0,1,6102,35002561,35.002561
6100,4900,6100,29890000,2,48806,12203,1,775920000,775920000,18301,6100,12201,6100,0,1,6102,33800213,33.800213
6100,4900,6100,29890000,2,48806,12203,1,775920000,775920000,18301,6100,12201,6100,0,1,6102,35327469,35.327469
6100,4900,6100,29890000,2,48806,12203,1,775920000,775920000,18301,6100,12201,6100,0,1,6102,33645183,33.645183
6100,4900,6100,29890000,2,48806,12203,1,775920000,775920000,18301,6100,12201,6100,0,1,6102,35672611,35.672611
6100,4900,6500,29890000,2,52006,13003,1,811120000,811120000,19501,6500,13001,6500,0,1,6502,36222342,36.222342
6100,4900,6500,29890000,2,52006,13003,1,811120000,811120000,19501,6500,13001,6500,0,1,6502,37555636,37.555636
6100,4900,6500,29890000,2,52006,13003,1,811120000,811120000,19501,6500,13001,6500,0,1,6502,36434421,36.434421
6100,4900,6500,29890000,2,52006,13003,1,811120000,811120000,19501,6500,13001,6500,0,1,6502,37268542,37.268542
6100,4900,6500,29890000,2,52006,13003,1,811120000,811120000,19501,6500,13001,6500,0,1,6502,36017188,36.017188
6100,4900,6500,29890000,2,52006,13003,1,811120000,811120000,19501,6500,13001,6500,0,1,6502,37643107,37.643107
6100,4900,6500,29890000,2,52006,13003,1,811120000,811120000,19501,6500,13001,6500,0,1,6502,35868308,35.868308
6100,4900,6500,29890000,2,52006,13003,1,811120000,811120000,19501,6500,13001,6500,0,1,6502,38008042,38.008042
6100,4900,6900,29890000,2,55206,13803,1,846320000,846320000,20701,6900,13801,6900,0,1,6902,38454061,38.454061
6100,4900,6900,29890000,2,55206,13803,1,846320000,846320000,20701,6900,13801,6900,0,1,6902,39984105,39.984105
6100,4900,6900,29890000,2,55206,13803,1,846320000,846320000,20701,6900,13801,6900,0,1,6902,38632668,38.632668
6100,4900,6900,29890000,2,55206,13803,1,846320000,846320000,20701,6900,13801,6900,0,1,6902,39610953,39.610953
6100,4900,6900,29890000,2,55206,13803,1,846320000,846320000,20701,6900,13801,6900,0,1,6902,38218411,38.218411
6100,4900,6900,29890000,2,55206,13803,1,846320000,846320000,20701,6900,13801,6900,0,1,6902,39960675,39.960675
6100,4900,6900,29890000,2,55206,13803,1,846320000,846320000,20701,6900,13801,6900,0,1,6902,38106424,38.106424
6100,4900,6900,29890000,2,55206,13803,1,846320000,846320000,20701,6900,13801,6900,0,1,6902,40304531,40.304531
6100,4500,500,27450000,2,4006,1003,1,262000000,262000000,1501,500,1001,500,0,1,502,2950893,2.950893
6100,4500,500,27450000,2,4006,1003,1,262000000,262000000,1501,500,1001,500,0,1,502,2999258,2.999258
6100,4500,500,27450000,2,4006,1003,1,262000000,262000000,1501,500,1001,500,0,1,502,2970711,2.970711
6100,4500,500,27450000,2,4006,1003,1,262000000,262000000,1501,500,1001,500,0,1,502,2905932,2.905932
6100,4500,500,27450000,2,4006,1003,1,262000000,262000000,1501,500,1001,500,0,1,502,2841207,2.841207
6100,4500,500,27450000,2,4006,1003,1,262000000,262000000,1501,500,1001,500,0,1,502,2951721,2.951721
6100,4500,500,27450000,2,4006,1003,1,262000000,262000000,1501,500,1001,500,0,1,502,2930403,2.930403
6100,4500,500,27450000,2,4006,1003,1,262000000,262000000,1501,500,1001,500,0,1,502,3043348,3.043348
6100,4500,900,27450000,2,7206,1803,1,295920000,295920000,2701,900,1801,900,0,1,902,4779892,4.779892
6100,4500,900,27450000,2,7206,1803,1,295920000,295920000,2701,900,1801,900,0,1,902,4963888,4.963888
6100,4500,900,27450000,2,7206,1803,1,295920000,295920000,2701,900,1801,900,0,1,902,4831460,4.83146
6100,4500,900,27450000,2,7206,1803,1,295920000,295920000,2701,900,1801,900,0,1,902,4930947,4.930947
6100,4500,900,27450000,2,7206,1803,1,295920000,295920000,2701,900,1801,900,0,1,902,4758282,4.758282
6100,4500,900,27450000,2,7206,1803,1,295920000,295920000,2701,900,1801,900,0,1,902,4983649,4.983649
6100,4500,900,27450000,2,7206,1803,1,295920000,295920000,2701,900,1801,900,0,1,902,4739620,4.73962
6100,4500,900,27450000,2,7206,1803,1,295920000,295920000,2701,900,1801,900,0,1,902,5028202,5.028202
6100,4500,1300,27450000,2,10406,2603,1,329840000,329840000,3901,1300,2601,1300,0,1,1302,6805542,6.805542
6100,4500,1300,27450000,2,10406,2603,1,329840000,329840000,3901,1300,2601,1300,0,1,1302,7073319,7.073319
6100,4500,1300,27450000,2,10406,2603,1,329840000,329840000,3901,1300,2601,1300,0,1,1302,6855839,6.855839
6100,4500,1300,27450000,2,10406,2603,1,329840000,329840000,3901,1300,2601,1300,0,1,1302,6979736,6.979736
6100,4500,1300,27450000,2,10406,2603,1,329840000,329840000,3901,1300,2601,1300,0,1,1302,6760242,6.760242
6100,4500,1300,27450000,2,10406,2603,1,329840000,329840000,3901,1300,2601,1300,0,1,1302,7053758,7.053758
6100,4500,1300,27450000,2,10406,2603,1,329840000,329840000,3901,1300,2601,1300,0,1,1302,6717810,6.71781
6100,4500,1300,27450000,2,10406,2603,1,329840000,329840000,3901,1300,2601,1300,0,1,1302,7140423,7.140423
6100,4500,1700,27450000,2,13606,3403,1,363760000,363760000,5101,1700,3401,1700,0,1,1702,8955814,8.955814
6100,4500,1700,27450000,2,13606,3403,1,363760000,363760000,5101,1700,3401,1700,0,1,1702,9242034,9.242034
6100,4500,1700,27450000,2,13606,3403,1,363760000,363760000,5101,1700,3401,1700,0,1,1702,9052663,9.052663
6100,4500,1700,27450000,2,13606,3403,1,363760000,363760000,5101,1700,3401,1700,0,1,1702,9179433,9.179433
6100,4500,1700,27450000,2,13606,3403,1,363760000,363760000,5101,1700,3401,1700,0,1,1702,8931603,8.931603
6100,4500,1700,27450000,2,13606,3403,1,363760000,363760000,5101,1700,3401,1700,0,1,1702,9260778,9.260778
6100,4500,1700,27450000,2,13606,3403,1,363760000,363760000,5101,1700,3401,1700,0,1,1702,8888600,8.8886
6100,4500,1700,27450000,2,13606,3403,1,363760000,363760000,5101,1700,3401,1700,0,1,1702,9385872,9.385872
6100,4500,2100,27450000,2,16806,4203,1,397680000,397680000,6301,2100,4201,2100,0,1,2102,10839017,10.839017
6100,4500,2100,27450000,2,16806,4203,1,397680000,397680000,6301,2100,4201,2100,0,1,2102,11224618,11.224618
6100,4500,2100,27450000,2,16806,4203,1,397680000,397680000,6301,2100,4201,2100,0,1,2102,10918092,10.918092
6100,4500,2100,27450000,2,16806,4203,1,397680000,397680000,6301,2100,4201,2100,0,1,2102,11105719,11.105719
6100,4500,2100,27450000,2,16806,4203,1,397680000,397680000,6301,2100,4201,2100,0,1,2102,10764712,10.764712
6100,4500,2100,27450000,2,16806,4203,1,397680000,397680000,6301,2100,4201,2100,0,1,2102,11250946,11.250946
6100,4500,2100,27450000,2,16806,4203,1,397680000,397680000,6301,2100,4201,2100,0,1,2102,10687348,10.687348
6100,4500,2100,27450000,2,16806,4203,1,397680000,397680000,6301,2100,4201,2100,0,1,2102,11358611,11.358611
6100,4500,2500,27450000,2,20006,5003,1,431600000,431600000,7501,2500,5001,2500,0,1,2502,12996792,12.996792
6100,4500,2500,27450000,2,20006,5003,1,431600000,431600000,7501,2500,5001,2500,0,1,2502,13430601,13.430601
6100,4500,2500,27450000,2,20006,5003,1,431600000,431600000,7501,2500,5001,2500,0,1,2502,13072424,13.072424
6100,4500,2500,27450000,2,20006,5003,1,431600000,431600000,7501,2500,5001,2500,0,1,2502,13297022,13.297022
6100,4500,2500,27450000,2,20006,5003,1,431600000,431600000,7501,2500,5001,2500,0,1,2502,12909913,12.909913
6100,4500,2500,27450000,2,20006,5003,1,431600000,431600000,7501,2500,5001,2500,0,1,2502,13450658,13.450658
6100,4500,2500,27450000,2,20006,5003,1,431600000,431600000,7501,2500,5001,2500,0,1,2502,12850050,12.85005
6100,4500,2500,27450000,2,20006,5003,1,431600000,431600000,7501,2500,5001,2500,0,1,2502,13578716,13.578716
6100,4500,2900,27450000,2,23206,5803,1,465520000,465520000,8701,2900,5801,2900,0,1,2902,14984411,14.984411
6100,4500,2900,27450000,2,23206,5803,1,465520000,465520000,8701,2900,5801,2900,0,1,2902,15526010,15.52601
6100,4500,2900,27450000,2,23206,5803,1,465520000,465520000,8701,2900,5801,2900,0,1,2902,15110518,15.110518
6100,4500,2900,27450000,2,23206,5803,1,465520000,465520000,8701,2900,5801,2900,0,1,2902,15390359,15.390359
6100,4500,2900,27450000,2,23206,5803,1,465520000,465520000,8701,2900,5801,2900,0,1,2902,14929689,14.929689
6100,4500,2900,27450000,2,23206,5803,1,465520000,465520000,8701,2900,5801,2900,0,1,2902,15557911,15.557911
6100,4500,2900,27450000,2,23206,5803,1,465520000,465520000,8701,2900,5801,2900,0,1,2902,14852154,14.852154
6100,4500,2900,27450000,2,23206,5803,1,465520000,465520000,8701,2900,5801,2900,0,1,2902,15715543,15.715543
6100,4500,3300,27450000,2,26406,6603,1,499440000,499440000,9901,3300,6601,3300,0,1,3302,17011323,17.011323
6100,4500,3300,27450000,2,26406,6603,1,499440000,499440000,9901,3300,6601,3300,0,1,3302,17636591,17.636591
6100,4500,3300,27450000,2,26406,6603,1,499440000,499440000,9901,3300,6601,3300,0,1,3302,17149866,17.149866
6100,4500,3300,27450000,2,26406,6603,1,499440000,499440000,9901,3300,6601,3300,0,1,3302,17456614,17.456614
6100,4500,3300,27450000,2,26406,6603,1,499440000,499440000,9901,3300,6601,3300,0,1,3302,16936936,16.936936
6100,4500,3300,27450000,2,26406,6603,1,499440000,499440000,9901,3300,6601,3300,0,1,3302,17671543,17.671543
6100,4500,3300,27450000,2,26406,6603,1,499440000,499440000,9901,3300,6601,3300,0,1,3302,16849474,16.849474
6100,4500,3300,27450000,2,26406,6603,1,499440000,499440000,9901,3300,6601,3300,0,1,3302,17821086,17.821086
6100,4500,3700,27450000,2,29606,7403,1,533360000,533360000,11101,3700,7401,3700,0,1,3702,19069026,19.069026
6100,4500,3700,27450000,2,29606,7403,1,533360000,533360000,11101,3700,7401,3700,0,1,3702,19704854,19.704854
6100,4500,3700,27450000,2,29606,7403,1,533360000,533360000,11101,3700,7401,3700,0,1,3702,19160622,19.160622
6100,4500,3700,27450000,2,29606,7403,1,533360000,533360000,11101,3700,7401,3700,0,1,3702,19554070,19.55407
6100,4500,3700,27450000,2,29606,7403,1,533360000,533360000,11101,3700,7401,3700,0,1,3702,18918431,18.918431
6100,4500,3700,27450000,2,29606,7403,1,533360000,533360000,11101,3700,7401,3700,0,1,3702,19751203,19.751203
6100,4500,3700,27450000,2,29606,7403,1,533360000,533360000,11101,3700,7401,3700,0,1,3702,18818919,18.818919
6100,4500,3700,27450000,2,29606,7403,1,533360000,533360000,11101,3700,7401,3700,0,1,3702,19936286,19.936286
6100,4500,4100,27450000,2,32806,8203,1,567280000,567280000,12301,4100,8201,4100,0,1,4102,21062883,21.062883
6100,4500,4100,27450000,2,32806,8203,1,567280000,567280000,12301,4100,8201,4100,0,1,4102,21889374,21.889374
6100,4500,4100,27450000,2,32806,8203,1,567280000,567280000,12301,4100,8201,4100,0,1,4102,21189976,21.189976
6100,4500,4100,27450000,2,32806,8203,1,567280000,567280000,12301,4100,8201,4100,0,1,4102,21558518,21.558518
6100,4500,4100,27450000,2,32806,8203,1,567280000,567280000,12301,4100,8201,4100,0,1,4102,20953645,20.953645
6100,4500,4100,27450000,2,32806,8203,1,567280000,567280000,12301,4100,8201,4100,0,1,4102,21869878,21.869878
6100,4500,4100,27450000,2,32806,8203,1,567280000,567280000,12301,4100,8201,4100,0,1,4102,20821406,20.821406
6100,4500,4100,27450000,2,32806,8203,1,567280000,567280000,12301,4100,8201,4100,0,1,4102,22119126,22.119126
6100,4500,4500,27450000,2,36006,9003,1,601200000,601200000,13501,4500,9001,4500,0,1,4502,23095934,23.095934
6100,4500,4500,27450000,2,36006,9003,1,601200000,601200000,13501,4500,9001,4500,0,1,4502,23883042,23.883042
6100,4500,4500,27450000,2,36006,9003,1,601200000,601200000,13501,4500,9001,4500,0,1,4502,23177687,23.177687
6100,4500,4500,27450000,2,36006,9003,1,601200000,601200000,13501,4500,9001,4500,0,1,4502,23715181,23.715181
6100,4500,4500,27450000,2,36006,9003,1,601200000,601200000,13501,4500,9001,4500,0,1,4502,22950957,22.950957
6100,4500,4500,27450000,2,36006,9003,1,601200000,601200000,13501,4500,9001,4500,0,1,4502,24010988,24.010988
6100,4500,4500,27450000,2,36006,9003,1,601200000,601200000,13501,4500,9001,4500,0,1,4502,22816133,22.816133
6100,4500,4500,27450000,2,36006,9003,1,601200000,601200000,13501,4500,9001,4500,0,1,4502,24210254,24.210254
6100,4500,4900,27450000,2,39206,9803,1,635120000,635120000,14701,4900,9801,4900,0,1,4902,25102542,25.102542
6100,4500,4900,27450000,2,39206,9803,1,635120000,635120000,14701,4900,9801,4900,0,1,4902,26051631,26.051631
6100,4500,4900,27450000,2,39206,9803,1,635120000,635120000,14701,4900,9801,4900,0,1,4902,25263536,25.263536
6100,4500,4900,27450000,2,39206,9803,1,635120000,635120000,14701,4900,9801,4900,0,1,4902,25789355,25.789355
6100,4500,4900,27450000,2,39206,9803,1,635120000,635120000,14701,4900,9801,4900,0,1,4902,25010216,25.010216
6100,4500,4900,27450000,2,39206,9803,1,635120000,635120000,14701,4900,9801,4900,0,1,4902,26097167,26.097167
6100,4500,4900,27450000,2,39206,9803,1,635120000,635120000,14701,4900,9801,4900,0,1,4902,24861107,24.861107
6100,4500,4900,27450000,2,39206,9803,1,635120000,635120000,14701,4900,9801,4900,0,1,4902,26312929,26.312929
6100,4500,5300,27450000,2,42406,10603,1,669040000,669040000,15901,5300,10601,5300,0,1,5302,27164261,27.164261
6100,4500,5300,27450000,2,42406,10603,1,669040000,669040000,15901,5300,10601,5300,0,1,5302,28153611,28.153611
6100,4500,5300,27450000,2,42406,10603,1,669040000,669040000,15901,5300,10601,5300,0,1,5302,27315065,27.315065
6100,4500,5300,27450000,2,42406,10603,1,669040000,669040000,15901,5300,10601,5300,0,1,5302,28009322,28.009322
6100,4500,5300,27450000,2,42406,10603,1,669040000,669040000,15901,5300,10601,5300,0,1,5302,27033497,27.033497
6100,4500,5300,27450000,2,42406,10603,1,669040000,669040000,15901,5300,10601,5300,0,1,5302,28217611,28.217611
6100,4500,5300,27450000,2,42406,10603,1,669040000,669040000,15901,5300,10601,5300,0,1,5302,26882955,26.882955
6100,4500,5300,27450000,2,42406,10603,1,669040000,669040000,15901,5300,10601,5300,0,1,5302,28542535,28.542535
6100,4500,5700,27450000,2,45606,11403,1,702960000,702960000,17101,5700,11401,5700,0,1,5702,29262653,29.262653
6100,4500,5700,27450000,2,45606,11403,1,702960000,702960000,17101,5700,11401,5700,0,1,5702,30285427,30.285427
6100,4500,5700,27450000,2,45606,11403,1,702960000,702960000,17101,5700,11401,5700,0,1,5702,29368501,29.368501
6100,4500,5700,27450000,2,45606,11403,1,702960000,702960000,17101,5700,11401,5700,0,1,5702,30055995,30.055995
6100,4500,5700,27450000,2,45606,11403,1,702960000,702960000,17101,5700,11401,5700,0,1,5702,29121329,29.121329
6100,4500,5700,27450000,2,45606,11403,1,702960000,702960000,17101,5700,11401,5700,0,1,5702,30341924,30.341924
6100,4500,5700,27450000,2,45606,11403,1,702960000,702960000,17101,5700,11401,5700,0,1,5702,28896662,28.896662
6100,4500,5700,27450000,2,45606,11403,1,702960000,702960000,17101,5700,11401,5700,0,1,5702,30685785,30.685785
6100,4500,6100,27450000,2,48806,12203,1,736880000,736880000,18301,6100,12201,6100,0,1,6102,31212700,31.2127
6100,4500,6100,27450000,2,48806,12203,1,736880000,736880000,18301,6100,12201,6100,0,1,6102,32452846,32.452846
6100,4500,6100,27450000,2,48806,12203,1,736880000,736880000,18301,6100,12201,6100,0,1,6102,31453217,31.453217
6100,4500,6100,27450000,2,48806,12203,1,736880000,736880000,18301,6100,12201,6100,0,1,6102,32097916,32.097916
6100,4500,6100,27450000,2,48806,12203,1,736880000,736880000,18301,6100,12201,6100,0,1,6102,31141580,31.14158
6100,4500,6100,27450000,2,48806,12203,1,736880000,736880000,18301,6100,12201,6100,0,1,6102,32494152,32.494152
6100,4500,6100,27450000,2,48806,12203,1,736880000,736880000,18301,6100,12201,6100,0,1,6102,30900988,30.900988
6100,4500,6100,27450000,2,48806,12203,1,736880000,736880000,18301,6100,12201,6100,0,1,6102,32829391,32.829391
6100,4500,6500,27450000,2,52006,13003,1,770800000,770800000,19501,6500,13001,6500,0,1,6502,33276911,33.276911
6100,4500,6500,27450000,2,52006,13003,1,770800000,770800000,19501,6500,13001,6500,0,1,6502,34547326,34.547326
6100,4500,6500,27450000,2,52006,13003,1,770800000,770800000,19501,6500,13001,6500,0,1,6502,33536030,33.53603
6100,4500,6500,27450000,2,52006,13003,1,770800000,770800000,19501,6500,13001,6500,0,1,6502,34250875,34.250875
6100,4500,6500,27450000,2,52006,13003,1,770800000,770800000,19501,6500,13001,6500,0,1,6502,33139260,33.13926
6100,4500,6500,27450000,2,52006,13003,1,770800000,770800000,19501,6500,13001,6500,0,1,6502,34602465,34.602465
6100,4500,6500,27450000,2,52006,13003,1,770800000,770800000,19501,6500,13001,6500,0,1,6502,32966357,32.966357
6100,4500,6500,27450000,2,52006,13003,1,770800000,770800000,19501,6500,13001,6500,0,1,6502,34874702,34.874702
6100,4500,6900,27450000,2,55206,13803,1,804720000,804720000,20701,6900,13801,6900,0,1,6902,35353337,35.353337
6100,4500,6900,27450000,2,55206,13803,1,804720000,804720000,20701,6900,13801,6900,0,1,6902,36758131,36.758131
6100,4500,6900,27450000,2,55206,13803,1,804720000,804720000,20701,6900,13801,6900,0,1,6902,35529821,35.529821
6100,4500,6900,27450000,2,55206,13803,1,804720000,804720000,20701,6900,13801,6900,0,1,6902,36354147,36.354147
6100,4500,6900,27450000,2,55206,13803,1,804720000,804720000,20701,6900,13801,6900,0,1,6902,35179698,35.179698
6100,4500,6900,27450000,2,55206,13803,1,804720000,804720000,20701,6900,13801,6900,0,1,6902,36697859,36.697859
6100,4500,6900,27450000,2,55206,13803,1,804720000,804720000,20701,6900,13801,6900,0,1,6902,34964962,34.964962
6100,4500,6900,27450000,2,55206,13803,1,804720000,804720000,20701,6900,13801,6900,0,1,6902,37084759,37.084759
6100,4100,500,25010000,2,4006,1003,1,240880000,240880000,1501,500,1001,500,0,1,502,2696356,2.696356
6100,4100,500,25010000,2,4006,1003,1,240880000,240880000,1501,500,1001,500,0,1,502,2756055,2.756055
6100,4100,500,25010000,2,4006,1003,1,240880000,240880000,1501,500,1001,500,0,1,502,2738442,2.738442
6100,4100,500,25010000,2,4006,1003,1,240880000,240880000,1501,500,1001,500,0,1,502,2757314,2.757314
6100,4100,500,25010000,2,4006,1003,1,240880000,240880000,1501,500,1001,500,0,1,502,2737495,2.737495
6100,4100,500,25010000,2,4006,1003,1,240880000,240880000,1501,500,1001,500,0,1,502,2738818,2.738818
6100,4100,500,25010000,2,4006,1003,1,240880000,240880000,1501,500,1001,500,0,1,502,2719099,2.719099
6100,4100,500,25010000,2,4006,1003,1,240880000,240880000,1501,500,1001,500,0,1,502,2803549,2.803549
6100,4100,900,25010000,2,7206,1803,1,273520000,273520000,2701,900,1801,900,0,1,902,4362562,4.362562
6100,4100,900,25010000,2,7206,1803,1,273520000,273520000,2701,900,1801,900,0,1,902,4525481,4.525481
6100,4100,900,25010000,2,7206,1803,1,273520000,273520000,2701,900,1801,900,0,1,902,4422566,4.422566
6100,4100,900,25010000,2,7206,1803,1,273520000,273520000,2701,900,1801,900,0,1,902,4486178,4.486178
6100,4100,900,25010000,2,7206,1803,1,273520000,273520000,2701,900,1801,900,0,1,902,4379504,4.379504
6100,4100,900,25010000,2,7206,1803,1,273520000,273520000,2701,900,1801,900,0,1,902,4507418,4.507418
6100,4100,900,25010000,2,7206,1803,1,273520000,273520000,2701,900,1801,900,0,1,902,4343093,4.343093
6100,4100,900,25010000,2,7206,1803,1,273520000,273520000,2701,900,1801,900,0,1,902,4607372,4.607372
6100,4100,1300,25010000,2,10406,2603,1,306160000,306160000,3901,1300,2601,1300,0,1,1302,6194002,6.194002
6100,4100,1300,25010000,2,10406,2603,1,306160000,306160000,3901,1300,2601,1300,0,1,1302,6423005,6.423005
6100,4100,1300,25010000,2,10406,2603,1,306160000,306160000,3901,1300,2601,1300,0,1,1302,6265965,6.265965
6100,4100,1300,25010000,2,10406,2603,1,306160000,306160000,3901,1300,2601,1300,0,1,1302,6375568,6.375568
6100,4100,1300,25010000,2,10406,2603,1,306160000,306160000,3901,1300,2601,1300,0,1,1302,6210936,6.210936
6100,4100,1300,25010000,2,10406,2603,1,306160000,306160000,3901,1300,2601,1300,0,1,1302,6440260,6.44026
6100,4100,1300,25010000,2,10406,2603,1,306160000,306160000,3901,1300,2601,1300,0,1,1302,6122356,6.122356
6100,4100,1300,25010000,2,10406,2603,1,306160000,306160000,3901,1300,2601,1300,0,1,1302,6523692,6.523692
6100,4100,1700,25010000,2,13606,3403,1,338800000,338800000,5101,1700,3401,1700,0,1,1702,8046362,8.046362
6100,4100,1700,25010000,2,13606,3403,1,338800000,338800000,5101,1700,3401,1700,0,1,1702,8325321,8.325321
6100,4100,1700,25010000,2,13606,3403,1,338800000,338800000,5101,1700,3401,1700,0,1,1702,8119557,8.119557
6100,4100,1700,25010000,2,13606,3403,1,338800000,338800000,5101,1700,3401,1700,0,1,1702,8250952,8.250952
6100,4100,1700,25010000,2,13606,3403,1,338800000,338800000,5101,1700,3401,1700,0,1,1702,8029100,8.0291
6100,4100,1700,25010000,2,13606,3403,1,338800000,338800000,5101,1700,3401,1700,0,1,1702,8344306,8.344306
6100,4100,1700,25010000,2,13606,3403,1,338800000,338800000,5101,1700,3401,1700,0,1,1702,7949672,7.949672
6100,4100,1700,25010000,2,13606,3403,1,338800000,338800000,5101,1700,3401,1700,0,1,1702,8452923,8.452923
6100,4100,2100,25010000,2,16806,4203,1,371440000,371440000,6301,2100,4201,2100,0,1,2102,10042268,10.042268
6100,4100,2100,25010000,2,16806,4203,1,371440000,371440000,6301,2100,4201,2100,0,1,2102,10360036,10.360036
6100,4100,2100,25010000,2,16806,4203,1,371440000,371440000,6301,2100,4201,2100,0,1,2102,10123848,10.123848
6100,4100,2100,25010000,2,16806,4203,1,371440000,371440000,6301,2100,4201,2100,0,1,2102,10270543,10.270543
6100,4100,2100,25010000,2,16806,4203,1,371440000,371440000,6301,2100,4201,2100,0,1,2102,10024944,10.024944
6100,4100,2100,25010000,2,16806,4203,1,371440000,371440000,6301,2100,4201,2100,0,1,2102,10378007,10.378007
6100,4100,2100,25010000,2,16806,4203,1,371440000,371440000,6301,2100,4201,2100,0,1,2102,9923287,9.923287
6100,4100,2100,25010000,2,16806,4203,1,371440000,371440000,6301,2100,4201,2100,0,1,2102,10491287,10.491287
6100,4100,2500,25010000,2,20006,5003,1,404080000,404080000,7501,2500,5001,2500,0,1,2502,11722473,11.722473
6100,4100,2500,25010000,2,20006,5003,1,404080000,404080000,7501,2500,5001,2500,0,1,2502,12150999,12.150999
6100,4100,2500,25010000,2,20006,5003,1,404080000,404080000,7501,2500,5001,2500,0,1,2502,11825868,11.825868
6100,4100,2500,25010000,2,20006,5003,1,404080000,404080000,7501,2500,5001,2500,0,1,2502,12036127,12.036127
6100,4100,2500,25010000,2,20006,5003,1,404080000,404080000,7501,2500,5001,2500,0,1,2502,11672263,11.672263
6100,4100,2500,25010000,2,20006,5003,1,404080000,404080000,7501,2500,5001,2500,0,1,2502,12169144,12.169144
6100,4100,2500,25010000,2,20006,5003,1,404080000,404080000,7501,2500,5001,2500,0,1,2502,11561288,11.561288
6100,4100,2500,25010000,2,20006,5003,1,404080000,404080000,7501,2500,5001,2500,0,1,2502,12321238,12.321238
6100,4100,2900,25010000,2,23206,5803,1,436720000,436720000,8701,2900,5801,2900,0,1,2902,13681107,13.681107
6100,4100,2900,25010000,2,23206,5803,1,436720000,436720000,8701,2900,5801,2900,0,1,2902,14225591,14.225591
6100,4100,2900,25010000,2,23206,5803,1,436720000,436720000,8701,2900,5801,2900,0,1,2902,13840533,13.840533
6100,4100,2900,25010000,2,23206,5803,1,436720000,436720000,8701,2900,5801,2900,0,1,2902,14040220,14.04022
6100,4100,2900,25010000,2,23206,5803,1,436720000,436720000,8701,2900,5801,2900,0,1,2902,13698035,13.698035
6100,4100,2900,25010000,2,23206,5803,1,436720000,436720000,8701,2900,5801,2900,0,1,2902,14208325,14.208325
6100,4100,2900,25010000,2,23206,5803,1,436720000,436720000,8701,2900,5801,2900,0,1,2902,13557566,13.557566
6100,4100,2900,25010000,2,23206,5803,1,436720000,436720000,8701,2900,5801,2900,0,1,2902,14383336,14.383336
6100,4100,3300,25010000,2,26406,6603,1,469360000,469360000,9901,3300,6601,3300,0,1,3302,15535638,15.535638
6100,4100,3300,25010000,2,26406,6603,1,469360000,469360000,9901,3300,6601,3300,0,1,3302,16105919,16.105919
6100,4100,3300,25010000,2,26406,6603,1,469360000,469360000,9901,3300,6601,3300,0,1,3302,15688030,15.68803
6100,4100,3300,25010000,2,26406,6603,1,469360000,469360000,9901,3300,6601,3300,0,1,3302,15919773,15.919773
6100,4100,3300,25010000,2,26406,6603,1,469360000,469360000,9901,3300,6601,3300,0,1,3302,15518210,15.51821
6100,4100,3300,25010000,2,26406,6603,1,469360000,469360000,9901,3300,6601,3300,0,1,3302,16133562,16.133562
6100,4100,3300,25010000,2,26406,6603,1,469360000,469360000,9901,3300,6601,3300,0,1,3302,15387491,15.387491
6100,4100,3300,25010000,2,26406,6603,1,469360000,469360000,9901,3300,6601,3300,0,1,3302,16320114,16.320114
6100,4100,3700,25010000,2,29606,7403,1,502000000,502000000,11101,3700,7401,3700,0,1,3702,17415596,17.415596
6100,4100,3700,25010000,2,29606,7403,1,502000000,502000000,11101,3700,7401,3700,0,1,3702,18009203,18.009203
6100,4100,3700,25010000,2,29606,7403,1,502000000,502000000,11101,3700,7401,3700,0,1,3702,17528213,17.528213
6100,4100,3700,25010000,2,29606,7403,1,502000000,502000000,11101,3700,7401,3700,0,1,3702,17872405,17.872405
6100,4100,3700,25010000,2,29606,7403,1,502000000,502000000,11101,3700,7401,3700,0,1,3702,17343519,17.343519
6100,4100,3700,25010000,2,29606,7403,1,502000000,502000000,11101,3700,7401,3700,0,1,3702,18098847,18.098847
6100,4100,3700,25010000,2,29606,7403,1,502000000,502000000,11101,3700,7401,3700,0,1,3702,17187553,17.187553
6100,4100,3700,25010000,2,29606,7403,1,502000000,502000000,11101,3700,7401,3700,0,1,3702,18241809,18.241809
6100,4100,4100,25010000,2,32806,8203,1,534640000,534640000,12301,4100,8201,4100,0,1,4102,19255493,19.255493
6100,4100,4100,25010000,2,32806,8203,1,534640000,534640000,12301,4100,8201,4100,0,1,4102,19921689,19.921689
6100,4100,4100,25010000,2,32806,8203,1,534640000,534640000,12301,4100,8201,4100,0,1,4102,19337940,19.33794
6100,4100,4100,25010000,2,32806,8203,1,534640000,534640000,12301,4100,8201,4100,0,1,4102,19739798,19.739798
6100,4100,4100,25010000,2,32806,8203,1,534640000,534640000,12301,4100,8201,4100,0,1,4102,19166226,19.166226
6100,4100,4100,25010000,2,32806,8203,1,534640000,534640000,12301,4100,8201,4100,0,1,4102,19951663,19.951663
6100,4100,4100,25010000,2,32806,8203,1,534640000,534640000,12301,4100,8201,4100,0,1,4102,18995389,18.995389
6100,4100,4100,25010000,2,32806,8203,1,534640000,534640000,12301,4100,8201,4100,0,1,4102,20164576,20.164576
6100,4100,4500,25010000,2,36006,9003,1,567280000,567280000,13501,4500,9001,4500,0,1,4502,21116512,21.116512
6100,4100,4500,25010000,2,36006,9003,1,567280000,567280000,13501,4500,9001,4500,0,1,4502,21856766,21.856766
6100,4100,4500,25010000,2,36006,9003,1,567280000,567280000,13501,4500,9001,4500,0,1,4502,21187033,21.187033
6100,4100,4500,25010000,2,36006,9003,1,567280000,567280000,13501,4500,9001,4500,0,1,4502,21596981,21.596981
6100,4100,4500,25010000,2,36006,9003,1,567280000,567280000,13501,4500,9001,4500,0,1,4502,20961188,20.961188
6100,4100,4500,25010000,2,36006,9003,1,567280000,567280000,13501,4500,9001,4500,0,1,4502,21926026,21.926026
6100,4100,4500,25010000,2,36006,9003,1,567280000,567280000,13501,4500,9001,4500,0,1,4502,20978737,20.978737
6100,4100,4500,25010000,2,36006,9003,1,567280000,567280000,13501,4500,9001,4500,0,1,4502,22104550,22.10455
6100,4100,4900,25010000,2,39206,9803,1,599920000,599920000,14701,4900,9801,4900,0,1,4902,22917585,22.917585
6100,4100,4900,25010000,2,39206,9803,1,599920000,599920000,14701,4900,9801,4900,0,1,4902,23759964,23.759964
6100,4100,4900,25010000,2,39206,9803,1,599920000,599920000,14701,4900,9801,4900,0,1,4902,22993956,22.993956
6100,4100,4900,25010000,2,39206,9803,1,599920000,599920000,14701,4900,9801,4900,0,1,4902,23503060,23.50306
6100,4100,4900,25010000,2,39206,9803,1,599920000,599920000,14701,4900,9801,4900,0,1,4902,22795014,22.795014
6100,4100,4900,25010000,2,39206,9803,1,599920000,599920000,14701,4900,9801,4900,0,1,4902,23792261,23.792261
6100,4100,4900,25010000,2,39206,9803,1,599920000,599920000,14701,4900,9801,4900,0,1,4902,22645259,22.645259
6100,4100,4900,25010000,2,39206,9803,1,599920000,599920000,14701,4900,9801,4900,0,1,4902,24050595,24.050595
6100,4100,5300,25010000,2,42406,10603,1,632560000,632560000,15901,5300,10601,5300,0,1,5302,24794770,24.79477
6100,4100,5300,25010000,2,42406,10603,1,632560000,632560000,15901,5300,10601,5300,0,1,5302,25669159,25.669159
6100,4100,5300,25010000,2,42406,10603,1,632560000,632560000,15901,5300,10601,5300,0,1,5302,24915394,24.915394
6100,4100,5300,25010000,2,42406,10603,1,632560000,632560000,15901,5300,10601,5300,0,1,5302,25474665,25.474665
6100,4100,5300,25010000,2,42406,10603,1,632560000,632560000,15901,5300,10601,5300,0,1,5302,24652498,24.652498
6100,4100,5300,25010000,2,42406,10603,1,632560000,632560000,15901,5300,10601,5300,0,1,5302,25737314,25.737314
6100,4100,5300,25010000,2,42406,10603,1,632560000,632560000,15901,5300,10601,5300,0,1,5302,24522041,24.522041
6100,4100,5300,25010000,2,42406,10603,1,632560000,632560000,15901,5300,10601,5300,0,1,5302,25997578,25.997578
6100,4100,5700,25010000,2,45606,11403,1,665200000,665200000,17101,5700,11401,5700,0,1,5702,26633767,26.633767
6100,4100,5700,25010000,2,45606,11403,1,665200000,665200000,17101,5700,11401,5700,0,1,5702,27657333,27.657333
6100,4100,5700,25010000,2,45606,11403,1,665200000,665200000,17101,5700,11401,5700,0,1,5702,26816875,26.816875
6100,4100,5700,25010000,2,45606,11403,1,665200000,665200000,17101,5700,11401,5700,0,1,5702,27350995,27.350995
6100,4100,5700,25010000,2,45606,11403,1,665200000,665200000,17101,5700,11401,5700,0,1,5702,26536820,26.53682
6100,4100,5700,25010000,2,45606,11403,1,665200000,665200000,17101,5700,11401,5700,0,1,5702,27691935,27.691935
6100,4100,5700,25010000,2,45606,11403,1,665200000,665200000,17101,5700,11401,5700,0,1,5702,26363467,26.363467
6100,4100,5700,25010000,2,45606,11403,1,665200000,665200000,17101,5700,11401,5700,0,1,5702,27994728,27.994728
6100,4100,6100,25010000,2,48806,12203,1,697840000,697840000,18301,6100,12201,6100,0,1,6102,28505603,28.505603
6100,4100,6100,25010000,2,48806,12203,1,697840000,697840000,18301,6100,12201,6100,0,1,6102,29560298,29.560298
6100,4100,6100,25010000,2,48806,12203,1,697840000,697840000,18301,6100,12201,6100,0,1,6102,28704441,28.704441
6100,4100,6100,25010000,2,48806,12203,1,697840000,697840000,18301,6100,12201,6100,0,1,6102,29316284,29.316284
6100,4100,6100,25010000,2,48806,12203,1,697840000,697840000,18301,6100,12201,6100,0,1,6102,28396425,28.396425
6100,4100,6100,25010000,2,48806,12203,1,697840000,697840000,18301,6100,12201,6100,0,1,6102,29629139,29.629139
6100,4100,6100,25010000,2,48806,12203,1,697840000,697840000,18301,6100,12201,6100,0,1,6102,28220410,28.22041
6100,4100,6100,25010000,2,48806,12203,1,697840000,697840000,18301,6100,12201,6100,0,1,6102,29918634,29.918634
6100,4100,6500,25010000,2,52006,13003,1,730480000,730480000,19501,6500,13001,6500,0,1,6502,30378493,30.378493
6100,4100,6500,25010000,2,52006,13003,1,730480000,730480000,19501,6500,13001,6500,0,1,6502,31526276,31.526276
6100,4100,6500,25010000,2,52006,13003,1,730480000,730480000,19501,6500,13001,6500,0,1,6502,30567200,30.5672
6100,4100,6500,25010000,2,52006,13003,1,730480000,730480000,19501,6500,13001,6500,0,1,6502,31297158,31.297158
6100,4100,6500,25010000,2,52006,13003,1,730480000,730480000,19501,6500,13001,6500,0,1,6502,30284041,30.284041
6100,4100,6500,25010000,2,52006,13003,1,730480000,730480000,19501,6500,13001,6500,0,1,6502,31591024,31.591024
6100,4100,6500,25010000,2,52006,13003,1,730480000,730480000,19501,6500,13001,6500,0,1,6502,30060961,30.060961
6100,4100,6500,25010000,2,52006,13003,1,730480000,730480000,19501,6500,13001,6500,0,1,6502,31858479,31.858479
6100,4100,6900,25010000,2,55206,13803,1,763120000,763120000,20701,6900,13801,6900,0,1,6902,32229777,32.229777
6100,4100,6900,25010000,2,55206,13803,1,763120000,763120000,20701,6900,13801,6900,0,1,6902,33417628,33.417628
6100,4100,6900,25010000,2,55206,13803,1,763120000,763120000,20701,6900,13801,6900,0,1,6902,32413234,32.413234
6100,4100,6900,25010000,2,55206,13803,1,763120000,763120000,20701,6900,13801,6900,0,1,6902,33136413,33.136413
6100,4100,6900,25010000,2,55206,13803,1,763120000,763120000,20701,6900,13801,6900,0,1,6902,32091258,32.091258
6100,4100,6900,25010000,2,55206,13803,1,763120000,763120000,20701,6900,13801,6900,0,1,6902,33484138,33.484138
6100,4100,6900,25010000,2,55206,13803,1,763120000,763120000,20701,6900,13801,6900,0,1,6902,31938317,31.938317
6100,4100,6900,25010000,2,55206,13803,1,763120000,763120000,20701,6900,13801,6900,0,1,6902,33771070,33.77107
6100,3700,500,22570000,2,4006,1003,1,219760000,219760000,1501,500,1001,500,0,1,502,2364732,2.364732
6100,3700,500,22570000,2,4006,1003,1,219760000,219760000,1501,500,1001,500,0,1,502,2447071,2.447071
6100,3700,500,22570000,2,4006,1003,1,219760000,219760000,1501,500,1001,500,0,1,502,2463460,2.46346
6100,3700,500,22570000,2,4006,1003,1,219760000,219760000,1501,500,1001,500,0,1,502,2497452,2.497452
6100,3700,500,22570000,2,4006,1003,1,219760000,219760000,1501,500,1001,500,0,1,502,2480190,2.48019
6100,3700,500,22570000,2,4006,1003,1,219760000,219760000,1501,500,1001,500,0,1,502,2482675,2.482675
6100,3700,500,22570000,2,4006,1003,1,219760000,219760000,1501,500,1001,500,0,1,502,2430263,2.430263
6100,3700,500,22570000,2,4006,1003,1,219760000,219760000,1501,500,1001,500,0,1,502,2381282,2.381282
6100,3700,900,22570000,2,7206,1803,1,251120000,251120000,2701,900,1801,900,0,1,902,3937494,3.937494
6100,3700,900,22570000,2,7206,1803,1,251120000,251120000,2701,900,1801,900,0,1,902,4103899,4.103899
6100,3700,900,22570000,2,7206,1803,1,251120000,251120000,2701,900,1801,900,0,1,902,3980411,3.980411
6100,3700,900,22570000,2,7206,1803,1,251120000,251120000,2701,900,1801,900,0,1,902,4071491,4.071491
6100,3700,900,22570000,2,7206,1803,1,251120000,251120000,2701,900,1801,900,0,1,902,3956764,3.956764
6100,3700,900,22570000,2,7206,1803,1,251120000,251120000,2701,900,1801,900,0,1,902,4087863,4.087863
6100,3700,900,22570000,2,7206,1803,1,251120000,251120000,2701,900,1801,900,0,1,902,3889375,3.889375
6100,3700,900,22570000,2,7206,1803,1,251120000,251120000,2701,900,1801,900,0,1,902,4238889,4.238889
6100,3700,1300,22570000,2,10406,2603,1,282480000,282480000,3901,1300,2601,1300,0,1,1302,5604601,5.604601
6100,3700,1300,22570000,2,10406,2603,1,282480000,282480000,3901,1300,2601,1300,0,1,1302,5804350,5.80435
6100,3700,1300,22570000,2,10406,2603,1,282480000,282480000,3901,1300,2601,1300,0,1,1302,5652716,5.652716
6100,3700,1300,22570000,2,10406,2603,1,282480000,282480000,3901,1300,2601,1300,0,1,1302,5765283,5.765283
6100,3700,1300,22570000,2,10406,2603,1,282480000,282480000,3901,1300,2601,1300,0,1,1302,5585753,5.585753
6100,3700,1300,22570000,2,10406,2603,1,282480000,282480000,3901,1300,2601,1300,0,1,1302,5804947,5.804947
6100,3700,1300,22570000,2,10406,2603,1,282480000,282480000,3901,1300,2601,1300,0,1,1302,5554226,5.554226
6100,3700,1300,22570000,2,10406,2603,1,282480000,282480000,3901,1300,2601,1300,0,1,1302,5856319,5.856319
6100,3700,1700,22570000,2,13606,3403,1,313840000,313840000,5101,1700,3401,1700,0,1,1702,7262159,7.262159
6100,3700,1700,22570000,2,13606,3403,1,313840000,313840000,5101,1700,3401,1700,0,1,1702,7512903,7.512903
6100,3700,1700,22570000,2,13606,3403,1,313840000,313840000,5101,1700,3401,1700,0,1,1702,7331469,7.331469
6100,3700,1700,22570000,2,13606,3403,1,313840000,313840000,5101,1700,3401,1700,0,1,1702,7470663,7.470663
6100,3700,1700,22570000,2,13606,3403,1,313840000,313840000,5101,1700,3401,1700,0,1,1702,7232471,7.232471
6100,3700,1700,22570000,2,13606,3403,1,313840000,313840000,5101,1700,3401,1700,0,1,1702,7529282,7.529282
6100,3700,1700,22570000,2,13606,3403,1,313840000,313840000,5101,1700,3401,1700,0,1,1702,7183447,7.183447
6100,3700,1700,22570000,2,13606,3403,1,313840000,313840000,5101,1700,3401,1700,0,1,1702,7593462,7.593462
6100,3700,2100,22570000,2,16806,4203,1,345200000,345200000,6301,2100,4201,2100,0,1,2102,9078790,9.07879
6100,3700,2100,22570000,2,16806,4203,1,345200000,345200000,6301,2100,4201,2100,0,1,2102,9360916,9.360916
6100,3700,2100,22570000,2,16806,4203,1,345200000,345200000,6301,2100,4201,2100,0,1,2102,9127293,9.127293
6100,3700,2100,22570000,2,16806,4203,1,345200000,345200000,6301,2100,4201,2100,0,1,2102,9230952,9.230952
6100,3700,2100,22570000,2,16806,4203,1,345200000,345200000,6301,2100,4201,2100,0,1,2102,9050663,9.050663
6100,3700,2100,22570000,2,16806,4203,1,345200000,345200000,6301,2100,4201,2100,0,1,2102,9382641,9.382641
6100,3700,2100,22570000,2,16806,4203,1,345200000,345200000,6301,2100,4201,2100,0,1,2102,8975044,8.975044
6100,3700,2100,22570000,2,16806,4203,1,345200000,345200000,6301,2100,4201,2100,0,1,2102,9456128,9.456128
6100,3700,2500,22570000,2,20006,5003,1,376560000,376560000,7501,2500,5001,2500,0,1,2502,10583227,10.583227
6100,3700,2500,22570000,2,20006,5003,1,376560000,376560000,7501,2500,5001,2500,0,1,2502,10962333,10.962333
6100,3700,2500,22570000,2,20006,5003,1,376560000,376560000,7501,2500,5001,2500,0,1,2502,10669647,10.669647
6100,3700,2500,22570000,2,20006,5003,1,376560000,376560000,7501,2500,5001,2500,0,1,2502,10850687,10.850687
6100,3700,2500,22570000,2,20006,5003,1,376560000,376560000,7501,2500,5001,2500,0,1,2502,10531722,10.531722
6100,3700,2500,22570000,2,20006,5003,1,376560000,376560000,7501,2500,5001,2500,0,1,2502,10990665,10.990665
6100,3700,2500,22570000,2,20006,5003,1,376560000,376560000,7501,2500,5001,2500,0,1,2502,10446227,10.446227
6100,3700,2500,22570000,2,20006,5003,1,376560000,376560000,7501,2500,5001,2500,0,1,2502,11081693,11.081693
6100,3700,2900,22570000,2,23206,5803,1,407920000,407920000,8701,2900,5801,2900,0,1,2902,12376648,12.376648
6100,3700,2900,22570000,2,23206,5803,1,407920000,407920000,8701,2900,5801,2900,0,1,2902,12796040,12.79604
6100,3700,2900,22570000,2,23206,5803,1,407920000,407920000,8701,2900,5801,2900,0,1,2902,12481913,12.481913
6100,3700,2900,22570000,2,23206,5803,1,407920000,407920000,8701,2900,5801,2900,0,1,2902,12672038,12.672038
6100,3700,2900,22570000,2,23206,5803,1,407920000,407920000,8701,2900,5801,2900,0,1,2902,12341862,12.341862
6100,3700,2900,22570000,2,23206,5803,1,407920000,407920000,8701,2900,5801,2900,0,1,2902,12812310,12.81231
6100,3700,2900,22570000,2,23206,5803,1,407920000,407920000,8701,2900,5801,2900,0,1,2902,12268761,12.268761
6100,3700,2900,22570000,2,23206,5803,1,407920000,407920000,8701,2900,5801,2900,0,1,2902,12922439,12.922439
6100,3700,3300,22570000,2,26406,6603,1,439280000,439280000,9901,3300,6601,3300,0,1,3302,14045564,14.045564
6100,3700,3300,22570000,2,26406,6603,1,439280000,439280000,9901,3300,6601,3300,0,1,3302,14521397,14.521397
6100,3700,3300,22570000,2,26406,6603,1,439280000,439280000,9901,3300,6601,3300,0,1,3302,14161195,14.161195
6100,3700,3300,22570000,2,26406,6603,1,439280000,439280000,9901,3300,6601,3300,0,1,3302,14396340,14.39634
6100,3700,3300,22570000,2,26406,6603,1,439280000,439280000,9901,3300,6601,3300,0,1,3302,13999105,13.999105
6100,3700,3300,22570000,2,26406,6603,1,439280000,439280000,9901,3300,6601,3300,0,1,3302,14580501,14.580501
6100,3700,3300,22570000,2,26406,6603,1,439280000,439280000,9901,3300,6601,3300,0,1,3302,13893644,13.893644
6100,3700,3300,22570000,2,26406,6603,1,439280000,439280000,9901,3300,6601,3300,0,1,3302,14705056,14.705056
6100,3700,3700,22570000,2,29606,7403,1,470640000,470640000,11101,3700,7401,3700,0,1,3702,15706486,15.706486
6100,3700,3700,22570000,2,29606,7403,1,470640000,470640000,11101,3700,7401,3700,0,1,3702,16252117,16.252117
6100,3700,3700,22570000,2,29606,7403,1,470640000,470640000,11101,3700,7401,3700,0,1,3702,15845796,15.845796
6100,3700,3700,22570000,2,29606,7403,1,470640000,470640000,11101,3700,7401,3700,0,1,3702,16125663,16.125663
6100,3700,3700,22570000,2,29606,7403,1,470640000,470640000,11101,3700,7401,3700,0,1,3702,15673718,15.673718
6100,3700,3700,22570000,2,29606,7403,1,470640000,470640000,11101,3700,7401,3700,0,1,3702,16279687,16.279687
6100,3700,3700,22570000,2,29606,7403,1,470640000,470640000,11101,3700,7401,3700,0,1,3702,15548322,15.548322
6100,3700,3700,22570000,2,29606,7403,1,470640000,470640000,11101,3700,7401,3700,0,1,3702,16416820,16.41682
6100,3700,4100,22570000,2,32806,8203,1,502000000,502000000,12301,4100,8201,4100,0,1,4102,17376305,17.376305
6100,3700,4100,22570000,2,32806,8203,1,502000000,502000000,12301,4100,8201,4100,0,1,4102,17996674,17.996674
6100,3700,4100,22570000,2,32806,8203,1,502000000,502000000,12301,4100,8201,4100,0,1,4102,17505625,17.505625
6100,3700,4100,22570000,2,32806,8203,1,502000000,502000000,12301,4100,8201,4100,0,1,4102,17819367,17.819367
6100,3700,4100,22570000,2,32806,8203,1,502000000,502000000,12301,4100,8201,4100,0,1,4102,17331641,17.331641
6100,3700,4100,22570000,2,32806,8203,1,502000000,502000000,12301,4100,8201,4100,0,1,4102,18028932,18.028932
6100,3700,4100,22570000,2,32806,8203,1,502000000,502000000,12301,4100,8201,4100,0,1,4102,17211499,17.211499
6100,3700,4100,22570000,2,32806,8203,1,502000000,502000000,12301,4100,8201,4100,0,1,4102,18164946,18.164946
6100,3700,4500,22570000,2,36006,9003,1,533360000,533360000,13501,4500,9001,4500,0,1,4502,19079171,19.079171
6100,3700,4500,22570000,2,36006,9003,1,533360000,533360000,13501,4500,9001,4500,0,1,4502,19726134,19.726134
6100,3700,4500,22570000,2,36006,9003,1,533360000,533360000,13501,4500,9001,4500,0,1,4502,19157984,19.157984
6100,3700,4500,22570000,2,36006,9003,1,533360000,533360000,13501,4500,9001,4500,0,1,4502,19562239,19.562239
6100,3700,4500,22570000,2,36006,9003,1,533360000,533360000,13501,4500,9001,4500,0,1,4502,18989465,18.989465
6100,3700,4500,22570000,2,36006,9003,1,533360000,533360000,13501,4500,9001,4500,0,1,4502,19774363,19.774363
6100,3700,4500,22570000,2,36006,9003,1,533360000,533360000,13501,4500,9001,4500,0,1,4502,18815024,18.815024
6100,3700,4500,22570000,2,36006,9003,1,533360000,533360000,13501,4500,9001,4500,0,1,4502,19940683,19.940683
6100,3700,4900,22570000,2,39206,9803,1,564720000,564720000,14701,4900,9801,4900,0,1,4902,20718656,20.718656
6100,3700,4900,22570000,2,39206,9803,1,564720000,564720000,14701,4900,9801,4900,0,1,4902,21464994,21.464994
6100,3700,4900,22570000,2,39206,9803,1,564720000,564720000,14701,4900,9801,4900,0,1,4902,20834323,20.834323
6100,3700,4900,22570000,2,39206,9803,1,564720000,564720000,14701,4900,9801,4900,0,1,4902,21248538,21.248538
6100,3700,4900,22570000,2,39206,9803,1,564720000,564720000,14701,4900,9801,4900,0,1,4902,20644512,20.644512
6100,3700,4900,22570000,2,39206,9803,1,564720000,564720000,14701,4900,9801,4900,0,1,4902,21494139,21.494139
6100,3700,4900,22570000,2,39206,9803,1,564720000,564720000,14701,4900,9801,4900,0,1,4902,20457673,20.457673
6100,3700,4900,22570000,2,39206,9803,1,564720000,564720000,14701,4900,9801,4900,0,1,4902,21684158,21.684158
6100,3700,5300,22570000,2,42406,10603,1,596080000,596080000,15901,5300,10601,5300,0,1,5302,22398050,22.39805
6100,3700,5300,22570000,2,42406,10603,1,596080000,596080000,15901,5300,10601,5300,0,1,5302,23171314,23.171314
6100,3700,5300,22570000,2,42406,10603,1,596080000,596080000,15901,5300,10601,5300,0,1,5302,22537720,22.53772
6100,3700,5300,22570000,2,42406,10603,1,596080000,596080000,15901,5300,10601,5300,0,1,5302,22966512,22.966512
6100,3700,5300,22570000,2,42406,10603,1,596080000,596080000,15901,5300,10601,5300,0,1,5302,22292533,22.292533
6100,3700,5300,22570000,2,42406,10603,1,596080000,596080000,15901,5300,10601,5300,0,1,5302,23269129,23.269129
6100,3700,5300,22570000,2,42406,10603,1,596080000,596080000,15901,5300,10601,5300,0,1,5302,22119058,22.119058
6100,3700,5300,22570000,2,42406,10603,1,596080000,596080000,15901,5300,10601,5300,0,1,5302,23452792,23.452792
6100,3700,5700,22570000,2,45606,11403,1,627440000,627440000,17101,5700,11401,5700,0,1,5702,24067676,24.067676
6100,3700,5700,22570000,2,45606,11403,1,627440000,627440000,17101,5700,11401,5700,0,1,5702,24928322,24.928322
6100,3700,5700,22570000,2,45606,11403,1,627440000,627440000,17101,5700,11401,5700,0,1,5702,24200265,24.200265
6100,3700,5700,22570000,2,45606,11403,1,627440000,627440000,17101,5700,11401,5700,0,1,5702,24733638,24.733638
6100,3700,5700,22570000,2,45606,11403,1,627440000,627440000,17101,5700,11401,5700,0,1,5702,23918679,23.918679
6100,3700,5700,22570000,2,45606,11403,1,627440000,627440000,17101,5700,11401,5700,0,1,5702,24944678,24.944678
6100,3700,5700,22570000,2,45606,11403,1,627440000,627440000,17101,5700,11401,5700,0,1,5702,23833973,23.833973
6100,3700,5700,22570000,2,45606,11403,1,627440000,627440000,17101,5700,11401,5700,0,1,5702,25225691,25.225691
6100,3700,6100,22570000,2,48806,12203,1,658800000,658800000,18301,6100,12201,6100,0,1,6102,25728991,25.728991
6100,3700,6100,22570000,2,48806,12203,1,658800000,658800000,18301,6100,12201,6100,0,1,6102,26704159,26.704159
6100,3700,6100,22570000,2,48806,12203,1,658800000,658800000,18301,6100,12201,6100,0,1,6102,25889617,25.889617
6100,3700,6100,22570000,2,48806,12203,1,658800000,658800000,18301,6100,12201,6100,0,1,6102,26465497,26.465497
6100,3700,6100,22570000,2,48806,12203,1,658800000,658800000,18301,6100,12201,6100,0,1,6102,25570405,25.570405
6100,3700,6100,22570000,2,48806,12203,1,658800000,658800000,18301,6100,12201,6100,0,1,6102,26739480,26.73948
6100,3700,6100,22570000,2,48806,12203,1,658800000,658800000,18301,6100,12201,6100,0,1,6102,25498384,25.498384
6100,3700,6100,22570000,2,48806,12203,1,658800000,658800000,18301,6100,12201,6100,0,1,6102,26968204,26.968204
6100,3700,6500,22570000,2,52006,13003,1,690160000,690160000,19501,6500,13001,6500,0,1,6502,27424035,27.424035
6100,3700,6500,22570000,2,52006,13003,1,690160000,690160000,19501,6500,13001,6500,0,1,6502,28457703,28.457703
6100,3700,6500,22570000,2,52006,13003,1,690160000,690160000,19501,6500,13001,6500,0,1,6502,27576445,27.576445
6100,3700,6500,22570000,2,52006,13003,1,690160000,690160000,19501,6500,13001,6500,0,1,6502,28147078,28.147078
6100,3700,6500,22570000,2,52006,13003,1,690160000,690160000,19501,6500,13001,6500,0,1,6502,27226004,27.226004
6100,3700,6500,22570000,2,52006,13003,1,690160000,690160000,19501,6500,13001,6500,0,1,6502,28476472,28.476472
6100,3700,6500,22570000,2,52006,13003,1,690160000,690160000,19501,6500,13001,6500,0,1,6502,27120892,27.120892
6100,3700,6500,22570000,2,52006,13003,1,690160000,690160000,19501,6500,13001,6500,0,1,6502,28760145,28.760145
6100,3700,6900,22570000,2,55206,13803,1,721520000,721520000,20701,6900,13801,6900,0,1,6902,29125229,29.125229
6100,3700,6900,22570000,2,55206,13803,1,721520000,721520000,20701,6900,13801,6900,0,1,6902,30249692,30.249692
6100,3700,6900,22570000,2,55206,13803,1,721520000,721520000,20701,6900,13801,6900,0,1,6902,29327239,29.327239
6100,3700,6900,22570000,2,55206,13803,1,721520000,721520000,20701,6900,13801,6900,0,1,6902,29884828,29.884828
6100,3700,6900,22570000,2,55206,13803,1,721520000,721520000,20701,6900,13801,6900,0,1,6902,28917258,28.917258
6100,3700,6900,22570000,2,55206,13803,1,721520000,721520000,20701,6900,13801,6900,0,1,6902,30270603,30.270603
6100,3700,6900,22570000,2,55206,13803,1,721520000,721520000,20701,6900,13801,6900,0,1,6902,28879219,28.879219
6100,3700,6900,22570000,2,55206,13803,1,721520000,721520000,20701,6900,13801,6900,0,1,6902,30616750,30.61675
6100,3300,500,20130000,2,4006,1003,1,198640000,198640000,1501,500,1001,500,0,1,502,2194699,2.194699
6100,3300,500,20130000,2,4006,1003,1,198640000,198640000,1501,500,1001,500,0,1,502,2116878,2.116878
6100,3300,500,20130000,2,4006,1003,1,198640000,198640000,1501,500,1001,500,0,1,502,2208958,2.208958
6100,3300,500,20130000,2,4006,1003,1,198640000,198640000,1501,500,1001,500,0,1,502,2168865,2.168865
6100,3300,500,20130000,2,4006,1003,1,198640000,198640000,1501,500,1001,500,0,1,502,2072054,2.072054
6100,3300,500,20130000,2,4006,1003,1,198640000,198640000,1501,500,1001,500,0,1,502,2131451,2.131451
6100,3300,500,20130000,2,4006,1003,1,198640000,198640000,1501,500,1001,500,0,1,502,2154215,2.154215
6100,3300,500,20130000,2,4006,1003,1,198640000,198640000,1501,500,1001,500,0,1,502,2116311,2.116311
6100,3300,900,20130000,2,7206,1803,1,228720000,228720000,2701,900,1801,900,0,1,902,3510766,3.510766
6100,3300,900,20130000,2,7206,1803,1,228720000,228720000,2701,900,1801,900,0,1,902,3755606,3.755606
6100,3300,900,20130000,2,7206,1803,1,228720000,228720000,2701,900,1801,900,0,1,902,3557866,3.557866
6100,3300,900,20130000,2,7206,1803,1,228720000,228720000,2701,900,1801,900,0,1,902,3636220,3.63622
6100,3300,900,20130000,2,7206,1803,1,228720000,228720000,2701,900,1801,900,0,1,902,3492852,3.492852
6100,3300,900,20130000,2,7206,1803,1,228720000,228720000,2701,900,1801,900,0,1,902,3770181,3.770181
6100,3300,900,20130000,2,7206,1803,1,228720000,228720000,2701,900,1801,900,0,1,902,3479096,3.479096
6100,3300,900,20130000,2,7206,1803,1,228720000,228720000,2701,900,1801,900,0,1,902,3784681,3.784681
6100,3300,1300,20130000,2,10406,2603,1,258800000,258800000,3901,1300,2601,1300,0,1,1302,4993435,4.993435
6100,3300,1300,20130000,2,10406,2603,1,258800000,258800000,3901,1300,2601,1300,0,1,1302,5188141,5.188141
6100,3300,1300,20130000,2,10406,2603,1,258800000,258800000,3901,1300,2601,1300,0,1,1302,5036177,5.036177
6100,3300,1300,20130000,2,10406,2603,1,258800000,258800000,3901,1300,2601,1300,0,1,1302,5173480,5.17348
6100,3300,1300,20130000,2,10406,2603,1,258800000,258800000,3901,1300,2601,1300,0,1,1302,4969071,4.969071
6100,3300,1300,20130000,2,10406,2603,1,258800000,258800000,3901,1300,2601,1300,0,1,1302,5211123,5.211123
6100,3300,1300,20130000,2,10406,2603,1,258800000,258800000,3901,1300,2601,1300,0,1,1302,4942111,4.942111
6100,3300,1300,20130000,2,10406,2603,1,258800000,258800000,3901,1300,2601,1300,0,1,1302,5228995,5.228995
6100,3300,1700,20130000,2,13606,3403,1,288880000,288880000,5101,1700,3401,1700,0,1,1702,6465126,6.465126
6100,3300,1700,20130000,2,13606,3403,1,288880000,288880000,5101,1700,3401,1700,0,1,1702,6706640,6.70664
6100,3300,1700,20130000,2,13606,3403,1,288880000,288880000,5101,1700,3401,1700,0,1,1702,6534074,6.534074
6100,3300,1700,20130000,2,13606,3403,1,288880000,288880000,5101,1700,3401,1700,0,1,1702,6644192,6.644192
6100,3300,1700,20130000,2,13606,3403,1,288880000,288880000,5101,1700,3401,1700,0,1,1702,6436354,6.436354
6100,3300,1700,20130000,2,13606,3403,1,288880000,288880000,5101,1700,3401,1700,0,1,1702,6742134,6.742134
6100,3300,1700,20130000,2,13606,3403,1,288880000,288880000,5101,1700,3401,1700,0,1,1702,6401606,6.401606
6100,3300,1700,20130000,2,13606,3403,1,288880000,288880000,5101,1700,3401,1700,0,1,1702,6777956,6.777956
6100,3300,2100,20130000,2,16806,4203,1,318960000,318960000,6301,2100,4201,2100,0,1,2102,8107459,8.107459
6100,3300,2100,20130000,2,16806,4203,1,318960000,318960000,6301,2100,4201,2100,0,1,2102,8345908,8.345908
6100,3300,2100,20130000,2,16806,4203,1,318960000,318960000,6301,2100,4201,2100,0,1,2102,8172949,8.172949
6100,3300,2100,20130000,2,16806,4203,1,318960000,318960000,6301,2100,4201,2100,0,1,2102,8287717,8.287717
6100,3300,2100,20130000,2,16806,4203,1,318960000,318960000,6301,2100,4201,2100,0,1,2102,8083590,8.08359
6100,3300,2100,20130000,2,16806,4203,1,318960000,318960000,6301,2100,4201,2100,0,1,2102,8387093,8.387093
6100,3300,2100,20130000,2,16806,4203,1,318960000,318960000,6301,2100,4201,2100,0,1,2102,8024306,8.024306
6100,3300,2100,20130000,2,16806,4203,1,318960000,318960000,6301,2100,4201,2100,0,1,2102,8451197,8.451197
6100,3300,2500,20130000,2,20006,5003,1,349040000,349040000,7501,2500,5001,2500,0,1,2502,9432600,9.4326
6100,3300,2500,20130000,2,20006,5003,1,349040000,349040000,7501,2500,5001,2500,0,1,2502,9776816,9.776816
6100,3300,2500,20130000,2,20006,5003,1,349040000,349040000,7501,2500,5001,2500,0,1,2502,9529058,9.529058
6100,3300,2500,20130000,2,20006,5003,1,349040000,349040000,7501,2500,5001,2500,0,1,2502,9695555,9.695555
6100,3300,2500,20130000,2,20006,5003,1,349040000,349040000,7501,2500,5001,2500,0,1,2502,9376017,9.376017
6100,3300,2500,20130000,2,20006,5003,1,349040000,349040000,7501,2500,5001,2500,0,1,2502,9830045,9.830045
6100,3300,2500,20130000,2,20006,5003,1,349040000,349040000,7501,2500,5001,2500,0,1,2502,9323211,9.323211
6100,3300,2500,20130000,2,20006,5003,1,349040000,349040000,7501,2500,5001,2500,0,1,2502,9885206,9.885206
6100,3300,2900,20130000,2,23206,5803,1,379120000,379120000,8701,2900,5801,2900,0,1,2902,11052484,11.052484
6100,3300,2900,20130000,2,23206,5803,1,379120000,379120000,8701,2900,5801,2900,0,1,2902,11405597,11.405597
6100,3300,2900,20130000,2,23206,5803,1,379120000,379120000,8701,2900,5801,2900,0,1,2902,11154024,11.154024
6100,3300,2900,20130000,2,23206,5803,1,379120000,379120000,8701,2900,5801,2900,0,1,2902,11329702,11.329702
6100,3300,2900,20130000,2,23206,5803,1,379120000,379120000,8701,2900,5801,2900,0,1,2902,10997292,10.997292
6100,3300,2900,20130000,2,23206,5803,1,379120000,379120000,8701,2900,5801,2900,0,1,2902,11513369,11.513369
6100,3300,2900,20130000,2,23206,5803,1,379120000,379120000,8701,2900,5801,2900,0,1,2902,10961391,10.961391
6100,3300,2900,20130000,2,23206,5803,1,379120000,379120000,8701,2900,5801,2900,0,1,2902,11564689,11.564689
6100,3300,3300,20130000,2,26406,6603,1,409200000,409200000,9901,3300,6601,3300,0,1,3302,12537448,12.537448
6100,3300,3300,20130000,2,26406,6603,1,409200000,409200000,9901,3300,6601,3300,0,1,3302,13002032,13.002032
6100,3300,3300,20130000,2,26406,6603,1,409200000,409200000,9901,3300,6601,3300,0,1,3302,12634045,12.634045
6100,3300,3300,20130000,2,26406,6603,1,409200000,409200000,9901,3300,6601,3300,0,1,3302,12866163,12.866163
6100,3300,3300,20130000,2,26406,6603,1,409200000,409200000,9901,3300,6601,3300,0,1,3302,12485021,12.485021
6100,3300,3300,20130000,2,26406,6603,1,409200000,409200000,9901,3300,6601,3300,0,1,3302,12919964,12.919964
6100,3300,3300,20130000,2,26406,6603,1,409200000,409200000,9901,3300,6601,3300,0,1,3302,12411023,12.411023
6100,3300,3300,20130000,2,26406,6603,1,409200000,409200000,9901,3300,6601,3300,0,1,3302,13114503,13.114503
6100,3300,3700,20130000,2,29606,7403,1,439280000,439280000,11101,3700,7401,3700,0,1,3702,14076926,14.076926
6100,3300,3700,20130000,2,29606,7403,1,439280000,439280000,11101,3700,7401,3700,0,1,3702,14409253,14.409253
6100,3300,3700,20130000,2,29606,7403,1,439280000,439280000,11101,3700,7401,3700,0,1,3702,14151247,14.151247
6100,3300,3700,20130000,2,29606,7403,1,439280000,439280000,11101,3700,7401,3700,0,1,3702,14433554,14.433554
6100,3300,3700,20130000,2,29606,7403,1,439280000,439280000,11101,3700,7401,3700,0,1,3702,13970346,13.970346
6100,3300,3700,20130000,2,29606,7403,1,439280000,439280000,11101,3700,7401,3700,0,1,3702,14538938,14.538938
6100,3300,3700,20130000,2,29606,7403,1,439280000,439280000,11101,3700,7401,3700,0,1,3702,13944987,13.944987
6100,3300,3700,20130000,2,29606,7403,1,439280000,439280000,11101,3700,7401,3700,0,1,3702,14570108,14.570108
6100,3300,4100,20130000,2,32806,8203,1,469360000,469360000,12301,4100,8201,4100,0,1,4102,15534620,15.53462
6100,3300,4100,20130000,2,32806,8203,1,469360000,469360000,12301,4100,8201,4100,0,1,4102,16047316,16.047316
6100,3300,4100,20130000,2,32806,8203,1,469360000,469360000,12301,4100,8201,4100,0,1,4102,15633468,15.633468
6100,3300,4100,20130000,2,32806,8203,1,469360000,469360000,12301,4100,8201,4100,0,1,4102,15894158,15.894158
6100,3300,4100,20130000,2,32806,8203,1,469360000,469360000,12301,4100,8201,4100,0,1,4102,15434782,15.434782
6100,3300,4100,20130000,2,32806,8203,1,469360000,469360000,12301,4100,8201,4100,0,1,4102,16071488,16.071488
6100,3300,4100,20130000,2,32806,8203,1,469360000,469360000,12301,4100,8201,4100,0,1,4102,15359382,15.359382
6100,3300,4100,20130000,2,32806,8203,1,469360000,469360000,12301,4100,8201,4100,0,1,4102,16258703,16.258703
6100,3300,4500,20130000,2,36006,9003,1,499440000,499440000,13501,4500,9001,4500,0,1,4502,16993054,16.993054
6100,3300,4500,20130000,2,36006,9003,1,499440000,499440000,13501,4500,9001,4500,0,1,4502,17582693,17.582693
6100,3300,4500,20130000,2,36006,9003,1,499440000,499440000,13501,4500,9001,4500,0,1,4502,17152234,17.152234
6100,3300,4500,20130000,2,36006,9003,1,499440000,499440000,13501,4500,9001,4500,0,1,4502,17409208,17.409208
6100,3300,4500,20130000,2,36006,9003,1,499440000,499440000,13501,4500,9001,4500,0,1,4502,16917367,16.917367
6100,3300,4500,20130000,2,36006,9003,1,499440000,499440000,13501,4500,9001,4500,0,1,4502,17608228,17.608228
6100,3300,4500,20130000,2,36006,9003,1,499440000,499440000,13501,4500,9001,4500,0,1,4502,16812215,16.812215
6100,3300,4500,20130000,2,36006,9003,1,499440000,499440000,13501,4500,9001,4500,0,1,4502,17804815,17.804815
6100,3300,4900,20130000,2,39206,9803,1,529520000,529520000,14701,4900,9801,4900,0,1,4902,18480528,18.480528
6100,3300,4900,20130000,2,39206,9803,1,529520000,529520000,14701,4900,9801,4900,0,1,4902,19139022,19.139022
6100,3300,4900,20130000,2,39206,9803,1,529520000,529520000,14701,4900,9801,4900,0,1,4902,18611059,18.611059
6100,3300,4900,20130000,2,39206,9803,1,529520000,529520000,14701,4900,9801,4900,0,1,4902,18963605,18.963605
6100,3300,4900,20130000,2,39206,9803,1,529520000,529520000,14701,4900,9801,4900,0,1,4902,18399801,18.399801
6100,3300,4900,20130000,2,39206,9803,1,529520000,529520000,14701,4900,9801,4900,0,1,4902,19176912,19.176912
6100,3300,4900,20130000,2,39206,9803,1,529520000,529520000,14701,4900,9801,4900,0,1,4902,18302627,18.302627
6100,3300,4900,20130000,2,39206,9803,1,529520000,529520000,14701,4900,9801,4900,0,1,4902,19318568,19.318568
6100,3300,5300,20130000,2,42406,10603,1,559600000,559600000,15901,5300,10601,5300,0,1,5302,19983693,19.983693
6100,3300,5300,20130000,2,42406,10603,1,559600000,559600000,15901,5300,10601,5300,0,1,5302,20689629,20.689629
6100,3300,5300,20130000,2,42406,10603,1,559600000,559600000,15901,5300,10601,5300,0,1,5302,20130742,20.130742
6100,3300,5300,20130000,2,42406,10603,1,559600000,559600000,15901,5300,10601,5300,0,1,5302,20495912,20.495912
6100,3300,5300,20130000,2,42406,10603,1,559600000,559600000,15901,5300,10601,5300,0,1,5302,19873614,19.873614
6100,3300,5300,20130000,2,42406,10603,1,559600000,559600000,15901,5300,10601,5300,0,1,5302,20729086,20.729086
6100,3300,5300,20130000,2,42406,10603,1,559600000,559600000,15901,5300,10601,5300,0,1,5302,19845774,19.845774
6100,3300,5300,20130000,2,42406,10603,1,559600000,559600000,15901,5300,10601,5300,0,1,5302,20875854,20.875854
6100,3300,5700,20130000,2,45606,11403,1,589680000,589680000,17101,5700,11401,5700,0,1,5702,21472986,21.472986
6100,3300,5700,20130000,2,45606,11403,1,589680000,589680000,17101,5700,11401,5700,0,1,5702,22271093,22.271093
6100,3300,5700,20130000,2,45606,11403,1,589680000,589680000,17101,5700,11401,5700,0,1,5702,21572626,21.572626
6100,3300,5700,20130000,2,45606,11403,1,589680000,589680000,17101,5700,11401,5700,0,1,5702,22024497,22.024497
6100,3300,5700,20130000,2,45606,11403,1,589680000,589680000,17101,5700,11401,5700,0,1,5702,21349195,21.349195
6100,3300,5700,20130000,2,45606,11403,1,589680000,589680000,17101,5700,11401,5700,0,1,5702,22322884,22.322884
6100,3300,5700,20130000,2,45606,11403,1,589680000,589680000,17101,5700,11401,5700,0,1,5702,21267478,21.267478
6100,3300,5700,20130000,2,45606,11403,1,589680000,589680000,17101,5700,11401,5700,0,1,5702,22508834,22.508834
6100,3300,6100,20130000,2,48806,12203,1,619760000,619760000,18301,6100,12201,6100,0,1,6102,22975319,22.975319
6100,3300,6100,20130000,2,48806,12203,1,619760000,619760000,18301,6100,12201,6100,0,1,6102,23816318,23.816318
6100,3300,6100,20130000,2,48806,12203,1,619760000,619760000,18301,6100,12201,6100,0,1,6102,23106765,23.106765
6100,3300,6100,20130000,2,48806,12203,1,619760000,619760000,18301,6100,12201,6100,0,1,6102,23631564,23.631564
6100,3300,6100,20130000,2,48806,12203,1,619760000,619760000,18301,6100,12201,6100,0,1,6102,22881150,22.88115
6100,3300,6100,20130000,2,48806,12203,1,619760000,619760000,18301,6100,12201,6100,0,1,6102,23855995,23.855995
6100,3300,6100,20130000,2,48806,12203,1,619760000,619760000,18301,6100,12201,6100,0,1,6102,22774569,22.774569
6100,3300,6100,20130000,2,48806,12203,1,619760000,619760000,18301,6100,12201,6100,0,1,6102,24041579,24.041579
6100,3300,6500,20130000,2,52006,13003,1,649840000,649840000,19501,6500,13001,6500,0,1,6502,24488160,24.48816
6100,3300,6500,20130000,2,52006,13003,1,649840000,649840000,19501,6500,13001,6500,0,1,6502,25375478,25.375478
6100,3300,6500,20130000,2,52006,13003,1,649840000,649840000,19501,6500,13001,6500,0,1,6502,24573671,24.573671
6100,3300,6500,20130000,2,52006,13003,1,649840000,649840000,19501,6500,13001,6500,0,1,6502,25153417,25.153417
6100,3300,6500,20130000,2,52006,13003,1,649840000,649840000,19501,6500,13001,6500,0,1,6502,24331254,24.331254
6100,3300,6500,20130000,2,52006,13003,1,649840000,649840000,19501,6500,13001,6500,0,1,6502,25412070,25.41207
6100,3300,6500,20130000,2,52006,13003,1,649840000,649840000,19501,6500,13001,6500,0,1,6502,24224034,24.224034
6100,3300,6500,20130000,2,52006,13003,1,649840000,649840000,19501,6500,13001,6500,0,1,6502,25646009,25.646009
6100,3300,6900,20130000,2,55206,13803,1,679920000,679920000,20701,6900,13801,6900,0,1,6902,26004217,26.004217
6100,3300,6900,20130000,2,55206,13803,1,679920000,679920000,20701,6900,13801,6900,0,1,6902,26854541,26.854541
6100,3300,6900,20130000,2,55206,13803,1,679920000,679920000,20701,6900,13801,6900,0,1,6902,26102137,26.102137
6100,3300,6900,20130000,2,55206,13803,1,679920000,679920000,20701,6900,13801,6900,0,1,6902,26610598,26.610598
6100,3300,6900,20130000,2,55206,13803,1,679920000,679920000,20701,6900,13801,6900,0,1,6902,25865916,25.865916
6100,3300,6900,20130000,2,55206,13803,1,679920000,679920000,20701,6900,13801,6900,0,1,6902,26973778,26.973778
6100,3300,6900,20130000,2,55206,13803,1,679920000,679920000,20701,6900,13801,6900,0,1,6902,25733022,25.733022
6100,3300,6900,20130000,2,55206,13803,1,679920000,679920000,20701,6900,13801,6900,0,1,6902,27225375,27.225375
6100,2900,500,17690000,2,4006,1003,1,177520000,177520000,1501,500,1001,500,0,1,502,1983424,1.983424
6100,2900,500,17690000,2,4006,1003,1,177520000,177520000,1501,500,1001,500,0,1,502,1853920,1.85392
6100,2900,500,17690000,2,4006,1003,1,177520000,177520000,1501,500,1001,500,0,1,502,1969835,1.969835
6100,2900,500,17690000,2,4006,1003,1,177520000,177520000,1501,500,1001,500,0,1,502,1837556,1.837556
6100,2900,500,17690000,2,4006,1003,1,177520000,177520000,1501,500,1001,500,0,1,502,1982988,1.982988
6100,2900,500,17690000,2,4006,1003,1,177520000,177520000,1501,500,1001,500,0,1,502,1853366,1.853366
6100,2900,500,17690000,2,4006,1003,1,177520000,177520000,1501,500,1001,500,0,1,502,1957151,1.957151
6100,2900,500,17690000,2,4006,1003,1,177520000,177520000,1501,500,1001,500,0,1,502,1866610,1.86661
6100,2900,900,17690000,2,7206,1803,1,206320000,206320000,2701,900,1801,900,0,1,902,3099150,3.09915
6100,2900,900,17690000,2,7206,1803,1,206320000,206320000,2701,900,1801,900,0,1,902,3353657,3.353657
6100,2900,900,17690000,2,7206,1803,1,206320000,206320000,2701,900,1801,900,0,1,902,3111588,3.111588
6100,2900,900,17690000,2,7206,1803,1,206320000,206320000,2701,900,1801,900,0,1,902,3327356,3.327356
6100,2900,900,17690000,2,7206,1803,1,206320000,206320000,2701,900,1801,900,0,1,902,3077465,3.077465
6100,2900,900,17690000,2,7206,1803,1,206320000,206320000,2701,900,1801,900,0,1,902,3368577,3.368577
6100,2900,900,17690000,2,7206,1803,1,206320000,206320000,2701,900,1801,900,0,1,902,3054005,3.054005
6100,2900,900,17690000,2,7206,1803,1,206320000,206320000,2701,900,1801,900,0,1,902,3340214,3.340214
6100,2900,1300,17690000,2,10406,2603,1,235120000,235120000,3901,1300,2601,1300,0,1,1302,4420694,4.420694
6100,2900,1300,17690000,2,10406,2603,1,235120000,235120000,3901,1300,2601,1300,0,1,1302,4584043,4.584043
6100,2900,1300,17690000,2,10406,2603,1,235120000,235120000,3901,1300,2601,1300,0,1,1302,4433001,4.433001
6100,2900,1300,17690000,2,10406,2603,1,235120000,235120000,3901,1300,2601,1300,0,1,1302,4533162,4.533162
6100,2900,1300,17690000,2,10406,2603,1,235120000,235120000,3901,1300,2601,1300,0,1,1302,4374274,4.374274
6100,2900,1300,17690000,2,10406,2603,1,235120000,235120000,3901,1300,2601,1300,0,1,1302,4568185,4.568185
6100,2900,1300,17690000,2,10406,2603,1,235120000,235120000,3901,1300,2601,1300,0,1,1302,4356995,4.356995
6100,2900,1300,17690000,2,10406,2603,1,235120000,235120000,3901,1300,2601,1300,0,1,1302,4611113,4.611113
6100,2900,1700,17690000,2,13606,3403,1,263920000,263920000,5101,1700,3401,1700,0,1,1702,5688286,5.688286
6100,2900,1700,17690000,2,13606,3403,1,263920000,263920000,5101,1700,3401,1700,0,1,1702,5931799,5.931799
6100,2900,1700,17690000,2,13606,3403,1,263920000,263920000,5101,1700,3401,1700,0,1,1702,5745553,5.745553
6100,2900,1700,17690000,2,13606,3403,1,263920000,263920000,5101,1700,3401,1700,0,1,1702,5861678,5.861678
6100,2900,1700,17690000,2,13606,3403,1,263920000,263920000,5101,1700,3401,1700,0,1,1702,5657823,5.657823
6100,2900,1700,17690000,2,13606,3403,1,263920000,263920000,5101,1700,3401,1700,0,1,1702,5915398,5.915398
6100,2900,1700,17690000,2,13606,3403,1,263920000,263920000,5101,1700,3401,1700,0,1,1702,5640754,5.640754
6100,2900,1700,17690000,2,13606,3403,1,263920000,263920000,5101,1700,3401,1700,0,1,1702,5974316,5.974316
6100,2900,2100,17690000,2,16806,4203,1,292720000,292720000,6301,2100,4201,2100,0,1,2102,6991602,6.991602
6100,2900,2100,17690000,2,16806,4203,1,292720000,292720000,6301,2100,4201,2100,0,1,2102,7290431,7.290431
6100,2900,2100,17690000,2,16806,4203,1,292720000,292720000,6301,2100,4201,2100,0,1,2102,7065880,7.06588
6100,2900,2100,17690000,2,16806,4203,1,292720000,292720000,6301,2100,4201,2100,0,1,2102,7173001,7.173001
6100,2900,2100,17690000,2,16806,4203,1,292720000,292720000,6301,2100,4201,2100,0,1,2102,6959344,6.959344
6100,2900,2100,17690000,2,16806,4203,1,292720000,292720000,6301,2100,4201,2100,0,1,2102,7273170,7.27317
6100,2900,2100,17690000,2,16806,4203,1,292720000,292720000,6301,2100,4201,2100,0,1,2102,6922693,6.922693
6100,2900,2100,17690000,2,16806,4203,1,292720000,292720000,6301,2100,4201,2100,0,1,2102,7341593,7.341593
6100,2900,2500,17690000,2,20006,5003,1,321520000,321520000,7501,2500,5001,2500,0,1,2502,8429989,8.429989
6100,2900,2500,17690000,2,20006,5003,1,321520000,321520000,7501,2500,5001,2500,0,1,2502,8781988,8.781988
6100,2900,2500,17690000,2,20006,5003,1,321520000,321520000,7501,2500,5001,2500,0,1,2502,8536077,8.536077
6100,2900,2500,17690000,2,20006,5003,1,321520000,321520000,7501,2500,5001,2500,0,1,2502,8646821,8.646821
6100,2900,2500,17690000,2,20006,5003,1,321520000,321520000,7501,2500,5001,2500,0,1,2502,8417773,8.417773
6100,2900,2500,17690000,2,20006,5003,1,321520000,321520000,7501,2500,5001,2500,0,1,2502,8769059,8.769059
6100,2900,2500,17690000,2,20006,5003,1,321520000,321520000,7501,2500,5001,2500,0,1,2502,8405598,8.405598
6100,2900,2500,17690000,2,20006,5003,1,321520000,321520000,7501,2500,5001,2500,0,1,2502,8813540,8.81354
6100,2900,2900,17690000,2,23206,5803,1,350320000,350320000,8701,2900,5801,2900,0,1,2902,9596317,9.596317
6100,2900,2900,17690000,2,23206,5803,1,350320000,350320000,8701,2900,5801,2900,0,1,2902,10002037,10.002037
6100,2900,2900,17690000,2,23206,5803,1,350320000,350320000,8701,2900,5801,2900,0,1,2902,9688086,9.688086
6100,2900,2900,17690000,2,23206,5803,1,350320000,350320000,8701,2900,5801,2900,0,1,2902,9862779,9.862779
6100,2900,2900,17690000,2,23206,5803,1,350320000,350320000,8701,2900,5801,2900,0,1,2902,9552802,9.552802
6100,2900,2900,17690000,2,23206,5803,1,350320000,350320000,8701,2900,5801,2900,0,1,2902,9988949,9.988949
6100,2900,2900,17690000,2,23206,5803,1,350320000,350320000,8701,2900,5801,2900,0,1,2902,9506554,9.506554
6100,2900,2900,17690000,2,23206,5803,1,350320000,350320000,8701,2900,5801,2900,0,1,2902,10078559,10.078559
6100,2900,3300,17690000,2,26406,6603,1,379120000,379120000,9901,3300,6601,3300,0,1,3302,11034078,11.034078
6100,2900,3300,17690000,2,26406,6603,1,379120000,379120000,9901,3300,6601,3300,0,1,3302,11473428,11.473428
6100,2900,3300,17690000,2,26406,6603,1,379120000,379120000,9901,3300,6601,3300,0,1,3302,11160912,11.160912
6100,2900,3300,17690000,2,26406,6603,1,379120000,379120000,9901,3300,6601,3300,0,1,3302,11315822,11.315822
6100,2900,3300,17690000,2,26406,6603,1,379120000,379120000,9901,3300,6601,3300,0,1,3302,10994617,10.994617
6100,2900,3300,17690000,2,26406,6603,1,379120000,379120000,9901,3300,6601,3300,0,1,3302,11485604,11.485604
6100,2900,3300,17690000,2,26406,6603,1,379120000,379120000,9901,3300,6601,3300,0,1,3302,10982434,10.982434
6100,2900,3300,17690000,2,26406,6603,1,379120000,379120000,9901,3300,6601,3300,0,1,3302,11547255,11.547255
6100,2900,3700,17690000,2,29606,7403,1,407920000,407920000,11101,3700,7401,3700,0,1,3702,12331558,12.331558
6100,2900,3700,17690000,2,29606,7403,1,407920000,407920000,11101,3700,7401,3700,0,1,3702,12846704,12.846704
6100,2900,3700,17690000,2,29606,7403,1,407920000,407920000,11101,3700,7401,3700,0,1,3702,12486234,12.486234
6100,2900,3700,17690000,2,29606,7403,1,407920000,407920000,11101,3700,7401,3700,0,1,3702,12690119,12.690119
6100,2900,3700,17690000,2,29606,7403,1,407920000,407920000,11101,3700,7401,3700,0,1,3702,12288488,12.288488
6100,2900,3700,17690000,2,29606,7403,1,407920000,407920000,11101,3700,7401,3700,0,1,3702,12833742,12.833742
6100,2900,3700,17690000,2,29606,7403,1,407920000,407920000,11101,3700,7401,3700,0,1,3702,12267585,12.267585
6100,2900,3700,17690000,2,29606,7403,1,407920000,407920000,11101,3700,7401,3700,0,1,3702,12923896,12.923896
6100,2900,4100,17690000,2,32806,8203,1,436720000,436720000,12301,4100,8201,4100,0,1,4102,13632292,13.632292
6100,2900,4100,17690000,2,32806,8203,1,436720000,436720000,12301,4100,8201,4100,0,1,4102,14166643,14.166643
6100,2900,4100,17690000,2,32806,8203,1,436720000,436720000,12301,4100,8201,4100,0,1,4102,13784607,13.784607
6100,2900,4100,17690000,2,32806,8203,1,436720000,436720000,12301,4100,8201,4100,0,1,4102,14003670,14.00367
6100,2900,4100,17690000,2,32806,8203,1,436720000,436720000,12301,4100,8201,4100,0,1,4102,13619796,13.619796
6100,2900,4100,17690000,2,32806,8203,1,436720000,436720000,12301,4100,8201,4100,0,1,4102,14204181,14.204181
6100,2900,4100,17690000,2,32806,8203,1,436720000,436720000,12301,4100,8201,4100,0,1,4102,13555408,13.555408
6100,2900,4100,17690000,2,32806,8203,1,436720000,436720000,12301,4100,8201,4100,0,1,4102,14281640,14.28164
6100,2900,4500,17690000,2,36006,9003,1,465520000,465520000,13501,4500,9001,4500,0,1,4502,14980472,14.980472
6100,2900,4500,17690000,2,36006,9003,1,465520000,465520000,13501,4500,9001,4500,0,1,4502,15535452,15.535452
6100,2900,4500,17690000,2,36006,9003,1,465520000,465520000,13501,4500,9001,4500,0,1,4502,15083618,15.083618
6100,2900,4500,17690000,2,36006,9003,1,465520000,465520000,13501,4500,9001,4500,0,1,4502,15347616,15.347616
6100,2900,4500,17690000,2,36006,9003,1,465520000,465520000,13501,4500,9001,4500,0,1,4502,14899496,14.899496
6100,2900,4500,17690000,2,36006,9003,1,465520000,465520000,13501,4500,9001,4500,0,1,4502,15522544,15.522544
6100,2900,4500,17690000,2,36006,9003,1,465520000,465520000,13501,4500,9001,4500,0,1,4502,14837263,14.837263
6100,2900,4500,17690000,2,36006,9003,1,465520000,465520000,13501,4500,9001,4500,0,1,4502,15704685,15.704685
6100,2900,4900,17690000,2,39206,9803,1,494320000,494320000,14701,4900,9801,4900,0,1,4902,16300649,16.300649
6100,2900,4900,17690000,2,39206,9803,1,494320000,494320000,14701,4900,9801,4900,0,1,4902,16875395,16.875395
6100,2900,4900,17690000,2,39206,9803,1,494320000,494320000,14701,4900,9801,4900,0,1,4902,16383148,16.383148
6100,2900,4900,17690000,2,39206,9803,1,494320000,494320000,14701,4900,9801,4900,0,1,4902,16673333,16.673333
6100,2900,4900,17690000,2,39206,9803,1,494320000,494320000,14701,4900,9801,4900,0,1,4902,16205189,16.205189
6100,2900,4900,17690000,2,39206,9803,1,494320000,494320000,14701,4900,9801,4900,0,1,4902,16888403,16.888403
6100,2900,4900,17690000,2,39206,9803,1,494320000,494320000,14701,4900,9801,4900,0,1,4902,16105234,16.105234
6100,2900,4900,17690000,2,39206,9803,1,494320000,494320000,14701,4900,9801,4900,0,1,4902,17076930,17.07693
6100,2900,5300,17690000,2,42406,10603,1,523120000,523120000,15901,5300,10601,5300,0,1,5302,17568988,17.568988
6100,2900,5300,17690000,2,42406,10603,1,523120000,523120000,15901,5300,10601,5300,0,1,5302,18211521,18.211521
6100,2900,5300,17690000,2,42406,10603,1,523120000,523120000,15901,5300,10601,5300,0,1,5302,17708627,17.708627
6100,2900,5300,17690000,2,42406,10603,1,523120000,523120000,15901,5300,10601,5300,0,1,5302,18000359,18.000359
6100,2900,5300,17690000,2,42406,10603,1,523120000,523120000,15901,5300,10601,5300,0,1,5302,17488775,17.488775
6100,2900,5300,17690000,2,42406,10603,1,523120000,523120000,15901,5300,10601,5300,0,1,5302,18279408,18.279408
6100,2900,5300,17690000,2,42406,10603,1,523120000,523120000,15901,5300,10601,5300,0,1,5302,17436251,17.436251
6100,2900,5300,17690000,2,42406,10603,1,523120000,523120000,15901,5300,10601,5300,0,1,5302,18417288,18.417288
6100,2900,5700,17690000,2,45606,11403,1,551920000,551920000,17101,5700,11401,5700,0,1,5702,18896132,18.896132
6100,2900,5700,17690000,2,45606,11403,1,551920000,551920000,17101,5700,11401,5700,0,1,5702,19588853,19.588853
6100,2900,5700,17690000,2,45606,11403,1,551920000,551920000,17101,5700,11401,5700,0,1,5702,18989595,18.989595
6100,2900,5700,17690000,2,45606,11403,1,551920000,551920000,17101,5700,11401,5700,0,1,5702,19392132,19.392132
6100,2900,5700,17690000,2,45606,11403,1,551920000,551920000,17101,5700,11401,5700,0,1,5702,18805722,18.805722
6100,2900,5700,17690000,2,45606,11403,1,551920000,551920000,17101,5700,11401,5700,0,1,5702,19613488,19.613488
6100,2900,5700,17690000,2,45606,11403,1,551920000,551920000,17101,5700,11401,5700,0,1,5702,18732686,18.732686
6100,2900,5700,17690000,2,45606,11403,1,551920000,551920000,17101,5700,11401,5700,0,1,5702,19805477,19.805477
6100,2900,6100,17690000,2,48806,12203,1,580720000,580720000,18301,6100,12201,6100,0,1,6102,20226357,20.226357
6100,2900,6100,17690000,2,48806,12203,1,580720000,580720000,18301,6100,12201,6100,0,1,6102,20964870,20.96487
6100,2900,6100,17690000,2,48806,12203,1,580720000,580720000,18301,6100,12201,6100,0,1,6102,20322952,20.322952
6100,2900,6100,17690000,2,48806,12203,1,580720000,580720000,18301,6100,12201,6100,0,1,6102,20766805,20.766805
6100,2900,6100,17690000,2,48806,12203,1,580720000,580720000,18301,6100,12201,6100,0,1,6102,20129996,20.129996
6100,2900,6100,17690000,2,48806,12203,1,580720000,580720000,18301,6100,12201,6100,0,1,6102,21007028,21.007028
6100,2900,6100,17690000,2,48806,12203,1,580720000,580720000,18301,6100,12201,6100,0,1,6102,20047012,20.047012
6100,2900,6100,17690000,2,48806,12203,1,580720000,580720000,18301,6100,12201,6100,0,1,6102,21199146,21.199146
6100,2900,6500,17690000,2,52006,13003,1,609520000,609520000,19501,6500,13001,6500,0,1,6502,21528315,21.528315
6100,2900,6500,17690000,2,52006,13003,1,609520000,609520000,19501,6500,13001,6500,0,1,6502,22344535,22.344535
6100,2900,6500,17690000,2,52006,13003,1,609520000,609520000,19501,6500,13001,6500,0,1,6502,21634044,21.634044
6100,2900,6500,17690000,2,52006,13003,1,609520000,609520000,19501,6500,13001,6500,0,1,6502,22074973,22.074973
6100,2900,6500,17690000,2,52006,13003,1,609520000,609520000,19501,6500,13001,6500,0,1,6502,21419929,21.419929
6100,2900,6500,17690000,2,52006,13003,1,609520000,609520000,19501,6500,13001,6500,0,1,6502,22369538,22.369538
6100,2900,6500,17690000,2,52006,13003,1,609520000,609520000,19501,6500,13001,6500,0,1,6502,21350609,21.350609
6100,2900,6500,17690000,2,52006,13003,1,609520000,609520000,19501,6500,13001,6500,0,1,6502,22521248,22.521248
6100,2900,6900,17690000,2,55206,13803,1,638320000,638320000,20701,6900,13801,6900,0,1,6902,22813915,22.813915
6100,2900,6900,17690000,2,55206,13803,1,638320000,638320000,20701,6900,13801,6900,0,1,6902,23658694,23.658694
6100,2900,6900,17690000,2,55206,13803,1,638320000,638320000,20701,6900,13801,6900,0,1,6902,23025495,23.025495
6100,2900,6900,17690000,2,55206,13803,1,638320000,638320000,20701,6900,13801,6900,0,1,6902,23449607,23.449607
6100,2900,6900,17690000,2,55206,13803,1,638320000,638320000,20701,6900,13801,6900,0,1,6902,22701522,22.701522
6100,2900,6900,17690000,2,55206,13803,1,638320000,638320000,20701,6900,13801,6900,0,1,6902,23766586,23.766586
6100,2900,6900,17690000,2,55206,13803,1,638320000,638320000,20701,6900,13801,6900,0,1,6902,22646021,22.646021
6100,2900,6900,17690000,2,55206,13803,1,638320000,638320000,20701,6900,13801,6900,0,1,6902,23931880,23.93188
6100,2500,500,15250000,2,4006,1003,1,156400000,156400000,1501,500,1001,500,0,1,502,1680458,1.680458
6100,2500,500,15250000,2,4006,1003,1,156400000,156400000,1501,500,1001,500,0,1,502,1603681,1.603681
6100,2500,500,15250000,2,4006,1003,1,156400000,156400000,1501,500,1001,500,0,1,502,1580960,1.58096
6100,2500,500,15250000,2,4006,1003,1,156400000,156400000,1501,500,1001,500,0,1,502,1592276,1.592276
6100,2500,500,15250000,2,4006,1003,1,156400000,156400000,1501,500,1001,500,0,1,502,1706746,1.706746
6100,2500,500,15250000,2,4006,1003,1,156400000,156400000,1501,500,1001,500,0,1,502,1604126,1.604126
6100,2500,500,15250000,2,4006,1003,1,156400000,156400000,1501,500,1001,500,0,1,502,1724283,1.724283
6100,2500,500,15250000,2,4006,1003,1,156400000,156400000,1501,500,1001,500,0,1,502,1615123,1.615123
6100,2500,900,15250000,2,7206,1803,1,183920000,183920000,2701,900,1801,900,0,1,902,2652600,2.6526
6100,2500,900,15250000,2,7206,1803,1,183920000,183920000,2701,900,1801,900,0,1,902,2871150,2.87115
6100,2500,900,15250000,2,7206,1803,1,183920000,183920000,2701,900,1801,900,0,1,902,2829364,2.829364
6100,2500,900,15250000,2,7206,1803,1,183920000,183920000,2701,900,1801,900,0,1,902,2851905,2.851905
6100,2500,900,15250000,2,7206,1803,1,183920000,183920000,2701,900,1801,900,0,1,902,2663099,2.663099
6100,2500,900,15250000,2,7206,1803,1,183920000,183920000,2701,900,1801,900,0,1,902,2882345,2.882345
6100,2500,900,15250000,2,7206,1803,1,183920000,183920000,2701,900,1801,900,0,1,902,2634424,2.634424
6100,2500,900,15250000,2,7206,1803,1,183920000,183920000,2701,900,1801,900,0,1,902,2917335,2.917335
6100,2500,1300,15250000,2,10406,2603,1,211440000,211440000,3901,1300,2601,1300,0,1,1302,3774015,3.774015
6100,2500,1300,15250000,2,10406,2603,1,211440000,211440000,3901,1300,2601,1300,0,1,1302,3920527,3.920527
6100,2500,1300,15250000,2,10406,2603,1,211440000,211440000,3901,1300,2601,1300,0,1,1302,3842572,3.842572
6100,2500,1300,15250000,2,10406,2603,1,211440000,211440000,3901,1300,2601,1300,0,1,1302,3887432,3.887432
6100,2500,1300,15250000,2,10406,2603,1,211440000,211440000,3901,1300,2601,1300,0,1,1302,3773580,3.77358
6100,2500,1300,15250000,2,10406,2603,1,211440000,211440000,3901,1300,2601,1300,0,1,1302,3932148,3.932148
6100,2500,1300,15250000,2,10406,2603,1,211440000,211440000,3901,1300,2601,1300,0,1,1302,3762652,3.762652
6100,2500,1300,15250000,2,10406,2603,1,211440000,211440000,3901,1300,2601,1300,0,1,1302,3961988,3.961988
6100,2500,1700,15250000,2,13606,3403,1,238960000,238960000,5101,1700,3401,1700,0,1,1702,4912147,4.912147
6100,2500,1700,15250000,2,13606,3403,1,238960000,238960000,5101,1700,3401,1700,0,1,1702,5087931,5.087931
6100,2500,1700,15250000,2,13606,3403,1,238960000,238960000,5101,1700,3401,1700,0,1,1702,4983481,4.983481
6100,2500,1700,15250000,2,13606,3403,1,238960000,238960000,5101,1700,3401,1700,0,1,1702,5044480,5.04448
6100,2500,1700,15250000,2,13606,3403,1,238960000,238960000,5101,1700,3401,1700,0,1,1702,4889413,4.889413
6100,2500,1700,15250000,2,13606,3403,1,238960000,238960000,5101,1700,3401,1700,0,1,1702,5108119,5.108119
6100,2500,1700,15250000,2,13606,3403,1,238960000,238960000,5101,1700,3401,1700,0,1,1702,4878875,4.878875
6100,2500,1700,15250000,2,13606,3403,1,238960000,238960000,5101,1700,3401,1700,0,1,1702,5151929,5.151929
6100,2500,2100,15250000,2,16806,4203,1,266480000,266480000,6301,2100,4201,2100,0,1,2102,6029611,6.029611
6100,2500,2100,15250000,2,16806,4203,1,266480000,266480000,6301,2100,4201,2100,0,1,2102,6245918,6.245918
6100,2500,2100,15250000,2,16806,4203,1,266480000,266480000,6301,2100,4201,2100,0,1,2102,6114323,6.114323
6100,2500,2100,15250000,2,16806,4203,1,266480000,266480000,6301,2100,4201,2100,0,1,2102,6185244,6.185244
6100,2500,2100,15250000,2,16806,4203,1,266480000,266480000,6301,2100,4201,2100,0,1,2102,6002024,6.002024
6100,2500,2100,15250000,2,16806,4203,1,266480000,266480000,6301,2100,4201,2100,0,1,2102,6267874,6.267874
6100,2500,2100,15250000,2,16806,4203,1,266480000,266480000,6301,2100,4201,2100,0,1,2102,5981347,5.981347
6100,2500,2100,15250000,2,16806,4203,1,266480000,266480000,6301,2100,4201,2100,0,1,2102,6327215,6.327215
6100,2500,2500,15250000,2,20006,5003,1,294000000,294000000,7501,2500,5001,2500,0,1,2502,7306727,7.306727
6100,2500,2500,15250000,2,20006,5003,1,294000000,294000000,7501,2500,5001,2500,0,1,2502,7535872,7.535872
6100,2500,2500,15250000,2,20006,5003,1,294000000,294000000,7501,2500,5001,2500,0,1,2502,7387754,7.387754
6100,2500,2500,15250000,2,20006,5003,1,294000000,294000000,7501,2500,5001,2500,0,1,2502,7469109,7.469109
6100,2500,2500,15250000,2,20006,5003,1,294000000,294000000,7501,2500,5001,2500,0,1,2502,7307168,7.307168
6100,2500,2500,15250000,2,20006,5003,1,294000000,294000000,7501,2500,5001,2500,0,1,2502,7552800,7.5528
6100,2500,2500,15250000,2,20006,5003,1,294000000,294000000,7501,2500,5001,2500,0,1,2502,7257093,7.257093
6100,2500,2500,15250000,2,20006,5003,1,294000000,294000000,7501,2500,5001,2500,0,1,2502,7639964,7.639964
6100,2500,2900,15250000,2,23206,5803,1,321520000,321520000,8701,2900,5801,2900,0,1,2902,8285413,8.285413
6100,2500,2900,15250000,2,23206,5803,1,321520000,321520000,8701,2900,5801,2900,0,1,2902,8582677,8.582677
6100,2500,2900,15250000,2,23206,5803,1,321520000,321520000,8701,2900,5801,2900,0,1,2902,8381149,8.381149
6100,2500,2900,15250000,2,23206,5803,1,321520000,321520000,8701,2900,5801,2900,0,1,2902,8500518,8.500518
6100,2500,2900,15250000,2,23206,5803,1,321520000,321520000,8701,2900,5801,2900,0,1,2902,8243453,8.243453
6100,2500,2900,15250000,2,23206,5803,1,321520000,321520000,8701,2900,5801,2900,0,1,2902,8617151,8.617151
6100,2500,2900,15250000,2,23206,5803,1,321520000,321520000,8701,2900,5801,2900,0,1,2902,8200473,8.200473
6100,2500,2900,15250000,2,23206,5803,1,321520000,321520000,8701,2900,5801,2900,0,1,2902,8699574,8.699574
6100,2500,3300,15250000,2,26406,6603,1,349040000,349040000,9901,3300,6601,3300,0,1,3302,9517572,9.517572
6100,2500,3300,15250000,2,26406,6603,1,349040000,349040000,9901,3300,6601,3300,0,1,3302,9883805,9.883805
6100,2500,3300,15250000,2,26406,6603,1,349040000,349040000,9901,3300,6601,3300,0,1,3302,9669976,9.669976
6100,2500,3300,15250000,2,26406,6603,1,349040000,349040000,9901,3300,6601,3300,0,1,3302,9789358,9.789358
6100,2500,3300,15250000,2,26406,6603,1,349040000,349040000,9901,3300,6601,3300,0,1,3302,9528017,9.528017
6100,2500,3300,15250000,2,26406,6603,1,349040000,349040000,9901,3300,6601,3300,0,1,3302,9912433,9.912433
6100,2500,3300,15250000,2,26406,6603,1,349040000,349040000,9901,3300,6601,3300,0,1,3302,9506750,9.50675
6100,2500,3300,15250000,2,26406,6603,1,349040000,349040000,9901,3300,6601,3300,0,1,3302,9970562,9.970562
6100,2500,3700,15250000,2,29606,7403,1,376560000,376560000,11101,3700,7401,3700,0,1,3702,10535599,10.535599
6100,2500,3700,15250000,2,29606,7403,1,376560000,376560000,11101,3700,7401,3700,0,1,3702,10932128,10.932128
6100,2500,3700,15250000,2,29606,7403,1,376560000,376560000,11101,3700,7401,3700,0,1,3702,10665071,10.665071
6100,2500,3700,15250000,2,29606,7403,1,376560000,376560000,11101,3700,7401,3700,0,1,3702,10837621,10.837621
6100,2500,3700,15250000,2,29606,7403,1,376560000,376560000,11101,3700,7401,3700,0,1,3702,10488392,10.488392
6100,2500,3700,15250000,2,29606,7403,1,376560000,376560000,11101,3700,7401,3700,0,1,3702,10956436,10.956436
6100,2500,3700,15250000,2,29606,7403,1,376560000,376560000,11101,3700,7401,3700,0,1,3702,10430071,10.430071
6100,2500,3700,15250000,2,29606,7403,1,376560000,376560000,11101,3700,7401,3700,0,1,3702,11059282,11.059282
6100,2500,4100,15250000,2,32806,8203,1,404080000,404080000,12301,4100,8201,4100,0,1,4102,11785727,11.785727
6100,2500,4100,15250000,2,32806,8203,1,404080000,404080000,12301,4100,8201,4100,0,1,4102,12178807,12.178807
6100,2500,4100,15250000,2,32806,8203,1,404080000,404080000,12301,4100,8201,4100,0,1,4102,11936091,11.936091
6100,2500,4100,15250000,2,32806,8203,1,404080000,404080000,12301,4100,8201,4100,0,1,4102,12108995,12.108995
6100,2500,4100,15250000,2,32806,8203,1,404080000,404080000,12301,4100,8201,4100,0,1,4102,11748361,11.748361
6100,2500,4100,15250000,2,32806,8203,1,404080000,404080000,12301,4100,8201,4100,0,1,4102,12257095,12.257095
6100,2500,4100,15250000,2,32806,8203,1,404080000,404080000,12301,4100,8201,4100,0,1,4102,11730815,11.730815
6100,2500,4100,15250000,2,32806,8203,1,404080000,404080000,12301,4100,8201,4100,0,1,4102,12340599,12.340599
6100,2500,4500,15250000,2,36006,9003,1,431600000,431600000,13501,4500,9001,4500,0,1,4502,12931500,12.9315
6100,2500,4500,15250000,2,36006,9003,1,431600000,431600000,13501,4500,9001,4500,0,1,4502,13365852,13.365852
6100,2500,4500,15250000,2,36006,9003,1,431600000,431600000,13501,4500,9001,4500,0,1,4502,13072889,13.072889
6100,2500,4500,15250000,2,36006,9003,1,431600000,431600000,13501,4500,9001,4500,0,1,4502,13240970,13.24097
6100,2500,4500,15250000,2,36006,9003,1,431600000,431600000,13501,4500,9001,4500,0,1,4502,12885666,12.885666
6100,2500,4500,15250000,2,36006,9003,1,431600000,431600000,13501,4500,9001,4500,0,1,4502,13390825,13.390825
6100,2500,4500,15250000,2,36006,9003,1,431600000,431600000,13501,4500,9001,4500,0,1,4502,12867491,12.867491
6100,2500,4500,15250000,2,36006,9003,1,431600000,431600000,13501,4500,9001,4500,0,1,4502,13540665,13.540665
6100,2500,4900,15250000,2,39206,9803,1,459120000,459120000,14701,4900,9801,4900,0,1,4902,14074190,14.07419
6100,2500,4900,15250000,2,39206,9803,1,459120000,459120000,14701,4900,9801,4900,0,1,4902,14558789,14.558789
6100,2500,4900,15250000,2,39206,9803,1,459120000,459120000,14701,4900,9801,4900,0,1,4902,14194546,14.194546
6100,2500,4900,15250000,2,39206,9803,1,459120000,459120000,14701,4900,9801,4900,0,1,4902,14418826,14.418826
6100,2500,4900,15250000,2,39206,9803,1,459120000,459120000,14701,4900,9801,4900,0,1,4902,14039308,14.039308
6100,2500,4900,15250000,2,39206,9803,1,459120000,459120000,14701,4900,9801,4900,0,1,4902,14594197,14.594197
6100,2500,4900,15250000,2,39206,9803,1,459120000,459120000,14701,4900,9801,4900,0,1,4902,13955756,13.955756
6100,2500,4900,15250000,2,39206,9803,1,459120000,459120000,14701,4900,9801,4900,0,1,4902,14687270,14.68727
6100,2500,5300,15250000,2,42406,10603,1,486640000,486640000,15901,5300,10601,5300,0,1,5302,15172419,15.172419
6100,2500,5300,15250000,2,42406,10603,1,486640000,486640000,15901,5300,10601,5300,0,1,5302,15806529,15.806529
6100,2500,5300,15250000,2,42406,10603,1,486640000,486640000,15901,5300,10601,5300,0,1,5302,15351290,15.35129
6100,2500,5300,15250000,2,42406,10603,1,486640000,486640000,15901,5300,10601,5300,0,1,5302,15598041,15.598041
6100,2500,5300,15250000,2,42406,10603,1,486640000,486640000,15901,5300,10601,5300,0,1,5302,15113639,15.113639
6100,2500,5300,15250000,2,42406,10603,1,486640000,486640000,15901,5300,10601,5300,0,1,5302,15807047,15.807047
6100,2500,5300,15250000,2,42406,10603,1,486640000,486640000,15901,5300,10601,5300,0,1,5302,15059163,15.059163
6100,2500,5300,15250000,2,42406,10603,1,486640000,486640000,15901,5300,10601,5300,0,1,5302,15914440,15.91444
6100,2500,5700,15250000,2,45606,11403,1,514160000,514160000,17101,5700,11401,5700,0,1,5702,16311670,16.31167
6100,2500,5700,15250000,2,45606,11403,1,514160000,514160000,17101,5700,11401,5700,0,1,5702,16926714,16.926714
6100,2500,5700,15250000,2,45606,11403,1,514160000,514160000,17101,5700,11401,5700,0,1,5702,16488294,16.488294
6100,2500,5700,15250000,2,45606,11403,1,514160000,514160000,17101,5700,11401,5700,0,1,5702,16707387,16.707387
6100,2500,5700,15250000,2,45606,11403,1,514160000,514160000,17101,5700,11401,5700,0,1,5702,16260765,16.260765
6100,2500,5700,15250000,2,45606,11403,1,514160000,514160000,17101,5700,11401,5700,0,1,5702,16966992,16.966992
6100,2500,5700,15250000,2,45606,11403,1,514160000,514160000,17101,5700,11401,5700,0,1,5702,16196583,16.196583
6100,2500,5700,15250000,2,45606,11403,1,514160000,514160000,17101,5700,11401,5700,0,1,5702,17087638,17.087638
6100,2500,6100,15250000,2,48806,12203,1,541680000,541680000,18301,6100,12201,6100,0,1,6102,17473135,17.473135
6100,2500,6100,15250000,2,48806,12203,1,541680000,541680000,18301,6100,12201,6100,0,1,6102,18069783,18.069783
6100,2500,6100,15250000,2,48806,12203,1,541680000,541680000,18301,6100,12201,6100,0,1,6102,17596055,17.596055
6100,2500,6100,15250000,2,48806,12203,1,541680000,541680000,18301,6100,12201,6100,0,1,6102,17929193,17.929193
6100,2500,6100,15250000,2,48806,12203,1,541680000,541680000,18301,6100,12201,6100,0,1,6102,17427635,17.427635
6100,2500,6100,15250000,2,48806,12203,1,541680000,541680000,18301,6100,12201,6100,0,1,6102,18125409,18.125409
6100,2500,6100,15250000,2,48806,12203,1,541680000,541680000,18301,6100,12201,6100,0,1,6102,17286694,17.286694
6100,2500,6100,15250000,2,48806,12203,1,541680000,541680000,18301,6100,12201,6100,0,1,6102,18315065,18.315065
6100,2500,6500,15250000,2,52006,13003,1,569200000,569200000,19501,6500,13001,6500,0,1,6502,18646168,18.646168
6100,2500,6500,15250000,2,52006,13003,1,569200000,569200000,19501,6500,13001,6500,0,1,6502,19255244,19.255244
6100,2500,6500,15250000,2,52006,13003,1,569200000,569200000,19501,6500,13001,6500,0,1,6502,18743009,18.743009
6100,2500,6500,15250000,2,52006,13003,1,569200000,569200000,19501,6500,13001,6500,0,1,6502,19044095,19.044095
6100,2500,6500,15250000,2,52006,13003,1,569200000,569200000,19501,6500,13001,6500,0,1,6502,18514978,18.514978
6100,2500,6500,15250000,2,52006,13003,1,569200000,569200000,19501,6500,13001,6500,0,1,6502,19318957,19.318957
6100,2500,6500,15250000,2,52006,13003,1,569200000,569200000,19501,6500,13001,6500,0,1,6502,18475323,18.475323
6100,2500,6500,15250000,2,52006,13003,1,569200000,569200000,19501,6500,13001,6500,0,1,6502,19510171,19.510171
6100,2500,6900,15250000,2,55206,13803,1,596720000,596720000,20701,6900,13801,6900,0,1,6902,19773388,19.773388
6100,2500,6900,15250000,2,55206,13803,1,596720000,596720000,20701,6900,13801,6900,0,1,6902,20461995,20.461995
6100,2500,6900,15250000,2,55206,13803,1,596720000,596720000,20701,6900,13801,6900,0,1,6902,19913223,19.913223
6100,2500,6900,15250000,2,55206,13803,1,596720000,596720000,20701,6900,13801,6900,0,1,6902,20230858,20.230858
6100,2500,6900,15250000,2,55206,13803,1,596720000,596720000,20701,6900,13801,6900,0,1,6902,19643486,19.643486
6100,2500,6900,15250000,2,55206,13803,1,596720000,596720000,20701,6900,13801,6900,0,1,6902,20491380,20.49138
6100,2500,6900,15250000,2,55206,13803,1,596720000,596720000,20701,6900,13801,6900,0,1,6902,19597807,19.597807
6100,2500,6900,15250000,2,55206,13803,1,596720000,596720000,20701,6900,13801,6900,0,1,6902,20685638,20.685638
6100,2100,500,12810000,2,4006,1003,1,135280000,135280000,1501,500,1001,500,0,1,502,1328066,1.328066
6100,2100,500,12810000,2,4006,1003,1,135280000,135280000,1501,500,1001,500,0,1,502,1341362,1.341362
6100,2100,500,12810000,2,4006,1003,1,135280000,135280000,1501,500,1001,500,0,1,502,1351789,1.351789
6100,2100,500,12810000,2,4006,1003,1,135280000,135280000,1501,500,1001,500,0,1,502,1328630,1.32863
6100,2100,500,12810000,2,4006,1003,1,135280000,135280000,1501,500,1001,500,0,1,502,1316672,1.316672
6100,2100,500,12810000,2,4006,1003,1,135280000,135280000,1501,500,1001,500,0,1,502,1351360,1.35136
6100,2100,500,12810000,2,4006,1003,1,135280000,135280000,1501,500,1001,500,0,1,502,1307150,1.30715
6100,2100,500,12810000,2,4006,1003,1,135280000,135280000,1501,500,1001,500,0,1,502,1362276,1.362276
6100,2100,900,12810000,2,7206,1803,1,161520000,161520000,2701,900,1801,900,0,1,902,2266693,2.266693
6100,2100,900,12810000,2,7206,1803,1,161520000,161520000,2701,900,1801,900,0,1,902,2319005,2.319005
6100,2100,900,12810000,2,7206,1803,1,161520000,161520000,2701,900,1801,900,0,1,902,2296903,2.296903
6100,2100,900,12810000,2,7206,1803,1,161520000,161520000,2701,900,1801,900,0,1,902,2309570,2.30957
6100,2100,900,12810000,2,7206,1803,1,161520000,161520000,2701,900,1801,900,0,1,902,2255674,2.255674
6100,2100,900,12810000,2,7206,1803,1,161520000,161520000,2701,900,1801,900,0,1,902,2329888,2.329888
6100,2100,900,12810000,2,7206,1803,1,161520000,161520000,2701,900,1801,900,0,1,902,2220811,2.220811
6100,2100,900,12810000,2,7206,1803,1,161520000,161520000,2701,900,1801,900,0,1,902,2356778,2.356778
6100,2100,1300,12810000,2,10406,2603,1,187760000,187760000,3901,1300,2601,1300,0,1,1302,3365490,3.36549
6100,2100,1300,12810000,2,10406,2603,1,187760000,187760000,3901,1300,2601,1300,0,1,1302,3417323,3.417323
6100,2100,1300,12810000,2,10406,2603,1,187760000,187760000,3901,1300,2601,1300,0,1,1302,3395576,3.395576
6100,2100,1300,12810000,2,10406,2603,1,187760000,187760000,3901,1300,2601,1300,0,1,1302,3386577,3.386577
6100,2100,1300,12810000,2,10406,2603,1,187760000,187760000,3901,1300,2601,1300,0,1,1302,3354998,3.354998
6100,2100,1300,12810000,2,10406,2603,1,187760000,187760000,3901,1300,2601,1300,0,1,1302,3442649,3.442649
6100,2100,1300,12810000,2,10406,2603,1,187760000,187760000,3901,1300,2601,1300,0,1,1302,3171542,3.171542
6100,2100,1300,12810000,2,10406,2603,1,187760000,187760000,3901,1300,2601,1300,0,1,1302,3467693,3.467693
6100,2100,1700,12810000,2,13606,3403,1,214000000,214000000,5101,1700,3401,1700,0,1,1702,4149291,4.149291
6100,2100,1700,12810000,2,13606,3403,1,214000000,214000000,5101,1700,3401,1700,0,1,1702,4277936,4.277936
6100,2100,1700,12810000,2,13606,3403,1,214000000,214000000,5101,1700,3401,1700,0,1,1702,4209638,4.209638
6100,2100,1700,12810000,2,13606,3403,1,214000000,214000000,5101,1700,3401,1700,0,1,1702,4232006,4.232006
6100,2100,1700,12810000,2,13606,3403,1,214000000,214000000,5101,1700,3401,1700,0,1,1702,4122745,4.122745
6100,2100,1700,12810000,2,13606,3403,1,214000000,214000000,5101,1700,3401,1700,0,1,1702,4290162,4.290162
6100,2100,1700,12810000,2,13606,3403,1,214000000,214000000,5101,1700,3401,1700,0,1,1702,4113813,4.113813
6100,2100,1700,12810000,2,13606,3403,1,214000000,214000000,5101,1700,3401,1700,0,1,1702,4329901,4.329901
6100,2100,2100,12810000,2,16806,4203,1,240240000,240240000,6301,2100,4201,2100,0,1,2102,5104021,5.104021
6100,2100,2100,12810000,2,16806,4203,1,240240000,240240000,6301,2100,4201,2100,0,1,2102,5262752,5.262752
6100,2100,2100,12810000,2,16806,4203,1,240240000,240240000,6301,2100,4201,2100,0,1,2102,5158485,5.158485
6100,2100,2100,12810000,2,16806,4203,1,240240000,240240000,6301,2100,4201,2100,0,1,2102,5211744,5.211744
6100,2100,2100,12810000,2,16806,4203,1,240240000,240240000,6301,2100,4201,2100,0,1,2102,5070279,5.070279
6100,2100,2100,12810000,2,16806,4203,1,240240000,240240000,6301,2100,4201,2100,0,1,2102,5280100,5.2801
6100,2100,2100,12810000,2,16806,4203,1,240240000,240240000,6301,2100,4201,2100,0,1,2102,5038232,5.038232
6100,2100,2100,12810000,2,16806,4203,1,240240000,240240000,6301,2100,4201,2100,0,1,2102,5324727,5.324727
6100,2100,2500,12810000,2,20006,5003,1,266480000,266480000,7501,2500,5001,2500,0,1,2502,6052489,6.052489
6100,2100,2500,12810000,2,20006,5003,1,266480000,266480000,7501,2500,5001,2500,0,1,2502,6233258,6.233258
6100,2100,2500,12810000,2,20006,5003,1,266480000,266480000,7501,2500,5001,2500,0,1,2502,6115843,6.115843
6100,2100,2500,12810000,2,20006,5003,1,266480000,266480000,7501,2500,5001,2500,0,1,2502,6173796,6.173796
6100,2100,2500,12810000,2,20006,5003,1,266480000,266480000,7501,2500,5001,2500,0,1,2502,6006943,6.006943
6100,2100,2500,12810000,2,20006,5003,1,266480000,266480000,7501,2500,5001,2500,0,1,2502,6266638,6.266638
6100,2100,2500,12810000,2,20006,5003,1,266480000,266480000,7501,2500,5001,2500,0,1,2502,5969850,5.96985
6100,2100,2500,12810000,2,20006,5003,1,266480000,266480000,7501,2500,5001,2500,0,1,2502,6321000,6.321
6100,2100,2900,12810000,2,23206,5803,1,292720000,292720000,8701,2900,5801,2900,0,1,2902,7150524,7.150524
6100,2100,2900,12810000,2,23206,5803,1,292720000,292720000,8701,2900,5801,2900,0,1,2902,7352370,7.35237
6100,2100,2900,12810000,2,23206,5803,1,292720000,292720000,8701,2900,5801,2900,0,1,2902,7224777,7.224777
6100,2100,2900,12810000,2,23206,5803,1,292720000,292720000,8701,2900,5801,2900,0,1,2902,7308496,7.308496
6100,2100,2900,12810000,2,23206,5803,1,292720000,292720000,8701,2900,5801,2900,0,1,2902,7137247,7.137247
6100,2100,2900,12810000,2,23206,5803,1,292720000,292720000,8701,2900,5801,2900,0,1,2902,7380005,7.380005
6100,2100,2900,12810000,2,23206,5803,1,292720000,292720000,8701,2900,5801,2900,0,1,2902,7079302,7.079302
6100,2100,2900,12810000,2,23206,5803,1,292720000,292720000,8701,2900,5801,2900,0,1,2902,7456375,7.456375
6100,2100,3300,12810000,2,26406,6603,1,318960000,318960000,9901,3300,6601,3300,0,1,3302,7936603,7.936603
6100,2100,3300,12810000,2,26406,6603,1,318960000,318960000,9901,3300,6601,3300,0,1,3302,8225132,8.225132
6100,2100,3300,12810000,2,26406,6603,1,318960000,318960000,9901,3300,6601,3300,0,1,3302,8030917,8.030917
6100,2100,3300,12810000,2,26406,6603,1,318960000,318960000,9901,3300,6601,3300,0,1,3302,8146668,8.146668
6100,2100,3300,12810000,2,26406,6603,1,318960000,318960000,9901,3300,6601,3300,0,1,3302,7903956,7.903956
6100,2100,3300,12810000,2,26406,6603,1,318960000,318960000,9901,3300,6601,3300,0,1,3302,8234572,8.234572
6100,2100,3300,12810000,2,26406,6603,1,318960000,318960000,9901,3300,6601,3300,0,1,3302,7838996,7.838996
6100,2100,3300,12810000,2,26406,6603,1,318960000,318960000,9901,3300,6601,3300,0,1,3302,8312649,8.312649
6100,2100,3700,12810000,2,29606,7403,1,345200000,345200000,11101,3700,7401,3700,0,1,3702,8985888,8.985888
6100,2100,3700,12810000,2,29606,7403,1,345200000,345200000,11101,3700,7401,3700,0,1,3702,9295510,9.29551
6100,2100,3700,12810000,2,29606,7403,1,345200000,345200000,11101,3700,7401,3700,0,1,3702,9143516,9.143516
6100,2100,3700,12810000,2,29606,7403,1,345200000,345200000,11101,3700,7401,3700,0,1,3702,9285998,9.285998
6100,2100,3700,12810000,2,29606,7403,1,345200000,345200000,11101,3700,7401,3700,0,1,3702,9000149,9.000149
6100,2100,3700,12810000,2,29606,7403,1,345200000,345200000,11101,3700,7401,3700,0,1,3702,9308945,9.308945
6100,2100,3700,12810000,2,29606,7403,1,345200000,345200000,11101,3700,7401,3700,0,1,3702,8963618,8.963618
6100,2100,3700,12810000,2,29606,7403,1,345200000,345200000,11101,3700,7401,3700,0,1,3702,9417606,9.417606
6100,2100,4100,12810000,2,32806,8203,1,371440000,371440000,12301,4100,8201,4100,0,1,4102,9807192,9.807192
6100,2100,4100,12810000,2,32806,8203,1,371440000,371440000,12301,4100,8201,4100,0,1,4102,10199751,10.199751
6100,2100,4100,12810000,2,32806,8203,1,371440000,371440000,12301,4100,8201,4100,0,1,4102,9923649,9.923649
6100,2100,4100,12810000,2,32806,8203,1,371440000,371440000,12301,4100,8201,4100,0,1,4102,10070902,10.070902
6100,2100,4100,12810000,2,32806,8203,1,371440000,371440000,12301,4100,8201,4100,0,1,4102,9767385,9.767385
6100,2100,4100,12810000,2,32806,8203,1,371440000,371440000,12301,4100,8201,4100,0,1,4102,10214954,10.214954
6100,2100,4100,12810000,2,32806,8203,1,371440000,371440000,12301,4100,8201,4100,0,1,4102,9713994,9.713994
6100,2100,4100,12810000,2,32806,8203,1,371440000,371440000,12301,4100,8201,4100,0,1,4102,10298404,10.298404
6100,2100,4500,12810000,2,36006,9003,1,397680000,397680000,13501,4500,9001,4500,0,1,4502,10905387,10.905387
6100,2100,4500,12810000,2,36006,9003,1,397680000,397680000,13501,4500,9001,4500,0,1,4502,11266152,11.266152
6100,2100,4500,12810000,2,36006,9003,1,397680000,397680000,13501,4500,9001,4500,0,1,4502,11042096,11.042096
6100,2100,4500,12810000,2,36006,9003,1,397680000,397680000,13501,4500,9001,4500,0,1,4502,11155834,11.155834
6100,2100,4500,12810000,2,36006,9003,1,397680000,397680000,13501,4500,9001,4500,0,1,4502,10871950,10.87195
6100,2100,4500,12810000,2,36006,9003,1,397680000,397680000,13501,4500,9001,4500,0,1,4502,11315831,11.315831
6100,2100,4500,12810000,2,36006,9003,1,397680000,397680000,13501,4500,9001,4500,0,1,4502,10851804,10.851804
6100,2100,4500,12810000,2,36006,9003,1,397680000,397680000,13501,4500,9001,4500,0,1,4502,11416091,11.416091
6100,2100,4900,12810000,2,39206,9803,1,423920000,423920000,14701,4900,9801,4900,0,1,4902,11829436,11.829436
6100,2100,4900,12810000,2,39206,9803,1,423920000,423920000,14701,4900,9801,4900,0,1,4902,12257073,12.257073
6100,2100,4900,12810000,2,39206,9803,1,423920000,423920000,14701,4900,9801,4900,0,1,4902,11977398,11.977398
6100,2100,4900,12810000,2,39206,9803,1,423920000,423920000,14701,4900,9801,4900,0,1,4902,12151245,12.151245
6100,2100,4900,12810000,2,39206,9803,1,423920000,423920000,14701,4900,9801,4900,0,1,4902,11801015,11.801015
6100,2100,4900,12810000,2,39206,9803,1,423920000,423920000,14701,4900,9801,4900,0,1,4902,12327505,12.327505
6100,2100,4900,12810000,2,39206,9803,1,423920000,423920000,14701,4900,9801,4900,0,1,4902,11759651,11.759651
6100,2100,4900,12810000,2,39206,9803,1,423920000,423920000,14701,4900,9801,4900,0,1,4902,12393871,12.393871
6100,2100,5300,12810000,2,42406,10603,1,450160000,450160000,15901,5300,10601,5300,0,1,5302,12809563,12.809563
6100,2100,5300,12810000,2,42406,10603,1,450160000,450160000,15901,5300,10601,5300,0,1,5302,13241914,13.241914
6100,2100,5300,12810000,2,42406,10603,1,450160000,450160000,15901,5300,10601,5300,0,1,5302,12954601,12.954601
6100,2100,5300,12810000,2,42406,10603,1,450160000,450160000,15901,5300,10601,5300,0,1,5302,13102329,13.102329
6100,2100,5300,12810000,2,42406,10603,1,450160000,450160000,15901,5300,10601,5300,0,1,5302,12754525,12.754525
6100,2100,5300,12810000,2,42406,10603,1,450160000,450160000,15901,5300,10601,5300,0,1,5302,13288975,13.288975
6100,2100,5300,12810000,2,42406,10603,1,450160000,450160000,15901,5300,10601,5300,0,1,5302,12763797,12.763797
6100,2100,5300,12810000,2,42406,10603,1,450160000,450160000,15901,5300,10601,5300,0,1,5302,13399810,13.39981
6100,2100,5700,12810000,2,45606,11403,1,476400000,476400000,17101,5700,11401,5700,0,1,5702,13759499,13.759499
6100,2100,5700,12810000,2,45606,11403,1,476400000,476400000,17101,5700,11401,5700,0,1,5702,14267540,14.26754
6100,2100,5700,12810000,2,45606,11403,1,476400000,476400000,17101,5700,11401,5700,0,1,5702,13901667,13.901667
6100,2100,5700,12810000,2,45606,11403,1,476400000,476400000,17101,5700,11401,5700,0,1,5702,14082151,14.082151
6100,2100,5700,12810000,2,45606,11403,1,476400000,476400000,17101,5700,11401,5700,0,1,5702,13715872,13.715872
6100,2100,5700,12810000,2,45606,11403,1,476400000,476400000,17101,5700,11401,5700,0,1,5702,14300258,14.300258
6100,2100,5700,12810000,2,45606,11403,1,476400000,476400000,17101,5700,11401,5700,0,1,5702,13678216,13.678216
6100,2100,5700,12810000,2,45606,11403,1,476400000,476400000,17101,5700,11401,5700,0,1,5702,14418387,14.418387
6100,2100,6100,12810000,2,48806,12203,1,502640000,502640000,18301,6100,12201,6100,0,1,6102,14689338,14.689338
6100,2100,6100,12810000,2,48806,12203,1,502640000,502640000,18301,6100,12201,6100,0,1,6102,15239579,15.239579
6100,2100,6100,12810000,2,48806,12203,1,502640000,502640000,18301,6100,12201,6100,0,1,6102,14846797,14.846797
6100,2100,6100,12810000,2,48806,12203,1,502640000,502640000,18301,6100,12201,6100,0,1,6102,15044930,15.04493
6100,2100,6100,12810000,2,48806,12203,1,502640000,502640000,18301,6100,12201,6100,0,1,6102,14643765,14.643765
6100,2100,6100,12810000,2,48806,12203,1,502640000,502640000,18301,6100,12201,6100,0,1,6102,15280815,15.280815
6100,2100,6100,12810000,2,48806,12203,1,502640000,502640000,18301,6100,12201,6100,0,1,6102,14591552,14.591552
6100,2100,6100,12810000,2,48806,12203,1,502640000,502640000,18301,6100,12201,6100,0,1,6102,15400481,15.400481
6100,2100,6500,12810000,2,52006,13003,1,528880000,528880000,19501,6500,13001,6500,0,1,6502,15648487,15.648487
6100,2100,6500,12810000,2,52006,13003,1,528880000,528880000,19501,6500,13001,6500,0,1,6502,16237003,16.237003
6100,2100,6500,12810000,2,52006,13003,1,528880000,528880000,19501,6500,13001,6500,0,1,6502,15838660,15.83866
6100,2100,6500,12810000,2,52006,13003,1,528880000,528880000,19501,6500,13001,6500,0,1,6502,16036669,16.036669
6100,2100,6500,12810000,2,52006,13003,1,528880000,528880000,19501,6500,13001,6500,0,1,6502,15590672,15.590672
6100,2100,6500,12810000,2,52006,13003,1,528880000,528880000,19501,6500,13001,6500,0,1,6502,16259528,16.259528
6100,2100,6500,12810000,2,52006,13003,1,528880000,528880000,19501,6500,13001,6500,0,1,6502,15545072,15.545072
6100,2100,6500,12810000,2,52006,13003,1,528880000,528880000,19501,6500,13001,6500,0,1,6502,16408602,16.408602
6100,2100,6900,12810000,2,55206,13803,1,555120000,555120000,20701,6900,13801,6900,0,1,6902,16641312,16.641312
6100,2100,6900,12810000,2,55206,13803,1,555120000,555120000,20701,6900,13801,6900,0,1,6902,17278050,17.27805
6100,2100,6900,12810000,2,55206,13803,1,555120000,555120000,20701,6900,13801,6900,0,1,6902,16739408,16.739408
6100,2100,6900,12810000,2,55206,13803,1,555120000,555120000,20701,6900,13801,6900,0,1,6902,17055134,17.055134
6100,2100,6900,12810000,2,55206,13803,1,555120000,555120000,20701,6900,13801,6900,0,1,6902,16520928,16.520928
6100,2100,6900,12810000,2,55206,13803,1,555120000,555120000,20701,6900,13801,6900,0,1,6902,17298045,17.298045
6100,2100,6900,12810000,2,55206,13803,1,555120000,555120000,20701,6900,13801,6900,0,1,6902,16480754,16.480754
6100,2100,6900,12810000,2,55206,13803,1,555120000,555120000,20701,6900,13801,6900,0,1,6902,17396681,17.396681
6100,1700,500,10370000,2,4006,1003,1,114160000,114160000,1501,500,1001,500,0,1,502,1048602,1.048602
6100,1700,500,10370000,2,4006,1003,1,114160000,114160000,1501,500,1001,500,0,1,502,1087539,1.087539
6100,1700,500,10370000,2,4006,1003,1,114160000,114160000,1501,500,1001,500,0,1,502,1095366,1.095366
6100,1700,500,10370000,2,4006,1003,1,114160000,114160000,1501,500,1001,500,0,1,502,1079461,1.079461
6100,1700,500,10370000,2,4006,1003,1,114160000,114160000,1501,500,1001,500,0,1,502,1057153,1.057153
6100,1700,500,10370000,2,4006,1003,1,114160000,114160000,1501,500,1001,500,0,1,502,1095683,1.095683
6100,1700,500,10370000,2,4006,1003,1,114160000,114160000,1501,500,1001,500,0,1,502,1056820,1.05682
6100,1700,500,10370000,2,4006,1003,1,114160000,114160000,1501,500,1001,500,0,1,502,1103342,1.103342
6100,1700,900,10370000,2,7206,1803,1,139120000,139120000,2701,900,1801,900,0,1,902,1840997,1.840997
6100,1700,900,10370000,2,7206,1803,1,139120000,139120000,2701,900,1801,900,0,1,902,1883133,1.883133
6100,1700,900,10370000,2,7206,1803,1,139120000,139120000,2701,900,1801,900,0,1,902,1872789,1.872789
6100,1700,900,10370000,2,7206,1803,1,139120000,139120000,2701,900,1801,900,0,1,902,1865404,1.865404
6100,1700,900,10370000,2,7206,1803,1,139120000,139120000,2701,900,1801,900,0,1,902,1833404,1.833404
6100,1700,900,10370000,2,7206,1803,1,139120000,139120000,2701,900,1801,900,0,1,902,1890895,1.890895
6100,1700,900,10370000,2,7206,1803,1,139120000,139120000,2701,900,1801,900,0,1,902,1815265,1.815265
6100,1700,900,10370000,2,7206,1803,1,139120000,139120000,2701,900,1801,900,0,1,902,1913546,1.913546
6100,1700,1300,10370000,2,10406,2603,1,164080000,164080000,3901,1300,2601,1300,0,1,1302,2719765,2.719765
6100,1700,1300,10370000,2,10406,2603,1,164080000,164080000,3901,1300,2601,1300,0,1,1302,2777727,2.777727
6100,1700,1300,10370000,2,10406,2603,1,164080000,164080000,3901,1300,2601,1300,0,1,1302,2769895,2.769895
6100,1700,1300,10370000,2,10406,2603,1,164080000,164080000,3901,1300,2601,1300,0,1,1302,2797137,2.797137
6100,1700,1300,10370000,2,10406,2603,1,164080000,164080000,3901,1300,2601,1300,0,1,1302,2671836,2.671836
6100,1700,1300,10370000,2,10406,2603,1,164080000,164080000,3901,1300,2601,1300,0,1,1302,2805412,2.805412
6100,1700,1300,10370000,2,10406,2603,1,164080000,164080000,3901,1300,2601,1300,0,1,1302,2706955,2.706955
6100,1700,1300,10370000,2,10406,2603,1,164080000,164080000,3901,1300,2601,1300,0,1,1302,2816034,2.816034
6100,1700,1700,10370000,2,13606,3403,1,189040000,189040000,5101,1700,3401,1700,0,1,1702,3374203,3.374203
6100,1700,1700,10370000,2,13606,3403,1,189040000,189040000,5101,1700,3401,1700,0,1,1702,3477006,3.477006
6100,1700,1700,10370000,2,13606,3403,1,189040000,189040000,5101,1700,3401,1700,0,1,1702,3409967,3.409967
6100,1700,1700,10370000,2,13606,3403,1,189040000,189040000,5101,1700,3401,1700,0,1,1702,3440525,3.440525
6100,1700,1700,10370000,2,13606,3403,1,189040000,189040000,5101,1700,3401,1700,0,1,1702,3346632,3.346632
6100,1700,1700,10370000,2,13606,3403,1,189040000,189040000,5101,1700,3401,1700,0,1,1702,3486902,3.486902
6100,1700,1700,10370000,2,13606,3403,1,189040000,189040000,5101,1700,3401,1700,0,1,1702,3330233,3.330233
6100,1700,1700,10370000,2,13606,3403,1,189040000,189040000,5101,1700,3401,1700,0,1,1702,3515053,3.515053
6100,1700,2100,10370000,2,16806,4203,1,214000000,214000000,6301,2100,4201,2100,0,1,2102,4138368,4.138368
6100,1700,2100,10370000,2,16806,4203,1,214000000,214000000,6301,2100,4201,2100,0,1,2102,4263297,4.263297
6100,1700,2100,10370000,2,16806,4203,1,214000000,214000000,6301,2100,4201,2100,0,1,2102,4175499,4.175499
6100,1700,2100,10370000,2,16806,4203,1,214000000,214000000,6301,2100,4201,2100,0,1,2102,4227345,4.227345
6100,1700,2100,10370000,2,16806,4203,1,214000000,214000000,6301,2100,4201,2100,0,1,2102,4108230,4.10823
6100,1700,2100,10370000,2,16806,4203,1,214000000,214000000,6301,2100,4201,2100,0,1,2102,4285669,4.285669
6100,1700,2100,10370000,2,16806,4203,1,214000000,214000000,6301,2100,4201,2100,0,1,2102,4089523,4.089523
6100,1700,2100,10370000,2,16806,4203,1,214000000,214000000,6301,2100,4201,2100,0,1,2102,4312695,4.312695
6100,1700,2500,10370000,2,20006,5003,1,238960000,238960000,7501,2500,5001,2500,0,1,2502,4913810,4.91381
6100,1700,2500,10370000,2,20006,5003,1,238960000,238960000,7501,2500,5001,2500,0,1,2502,5063643,5.063643
6100,1700,2500,10370000,2,20006,5003,1,238960000,238960000,7501,2500,5001,2500,0,1,2502,4970679,4.970679
6100,1700,2500,10370000,2,20006,5003,1,238960000,238960000,7501,2500,5001,2500,0,1,2502,5027145,5.027145
6100,1700,2500,10370000,2,20006,5003,1,238960000,238960000,7501,2500,5001,2500,0,1,2502,4877985,4.877985
6100,1700,2500,10370000,2,20006,5003,1,238960000,238960000,7501,2500,5001,2500,0,1,2502,5093838,5.093838
6100,1700,2500,10370000,2,20006,5003,1,238960000,238960000,7501,2500,5001,2500,0,1,2502,4852614,4.852614
6100,1700,2500,10370000,2,20006,5003,1,238960000,238960000,7501,2500,5001,2500,0,1,2502,5136652,5.136652
6100,1700,2900,10370000,2,23206,5803,1,263920000,263920000,8701,2900,5801,2900,0,1,2902,5690711,5.690711
6100,1700,2900,10370000,2,23206,5803,1,263920000,263920000,8701,2900,5801,2900,0,1,2902,5866711,5.866711
6100,1700,2900,10370000,2,23206,5803,1,263920000,263920000,8701,2900,5801,2900,0,1,2902,5742271,5.742271
6100,1700,2900,10370000,2,23206,5803,1,263920000,263920000,8701,2900,5801,2900,0,1,2902,5817421,5.817421
6100,1700,2900,10370000,2,23206,5803,1,263920000,263920000,8701,2900,5801,2900,0,1,2902,5636772,5.636772
6100,1700,2900,10370000,2,23206,5803,1,263920000,263920000,8701,2900,5801,2900,0,1,2902,5919101,5.919101
6100,1700,2900,10370000,2,23206,5803,1,263920000,263920000,8701,2900,5801,2900,0,1,2902,5644648,5.644648
6100,1700,2900,10370000,2,23206,5803,1,263920000,263920000,8701,2900,5801,2900,0,1,2902,5962069,5.962069
6100,1700,3300,10370000,2,26406,6603,1,288880000,288880000,9901,3300,6601,3300,0,1,3302,6595870,6.59587
6100,1700,3300,10370000,2,26406,6603,1,288880000,288880000,9901,3300,6601,3300,0,1,3302,6799650,6.79965
6100,1700,3300,10370000,2,26406,6603,1,288880000,288880000,9901,3300,6601,3300,0,1,3302,6690399,6.690399
6100,1700,3300,10370000,2,26406,6603,1,288880000,288880000,9901,3300,6601,3300,0,1,3302,6710567,6.710567
6100,1700,3300,10370000,2,26406,6603,1,288880000,288880000,9901,3300,6601,3300,0,1,3302,6607038,6.607038
6100,1700,3300,10370000,2,26406,6603,1,288880000,288880000,9901,3300,6601,3300,0,1,3302,6807388,6.807388
6100,1700,3300,10370000,2,26406,6603,1,288880000,288880000,9901,3300,6601,3300,0,1,3302,6588350,6.58835
6100,1700,3300,10370000,2,26406,6603,1,288880000,288880000,9901,3300,6601,3300,0,1,3302,6867271,6.867271
6100,1700,3700,10370000,2,29606,7403,1,313840000,313840000,11101,3700,7401,3700,0,1,3702,7228913,7.228913
6100,1700,3700,10370000,2,29606,7403,1,313840000,313840000,11101,3700,7401,3700,0,1,3702,7495153,7.495153
6100,1700,3700,10370000,2,29606,7403,1,313840000,313840000,11101,3700,7401,3700,0,1,3702,7302412,7.302412
6100,1700,3700,10370000,2,29606,7403,1,313840000,313840000,11101,3700,7401,3700,0,1,3702,7393588,7.393588
6100,1700,3700,10370000,2,29606,7403,1,313840000,313840000,11101,3700,7401,3700,0,1,3702,7188786,7.188786
6100,1700,3700,10370000,2,29606,7403,1,313840000,313840000,11101,3700,7401,3700,0,1,3702,7507434,7.507434
6100,1700,3700,10370000,2,29606,7403,1,313840000,313840000,11101,3700,7401,3700,0,1,3702,7153576,7.153576
6100,1700,3700,10370000,2,29606,7403,1,313840000,313840000,11101,3700,7401,3700,0,1,3702,7564063,7.564063
6100,1700,4100,10370000,2,32806,8203,1,338800000,338800000,12301,4100,8201,4100,0,1,4102,8159161,8.159161
6100,1700,4100,10370000,2,32806,8203,1,338800000,338800000,12301,4100,8201,4100,0,1,4102,8416686,8.416686
6100,1700,4100,10370000,2,32806,8203,1,338800000,338800000,12301,4100,8201,4100,0,1,4102,8219283,8.219283
6100,1700,4100,10370000,2,32806,8203,1,338800000,338800000,12301,4100,8201,4100,0,1,4102,8301171,8.301171
6100,1700,4100,10370000,2,32806,8203,1,338800000,338800000,12301,4100,8201,4100,0,1,4102,8144469,8.144469
6100,1700,4100,10370000,2,32806,8203,1,338800000,338800000,12301,4100,8201,4100,0,1,4102,8424417,8.424417
6100,1700,4100,10370000,2,32806,8203,1,338800000,338800000,12301,4100,8201,4100,0,1,4102,8063539,8.063539
6100,1700,4100,10370000,2,32806,8203,1,338800000,338800000,12301,4100,8201,4100,0,1,4102,8466881,8.466881
6100,1700,4500,10370000,2,36006,9003,1,363760000,363760000,13501,4500,9001,4500,0,1,4502,8776169,8.776169
6100,1700,4500,10370000,2,36006,9003,1,363760000,363760000,13501,4500,9001,4500,0,1,4502,9099743,9.099743
6100,1700,4500,10370000,2,36006,9003,1,363760000,363760000,13501,4500,9001,4500,0,1,4502,8855590,8.85559
6100,1700,4500,10370000,2,36006,9003,1,363760000,363760000,13501,4500,9001,4500,0,1,4502,8979316,8.979316
6100,1700,4500,10370000,2,36006,9003,1,363760000,363760000,13501,4500,9001,4500,0,1,4502,8733847,8.733847
6100,1700,4500,10370000,2,36006,9003,1,363760000,363760000,13501,4500,9001,4500,0,1,4502,9113765,9.113765
6100,1700,4500,10370000,2,36006,9003,1,363760000,363760000,13501,4500,9001,4500,0,1,4502,8688522,8.688522
6100,1700,4500,10370000,2,36006,9003,1,363760000,363760000,13501,4500,9001,4500,0,1,4502,9179919,9.179919
6100,1700,4900,10370000,2,39206,9803,1,388720000,388720000,14701,4900,9801,4900,0,1,4902,9703382,9.703382
6100,1700,4900,10370000,2,39206,9803,1,388720000,388720000,14701,4900,9801,4900,0,1,4902,10026364,10.026364
6100,1700,4900,10370000,2,39206,9803,1,388720000,388720000,14701,4900,9801,4900,0,1,4902,9780501,9.780501
6100,1700,4900,10370000,2,39206,9803,1,388720000,388720000,14701,4900,9801,4900,0,1,4902,9885737,9.885737
6100,1700,4900,10370000,2,39206,9803,1,388720000,388720000,14701,4900,9801,4900,0,1,4902,9643890,9.64389
6100,1700,4900,10370000,2,39206,9803,1,388720000,388720000,14701,4900,9801,4900,0,1,4902,10041952,10.041952
6100,1700,4900,10370000,2,39206,9803,1,388720000,388720000,14701,4900,9801,4900,0,1,4902,9601480,9.60148
6100,1700,4900,10370000,2,39206,9803,1,388720000,388720000,14701,4900,9801,4900,0,1,4902,10076662,10.076662
6100,1700,5300,10370000,2,42406,10603,1,413680000,413680000,15901,5300,10601,5300,0,1,5302,10464585,10.464585
6100,1700,5300,10370000,2,42406,10603,1,413680000,413680000,15901,5300,10601,5300,0,1,5302,10808276,10.808276
6100,1700,5300,10370000,2,42406,10603,1,413680000,413680000,15901,5300,10601,5300,0,1,5302,10585262,10.585262
6100,1700,5300,10370000,2,42406,10603,1,413680000,413680000,15901,5300,10601,5300,0,1,5302,10666937,10.666937
6100,1700,5300,10370000,2,42406,10603,1,413680000,413680000,15901,5300,10601,5300,0,1,5302,10443766,10.443766
6100,1700,5300,10370000,2,42406,10603,1,413680000,413680000,15901,5300,10601,5300,0,1,5302,10826543,10.826543
6100,1700,5300,10370000,2,42406,10603,1,413680000,413680000,15901,5300,10601,5300,0,1,5302,10400762,10.400762
6100,1700,5300,10370000,2,42406,10603,1,413680000,413680000,15901,5300,10601,5300,0,1,5302,10918660,10.91866
6100,1700,5700,10370000,2,45606,11403,1,438640000,438640000,17101,5700,11401,5700,0,1,5702,11105046,11.105046
6100,1700,5700,10370000,2,45606,11403,1,438640000,438640000,17101,5700,11401,5700,0,1,5702,11504638,11.504638
6100,1700,5700,10370000,2,45606,11403,1,438640000,438640000,17101,5700,11401,5700,0,1,5702,11191704,11.191704
6100,1700,5700,10370000,2,45606,11403,1,438640000,438640000,17101,5700,11401,5700,0,1,5702,11358268,11.358268
6100,1700,5700,10370000,2,45606,11403,1,438640000,438640000,17101,5700,11401,5700,0,1,5702,11037481,11.037481
6100,1700,5700,10370000,2,45606,11403,1,438640000,438640000,17101,5700,11401,5700,0,1,5702,11525986,11.525986
6100,1700,5700,10370000,2,45606,11403,1,438640000,438640000,17101,5700,11401,5700,0,1,5702,10969044,10.969044
6100,1700,5700,10370000,2,45606,11403,1,438640000,438640000,17101,5700,11401,5700,0,1,5702,11614350,11.61435
6100,1700,6100,10370000,2,48806,12203,1,463600000,463600000,18301,6100,12201,6100,0,1,6102,12032140,12.03214
6100,1700,6100,10370000,2,48806,12203,1,463600000,463600000,18301,6100,12201,6100,0,1,6102,12430936,12.430936
6100,1700,6100,10370000,2,48806,12203,1,463600000,463600000,18301,6100,12201,6100,0,1,6102,12128530,12.12853
6100,1700,6100,10370000,2,48806,12203,1,463600000,463600000,18301,6100,12201,6100,0,1,6102,12273630,12.27363
6100,1700,6100,10370000,2,48806,12203,1,463600000,463600000,18301,6100,12201,6100,0,1,6102,11946614,11.946614
6100,1700,6100,10370000,2,48806,12203,1,463600000,463600000,18301,6100,12201,6100,0,1,6102,12455876,12.455876
6100,1700,6100,10370000,2,48806,12203,1,463600000,463600000,18301,6100,12201,6100,0,1,6102,11906397,11.906397
6100,1700,6100,10370000,2,48806,12203,1,463600000,463600000,18301,6100,12201,6100,0,1,6102,12514924,12.514924
6100,1700,6500,10370000,2,52006,13003,1,488560000,488560000,19501,6500,13001,6500,0,1,6502,12760789,12.760789
6100,1700,6500,10370000,2,52006,13003,1,488560000,488560000,19501,6500,13001,6500,0,1,6502,13186267,13.186267
6100,1700,6500,10370000,2,52006,13003,1,488560000,488560000,19501,6500,13001,6500,0,1,6502,12869419,12.869419
6100,1700,6500,10370000,2,52006,13003,1,488560000,488560000,19501,6500,13001,6500,0,1,6502,13075089,13.075089
6100,1700,6500,10370000,2,52006,13003,1,488560000,488560000,19501,6500,13001,6500,0,1,6502,12723861,12.723861
6100,1700,6500,10370000,2,52006,13003,1,488560000,488560000,19501,6500,13001,6500,0,1,6502,13215399,13.215399
6100,1700,6500,10370000,2,52006,13003,1,488560000,488560000,19501,6500,13001,6500,0,1,6502,12670230,12.67023
6100,1700,6500,10370000,2,52006,13003,1,488560000,488560000,19501,6500,13001,6500,0,1,6502,13330996,13.330996
6100,1700,6900,10370000,2,55206,13803,1,513520000,513520000,20701,6900,13801,6900,0,1,6902,13576232,13.576232
6100,1700,6900,10370000,2,55206,13803,1,513520000,513520000,20701,6900,13801,6900,0,1,6902,13994220,13.99422
6100,1700,6900,10370000,2,55206,13803,1,513520000,513520000,20701,6900,13801,6900,0,1,6902,13657737,13.657737
6100,1700,6900,10370000,2,55206,13803,1,513520000,513520000,20701,6900,13801,6900,0,1,6902,13861438,13.861438
6100,1700,6900,10370000,2,55206,13803,1,513520000,513520000,20701,6900,13801,6900,0,1,6902,13485540,13.48554
6100,1700,6900,10370000,2,55206,13803,1,513520000,513520000,20701,6900,13801,6900,0,1,6902,14068160,14.06816
6100,1700,6900,10370000,2,55206,13803,1,513520000,513520000,20701,6900,13801,6900,0,1,6902,13425924,13.425924
6100,1700,6900,10370000,2,55206,13803,1,513520000,513520000,20701,6900,13801,6900,0,1,6902,14141697,14.141697
6100,1300,500,7930000,2,4006,1003,1,93040000,93040000,1501,500,1001,500,0,1,502,830368,0.830368
6100,1300,500,7930000,2,4006,1003,1,93040000,93040000,1501,500,1001,500,0,1,502,836933,0.836933
6100,1300,500,7930000,2,4006,1003,1,93040000,93040000,1501,500,1001,500,0,1,502,836803,0.836803
6100,1300,500,7930000,2,4006,1003,1,93040000,93040000,1501,500,1001,500,0,1,502,830086,0.830086
6100,1300,500,7930000,2,4006,1003,1,93040000,93040000,1501,500,1001,500,0,1,502,817062,0.817062
6100,1300,500,7930000,2,4006,1003,1,93040000,93040000,1501,500,1001,500,0,1,502,836460,0.83646
6100,1300,500,7930000,2,4006,1003,1,93040000,93040000,1501,500,1001,500,0,1,502,823176,0.823176
6100,1300,500,7930000,2,4006,1003,1,93040000,93040000,1501,500,1001,500,0,1,502,842513,0.842513
6100,1300,900,7930000,2,7206,1803,1,116720000,116720000,2701,900,1801,900,0,1,902,1405811,1.405811
6100,1300,900,7930000,2,7206,1803,1,116720000,116720000,2701,900,1801,900,0,1,902,1445782,1.445782
6100,1300,900,7930000,2,7206,1803,1,116720000,116720000,2701,900,1801,900,0,1,902,1439608,1.439608
6100,1300,900,7930000,2,7206,1803,1,116720000,116720000,2701,900,1801,900,0,1,902,1429910,1.42991
6100,1300,900,7930000,2,7206,1803,1,116720000,116720000,2701,900,1801,900,0,1,902,1406171,1.406171
6100,1300,900,7930000,2,7206,1803,1,116720000,116720000,2701,900,1801,900,0,1,902,1446140,1.44614
6100,1300,900,7930000,2,7206,1803,1,116720000,116720000,2701,900,1801,900,0,1,902,1400007,1.400007
6100,1300,900,7930000,2,7206,1803,1,116720000,116720000,2701,900,1801,900,0,1,902,1455090,1.45509
6100,1300,1300,7930000,2,10406,2603,1,140400000,140400000,3901,1300,2601,1300,0,1,1302,1995413,1.995413
6100,1300,1300,7930000,2,10406,2603,1,140400000,140400000,3901,1300,2601,1300,0,1,1302,2060909,2.060909
6100,1300,1300,7930000,2,10406,2603,1,140400000,140400000,3901,1300,2601,1300,0,1,1302,2026145,2.026145
6100,1300,1300,7930000,2,10406,2603,1,140400000,140400000,3901,1300,2601,1300,0,1,1302,2032197,2.032197
6100,1300,1300,7930000,2,10406,2603,1,140400000,140400000,3901,1300,2601,1300,0,1,1302,1989578,1.989578
6100,1300,1300,7930000,2,10406,2603,1,140400000,140400000,3901,1300,2601,1300,0,1,1302,2053578,2.053578
6100,1300,1300,7930000,2,10406,2603,1,140400000,140400000,3901,1300,2601,1300,0,1,1302,1983870,1.98387
6100,1300,1300,7930000,2,10406,2603,1,140400000,140400000,3901,1300,2601,1300,0,1,1302,2075809,2.075809
6100,1300,1700,7930000,2,13606,3403,1,164080000,164080000,5101,1700,3401,1700,0,1,1702,2590191,2.590191
6100,1300,1700,7930000,2,13606,3403,1,164080000,164080000,5101,1700,3401,1700,0,1,1702,2685186,2.685186
6100,1300,1700,7930000,2,13606,3403,1,164080000,164080000,5101,1700,3401,1700,0,1,1702,2630297,2.630297
6100,1300,1700,7930000,2,13606,3403,1,164080000,164080000,5101,1700,3401,1700,0,1,1702,2636243,2.636243
6100,1300,1700,7930000,2,13606,3403,1,164080000,164080000,5101,1700,3401,1700,0,1,1702,2572919,2.572919
6100,1300,1700,7930000,2,13606,3403,1,164080000,164080000,5101,1700,3401,1700,0,1,1702,2672595,2.672595
6100,1300,1700,7930000,2,13606,3403,1,164080000,164080000,5101,1700,3401,1700,0,1,1702,2565495,2.565495
6100,1300,1700,7930000,2,13606,3403,1,164080000,164080000,5101,1700,3401,1700,0,1,1702,2705835,2.705835
6100,1300,2100,7930000,2,16806,4203,1,187760000,187760000,6301,2100,4201,2100,0,1,2102,3336078,3.336078
6100,1300,2100,7930000,2,16806,4203,1,187760000,187760000,6301,2100,4201,2100,0,1,2102,3432921,3.432921
6100,1300,2100,7930000,2,16806,4203,1,187760000,187760000,6301,2100,4201,2100,0,1,2102,3357822,3.357822
6100,1300,2100,7930000,2,16806,4203,1,187760000,187760000,6301,2100,4201,2100,0,1,2102,3375876,3.375876
6100,1300,2100,7930000,2,16806,4203,1,187760000,187760000,6301,2100,4201,2100,0,1,2102,3336429,3.336429
6100,1300,2100,7930000,2,16806,4203,1,187760000,187760000,6301,2100,4201,2100,0,1,2102,3409528,3.409528
6100,1300,2100,7930000,2,16806,4203,1,187760000,187760000,6301,2100,4201,2100,0,1,2102,3306468,3.306468
6100,1300,2100,7930000,2,16806,4203,1,187760000,187760000,6301,2100,4201,2100,0,1,2102,3462479,3.462479
6100,1300,2500,7930000,2,20006,5003,1,211440000,211440000,7501,2500,5001,2500,0,1,2502,3776873,3.776873
6100,1300,2500,7930000,2,20006,5003,1,211440000,211440000,7501,2500,5001,2500,0,1,2502,3916284,3.916284
6100,1300,2500,7930000,2,20006,5003,1,211440000,211440000,7501,2500,5001,2500,0,1,2502,3819035,3.819035
6100,1300,2500,7930000,2,20006,5003,1,211440000,211440000,7501,2500,5001,2500,0,1,2502,3836580,3.83658
6100,1300,2500,7930000,2,20006,5003,1,211440000,211440000,7501,2500,5001,2500,0,1,2502,3734488,3.734488
6100,1300,2500,7930000,2,20006,5003,1,211440000,211440000,7501,2500,5001,2500,0,1,2502,3910533,3.910533
6100,1300,2500,7930000,2,20006,5003,1,211440000,211440000,7501,2500,5001,2500,0,1,2502,3714927,3.714927
6100,1300,2500,7930000,2,20006,5003,1,211440000,211440000,7501,2500,5001,2500,0,1,2502,3943647,3.943647
6100,1300,2900,7930000,2,23206,5803,1,235120000,235120000,8701,2900,5801,2900,0,1,2902,4371907,4.371907
6100,1300,2900,7930000,2,23206,5803,1,235120000,235120000,8701,2900,5801,2900,0,1,2902,4527625,4.527625
6100,1300,2900,7930000,2,23206,5803,1,235120000,235120000,8701,2900,5801,2900,0,1,2902,4418540,4.41854
6100,1300,2900,7930000,2,23206,5803,1,235120000,235120000,8701,2900,5801,2900,0,1,2902,4449423,4.449423
6100,1300,2900,7930000,2,23206,5803,1,235120000,235120000,8701,2900,5801,2900,0,1,2902,4345116,4.345116
6100,1300,2900,7930000,2,23206,5803,1,235120000,235120000,8701,2900,5801,2900,0,1,2902,4507873,4.507873
6100,1300,2900,7930000,2,23206,5803,1,235120000,235120000,8701,2900,5801,2900,0,1,2902,4317023,4.317023
6100,1300,2900,7930000,2,23206,5803,1,235120000,235120000,8701,2900,5801,2900,0,1,2902,4561268,4.561268
6100,1300,3300,7930000,2,26406,6603,1,258800000,258800000,9901,3300,6601,3300,0,1,3302,4962635,4.962635
6100,1300,3300,7930000,2,26406,6603,1,258800000,258800000,9901,3300,6601,3300,0,1,3302,5143094,5.143094
6100,1300,3300,7930000,2,26406,6603,1,258800000,258800000,9901,3300,6601,3300,0,1,3302,5014644,5.014644
6100,1300,3300,7930000,2,26406,6603,1,258800000,258800000,9901,3300,6601,3300,0,1,3302,5063708,5.063708
6100,1300,3300,7930000,2,26406,6603,1,258800000,258800000,9901,3300,6601,3300,0,1,3302,4922862,4.922862
6100,1300,3300,7930000,2,26406,6603,1,258800000,258800000,9901,3300,6601,3300,0,1,3302,5160072,5.160072
6100,1300,3300,7930000,2,26406,6603,1,258800000,258800000,9901,3300,6601,3300,0,1,3302,4912912,4.912912
6100,1300,3300,7930000,2,26406,6603,1,258800000,258800000,9901,3300,6601,3300,0,1,3302,5197536,5.197536
6100,1300,3700,7930000,2,29606,7403,1,282480000,282480000,11101,3700,7401,3700,0,1,3702,5552049,5.552049
6100,1300,3700,7930000,2,29606,7403,1,282480000,282480000,11101,3700,7401,3700,0,1,3702,5746908,5.746908
6100,1300,3700,7930000,2,29606,7403,1,282480000,282480000,11101,3700,7401,3700,0,1,3702,5607294,5.607294
6100,1300,3700,7930000,2,29606,7403,1,282480000,282480000,11101,3700,7401,3700,0,1,3702,5667619,5.667619
6100,1300,3700,7930000,2,29606,7403,1,282480000,282480000,11101,3700,7401,3700,0,1,3702,5506009,5.506009
6100,1300,3700,7930000,2,29606,7403,1,282480000,282480000,11101,3700,7401,3700,0,1,3702,5760879,5.760879
6100,1300,3700,7930000,2,29606,7403,1,282480000,282480000,11101,3700,7401,3700,0,1,3702,5483472,5.483472
6100,1300,3700,7930000,2,29606,7403,1,282480000,282480000,11101,3700,7401,3700,0,1,3702,5811761,5.811761
6100,1300,4100,7930000,2,32806,8203,1,306160000,306160000,12301,4100,8201,4100,0,1,4102,6302340,6.30234
6100,1300,4100,7930000,2,32806,8203,1,306160000,306160000,12301,4100,8201,4100,0,1,4102,6501064,6.501064
6100,1300,4100,7930000,2,32806,8203,1,306160000,306160000,12301,4100,8201,4100,0,1,4102,6345584,6.345584
6100,1300,4100,7930000,2,32806,8203,1,306160000,306160000,12301,4100,8201,4100,0,1,4102,6409802,6.409802
6100,1300,4100,7930000,2,32806,8203,1,306160000,306160000,12301,4100,8201,4100,0,1,4102,6261185,6.261185
6100,1300,4100,7930000,2,32806,8203,1,306160000,306160000,12301,4100,8201,4100,0,1,4102,6511584,6.511584
6100,1300,4100,7930000,2,32806,8203,1,306160000,306160000,12301,4100,8201,4100,0,1,4102,6234660,6.23466
6100,1300,4100,7930000,2,32806,8203,1,306160000,306160000,12301,4100,8201,4100,0,1,4102,6534684,6.534684
6100,1300,4500,7930000,2,36006,9003,1,329840000,329840000,13501,4500,9001,4500,0,1,4502,6744966,6.744966
6100,1300,4500,7930000,2,36006,9003,1,329840000,329840000,13501,4500,9001,4500,0,1,4502,6979736,6.979736
6100,1300,4500,7930000,2,36006,9003,1,329840000,329840000,13501,4500,9001,4500,0,1,4502,6800970,6.80097
6100,1300,4500,7930000,2,36006,9003,1,329840000,329840000,13501,4500,9001,4500,0,1,4502,6879580,6.87958
6100,1300,4500,7930000,2,36006,9003,1,329840000,329840000,13501,4500,9001,4500,0,1,4502,6688600,6.6886
6100,1300,4500,7930000,2,36006,9003,1,329840000,329840000,13501,4500,9001,4500,0,1,4502,6990261,6.990261
6100,1300,4500,7930000,2,36006,9003,1,329840000,329840000,13501,4500,9001,4500,0,1,4502,6667940,6.66794
6100,1300,4500,7930000,2,36006,9003,1,329840000,329840000,13501,4500,9001,4500,0,1,4502,7059814,7.059814
6100,1300,4900,7930000,2,39206,9803,1,353520000,353520000,14701,4900,9801,4900,0,1,4902,7469857,7.469857
6100,1300,4900,7930000,2,39206,9803,1,353520000,353520000,14701,4900,9801,4900,0,1,4902,7699890,7.69989
6100,1300,4900,7930000,2,39206,9803,1,353520000,353520000,14701,4900,9801,4900,0,1,4902,7561537,7.561537
6100,1300,4900,7930000,2,39206,9803,1,353520000,353520000,14701,4900,9801,4900,0,1,4902,7583965,7.583965
6100,1300,4900,7930000,2,39206,9803,1,353520000,353520000,14701,4900,9801,4900,0,1,4902,7437508,7.437508
6100,1300,4900,7930000,2,39206,9803,1,353520000,353520000,14701,4900,9801,4900,0,1,4902,7710590,7.71059
6100,1300,4900,7930000,2,39206,9803,1,353520000,353520000,14701,4900,9801,4900,0,1,4902,7425706,7.425706
6100,1300,4900,7930000,2,39206,9803,1,353520000,353520000,14701,4900,9801,4900,0,1,4902,7794296,7.794296
6100,1300,5300,7930000,2,42406,10603,1,377200000,377200000,15901,5300,10601,5300,0,1,5302,7938540,7.93854
6100,1300,5300,7930000,2,42406,10603,1,377200000,377200000,15901,5300,10601,5300,0,1,5302,8221589,8.221589
6100,1300,5300,7930000,2,42406,10603,1,377200000,377200000,15901,5300,10601,5300,0,1,5302,8007975,8.007975
6100,1300,5300,7930000,2,42406,10603,1,377200000,377200000,15901,5300,10601,5300,0,1,5302,8106949,8.106949
6100,1300,5300,7930000,2,42406,10603,1,377200000,377200000,15901,5300,10601,5300,0,1,5302,7870638,7.870638
6100,1300,5300,7930000,2,42406,10603,1,377200000,377200000,15901,5300,10601,5300,0,1,5302,8233559,8.233559
6100,1300,5300,7930000,2,42406,10603,1,377200000,377200000,15901,5300,10601,5300,0,1,5302,7840997,7.840997
6100,1300,5300,7930000,2,42406,10603,1,377200000,377200000,15901,5300,10601,5300,0,1,5302,8301691,8.301691
6100,1300,5700,7930000,2,45606,11403,1,400880000,400880000,17101,5700,11401,5700,0,1,5702,8679219,8.679219
6100,1300,5700,7930000,2,45606,11403,1,400880000,400880000,17101,5700,11401,5700,0,1,5702,8970479,8.970479
6100,1300,5700,7930000,2,45606,11403,1,400880000,400880000,17101,5700,11401,5700,0,1,5702,8743508,8.743508
6100,1300,5700,7930000,2,45606,11403,1,400880000,400880000,17101,5700,11401,5700,0,1,5702,8839544,8.839544
6100,1300,5700,7930000,2,45606,11403,1,400880000,400880000,17101,5700,11401,5700,0,1,5702,8597909,8.597909
6100,1300,5700,7930000,2,45606,11403,1,400880000,400880000,17101,5700,11401,5700,0,1,5702,8976708,8.976708
6100,1300,5700,7930000,2,45606,11403,1,400880000,400880000,17101,5700,11401,5700,0,1,5702,8584711,8.584711
6100,1300,5700,7930000,2,45606,11403,1,400880000,400880000,17101,5700,11401,5700,0,1,5702,9027703,9.027703
6100,1300,6100,7930000,2,48806,12203,1,424560000,424560000,18301,6100,12201,6100,0,1,6102,9119782,9.119782
6100,1300,6100,7930000,2,48806,12203,1,424560000,424560000,18301,6100,12201,6100,0,1,6102,9451184,9.451184
6100,1300,6100,7930000,2,48806,12203,1,424560000,424560000,18301,6100,12201,6100,0,1,6102,9336023,9.336023
6100,1300,6100,7930000,2,48806,12203,1,424560000,424560000,18301,6100,12201,6100,0,1,6102,9439299,9.439299
6100,1300,6100,7930000,2,48806,12203,1,424560000,424560000,18301,6100,12201,6100,0,1,6102,9041694,9.041694
6100,1300,6100,7930000,2,48806,12203,1,424560000,424560000,18301,6100,12201,6100,0,1,6102,9601059,9.601059
6100,1300,6100,7930000,2,48806,12203,1,424560000,424560000,18301,6100,12201,6100,0,1,6102,9016070,9.01607
6100,1300,6100,7930000,2,48806,12203,1,424560000,424560000,18301,6100,12201,6100,0,1,6102,9559375,9.559375
6100,1300,6500,7930000,2,52006,13003,1,448240000,448240000,19501,6500,13001,6500,0,1,6502,9883226,9.883226
6100,1300,6500,7930000,2,52006,13003,1,448240000,448240000,19501,6500,13001,6500,0,1,6502,10160311,10.160311
6100,1300,6500,7930000,2,52006,13003,1,448240000,448240000,19501,6500,13001,6500,0,1,6502,9823324,9.823324
6100,1300,6500,7930000,2,52006,13003,1,448240000,448240000,19501,6500,13001,6500,0,1,6502,9929335,9.929335
6100,1300,6500,7930000,2,52006,13003,1,448240000,448240000,19501,6500,13001,6500,0,1,6502,9780381,9.780381
6100,1300,6500,7930000,2,52006,13003,1,448240000,448240000,19501,6500,13001,6500,0,1,6502,10075366,10.075366
6100,1300,6500,7930000,2,52006,13003,1,448240000,448240000,19501,6500,13001,6500,0,1,6502,9774051,9.774051
6100,1300,6500,7930000,2,52006,13003,1,448240000,448240000,19501,6500,13001,6500,0,1,6502,10271498,10.271498
6100,1300,6900,7930000,2,55206,13803,1,471920000,471920000,20701,6900,13801,6900,0,1,6902,10436296,10.436296
6100,1300,6900,7930000,2,55206,13803,1,471920000,471920000,20701,6900,13801,6900,0,1,6902,10776175,10.776175
6100,1300,6900,7930000,2,55206,13803,1,471920000,471920000,20701,6900,13801,6900,0,1,6902,10532564,10.532564
6100,1300,6900,7930000,2,55206,13803,1,471920000,471920000,20701,6900,13801,6900,0,1,6902,10656476,10.656476
6100,1300,6900,7930000,2,55206,13803,1,471920000,471920000,20701,6900,13801,6900,0,1,6902,10395922,10.395922
6100,1300,6900,7930000,2,55206,13803,1,471920000,471920000,20701,6900,13801,6900,0,1,6902,10805070,10.80507
6100,1300,6900,7930000,2,55206,13803,1,471920000,471920000,20701,6900,13801,6900,0,1,6902,10361304,10.361304
6100,1300,6900,7930000,2,55206,13803,1,471920000,471920000,20701,6900,13801,6900,0,1,6902,10908587,10.908587
6100,900,500,5490000,2,4006,1003,1,71920000,71920000,1501,500,1001,500,0,1,502,581631,0.581631
6100,900,500,5490000,2,4006,1003,1,71920000,71920000,1501,500,1001,500,0,1,502,590321,0.590321
6100,900,500,5490000,2,4006,1003,1,71920000,71920000,1501,500,1001,500,0,1,502,586383,0.586383
6100,900,500,5490000,2,4006,1003,1,71920000,71920000,1501,500,1001,500,0,1,502,569517,0.569517
6100,900,500,5490000,2,4006,1003,1,71920000,71920000,1501,500,1001,500,0,1,502,565279,0.565279
6100,900,500,5490000,2,4006,1003,1,71920000,71920000,1501,500,1001,500,0,1,502,586048,0.586048
6100,900,500,5490000,2,4006,1003,1,71920000,71920000,1501,500,1001,500,0,1,502,569269,0.569269
6100,900,500,5490000,2,4006,1003,1,71920000,71920000,1501,500,1001,500,0,1,502,586506,0.586506
6100,900,900,5490000,2,7206,1803,1,94320000,94320000,2701,900,1801,900,0,1,902,982403,0.982403
6100,900,900,5490000,2,7206,1803,1,94320000,94320000,2701,900,1801,900,0,1,902,1019036,1.019036
6100,900,900,5490000,2,7206,1803,1,94320000,94320000,2701,900,1801,900,0,1,902,998025,0.998025
6100,900,900,5490000,2,7206,1803,1,94320000,94320000,2701,900,1801,900,0,1,902,1002316,1.002316
6100,900,900,5490000,2,7206,1803,1,94320000,94320000,2701,900,1801,900,0,1,902,986607,0.986607
6100,900,900,5490000,2,7206,1803,1,94320000,94320000,2701,900,1801,900,0,1,902,1014064,1.014064
6100,900,900,5490000,2,7206,1803,1,94320000,94320000,2701,900,1801,900,0,1,902,977437,0.977437
6100,900,900,5490000,2,7206,1803,1,94320000,94320000,2701,900,1801,900,0,1,902,1025412,1.025412
6100,900,1300,5490000,2,10406,2603,1,116720000,116720000,3901,1300,2601,1300,0,1,1302,1398222,1.398222
6100,900,1300,5490000,2,10406,2603,1,116720000,116720000,3901,1300,2601,1300,0,1,1302,1449393,1.449393
6100,900,1300,5490000,2,10406,2603,1,116720000,116720000,3901,1300,2601,1300,0,1,1302,1432628,1.432628
6100,900,1300,5490000,2,10406,2603,1,116720000,116720000,3901,1300,2601,1300,0,1,1302,1443428,1.443428
6100,900,1300,5490000,2,10406,2603,1,116720000,116720000,3901,1300,2601,1300,0,1,1302,1398566,1.398566
6100,900,1300,5490000,2,10406,2603,1,116720000,116720000,3901,1300,2601,1300,0,1,1302,1443810,1.44381
6100,900,1300,5490000,2,10406,2603,1,116720000,116720000,3901,1300,2601,1300,0,1,1302,1393946,1.393946
6100,900,1300,5490000,2,10406,2603,1,116720000,116720000,3901,1300,2601,1300,0,1,1302,1456878,1.456878
6100,900,1700,5490000,2,13606,3403,1,139120000,139120000,5101,1700,3401,1700,0,1,1702,1800999,1.800999
6100,900,1700,5490000,2,13606,3403,1,139120000,139120000,5101,1700,3401,1700,0,1,1702,1844747,1.844747
6100,900,1700,5490000,2,13606,3403,1,139120000,139120000,5101,1700,3401,1700,0,1,1702,1839214,1.839214
6100,900,1700,5490000,2,13606,3403,1,139120000,139120000,5101,1700,3401,1700,0,1,1702,1855698,1.855698
6100,900,1700,5490000,2,13606,3403,1,139120000,139120000,5101,1700,3401,1700,0,1,1702,1805040,1.80504
6100,900,1700,5490000,2,13606,3403,1,139120000,139120000,5101,1700,3401,1700,0,1,1702,1863085,1.863085
6100,900,1700,5490000,2,13606,3403,1,139120000,139120000,5101,1700,3401,1700,0,1,1702,1800620,1.80062
6100,900,1700,5490000,2,13606,3403,1,139120000,139120000,5101,1700,3401,1700,0,1,1702,1876013,1.876013
6100,900,2100,5490000,2,16806,4203,1,161520000,161520000,6301,2100,4201,2100,0,1,2102,2215567,2.215567
6100,900,2100,5490000,2,16806,4203,1,161520000,161520000,6301,2100,4201,2100,0,1,2102,2292806,2.292806
6100,900,2100,5490000,2,16806,4203,1,161520000,161520000,6301,2100,4201,2100,0,1,2102,2238370,2.23837
6100,900,2100,5490000,2,16806,4203,1,161520000,161520000,6301,2100,4201,2100,0,1,2102,2254553,2.254553
6100,900,2100,5490000,2,16806,4203,1,161520000,161520000,6301,2100,4201,2100,0,1,2102,2219645,2.219645
6100,900,2100,5490000,2,16806,4203,1,161520000,161520000,6301,2100,4201,2100,0,1,2102,2285067,2.285067
6100,900,2100,5490000,2,16806,4203,1,161520000,161520000,6301,2100,4201,2100,0,1,2102,2194829,2.194829
6100,900,2100,5490000,2,16806,4203,1,161520000,161520000,6301,2100,4201,2100,0,1,2102,2310332,2.310332
6100,900,2500,5490000,2,20006,5003,1,183920000,183920000,7501,2500,5001,2500,0,1,2502,2635742,2.635742
6100,900,2500,5490000,2,20006,5003,1,183920000,183920000,7501,2500,5001,2500,0,1,2502,2725403,2.725403
6100,900,2500,5490000,2,20006,5003,1,183920000,183920000,7501,2500,5001,2500,0,1,2502,2809645,2.809645
6100,900,2500,5490000,2,20006,5003,1,183920000,183920000,7501,2500,5001,2500,0,1,2502,2763031,2.763031
6100,900,2500,5490000,2,20006,5003,1,183920000,183920000,7501,2500,5001,2500,0,1,2502,2616820,2.61682
6100,900,2500,5490000,2,20006,5003,1,183920000,183920000,7501,2500,5001,2500,0,1,2502,2805568,2.805568
6100,900,2500,5490000,2,20006,5003,1,183920000,183920000,7501,2500,5001,2500,0,1,2502,2620933,2.620933
6100,900,2500,5490000,2,20006,5003,1,183920000,183920000,7501,2500,5001,2500,0,1,2502,2758699,2.758699
6100,900,2900,5490000,2,23206,5803,1,206320000,206320000,8701,2900,5801,2900,0,1,2902,3046082,3.046082
6100,900,2900,5490000,2,23206,5803,1,206320000,206320000,8701,2900,5801,2900,0,1,2902,3158517,3.158517
6100,900,2900,5490000,2,23206,5803,1,206320000,206320000,8701,2900,5801,2900,0,1,2902,3081077,3.081077
6100,900,2900,5490000,2,23206,5803,1,206320000,206320000,8701,2900,5801,2900,0,1,2902,3099538,3.099538
6100,900,2900,5490000,2,23206,5803,1,206320000,206320000,8701,2900,5801,2900,0,1,2902,3019604,3.019604
6100,900,2900,5490000,2,23206,5803,1,206320000,206320000,8701,2900,5801,2900,0,1,2902,3154107,3.154107
6100,900,2900,5490000,2,23206,5803,1,206320000,206320000,8701,2900,5801,2900,0,1,2902,3010902,3.010902
6100,900,2900,5490000,2,23206,5803,1,206320000,206320000,8701,2900,5801,2900,0,1,2902,3182781,3.182781
6100,900,3300,5490000,2,26406,6603,1,228720000,228720000,9901,3300,6601,3300,0,1,3302,3606514,3.606514
6100,900,3300,5490000,2,26406,6603,1,228720000,228720000,9901,3300,6601,3300,0,1,3302,3718240,3.71824
6100,900,3300,5490000,2,26406,6603,1,228720000,228720000,9901,3300,6601,3300,0,1,3302,3498570,3.49857
6100,900,3300,5490000,2,26406,6603,1,228720000,228720000,9901,3300,6601,3300,0,1,3302,3530166,3.530166
6100,900,3300,5490000,2,26406,6603,1,228720000,228720000,9901,3300,6601,3300,0,1,3302,3487924,3.487924
6100,900,3300,5490000,2,26406,6603,1,228720000,228720000,9901,3300,6601,3300,0,1,3302,3599340,3.59934
6100,900,3300,5490000,2,26406,6603,1,228720000,228720000,9901,3300,6601,3300,0,1,3302,3588956,3.588956
6100,900,3300,5490000,2,26406,6603,1,228720000,228720000,9901,3300,6601,3300,0,1,3302,3713898,3.713898
6100,900,3700,5490000,2,29606,7403,1,251120000,251120000,11101,3700,7401,3700,0,1,3702,3879485,3.879485
6100,900,3700,5490000,2,29606,7403,1,251120000,251120000,11101,3700,7401,3700,0,1,3702,4015177,4.015177
6100,900,3700,5490000,2,29606,7403,1,251120000,251120000,11101,3700,7401,3700,0,1,3702,3913873,3.913873
6100,900,3700,5490000,2,29606,7403,1,251120000,251120000,11101,3700,7401,3700,0,1,3702,3953858,3.953858
6100,900,3700,5490000,2,29606,7403,1,251120000,251120000,11101,3700,7401,3700,0,1,3702,3853084,3.853084
6100,900,3700,5490000,2,29606,7403,1,251120000,251120000,11101,3700,7401,3700,0,1,3702,4011057,4.011057
6100,900,3700,5490000,2,29606,7403,1,251120000,251120000,11101,3700,7401,3700,0,1,3702,3834834,3.834834
6100,900,3700,5490000,2,29606,7403,1,251120000,251120000,11101,3700,7401,3700,0,1,3702,4055563,4.055563
6100,900,4100,5490000,2,32806,8203,1,273520000,273520000,12301,4100,8201,4100,0,1,4102,4290456,4.290456
6100,900,4100,5490000,2,32806,8203,1,273520000,273520000,12301,4100,8201,4100,0,1,4102,4436963,4.436963
6100,900,4100,5490000,2,32806,8203,1,273520000,273520000,12301,4100,8201,4100,0,1,4102,4330228,4.330228
6100,900,4100,5490000,2,32806,8203,1,273520000,273520000,12301,4100,8201,4100,0,1,4102,4377896,4.377896
6100,900,4100,5490000,2,32806,8203,1,273520000,273520000,12301,4100,8201,4100,0,1,4102,4252329,4.252329
6100,900,4100,5490000,2,32806,8203,1,273520000,273520000,12301,4100,8201,4100,0,1,4102,4445586,4.445586
6100,900,4100,5490000,2,32806,8203,1,273520000,273520000,12301,4100,8201,4100,0,1,4102,4245523,4.245523
6100,900,4100,5490000,2,32806,8203,1,273520000,273520000,12301,4100,8201,4100,0,1,4102,4494872,4.494872
6100,900,4500,5490000,2,36006,9003,1,295920000,295920000,13501,4500,9001,4500,0,1,4502,4704951,4.704951
6100,900,4500,5490000,2,36006,9003,1,295920000,295920000,13501,4500,9001,4500,0,1,4502,4877404,4.877404
6100,900,4500,5490000,2,36006,9003,1,295920000,295920000,13501,4500,9001,4500,0,1,4502,4758884,4.758884
6100,900,4500,5490000,2,36006,9003,1,295920000,295920000,13501,4500,9001,4500,0,1,4502,4816160,4.81616
6100,900,4500,5490000,2,36006,9003,1,295920000,295920000,13501,4500,9001,4500,0,1,4502,4700730,4.70073
6100,900,4500,5490000,2,36006,9003,1,295920000,295920000,13501,4500,9001,4500,0,1,4502,4881800,4.8818
6100,900,4500,5490000,2,36006,9003,1,295920000,295920000,13501,4500,9001,4500,0,1,4502,4663613,4.663613
6100,900,4500,5490000,2,36006,9003,1,295920000,295920000,13501,4500,9001,4500,0,1,4502,4934567,4.934567
6100,900,4900,5490000,2,39206,9803,1,318320000,318320000,14701,4900,9801,4900,0,1,4902,5273530,5.27353
6100,900,4900,5490000,2,39206,9803,1,318320000,318320000,14701,4900,9801,4900,0,1,4902,5407823,5.407823
6100,900,4900,5490000,2,39206,9803,1,318320000,318320000,14701,4900,9801,4900,0,1,4902,5308107,5.308107
6100,900,4900,5490000,2,39206,9803,1,318320000,318320000,14701,4900,9801,4900,0,1,4902,5358550,5.35855
6100,900,4900,5490000,2,39206,9803,1,318320000,318320000,14701,4900,9801,4900,0,1,4902,5246077,5.246077
6100,900,4900,5490000,2,39206,9803,1,318320000,318320000,14701,4900,9801,4900,0,1,4902,5423248,5.423248
6100,900,4900,5490000,2,39206,9803,1,318320000,318320000,14701,4900,9801,4900,0,1,4902,5260430,5.26043
6100,900,4900,5490000,2,39206,9803,1,318320000,318320000,14701,4900,9801,4900,0,1,4902,5450900,5.4509
6100,900,5300,5490000,2,42406,10603,1,340720000,340720000,15901,5300,10601,5300,0,1,5302,5529685,5.529685
6100,900,5300,5490000,2,42406,10603,1,340720000,340720000,15901,5300,10601,5300,0,1,5302,5731354,5.731354
6100,900,5300,5490000,2,42406,10603,1,340720000,340720000,15901,5300,10601,5300,0,1,5302,5585484,5.585484
6100,900,5300,5490000,2,42406,10603,1,340720000,340720000,15901,5300,10601,5300,0,1,5302,5655427,5.655427
6100,900,5300,5490000,2,42406,10603,1,340720000,340720000,15901,5300,10601,5300,0,1,5302,5514862,5.514862
6100,900,5300,5490000,2,42406,10603,1,340720000,340720000,15901,5300,10601,5300,0,1,5302,5720549,5.720549
6100,900,5300,5490000,2,42406,10603,1,340720000,340720000,15901,5300,10601,5300,0,1,5302,5483933,5.483933
6100,900,5300,5490000,2,42406,10603,1,340720000,340720000,15901,5300,10601,5300,0,1,5302,5791117,5.791117
6100,900,5700,5490000,2,45606,11403,1,363120000,363120000,17101,5700,11401,5700,0,1,5702,5946933,5.946933
6100,900,5700,5490000,2,45606,11403,1,363120000,363120000,17101,5700,11401,5700,0,1,5702,6171143,6.171143
6100,900,5700,5490000,2,45606,11403,1,363120000,363120000,17101,5700,11401,5700,0,1,5702,6001227,6.001227
6100,900,5700,5490000,2,45606,11403,1,363120000,363120000,17101,5700,11401,5700,0,1,5702,6072048,6.072048
6100,900,5700,5490000,2,45606,11403,1,363120000,363120000,17101,5700,11401,5700,0,1,5702,5927383,5.927383
6100,900,5700,5490000,2,45606,11403,1,363120000,363120000,17101,5700,11401,5700,0,1,5702,6157415,6.157415
6100,900,5700,5490000,2,45606,11403,1,363120000,363120000,17101,5700,11401,5700,0,1,5702,5881727,5.881727
6100,900,5700,5490000,2,45606,11403,1,363120000,363120000,17101,5700,11401,5700,0,1,5702,6231405,6.231405
6100,900,6100,5490000,2,48806,12203,1,385520000,385520000,18301,6100,12201,6100,0,1,6102,6519420,6.51942
6100,900,6100,5490000,2,48806,12203,1,385520000,385520000,18301,6100,12201,6100,0,1,6102,6739978,6.739978
6100,900,6100,5490000,2,48806,12203,1,385520000,385520000,18301,6100,12201,6100,0,1,6102,6576031,6.576031
6100,900,6100,5490000,2,48806,12203,1,385520000,385520000,18301,6100,12201,6100,0,1,6102,6629877,6.629877
6100,900,6100,5490000,2,48806,12203,1,385520000,385520000,18301,6100,12201,6100,0,1,6102,6527555,6.527555
6100,900,6100,5490000,2,48806,12203,1,385520000,385520000,18301,6100,12201,6100,0,1,6102,6711332,6.711332
6100,900,6100,5490000,2,48806,12203,1,385520000,385520000,18301,6100,12201,6100,0,1,6102,6458469,6.458469
6100,900,6100,5490000,2,48806,12203,1,385520000,385520000,18301,6100,12201,6100,0,1,6102,6760106,6.760106
6100,900,6500,5490000,2,52006,13003,1,407920000,407920000,19501,6500,13001,6500,0,1,6502,6767060,6.76706
6100,900,6500,5490000,2,52006,13003,1,407920000,407920000,19501,6500,13001,6500,0,1,6502,7017334,7.017334
6100,900,6500,5490000,2,52006,13003,1,407920000,407920000,19501,6500,13001,6500,0,1,6502,6826473,6.826473
6100,900,6500,5490000,2,52006,13003,1,407920000,407920000,19501,6500,13001,6500,0,1,6502,6923044,6.923044
6100,900,6500,5490000,2,52006,13003,1,407920000,407920000,19501,6500,13001,6500,0,1,6502,6750699,6.750699
6100,900,6500,5490000,2,52006,13003,1,407920000,407920000,19501,6500,13001,6500,0,1,6502,7007108,7.007108
6100,900,6500,5490000,2,52006,13003,1,407920000,407920000,19501,6500,13001,6500,0,1,6502,6713942,6.713942
6100,900,6500,5490000,2,52006,13003,1,407920000,407920000,19501,6500,13001,6500,0,1,6502,7090745,7.090745
6100,900,6900,5490000,2,55206,13803,1,430320000,430320000,20701,6900,13801,6900,0,1,6902,7360536,7.360536
6100,900,6900,5490000,2,55206,13803,1,430320000,430320000,20701,6900,13801,6900,0,1,6902,7532729,7.532729
6100,900,6900,5490000,2,55206,13803,1,430320000,430320000,20701,6900,13801,6900,0,1,6902,7413582,7.413582
6100,900,6900,5490000,2,55206,13803,1,430320000,430320000,20701,6900,13801,6900,0,1,6902,7480167,7.480167
6100,900,6900,5490000,2,55206,13803,1,430320000,430320000,20701,6900,13801,6900,0,1,6902,7313002,7.313002
6100,900,6900,5490000,2,55206,13803,1,430320000,430320000,20701,6900,13801,6900,0,1,6902,7605187,7.605187
6100,900,6900,5490000,2,55206,13803,1,430320000,430320000,20701,6900,13801,6900,0,1,6902,7308168,7.308168
6100,900,6900,5490000,2,55206,13803,1,430320000,430320000,20701,6900,13801,6900,0,1,6902,7643535,7.643535
6100,500,500,3050000,2,4006,1003,1,50800000,50800000,1501,500,1001,500,0,1,502,327205,0.327205
6100,500,500,3050000,2,4006,1003,1,50800000,50800000,1501,500,1001,500,0,1,502,326887,0.326887
6100,500,500,3050000,2,4006,1003,1,50800000,50800000,1501,500,1001,500,0,1,502,327094,0.327094
6100,500,500,3050000,2,4006,1003,1,50800000,50800000,1501,500,1001,500,0,1,502,309488,0.309488
6100,500,500,3050000,2,4006,1003,1,50800000,50800000,1501,500,1001,500,0,1,502,314728,0.314728
6100,500,500,3050000,2,4006,1003,1,50800000,50800000,1501,500,1001,500,0,1,502,324574,0.324574
6100,500,500,3050000,2,4006,1003,1,50800000,50800000,1501,500,1001,500,0,1,502,304985,0.304985
6100,500,500,3050000,2,4006,1003,1,50800000,50800000,1501,500,1001,500,0,1,502,330138,0.330138
6100,500,900,3050000,2,7206,1803,1,71920000,71920000,2701,900,1801,900,0,1,902,555121,0.555121
6100,500,900,3050000,2,7206,1803,1,71920000,71920000,2701,900,1801,900,0,1,902,563205,0.563205
6100,500,900,3050000,2,7206,1803,1,71920000,71920000,2701,900,1801,900,0,1,902,558054,0.558054
6100,500,900,3050000,2,7206,1803,1,71920000,71920000,2701,900,1801,900,0,1,902,552140,0.55214
6100,500,900,3050000,2,7206,1803,1,71920000,71920000,2701,900,1801,900,0,1,902,554764,0.554764
6100,500,900,3050000,2,7206,1803,1,71920000,71920000,2701,900,1801,900,0,1,902,565743,0.565743
6100,500,900,3050000,2,7206,1803,1,71920000,71920000,2701,900,1801,900,0,1,902,543412,0.543412
6100,500,900,3050000,2,7206,1803,1,71920000,71920000,2701,900,1801,900,0,1,902,568243,0.568243
6100,500,1300,3050000,2,10406,2603,1,93040000,93040000,3901,1300,2601,1300,0,1,1302,785267,0.785267
6100,500,1300,3050000,2,10406,2603,1,93040000,93040000,3901,1300,2601,1300,0,1,1302,812952,0.812952
6100,500,1300,3050000,2,10406,2603,1,93040000,93040000,3901,1300,2601,1300,0,1,1302,796086,0.796086
6100,500,1300,3050000,2,10406,2603,1,93040000,93040000,3901,1300,2601,1300,0,1,1302,799338,0.799338
6100,500,1300,3050000,2,10406,2603,1,93040000,93040000,3901,1300,2601,1300,0,1,1302,779804,0.779804
6100,500,1300,3050000,2,10406,2603,1,93040000,93040000,3901,1300,2601,1300,0,1,1302,808811,0.808811
6100,500,1300,3050000,2,10406,2603,1,93040000,93040000,3901,1300,2601,1300,0,1,1302,776665,0.776665
6100,500,1300,3050000,2,10406,2603,1,93040000,93040000,3901,1300,2601,1300,0,1,1302,819314,0.819314
6100,500,1700,3050000,2,13606,3403,1,114160000,114160000,5101,1700,3401,1700,0,1,1702,1017301,1.017301
6100,500,1700,3050000,2,13606,3403,1,114160000,114160000,5101,1700,3401,1700,0,1,1702,1054745,1.054745
6100,500,1700,3050000,2,13606,3403,1,114160000,114160000,5101,1700,3401,1700,0,1,1702,1038728,1.038728
6100,500,1700,3050000,2,13606,3403,1,114160000,114160000,5101,1700,3401,1700,0,1,1702,1039170,1.03917
6100,500,1700,3050000,2,13606,3403,1,114160000,114160000,5101,1700,3401,1700,0,1,1702,1021738,1.021738
6100,500,1700,3050000,2,13606,3403,1,114160000,114160000,5101,1700,3401,1700,0,1,1702,1042632,1.042632
6100,500,1700,3050000,2,13606,3403,1,114160000,114160000,5101,1700,3401,1700,0,1,1702,1006149,1.006149
6100,500,1700,3050000,2,13606,3403,1,114160000,114160000,5101,1700,3401,1700,0,1,1702,1062333,1.062333
6100,500,2100,3050000,2,16806,4203,1,135280000,135280000,6301,2100,4201,2100,0,1,2102,1253749,1.253749
6100,500,2100,3050000,2,16806,4203,1,135280000,135280000,6301,2100,4201,2100,0,1,2102,1296584,1.296584
6100,500,2100,3050000,2,16806,4203,1,135280000,135280000,6301,2100,4201,2100,0,1,2102,1279977,1.279977
6100,500,2100,3050000,2,16806,4203,1,135280000,135280000,6301,2100,4201,2100,0,1,2102,1273558,1.273558
6100,500,2100,3050000,2,16806,4203,1,135280000,135280000,6301,2100,4201,2100,0,1,2102,1253338,1.253338
6100,500,2100,3050000,2,16806,4203,1,135280000,135280000,6301,2100,4201,2100,0,1,2102,1294017,1.294017
6100,500,2100,3050000,2,16806,4203,1,135280000,135280000,6301,2100,4201,2100,0,1,2102,1247205,1.247205
6100,500,2100,3050000,2,16806,4203,1,135280000,135280000,6301,2100,4201,2100,0,1,2102,1307769,1.307769
6100,500,2500,3050000,2,20006,5003,1,156400000,156400000,7501,2500,5001,2500,0,1,2502,1488955,1.488955
6100,500,2500,3050000,2,20006,5003,1,156400000,156400000,7501,2500,5001,2500,0,1,2502,1540697,1.540697
6100,500,2500,3050000,2,20006,5003,1,156400000,156400000,7501,2500,5001,2500,0,1,2502,1523011,1.523011
6100,500,2500,3050000,2,20006,5003,1,156400000,156400000,7501,2500,5001,2500,0,1,2502,1519468,1.519468
6100,500,2500,3050000,2,20006,5003,1,156400000,156400000,7501,2500,5001,2500,0,1,2502,1491427,1.491427
6100,500,2500,3050000,2,20006,5003,1,156400000,156400000,7501,2500,5001,2500,0,1,2502,1547762,1.547762
6100,500,2500,3050000,2,20006,5003,1,156400000,156400000,7501,2500,5001,2500,0,1,2502,1485407,1.485407
6100,500,2500,3050000,2,20006,5003,1,156400000,156400000,7501,2500,5001,2500,0,1,2502,1557688,1.557688
6100,500,2900,3050000,2,23206,5803,1,177520000,177520000,8701,2900,5801,2900,0,1,2902,1727740,1.72774
6100,500,2900,3050000,2,23206,5803,1,177520000,177520000,8701,2900,5801,2900,0,1,2902,1796993,1.796993
6100,500,2900,3050000,2,23206,5803,1,177520000,177520000,8701,2900,5801,2900,0,1,2902,1753243,1.753243
6100,500,2900,3050000,2,23206,5803,1,177520000,177520000,8701,2900,5801,2900,0,1,2902,1761657,1.761657
6100,500,2900,3050000,2,23206,5803,1,177520000,177520000,8701,2900,5801,2900,0,1,2902,1730440,1.73044
6100,500,2900,3050000,2,23206,5803,1,177520000,177520000,8701,2900,5801,2900,0,1,2902,1794105,1.794105
6100,500,2900,3050000,2,23206,5803,1,177520000,177520000,8701,2900,5801,2900,0,1,2902,1710497,1.710497
6100,500,2900,3050000,2,23206,5803,1,177520000,177520000,8701,2900,5801,2900,0,1,2902,1794466,1.794466
6100,500,3300,3050000,2,26406,6603,1,198640000,198640000,9901,3300,6601,3300,0,1,3302,1966841,1.966841
6100,500,3300,3050000,2,26406,6603,1,198640000,198640000,9901,3300,6601,3300,0,1,3302,2031022,2.031022
6100,500,3300,3050000,2,26406,6603,1,198640000,198640000,9901,3300,6601,3300,0,1,3302,1999555,1.999555
6100,500,3300,3050000,2,26406,6603,1,198640000,198640000,9901,3300,6601,3300,0,1,3302,1997082,1.997082
6100,500,3300,3050000,2,26406,6603,1,198640000,198640000,9901,3300,6601,3300,0,1,3302,1964582,1.964582
6100,500,3300,3050000,2,26406,6603,1,198640000,198640000,9901,3300,6601,3300,0,1,3302,2012013,2.012013
6100,500,3300,3050000,2,26406,6603,1,198640000,198640000,9901,3300,6601,3300,0,1,3302,1964215,1.964215
6100,500,3300,3050000,2,26406,6603,1,198640000,198640000,9901,3300,6601,3300,0,1,3302,2039681,2.039681
6100,500,3700,3050000,2,29606,7403,1,219760000,219760000,11101,3700,7401,3700,0,1,3702,2190923,2.190923
6100,500,3700,3050000,2,29606,7403,1,219760000,219760000,11101,3700,7401,3700,0,1,3702,2267985,2.267985
6100,500,3700,3050000,2,29606,7403,1,219760000,219760000,11101,3700,7401,3700,0,1,3702,2221964,2.221964
6100,500,3700,3050000,2,29606,7403,1,219760000,219760000,11101,3700,7401,3700,0,1,3702,2228669,2.228669
6100,500,3700,3050000,2,29606,7403,1,219760000,219760000,11101,3700,7401,3700,0,1,3702,2188464,2.188464
6100,500,3700,3050000,2,29606,7403,1,219760000,219760000,11101,3700,7401,3700,0,1,3702,2257191,2.257191
6100,500,3700,3050000,2,29606,7403,1,219760000,219760000,11101,3700,7401,3700,0,1,3702,2188069,2.188069
6100,500,3700,3050000,2,29606,7403,1,219760000,219760000,11101,3700,7401,3700,0,1,3702,2278385,2.278385
6100,500,4100,3050000,2,32806,8203,1,240880000,240880000,12301,4100,8201,4100,0,1,4102,2428303,2.428303
6100,500,4100,3050000,2,32806,8203,1,240880000,240880000,12301,4100,8201,4100,0,1,4102,2507440,2.50744
6100,500,4100,3050000,2,32806,8203,1,240880000,240880000,12301,4100,8201,4100,0,1,4102,2618149,2.618149
6100,500,4100,3050000,2,32806,8203,1,240880000,240880000,12301,4100,8201,4100,0,1,4102,2618662,2.618662
6100,500,4100,3050000,2,32806,8203,1,240880000,240880000,12301,4100,8201,4100,0,1,4102,2419201,2.419201
6100,500,4100,3050000,2,32806,8203,1,240880000,240880000,12301,4100,8201,4100,0,1,4102,2641497,2.641497
6100,500,4100,3050000,2,32806,8203,1,240880000,240880000,12301,4100,8201,4100,0,1,4102,2405745,2.405745
6100,500,4100,3050000,2,32806,8203,1,240880000,240880000,12301,4100,8201,4100,0,1,4102,2575840,2.57584
6100,500,4500,3050000,2,36006,9003,1,262000000,262000000,13501,4500,9001,4500,0,1,4502,2806861,2.806861
6100,500,4500,3050000,2,36006,9003,1,262000000,262000000,13501,4500,9001,4500,0,1,4502,2878365,2.878365
6100,500,4500,3050000,2,36006,9003,1,262000000,262000000,13501,4500,9001,4500,0,1,4502,2687831,2.687831
6100,500,4500,3050000,2,36006,9003,1,262000000,262000000,13501,4500,9001,4500,0,1,4502,2712842,2.712842
6100,500,4500,3050000,2,36006,9003,1,262000000,262000000,13501,4500,9001,4500,0,1,4502,2758486,2.758486
6100,500,4500,3050000,2,36006,9003,1,262000000,262000000,13501,4500,9001,4500,0,1,4502,2745608,2.745608
6100,500,4500,3050000,2,36006,9003,1,262000000,262000000,13501,4500,9001,4500,0,1,4502,2862083,2.862083
6100,500,4500,3050000,2,36006,9003,1,262000000,262000000,13501,4500,9001,4500,0,1,4502,2788435,2.788435
6100,500,4900,3050000,2,39206,9803,1,283120000,283120000,14701,4900,9801,4900,0,1,4902,2903022,2.903022
6100,500,4900,3050000,2,39206,9803,1,283120000,283120000,14701,4900,9801,4900,0,1,4902,3004024,3.004024
6100,500,4900,3050000,2,39206,9803,1,283120000,283120000,14701,4900,9801,4900,0,1,4902,2943583,2.943583
6100,500,4900,3050000,2,39206,9803,1,283120000,283120000,14701,4900,9801,4900,0,1,4902,2961104,2.961104
6100,500,4900,3050000,2,39206,9803,1,283120000,283120000,14701,4900,9801,4900,0,1,4902,2913481,2.913481
6100,500,4900,3050000,2,39206,9803,1,283120000,283120000,14701,4900,9801,4900,0,1,4902,2985981,2.985981
6100,500,4900,3050000,2,39206,9803,1,283120000,283120000,14701,4900,9801,4900,0,1,4902,2891314,2.891314
6100,500,4900,3050000,2,39206,9803,1,283120000,283120000,14701,4900,9801,4900,0,1,4902,3025040,3.02504
6100,500,5300,3050000,2,42406,10603,1,304240000,304240000,15901,5300,10601,5300,0,1,5302,3148043,3.148043
6100,500,5300,3050000,2,42406,10603,1,304240000,304240000,15901,5300,10601,5300,0,1,5302,3260691,3.260691
6100,500,5300,3050000,2,42406,10603,1,304240000,304240000,15901,5300,10601,5300,0,1,5302,3186827,3.186827
6100,500,5300,3050000,2,42406,10603,1,304240000,304240000,15901,5300,10601,5300,0,1,5302,3234086,3.234086
6100,500,5300,3050000,2,42406,10603,1,304240000,304240000,15901,5300,10601,5300,0,1,5302,3152898,3.152898
6100,500,5300,3050000,2,42406,10603,1,304240000,304240000,15901,5300,10601,5300,0,1,5302,3266124,3.266124
6100,500,5300,3050000,2,42406,10603,1,304240000,304240000,15901,5300,10601,5300,0,1,5302,3135246,3.135246
6100,500,5300,3050000,2,42406,10603,1,304240000,304240000,15901,5300,10601,5300,0,1,5302,3300717,3.300717
6100,500,5700,3050000,2,45606,11403,1,325360000,325360000,17101,5700,11401,5700,0,1,5702,3377348,3.377348
6100,500,5700,3050000,2,45606,11403,1,325360000,325360000,17101,5700,11401,5700,0,1,5702,3489513,3.489513
6100,500,5700,3050000,2,45606,11403,1,325360000,325360000,17101,5700,11401,5700,0,1,5702,3406599,3.406599
6100,500,5700,3050000,2,45606,11403,1,325360000,325360000,17101,5700,11401,5700,0,1,5702,3428650,3.42865
6100,500,5700,3050000,2,45606,11403,1,325360000,325360000,17101,5700,11401,5700,0,1,5702,3374758,3.374758
6100,500,5700,3050000,2,45606,11403,1,325360000,325360000,17101,5700,11401,5700,0,1,5702,3466552,3.466552
6100,500,5700,3050000,2,45606,11403,1,325360000,325360000,17101,5700,11401,5700,0,1,5702,3353218,3.353218
6100,500,5700,3050000,2,45606,11403,1,325360000,325360000,17101,5700,11401,5700,0,1,5702,3509101,3.509101
6100,500,6100,3050000,2,48806,12203,1,346480000,346480000,18301,6100,12201,6100,0,1,6102,3624226,3.624226
6100,500,6100,3050000,2,48806,12203,1,346480000,346480000,18301,6100,12201,6100,0,1,6102,3756334,3.756334
6100,500,6100,3050000,2,48806,12203,1,346480000,346480000,18301,6100,12201,6100,0,1,6102,3661821,3.661821
6100,500,6100,3050000,2,48806,12203,1,346480000,346480000,18301,6100,12201,6100,0,1,6102,3717426,3.717426
6100,500,6100,3050000,2,48806,12203,1,346480000,346480000,18301,6100,12201,6100,0,1,6102,3641985,3.641985
6100,500,6100,3050000,2,48806,12203,1,346480000,346480000,18301,6100,12201,6100,0,1,6102,3782899,3.782899
6100,500,6100,3050000,2,48806,12203,1,346480000,346480000,18301,6100,12201,6100,0,1,6102,3633234,3.633234
6100,500,6100,3050000,2,48806,12203,1,346480000,346480000,18301,6100,12201,6100,0,1,6102,3814719,3.814719
6100,500,6500,3050000,2,52006,13003,1,367600000,367600000,19501,6500,13001,6500,0,1,6502,3858116,3.858116
6100,500,6500,3050000,2,52006,13003,1,367600000,367600000,19501,6500,13001,6500,0,1,6502,4116298,4.116298
6100,500,6500,3050000,2,52006,13003,1,367600000,367600000,19501,6500,13001,6500,0,1,6502,4012991,4.012991
6100,500,6500,3050000,2,52006,13003,1,367600000,367600000,19501,6500,13001,6500,0,1,6502,4103781,4.103781
6100,500,6500,3050000,2,52006,13003,1,367600000,367600000,19501,6500,13001,6500,0,1,6502,4003833,4.003833
6100,500,6500,3050000,2,52006,13003,1,367600000,367600000,19501,6500,13001,6500,0,1,6502,4109059,4.109059
6100,500,6500,3050000,2,52006,13003,1,367600000,367600000,19501,6500,13001,6500,0,1,6502,3841301,3.841301
6100,500,6500,3050000,2,52006,13003,1,367600000,367600000,19501,6500,13001,6500,0,1,6502,4168485,4.168485
6100,500,6900,3050000,2,55206,13803,1,388720000,388720000,20701,6900,13801,6900,0,1,6902,4275777,4.275777
6100,500,6900,3050000,2,55206,13803,1,388720000,388720000,20701,6900,13801,6900,0,1,6902,4258204,4.258204
6100,500,6900,3050000,2,55206,13803,1,388720000,388720000,20701,6900,13801,6900,0,1,6902,4144856,4.144856
6100,500,6900,3050000,2,55206,13803,1,388720000,388720000,20701,6900,13801,6900,0,1,6902,4225758,4.225758
6100,500,6900,3050000,2,55206,13803,1,388720000,388720000,20701,6900,13801,6900,0,1,6902,4106232,4.106232
6100,500,6900,3050000,2,55206,13803,1,388720000,388720000,20701,6900,13801,6900,0,1,6902,4282451,4.282451
6100,500,6900,3050000,2,55206,13803,1,388720000,388720000,20701,6900,13801,6900,0,1,6902,4332718,4.332718
6100,500,6900,3050000,2,55206,13803,1,388720000,388720000,20701,6900,13801,6900,0,1,6902,4335898,4.335898
6100,100,500,610000,2,4006,1003,1,29680000,29680000,1501,500,1001,500,0,1,502,77504,0.077504
6100,100,500,610000,2,4006,1003,1,29680000,29680000,1501,500,1001,500,0,1,502,77716,0.077716
6100,100,500,610000,2,4006,1003,1,29680000,29680000,1501,500,1001,500,0,1,502,78713,0.078713
6100,100,500,610000,2,4006,1003,1,29680000,29680000,1501,500,1001,500,0,1,502,80362,0.080362
6100,100,500,610000,2,4006,1003,1,29680000,29680000,1501,500,1001,500,0,1,502,90367,0.090367
6100,100,500,610000,2,4006,1003,1,29680000,29680000,1501,500,1001,500,0,1,502,87825,0.087825
6100,100,500,610000,2,4006,1003,1,29680000,29680000,1501,500,1001,500,0,1,502,85878,0.085878
6100,100,500,610000,2,4006,1003,1,29680000,29680000,1501,500,1001,500,0,1,502,90572,0.090572
6100,100,900,610000,2,7206,1803,1,49520000,49520000,2701,900,1801,900,0,1,902,125508,0.125508
6100,100,900,610000,2,7206,1803,1,49520000,49520000,2701,900,1801,900,0,1,902,131608,0.131608
6100,100,900,610000,2,7206,1803,1,49520000,49520000,2701,900,1801,900,0,1,902,128039,0.128039
6100,100,900,610000,2,7206,1803,1,49520000,49520000,2701,900,1801,900,0,1,902,132990,0.13299
6100,100,900,610000,2,7206,1803,1,49520000,49520000,2701,900,1801,900,0,1,902,142195,0.142195
6100,100,900,610000,2,7206,1803,1,49520000,49520000,2701,900,1801,900,0,1,902,142417,0.142417
6100,100,900,610000,2,7206,1803,1,49520000,49520000,2701,900,1801,900,0,1,902,138769,0.138769
6100,100,900,610000,2,7206,1803,1,49520000,49520000,2701,900,1801,900,0,1,902,141641,0.141641
6100,100,1300,610000,2,10406,2603,1,69360000,69360000,3901,1300,2601,1300,0,1,1302,181673,0.181673
6100,100,1300,610000,2,10406,2603,1,69360000,69360000,3901,1300,2601,1300,0,1,1302,183716,0.183716
6100,100,1300,610000,2,10406,2603,1,69360000,69360000,3901,1300,2601,1300,0,1,1302,186790,0.18679
6100,100,1300,610000,2,10406,2603,1,69360000,69360000,3901,1300,2601,1300,0,1,1302,169923,0.169923
6100,100,1300,610000,2,10406,2603,1,69360000,69360000,3901,1300,2601,1300,0,1,1302,194624,0.194624
6100,100,1300,610000,2,10406,2603,1,69360000,69360000,3901,1300,2601,1300,0,1,1302,194322,0.194322
6100,100,1300,610000,2,10406,2603,1,69360000,69360000,3901,1300,2601,1300,0,1,1302,192982,0.192982
6100,100,1300,610000,2,10406,2603,1,69360000,69360000,3901,1300,2601,1300,0,1,1302,194856,0.194856
6100,100,1700,610000,2,13606,3403,1,89200000,89200000,5101,1700,3401,1700,0,1,1702,235616,0.235616
6100,100,1700,610000,2,13606,3403,1,89200000,89200000,5101,1700,3401,1700,0,1,1702,228395,0.228395
6100,100,1700,610000,2,13606,3403,1,89200000,89200000,5101,1700,3401,1700,0,1,1702,239850,0.23985
6100,100,1700,610000,2,13606,3403,1,89200000,89200000,5101,1700,3401,1700,0,1,1702,227139,0.227139
6100,100,1700,610000,2,13606,3403,1,89200000,89200000,5101,1700,3401,1700,0,1,1702,242734,0.242734
6100,100,1700,610000,2,13606,3403,1,89200000,89200000,5101,1700,3401,1700,0,1,1702,242117,0.242117
6100,100,1700,610000,2,13606,3403,1,89200000,89200000,5101,1700,3401,1700,0,1,1702,226675,0.226675
6100,100,1700,610000,2,13606,3403,1,89200000,89200000,5101,1700,3401,1700,0,1,1702,243837,0.243837
6100,100,2100,610000,2,16806,4203,1,109040000,109040000,6301,2100,4201,2100,0,1,2102,291222,0.291222
6100,100,2100,610000,2,16806,4203,1,109040000,109040000,6301,2100,4201,2100,0,1,2102,276631,0.276631
6100,100,2100,610000,2,16806,4203,1,109040000,109040000,6301,2100,4201,2100,0,1,2102,292864,0.292864
6100,100,2100,610000,2,16806,4203,1,109040000,109040000,6301,2100,4201,2100,0,1,2102,276261,0.276261
6100,100,2100,610000,2,16806,4203,1,109040000,109040000,6301,2100,4201,2100,0,1,2102,296441,0.296441
6100,100,2100,610000,2,16806,4203,1,109040000,109040000,6301,2100,4201,2100,0,1,2102,295708,0.295708
6100,100,2100,610000,2,16806,4203,1,109040000,109040000,6301,2100,4201,2100,0,1,2102,276866,0.276866
6100,100,2100,610000,2,16806,4203,1,109040000,109040000,6301,2100,4201,2100,0,1,2102,296737,0.296737
6100,100,2500,610000,2,20006,5003,1,128880000,128880000,7501,2500,5001,2500,0,1,2502,349546,0.349546
6100,100,2500,610000,2,20006,5003,1,128880000,128880000,7501,2500,5001,2500,0,1,2502,353900,0.3539
6100,100,2500,610000,2,20006,5003,1,128880000,128880000,7501,2500,5001,2500,0,1,2502,353294,0.353294
6100,100,2500,610000,2,20006,5003,1,128880000,128880000,7501,2500,5001,2500,0,1,2502,330305,0.330305
6100,100,2500,610000,2,20006,5003,1,128880000,128880000,7501,2500,5001,2500,0,1,2502,356848,0.356848
6100,100,2500,610000,2,20006,5003,1,128880000,128880000,7501,2500,5001,2500,0,1,2502,355378,0.355378
6100,100,2500,610000,2,20006,5003,1,128880000,128880000,7501,2500,5001,2500,0,1,2502,352212,0.352212
6100,100,2500,610000,2,20006,5003,1,128880000,128880000,7501,2500,5001,2500,0,1,2502,357149,0.357149
6100,100,2900,610000,2,23206,5803,1,148720000,148720000,8701,2900,5801,2900,0,1,2902,412293,0.412293
6100,100,2900,610000,2,23206,5803,1,148720000,148720000,8701,2900,5801,2900,0,1,2902,418216,0.418216
6100,100,2900,610000,2,23206,5803,1,148720000,148720000,8701,2900,5801,2900,0,1,2902,416894,0.416894
6100,100,2900,610000,2,23206,5803,1,148720000,148720000,8701,2900,5801,2900,0,1,2902,388449,0.388449
6100,100,2900,610000,2,23206,5803,1,148720000,148720000,8701,2900,5801,2900,0,1,2902,412864,0.412864
6100,100,2900,610000,2,23206,5803,1,148720000,148720000,8701,2900,5801,2900,0,1,2902,417570,0.41757
6100,100,2900,610000,2,23206,5803,1,148720000,148720000,8701,2900,5801,2900,0,1,2902,408881,0.408881
6100,100,2900,610000,2,23206,5803,1,148720000,148720000,8701,2900,5801,2900,0,1,2902,418455,0.418455
6100,100,3300,610000,2,26406,6603,1,168560000,168560000,9901,3300,6601,3300,0,1,3302,469262,0.469262
6100,100,3300,610000,2,26406,6603,1,168560000,168560000,9901,3300,6601,3300,0,1,3302,473166,0.473166
6100,100,3300,610000,2,26406,6603,1,168560000,168560000,9901,3300,6601,3300,0,1,3302,472811,0.472811
6100,100,3300,610000,2,26406,6603,1,168560000,168560000,9901,3300,6601,3300,0,1,3302,434314,0.434314
6100,100,3300,610000,2,26406,6603,1,168560000,168560000,9901,3300,6601,3300,0,1,3302,436977,0.436977
6100,100,3300,610000,2,26406,6603,1,168560000,168560000,9901,3300,6601,3300,0,1,3302,458347,0.458347
6100,100,3300,610000,2,26406,6603,1,168560000,168560000,9901,3300,6601,3300,0,1,3302,447530,0.44753
6100,100,3300,610000,2,26406,6603,1,168560000,168560000,9901,3300,6601,3300,0,1,3302,459120,0.45912
6100,100,3700,610000,2,29606,7403,1,188400000,188400000,11101,3700,7401,3700,0,1,3702,518034,0.518034
6100,100,3700,610000,2,29606,7403,1,188400000,188400000,11101,3700,7401,3700,0,1,3702,530591,0.530591
6100,100,3700,610000,2,29606,7403,1,188400000,188400000,11101,3700,7401,3700,0,1,3702,527877,0.527877
6100,100,3700,610000,2,29606,7403,1,188400000,188400000,11101,3700,7401,3700,0,1,3702,489286,0.489286
6100,100,3700,610000,2,29606,7403,1,188400000,188400000,11101,3700,7401,3700,0,1,3702,490153,0.490153
6100,100,3700,610000,2,29606,7403,1,188400000,188400000,11101,3700,7401,3700,0,1,3702,517587,0.517587
6100,100,3700,610000,2,29606,7403,1,188400000,188400000,11101,3700,7401,3700,0,1,3702,505802,0.505802
6100,100,3700,610000,2,29606,7403,1,188400000,188400000,11101,3700,7401,3700,0,1,3702,520470,0.52047
6100,100,4100,610000,2,32806,8203,1,208240000,208240000,12301,4100,8201,4100,0,1,4102,574449,0.574449
6100,100,4100,610000,2,32806,8203,1,208240000,208240000,12301,4100,8201,4100,0,1,4102,587285,0.587285
6100,100,4100,610000,2,32806,8203,1,208240000,208240000,12301,4100,8201,4100,0,1,4102,584451,0.584451
6100,100,4100,610000,2,32806,8203,1,208240000,208240000,12301,4100,8201,4100,0,1,4102,548825,0.548825
6100,100,4100,610000,2,32806,8203,1,208240000,208240000,12301,4100,8201,4100,0,1,4102,541170,0.54117
6100,100,4100,610000,2,32806,8203,1,208240000,208240000,12301,4100,8201,4100,0,1,4102,581022,0.581022
6100,100,4100,610000,2,32806,8203,1,208240000,208240000,12301,4100,8201,4100,0,1,4102,567679,0.567679
6100,100,4100,610000,2,32806,8203,1,208240000,208240000,12301,4100,8201,4100,0,1,4102,585855,0.585855
6100,100,4500,610000,2,36006,9003,1,228080000,228080000,13501,4500,9001,4500,0,1,4502,622530,0.62253
6100,100,4500,610000,2,36006,9003,1,228080000,228080000,13501,4500,9001,4500,0,1,4502,639507,0.639507
6100,100,4500,610000,2,36006,9003,1,228080000,228080000,13501,4500,9001,4500,0,1,4502,635878,0.635878
6100,100,4500,610000,2,36006,9003,1,228080000,228080000,13501,4500,9001,4500,0,1,4502,593949,0.593949
6100,100,4500,610000,2,36006,9003,1,228080000,228080000,13501,4500,9001,4500,0,1,4502,593431,0.593431
6100,100,4500,610000,2,36006,9003,1,228080000,228080000,13501,4500,9001,4500,0,1,4502,627991,0.627991
6100,100,4500,610000,2,36006,9003,1,228080000,228080000,13501,4500,9001,4500,0,1,4502,602132,0.602132
6100,100,4500,610000,2,36006,9003,1,228080000,228080000,13501,4500,9001,4500,0,1,4502,636299,0.636299
6100,100,4900,610000,2,39206,9803,1,247920000,247920000,14701,4900,9801,4900,0,1,4902,676969,0.676969
6100,100,4900,610000,2,39206,9803,1,247920000,247920000,14701,4900,9801,4900,0,1,4902,688334,0.688334
6100,100,4900,610000,2,39206,9803,1,247920000,247920000,14701,4900,9801,4900,0,1,4902,659883,0.659883
6100,100,4900,610000,2,39206,9803,1,247920000,247920000,14701,4900,9801,4900,0,1,4902,658090,0.65809
6100,100,4900,610000,2,39206,9803,1,247920000,247920000,14701,4900,9801,4900,0,1,4902,641505,0.641505
6100,100,4900,610000,2,39206,9803,1,247920000,247920000,14701,4900,9801,4900,0,1,4902,684975,0.684975
6100,100,4900,610000,2,39206,9803,1,247920000,247920000,14701,4900,9801,4900,0,1,4902,669272,0.669272
6100,100,4900,610000,2,39206,9803,1,247920000,247920000,14701,4900,9801,4900,0,1,4902,662399,0.662399
6100,100,5300,610000,2,42406,10603,1,267760000,267760000,15901,5300,10601,5300,0,1,5302,715966,0.715966
6100,100,5300,610000,2,42406,10603,1,267760000,267760000,15901,5300,10601,5300,0,1,5302,737962,0.737962
6100,100,5300,610000,2,42406,10603,1,267760000,267760000,15901,5300,10601,5300,0,1,5302,723568,0.723568
6100,100,5300,610000,2,42406,10603,1,267760000,267760000,15901,5300,10601,5300,0,1,5302,709614,0.709614
6100,100,5300,610000,2,42406,10603,1,267760000,267760000,15901,5300,10601,5300,0,1,5302,689816,0.689816
6100,100,5300,610000,2,42406,10603,1,267760000,267760000,15901,5300,10601,5300,0,1,5302,745064,0.745064
6100,100,5300,610000,2,42406,10603,1,267760000,267760000,15901,5300,10601,5300,0,1,5302,726431,0.726431
6100,100,5300,610000,2,42406,10603,1,267760000,267760000,15901,5300,10601,5300,0,1,5302,724046,0.724046
6100,100,5700,610000,2,45606,11403,1,287600000,287600000,17101,5700,11401,5700,0,1,5702,792894,0.792894
6100,100,5700,610000,2,45606,11403,1,287600000,287600000,17101,5700,11401,5700,0,1,5702,818400,0.8184
6100,100,5700,610000,2,45606,11403,1,287600000,287600000,17101,5700,11401,5700,0,1,5702,807609,0.807609
6100,100,5700,610000,2,45606,11403,1,287600000,287600000,17101,5700,11401,5700,0,1,5702,772410,0.77241
6100,100,5700,610000,2,45606,11403,1,287600000,287600000,17101,5700,11401,5700,0,1,5702,817765,0.817765
6100,100,5700,610000,2,45606,11403,1,287600000,287600000,17101,5700,11401,5700,0,1,5702,819424,0.819424
6100,100,5700,610000,2,45606,11403,1,287600000,287600000,17101,5700,11401,5700,0,1,5702,797850,0.79785
6100,100,5700,610000,2,45606,11403,1,287600000,287600000,17101,5700,11401,5700,0,1,5702,780559,0.780559
6100,100,6100,610000,2,48806,12203,1,307440000,307440000,18301,6100,12201,6100,0,1,6102,864123,0.864123
6100,100,6100,610000,2,48806,12203,1,307440000,307440000,18301,6100,12201,6100,0,1,6102,893959,0.893959
6100,100,6100,610000,2,48806,12203,1,307440000,307440000,18301,6100,12201,6100,0,1,6102,884216,0.884216
6100,100,6100,610000,2,48806,12203,1,307440000,307440000,18301,6100,12201,6100,0,1,6102,885981,0.885981
6100,100,6100,610000,2,48806,12203,1,307440000,307440000,18301,6100,12201,6100,0,1,6102,865862,0.865862
6100,100,6100,610000,2,48806,12203,1,307440000,307440000,18301,6100,12201,6100,0,1,6102,890387,0.890387
6100,100,6100,610000,2,48806,12203,1,307440000,307440000,18301,6100,12201,6100,0,1,6102,875139,0.875139
6100,100,6100,610000,2,48806,12203,1,307440000,307440000,18301,6100,12201,6100,0,1,6102,896836,0.896836
6100,100,6500,610000,2,52006,13003,1,327280000,327280000,19501,6500,13001,6500,0,1,6502,939053,0.939053
6100,100,6500,610000,2,52006,13003,1,327280000,327280000,19501,6500,13001,6500,0,1,6502,973765,0.973765
6100,100,6500,610000,2,52006,13003,1,327280000,327280000,19501,6500,13001,6500,0,1,6502,961120,0.96112
6100,100,6500,610000,2,52006,13003,1,327280000,327280000,19501,6500,13001,6500,0,1,6502,972588,0.972588
6100,100,6500,610000,2,52006,13003,1,327280000,327280000,19501,6500,13001,6500,0,1,6502,958288,0.958288
6100,100,6500,610000,2,52006,13003,1,327280000,327280000,19501,6500,13001,6500,0,1,6502,978038,0.978038
6100,100,6500,610000,2,52006,13003,1,327280000,327280000,19501,6500,13001,6500,0,1,6502,946604,0.946604
6100,100,6500,610000,2,52006,13003,1,327280000,327280000,19501,6500,13001,6500,0,1,6502,982743,0.982743
6100,100,6900,610000,2,55206,13803,1,347120000,347120000,20701,6900,13801,6900,0,1,6902,998658,0.998658
6100,100,6900,610000,2,55206,13803,1,347120000,347120000,20701,6900,13801,6900,0,1,6902,1035947,1.035947
6100,100,6900,610000,2,55206,13803,1,347120000,347120000,20701,6900,13801,6900,0,1,6902,1025486,1.025486
6100,100,6900,610000,2,55206,13803,1,347120000,347120000,20701,6900,13801,6900,0,1,6902,1030062,1.030062
6100,100,6900,610000,2,55206,13803,1,347120000,347120000,20701,6900,13801,6900,0,1,6902,1024874,1.024874
6100,100,6900,610000,2,55206,13803,1,347120000,347120000,20701,6900,13801,6900,0,1,6902,1038619,1.038619
6100,100,6900,610000,2,55206,13803,1,347120000,347120000,20701,6900,13801,6900,0,1,6902,1010135,1.010135
6100,100,6900,610000,2,55206,13803,1,347120000,347120000,20701,6900,13801,6900,0,1,6902,1046961,1.046961
5700,6900,500,39330000,2,4006,1003,1,365040000,365040000,1501,500,1001,500,0,1,502,4023569,4.023569
5700,6900,500,39330000,2,4006,1003,1,365040000,365040000,1501,500,1001,500,0,1,502,4202336,4.202336
5700,6900,500,39330000,2,4006,1003,1,365040000,365040000,1501,500,1001,500,0,1,502,4051639,4.051639
5700,6900,500,39330000,2,4006,1003,1,365040000,365040000,1501,500,1001,500,0,1,502,4200818,4.200818
5700,6900,500,39330000,2,4006,1003,1,365040000,365040000,1501,500,1001,500,0,1,502,4025124,4.025124
5700,6900,500,39330000,2,4006,1003,1,365040000,365040000,1501,500,1001,500,0,1,502,4171195,4.171195
5700,6900,500,39330000,2,4006,1003,1,365040000,365040000,1501,500,1001,500,0,1,502,3995949,3.995949
5700,6900,500,39330000,2,4006,1003,1,365040000,365040000,1501,500,1001,500,0,1,502,4230317,4.230317
5700,6900,900,39330000,2,7206,1803,1,405360000,405360000,2701,900,1801,900,0,1,902,7030011,7.030011
5700,6900,900,39330000,2,7206,1803,1,405360000,405360000,2701,900,1801,900,0,1,902,7265976,7.265976
5700,6900,900,39330000,2,7206,1803,1,405360000,405360000,2701,900,1801,900,0,1,902,7133641,7.133641
5700,6900,900,39330000,2,7206,1803,1,405360000,405360000,2701,900,1801,900,0,1,902,7197687,7.197687
5700,6900,900,39330000,2,7206,1803,1,405360000,405360000,2701,900,1801,900,0,1,902,7058116,7.058116
5700,6900,900,39330000,2,7206,1803,1,405360000,405360000,2701,900,1801,900,0,1,902,7266352,7.266352
5700,6900,900,39330000,2,7206,1803,1,405360000,405360000,2701,900,1801,900,0,1,902,7057568,7.057568
5700,6900,900,39330000,2,7206,1803,1,405360000,405360000,2701,900,1801,900,0,1,902,7341590,7.34159
5700,6900,1300,39330000,2,10406,2603,1,445680000,445680000,3901,1300,2601,1300,0,1,1302,9745582,9.745582
5700,6900,1300,39330000,2,10406,2603,1,445680000,445680000,3901,1300,2601,1300,0,1,1302,10154408,10.154408
5700,6900,1300,39330000,2,10406,2603,1,445680000,445680000,3901,1300,2601,1300,0,1,1302,9862179,9.862179
5700,6900,1300,39330000,2,10406,2603,1,445680000,445680000,3901,1300,2601,1300,0,1,1302,10040758,10.040758
5700,6900,1300,39330000,2,10406,2603,1,445680000,445680000,3901,1300,2601,1300,0,1,1302,9700384,9.700384
5700,6900,1300,39330000,2,10406,2603,1,445680000,445680000,3901,1300,2601,1300,0,1,1302,10126525,10.126525
5700,6900,1300,39330000,2,10406,2603,1,445680000,445680000,3901,1300,2601,1300,0,1,1302,9642343,9.642343
5700,6900,1300,39330000,2,10406,2603,1,445680000,445680000,3901,1300,2601,1300,0,1,1302,10225906,10.225906
5700,6900,1700,39330000,2,13606,3403,1,486000000,486000000,5101,1700,3401,1700,0,1,1702,12735736,12.735736
5700,6900,1700,39330000,2,13606,3403,1,486000000,486000000,5101,1700,3401,1700,0,1,1702,13235406,13.235406
5700,6900,1700,39330000,2,13606,3403,1,486000000,486000000,5101,1700,3401,1700,0,1,1702,12869283,12.869283
5700,6900,1700,39330000,2,13606,3403,1,486000000,486000000,5101,1700,3401,1700,0,1,1702,13098914,13.098914
5700,6900,1700,39330000,2,13606,3403,1,486000000,486000000,5101,1700,3401,1700,0,1,1702,12762264,12.762264
5700,6900,1700,39330000,2,13606,3403,1,486000000,486000000,5101,1700,3401,1700,0,1,1702,13271701,13.271701
5700,6900,1700,39330000,2,13606,3403,1,486000000,486000000,5101,1700,3401,1700,0,1,1702,12681118,12.681118
5700,6900,1700,39330000,2,13606,3403,1,486000000,486000000,5101,1700,3401,1700,0,1,1702,13360992,13.360992
5700,6900,2100,39330000,2,16806,4203,1,526320000,526320000,6301,2100,4201,2100,0,1,2102,15638916,15.638916
5700,6900,2100,39330000,2,16806,4203,1,526320000,526320000,6301,2100,4201,2100,0,1,2102,16241282,16.241282
5700,6900,2100,39330000,2,16806,4203,1,526320000,526320000,6301,2100,4201,2100,0,1,2102,15780014,15.780014
5700,6900,2100,39330000,2,16806,4203,1,526320000,526320000,6301,2100,4201,2100,0,1,2102,16070001,16.070001
5700,6900,2100,39330000,2,16806,4203,1,526320000,526320000,6301,2100,4201,2100,0,1,2102,15611658,15.611658
5700,6900,2100,39330000,2,16806,4203,1,526320000,526320000,6301,2100,4201,2100,0,1,2102,16269257,16.269257
5700,6900,2100,39330000,2,16806,4203,1,526320000,526320000,6301,2100,4201,2100,0,1,2102,15531333,15.531333
5700,6900,2100,39330000,2,16806,4203,1,526320000,526320000,6301,2100,4201,2100,0,1,2102,16402660,16.40266
5700,6900,2500,39330000,2,20006,5003,1,566640000,566640000,7501,2500,5001,2500,0,1,2502,18552458,18.552458
5700,6900,2500,39330000,2,20006,5003,1,566640000,566640000,7501,2500,5001,2500,0,1,2502,19224191,19.224191
5700,6900,2500,39330000,2,20006,5003,1,566640000,566640000,7501,2500,5001,2500,0,1,2502,18714357,18.714357
5700,6900,2500,39330000,2,20006,5003,1,566640000,566640000,7501,2500,5001,2500,0,1,2502,19045338,19.045338
5700,6900,2500,39330000,2,20006,5003,1,566640000,566640000,7501,2500,5001,2500,0,1,2502,18474075,18.474075
5700,6900,2500,39330000,2,20006,5003,1,566640000,566640000,7501,2500,5001,2500,0,1,2502,19252908,19.252908
5700,6900,2500,39330000,2,20006,5003,1,566640000,566640000,7501,2500,5001,2500,0,1,2502,18383174,18.383174
5700,6900,2500,39330000,2,20006,5003,1,566640000,566640000,7501,2500,5001,2500,0,1,2502,19442202,19.442202
5700,6900,2900,39330000,2,23206,5803,1,606960000,606960000,8701,2900,5801,2900,0,1,2902,21432866,21.432866
5700,6900,2900,39330000,2,23206,5803,1,606960000,606960000,8701,2900,5801,2900,0,1,2902,22315253,22.315253
5700,6900,2900,39330000,2,23206,5803,1,606960000,606960000,8701,2900,5801,2900,0,1,2902,21611643,21.611643
5700,6900,2900,39330000,2,23206,5803,1,606960000,606960000,8701,2900,5801,2900,0,1,2902,22085234,22.085234
5700,6900,2900,39330000,2,23206,5803,1,606960000,606960000,8701,2900,5801,2900,0,1,2902,21369798,21.369798
5700,6900,2900,39330000,2,23206,5803,1,606960000,606960000,8701,2900,5801,2900,0,1,2902,22286237,22.286237
5700,6900,2900,39330000,2,23206,5803,1,606960000,606960000,8701,2900,5801,2900,0,1,2902,21223631,21.223631
5700,6900,2900,39330000,2,23206,5803,1,606960000,606960000,8701,2900,5801,2900,0,1,2902,22465885,22.465885
5700,6900,3300,39330000,2,26406,6603,1,647280000,647280000,9901,3300,6601,3300,0,1,3302,24345061,24.345061
5700,6900,3300,39330000,2,26406,6603,1,647280000,647280000,9901,3300,6601,3300,0,1,3302,25345560,25.34556
5700,6900,3300,39330000,2,26406,6603,1,647280000,647280000,9901,3300,6601,3300,0,1,3302,24612915,24.612915
5700,6900,3300,39330000,2,26406,6603,1,647280000,647280000,9901,3300,6601,3300,0,1,3302,25120975,25.120975
5700,6900,3300,39330000,2,26406,6603,1,647280000,647280000,9901,3300,6601,3300,0,1,3302,24189145,24.189145
5700,6900,3300,39330000,2,26406,6603,1,647280000,647280000,9901,3300,6601,3300,0,1,3302,25371198,25.371198
5700,6900,3300,39330000,2,26406,6603,1,647280000,647280000,9901,3300,6601,3300,0,1,3302,24095062,24.095062
5700,6900,3300,39330000,2,26406,6603,1,647280000,647280000,9901,3300,6601,3300,0,1,3302,25535749,25.535749
5700,6900,3700,39330000,2,29606,7403,1,687600000,687600000,11101,3700,7401,3700,0,1,3702,27195515,27.195515
5700,6900,3700,39330000,2,29606,7403,1,687600000,687600000,11101,3700,7401,3700,0,1,3702,28318173,28.318173
5700,6900,3700,39330000,2,29606,7403,1,687600000,687600000,11101,3700,7401,3700,0,1,3702,27475766,27.475766
5700,6900,3700,39330000,2,29606,7403,1,687600000,687600000,11101,3700,7401,3700,0,1,3702,28076474,28.076474
5700,6900,3700,39330000,2,29606,7403,1,687600000,687600000,11101,3700,7401,3700,0,1,3702,27120547,27.120547
5700,6900,3700,39330000,2,29606,7403,1,687600000,687600000,11101,3700,7401,3700,0,1,3702,28361445,28.361445
5700,6900,3700,39330000,2,29606,7403,1,687600000,687600000,11101,3700,7401,3700,0,1,3702,27009848,27.009848
5700,6900,3700,39330000,2,29606,7403,1,687600000,687600000,11101,3700,7401,3700,0,1,3702,28574391,28.574391
5700,6900,4100,39330000,2,32806,8203,1,727920000,727920000,12301,4100,8201,4100,0,1,4102,30100247,30.100247
5700,6900,4100,39330000,2,32806,8203,1,727920000,727920000,12301,4100,8201,4100,0,1,4102,31284623,31.284623
5700,6900,4100,39330000,2,32806,8203,1,727920000,727920000,12301,4100,8201,4100,0,1,4102,30376554,30.376554
5700,6900,4100,39330000,2,32806,8203,1,727920000,727920000,12301,4100,8201,4100,0,1,4102,30976643,30.976643
5700,6900,4100,39330000,2,32806,8203,1,727920000,727920000,12301,4100,8201,4100,0,1,4102,30020120,30.02012
5700,6900,4100,39330000,2,32806,8203,1,727920000,727920000,12301,4100,8201,4100,0,1,4102,31348212,31.348212
5700,6900,4100,39330000,2,32806,8203,1,727920000,727920000,12301,4100,8201,4100,0,1,4102,29855755,29.855755
5700,6900,4100,39330000,2,32806,8203,1,727920000,727920000,12301,4100,8201,4100,0,1,4102,31679520,31.67952
5700,6900,4500,39330000,2,36006,9003,1,768240000,768240000,13501,4500,9001,4500,0,1,4502,33038123,33.038123
5700,6900,4500,39330000,2,36006,9003,1,768240000,768240000,13501,4500,9001,4500,0,1,4502,34363264,34.363264
5700,6900,4500,39330000,2,36006,9003,1,768240000,768240000,13501,4500,9001,4500,0,1,4502,33289337,33.289337
5700,6900,4500,39330000,2,36006,9003,1,768240000,768240000,13501,4500,9001,4500,0,1,4502,34042062,34.042062
5700,6900,4500,39330000,2,36006,9003,1,768240000,768240000,13501,4500,9001,4500,0,1,4502,32884877,32.884877
5700,6900,4500,39330000,2,36006,9003,1,768240000,768240000,13501,4500,9001,4500,0,1,4502,34336667,34.336667
5700,6900,4500,39330000,2,36006,9003,1,768240000,768240000,13501,4500,9001,4500,0,1,4502,32785946,32.785946
5700,6900,4500,39330000,2,36006,9003,1,768240000,768240000,13501,4500,9001,4500,0,1,4502,34716224,34.716224
5700,6900,4900,39330000,2,39206,9803,1,808560000,808560000,14701,4900,9801,4900,0,1,4902,35902031,35.902031
5700,6900,4900,39330000,2,39206,9803,1,808560000,808560000,14701,4900,9801,4900,0,1,4902,37420443,37.420443
5700,6900,4900,39330000,2,39206,9803,1,808560000,808560000,14701,4900,9801,4900,0,1,4902,36195981,36.195981
5700,6900,4900,39330000,2,39206,9803,1,808560000,808560000,14701,4900,9801,4900,0,1,4902,36994449,36.994449
5700,6900,4900,39330000,2,39206,9803,1,808560000,808560000,14701,4900,9801,4900,0,1,4902,35744441,35.744441
5700,6900,4900,39330000,2,39206,9803,1,808560000,808560000,14701,4900,9801,4900,0,1,4902,37368363,37.368363
5700,6900,4900,39330000,2,39206,9803,1,808560000,808560000,14701,4900,9801,4900,0,1,4902,35597664,35.597664
5700,6900,4900,39330000,2,39206,9803,1,808560000,808560000,14701,4900,9801,4900,0,1,4902,37754295,37.754295
5700,6900,5300,39330000,2,42406,10603,1,848880000,848880000,15901,5300,10601,5300,0,1,5302,38782758,38.782758
5700,6900,5300,39330000,2,42406,10603,1,848880000,848880000,15901,5300,10601,5300,0,1,5302,40483600,40.4836
5700,6900,5300,39330000,2,42406,10603,1,848880000,848880000,15901,5300,10601,5300,0,1,5302,39175249,39.175249
5700,6900,5300,39330000,2,42406,10603,1,848880000,848880000,15901,5300,10601,5300,0,1,5302,40032786,40.032786
5700,6900,5300,39330000,2,42406,10603,1,848880000,848880000,15901,5300,10601,5300,0,1,5302,38671765,38.671765
5700,6900,5300,39330000,2,42406,10603,1,848880000,848880000,15901,5300,10601,5300,0,1,5302,40410537,40.410537
5700,6900,5300,39330000,2,42406,10603,1,848880000,848880000,15901,5300,10601,5300,0,1,5302,38512021,38.512021
5700,6900,5300,39330000,2,42406,10603,1,848880000,848880000,15901,5300,10601,5300,0,1,5302,40830322,40.830322
5700,6900,5700,39330000,2,45606,11403,1,889200000,889200000,17101,5700,11401,5700,0,1,5702,41750971,41.750971
5700,6900,5700,39330000,2,45606,11403,1,889200000,889200000,17101,5700,11401,5700,0,1,5702,43335428,43.335428
5700,6900,5700,39330000,2,45606,11403,1,889200000,889200000,17101,5700,11401,5700,0,1,5702,42077458,42.077458
5700,6900,5700,39330000,2,45606,11403,1,889200000,889200000,17101,5700,11401,5700,0,1,5702,43111859,43.111859
5700,6900,5700,39330000,2,45606,11403,1,889200000,889200000,17101,5700,11401,5700,0,1,5702,41558505,41.558505
5700,6900,5700,39330000,2,45606,11403,1,889200000,889200000,17101,5700,11401,5700,0,1,5702,43410892,43.410892
5700,6900,5700,39330000,2,45606,11403,1,889200000,889200000,17101,5700,11401,5700,0,1,5702,41386144,41.386144
5700,6900,5700,39330000,2,45606,11403,1,889200000,889200000,17101,5700,11401,5700,0,1,5702,43861386,43.861386
5700,6900,6100,39330000,2,48806,12203,1,929520000,929520000,18301,6100,12201,6100,0,1,6102,44641816,44.641816
5700,6900,6100,39330000,2,48806,12203,1,929520000,929520000,18301,6100,12201,6100,0,1,6102,46469357,46.469357
5700,6900,6100,39330000,2,48806,12203,1,929520000,929520000,18301,6100,12201,6100,0,1,6102,45095936,45.095936
5700,6900,6100,39330000,2,48806,12203,1,929520000,929520000,18301,6100,12201,6100,0,1,6102,46200936,46.200936
5700,6900,6100,39330000,2,48806,12203,1,929520000,929520000,18301,6100,12201,6100,0,1,6102,44548997,44.548997
5700,6900,6100,39330000,2,48806,12203,1,929520000,929520000,18301,6100,12201,6100,0,1,6102,46581938,46.581938
5700,6900,6100,39330000,2,48806,12203,1,929520000,929520000,18301,6100,12201,6100,0,1,6102,44379027,44.379027
5700,6900,6100,39330000,2,48806,12203,1,929520000,929520000,18301,6100,12201,6100,0,1,6102,46910849,46.910849
5700,6900,6500,39330000,2,52006,13003,1,969840000,969840000,19501,6500,13001,6500,0,1,6502,47580423,47.580423
5700,6900,6500,39330000,2,52006,13003,1,969840000,969840000,19501,6500,13001,6500,0,1,6502,49552979,49.552979
5700,6900,6500,39330000,2,52006,13003,1,969840000,969840000,19501,6500,13001,6500,0,1,6502,47912222,47.912222
5700,6900,6500,39330000,2,52006,13003,1,969840000,969840000,19501,6500,13001,6500,0,1,6502,49175982,49.175982
5700,6900,6500,39330000,2,52006,13003,1,969840000,969840000,19501,6500,13001,6500,0,1,6502,47389467,47.389467
5700,6900,6500,39330000,2,52006,13003,1,969840000,969840000,19501,6500,13001,6500,0,1,6502,49520976,49.520976
5700,6900,6500,39330000,2,52006,13003,1,969840000,969840000,19501,6500,13001,6500,0,1,6502,47265297,47.265297
5700,6900,6500,39330000,2,52006,13003,1,969840000,969840000,19501,6500,13001,6500,0,1,6502,49962694,49.962694
5700,6900,6900,39330000,2,55206,13803,1,1010160000,1010160000,20701,6900,13801,6900,0,1,6902,50456165,50.456165
5700,6900,6900,39330000,2,55206,13803,1,1010160000,1010160000,20701,6900,13801,6900,0,1,6902,52585101,52.585101
5700,6900,6900,39330000,2,55206,13803,1,1010160000,1010160000,20701,6900,13801,6900,0,1,6902,50938442,50.938442
5700,6900,6900,39330000,2,55206,13803,1,1010160000,1010160000,20701,6900,13801,6900,0,1,6902,52281927,52.281927
5700,6900,6900,39330000,2,55206,13803,1,1010160000,1010160000,20701,6900,13801,6900,0,1,6902,50355768,50.355768
5700,6900,6900,39330000,2,55206,13803,1,1010160000,1010160000,20701,6900,13801,6900,0,1,6902,52618199,52.618199
5700,6900,6900,39330000,2,55206,13803,1,1010160000,1010160000,20701,6900,13801,6900,0,1,6902,50321620,50.32162
5700,6900,6900,39330000,2,55206,13803,1,1010160000,1010160000,20701,6900,13801,6900,0,1,6902,53092392,53.092392
5700,6500,500,37050000,2,4006,1003,1,345200000,345200000,1501,500,1001,500,0,1,502,3908442,3.908442
5700,6500,500,37050000,2,4006,1003,1,345200000,345200000,1501,500,1001,500,0,1,502,3979531,3.979531
5700,6500,500,37050000,2,4006,1003,1,345200000,345200000,1501,500,1001,500,0,1,502,4005053,4.005053
5700,6500,500,37050000,2,4006,1003,1,345200000,345200000,1501,500,1001,500,0,1,502,4006057,4.006057
5700,6500,500,37050000,2,4006,1003,1,345200000,345200000,1501,500,1001,500,0,1,502,3939428,3.939428
5700,6500,500,37050000,2,4006,1003,1,345200000,345200000,1501,500,1001,500,0,1,502,3940170,3.94017
5700,6500,500,37050000,2,4006,1003,1,345200000,345200000,1501,500,1001,500,0,1,502,3939815,3.939815
5700,6500,500,37050000,2,4006,1003,1,345200000,345200000,1501,500,1001,500,0,1,502,4032527,4.032527
5700,6500,900,37050000,2,7206,1803,1,384240000,384240000,2701,900,1801,900,0,1,902,6482368,6.482368
5700,6500,900,37050000,2,7206,1803,1,384240000,384240000,2701,900,1801,900,0,1,902,6685985,6.685985
5700,6500,900,37050000,2,7206,1803,1,384240000,384240000,2701,900,1801,900,0,1,902,6544651,6.544651
5700,6500,900,37050000,2,7206,1803,1,384240000,384240000,2701,900,1801,900,0,1,902,6649631,6.649631
5700,6500,900,37050000,2,7206,1803,1,384240000,384240000,2701,900,1801,900,0,1,902,6456978,6.456978
5700,6500,900,37050000,2,7206,1803,1,384240000,384240000,2701,900,1801,900,0,1,902,6718631,6.718631
5700,6500,900,37050000,2,7206,1803,1,384240000,384240000,2701,900,1801,900,0,1,902,6420545,6.420545
5700,6500,900,37050000,2,7206,1803,1,384240000,384240000,2701,900,1801,900,0,1,902,6760690,6.76069
5700,6500,1300,37050000,2,10406,2603,1,423280000,423280000,3901,1300,2601,1300,0,1,1302,9186378,9.186378
5700,6500,1300,37050000,2,10406,2603,1,423280000,423280000,3901,1300,2601,1300,0,1,1302,9494712,9.494712
5700,6500,1300,37050000,2,10406,2603,1,423280000,423280000,3901,1300,2601,1300,0,1,1302,9282805,9.282805
5700,6500,1300,37050000,2,10406,2603,1,423280000,423280000,3901,1300,2601,1300,0,1,1302,9426404,9.426404
5700,6500,1300,37050000,2,10406,2603,1,423280000,423280000,3901,1300,2601,1300,0,1,1302,9143904,9.143904
5700,6500,1300,37050000,2,10406,2603,1,423280000,423280000,3901,1300,2601,1300,0,1,1302,9528085,9.528085
5700,6500,1300,37050000,2,10406,2603,1,423280000,423280000,3901,1300,2601,1300,0,1,1302,9098299,9.098299
5700,6500,1300,37050000,2,10406,2603,1,423280000,423280000,3901,1300,2601,1300,0,1,1302,9623465,9.623465
5700,6500,1700,37050000,2,13606,3403,1,462320000,462320000,5101,1700,3401,1700,0,1,1702,12030010,12.03001
5700,6500,1700,37050000,2,13606,3403,1,462320000,462320000,5101,1700,3401,1700,0,1,1702,12446662,12.446662
5700,6500,1700,37050000,2,13606,3403,1,462320000,462320000,5101,1700,3401,1700,0,1,1702,12160171,12.160171
5700,6500,1700,37050000,2,13606,3403,1,462320000,462320000,5101,1700,3401,1700,0,1,1702,12309619,12.309619
5700,6500,1700,37050000,2,13606,3403,1,462320000,462320000,5101,1700,3401,1700,0,1,1702,12004400,12.0044
5700,6500,1700,37050000,2,13606,3403,1,462320000,462320000,5101,1700,3401,1700,0,1,1702,12512719,12.512719
5700,6500,1700,37050000,2,13606,3403,1,462320000,462320000,5101,1700,3401,1700,0,1,1702,11944115,11.944115
5700,6500,1700,37050000,2,13606,3403,1,462320000,462320000,5101,1700,3401,1700,0,1,1702,12581098,12.581098
5700,6500,2100,37050000,2,16806,4203,1,501360000,501360000,6301,2100,4201,2100,0,1,2102,14718660,14.71866
5700,6500,2100,37050000,2,16806,4203,1,501360000,501360000,6301,2100,4201,2100,0,1,2102,15259152,15.259152
5700,6500,2100,37050000,2,16806,4203,1,501360000,501360000,6301,2100,4201,2100,0,1,2102,14877615,14.877615
5700,6500,2100,37050000,2,16806,4203,1,501360000,501360000,6301,2100,4201,2100,0,1,2102,15086693,15.086693
5700,6500,2100,37050000,2,16806,4203,1,501360000,501360000,6301,2100,4201,2100,0,1,2102,14633103,14.633103
5700,6500,2100,37050000,2,16806,4203,1,501360000,501360000,6301,2100,4201,2100,0,1,2102,15336397,15.336397
5700,6500,2100,37050000,2,16806,4203,1,501360000,501360000,6301,2100,4201,2100,0,1,2102,14578290,14.57829
5700,6500,2100,37050000,2,16806,4203,1,501360000,501360000,6301,2100,4201,2100,0,1,2102,15467081,15.467081
5700,6500,2500,37050000,2,20006,5003,1,540400000,540400000,7501,2500,5001,2500,0,1,2502,17472570,17.47257
5700,6500,2500,37050000,2,20006,5003,1,540400000,540400000,7501,2500,5001,2500,0,1,2502,18062822,18.062822
5700,6500,2500,37050000,2,20006,5003,1,540400000,540400000,7501,2500,5001,2500,0,1,2502,17589133,17.589133
5700,6500,2500,37050000,2,20006,5003,1,540400000,540400000,7501,2500,5001,2500,0,1,2502,17869516,17.869516
5700,6500,2500,37050000,2,20006,5003,1,540400000,540400000,7501,2500,5001,2500,0,1,2502,17329843,17.329843
5700,6500,2500,37050000,2,20006,5003,1,540400000,540400000,7501,2500,5001,2500,0,1,2502,18106287,18.106287
5700,6500,2500,37050000,2,20006,5003,1,540400000,540400000,7501,2500,5001,2500,0,1,2502,17293975,17.293975
5700,6500,2500,37050000,2,20006,5003,1,540400000,540400000,7501,2500,5001,2500,0,1,2502,18308087,18.308087
5700,6500,2900,37050000,2,23206,5803,1,579440000,579440000,8701,2900,5801,2900,0,1,2902,20142375,20.142375
5700,6500,2900,37050000,2,23206,5803,1,579440000,579440000,8701,2900,5801,2900,0,1,2902,20910756,20.910756
5700,6500,2900,37050000,2,23206,5803,1,579440000,579440000,8701,2900,5801,2900,0,1,2902,20338409,20.338409
5700,6500,2900,37050000,2,23206,5803,1,579440000,579440000,8701,2900,5801,2900,0,1,2902,20746528,20.746528
5700,6500,2900,37050000,2,23206,5803,1,579440000,579440000,8701,2900,5801,2900,0,1,2902,20057921,20.057921
5700,6500,2900,37050000,2,23206,5803,1,579440000,579440000,8701,2900,5801,2900,0,1,2902,20937875,20.937875
5700,6500,2900,37050000,2,23206,5803,1,579440000,579440000,8701,2900,5801,2900,0,1,2902,19984045,19.984045
5700,6500,2900,37050000,2,23206,5803,1,579440000,579440000,8701,2900,5801,2900,0,1,2902,21123306,21.123306
5700,6500,3300,37050000,2,26406,6603,1,618480000,618480000,9901,3300,6601,3300,0,1,3302,22867990,22.86799
5700,6500,3300,37050000,2,26406,6603,1,618480000,618480000,9901,3300,6601,3300,0,1,3302,23763420,23.76342
5700,6500,3300,37050000,2,26406,6603,1,618480000,618480000,9901,3300,6601,3300,0,1,3302,23098065,23.098065
5700,6500,3300,37050000,2,26406,6603,1,618480000,618480000,9901,3300,6601,3300,0,1,3302,23568377,23.568377
5700,6500,3300,37050000,2,26406,6603,1,618480000,618480000,9901,3300,6601,3300,0,1,3302,22774752,22.774752
5700,6500,3300,37050000,2,26406,6603,1,618480000,618480000,9901,3300,6601,3300,0,1,3302,23736300,23.7363
5700,6500,3300,37050000,2,26406,6603,1,618480000,618480000,9901,3300,6601,3300,0,1,3302,22663702,22.663702
5700,6500,3300,37050000,2,26406,6603,1,618480000,618480000,9901,3300,6601,3300,0,1,3302,24011377,24.011377
5700,6500,3700,37050000,2,29606,7403,1,657520000,657520000,11101,3700,7401,3700,0,1,3702,25627009,25.627009
5700,6500,3700,37050000,2,29606,7403,1,657520000,657520000,11101,3700,7401,3700,0,1,3702,26558790,26.55879
5700,6500,3700,37050000,2,29606,7403,1,657520000,657520000,11101,3700,7401,3700,0,1,3702,25843949,25.843949
5700,6500,3700,37050000,2,29606,7403,1,657520000,657520000,11101,3700,7401,3700,0,1,3702,26351876,26.351876
5700,6500,3700,37050000,2,29606,7403,1,657520000,657520000,11101,3700,7401,3700,0,1,3702,25474105,25.474105
5700,6500,3700,37050000,2,29606,7403,1,657520000,657520000,11101,3700,7401,3700,0,1,3702,26666562,26.666562
5700,6500,3700,37050000,2,29606,7403,1,657520000,657520000,11101,3700,7401,3700,0,1,3702,25404467,25.404467
5700,6500,3700,37050000,2,29606,7403,1,657520000,657520000,11101,3700,7401,3700,0,1,3702,26933185,26.933185
5700,6500,4100,37050000,2,32806,8203,1,696560000,696560000,12301,4100,8201,4100,0,1,4102,28347507,28.347507
5700,6500,4100,37050000,2,32806,8203,1,696560000,696560000,12301,4100,8201,4100,0,1,4102,29436418,29.436418
5700,6500,4100,37050000,2,32806,8203,1,696560000,696560000,12301,4100,8201,4100,0,1,4102,28536987,28.536987
5700,6500,4100,37050000,2,32806,8203,1,696560000,696560000,12301,4100,8201,4100,0,1,4102,29113549,29.113549
5700,6500,4100,37050000,2,32806,8203,1,696560000,696560000,12301,4100,8201,4100,0,1,4102,28174890,28.17489
5700,6500,4100,37050000,2,32806,8203,1,696560000,696560000,12301,4100,8201,4100,0,1,4102,29481653,29.481653
5700,6500,4100,37050000,2,32806,8203,1,696560000,696560000,12301,4100,8201,4100,0,1,4102,28094380,28.09438
5700,6500,4100,37050000,2,32806,8203,1,696560000,696560000,12301,4100,8201,4100,0,1,4102,29776873,29.776873
5700,6500,4500,37050000,2,36006,9003,1,735600000,735600000,13501,4500,9001,4500,0,1,4502,31071261,31.071261
5700,6500,4500,37050000,2,36006,9003,1,735600000,735600000,13501,4500,9001,4500,0,1,4502,32253502,32.253502
5700,6500,4500,37050000,2,36006,9003,1,735600000,735600000,13501,4500,9001,4500,0,1,4502,31318496,31.318496
5700,6500,4500,37050000,2,36006,9003,1,735600000,735600000,13501,4500,9001,4500,0,1,4502,32037266,32.037266
5700,6500,4500,37050000,2,36006,9003,1,735600000,735600000,13501,4500,9001,4500,0,1,4502,30935186,30.935186
5700,6500,4500,37050000,2,36006,9003,1,735600000,735600000,13501,4500,9001,4500,0,1,4502,32318907,32.318907
5700,6500,4500,37050000,2,36006,9003,1,735600000,735600000,13501,4500,9001,4500,0,1,4502,30821031,30.821031
5700,6500,4500,37050000,2,36006,9003,1,735600000,735600000,13501,4500,9001,4500,0,1,4502,32644864,32.644864
5700,6500,4900,37050000,2,39206,9803,1,774640000,774640000,14701,4900,9801,4900,0,1,4902,33886667,33.886667
5700,6500,4900,37050000,2,39206,9803,1,774640000,774640000,14701,4900,9801,4900,0,1,4902,35158708,35.158708
5700,6500,4900,37050000,2,39206,9803,1,774640000,774640000,14701,4900,9801,4900,0,1,4902,34165836,34.165836
5700,6500,4900,37050000,2,39206,9803,1,774640000,774640000,14701,4900,9801,4900,0,1,4902,34863279,34.863279
5700,6500,4900,37050000,2,39206,9803,1,774640000,774640000,14701,4900,9801,4900,0,1,4902,33664947,33.664947
5700,6500,4900,37050000,2,39206,9803,1,774640000,774640000,14701,4900,9801,4900,0,1,4902,35204751,35.204751
5700,6500,4900,37050000,2,39206,9803,1,774640000,774640000,14701,4900,9801,4900,0,1,4902,33582874,33.582874
5700,6500,4900,37050000,2,39206,9803,1,774640000,774640000,14701,4900,9801,4900,0,1,4902,35563651,35.563651
5700,6500,5300,37050000,2,42406,10603,1,813680000,813680000,15901,5300,10601,5300,0,1,5302,36582286,36.582286
5700,6500,5300,37050000,2,42406,10603,1,813680000,813680000,15901,5300,10601,5300,0,1,5302,38097931,38.097931
5700,6500,5300,37050000,2,42406,10603,1,813680000,813680000,15901,5300,10601,5300,0,1,5302,36844151,36.844151
5700,6500,5300,37050000,2,42406,10603,1,813680000,813680000,15901,5300,10601,5300,0,1,5302,37727682,37.727682
5700,6500,5300,37050000,2,42406,10603,1,813680000,813680000,15901,5300,10601,5300,0,1,5302,36413923,36.413923
5700,6500,5300,37050000,2,42406,10603,1,813680000,813680000,15901,5300,10601,5300,0,1,5302,38045768,38.045768
5700,6500,5300,37050000,2,42406,10603,1,813680000,813680000,15901,5300,10601,5300,0,1,5302,36278498,36.278498
5700,6500,5300,37050000,2,42406,10603,1,813680000,813680000,15901,5300,10601,5300,0,1,5302,38434985,38.434985
5700,6500,5700,37050000,2,45606,11403,1,852720000,852720000,17101,5700,11401,5700,0,1,5702,39389251,39.389251
5700,6500,5700,37050000,2,45606,11403,1,852720000,852720000,17101,5700,11401,5700,0,1,5702,40953356,40.953356
5700,6500,5700,37050000,2,45606,11403,1,852720000,852720000,17101,5700,11401,5700,0,1,5702,39606057,39.606057
5700,6500,5700,37050000,2,45606,11403,1,852720000,852720000,17101,5700,11401,5700,0,1,5702,40667029,40.667029
5700,6500,5700,37050000,2,45606,11403,1,852720000,852720000,17101,5700,11401,5700,0,1,5702,39190986,39.190986
5700,6500,5700,37050000,2,45606,11403,1,852720000,852720000,17101,5700,11401,5700,0,1,5702,40900991,40.900991
5700,6500,5700,37050000,2,45606,11403,1,852720000,852720000,17101,5700,11401,5700,0,1,5702,38995069,38.995069
5700,6500,5700,37050000,2,45606,11403,1,852720000,852720000,17101,5700,11401,5700,0,1,5702,41413823,41.413823
5700,6500,6100,37050000,2,48806,12203,1,891760000,891760000,18301,6100,12201,6100,0,1,6102,42109803,42.109803
5700,6500,6100,37050000,2,48806,12203,1,891760000,891760000,18301,6100,12201,6100,0,1,6102,43873731,43.873731
5700,6500,6100,37050000,2,48806,12203,1,891760000,891760000,18301,6100,12201,6100,0,1,6102,42394074,42.394074
5700,6500,6100,37050000,2,48806,12203,1,891760000,891760000,18301,6100,12201,6100,0,1,6102,43480303,43.480303
5700,6500,6100,37050000,2,48806,12203,1,891760000,891760000,18301,6100,12201,6100,0,1,6102,41923044,41.923044
5700,6500,6100,37050000,2,48806,12203,1,891760000,891760000,18301,6100,12201,6100,0,1,6102,43845473,43.845473
5700,6500,6100,37050000,2,48806,12203,1,891760000,891760000,18301,6100,12201,6100,0,1,6102,41730277,41.730277
5700,6500,6100,37050000,2,48806,12203,1,891760000,891760000,18301,6100,12201,6100,0,1,6102,44268119,44.268119
5700,6500,6500,37050000,2,52006,13003,1,930800000,930800000,19501,6500,13001,6500,0,1,6502,44826345,44.826345
5700,6500,6500,37050000,2,52006,13003,1,930800000,930800000,19501,6500,13001,6500,0,1,6502,46605142,46.605142
5700,6500,6500,37050000,2,52006,13003,1,930800000,930800000,19501,6500,13001,6500,0,1,6502,45113007,45.113007
5700,6500,6500,37050000,2,52006,13003,1,930800000,930800000,19501,6500,13001,6500,0,1,6502,46335194,46.335194
5700,6500,6500,37050000,2,52006,13003,1,930800000,930800000,19501,6500,13001,6500,0,1,6502,44631254,44.631254
5700,6500,6500,37050000,2,52006,13003,1,930800000,930800000,19501,6500,13001,6500,0,1,6502,46672285,46.672285
5700,6500,6500,37050000,2,52006,13003,1,930800000,930800000,19501,6500,13001,6500,0,1,6502,44436957,44.436957
5700,6500,6500,37050000,2,52006,13003,1,930800000,930800000,19501,6500,13001,6500,0,1,6502,47161277,47.161277
5700,6500,6900,37050000,2,55206,13803,1,969840000,969840000,20701,6900,13801,6900,0,1,6902,47575759,47.575759
5700,6500,6900,37050000,2,55206,13803,1,969840000,969840000,20701,6900,13801,6900,0,1,6902,49567504,49.567504
5700,6500,6900,37050000,2,55206,13803,1,969840000,969840000,20701,6900,13801,6900,0,1,6902,47888645,47.888645
5700,6500,6900,37050000,2,55206,13803,1,969840000,969840000,20701,6900,13801,6900,0,1,6902,49165017,49.165017
5700,6500,6900,37050000,2,55206,13803,1,969840000,969840000,20701,6900,13801,6900,0,1,6902,47329840,47.32984
5700,6500,6900,37050000,2,55206,13803,1,969840000,969840000,20701,6900,13801,6900,0,1,6902,49512741,49.512741
5700,6500,6900,37050000,2,55206,13803,1,969840000,969840000,20701,6900,13801,6900,0,1,6902,47237878,47.237878
5700,6500,6900,37050000,2,55206,13803,1,969840000,969840000,20701,6900,13801,6900,0,1,6902,50014966,50.014966
5700,6100,500,34770000,2,4006,1003,1,325360000,325360000,1501,500,1001,500,0,1,502,3707679,3.707679
5700,6100,500,34770000,2,4006,1003,1,325360000,325360000,1501,500,1001,500,0,1,502,3767781,3.767781
5700,6100,500,34770000,2,4006,1003,1,325360000,325360000,1501,500,1001,500,0,1,502,3708926,3.708926
5700,6100,500,34770000,2,4006,1003,1,325360000,325360000,1501,500,1001,500,0,1,502,3791862,3.791862
5700,6100,500,34770000,2,4006,1003,1,325360000,325360000,1501,500,1001,500,0,1,502,3708221,3.708221
5700,6100,500,34770000,2,4006,1003,1,325360000,325360000,1501,500,1001,500,0,1,502,3683937,3.683937
5700,6100,500,34770000,2,4006,1003,1,325360000,325360000,1501,500,1001,500,0,1,502,3657017,3.657017
5700,6100,500,34770000,2,4006,1003,1,325360000,325360000,1501,500,1001,500,0,1,502,3836540,3.83654
5700,6100,900,34770000,2,7206,1803,1,363120000,363120000,2701,900,1801,900,0,1,902,6064536,6.064536
5700,6100,900,34770000,2,7206,1803,1,363120000,363120000,2701,900,1801,900,0,1,902,6305768,6.305768
5700,6100,900,34770000,2,7206,1803,1,363120000,363120000,2701,900,1801,900,0,1,902,6108583,6.108583
5700,6100,900,34770000,2,7206,1803,1,363120000,363120000,2701,900,1801,900,0,1,902,6257431,6.257431
5700,6100,900,34770000,2,7206,1803,1,363120000,363120000,2701,900,1801,900,0,1,902,6040602,6.040602
5700,6100,900,34770000,2,7206,1803,1,363120000,363120000,2701,900,1801,900,0,1,902,6282776,6.282776
5700,6100,900,34770000,2,7206,1803,1,363120000,363120000,2701,900,1801,900,0,1,902,6016757,6.016757
5700,6100,900,34770000,2,7206,1803,1,363120000,363120000,2701,900,1801,900,0,1,902,6355366,6.355366
5700,6100,1300,34770000,2,10406,2603,1,400880000,400880000,3901,1300,2601,1300,0,1,1302,8592718,8.592718
5700,6100,1300,34770000,2,10406,2603,1,400880000,400880000,3901,1300,2601,1300,0,1,1302,8907809,8.907809
5700,6100,1300,34770000,2,10406,2603,1,400880000,400880000,3901,1300,2601,1300,0,1,1302,8680258,8.680258
5700,6100,1300,34770000,2,10406,2603,1,400880000,400880000,3901,1300,2601,1300,0,1,1302,8826668,8.826668
5700,6100,1300,34770000,2,10406,2603,1,400880000,400880000,3901,1300,2601,1300,0,1,1302,8533384,8.533384
5700,6100,1300,34770000,2,10406,2603,1,400880000,400880000,3901,1300,2601,1300,0,1,1302,9001047,9.001047
5700,6100,1300,34770000,2,10406,2603,1,400880000,400880000,3901,1300,2601,1300,0,1,1302,8498761,8.498761
5700,6100,1300,34770000,2,10406,2603,1,400880000,400880000,3901,1300,2601,1300,0,1,1302,9026690,9.02669
5700,6100,1700,34770000,2,13606,3403,1,438640000,438640000,5101,1700,3401,1700,0,1,1702,11317063,11.317063
5700,6100,1700,34770000,2,13606,3403,1,438640000,438640000,5101,1700,3401,1700,0,1,1702,11712720,11.71272
5700,6100,1700,34770000,2,13606,3403,1,438640000,438640000,5101,1700,3401,1700,0,1,1702,11422629,11.422629
5700,6100,1700,34770000,2,13606,3403,1,438640000,438640000,5101,1700,3401,1700,0,1,1702,11548135,11.548135
5700,6100,1700,34770000,2,13606,3403,1,438640000,438640000,5101,1700,3401,1700,0,1,1702,11286732,11.286732
5700,6100,1700,34770000,2,13606,3403,1,438640000,438640000,5101,1700,3401,1700,0,1,1702,11689618,11.689618
5700,6100,1700,34770000,2,13606,3403,1,438640000,438640000,5101,1700,3401,1700,0,1,1702,11255664,11.255664
5700,6100,1700,34770000,2,13606,3403,1,438640000,438640000,5101,1700,3401,1700,0,1,1702,11818121,11.818121
5700,6100,2100,34770000,2,16806,4203,1,476400000,476400000,6301,2100,4201,2100,0,1,2102,13861238,13.861238
5700,6100,2100,34770000,2,16806,4203,1,476400000,476400000,6301,2100,4201,2100,0,1,2102,14301101,14.301101
5700,6100,2100,34770000,2,16806,4203,1,476400000,476400000,6301,2100,4201,2100,0,1,2102,13980598,13.980598
5700,6100,2100,34770000,2,16806,4203,1,476400000,476400000,6301,2100,4201,2100,0,1,2102,14188311,14.188311
5700,6100,2100,34770000,2,16806,4203,1,476400000,476400000,6301,2100,4201,2100,0,1,2102,13827363,13.827363
5700,6100,2100,34770000,2,16806,4203,1,476400000,476400000,6301,2100,4201,2100,0,1,2102,14359481,14.359481
5700,6100,2100,34770000,2,16806,4203,1,476400000,476400000,6301,2100,4201,2100,0,1,2102,13687667,13.687667
5700,6100,2100,34770000,2,16806,4203,1,476400000,476400000,6301,2100,4201,2100,0,1,2102,14516379,14.516379
5700,6100,2500,34770000,2,20006,5003,1,514160000,514160000,7501,2500,5001,2500,0,1,2502,16414847,16.414847
5700,6100,2500,34770000,2,20006,5003,1,514160000,514160000,7501,2500,5001,2500,0,1,2502,17012135,17.012135
5700,6100,2500,34770000,2,20006,5003,1,514160000,514160000,7501,2500,5001,2500,0,1,2502,16549923,16.549923
5700,6100,2500,34770000,2,20006,5003,1,514160000,514160000,7501,2500,5001,2500,0,1,2502,16822412,16.822412
5700,6100,2500,34770000,2,20006,5003,1,514160000,514160000,7501,2500,5001,2500,0,1,2502,16350428,16.350428
5700,6100,2500,34770000,2,20006,5003,1,514160000,514160000,7501,2500,5001,2500,0,1,2502,17038193,17.038193
5700,6100,2500,34770000,2,20006,5003,1,514160000,514160000,7501,2500,5001,2500,0,1,2502,16217222,16.217222
5700,6100,2500,34770000,2,20006,5003,1,514160000,514160000,7501,2500,5001,2500,0,1,2502,17194589,17.194589
5700,6100,2900,34770000,2,23206,5803,1,551920000,551920000,8701,2900,5801,2900,0,1,2902,18972438,18.972438
5700,6100,2900,34770000,2,23206,5803,1,551920000,551920000,8701,2900,5801,2900,0,1,2902,19602931,19.602931
5700,6100,2900,34770000,2,23206,5803,1,551920000,551920000,8701,2900,5801,2900,0,1,2902,19109641,19.109641
5700,6100,2900,34770000,2,23206,5803,1,551920000,551920000,8701,2900,5801,2900,0,1,2902,19503835,19.503835
5700,6100,2900,34770000,2,23206,5803,1,551920000,551920000,8701,2900,5801,2900,0,1,2902,18899117,18.899117
5700,6100,2900,34770000,2,23206,5803,1,551920000,551920000,8701,2900,5801,2900,0,1,2902,19679205,19.679205
5700,6100,2900,34770000,2,23206,5803,1,551920000,551920000,8701,2900,5801,2900,0,1,2902,18727945,18.727945
5700,6100,2900,34770000,2,23206,5803,1,551920000,551920000,8701,2900,5801,2900,0,1,2902,19897927,19.897927
5700,6100,3300,34770000,2,26406,6603,1,589680000,589680000,9901,3300,6601,3300,0,1,3302,21540347,21.540347
5700,6100,3300,34770000,2,26406,6603,1,589680000,589680000,9901,3300,6601,3300,0,1,3302,22284514,22.284514
5700,6100,3300,34770000,2,26406,6603,1,589680000,589680000,9901,3300,6601,3300,0,1,3302,21698056,21.698056
5700,6100,3300,34770000,2,26406,6603,1,589680000,589680000,9901,3300,6601,3300,0,1,3302,22154693,22.154693
5700,6100,3300,34770000,2,26406,6603,1,589680000,589680000,9901,3300,6601,3300,0,1,3302,21456860,21.45686
5700,6100,3300,34770000,2,26406,6603,1,589680000,589680000,9901,3300,6601,3300,0,1,3302,22322021,22.322021
5700,6100,3300,34770000,2,26406,6603,1,589680000,589680000,9901,3300,6601,3300,0,1,3302,21264919,21.264919
5700,6100,3300,34770000,2,26406,6603,1,589680000,589680000,9901,3300,6601,3300,0,1,3302,22600513,22.600513
5700,6100,3700,34770000,2,29606,7403,1,627440000,627440000,11101,3700,7401,3700,0,1,3702,24108246,24.108246
5700,6100,3700,34770000,2,29606,7403,1,627440000,627440000,11101,3700,7401,3700,0,1,3702,25014055,25.014055
5700,6100,3700,34770000,2,29606,7403,1,627440000,627440000,11101,3700,7401,3700,0,1,3702,24244630,24.24463
5700,6100,3700,34770000,2,29606,7403,1,627440000,627440000,11101,3700,7401,3700,0,1,3702,24802725,24.802725
5700,6100,3700,34770000,2,29606,7403,1,627440000,627440000,11101,3700,7401,3700,0,1,3702,24010886,24.010886
5700,6100,3700,34770000,2,29606,7403,1,627440000,627440000,11101,3700,7401,3700,0,1,3702,24969704,24.969704
5700,6100,3700,34770000,2,29606,7403,1,627440000,627440000,11101,3700,7401,3700,0,1,3702,23799134,23.799134
5700,6100,3700,34770000,2,29606,7403,1,627440000,627440000,11101,3700,7401,3700,0,1,3702,25356817,25.356817
5700,6100,4100,34770000,2,32806,8203,1,665200000,665200000,12301,4100,8201,4100,0,1,4102,26673235,26.673235
5700,6100,4100,34770000,2,32806,8203,1,665200000,665200000,12301,4100,8201,4100,0,1,4102,27606677,27.606677
5700,6100,4100,34770000,2,32806,8203,1,665200000,665200000,12301,4100,8201,4100,0,1,4102,26809117,26.809117
5700,6100,4100,34770000,2,32806,8203,1,665200000,665200000,12301,4100,8201,4100,0,1,4102,27393424,27.393424
5700,6100,4100,34770000,2,32806,8203,1,665200000,665200000,12301,4100,8201,4100,0,1,4102,26563244,26.563244
5700,6100,4100,34770000,2,32806,8203,1,665200000,665200000,12301,4100,8201,4100,0,1,4102,27782183,27.782183
5700,6100,4100,34770000,2,32806,8203,1,665200000,665200000,12301,4100,8201,4100,0,1,4102,26333278,26.333278
5700,6100,4100,34770000,2,32806,8203,1,665200000,665200000,12301,4100,8201,4100,0,1,4102,27954537,27.954537
5700,6100,4500,34770000,2,36006,9003,1,702960000,702960000,13501,4500,9001,4500,0,1,4502,29216290,29.21629
5700,6100,4500,34770000,2,36006,9003,1,702960000,702960000,13501,4500,9001,4500,0,1,4502,30339442,30.339442
5700,6100,4500,34770000,2,36006,9003,1,702960000,702960000,13501,4500,9001,4500,0,1,4502,29404811,29.404811
5700,6100,4500,34770000,2,36006,9003,1,702960000,702960000,13501,4500,9001,4500,0,1,4502,30036062,30.036062
5700,6100,4500,34770000,2,36006,9003,1,702960000,702960000,13501,4500,9001,4500,0,1,4502,29092220,29.09222
5700,6100,4500,34770000,2,36006,9003,1,702960000,702960000,13501,4500,9001,4500,0,1,4502,30365126,30.365126
5700,6100,4500,34770000,2,36006,9003,1,702960000,702960000,13501,4500,9001,4500,0,1,4502,28910182,28.910182
5700,6100,4500,34770000,2,36006,9003,1,702960000,702960000,13501,4500,9001,4500,0,1,4502,30686309,30.686309
5700,6100,4900,34770000,2,39206,9803,1,740720000,740720000,14701,4900,9801,4900,0,1,4902,31796676,31.796676
5700,6100,4900,34770000,2,39206,9803,1,740720000,740720000,14701,4900,9801,4900,0,1,4902,33039784,33.039784
5700,6100,4900,34770000,2,39206,9803,1,740720000,740720000,14701,4900,9801,4900,0,1,4902,32056595,32.056595
5700,6100,4900,34770000,2,39206,9803,1,740720000,740720000,14701,4900,9801,4900,0,1,4902,32681620,32.68162
5700,6100,4900,34770000,2,39206,9803,1,740720000,740720000,14701,4900,9801,4900,0,1,4902,31658829,31.658829
5700,6100,4900,34770000,2,39206,9803,1,740720000,740720000,14701,4900,9801,4900,0,1,4902,33065126,33.065126
5700,6100,4900,34770000,2,39206,9803,1,740720000,740720000,14701,4900,9801,4900,0,1,4902,31475344,31.475344
5700,6100,4900,34770000,2,39206,9803,1,740720000,740720000,14701,4900,9801,4900,0,1,4902,33443224,33.443224
5700,6100,5300,34770000,2,42406,10603,1,778480000,778480000,15901,5300,10601,5300,0,1,5302,34420396,34.420396
5700,6100,5300,34770000,2,42406,10603,1,778480000,778480000,15901,5300,10601,5300,0,1,5302,35751484,35.751484
5700,6100,5300,34770000,2,42406,10603,1,778480000,778480000,15901,5300,10601,5300,0,1,5302,34624788,34.624788
5700,6100,5300,34770000,2,42406,10603,1,778480000,778480000,15901,5300,10601,5300,0,1,5302,35408296,35.408296
5700,6100,5300,34770000,2,42406,10603,1,778480000,778480000,15901,5300,10601,5300,0,1,5302,34312056,34.312056
5700,6100,5300,34770000,2,42406,10603,1,778480000,778480000,15901,5300,10601,5300,0,1,5302,35811755,35.811755
5700,6100,5300,34770000,2,42406,10603,1,778480000,778480000,15901,5300,10601,5300,0,1,5302,34028437,34.028437
5700,6100,5300,34770000,2,42406,10603,1,778480000,778480000,15901,5300,10601,5300,0,1,5302,36143281,36.143281
5700,6100,5700,34770000,2,45606,11403,1,816240000,816240000,17101,5700,11401,5700,0,1,5702,36994771,36.994771
5700,6100,5700,34770000,2,45606,11403,1,816240000,816240000,17101,5700,11401,5700,0,1,5702,38390481,38.390481
5700,6100,5700,34770000,2,45606,11403,1,816240000,816240000,17101,5700,11401,5700,0,1,5702,37222603,37.222603
5700,6100,5700,34770000,2,45606,11403,1,816240000,816240000,17101,5700,11401,5700,0,1,5702,38089066,38.089066
5700,6100,5700,34770000,2,45606,11403,1,816240000,816240000,17101,5700,11401,5700,0,1,5702,36860517,36.860517
5700,6100,5700,34770000,2,45606,11403,1,816240000,816240000,17101,5700,11401,5700,0,1,5702,38439904,38.439904
5700,6100,5700,34770000,2,45606,11403,1,816240000,816240000,17101,5700,11401,5700,0,1,5702,36615910,36.61591
5700,6100,5700,34770000,2,45606,11403,1,816240000,816240000,17101,5700,11401,5700,0,1,5702,38857852,38.857852
5700,6100,6100,34770000,2,48806,12203,1,854000000,854000000,18301,6100,12201,6100,0,1,6102,39602054,39.602054
5700,6100,6100,34770000,2,48806,12203,1,854000000,854000000,18301,6100,12201,6100,0,1,6102,41103623,41.103623
5700,6100,6100,34770000,2,48806,12203,1,854000000,854000000,18301,6100,12201,6100,0,1,6102,39799618,39.799618
5700,6100,6100,34770000,2,48806,12203,1,854000000,854000000,18301,6100,12201,6100,0,1,6102,40737631,40.737631
5700,6100,6100,34770000,2,48806,12203,1,854000000,854000000,18301,6100,12201,6100,0,1,6102,39448779,39.448779
5700,6100,6100,34770000,2,48806,12203,1,854000000,854000000,18301,6100,12201,6100,0,1,6102,41131244,41.131244
5700,6100,6100,34770000,2,48806,12203,1,854000000,854000000,18301,6100,12201,6100,0,1,6102,39188419,39.188419
5700,6100,6100,34770000,2,48806,12203,1,854000000,854000000,18301,6100,12201,6100,0,1,6102,41624023,41.624023
5700,6100,6500,34770000,2,52006,13003,1,891760000,891760000,19501,6500,13001,6500,0,1,6502,42124550,42.12455
5700,6100,6500,34770000,2,52006,13003,1,891760000,891760000,19501,6500,13001,6500,0,1,6502,43961706,43.961706
5700,6100,6500,34770000,2,52006,13003,1,891760000,891760000,19501,6500,13001,6500,0,1,6502,42465477,42.465477
5700,6100,6500,34770000,2,52006,13003,1,891760000,891760000,19501,6500,13001,6500,0,1,6502,43484665,43.484665
5700,6100,6500,34770000,2,52006,13003,1,891760000,891760000,19501,6500,13001,6500,0,1,6502,41874691,41.874691
5700,6100,6500,34770000,2,52006,13003,1,891760000,891760000,19501,6500,13001,6500,0,1,6502,43825934,43.825934
5700,6100,6500,34770000,2,52006,13003,1,891760000,891760000,19501,6500,13001,6500,0,1,6502,41778741,41.778741
5700,6100,6500,34770000,2,52006,13003,1,891760000,891760000,19501,6500,13001,6500,0,1,6502,44324910,44.32491
5700,6100,6900,34770000,2,55206,13803,1,929520000,929520000,20701,6900,13801,6900,0,1,6902,44773344,44.773344
5700,6100,6900,34770000,2,55206,13803,1,929520000,929520000,20701,6900,13801,6900,0,1,6902,46596818,46.596818
5700,6100,6900,34770000,2,55206,13803,1,929520000,929520000,20701,6900,13801,6900,0,1,6902,45077618,45.077618
5700,6100,6900,34770000,2,55206,13803,1,929520000,929520000,20701,6900,13801,6900,0,1,6902,46183999,46.183999
5700,6100,6900,34770000,2,55206,13803,1,929520000,929520000,20701,6900,13801,6900,0,1,6902,44599453,44.599453
5700,6100,6900,34770000,2,55206,13803,1,929520000,929520000,20701,6900,13801,6900,0,1,6902,46506318,46.506318
5700,6100,6900,34770000,2,55206,13803,1,929520000,929520000,20701,6900,13801,6900,0,1,6902,44401150,44.40115
5700,6100,6900,34770000,2,55206,13803,1,929520000,929520000,20701,6900,13801,6900,0,1,6902,46986181,46.986181
5700,5700,500,32490000,2,4006,1003,1,305520000,305520000,1501,500,1001,500,0,1,502,3422989,3.422989
5700,5700,500,32490000,2,4006,1003,1,305520000,305520000,1501,500,1001,500,0,1,502,3572975,3.572975
5700,5700,500,32490000,2,4006,1003,1,305520000,305520000,1501,500,1001,500,0,1,502,3527292,3.527292
5700,5700,500,32490000,2,4006,1003,1,305520000,305520000,1501,500,1001,500,0,1,502,3400781,3.400781
5700,5700,500,32490000,2,4006,1003,1,305520000,305520000,1501,500,1001,500,0,1,502,3549093,3.549093
5700,5700,500,32490000,2,4006,1003,1,305520000,305520000,1501,500,1001,500,0,1,502,3526523,3.526523
5700,5700,500,32490000,2,4006,1003,1,305520000,305520000,1501,500,1001,500,0,1,502,3453881,3.453881
5700,5700,500,32490000,2,4006,1003,1,305520000,305520000,1501,500,1001,500,0,1,502,3502335,3.502335
5700,5700,900,32490000,2,7206,1803,1,342000000,342000000,2701,900,1801,900,0,1,902,5649614,5.649614
5700,5700,900,32490000,2,7206,1803,1,342000000,342000000,2701,900,1801,900,0,1,902,5888295,5.888295
5700,5700,900,32490000,2,7206,1803,1,342000000,342000000,2701,900,1801,900,0,1,902,5710859,5.710859
5700,5700,900,32490000,2,7206,1803,1,342000000,342000000,2701,900,1801,900,0,1,902,5830434,5.830434
5700,5700,900,32490000,2,7206,1803,1,342000000,342000000,2701,900,1801,900,0,1,902,5622913,5.622913
5700,5700,900,32490000,2,7206,1803,1,342000000,342000000,2701,900,1801,900,0,1,902,5863679,5.863679
5700,5700,900,32490000,2,7206,1803,1,342000000,342000000,2701,900,1801,900,0,1,902,5590406,5.590406
5700,5700,900,32490000,2,7206,1803,1,342000000,342000000,2701,900,1801,900,0,1,902,5955940,5.95594
5700,5700,1300,32490000,2,10406,2603,1,378480000,378480000,3901,1300,2601,1300,0,1,1302,8043023,8.043023
5700,5700,1300,32490000,2,10406,2603,1,378480000,378480000,3901,1300,2601,1300,0,1,1302,8321523,8.321523
5700,5700,1300,32490000,2,10406,2603,1,378480000,378480000,3901,1300,2601,1300,0,1,1302,8102963,8.102963
5700,5700,1300,32490000,2,10406,2603,1,378480000,378480000,3901,1300,2601,1300,0,1,1302,8246774,8.246774
5700,5700,1300,32490000,2,10406,2603,1,378480000,378480000,3901,1300,2601,1300,0,1,1302,7994571,7.994571
5700,5700,1300,32490000,2,10406,2603,1,378480000,378480000,3901,1300,2601,1300,0,1,1302,8344722,8.344722
5700,5700,1300,32490000,2,10406,2603,1,378480000,378480000,3901,1300,2601,1300,0,1,1302,7954231,7.954231
5700,5700,1300,32490000,2,10406,2603,1,378480000,378480000,3901,1300,2601,1300,0,1,1302,8454523,8.454523
5700,5700,1700,32490000,2,13606,3403,1,414960000,414960000,5101,1700,3401,1700,0,1,1702,10554955,10.554955
5700,5700,1700,32490000,2,13606,3403,1,414960000,414960000,5101,1700,3401,1700,0,1,1702,10911136,10.911136
5700,5700,1700,32490000,2,13606,3403,1,414960000,414960000,5101,1700,3401,1700,0,1,1702,10643951,10.643951
5700,5700,1700,32490000,2,13606,3403,1,414960000,414960000,5101,1700,3401,1700,0,1,1702,10806595,10.806595
5700,5700,1700,32490000,2,13606,3403,1,414960000,414960000,5101,1700,3401,1700,0,1,1702,10509444,10.509444
5700,5700,1700,32490000,2,13606,3403,1,414960000,414960000,5101,1700,3401,1700,0,1,1702,10932699,10.932699
5700,5700,1700,32490000,2,13606,3403,1,414960000,414960000,5101,1700,3401,1700,0,1,1702,10434619,10.434619
5700,5700,1700,32490000,2,13606,3403,1,414960000,414960000,5101,1700,3401,1700,0,1,1702,11080544,11.080544
5700,5700,2100,32490000,2,16806,4203,1,451440000,451440000,6301,2100,4201,2100,0,1,2102,12940970,12.94097
5700,5700,2100,32490000,2,16806,4203,1,451440000,451440000,6301,2100,4201,2100,0,1,2102,13407138,13.407138
5700,5700,2100,32490000,2,16806,4203,1,451440000,451440000,6301,2100,4201,2100,0,1,2102,13052845,13.052845
5700,5700,2100,32490000,2,16806,4203,1,451440000,451440000,6301,2100,4201,2100,0,1,2102,13254244,13.254244
5700,5700,2100,32490000,2,16806,4203,1,451440000,451440000,6301,2100,4201,2100,0,1,2102,12866818,12.866818
5700,5700,2100,32490000,2,16806,4203,1,451440000,451440000,6301,2100,4201,2100,0,1,2102,13430361,13.430361
5700,5700,2100,32490000,2,16806,4203,1,451440000,451440000,6301,2100,4201,2100,0,1,2102,12800554,12.800554
5700,5700,2100,32490000,2,16806,4203,1,451440000,451440000,6301,2100,4201,2100,0,1,2102,13584804,13.584804
5700,5700,2500,32490000,2,20006,5003,1,487920000,487920000,7501,2500,5001,2500,0,1,2502,15180488,15.180488
5700,5700,2500,32490000,2,20006,5003,1,487920000,487920000,7501,2500,5001,2500,0,1,2502,15749612,15.749612
5700,5700,2500,32490000,2,20006,5003,1,487920000,487920000,7501,2500,5001,2500,0,1,2502,15313026,15.313026
5700,5700,2500,32490000,2,20006,5003,1,487920000,487920000,7501,2500,5001,2500,0,1,2502,15629173,15.629173
5700,5700,2500,32490000,2,20006,5003,1,487920000,487920000,7501,2500,5001,2500,0,1,2502,15080182,15.080182
5700,5700,2500,32490000,2,20006,5003,1,487920000,487920000,7501,2500,5001,2500,0,1,2502,15891321,15.891321
5700,5700,2500,32490000,2,20006,5003,1,487920000,487920000,7501,2500,5001,2500,0,1,2502,15007057,15.007057
5700,5700,2500,32490000,2,20006,5003,1,487920000,487920000,7501,2500,5001,2500,0,1,2502,15974083,15.974083
5700,5700,2900,32490000,2,23206,5803,1,524400000,524400000,8701,2900,5801,2900,0,1,2902,17716242,17.716242
5700,5700,2900,32490000,2,23206,5803,1,524400000,524400000,8701,2900,5801,2900,0,1,2902,18339042,18.339042
5700,5700,2900,32490000,2,23206,5803,1,524400000,524400000,8701,2900,5801,2900,0,1,2902,17847358,17.847358
5700,5700,2900,32490000,2,23206,5803,1,524400000,524400000,8701,2900,5801,2900,0,1,2902,18210425,18.210425
5700,5700,2900,32490000,2,23206,5803,1,524400000,524400000,8701,2900,5801,2900,0,1,2902,17609427,17.609427
5700,5700,2900,32490000,2,23206,5803,1,524400000,524400000,8701,2900,5801,2900,0,1,2902,18401905,18.401905
5700,5700,2900,32490000,2,23206,5803,1,524400000,524400000,8701,2900,5801,2900,0,1,2902,17531977,17.531977
5700,5700,2900,32490000,2,23206,5803,1,524400000,524400000,8701,2900,5801,2900,0,1,2902,18601504,18.601504
5700,5700,3300,32490000,2,26406,6603,1,560880000,560880000,9901,3300,6601,3300,0,1,3302,20093517,20.093517
5700,5700,3300,32490000,2,26406,6603,1,560880000,560880000,9901,3300,6601,3300,0,1,3302,20797251,20.797251
5700,5700,3300,32490000,2,26406,6603,1,560880000,560880000,9901,3300,6601,3300,0,1,3302,20269767,20.269767
5700,5700,3300,32490000,2,26406,6603,1,560880000,560880000,9901,3300,6601,3300,0,1,3302,20684911,20.684911
5700,5700,3300,32490000,2,26406,6603,1,560880000,560880000,9901,3300,6601,3300,0,1,3302,20023266,20.023266
5700,5700,3300,32490000,2,26406,6603,1,560880000,560880000,9901,3300,6601,3300,0,1,3302,20859333,20.859333
5700,5700,3300,32490000,2,26406,6603,1,560880000,560880000,9901,3300,6601,3300,0,1,3302,19898148,19.898148
5700,5700,3300,32490000,2,26406,6603,1,560880000,560880000,9901,3300,6601,3300,0,1,3302,21104744,21.104744
5700,5700,3700,32490000,2,29606,7403,1,597360000,597360000,11101,3700,7401,3700,0,1,3702,22542120,22.54212
5700,5700,3700,32490000,2,29606,7403,1,597360000,597360000,11101,3700,7401,3700,0,1,3702,23409935,23.409935
5700,5700,3700,32490000,2,29606,7403,1,597360000,597360000,11101,3700,7401,3700,0,1,3702,22725265,22.725265
5700,5700,3700,32490000,2,29606,7403,1,597360000,597360000,11101,3700,7401,3700,0,1,3702,23124232,23.124232
5700,5700,3700,32490000,2,29606,7403,1,597360000,597360000,11101,3700,7401,3700,0,1,3702,22519548,22.519548
5700,5700,3700,32490000,2,29606,7403,1,597360000,597360000,11101,3700,7401,3700,0,1,3702,23459729,23.459729
5700,5700,3700,32490000,2,29606,7403,1,597360000,597360000,11101,3700,7401,3700,0,1,3702,22364300,22.3643
5700,5700,3700,32490000,2,29606,7403,1,597360000,597360000,11101,3700,7401,3700,0,1,3702,23647551,23.647551
5700,5700,4100,32490000,2,32806,8203,1,633840000,633840000,12301,4100,8201,4100,0,1,4102,24890628,24.890628
5700,5700,4100,32490000,2,32806,8203,1,633840000,633840000,12301,4100,8201,4100,0,1,4102,25822240,25.82224
5700,5700,4100,32490000,2,32806,8203,1,633840000,633840000,12301,4100,8201,4100,0,1,4102,25060227,25.060227
5700,5700,4100,32490000,2,32806,8203,1,633840000,633840000,12301,4100,8201,4100,0,1,4102,25576657,25.576657
5700,5700,4100,32490000,2,32806,8203,1,633840000,633840000,12301,4100,8201,4100,0,1,4102,24840292,24.840292
5700,5700,4100,32490000,2,32806,8203,1,633840000,633840000,12301,4100,8201,4100,0,1,4102,25882075,25.882075
5700,5700,4100,32490000,2,32806,8203,1,633840000,633840000,12301,4100,8201,4100,0,1,4102,24624198,24.624198
5700,5700,4100,32490000,2,32806,8203,1,633840000,633840000,12301,4100,8201,4100,0,1,4102,26145833,26.145833
5700,5700,4500,32490000,2,36006,9003,1,670320000,670320000,13501,4500,9001,4500,0,1,4502,27311450,27.31145
5700,5700,4500,32490000,2,36006,9003,1,670320000,670320000,13501,4500,9001,4500,0,1,4502,28299973,28.299973
5700,5700,4500,32490000,2,36006,9003,1,670320000,670320000,13501,4500,9001,4500,0,1,4502,27453368,27.453368
5700,5700,4500,32490000,2,36006,9003,1,670320000,670320000,13501,4500,9001,4500,0,1,4502,28045457,28.045457
5700,5700,4500,32490000,2,36006,9003,1,670320000,670320000,13501,4500,9001,4500,0,1,4502,27202549,27.202549
5700,5700,4500,32490000,2,36006,9003,1,670320000,670320000,13501,4500,9001,4500,0,1,4502,28356340,28.35634
5700,5700,4500,32490000,2,36006,9003,1,670320000,670320000,13501,4500,9001,4500,0,1,4502,26982131,26.982131
5700,5700,4500,32490000,2,36006,9003,1,670320000,670320000,13501,4500,9001,4500,0,1,4502,28687195,28.687195
5700,5700,4900,32490000,2,39206,9803,1,706800000,706800000,14701,4900,9801,4900,0,1,4902,29681058,29.681058
5700,5700,4900,32490000,2,39206,9803,1,706800000,706800000,14701,4900,9801,4900,0,1,4902,30864510,30.86451
5700,5700,4900,32490000,2,39206,9803,1,706800000,706800000,14701,4900,9801,4900,0,1,4902,29897718,29.897718
5700,5700,4900,32490000,2,39206,9803,1,706800000,706800000,14701,4900,9801,4900,0,1,4902,30544172,30.544172
5700,5700,4900,32490000,2,39206,9803,1,706800000,706800000,14701,4900,9801,4900,0,1,4902,29629947,29.629947
5700,5700,4900,32490000,2,39206,9803,1,706800000,706800000,14701,4900,9801,4900,0,1,4902,30905525,30.905525
5700,5700,4900,32490000,2,39206,9803,1,706800000,706800000,14701,4900,9801,4900,0,1,4902,29390181,29.390181
5700,5700,4900,32490000,2,39206,9803,1,706800000,706800000,14701,4900,9801,4900,0,1,4902,31190235,31.190235
5700,5700,5300,32490000,2,42406,10603,1,743280000,743280000,15901,5300,10601,5300,0,1,5302,32117764,32.117764
5700,5700,5300,32490000,2,42406,10603,1,743280000,743280000,15901,5300,10601,5300,0,1,5302,33347934,33.347934
5700,5700,5300,32490000,2,42406,10603,1,743280000,743280000,15901,5300,10601,5300,0,1,5302,32369973,32.369973
5700,5700,5300,32490000,2,42406,10603,1,743280000,743280000,15901,5300,10601,5300,0,1,5302,33055046,33.055046
5700,5700,5300,32490000,2,42406,10603,1,743280000,743280000,15901,5300,10601,5300,0,1,5302,32013577,32.013577
5700,5700,5300,32490000,2,42406,10603,1,743280000,743280000,15901,5300,10601,5300,0,1,5302,33392424,33.392424
5700,5700,5300,32490000,2,42406,10603,1,743280000,743280000,15901,5300,10601,5300,0,1,5302,31810592,31.810592
5700,5700,5300,32490000,2,42406,10603,1,743280000,743280000,15901,5300,10601,5300,0,1,5302,33767672,33.767672
5700,5700,5700,32490000,2,45606,11403,1,779760000,779760000,17101,5700,11401,5700,0,1,5702,34547759,34.547759
5700,5700,5700,32490000,2,45606,11403,1,779760000,779760000,17101,5700,11401,5700,0,1,5702,35817582,35.817582
5700,5700,5700,32490000,2,45606,11403,1,779760000,779760000,17101,5700,11401,5700,0,1,5702,34711038,34.711038
5700,5700,5700,32490000,2,45606,11403,1,779760000,779760000,17101,5700,11401,5700,0,1,5702,35505590,35.50559
5700,5700,5700,32490000,2,45606,11403,1,779760000,779760000,17101,5700,11401,5700,0,1,5702,34431588,34.431588
5700,5700,5700,32490000,2,45606,11403,1,779760000,779760000,17101,5700,11401,5700,0,1,5702,35882206,35.882206
5700,5700,5700,32490000,2,45606,11403,1,779760000,779760000,17101,5700,11401,5700,0,1,5702,34183475,34.183475
5700,5700,5700,32490000,2,45606,11403,1,779760000,779760000,17101,5700,11401,5700,0,1,5702,36292038,36.292038
5700,5700,6100,32490000,2,48806,12203,1,816240000,816240000,18301,6100,12201,6100,0,1,6102,36982282,36.982282
5700,5700,6100,32490000,2,48806,12203,1,816240000,816240000,18301,6100,12201,6100,0,1,6102,38462266,38.462266
5700,5700,6100,32490000,2,48806,12203,1,816240000,816240000,18301,6100,12201,6100,0,1,6102,37193082,37.193082
5700,5700,6100,32490000,2,48806,12203,1,816240000,816240000,18301,6100,12201,6100,0,1,6102,38124770,38.12477
5700,5700,6100,32490000,2,48806,12203,1,816240000,816240000,18301,6100,12201,6100,0,1,6102,36861904,36.861904
5700,5700,6100,32490000,2,48806,12203,1,816240000,816240000,18301,6100,12201,6100,0,1,6102,38510108,38.510108
5700,5700,6100,32490000,2,48806,12203,1,816240000,816240000,18301,6100,12201,6100,0,1,6102,36559576,36.559576
5700,5700,6100,32490000,2,48806,12203,1,816240000,816240000,18301,6100,12201,6100,0,1,6102,38879878,38.879878
5700,5700,6500,32490000,2,52006,13003,1,852720000,852720000,19501,6500,13001,6500,0,1,6502,39365056,39.365056
5700,5700,6500,32490000,2,52006,13003,1,852720000,852720000,19501,6500,13001,6500,0,1,6502,40934920,40.93492
5700,5700,6500,32490000,2,52006,13003,1,852720000,852720000,19501,6500,13001,6500,0,1,6502,39606957,39.606957
5700,5700,6500,32490000,2,52006,13003,1,852720000,852720000,19501,6500,13001,6500,0,1,6502,40532482,40.532482
5700,5700,6500,32490000,2,52006,13003,1,852720000,852720000,19501,6500,13001,6500,0,1,6502,39220420,39.22042
5700,5700,6500,32490000,2,52006,13003,1,852720000,852720000,19501,6500,13001,6500,0,1,6502,40907139,40.907139
5700,5700,6500,32490000,2,52006,13003,1,852720000,852720000,19501,6500,13001,6500,0,1,6502,38949957,38.949957
5700,5700,6500,32490000,2,52006,13003,1,852720000,852720000,19501,6500,13001,6500,0,1,6502,41365426,41.365426
5700,5700,6900,32490000,2,55206,13803,1,889200000,889200000,20701,6900,13801,6900,0,1,6902,41774750,41.77475
5700,5700,6900,32490000,2,55206,13803,1,889200000,889200000,20701,6900,13801,6900,0,1,6902,43415214,43.415214
5700,5700,6900,32490000,2,55206,13803,1,889200000,889200000,20701,6900,13801,6900,0,1,6902,42009642,42.009642
5700,5700,6900,32490000,2,55206,13803,1,889200000,889200000,20701,6900,13801,6900,0,1,6902,43156602,43.156602
5700,5700,6900,32490000,2,55206,13803,1,889200000,889200000,20701,6900,13801,6900,0,1,6902,41615416,41.615416
5700,5700,6900,32490000,2,55206,13803,1,889200000,889200000,20701,6900,13801,6900,0,1,6902,43465965,43.465965
5700,5700,6900,32490000,2,55206,13803,1,889200000,889200000,20701,6900,13801,6900,0,1,6902,41397735,41.397735
5700,5700,6900,32490000,2,55206,13803,1,889200000,889200000,20701,6900,13801,6900,0,1,6902,43927471,43.927471
5700,5300,500,30210000,2,4006,1003,1,285680000,285680000,1501,500,1001,500,0,1,502,3198453,3.198453
5700,5300,500,30210000,2,4006,1003,1,285680000,285680000,1501,500,1001,500,0,1,502,3317202,3.317202
5700,5300,500,30210000,2,4006,1003,1,285680000,285680000,1501,500,1001,500,0,1,502,3231376,3.231376
5700,5300,500,30210000,2,4006,1003,1,285680000,285680000,1501,500,1001,500,0,1,502,3275537,3.275537
5700,5300,500,30210000,2,4006,1003,1,285680000,285680000,1501,500,1001,500,0,1,502,3274861,3.274861
5700,5300,500,30210000,2,4006,1003,1,285680000,285680000,1501,500,1001,500,0,1,502,3276570,3.27657
5700,5300,500,30210000,2,4006,1003,1,285680000,285680000,1501,500,1001,500,0,1,502,3253508,3.253508
5700,5300,500,30210000,2,4006,1003,1,285680000,285680000,1501,500,1001,500,0,1,502,3376406,3.376406
5700,5300,900,30210000,2,7206,1803,1,320880000,320880000,2701,900,1801,900,0,1,902,5287578,5.287578
5700,5300,900,30210000,2,7206,1803,1,320880000,320880000,2701,900,1801,900,0,1,902,5459980,5.45998
5700,5300,900,30210000,2,7206,1803,1,320880000,320880000,2701,900,1801,900,0,1,902,5328176,5.328176
5700,5300,900,30210000,2,7206,1803,1,320880000,320880000,2701,900,1801,900,0,1,902,5438288,5.438288
5700,5300,900,30210000,2,7206,1803,1,320880000,320880000,2701,900,1801,900,0,1,902,5266759,5.266759
5700,5300,900,30210000,2,7206,1803,1,320880000,320880000,2701,900,1801,900,0,1,902,5487345,5.487345
5700,5300,900,30210000,2,7206,1803,1,320880000,320880000,2701,900,1801,900,0,1,902,5190858,5.190858
5700,5300,900,30210000,2,7206,1803,1,320880000,320880000,2701,900,1801,900,0,1,902,5540323,5.540323
5700,5300,1300,30210000,2,10406,2603,1,356080000,356080000,3901,1300,2601,1300,0,1,1302,7493527,7.493527
5700,5300,1300,30210000,2,10406,2603,1,356080000,356080000,3901,1300,2601,1300,0,1,1302,7767847,7.767847
5700,5300,1300,30210000,2,10406,2603,1,356080000,356080000,3901,1300,2601,1300,0,1,1302,7549908,7.549908
5700,5300,1300,30210000,2,10406,2603,1,356080000,356080000,3901,1300,2601,1300,0,1,1302,7668896,7.668896
5700,5300,1300,30210000,2,10406,2603,1,356080000,356080000,3901,1300,2601,1300,0,1,1302,7513964,7.513964
5700,5300,1300,30210000,2,10406,2603,1,356080000,356080000,3901,1300,2601,1300,0,1,1302,7746181,7.746181
5700,5300,1300,30210000,2,10406,2603,1,356080000,356080000,3901,1300,2601,1300,0,1,1302,7381080,7.38108
5700,5300,1300,30210000,2,10406,2603,1,356080000,356080000,3901,1300,2601,1300,0,1,1302,7875696,7.875696
5700,5300,1700,30210000,2,13606,3403,1,391280000,391280000,5101,1700,3401,1700,0,1,1702,9824915,9.824915
5700,5300,1700,30210000,2,13606,3403,1,391280000,391280000,5101,1700,3401,1700,0,1,1702,10145089,10.145089
5700,5300,1700,30210000,2,13606,3403,1,391280000,391280000,5101,1700,3401,1700,0,1,1702,9945674,9.945674
5700,5300,1700,30210000,2,13606,3403,1,391280000,391280000,5101,1700,3401,1700,0,1,1702,10096794,10.096794
5700,5300,1700,30210000,2,13606,3403,1,391280000,391280000,5101,1700,3401,1700,0,1,1702,9851413,9.851413
5700,5300,1700,30210000,2,13606,3403,1,391280000,391280000,5101,1700,3401,1700,0,1,1702,10166762,10.166762
5700,5300,1700,30210000,2,13606,3403,1,391280000,391280000,5101,1700,3401,1700,0,1,1702,9739666,9.739666
5700,5300,1700,30210000,2,13606,3403,1,391280000,391280000,5101,1700,3401,1700,0,1,1702,10260051,10.260051
5700,5300,2100,30210000,2,16806,4203,1,426480000,426480000,6301,2100,4201,2100,0,1,2102,11930889,11.930889
5700,5300,2100,30210000,2,16806,4203,1,426480000,426480000,6301,2100,4201,2100,0,1,2102,12365379,12.365379
5700,5300,2100,30210000,2,16806,4203,1,426480000,426480000,6301,2100,4201,2100,0,1,2102,12005907,12.005907
5700,5300,2100,30210000,2,16806,4203,1,426480000,426480000,6301,2100,4201,2100,0,1,2102,12232504,12.232504
5700,5300,2100,30210000,2,16806,4203,1,426480000,426480000,6301,2100,4201,2100,0,1,2102,11887919,11.887919
5700,5300,2100,30210000,2,16806,4203,1,426480000,426480000,6301,2100,4201,2100,0,1,2102,12418201,12.418201
5700,5300,2100,30210000,2,16806,4203,1,426480000,426480000,6301,2100,4201,2100,0,1,2102,11748182,11.748182
5700,5300,2100,30210000,2,16806,4203,1,426480000,426480000,6301,2100,4201,2100,0,1,2102,12536714,12.536714
5700,5300,2500,30210000,2,20006,5003,1,461680000,461680000,7501,2500,5001,2500,0,1,2502,14281463,14.281463
5700,5300,2500,30210000,2,20006,5003,1,461680000,461680000,7501,2500,5001,2500,0,1,2502,14781803,14.781803
5700,5300,2500,30210000,2,20006,5003,1,461680000,461680000,7501,2500,5001,2500,0,1,2502,14376321,14.376321
5700,5300,2500,30210000,2,20006,5003,1,461680000,461680000,7501,2500,5001,2500,0,1,2502,14618148,14.618148
5700,5300,2500,30210000,2,20006,5003,1,461680000,461680000,7501,2500,5001,2500,0,1,2502,14243047,14.243047
5700,5300,2500,30210000,2,20006,5003,1,461680000,461680000,7501,2500,5001,2500,0,1,2502,14803344,14.803344
5700,5300,2500,30210000,2,20006,5003,1,461680000,461680000,7501,2500,5001,2500,0,1,2502,14145595,14.145595
5700,5300,2500,30210000,2,20006,5003,1,461680000,461680000,7501,2500,5001,2500,0,1,2502,14973436,14.973436
5700,5300,2900,30210000,2,23206,5803,1,496880000,496880000,8701,2900,5801,2900,0,1,2902,16484500,16.4845
5700,5300,2900,30210000,2,23206,5803,1,496880000,496880000,8701,2900,5801,2900,0,1,2902,17075320,17.07532
5700,5300,2900,30210000,2,23206,5803,1,496880000,496880000,8701,2900,5801,2900,0,1,2902,16664983,16.664983
5700,5300,2900,30210000,2,23206,5803,1,496880000,496880000,8701,2900,5801,2900,0,1,2902,16900824,16.900824
5700,5300,2900,30210000,2,23206,5803,1,496880000,496880000,8701,2900,5801,2900,0,1,2902,16463776,16.463776
5700,5300,2900,30210000,2,23206,5803,1,496880000,496880000,8701,2900,5801,2900,0,1,2902,17097050,17.09705
5700,5300,2900,30210000,2,23206,5803,1,496880000,496880000,8701,2900,5801,2900,0,1,2902,16318977,16.318977
5700,5300,2900,30210000,2,23206,5803,1,496880000,496880000,8701,2900,5801,2900,0,1,2902,17318604,17.318604
5700,5300,3300,30210000,2,26406,6603,1,532080000,532080000,9901,3300,6601,3300,0,1,3302,18701560,18.70156
5700,5300,3300,30210000,2,26406,6603,1,532080000,532080000,9901,3300,6601,3300,0,1,3302,19380096,19.380096
5700,5300,3300,30210000,2,26406,6603,1,532080000,532080000,9901,3300,6601,3300,0,1,3302,18853267,18.853267
5700,5300,3300,30210000,2,26406,6603,1,532080000,532080000,9901,3300,6601,3300,0,1,3302,19225486,19.225486
5700,5300,3300,30210000,2,26406,6603,1,532080000,532080000,9901,3300,6601,3300,0,1,3302,18658320,18.65832
5700,5300,3300,30210000,2,26406,6603,1,532080000,532080000,9901,3300,6601,3300,0,1,3302,19414015,19.414015
5700,5300,3300,30210000,2,26406,6603,1,532080000,532080000,9901,3300,6601,3300,0,1,3302,18515148,18.515148
5700,5300,3300,30210000,2,26406,6603,1,532080000,532080000,9901,3300,6601,3300,0,1,3302,19641161,19.641161
5700,5300,3700,30210000,2,29606,7403,1,567280000,567280000,11101,3700,7401,3700,0,1,3702,20928882,20.928882
5700,5300,3700,30210000,2,29606,7403,1,567280000,567280000,11101,3700,7401,3700,0,1,3702,21690988,21.690988
5700,5300,3700,30210000,2,29606,7403,1,567280000,567280000,11101,3700,7401,3700,0,1,3702,21092206,21.092206
5700,5300,3700,30210000,2,29606,7403,1,567280000,567280000,11101,3700,7401,3700,0,1,3702,21507451,21.507451
5700,5300,3700,30210000,2,29606,7403,1,567280000,567280000,11101,3700,7401,3700,0,1,3702,20894733,20.894733
5700,5300,3700,30210000,2,29606,7403,1,567280000,567280000,11101,3700,7401,3700,0,1,3702,21726536,21.726536
5700,5300,3700,30210000,2,29606,7403,1,567280000,567280000,11101,3700,7401,3700,0,1,3702,20725999,20.725999
5700,5300,3700,30210000,2,29606,7403,1,567280000,567280000,11101,3700,7401,3700,0,1,3702,21988730,21.98873
5700,5300,4100,30210000,2,32806,8203,1,602480000,602480000,12301,4100,8201,4100,0,1,4102,23222512,23.222512
5700,5300,4100,30210000,2,32806,8203,1,602480000,602480000,12301,4100,8201,4100,0,1,4102,24003673,24.003673
5700,5300,4100,30210000,2,32806,8203,1,602480000,602480000,12301,4100,8201,4100,0,1,4102,23364084,23.364084
5700,5300,4100,30210000,2,32806,8203,1,602480000,602480000,12301,4100,8201,4100,0,1,4102,23834968,23.834968
5700,5300,4100,30210000,2,32806,8203,1,602480000,602480000,12301,4100,8201,4100,0,1,4102,23076721,23.076721
5700,5300,4100,30210000,2,32806,8203,1,602480000,602480000,12301,4100,8201,4100,0,1,4102,24040832,24.040832
5700,5300,4100,30210000,2,32806,8203,1,602480000,602480000,12301,4100,8201,4100,0,1,4102,22910518,22.910518
5700,5300,4100,30210000,2,32806,8203,1,602480000,602480000,12301,4100,8201,4100,0,1,4102,24309839,24.309839
5700,5300,4500,30210000,2,36006,9003,1,637680000,637680000,13501,4500,9001,4500,0,1,4502,25412923,25.412923
5700,5300,4500,30210000,2,36006,9003,1,637680000,637680000,13501,4500,9001,4500,0,1,4502,26302468,26.302468
5700,5300,4500,30210000,2,36006,9003,1,637680000,637680000,13501,4500,9001,4500,0,1,4502,25546174,25.546174
5700,5300,4500,30210000,2,36006,9003,1,637680000,637680000,13501,4500,9001,4500,0,1,4502,26097608,26.097608
5700,5300,4500,30210000,2,36006,9003,1,637680000,637680000,13501,4500,9001,4500,0,1,4502,25298100,25.2981
5700,5300,4500,30210000,2,36006,9003,1,637680000,637680000,13501,4500,9001,4500,0,1,4502,26362991,26.362991
5700,5300,4500,30210000,2,36006,9003,1,637680000,637680000,13501,4500,9001,4500,0,1,4502,25105479,25.105479
5700,5300,4500,30210000,2,36006,9003,1,637680000,637680000,13501,4500,9001,4500,0,1,4502,26654277,26.654277
5700,5300,4900,30210000,2,39206,9803,1,672880000,672880000,14701,4900,9801,4900,0,1,4902,27615431,27.615431
5700,5300,4900,30210000,2,39206,9803,1,672880000,672880000,14701,4900,9801,4900,0,1,4902,28676879,28.676879
5700,5300,4900,30210000,2,39206,9803,1,672880000,672880000,14701,4900,9801,4900,0,1,4902,27813340,27.81334
5700,5300,4900,30210000,2,39206,9803,1,672880000,672880000,14701,4900,9801,4900,0,1,4902,28413057,28.413057
5700,5300,4900,30210000,2,39206,9803,1,672880000,672880000,14701,4900,9801,4900,0,1,4902,27539723,27.539723
5700,5300,4900,30210000,2,39206,9803,1,672880000,672880000,14701,4900,9801,4900,0,1,4902,28715463,28.715463
5700,5300,4900,30210000,2,39206,9803,1,672880000,672880000,14701,4900,9801,4900,0,1,4902,27345965,27.345965
5700,5300,4900,30210000,2,39206,9803,1,672880000,672880000,14701,4900,9801,4900,0,1,4902,29027167,29.027167
5700,5300,5300,30210000,2,42406,10603,1,708080000,708080000,15901,5300,10601,5300,0,1,5302,29914704,29.914704
5700,5300,5300,30210000,2,42406,10603,1,708080000,708080000,15901,5300,10601,5300,0,1,5302,31076535,31.076535
5700,5300,5300,30210000,2,42406,10603,1,708080000,708080000,15901,5300,10601,5300,0,1,5302,30086917,30.086917
5700,5300,5300,30210000,2,42406,10603,1,708080000,708080000,15901,5300,10601,5300,0,1,5302,30747836,30.747836
5700,5300,5300,30210000,2,42406,10603,1,708080000,708080000,15901,5300,10601,5300,0,1,5302,29769843,29.769843
5700,5300,5300,30210000,2,42406,10603,1,708080000,708080000,15901,5300,10601,5300,0,1,5302,31036853,31.036853
5700,5300,5300,30210000,2,42406,10603,1,708080000,708080000,15901,5300,10601,5300,0,1,5302,29567920,29.56792
5700,5300,5300,30210000,2,42406,10603,1,708080000,708080000,15901,5300,10601,5300,0,1,5302,31341164,31.341164
5700,5300,5700,30210000,2,45606,11403,1,743280000,743280000,17101,5700,11401,5700,0,1,5702,32160556,32.160556
5700,5300,5700,30210000,2,45606,11403,1,743280000,743280000,17101,5700,11401,5700,0,1,5702,33408006,33.408006
5700,5300,5700,30210000,2,45606,11403,1,743280000,743280000,17101,5700,11401,5700,0,1,5702,32349379,32.349379
5700,5300,5700,30210000,2,45606,11403,1,743280000,743280000,17101,5700,11401,5700,0,1,5702,33099481,33.099481
5700,5300,5700,30210000,2,45606,11403,1,743280000,743280000,17101,5700,11401,5700,0,1,5702,32020293,32.020293
5700,5300,5700,30210000,2,45606,11403,1,743280000,743280000,17101,5700,11401,5700,0,1,5702,33364339,33.364339
5700,5300,5700,30210000,2,45606,11403,1,743280000,743280000,17101,5700,11401,5700,0,1,5702,31779494,31.779494
5700,5300,5700,30210000,2,45606,11403,1,743280000,743280000,17101,5700,11401,5700,0,1,5702,33780847,33.780847
5700,5300,6100,30210000,2,48806,12203,1,778480000,778480000,18301,6100,12201,6100,0,1,6102,34543666,34.543666
5700,5300,6100,30210000,2,48806,12203,1,778480000,778480000,18301,6100,12201,6100,0,1,6102,35764452,35.764452
5700,5300,6100,30210000,2,48806,12203,1,778480000,778480000,18301,6100,12201,6100,0,1,6102,34705998,34.705998
5700,5300,6100,30210000,2,48806,12203,1,778480000,778480000,18301,6100,12201,6100,0,1,6102,35583674,35.583674
5700,5300,6100,30210000,2,48806,12203,1,778480000,778480000,18301,6100,12201,6100,0,1,6102,34327977,34.327977
5700,5300,6100,30210000,2,48806,12203,1,778480000,778480000,18301,6100,12201,6100,0,1,6102,35808866,35.808866
5700,5300,6100,30210000,2,48806,12203,1,778480000,778480000,18301,6100,12201,6100,0,1,6102,34093863,34.093863
5700,5300,6100,30210000,2,48806,12203,1,778480000,778480000,18301,6100,12201,6100,0,1,6102,36184464,36.184464
5700,5300,6500,30210000,2,52006,13003,1,813680000,813680000,19501,6500,13001,6500,0,1,6502,36637533,36.637533
5700,5300,6500,30210000,2,52006,13003,1,813680000,813680000,19501,6500,13001,6500,0,1,6502,38047497,38.047497
5700,5300,6500,30210000,2,52006,13003,1,813680000,813680000,19501,6500,13001,6500,0,1,6502,36911365,36.911365
5700,5300,6500,30210000,2,52006,13003,1,813680000,813680000,19501,6500,13001,6500,0,1,6502,37724284,37.724284
5700,5300,6500,30210000,2,52006,13003,1,813680000,813680000,19501,6500,13001,6500,0,1,6502,36460832,36.460832
5700,5300,6500,30210000,2,52006,13003,1,813680000,813680000,19501,6500,13001,6500,0,1,6502,38071221,38.071221
5700,5300,6500,30210000,2,52006,13003,1,813680000,813680000,19501,6500,13001,6500,0,1,6502,36261769,36.261769
5700,5300,6500,30210000,2,52006,13003,1,813680000,813680000,19501,6500,13001,6500,0,1,6502,38463528,38.463528
5700,5300,6900,30210000,2,55206,13803,1,848880000,848880000,20701,6900,13801,6900,0,1,6902,38844925,38.844925
5700,5300,6900,30210000,2,55206,13803,1,848880000,848880000,20701,6900,13801,6900,0,1,6902,40439370,40.43937
5700,5300,6900,30210000,2,55206,13803,1,848880000,848880000,20701,6900,13801,6900,0,1,6902,39124461,39.124461
5700,5300,6900,30210000,2,55206,13803,1,848880000,848880000,20701,6900,13801,6900,0,1,6902,40135089,40.135089
5700,5300,6900,30210000,2,55206,13803,1,848880000,848880000,20701,6900,13801,6900,0,1,6902,38792380,38.79238
5700,5300,6900,30210000,2,55206,13803,1,848880000,848880000,20701,6900,13801,6900,0,1,6902,40389798,40.389798
5700,5300,6900,30210000,2,55206,13803,1,848880000,848880000,20701,6900,13801,6900,0,1,6902,38468418,38.468418
5700,5300,6900,30210000,2,55206,13803,1,848880000,848880000,20701,6900,13801,6900,0,1,6902,40941392,40.941392
5700,4900,500,27930000,2,4006,1003,1,265840000,265840000,1501,500,1001,500,0,1,502,2956488,2.956488
5700,4900,500,27930000,2,4006,1003,1,265840000,265840000,1501,500,1001,500,0,1,502,3079918,3.079918
5700,4900,500,27930000,2,4006,1003,1,265840000,265840000,1501,500,1001,500,0,1,502,3048342,3.048342
5700,4900,500,27930000,2,4006,1003,1,265840000,265840000,1501,500,1001,500,0,1,502,2933249,2.933249
5700,4900,500,27930000,2,4006,1003,1,265840000,265840000,1501,500,1001,500,0,1,502,3050846,3.050846
5700,4900,500,27930000,2,4006,1003,1,265840000,265840000,1501,500,1001,500,0,1,502,3028983,3.028983
5700,4900,500,27930000,2,4006,1003,1,265840000,265840000,1501,500,1001,500,0,1,502,2990724,2.990724
5700,4900,500,27930000,2,4006,1003,1,265840000,265840000,1501,500,1001,500,0,1,502,3101792,3.101792
5700,4900,900,27930000,2,7206,1803,1,299760000,299760000,2701,900,1801,900,0,1,902,4881483,4.881483
5700,4900,900,27930000,2,7206,1803,1,299760000,299760000,2701,900,1801,900,0,1,902,5054411,5.054411
5700,4900,900,27930000,2,7206,1803,1,299760000,299760000,2701,900,1801,900,0,1,902,4938207,4.938207
5700,4900,900,27930000,2,7206,1803,1,299760000,299760000,2701,900,1801,900,0,1,902,5034301,5.034301
5700,4900,900,27930000,2,7206,1803,1,299760000,299760000,2701,900,1801,900,0,1,902,4906861,4.906861
5700,4900,900,27930000,2,7206,1803,1,299760000,299760000,2701,900,1801,900,0,1,902,5107943,5.107943
5700,4900,900,27930000,2,7206,1803,1,299760000,299760000,2701,900,1801,900,0,1,902,4813665,4.813665
5700,4900,900,27930000,2,7206,1803,1,299760000,299760000,2701,900,1801,900,0,1,902,5148437,5.148437
5700,4900,1300,27930000,2,10406,2603,1,333680000,333680000,3901,1300,2601,1300,0,1,1302,6932043,6.932043
5700,4900,1300,27930000,2,10406,2603,1,333680000,333680000,3901,1300,2601,1300,0,1,1302,7187502,7.187502
5700,4900,1300,27930000,2,10406,2603,1,333680000,333680000,3901,1300,2601,1300,0,1,1302,6999033,6.999033
5700,4900,1300,27930000,2,10406,2603,1,333680000,333680000,3901,1300,2601,1300,0,1,1302,7115486,7.115486
5700,4900,1300,27930000,2,10406,2603,1,333680000,333680000,3901,1300,2601,1300,0,1,1302,6950962,6.950962
5700,4900,1300,27930000,2,10406,2603,1,333680000,333680000,3901,1300,2601,1300,0,1,1302,7237451,7.237451
5700,4900,1300,27930000,2,10406,2603,1,333680000,333680000,3901,1300,2601,1300,0,1,1302,6820373,6.820373
5700,4900,1300,27930000,2,10406,2603,1,333680000,333680000,3901,1300,2601,1300,0,1,1302,7306563,7.306563
5700,4900,1700,27930000,2,13606,3403,1,367600000,367600000,5101,1700,3401,1700,0,1,1702,9095348,9.095348
5700,4900,1700,27930000,2,13606,3403,1,367600000,367600000,5101,1700,3401,1700,0,1,1702,9428306,9.428306
5700,4900,1700,27930000,2,13606,3403,1,367600000,367600000,5101,1700,3401,1700,0,1,1702,9219952,9.219952
5700,4900,1700,27930000,2,13606,3403,1,367600000,367600000,5101,1700,3401,1700,0,1,1702,9292519,9.292519
5700,4900,1700,27930000,2,13606,3403,1,367600000,367600000,5101,1700,3401,1700,0,1,1702,9125352,9.125352
5700,4900,1700,27930000,2,13606,3403,1,367600000,367600000,5101,1700,3401,1700,0,1,1702,9446855,9.446855
5700,4900,1700,27930000,2,13606,3403,1,367600000,367600000,5101,1700,3401,1700,0,1,1702,9023544,9.023544
5700,4900,1700,27930000,2,13606,3403,1,367600000,367600000,5101,1700,3401,1700,0,1,1702,9552826,9.552826
5700,4900,2100,27930000,2,16806,4203,1,401520000,401520000,6301,2100,4201,2100,0,1,2102,11023693,11.023693
5700,4900,2100,27930000,2,16806,4203,1,401520000,401520000,6301,2100,4201,2100,0,1,2102,11455286,11.455286
5700,4900,2100,27930000,2,16806,4203,1,401520000,401520000,6301,2100,4201,2100,0,1,2102,11120350,11.12035
5700,4900,2100,27930000,2,16806,4203,1,401520000,401520000,6301,2100,4201,2100,0,1,2102,11322916,11.322916
5700,4900,2100,27930000,2,16806,4203,1,401520000,401520000,6301,2100,4201,2100,0,1,2102,10997899,10.997899
5700,4900,2100,27930000,2,16806,4203,1,401520000,401520000,6301,2100,4201,2100,0,1,2102,11435569,11.435569
5700,4900,2100,27930000,2,16806,4203,1,401520000,401520000,6301,2100,4201,2100,0,1,2102,10881094,10.881094
5700,4900,2100,27930000,2,16806,4203,1,401520000,401520000,6301,2100,4201,2100,0,1,2102,11592034,11.592034
5700,4900,2500,27930000,2,20006,5003,1,435440000,435440000,7501,2500,5001,2500,0,1,2502,13215701,13.215701
5700,4900,2500,27930000,2,20006,5003,1,435440000,435440000,7501,2500,5001,2500,0,1,2502,13649602,13.649602
5700,4900,2500,27930000,2,20006,5003,1,435440000,435440000,7501,2500,5001,2500,0,1,2502,13316261,13.316261
5700,4900,2500,27930000,2,20006,5003,1,435440000,435440000,7501,2500,5001,2500,0,1,2502,13538045,13.538045
5700,4900,2500,27930000,2,20006,5003,1,435440000,435440000,7501,2500,5001,2500,0,1,2502,13170692,13.170692
5700,4900,2500,27930000,2,20006,5003,1,435440000,435440000,7501,2500,5001,2500,0,1,2502,13678226,13.678226
5700,4900,2500,27930000,2,20006,5003,1,435440000,435440000,7501,2500,5001,2500,0,1,2502,13065506,13.065506
5700,4900,2500,27930000,2,20006,5003,1,435440000,435440000,7501,2500,5001,2500,0,1,2502,13840652,13.840652
5700,4900,2900,27930000,2,23206,5803,1,469360000,469360000,8701,2900,5801,2900,0,1,2902,15301489,15.301489
5700,4900,2900,27930000,2,23206,5803,1,469360000,469360000,8701,2900,5801,2900,0,1,2902,15789829,15.789829
5700,4900,2900,27930000,2,23206,5803,1,469360000,469360000,8701,2900,5801,2900,0,1,2902,15398622,15.398622
5700,4900,2900,27930000,2,23206,5803,1,469360000,469360000,8701,2900,5801,2900,0,1,2902,15698721,15.698721
5700,4900,2900,27930000,2,23206,5803,1,469360000,469360000,8701,2900,5801,2900,0,1,2902,15231846,15.231846
5700,4900,2900,27930000,2,23206,5803,1,469360000,469360000,8701,2900,5801,2900,0,1,2902,15819983,15.819983
5700,4900,2900,27930000,2,23206,5803,1,469360000,469360000,8701,2900,5801,2900,0,1,2902,15087606,15.087606
5700,4900,2900,27930000,2,23206,5803,1,469360000,469360000,8701,2900,5801,2900,0,1,2902,16003862,16.003862
5700,4900,3300,27930000,2,26406,6603,1,503280000,503280000,9901,3300,6601,3300,0,1,3302,17354687,17.354687
5700,4900,3300,27930000,2,26406,6603,1,503280000,503280000,9901,3300,6601,3300,0,1,3302,17922832,17.922832
5700,4900,3300,27930000,2,26406,6603,1,503280000,503280000,9901,3300,6601,3300,0,1,3302,17454868,17.454868
5700,4900,3300,27930000,2,26406,6603,1,503280000,503280000,9901,3300,6601,3300,0,1,3302,17830960,17.83096
5700,4900,3300,27930000,2,26406,6603,1,503280000,503280000,9901,3300,6601,3300,0,1,3302,17285711,17.285711
5700,4900,3300,27930000,2,26406,6603,1,503280000,503280000,9901,3300,6601,3300,0,1,3302,17965253,17.965253
5700,4900,3300,27930000,2,26406,6603,1,503280000,503280000,9901,3300,6601,3300,0,1,3302,17159046,17.159046
5700,4900,3300,27930000,2,26406,6603,1,503280000,503280000,9901,3300,6601,3300,0,1,3302,18161713,18.161713
5700,4900,3700,27930000,2,29606,7403,1,537200000,537200000,11101,3700,7401,3700,0,1,3702,19363823,19.363823
5700,4900,3700,27930000,2,29606,7403,1,537200000,537200000,11101,3700,7401,3700,0,1,3702,20086773,20.086773
5700,4900,3700,27930000,2,29606,7403,1,537200000,537200000,11101,3700,7401,3700,0,1,3702,19529194,19.529194
5700,4900,3700,27930000,2,29606,7403,1,537200000,537200000,11101,3700,7401,3700,0,1,3702,19897072,19.897072
5700,4900,3700,27930000,2,29606,7403,1,537200000,537200000,11101,3700,7401,3700,0,1,3702,19344335,19.344335
5700,4900,3700,27930000,2,29606,7403,1,537200000,537200000,11101,3700,7401,3700,0,1,3702,20106854,20.106854
5700,4900,3700,27930000,2,29606,7403,1,537200000,537200000,11101,3700,7401,3700,0,1,3702,19188659,19.188659
5700,4900,3700,27930000,2,29606,7403,1,537200000,537200000,11101,3700,7401,3700,0,1,3702,20354686,20.354686
5700,4900,4100,27930000,2,32806,8203,1,571120000,571120000,12301,4100,8201,4100,0,1,4102,21447559,21.447559
5700,4900,4100,27930000,2,32806,8203,1,571120000,571120000,12301,4100,8201,4100,0,1,4102,22217619,22.217619
5700,4900,4100,27930000,2,32806,8203,1,571120000,571120000,12301,4100,8201,4100,0,1,4102,21557936,21.557936
5700,4900,4100,27930000,2,32806,8203,1,571120000,571120000,12301,4100,8201,4100,0,1,4102,21959558,21.959558
5700,4900,4100,27930000,2,32806,8203,1,571120000,571120000,12301,4100,8201,4100,0,1,4102,21387897,21.387897
5700,4900,4100,27930000,2,32806,8203,1,571120000,571120000,12301,4100,8201,4100,0,1,4102,22237223,22.237223
5700,4900,4100,27930000,2,32806,8203,1,571120000,571120000,12301,4100,8201,4100,0,1,4102,21210509,21.210509
5700,4900,4100,27930000,2,32806,8203,1,571120000,571120000,12301,4100,8201,4100,0,1,4102,22477894,22.477894
5700,4900,4500,27930000,2,36006,9003,1,605040000,605040000,13501,4500,9001,4500,0,1,4502,23493124,23.493124
5700,4900,4500,27930000,2,36006,9003,1,605040000,605040000,13501,4500,9001,4500,0,1,4502,24356503,24.356503
5700,4900,4500,27930000,2,36006,9003,1,605040000,605040000,13501,4500,9001,4500,0,1,4502,23642551,23.642551
5700,4900,4500,27930000,2,36006,9003,1,605040000,605040000,13501,4500,9001,4500,0,1,4502,24131076,24.131076
5700,4900,4500,27930000,2,36006,9003,1,605040000,605040000,13501,4500,9001,4500,0,1,4502,23427804,23.427804
5700,4900,4500,27930000,2,36006,9003,1,605040000,605040000,13501,4500,9001,4500,0,1,4502,24421326,24.421326
5700,4900,4500,27930000,2,36006,9003,1,605040000,605040000,13501,4500,9001,4500,0,1,4502,23238072,23.238072
5700,4900,4500,27930000,2,36006,9003,1,605040000,605040000,13501,4500,9001,4500,0,1,4502,24684481,24.684481
5700,4900,4900,27930000,2,39206,9803,1,638960000,638960000,14701,4900,9801,4900,0,1,4902,25572426,25.572426
5700,4900,4900,27930000,2,39206,9803,1,638960000,638960000,14701,4900,9801,4900,0,1,4902,26476969,26.476969
5700,4900,4900,27930000,2,39206,9803,1,638960000,638960000,14701,4900,9801,4900,0,1,4902,25688191,25.688191
5700,4900,4900,27930000,2,39206,9803,1,638960000,638960000,14701,4900,9801,4900,0,1,4902,26279101,26.279101
5700,4900,4900,27930000,2,39206,9803,1,638960000,638960000,14701,4900,9801,4900,0,1,4902,25462044,25.462044
5700,4900,4900,27930000,2,39206,9803,1,638960000,638960000,14701,4900,9801,4900,0,1,4902,26553994,26.553994
5700,4900,4900,27930000,2,39206,9803,1,638960000,638960000,14701,4900,9801,4900,0,1,4902,25303525,25.303525
5700,4900,4900,27930000,2,39206,9803,1,638960000,638960000,14701,4900,9801,4900,0,1,4902,26871199,26.871199
5700,4900,5300,27930000,2,42406,10603,1,672880000,672880000,15901,5300,10601,5300,0,1,5302,27642306,27.642306
5700,4900,5300,27930000,2,42406,10603,1,672880000,672880000,15901,5300,10601,5300,0,1,5302,28695753,28.695753
5700,4900,5300,27930000,2,42406,10603,1,672880000,672880000,15901,5300,10601,5300,0,1,5302,27814983,27.814983
5700,4900,5300,27930000,2,42406,10603,1,672880000,672880000,15901,5300,10601,5300,0,1,5302,28404692,28.404692
5700,4900,5300,27930000,2,42406,10603,1,672880000,672880000,15901,5300,10601,5300,0,1,5302,27536066,27.536066
5700,4900,5300,27930000,2,42406,10603,1,672880000,672880000,15901,5300,10601,5300,0,1,5302,28734095,28.734095
5700,4900,5300,27930000,2,42406,10603,1,672880000,672880000,15901,5300,10601,5300,0,1,5302,27356703,27.356703
5700,4900,5300,27930000,2,42406,10603,1,672880000,672880000,15901,5300,10601,5300,0,1,5302,29005626,29.005626
5700,4900,5700,27930000,2,45606,11403,1,706800000,706800000,17101,5700,11401,5700,0,1,5702,29730438,29.730438
5700,4900,5700,27930000,2,45606,11403,1,706800000,706800000,17101,5700,11401,5700,0,1,5702,30835392,30.835392
5700,4900,5700,27930000,2,45606,11403,1,706800000,706800000,17101,5700,11401,5700,0,1,5702,29842938,29.842938
5700,4900,5700,27930000,2,45606,11403,1,706800000,706800000,17101,5700,11401,5700,0,1,5702,30556594,30.556594
5700,4900,5700,27930000,2,45606,11403,1,706800000,706800000,17101,5700,11401,5700,0,1,5702,29613136,29.613136
5700,4900,5700,27930000,2,45606,11403,1,706800000,706800000,17101,5700,11401,5700,0,1,5702,30874844,30.874844
5700,4900,5700,27930000,2,45606,11403,1,706800000,706800000,17101,5700,11401,5700,0,1,5702,29397206,29.397206
5700,4900,5700,27930000,2,45606,11403,1,706800000,706800000,17101,5700,11401,5700,0,1,5702,31194582,31.194582
5700,4900,6100,27930000,2,48806,12203,1,740720000,740720000,18301,6100,12201,6100,0,1,6102,31818686,31.818686
5700,4900,6100,27930000,2,48806,12203,1,740720000,740720000,18301,6100,12201,6100,0,1,6102,33017691,33.017691
5700,4900,6100,27930000,2,48806,12203,1,740720000,740720000,18301,6100,12201,6100,0,1,6102,31972945,31.972945
5700,4900,6100,27930000,2,48806,12203,1,740720000,740720000,18301,6100,12201,6100,0,1,6102,32771938,32.771938
5700,4900,6100,27930000,2,48806,12203,1,740720000,740720000,18301,6100,12201,6100,0,1,6102,31679444,31.679444
5700,4900,6100,27930000,2,48806,12203,1,740720000,740720000,18301,6100,12201,6100,0,1,6102,33040430,33.04043
5700,4900,6100,27930000,2,48806,12203,1,740720000,740720000,18301,6100,12201,6100,0,1,6102,31432962,31.432962
5700,4900,6100,27930000,2,48806,12203,1,740720000,740720000,18301,6100,12201,6100,0,1,6102,33376037,33.376037
5700,4900,6500,27930000,2,52006,13003,1,774640000,774640000,19501,6500,13001,6500,0,1,6502,33886703,33.886703
5700,4900,6500,27930000,2,52006,13003,1,774640000,774640000,19501,6500,13001,6500,0,1,6502,35173254,35.173254
5700,4900,6500,27930000,2,52006,13003,1,774640000,774640000,19501,6500,13001,6500,0,1,6502,33995533,33.995533
5700,4900,6500,27930000,2,52006,13003,1,774640000,774640000,19501,6500,13001,6500,0,1,6502,34804918,34.804918
5700,4900,6500,27930000,2,52006,13003,1,774640000,774640000,19501,6500,13001,6500,0,1,6502,33741500,33.7415
5700,4900,6500,27930000,2,52006,13003,1,774640000,774640000,19501,6500,13001,6500,0,1,6502,35195790,35.19579
5700,4900,6500,27930000,2,52006,13003,1,774640000,774640000,19501,6500,13001,6500,0,1,6502,33519750,33.51975
5700,4900,6500,27930000,2,52006,13003,1,774640000,774640000,19501,6500,13001,6500,0,1,6502,35607875,35.607875
5700,4900,6900,27930000,2,55206,13803,1,808560000,808560000,20701,6900,13801,6900,0,1,6902,36044659,36.044659
5700,4900,6900,27930000,2,55206,13803,1,808560000,808560000,20701,6900,13801,6900,0,1,6902,37371290,37.37129
5700,4900,6900,27930000,2,55206,13803,1,808560000,808560000,20701,6900,13801,6900,0,1,6902,36185988,36.185988
5700,4900,6900,27930000,2,55206,13803,1,808560000,808560000,20701,6900,13801,6900,0,1,6902,37074046,37.074046
5700,4900,6900,27930000,2,55206,13803,1,808560000,808560000,20701,6900,13801,6900,0,1,6902,35812525,35.812525
5700,4900,6900,27930000,2,55206,13803,1,808560000,808560000,20701,6900,13801,6900,0,1,6902,37327436,37.327436
5700,4900,6900,27930000,2,55206,13803,1,808560000,808560000,20701,6900,13801,6900,0,1,6902,35571190,35.57119
5700,4900,6900,27930000,2,55206,13803,1,808560000,808560000,20701,6900,13801,6900,0,1,6902,37786167,37.786167
5700,4500,500,25650000,2,4006,1003,1,246000000,246000000,1501,500,1001,500,0,1,502,2749708,2.749708
5700,4500,500,25650000,2,4006,1003,1,246000000,246000000,1501,500,1001,500,0,1,502,2836721,2.836721
5700,4500,500,25650000,2,4006,1003,1,246000000,246000000,1501,500,1001,500,0,1,502,2768150,2.76815
5700,4500,500,25650000,2,4006,1003,1,246000000,246000000,1501,500,1001,500,0,1,502,2817709,2.817709
5700,4500,500,25650000,2,4006,1003,1,246000000,246000000,1501,500,1001,500,0,1,502,2750382,2.750382
5700,4500,500,25650000,2,4006,1003,1,246000000,246000000,1501,500,1001,500,0,1,502,2787810,2.78781
5700,4500,500,25650000,2,4006,1003,1,246000000,246000000,1501,500,1001,500,0,1,502,2788170,2.78817
5700,4500,500,25650000,2,4006,1003,1,246000000,246000000,1501,500,1001,500,0,1,502,2881357,2.881357
5700,4500,900,25650000,2,7206,1803,1,278640000,278640000,2701,900,1801,900,0,1,902,4507732,4.507732
5700,4500,900,25650000,2,7206,1803,1,278640000,278640000,2701,900,1801,900,0,1,902,4641501,4.641501
5700,4500,900,25650000,2,7206,1803,1,278640000,278640000,2701,900,1801,900,0,1,902,4550677,4.550677
5700,4500,900,25650000,2,7206,1803,1,278640000,278640000,2701,900,1801,900,0,1,902,4597531,4.597531
5700,4500,900,25650000,2,7206,1803,1,278640000,278640000,2701,900,1801,900,0,1,902,4489935,4.489935
5700,4500,900,25650000,2,7206,1803,1,278640000,278640000,2701,900,1801,900,0,1,902,4620118,4.620118
5700,4500,900,25650000,2,7206,1803,1,278640000,278640000,2701,900,1801,900,0,1,902,4464350,4.46435
5700,4500,900,25650000,2,7206,1803,1,278640000,278640000,2701,900,1801,900,0,1,902,4719036,4.719036
5700,4500,1300,25650000,2,10406,2603,1,311280000,311280000,3901,1300,2601,1300,0,1,1302,6368616,6.368616
5700,4500,1300,25650000,2,10406,2603,1,311280000,311280000,3901,1300,2601,1300,0,1,1302,6602771,6.602771
5700,4500,1300,25650000,2,10406,2603,1,311280000,311280000,3901,1300,2601,1300,0,1,1302,6420749,6.420749
5700,4500,1300,25650000,2,10406,2603,1,311280000,311280000,3901,1300,2601,1300,0,1,1302,6512396,6.512396
5700,4500,1300,25650000,2,10406,2603,1,311280000,311280000,3901,1300,2601,1300,0,1,1302,6350304,6.350304
5700,4500,1300,25650000,2,10406,2603,1,311280000,311280000,3901,1300,2601,1300,0,1,1302,6582346,6.582346
5700,4500,1300,25650000,2,10406,2603,1,311280000,311280000,3901,1300,2601,1300,0,1,1302,6274326,6.274326
5700,4500,1300,25650000,2,10406,2603,1,311280000,311280000,3901,1300,2601,1300,0,1,1302,6674322,6.674322
5700,4500,1700,25650000,2,13606,3403,1,343920000,343920000,5101,1700,3401,1700,0,1,1702,8408837,8.408837
5700,4500,1700,25650000,2,13606,3403,1,343920000,343920000,5101,1700,3401,1700,0,1,1702,8554279,8.554279
5700,4500,1700,25650000,2,13606,3403,1,343920000,343920000,5101,1700,3401,1700,0,1,1702,8478072,8.478072
5700,4500,1700,25650000,2,13606,3403,1,343920000,343920000,5101,1700,3401,1700,0,1,1702,8455155,8.455155
5700,4500,1700,25650000,2,13606,3403,1,343920000,343920000,5101,1700,3401,1700,0,1,1702,8427007,8.427007
5700,4500,1700,25650000,2,13606,3403,1,343920000,343920000,5101,1700,3401,1700,0,1,1702,8535698,8.535698
5700,4500,1700,25650000,2,13606,3403,1,343920000,343920000,5101,1700,3401,1700,0,1,1702,8312054,8.312054
5700,4500,1700,25650000,2,13606,3403,1,343920000,343920000,5101,1700,3401,1700,0,1,1702,8666625,8.666625
5700,4500,2100,25650000,2,16806,4203,1,376560000,376560000,6301,2100,4201,2100,0,1,2102,10118348,10.118348
5700,4500,2100,25650000,2,16806,4203,1,376560000,376560000,6301,2100,4201,2100,0,1,2102,10596493,10.596493
5700,4500,2100,25650000,2,16806,4203,1,376560000,376560000,6301,2100,4201,2100,0,1,2102,10196887,10.196887
5700,4500,2100,25650000,2,16806,4203,1,376560000,376560000,6301,2100,4201,2100,0,1,2102,10512870,10.51287
5700,4500,2100,25650000,2,16806,4203,1,376560000,376560000,6301,2100,4201,2100,0,1,2102,10083180,10.08318
5700,4500,2100,25650000,2,16806,4203,1,376560000,376560000,6301,2100,4201,2100,0,1,2102,10596170,10.59617
5700,4500,2100,25650000,2,16806,4203,1,376560000,376560000,6301,2100,4201,2100,0,1,2102,9981744,9.981744
5700,4500,2100,25650000,2,16806,4203,1,376560000,376560000,6301,2100,4201,2100,0,1,2102,10769213,10.769213
5700,4500,2500,25650000,2,20006,5003,1,409200000,409200000,7501,2500,5001,2500,0,1,2502,12130378,12.130378
5700,4500,2500,25650000,2,20006,5003,1,409200000,409200000,7501,2500,5001,2500,0,1,2502,12570725,12.570725
5700,4500,2500,25650000,2,20006,5003,1,409200000,409200000,7501,2500,5001,2500,0,1,2502,12229629,12.229629
5700,4500,2500,25650000,2,20006,5003,1,409200000,409200000,7501,2500,5001,2500,0,1,2502,12428627,12.428627
5700,4500,2500,25650000,2,20006,5003,1,409200000,409200000,7501,2500,5001,2500,0,1,2502,12093167,12.093167
5700,4500,2500,25650000,2,20006,5003,1,409200000,409200000,7501,2500,5001,2500,0,1,2502,12589138,12.589138
5700,4500,2500,25650000,2,20006,5003,1,409200000,409200000,7501,2500,5001,2500,0,1,2502,12012170,12.01217
5700,4500,2500,25650000,2,20006,5003,1,409200000,409200000,7501,2500,5001,2500,0,1,2502,12732135,12.732135
5700,4500,2900,25650000,2,23206,5803,1,441840000,441840000,8701,2900,5801,2900,0,1,2902,14012344,14.012344
5700,4500,2900,25650000,2,23206,5803,1,441840000,441840000,8701,2900,5801,2900,0,1,2902,14499204,14.499204
5700,4500,2900,25650000,2,23206,5803,1,441840000,441840000,8701,2900,5801,2900,0,1,2902,14130836,14.130836
5700,4500,2900,25650000,2,23206,5803,1,441840000,441840000,8701,2900,5801,2900,0,1,2902,14398842,14.398842
5700,4500,2900,25650000,2,23206,5803,1,441840000,441840000,8701,2900,5801,2900,0,1,2902,13978311,13.978311
5700,4500,2900,25650000,2,23206,5803,1,441840000,441840000,8701,2900,5801,2900,0,1,2902,14567886,14.567886
5700,4500,2900,25650000,2,23206,5803,1,441840000,441840000,8701,2900,5801,2900,0,1,2902,13898347,13.898347
5700,4500,2900,25650000,2,23206,5803,1,441840000,441840000,8701,2900,5801,2900,0,1,2902,14724833,14.724833
5700,4500,3300,25650000,2,26406,6603,1,474480000,474480000,9901,3300,6601,3300,0,1,3302,15927394,15.927394
5700,4500,3300,25650000,2,26406,6603,1,474480000,474480000,9901,3300,6601,3300,0,1,3302,16459967,16.459967
5700,4500,3300,25650000,2,26406,6603,1,474480000,474480000,9901,3300,6601,3300,0,1,3302,16077840,16.07784
5700,4500,3300,25650000,2,26406,6603,1,474480000,474480000,9901,3300,6601,3300,0,1,3302,16377577,16.377577
5700,4500,3300,25650000,2,26406,6603,1,474480000,474480000,9901,3300,6601,3300,0,1,3302,15887277,15.887277
5700,4500,3300,25650000,2,26406,6603,1,474480000,474480000,9901,3300,6601,3300,0,1,3302,16488945,16.488945
5700,4500,3300,25650000,2,26406,6603,1,474480000,474480000,9901,3300,6601,3300,0,1,3302,15789544,15.789544
5700,4500,3300,25650000,2,26406,6603,1,474480000,474480000,9901,3300,6601,3300,0,1,3302,16719176,16.719176
5700,4500,3700,25650000,2,29606,7403,1,507120000,507120000,11101,3700,7401,3700,0,1,3702,17802596,17.802596
5700,4500,3700,25650000,2,29606,7403,1,507120000,507120000,11101,3700,7401,3700,0,1,3702,18461388,18.461388
5700,4500,3700,25650000,2,29606,7403,1,507120000,507120000,11101,3700,7401,3700,0,1,3702,17951053,17.951053
5700,4500,3700,25650000,2,29606,7403,1,507120000,507120000,11101,3700,7401,3700,0,1,3702,18283041,18.283041
5700,4500,3700,25650000,2,29606,7403,1,507120000,507120000,11101,3700,7401,3700,0,1,3702,17784453,17.784453
5700,4500,3700,25650000,2,29606,7403,1,507120000,507120000,11101,3700,7401,3700,0,1,3702,18491561,18.491561
5700,4500,3700,25650000,2,29606,7403,1,507120000,507120000,11101,3700,7401,3700,0,1,3702,17626007,17.626007
5700,4500,3700,25650000,2,29606,7403,1,507120000,507120000,11101,3700,7401,3700,0,1,3702,18693161,18.693161
5700,4500,4100,25650000,2,32806,8203,1,539760000,539760000,12301,4100,8201,4100,0,1,4102,19680855,19.680855
5700,4500,4100,25650000,2,32806,8203,1,539760000,539760000,12301,4100,8201,4100,0,1,4102,20418970,20.41897
5700,4500,4100,25650000,2,32806,8203,1,539760000,539760000,12301,4100,8201,4100,0,1,4102,19816888,19.816888
5700,4500,4100,25650000,2,32806,8203,1,539760000,539760000,12301,4100,8201,4100,0,1,4102,20206932,20.206932
5700,4500,4100,25650000,2,32806,8203,1,539760000,539760000,12301,4100,8201,4100,0,1,4102,19623973,19.623973
5700,4500,4100,25650000,2,32806,8203,1,539760000,539760000,12301,4100,8201,4100,0,1,4102,20462440,20.46244
5700,4500,4100,25650000,2,32806,8203,1,539760000,539760000,12301,4100,8201,4100,0,1,4102,19478942,19.478942
5700,4500,4100,25650000,2,32806,8203,1,539760000,539760000,12301,4100,8201,4100,0,1,4102,20676935,20.676935
5700,4500,4500,25650000,2,36006,9003,1,572400000,572400000,13501,4500,9001,4500,0,1,4502,21589080,21.58908
5700,4500,4500,25650000,2,36006,9003,1,572400000,572400000,13501,4500,9001,4500,0,1,4502,22362548,22.362548
5700,4500,4500,25650000,2,36006,9003,1,572400000,572400000,13501,4500,9001,4500,0,1,4502,21733042,21.733042
5700,4500,4500,25650000,2,36006,9003,1,572400000,572400000,13501,4500,9001,4500,0,1,4502,22176398,22.176398
5700,4500,4500,25650000,2,36006,9003,1,572400000,572400000,13501,4500,9001,4500,0,1,4502,21549272,21.549272
5700,4500,4500,25650000,2,36006,9003,1,572400000,572400000,13501,4500,9001,4500,0,1,4502,22408079,22.408079
5700,4500,4500,25650000,2,36006,9003,1,572400000,572400000,13501,4500,9001,4500,0,1,4502,21365513,21.365513
5700,4500,4500,25650000,2,36006,9003,1,572400000,572400000,13501,4500,9001,4500,0,1,4502,22675153,22.675153
5700,4500,4900,25650000,2,39206,9803,1,605040000,605040000,14701,4900,9801,4900,0,1,4902,23513632,23.513632
5700,4500,4900,25650000,2,39206,9803,1,605040000,605040000,14701,4900,9801,4900,0,1,4902,24351797,24.351797
5700,4500,4900,25650000,2,39206,9803,1,605040000,605040000,14701,4900,9801,4900,0,1,4902,23619166,23.619166
5700,4500,4900,25650000,2,39206,9803,1,605040000,605040000,14701,4900,9801,4900,0,1,4902,24118302,24.118302
5700,4500,4900,25650000,2,39206,9803,1,605040000,605040000,14701,4900,9801,4900,0,1,4902,23388254,23.388254
5700,4500,4900,25650000,2,39206,9803,1,605040000,605040000,14701,4900,9801,4900,0,1,4902,24408643,24.408643
5700,4500,4900,25650000,2,39206,9803,1,605040000,605040000,14701,4900,9801,4900,0,1,4902,23237368,23.237368
5700,4500,4900,25650000,2,39206,9803,1,605040000,605040000,14701,4900,9801,4900,0,1,4902,24657511,24.657511
5700,4500,5300,25650000,2,42406,10603,1,637680000,637680000,15901,5300,10601,5300,0,1,5302,25421631,25.421631
5700,4500,5300,25650000,2,42406,10603,1,637680000,637680000,15901,5300,10601,5300,0,1,5302,26322872,26.322872
5700,4500,5300,25650000,2,42406,10603,1,637680000,637680000,15901,5300,10601,5300,0,1,5302,25511657,25.511657
5700,4500,5300,25650000,2,42406,10603,1,637680000,637680000,15901,5300,10601,5300,0,1,5302,26106964,26.106964
5700,4500,5300,25650000,2,42406,10603,1,637680000,637680000,15901,5300,10601,5300,0,1,5302,25325789,25.325789
5700,4500,5300,25650000,2,42406,10603,1,637680000,637680000,15901,5300,10601,5300,0,1,5302,26365521,26.365521
5700,4500,5300,25650000,2,42406,10603,1,637680000,637680000,15901,5300,10601,5300,0,1,5302,25164490,25.16449
5700,4500,5300,25650000,2,42406,10603,1,637680000,637680000,15901,5300,10601,5300,0,1,5302,26644659,26.644659
5700,4500,5700,25650000,2,45606,11403,1,670320000,670320000,17101,5700,11401,5700,0,1,5702,27302917,27.302917
5700,4500,5700,25650000,2,45606,11403,1,670320000,670320000,17101,5700,11401,5700,0,1,5702,28309495,28.309495
5700,4500,5700,25650000,2,45606,11403,1,670320000,670320000,17101,5700,11401,5700,0,1,5702,27443627,27.443627
5700,4500,5700,25650000,2,45606,11403,1,670320000,670320000,17101,5700,11401,5700,0,1,5702,28027878,28.027878
5700,4500,5700,25650000,2,45606,11403,1,670320000,670320000,17101,5700,11401,5700,0,1,5702,27180325,27.180325
5700,4500,5700,25650000,2,45606,11403,1,670320000,670320000,17101,5700,11401,5700,0,1,5702,28377658,28.377658
5700,4500,5700,25650000,2,45606,11403,1,670320000,670320000,17101,5700,11401,5700,0,1,5702,27002683,27.002683
5700,4500,5700,25650000,2,45606,11403,1,670320000,670320000,17101,5700,11401,5700,0,1,5702,28617970,28.61797
5700,4500,6100,25650000,2,48806,12203,1,702960000,702960000,18301,6100,12201,6100,0,1,6102,29249043,29.249043
5700,4500,6100,25650000,2,48806,12203,1,702960000,702960000,18301,6100,12201,6100,0,1,6102,30385755,30.385755
5700,4500,6100,25650000,2,48806,12203,1,702960000,702960000,18301,6100,12201,6100,0,1,6102,29368285,29.368285
5700,4500,6100,25650000,2,48806,12203,1,702960000,702960000,18301,6100,12201,6100,0,1,6102,29985040,29.98504
5700,4500,6100,25650000,2,48806,12203,1,702960000,702960000,18301,6100,12201,6100,0,1,6102,29031084,29.031084
5700,4500,6100,25650000,2,48806,12203,1,702960000,702960000,18301,6100,12201,6100,0,1,6102,30347723,30.347723
5700,4500,6100,25650000,2,48806,12203,1,702960000,702960000,18301,6100,12201,6100,0,1,6102,28889114,28.889114
5700,4500,6100,25650000,2,48806,12203,1,702960000,702960000,18301,6100,12201,6100,0,1,6102,30670009,30.670009
5700,4500,6500,25650000,2,52006,13003,1,735600000,735600000,19501,6500,13001,6500,0,1,6502,31148256,31.148256
5700,4500,6500,25650000,2,52006,13003,1,735600000,735600000,19501,6500,13001,6500,0,1,6502,32313399,32.313399
5700,4500,6500,25650000,2,52006,13003,1,735600000,735600000,19501,6500,13001,6500,0,1,6502,31279114,31.279114
5700,4500,6500,25650000,2,52006,13003,1,735600000,735600000,19501,6500,13001,6500,0,1,6502,32015720,32.01572
5700,4500,6500,25650000,2,52006,13003,1,735600000,735600000,19501,6500,13001,6500,0,1,6502,30930473,30.930473
5700,4500,6500,25650000,2,52006,13003,1,735600000,735600000,19501,6500,13001,6500,0,1,6502,32334599,32.334599
5700,4500,6500,25650000,2,52006,13003,1,735600000,735600000,19501,6500,13001,6500,0,1,6502,30725921,30.725921
5700,4500,6500,25650000,2,52006,13003,1,735600000,735600000,19501,6500,13001,6500,0,1,6502,32685899,32.685899
5700,4500,6900,25650000,2,55206,13803,1,768240000,768240000,20701,6900,13801,6900,0,1,6902,33070459,33.070459
5700,4500,6900,25650000,2,55206,13803,1,768240000,768240000,20701,6900,13801,6900,0,1,6902,34245981,34.245981
5700,4500,6900,25650000,2,55206,13803,1,768240000,768240000,20701,6900,13801,6900,0,1,6902,33185491,33.185491
5700,4500,6900,25650000,2,55206,13803,1,768240000,768240000,20701,6900,13801,6900,0,1,6902,34059216,34.059216
5700,4500,6900,25650000,2,55206,13803,1,768240000,768240000,20701,6900,13801,6900,0,1,6902,32897870,32.89787
5700,4500,6900,25650000,2,55206,13803,1,768240000,768240000,20701,6900,13801,6900,0,1,6902,34297304,34.297304
5700,4500,6900,25650000,2,55206,13803,1,768240000,768240000,20701,6900,13801,6900,0,1,6902,32676129,32.676129
5700,4500,6900,25650000,2,55206,13803,1,768240000,768240000,20701,6900,13801,6900,0,1,6902,34707090,34.70709
5700,4100,500,23370000,2,4006,1003,1,226160000,226160000,1501,500,1001,500,0,1,502,2371583,2.371583
5700,4100,500,23370000,2,4006,1003,1,226160000,226160000,1501,500,1001,500,0,1,502,2484636,2.484636
5700,4100,500,23370000,2,4006,1003,1,226160000,226160000,1501,500,1001,500,0,1,502,2586381,2.586381
5700,4100,500,23370000,2,4006,1003,1,226160000,226160000,1501,500,1001,500,0,1,502,2588863,2.588863
5700,4100,500,23370000,2,4006,1003,1,226160000,226160000,1501,500,1001,500,0,1,502,2549119,2.549119
5700,4100,500,23370000,2,4006,1003,1,226160000,226160000,1501,500,1001,500,0,1,502,2532457,2.532457
5700,4100,500,23370000,2,4006,1003,1,226160000,226160000,1501,500,1001,500,0,1,502,2533017,2.533017
5700,4100,500,23370000,2,4006,1003,1,226160000,226160000,1501,500,1001,500,0,1,502,2501463,2.501463
5700,4100,900,23370000,2,7206,1803,1,257520000,257520000,2701,900,1801,900,0,1,902,4088357,4.088357
5700,4100,900,23370000,2,7206,1803,1,257520000,257520000,2701,900,1801,900,0,1,902,4220861,4.220861
5700,4100,900,23370000,2,7206,1803,1,257520000,257520000,2701,900,1801,900,0,1,902,4120190,4.12019
5700,4100,900,23370000,2,7206,1803,1,257520000,257520000,2701,900,1801,900,0,1,902,4200688,4.200688
5700,4100,900,23370000,2,7206,1803,1,257520000,257520000,2701,900,1801,900,0,1,902,4072149,4.072149
5700,4100,900,23370000,2,7206,1803,1,257520000,257520000,2701,900,1801,900,0,1,902,4251157,4.251157
5700,4100,900,23370000,2,7206,1803,1,257520000,257520000,2701,900,1801,900,0,1,902,4021926,4.021926
5700,4100,900,23370000,2,7206,1803,1,257520000,257520000,2701,900,1801,900,0,1,902,4368498,4.368498
5700,4100,1300,23370000,2,10406,2603,1,288880000,288880000,3901,1300,2601,1300,0,1,1302,5799660,5.79966
5700,4100,1300,23370000,2,10406,2603,1,288880000,288880000,3901,1300,2601,1300,0,1,1302,6008101,6.008101
5700,4100,1300,23370000,2,10406,2603,1,288880000,288880000,3901,1300,2601,1300,0,1,1302,5842436,5.842436
5700,4100,1300,23370000,2,10406,2603,1,288880000,288880000,3901,1300,2601,1300,0,1,1302,5951899,5.951899
5700,4100,1300,23370000,2,10406,2603,1,288880000,288880000,3901,1300,2601,1300,0,1,1302,5761720,5.76172
5700,4100,1300,23370000,2,10406,2603,1,288880000,288880000,3901,1300,2601,1300,0,1,1302,6025458,6.025458
5700,4100,1300,23370000,2,10406,2603,1,288880000,288880000,3901,1300,2601,1300,0,1,1302,5745474,5.745474
5700,4100,1300,23370000,2,10406,2603,1,288880000,288880000,3901,1300,2601,1300,0,1,1302,6088774,6.088774
5700,4100,1700,23370000,2,13606,3403,1,320240000,320240000,5101,1700,3401,1700,0,1,1702,7518545,7.518545
5700,4100,1700,23370000,2,13606,3403,1,320240000,320240000,5101,1700,3401,1700,0,1,1702,7782891,7.782891
5700,4100,1700,23370000,2,13606,3403,1,320240000,320240000,5101,1700,3401,1700,0,1,1702,7581311,7.581311
5700,4100,1700,23370000,2,13606,3403,1,320240000,320240000,5101,1700,3401,1700,0,1,1702,7706290,7.70629
5700,4100,1700,23370000,2,13606,3403,1,320240000,320240000,5101,1700,3401,1700,0,1,1702,7466257,7.466257
5700,4100,1700,23370000,2,13606,3403,1,320240000,320240000,5101,1700,3401,1700,0,1,1702,7799735,7.799735
5700,4100,1700,23370000,2,13606,3403,1,320240000,320240000,5101,1700,3401,1700,0,1,1702,7421611,7.421611
5700,4100,1700,23370000,2,13606,3403,1,320240000,320240000,5101,1700,3401,1700,0,1,1702,7886004,7.886004
5700,4100,2100,23370000,2,16806,4203,1,351600000,351600000,6301,2100,4201,2100,0,1,2102,9358158,9.358158
5700,4100,2100,23370000,2,16806,4203,1,351600000,351600000,6301,2100,4201,2100,0,1,2102,9678501,9.678501
5700,4100,2100,23370000,2,16806,4203,1,351600000,351600000,6301,2100,4201,2100,0,1,2102,9470302,9.470302
5700,4100,2100,23370000,2,16806,4203,1,351600000,351600000,6301,2100,4201,2100,0,1,2102,9599169,9.599169
5700,4100,2100,23370000,2,16806,4203,1,351600000,351600000,6301,2100,4201,2100,0,1,2102,9341319,9.341319
5700,4100,2100,23370000,2,16806,4203,1,351600000,351600000,6301,2100,4201,2100,0,1,2102,9660539,9.660539
5700,4100,2100,23370000,2,16806,4203,1,351600000,351600000,6301,2100,4201,2100,0,1,2102,9315083,9.315083
5700,4100,2100,23370000,2,16806,4203,1,351600000,351600000,6301,2100,4201,2100,0,1,2102,9678971,9.678971
5700,4100,2500,23370000,2,20006,5003,1,382960000,382960000,7501,2500,5001,2500,0,1,2502,10953161,10.953161
5700,4100,2500,23370000,2,20006,5003,1,382960000,382960000,7501,2500,5001,2500,0,1,2502,11346235,11.346235
5700,4100,2500,23370000,2,20006,5003,1,382960000,382960000,7501,2500,5001,2500,0,1,2502,11048792,11.048792
5700,4100,2500,23370000,2,20006,5003,1,382960000,382960000,7501,2500,5001,2500,0,1,2502,11227467,11.227467
5700,4100,2500,23370000,2,20006,5003,1,382960000,382960000,7501,2500,5001,2500,0,1,2502,10885796,10.885796
5700,4100,2500,23370000,2,20006,5003,1,382960000,382960000,7501,2500,5001,2500,0,1,2502,11372369,11.372369
5700,4100,2500,23370000,2,20006,5003,1,382960000,382960000,7501,2500,5001,2500,0,1,2502,10808508,10.808508
5700,4100,2500,23370000,2,20006,5003,1,382960000,382960000,7501,2500,5001,2500,0,1,2502,11581315,11.581315
5700,4100,2900,23370000,2,23206,5803,1,414320000,414320000,8701,2900,5801,2900,0,1,2902,12777929,12.777929
5700,4100,2900,23370000,2,23206,5803,1,414320000,414320000,8701,2900,5801,2900,0,1,2902,13242085,13.242085
5700,4100,2900,23370000,2,23206,5803,1,414320000,414320000,8701,2900,5801,2900,0,1,2902,12935567,12.935567
5700,4100,2900,23370000,2,23206,5803,1,414320000,414320000,8701,2900,5801,2900,0,1,2902,13144551,13.144551
5700,4100,2900,23370000,2,23206,5803,1,414320000,414320000,8701,2900,5801,2900,0,1,2902,12761670,12.76167
5700,4100,2900,23370000,2,23206,5803,1,414320000,414320000,8701,2900,5801,2900,0,1,2902,13265979,13.265979
5700,4100,2900,23370000,2,23206,5803,1,414320000,414320000,8701,2900,5801,2900,0,1,2902,12709292,12.709292
5700,4100,2900,23370000,2,23206,5803,1,414320000,414320000,8701,2900,5801,2900,0,1,2902,13293224,13.293224
5700,4100,3300,23370000,2,26406,6603,1,445680000,445680000,9901,3300,6601,3300,0,1,3302,14602699,14.602699
5700,4100,3300,23370000,2,26406,6603,1,445680000,445680000,9901,3300,6601,3300,0,1,3302,15061633,15.061633
5700,4100,3300,23370000,2,26406,6603,1,445680000,445680000,9901,3300,6601,3300,0,1,3302,14695127,14.695127
5700,4100,3300,23370000,2,26406,6603,1,445680000,445680000,9901,3300,6601,3300,0,1,3302,14935826,14.935826
5700,4100,3300,23370000,2,26406,6603,1,445680000,445680000,9901,3300,6601,3300,0,1,3302,14466307,14.466307
5700,4100,3300,23370000,2,26406,6603,1,445680000,445680000,9901,3300,6601,3300,0,1,3302,15078466,15.078466
5700,4100,3300,23370000,2,26406,6603,1,445680000,445680000,9901,3300,6601,3300,0,1,3302,14403467,14.403467
5700,4100,3300,23370000,2,26406,6603,1,445680000,445680000,9901,3300,6601,3300,0,1,3302,15181834,15.181834
5700,4100,3700,23370000,2,29606,7403,1,477040000,477040000,11101,3700,7401,3700,0,1,3702,16288505,16.288505
5700,4100,3700,23370000,2,29606,7403,1,477040000,477040000,11101,3700,7401,3700,0,1,3702,16735929,16.735929
5700,4100,3700,23370000,2,29606,7403,1,477040000,477040000,11101,3700,7401,3700,0,1,3702,16451435,16.451435
5700,4100,3700,23370000,2,29606,7403,1,477040000,477040000,11101,3700,7401,3700,0,1,3702,16617334,16.617334
5700,4100,3700,23370000,2,29606,7403,1,477040000,477040000,11101,3700,7401,3700,0,1,3702,16212672,16.212672
5700,4100,3700,23370000,2,29606,7403,1,477040000,477040000,11101,3700,7401,3700,0,1,3702,16762291,16.762291
5700,4100,3700,23370000,2,29606,7403,1,477040000,477040000,11101,3700,7401,3700,0,1,3702,16088230,16.08823
5700,4100,3700,23370000,2,29606,7403,1,477040000,477040000,11101,3700,7401,3700,0,1,3702,17022041,17.022041
5700,4100,4100,23370000,2,32806,8203,1,508400000,508400000,12301,4100,8201,4100,0,1,4102,17988209,17.988209
5700,4100,4100,23370000,2,32806,8203,1,508400000,508400000,12301,4100,8201,4100,0,1,4102,18622629,18.622629
5700,4100,4100,23370000,2,32806,8203,1,508400000,508400000,12301,4100,8201,4100,0,1,4102,18105313,18.105313
5700,4100,4100,23370000,2,32806,8203,1,508400000,508400000,12301,4100,8201,4100,0,1,4102,18413594,18.413594
5700,4100,4100,23370000,2,32806,8203,1,508400000,508400000,12301,4100,8201,4100,0,1,4102,17901768,17.901768
5700,4100,4100,23370000,2,32806,8203,1,508400000,508400000,12301,4100,8201,4100,0,1,4102,18658237,18.658237
5700,4100,4100,23370000,2,32806,8203,1,508400000,508400000,12301,4100,8201,4100,0,1,4102,17819231,17.819231
5700,4100,4100,23370000,2,32806,8203,1,508400000,508400000,12301,4100,8201,4100,0,1,4102,18815052,18.815052
5700,4100,4500,23370000,2,36006,9003,1,539760000,539760000,13501,4500,9001,4500,0,1,4502,19751751,19.751751
5700,4100,4500,23370000,2,36006,9003,1,539760000,539760000,13501,4500,9001,4500,0,1,4502,20389203,20.389203
5700,4100,4500,23370000,2,36006,9003,1,539760000,539760000,13501,4500,9001,4500,0,1,4502,19893525,19.893525
5700,4100,4500,23370000,2,36006,9003,1,539760000,539760000,13501,4500,9001,4500,0,1,4502,20211334,20.211334
5700,4100,4500,23370000,2,36006,9003,1,539760000,539760000,13501,4500,9001,4500,0,1,4502,19591996,19.591996
5700,4100,4500,23370000,2,36006,9003,1,539760000,539760000,13501,4500,9001,4500,0,1,4502,20429643,20.429643
5700,4100,4500,23370000,2,36006,9003,1,539760000,539760000,13501,4500,9001,4500,0,1,4502,19608013,19.608013
5700,4100,4500,23370000,2,36006,9003,1,539760000,539760000,13501,4500,9001,4500,0,1,4502,20735421,20.735421
5700,4100,4900,23370000,2,39206,9803,1,571120000,571120000,14701,4900,9801,4900,0,1,4902,21476410,21.47641
5700,4100,4900,23370000,2,39206,9803,1,571120000,571120000,14701,4900,9801,4900,0,1,4902,22219511,22.219511
5700,4100,4900,23370000,2,39206,9803,1,571120000,571120000,14701,4900,9801,4900,0,1,4902,21570235,21.570235
5700,4100,4900,23370000,2,39206,9803,1,571120000,571120000,14701,4900,9801,4900,0,1,4902,21984779,21.984779
5700,4100,4900,23370000,2,39206,9803,1,571120000,571120000,14701,4900,9801,4900,0,1,4902,21353221,21.353221
5700,4100,4900,23370000,2,39206,9803,1,571120000,571120000,14701,4900,9801,4900,0,1,4902,22237288,22.237288
5700,4100,4900,23370000,2,39206,9803,1,571120000,571120000,14701,4900,9801,4900,0,1,4902,21223946,21.223946
5700,4100,4900,23370000,2,39206,9803,1,571120000,571120000,14701,4900,9801,4900,0,1,4902,22509859,22.509859
5700,4100,5300,23370000,2,42406,10603,1,602480000,602480000,15901,5300,10601,5300,0,1,5302,23186222,23.186222
5700,4100,5300,23370000,2,42406,10603,1,602480000,602480000,15901,5300,10601,5300,0,1,5302,24040966,24.040966
5700,4100,5300,23370000,2,42406,10603,1,602480000,602480000,15901,5300,10601,5300,0,1,5302,23366620,23.36662
5700,4100,5300,23370000,2,42406,10603,1,602480000,602480000,15901,5300,10601,5300,0,1,5302,23761747,23.761747
5700,4100,5300,23370000,2,42406,10603,1,602480000,602480000,15901,5300,10601,5300,0,1,5302,23153950,23.15395
5700,4100,5300,23370000,2,42406,10603,1,602480000,602480000,15901,5300,10601,5300,0,1,5302,24120927,24.120927
5700,4100,5300,23370000,2,42406,10603,1,602480000,602480000,15901,5300,10601,5300,0,1,5302,23022965,23.022965
5700,4100,5300,23370000,2,42406,10603,1,602480000,602480000,15901,5300,10601,5300,0,1,5302,24399578,24.399578
5700,4100,5700,23370000,2,45606,11403,1,633840000,633840000,17101,5700,11401,5700,0,1,5702,24972176,24.972176
5700,4100,5700,23370000,2,45606,11403,1,633840000,633840000,17101,5700,11401,5700,0,1,5702,25845426,25.845426
5700,4100,5700,23370000,2,45606,11403,1,633840000,633840000,17101,5700,11401,5700,0,1,5702,25077012,25.077012
5700,4100,5700,23370000,2,45606,11403,1,633840000,633840000,17101,5700,11401,5700,0,1,5702,25592964,25.592964
5700,4100,5700,23370000,2,45606,11403,1,633840000,633840000,17101,5700,11401,5700,0,1,5702,24786404,24.786404
5700,4100,5700,23370000,2,45606,11403,1,633840000,633840000,17101,5700,11401,5700,0,1,5702,25947629,25.947629
5700,4100,5700,23370000,2,45606,11403,1,633840000,633840000,17101,5700,11401,5700,0,1,5702,24658986,24.658986
5700,4100,5700,23370000,2,45606,11403,1,633840000,633840000,17101,5700,11401,5700,0,1,5702,26174071,26.174071
5700,4100,6100,23370000,2,48806,12203,1,665200000,665200000,18301,6100,12201,6100,0,1,6102,26664889,26.664889
5700,4100,6100,23370000,2,48806,12203,1,665200000,665200000,18301,6100,12201,6100,0,1,6102,27613093,27.613093
5700,4100,6100,23370000,2,48806,12203,1,665200000,665200000,18301,6100,12201,6100,0,1,6102,26833541,26.833541
5700,4100,6100,23370000,2,48806,12203,1,665200000,665200000,18301,6100,12201,6100,0,1,6102,27459215,27.459215
5700,4100,6100,23370000,2,48806,12203,1,665200000,665200000,18301,6100,12201,6100,0,1,6102,26479198,26.479198
5700,4100,6100,23370000,2,48806,12203,1,665200000,665200000,18301,6100,12201,6100,0,1,6102,27763668,27.763668
5700,4100,6100,23370000,2,48806,12203,1,665200000,665200000,18301,6100,12201,6100,0,1,6102,26401273,26.401273
5700,4100,6100,23370000,2,48806,12203,1,665200000,665200000,18301,6100,12201,6100,0,1,6102,28048397,28.048397
5700,4100,6500,23370000,2,52006,13003,1,696560000,696560000,19501,6500,13001,6500,0,1,6502,28381932,28.381932
5700,4100,6500,23370000,2,52006,13003,1,696560000,696560000,19501,6500,13001,6500,0,1,6502,29482589,29.482589
5700,4100,6500,23370000,2,52006,13003,1,696560000,696560000,19501,6500,13001,6500,0,1,6502,28599407,28.599407
5700,4100,6500,23370000,2,52006,13003,1,696560000,696560000,19501,6500,13001,6500,0,1,6502,29235040,29.23504
5700,4100,6500,23370000,2,52006,13003,1,696560000,696560000,19501,6500,13001,6500,0,1,6502,28237835,28.237835
5700,4100,6500,23370000,2,52006,13003,1,696560000,696560000,19501,6500,13001,6500,0,1,6502,29461625,29.461625
5700,4100,6500,23370000,2,52006,13003,1,696560000,696560000,19501,6500,13001,6500,0,1,6502,28152689,28.152689
5700,4100,6500,23370000,2,52006,13003,1,696560000,696560000,19501,6500,13001,6500,0,1,6502,29858707,29.858707
5700,4100,6900,23370000,2,55206,13803,1,727920000,727920000,20701,6900,13801,6900,0,1,6902,30219560,30.21956
5700,4100,6900,23370000,2,55206,13803,1,727920000,727920000,20701,6900,13801,6900,0,1,6902,31283783,31.283783
5700,4100,6900,23370000,2,55206,13803,1,727920000,727920000,20701,6900,13801,6900,0,1,6902,30377434,30.377434
5700,4100,6900,23370000,2,55206,13803,1,727920000,727920000,20701,6900,13801,6900,0,1,6902,31073239,31.073239
5700,4100,6900,23370000,2,55206,13803,1,727920000,727920000,20701,6900,13801,6900,0,1,6902,30060527,30.060527
5700,4100,6900,23370000,2,55206,13803,1,727920000,727920000,20701,6900,13801,6900,0,1,6902,31337465,31.337465
5700,4100,6900,23370000,2,55206,13803,1,727920000,727920000,20701,6900,13801,6900,0,1,6902,29872408,29.872408
5700,4100,6900,23370000,2,55206,13803,1,727920000,727920000,20701,6900,13801,6900,0,1,6902,31681800,31.6818
5700,3700,500,21090000,2,4006,1003,1,206320000,206320000,1501,500,1001,500,0,1,502,2293901,2.293901
5700,3700,500,21090000,2,4006,1003,1,206320000,206320000,1501,500,1001,500,0,1,502,2325688,2.325688
5700,3700,500,21090000,2,4006,1003,1,206320000,206320000,1501,500,1001,500,0,1,502,2340599,2.340599
5700,3700,500,21090000,2,4006,1003,1,206320000,206320000,1501,500,1001,500,0,1,502,2341576,2.341576
5700,3700,500,21090000,2,4006,1003,1,206320000,206320000,1501,500,1001,500,0,1,502,2324973,2.324973
5700,3700,500,21090000,2,4006,1003,1,206320000,206320000,1501,500,1001,500,0,1,502,2309498,2.309498
5700,3700,500,21090000,2,4006,1003,1,206320000,206320000,1501,500,1001,500,0,1,502,2254940,2.25494
5700,3700,500,21090000,2,4006,1003,1,206320000,206320000,1501,500,1001,500,0,1,502,2255655,2.255655
5700,3700,900,21090000,2,7206,1803,1,236400000,236400000,2701,900,1801,900,0,1,902,3676593,3.676593
5700,3700,900,21090000,2,7206,1803,1,236400000,236400000,2701,900,1801,900,0,1,902,3820466,3.820466
5700,3700,900,21090000,2,7206,1803,1,236400000,236400000,2701,900,1801,900,0,1,902,3711283,3.711283
5700,3700,900,21090000,2,7206,1803,1,236400000,236400000,2701,900,1801,900,0,1,902,3805404,3.805404
5700,3700,900,21090000,2,7206,1803,1,236400000,236400000,2701,900,1801,900,0,1,902,3691008,3.691008
5700,3700,900,21090000,2,7206,1803,1,236400000,236400000,2701,900,1801,900,0,1,902,3805702,3.805702
5700,3700,900,21090000,2,7206,1803,1,236400000,236400000,2701,900,1801,900,0,1,902,3650790,3.65079
5700,3700,900,21090000,2,7206,1803,1,236400000,236400000,2701,900,1801,900,0,1,902,3976634,3.976634
5700,3700,1300,21090000,2,10406,2603,1,266480000,266480000,3901,1300,2601,1300,0,1,1302,5230266,5.230266
5700,3700,1300,21090000,2,10406,2603,1,266480000,266480000,3901,1300,2601,1300,0,1,1302,5414565,5.414565
5700,3700,1300,21090000,2,10406,2603,1,266480000,266480000,3901,1300,2601,1300,0,1,1302,5282977,5.282977
5700,3700,1300,21090000,2,10406,2603,1,266480000,266480000,3901,1300,2601,1300,0,1,1302,5374718,5.374718
5700,3700,1300,21090000,2,10406,2603,1,266480000,266480000,3901,1300,2601,1300,0,1,1302,5215865,5.215865
5700,3700,1300,21090000,2,10406,2603,1,266480000,266480000,3901,1300,2601,1300,0,1,1302,5429893,5.429893
5700,3700,1300,21090000,2,10406,2603,1,266480000,266480000,3901,1300,2601,1300,0,1,1302,5161927,5.161927
5700,3700,1300,21090000,2,10406,2603,1,266480000,266480000,3901,1300,2601,1300,0,1,1302,5497572,5.497572
5700,3700,1700,21090000,2,13606,3403,1,296560000,296560000,5101,1700,3401,1700,0,1,1702,6769789,6.769789
5700,3700,1700,21090000,2,13606,3403,1,296560000,296560000,5101,1700,3401,1700,0,1,1702,7021113,7.021113
5700,3700,1700,21090000,2,13606,3403,1,296560000,296560000,5101,1700,3401,1700,0,1,1702,6830843,6.830843
5700,3700,1700,21090000,2,13606,3403,1,296560000,296560000,5101,1700,3401,1700,0,1,1702,6970109,6.970109
5700,3700,1700,21090000,2,13606,3403,1,296560000,296560000,5101,1700,3401,1700,0,1,1702,6737528,6.737528
5700,3700,1700,21090000,2,13606,3403,1,296560000,296560000,5101,1700,3401,1700,0,1,1702,7036406,7.036406
5700,3700,1700,21090000,2,13606,3403,1,296560000,296560000,5101,1700,3401,1700,0,1,1702,6705255,6.705255
5700,3700,1700,21090000,2,13606,3403,1,296560000,296560000,5101,1700,3401,1700,0,1,1702,7121264,7.121264
5700,3700,2100,21090000,2,16806,4203,1,326640000,326640000,6301,2100,4201,2100,0,1,2102,8485928,8.485928
5700,3700,2100,21090000,2,16806,4203,1,326640000,326640000,6301,2100,4201,2100,0,1,2102,8740125,8.740125
5700,3700,2100,21090000,2,16806,4203,1,326640000,326640000,6301,2100,4201,2100,0,1,2102,8564153,8.564153
5700,3700,2100,21090000,2,16806,4203,1,326640000,326640000,6301,2100,4201,2100,0,1,2102,8683078,8.683078
5700,3700,2100,21090000,2,16806,4203,1,326640000,326640000,6301,2100,4201,2100,0,1,2102,8459103,8.459103
5700,3700,2100,21090000,2,16806,4203,1,326640000,326640000,6301,2100,4201,2100,0,1,2102,8755678,8.755678
5700,3700,2100,21090000,2,16806,4203,1,326640000,326640000,6301,2100,4201,2100,0,1,2102,8395865,8.395865
5700,3700,2100,21090000,2,16806,4203,1,326640000,326640000,6301,2100,4201,2100,0,1,2102,8874192,8.874192
5700,3700,2500,21090000,2,20006,5003,1,356720000,356720000,7501,2500,5001,2500,0,1,2502,9871447,9.871447
5700,3700,2500,21090000,2,20006,5003,1,356720000,356720000,7501,2500,5001,2500,0,1,2502,10252821,10.252821
5700,3700,2500,21090000,2,20006,5003,1,356720000,356720000,7501,2500,5001,2500,0,1,2502,9955259,9.955259
5700,3700,2500,21090000,2,20006,5003,1,356720000,356720000,7501,2500,5001,2500,0,1,2502,10142157,10.142157
5700,3700,2500,21090000,2,20006,5003,1,356720000,356720000,7501,2500,5001,2500,0,1,2502,9815419,9.815419
5700,3700,2500,21090000,2,20006,5003,1,356720000,356720000,7501,2500,5001,2500,0,1,2502,10268123,10.268123
5700,3700,2500,21090000,2,20006,5003,1,356720000,356720000,7501,2500,5001,2500,0,1,2502,9755394,9.755394
5700,3700,2500,21090000,2,20006,5003,1,356720000,356720000,7501,2500,5001,2500,0,1,2502,10384002,10.384002
5700,3700,2900,21090000,2,23206,5803,1,386800000,386800000,8701,2900,5801,2900,0,1,2902,11545318,11.545318
5700,3700,2900,21090000,2,23206,5803,1,386800000,386800000,8701,2900,5801,2900,0,1,2902,11993997,11.993997
5700,3700,2900,21090000,2,23206,5803,1,386800000,386800000,8701,2900,5801,2900,0,1,2902,11691790,11.69179
5700,3700,2900,21090000,2,23206,5803,1,386800000,386800000,8701,2900,5801,2900,0,1,2902,11889361,11.889361
5700,3700,2900,21090000,2,23206,5803,1,386800000,386800000,8701,2900,5801,2900,0,1,2902,11569102,11.569102
5700,3700,2900,21090000,2,23206,5803,1,386800000,386800000,8701,2900,5801,2900,0,1,2902,12009124,12.009124
5700,3700,2900,21090000,2,23206,5803,1,386800000,386800000,8701,2900,5801,2900,0,1,2902,11469977,11.469977
5700,3700,2900,21090000,2,23206,5803,1,386800000,386800000,8701,2900,5801,2900,0,1,2902,12156815,12.156815
5700,3700,3300,21090000,2,26406,6603,1,416880000,416880000,9901,3300,6601,3300,0,1,3302,13147187,13.147187
5700,3700,3300,21090000,2,26406,6603,1,416880000,416880000,9901,3300,6601,3300,0,1,3302,13572991,13.572991
5700,3700,3300,21090000,2,26406,6603,1,416880000,416880000,9901,3300,6601,3300,0,1,3302,13221544,13.221544
5700,3700,3300,21090000,2,26406,6603,1,416880000,416880000,9901,3300,6601,3300,0,1,3302,13447347,13.447347
5700,3700,3300,21090000,2,26406,6603,1,416880000,416880000,9901,3300,6601,3300,0,1,3302,13091098,13.091098
5700,3700,3300,21090000,2,26406,6603,1,416880000,416880000,9901,3300,6601,3300,0,1,3302,13595844,13.595844
5700,3700,3300,21090000,2,26406,6603,1,416880000,416880000,9901,3300,6601,3300,0,1,3302,12988546,12.988546
5700,3700,3300,21090000,2,26406,6603,1,416880000,416880000,9901,3300,6601,3300,0,1,3302,13768885,13.768885
5700,3700,3700,21090000,2,29606,7403,1,446960000,446960000,11101,3700,7401,3700,0,1,3702,14680280,14.68028
5700,3700,3700,21090000,2,29606,7403,1,446960000,446960000,11101,3700,7401,3700,0,1,3702,15191474,15.191474
5700,3700,3700,21090000,2,29606,7403,1,446960000,446960000,11101,3700,7401,3700,0,1,3702,14801273,14.801273
5700,3700,3700,21090000,2,29606,7403,1,446960000,446960000,11101,3700,7401,3700,0,1,3702,15065641,15.065641
5700,3700,3700,21090000,2,29606,7403,1,446960000,446960000,11101,3700,7401,3700,0,1,3702,14621101,14.621101
5700,3700,3700,21090000,2,29606,7403,1,446960000,446960000,11101,3700,7401,3700,0,1,3702,15254594,15.254594
5700,3700,3700,21090000,2,29606,7403,1,446960000,446960000,11101,3700,7401,3700,0,1,3702,14583880,14.58388
5700,3700,3700,21090000,2,29606,7403,1,446960000,446960000,11101,3700,7401,3700,0,1,3702,15405580,15.40558
5700,3700,4100,21090000,2,32806,8203,1,477040000,477040000,12301,4100,8201,4100,0,1,4102,16207691,16.207691
5700,3700,4100,21090000,2,32806,8203,1,477040000,477040000,12301,4100,8201,4100,0,1,4102,16821864,16.821864
5700,3700,4100,21090000,2,32806,8203,1,477040000,477040000,12301,4100,8201,4100,0,1,4102,16362846,16.362846
5700,3700,4100,21090000,2,32806,8203,1,477040000,477040000,12301,4100,8201,4100,0,1,4102,16671732,16.671732
5700,3700,4100,21090000,2,32806,8203,1,477040000,477040000,12301,4100,8201,4100,0,1,4102,16192717,16.192717
5700,3700,4100,21090000,2,32806,8203,1,477040000,477040000,12301,4100,8201,4100,0,1,4102,16853437,16.853437
5700,3700,4100,21090000,2,32806,8203,1,477040000,477040000,12301,4100,8201,4100,0,1,4102,16094561,16.094561
5700,3700,4100,21090000,2,32806,8203,1,477040000,477040000,12301,4100,8201,4100,0,1,4102,17046900,17.0469
5700,3700,4500,21090000,2,36006,9003,1,507120000,507120000,13501,4500,9001,4500,0,1,4502,17794960,17.79496
5700,3700,4500,21090000,2,36006,9003,1,507120000,507120000,13501,4500,9001,4500,0,1,4502,18490234,18.490234
5700,3700,4500,21090000,2,36006,9003,1,507120000,507120000,13501,4500,9001,4500,0,1,4502,17941871,17.941871
5700,3700,4500,21090000,2,36006,9003,1,507120000,507120000,13501,4500,9001,4500,0,1,4502,18250611,18.250611
5700,3700,4500,21090000,2,36006,9003,1,507120000,507120000,13501,4500,9001,4500,0,1,4502,17693432,17.693432
5700,3700,4500,21090000,2,36006,9003,1,507120000,507120000,13501,4500,9001,4500,0,1,4502,18474993,18.474993
5700,3700,4500,21090000,2,36006,9003,1,507120000,507120000,13501,4500,9001,4500,0,1,4502,17652853,17.652853
5700,3700,4500,21090000,2,36006,9003,1,507120000,507120000,13501,4500,9001,4500,0,1,4502,18684385,18.684385
5700,3700,4900,21090000,2,39206,9803,1,537200000,537200000,14701,4900,9801,4900,0,1,4902,19320016,19.320016
5700,3700,4900,21090000,2,39206,9803,1,537200000,537200000,14701,4900,9801,4900,0,1,4902,20058009,20.058009
5700,3700,4900,21090000,2,39206,9803,1,537200000,537200000,14701,4900,9801,4900,0,1,4902,19517077,19.517077
5700,3700,4900,21090000,2,39206,9803,1,537200000,537200000,14701,4900,9801,4900,0,1,4902,19865648,19.865648
5700,3700,4900,21090000,2,39206,9803,1,537200000,537200000,14701,4900,9801,4900,0,1,4902,19212819,19.212819
5700,3700,4900,21090000,2,39206,9803,1,537200000,537200000,14701,4900,9801,4900,0,1,4902,20092008,20.092008
5700,3700,4900,21090000,2,39206,9803,1,537200000,537200000,14701,4900,9801,4900,0,1,4902,19148304,19.148304
5700,3700,4900,21090000,2,39206,9803,1,537200000,537200000,14701,4900,9801,4900,0,1,4902,20272223,20.272223
5700,3700,5300,21090000,2,42406,10603,1,567280000,567280000,15901,5300,10601,5300,0,1,5302,20918626,20.918626
5700,3700,5300,21090000,2,42406,10603,1,567280000,567280000,15901,5300,10601,5300,0,1,5302,21684864,21.684864
5700,3700,5300,21090000,2,42406,10603,1,567280000,567280000,15901,5300,10601,5300,0,1,5302,21103934,21.103934
5700,3700,5300,21090000,2,42406,10603,1,567280000,567280000,15901,5300,10601,5300,0,1,5302,21498099,21.498099
5700,3700,5300,21090000,2,42406,10603,1,567280000,567280000,15901,5300,10601,5300,0,1,5302,20770687,20.770687
5700,3700,5300,21090000,2,42406,10603,1,567280000,567280000,15901,5300,10601,5300,0,1,5302,21754498,21.754498
5700,3700,5300,21090000,2,42406,10603,1,567280000,567280000,15901,5300,10601,5300,0,1,5302,20712791,20.712791
5700,3700,5300,21090000,2,42406,10603,1,567280000,567280000,15901,5300,10601,5300,0,1,5302,21976547,21.976547
5700,3700,5700,21090000,2,45606,11403,1,597360000,597360000,17101,5700,11401,5700,0,1,5702,22502685,22.502685
5700,3700,5700,21090000,2,45606,11403,1,597360000,597360000,17101,5700,11401,5700,0,1,5702,23295313,23.295313
5700,3700,5700,21090000,2,45606,11403,1,597360000,597360000,17101,5700,11401,5700,0,1,5702,22640889,22.640889
5700,3700,5700,21090000,2,45606,11403,1,597360000,597360000,17101,5700,11401,5700,0,1,5702,23122730,23.12273
5700,3700,5700,21090000,2,45606,11403,1,597360000,597360000,17101,5700,11401,5700,0,1,5702,22399317,22.399317
5700,3700,5700,21090000,2,45606,11403,1,597360000,597360000,17101,5700,11401,5700,0,1,5702,23346713,23.346713
5700,3700,5700,21090000,2,45606,11403,1,597360000,597360000,17101,5700,11401,5700,0,1,5702,22245766,22.245766
5700,3700,5700,21090000,2,45606,11403,1,597360000,597360000,17101,5700,11401,5700,0,1,5702,23623246,23.623246
5700,3700,6100,21090000,2,48806,12203,1,627440000,627440000,18301,6100,12201,6100,0,1,6102,24044947,24.044947
5700,3700,6100,21090000,2,48806,12203,1,627440000,627440000,18301,6100,12201,6100,0,1,6102,24920759,24.920759
5700,3700,6100,21090000,2,48806,12203,1,627440000,627440000,18301,6100,12201,6100,0,1,6102,24237859,24.237859
5700,3700,6100,21090000,2,48806,12203,1,627440000,627440000,18301,6100,12201,6100,0,1,6102,24749807,24.749807
5700,3700,6100,21090000,2,48806,12203,1,627440000,627440000,18301,6100,12201,6100,0,1,6102,23925242,23.925242
5700,3700,6100,21090000,2,48806,12203,1,627440000,627440000,18301,6100,12201,6100,0,1,6102,24993557,24.993557
5700,3700,6100,21090000,2,48806,12203,1,627440000,627440000,18301,6100,12201,6100,0,1,6102,23837157,23.837157
5700,3700,6100,21090000,2,48806,12203,1,627440000,627440000,18301,6100,12201,6100,0,1,6102,25210283,25.210283
5700,3700,6500,21090000,2,52006,13003,1,657520000,657520000,19501,6500,13001,6500,0,1,6502,25600129,25.600129
5700,3700,6500,21090000,2,52006,13003,1,657520000,657520000,19501,6500,13001,6500,0,1,6502,26589289,26.589289
5700,3700,6500,21090000,2,52006,13003,1,657520000,657520000,19501,6500,13001,6500,0,1,6502,25723905,25.723905
5700,3700,6500,21090000,2,52006,13003,1,657520000,657520000,19501,6500,13001,6500,0,1,6502,26357170,26.35717
5700,3700,6500,21090000,2,52006,13003,1,657520000,657520000,19501,6500,13001,6500,0,1,6502,25487550,25.48755
5700,3700,6500,21090000,2,52006,13003,1,657520000,657520000,19501,6500,13001,6500,0,1,6502,26628853,26.628853
5700,3700,6500,21090000,2,52006,13003,1,657520000,657520000,19501,6500,13001,6500,0,1,6502,25358684,25.358684
5700,3700,6500,21090000,2,52006,13003,1,657520000,657520000,19501,6500,13001,6500,0,1,6502,26890643,26.890643
5700,3700,6900,21090000,2,55206,13803,1,687600000,687600000,20701,6900,13801,6900,0,1,6902,27206831,27.206831
5700,3700,6900,21090000,2,55206,13803,1,687600000,687600000,20701,6900,13801,6900,0,1,6902,28178359,28.178359
5700,3700,6900,21090000,2,55206,13803,1,687600000,687600000,20701,6900,13801,6900,0,1,6902,27363284,27.363284
5700,3700,6900,21090000,2,55206,13803,1,687600000,687600000,20701,6900,13801,6900,0,1,6902,27972873,27.972873
5700,3700,6900,21090000,2,55206,13803,1,687600000,687600000,20701,6900,13801,6900,0,1,6902,27056764,27.056764
5700,3700,6900,21090000,2,55206,13803,1,687600000,687600000,20701,6900,13801,6900,0,1,6902,28228057,28.228057
5700,3700,6900,21090000,2,55206,13803,1,687600000,687600000,20701,6900,13801,6900,0,1,6902,26891111,26.891111
5700,3700,6900,21090000,2,55206,13803,1,687600000,687600000,20701,6900,13801,6900,0,1,6902,28563685,28.563685
5700,3300,500,18810000,2,4006,1003,1,186480000,186480000,1501,500,1001,500,0,1,502,2054910,2.05491
5700,3300,500,18810000,2,4006,1003,1,186480000,186480000,1501,500,1001,500,0,1,502,1972377,1.972377
5700,3300,500,18810000,2,4006,1003,1,186480000,186480000,1501,500,1001,500,0,1,502,2082921,2.082921
5700,3300,500,18810000,2,4006,1003,1,186480000,186480000,1501,500,1001,500,0,1,502,2032387,2.032387
5700,3300,500,18810000,2,4006,1003,1,186480000,186480000,1501,500,1001,500,0,1,502,2069563,2.069563
5700,3300,500,18810000,2,4006,1003,1,186480000,186480000,1501,500,1001,500,0,1,502,1958519,1.958519
5700,3300,500,18810000,2,4006,1003,1,186480000,186480000,1501,500,1001,500,0,1,502,1944757,1.944757
5700,3300,500,18810000,2,4006,1003,1,186480000,186480000,1501,500,1001,500,0,1,502,1994911,1.994911
5700,3300,900,18810000,2,7206,1803,1,215280000,215280000,2701,900,1801,900,0,1,902,3277221,3.277221
5700,3300,900,18810000,2,7206,1803,1,215280000,215280000,2701,900,1801,900,0,1,902,3509325,3.509325
5700,3300,900,18810000,2,7206,1803,1,215280000,215280000,2701,900,1801,900,0,1,902,3319953,3.319953
5700,3300,900,18810000,2,7206,1803,1,215280000,215280000,2701,900,1801,900,0,1,902,3388006,3.388006
5700,3300,900,18810000,2,7206,1803,1,215280000,215280000,2701,900,1801,900,0,1,902,3263961,3.263961
5700,3300,900,18810000,2,7206,1803,1,215280000,215280000,2701,900,1801,900,0,1,902,3495682,3.495682
5700,3300,900,18810000,2,7206,1803,1,215280000,215280000,2701,900,1801,900,0,1,902,3240301,3.240301
5700,3300,900,18810000,2,7206,1803,1,215280000,215280000,2701,900,1801,900,0,1,902,3568535,3.568535
5700,3300,1300,18810000,2,10406,2603,1,244080000,244080000,3901,1300,2601,1300,0,1,1302,4693337,4.693337
5700,3300,1300,18810000,2,10406,2603,1,244080000,244080000,3901,1300,2601,1300,0,1,1302,4852201,4.852201
5700,3300,1300,18810000,2,10406,2603,1,244080000,244080000,3901,1300,2601,1300,0,1,1302,4730769,4.730769
5700,3300,1300,18810000,2,10406,2603,1,244080000,244080000,3901,1300,2601,1300,0,1,1302,4783825,4.783825
5700,3300,1300,18810000,2,10406,2603,1,244080000,244080000,3901,1300,2601,1300,0,1,1302,4655844,4.655844
5700,3300,1300,18810000,2,10406,2603,1,244080000,244080000,3901,1300,2601,1300,0,1,1302,4880241,4.880241
5700,3300,1300,18810000,2,10406,2603,1,244080000,244080000,3901,1300,2601,1300,0,1,1302,4617614,4.617614
5700,3300,1300,18810000,2,10406,2603,1,244080000,244080000,3901,1300,2601,1300,0,1,1302,4900547,4.900547
5700,3300,1700,18810000,2,13606,3403,1,272880000,272880000,5101,1700,3401,1700,0,1,1702,6041383,6.041383
5700,3300,1700,18810000,2,13606,3403,1,272880000,272880000,5101,1700,3401,1700,0,1,1702,6272372,6.272372
5700,3300,1700,18810000,2,13606,3403,1,272880000,272880000,5101,1700,3401,1700,0,1,1702,6101878,6.101878
5700,3300,1700,18810000,2,13606,3403,1,272880000,272880000,5101,1700,3401,1700,0,1,1702,6209447,6.209447
5700,3300,1700,18810000,2,13606,3403,1,272880000,272880000,5101,1700,3401,1700,0,1,1702,6022874,6.022874
5700,3300,1700,18810000,2,13606,3403,1,272880000,272880000,5101,1700,3401,1700,0,1,1702,6304018,6.304018
5700,3300,1700,18810000,2,13606,3403,1,272880000,272880000,5101,1700,3401,1700,0,1,1702,5983183,5.983183
5700,3300,1700,18810000,2,13606,3403,1,272880000,272880000,5101,1700,3401,1700,0,1,1702,6335611,6.335611
5700,3300,2100,18810000,2,16806,4203,1,301680000,301680000,6301,2100,4201,2100,0,1,2102,7603506,7.603506
5700,3300,2100,18810000,2,16806,4203,1,301680000,301680000,6301,2100,4201,2100,0,1,2102,7720013,7.720013
5700,3300,2100,18810000,2,16806,4203,1,301680000,301680000,6301,2100,4201,2100,0,1,2102,7671800,7.6718
5700,3300,2100,18810000,2,16806,4203,1,301680000,301680000,6301,2100,4201,2100,0,1,2102,7773028,7.773028
5700,3300,2100,18810000,2,16806,4203,1,301680000,301680000,6301,2100,4201,2100,0,1,2102,7616507,7.616507
5700,3300,2100,18810000,2,16806,4203,1,301680000,301680000,6301,2100,4201,2100,0,1,2102,7758515,7.758515
5700,3300,2100,18810000,2,16806,4203,1,301680000,301680000,6301,2100,4201,2100,0,1,2102,7562339,7.562339
5700,3300,2100,18810000,2,16806,4203,1,301680000,301680000,6301,2100,4201,2100,0,1,2102,7786479,7.786479
5700,3300,2500,18810000,2,20006,5003,1,330480000,330480000,7501,2500,5001,2500,0,1,2502,8828191,8.828191
5700,3300,2500,18810000,2,20006,5003,1,330480000,330480000,7501,2500,5001,2500,0,1,2502,9271320,9.27132
5700,3300,2500,18810000,2,20006,5003,1,330480000,330480000,7501,2500,5001,2500,0,1,2502,8915848,8.915848
5700,3300,2500,18810000,2,20006,5003,1,330480000,330480000,7501,2500,5001,2500,0,1,2502,9076519,9.076519
5700,3300,2500,18810000,2,20006,5003,1,330480000,330480000,7501,2500,5001,2500,0,1,2502,8743224,8.743224
5700,3300,2500,18810000,2,20006,5003,1,330480000,330480000,7501,2500,5001,2500,0,1,2502,9293967,9.293967
5700,3300,2500,18810000,2,20006,5003,1,330480000,330480000,7501,2500,5001,2500,0,1,2502,8724729,8.724729
5700,3300,2500,18810000,2,20006,5003,1,330480000,330480000,7501,2500,5001,2500,0,1,2502,9373305,9.373305
5700,3300,2900,18810000,2,23206,5803,1,359280000,359280000,8701,2900,5801,2900,0,1,2902,10339355,10.339355
5700,3300,2900,18810000,2,23206,5803,1,359280000,359280000,8701,2900,5801,2900,0,1,2902,10596039,10.596039
5700,3300,2900,18810000,2,23206,5803,1,359280000,359280000,8701,2900,5801,2900,0,1,2902,10460720,10.46072
5700,3300,2900,18810000,2,23206,5803,1,359280000,359280000,8701,2900,5801,2900,0,1,2902,10582114,10.582114
5700,3300,2900,18810000,2,23206,5803,1,359280000,359280000,8701,2900,5801,2900,0,1,2902,10300434,10.300434
5700,3300,2900,18810000,2,23206,5803,1,359280000,359280000,8701,2900,5801,2900,0,1,2902,10636081,10.636081
5700,3300,2900,18810000,2,23206,5803,1,359280000,359280000,8701,2900,5801,2900,0,1,2902,10281059,10.281059
5700,3300,2900,18810000,2,23206,5803,1,359280000,359280000,8701,2900,5801,2900,0,1,2902,10695694,10.695694
5700,3300,3300,18810000,2,26406,6603,1,388080000,388080000,9901,3300,6601,3300,0,1,3302,11586583,11.586583
5700,3300,3300,18810000,2,26406,6603,1,388080000,388080000,9901,3300,6601,3300,0,1,3302,12090829,12.090829
5700,3300,3300,18810000,2,26406,6603,1,388080000,388080000,9901,3300,6601,3300,0,1,3302,11685925,11.685925
5700,3300,3300,18810000,2,26406,6603,1,388080000,388080000,9901,3300,6601,3300,0,1,3302,11911204,11.911204
5700,3300,3300,18810000,2,26406,6603,1,388080000,388080000,9901,3300,6601,3300,0,1,3302,11512230,11.51223
5700,3300,3300,18810000,2,26406,6603,1,388080000,388080000,9901,3300,6601,3300,0,1,3302,12213327,12.213327
5700,3300,3300,18810000,2,26406,6603,1,388080000,388080000,9901,3300,6601,3300,0,1,3302,11450867,11.450867
5700,3300,3300,18810000,2,26406,6603,1,388080000,388080000,9901,3300,6601,3300,0,1,3302,12255085,12.255085
5700,3300,3700,18810000,2,29606,7403,1,416880000,416880000,11101,3700,7401,3700,0,1,3702,13093958,13.093958
5700,3300,3700,18810000,2,29606,7403,1,416880000,416880000,11101,3700,7401,3700,0,1,3702,13603840,13.60384
5700,3300,3700,18810000,2,29606,7403,1,416880000,416880000,11101,3700,7401,3700,0,1,3702,13249092,13.249092
5700,3300,3700,18810000,2,29606,7403,1,416880000,416880000,11101,3700,7401,3700,0,1,3702,13422085,13.422085
5700,3300,3700,18810000,2,29606,7403,1,416880000,416880000,11101,3700,7401,3700,0,1,3702,13052382,13.052382
5700,3300,3700,18810000,2,29606,7403,1,416880000,416880000,11101,3700,7401,3700,0,1,3702,13656398,13.656398
5700,3300,3700,18810000,2,29606,7403,1,416880000,416880000,11101,3700,7401,3700,0,1,3702,12979851,12.979851
5700,3300,3700,18810000,2,29606,7403,1,416880000,416880000,11101,3700,7401,3700,0,1,3702,13697835,13.697835
5700,3300,4100,18810000,2,32806,8203,1,445680000,445680000,12301,4100,8201,4100,0,1,4102,14518727,14.518727
5700,3300,4100,18810000,2,32806,8203,1,445680000,445680000,12301,4100,8201,4100,0,1,4102,15037615,15.037615
5700,3300,4100,18810000,2,32806,8203,1,445680000,445680000,12301,4100,8201,4100,0,1,4102,14585786,14.585786
5700,3300,4100,18810000,2,32806,8203,1,445680000,445680000,12301,4100,8201,4100,0,1,4102,14895424,14.895424
5700,3300,4100,18810000,2,32806,8203,1,445680000,445680000,12301,4100,8201,4100,0,1,4102,14401477,14.401477
5700,3300,4100,18810000,2,32806,8203,1,445680000,445680000,12301,4100,8201,4100,0,1,4102,15087730,15.08773
5700,3300,4100,18810000,2,32806,8203,1,445680000,445680000,12301,4100,8201,4100,0,1,4102,14356308,14.356308
5700,3300,4100,18810000,2,32806,8203,1,445680000,445680000,12301,4100,8201,4100,0,1,4102,15208904,15.208904
5700,3300,4500,18810000,2,36006,9003,1,474480000,474480000,13501,4500,9001,4500,0,1,4502,15890594,15.890594
5700,3300,4500,18810000,2,36006,9003,1,474480000,474480000,13501,4500,9001,4500,0,1,4502,16443921,16.443921
5700,3300,4500,18810000,2,36006,9003,1,474480000,474480000,13501,4500,9001,4500,0,1,4502,15976001,15.976001
5700,3300,4500,18810000,2,36006,9003,1,474480000,474480000,13501,4500,9001,4500,0,1,4502,16319948,16.319948
5700,3300,4500,18810000,2,36006,9003,1,474480000,474480000,13501,4500,9001,4500,0,1,4502,15843170,15.84317
5700,3300,4500,18810000,2,36006,9003,1,474480000,474480000,13501,4500,9001,4500,0,1,4502,16490335,16.490335
5700,3300,4500,18810000,2,36006,9003,1,474480000,474480000,13501,4500,9001,4500,0,1,4502,15704337,15.704337
5700,3300,4500,18810000,2,36006,9003,1,474480000,474480000,13501,4500,9001,4500,0,1,4502,16648094,16.648094
5700,3300,4900,18810000,2,39206,9803,1,503280000,503280000,14701,4900,9801,4900,0,1,4902,17285839,17.285839
5700,3300,4900,18810000,2,39206,9803,1,503280000,503280000,14701,4900,9801,4900,0,1,4902,17917687,17.917687
5700,3300,4900,18810000,2,39206,9803,1,503280000,503280000,14701,4900,9801,4900,0,1,4902,17389261,17.389261
5700,3300,4900,18810000,2,39206,9803,1,503280000,503280000,14701,4900,9801,4900,0,1,4902,17745125,17.745125
5700,3300,4900,18810000,2,39206,9803,1,503280000,503280000,14701,4900,9801,4900,0,1,4902,17212541,17.212541
5700,3300,4900,18810000,2,39206,9803,1,503280000,503280000,14701,4900,9801,4900,0,1,4902,17954440,17.95444
5700,3300,4900,18810000,2,39206,9803,1,503280000,503280000,14701,4900,9801,4900,0,1,4902,17139128,17.139128
5700,3300,4900,18810000,2,39206,9803,1,503280000,503280000,14701,4900,9801,4900,0,1,4902,18100241,18.100241
5700,3300,5300,18810000,2,42406,10603,1,532080000,532080000,15901,5300,10601,5300,0,1,5302,18681286,18.681286
5700,3300,5300,18810000,2,42406,10603,1,532080000,532080000,15901,5300,10601,5300,0,1,5302,19335933,19.335933
5700,3300,5300,18810000,2,42406,10603,1,532080000,532080000,15901,5300,10601,5300,0,1,5302,18770385,18.770385
5700,3300,5300,18810000,2,42406,10603,1,532080000,532080000,15901,5300,10601,5300,0,1,5302,19167474,19.167474
5700,3300,5300,18810000,2,42406,10603,1,532080000,532080000,15901,5300,10601,5300,0,1,5302,18598683,18.598683
5700,3300,5300,18810000,2,42406,10603,1,532080000,532080000,15901,5300,10601,5300,0,1,5302,19418711,19.418711
5700,3300,5300,18810000,2,42406,10603,1,532080000,532080000,15901,5300,10601,5300,0,1,5302,18507551,18.507551
5700,3300,5300,18810000,2,42406,10603,1,532080000,532080000,15901,5300,10601,5300,0,1,5302,19564998,19.564998
5700,3300,5700,18810000,2,45606,11403,1,560880000,560880000,17101,5700,11401,5700,0,1,5702,20060011,20.060011
5700,3300,5700,18810000,2,45606,11403,1,560880000,560880000,17101,5700,11401,5700,0,1,5702,20818976,20.818976
5700,3300,5700,18810000,2,45606,11403,1,560880000,560880000,17101,5700,11401,5700,0,1,5702,20204603,20.204603
5700,3300,5700,18810000,2,45606,11403,1,560880000,560880000,17101,5700,11401,5700,0,1,5702,20590276,20.590276
5700,3300,5700,18810000,2,45606,11403,1,560880000,560880000,17101,5700,11401,5700,0,1,5702,19978614,19.978614
5700,3300,5700,18810000,2,45606,11403,1,560880000,560880000,17101,5700,11401,5700,0,1,5702,20877696,20.877696
5700,3300,5700,18810000,2,45606,11403,1,560880000,560880000,17101,5700,11401,5700,0,1,5702,19880509,19.880509
5700,3300,5700,18810000,2,45606,11403,1,560880000,560880000,17101,5700,11401,5700,0,1,5702,21023489,21.023489
5700,3300,6100,18810000,2,48806,12203,1,589680000,589680000,18301,6100,12201,6100,0,1,6102,21438904,21.438904
5700,3300,6100,18810000,2,48806,12203,1,589680000,589680000,18301,6100,12201,6100,0,1,6102,22261139,22.261139
5700,3300,6100,18810000,2,48806,12203,1,589680000,589680000,18301,6100,12201,6100,0,1,6102,21647370,21.64737
5700,3300,6100,18810000,2,48806,12203,1,589680000,589680000,18301,6100,12201,6100,0,1,6102,22031388,22.031388
5700,3300,6100,18810000,2,48806,12203,1,589680000,589680000,18301,6100,12201,6100,0,1,6102,21370259,21.370259
5700,3300,6100,18810000,2,48806,12203,1,589680000,589680000,18301,6100,12201,6100,0,1,6102,22288746,22.288746
5700,3300,6100,18810000,2,48806,12203,1,589680000,589680000,18301,6100,12201,6100,0,1,6102,21251207,21.251207
5700,3300,6100,18810000,2,48806,12203,1,589680000,589680000,18301,6100,12201,6100,0,1,6102,22521439,22.521439
5700,3300,6500,18810000,2,52006,13003,1,618480000,618480000,19501,6500,13001,6500,0,1,6502,22859807,22.859807
5700,3300,6500,18810000,2,52006,13003,1,618480000,618480000,19501,6500,13001,6500,0,1,6502,23664905,23.664905
5700,3300,6500,18810000,2,52006,13003,1,618480000,618480000,19501,6500,13001,6500,0,1,6502,22971463,22.971463
5700,3300,6500,18810000,2,52006,13003,1,618480000,618480000,19501,6500,13001,6500,0,1,6502,23467949,23.467949
5700,3300,6500,18810000,2,52006,13003,1,618480000,618480000,19501,6500,13001,6500,0,1,6502,22790866,22.790866
5700,3300,6500,18810000,2,52006,13003,1,618480000,618480000,19501,6500,13001,6500,0,1,6502,23727558,23.727558
5700,3300,6500,18810000,2,52006,13003,1,618480000,618480000,19501,6500,13001,6500,0,1,6502,22645550,22.64555
5700,3300,6500,18810000,2,52006,13003,1,618480000,618480000,19501,6500,13001,6500,0,1,6502,23991685,23.991685
5700,3300,6900,18810000,2,55206,13803,1,647280000,647280000,20701,6900,13801,6900,0,1,6902,24285603,24.285603
5700,3300,6900,18810000,2,55206,13803,1,647280000,647280000,20701,6900,13801,6900,0,1,6902,25180467,25.180467
5700,3300,6900,18810000,2,55206,13803,1,647280000,647280000,20701,6900,13801,6900,0,1,6902,24418500,24.4185
5700,3300,6900,18810000,2,55206,13803,1,647280000,647280000,20701,6900,13801,6900,0,1,6902,24939367,24.939367
5700,3300,6900,18810000,2,55206,13803,1,647280000,647280000,20701,6900,13801,6900,0,1,6902,24137369,24.137369
5700,3300,6900,18810000,2,55206,13803,1,647280000,647280000,20701,6900,13801,6900,0,1,6902,25219492,25.219492
5700,3300,6900,18810000,2,55206,13803,1,647280000,647280000,20701,6900,13801,6900,0,1,6902,24010245,24.010245
5700,3300,6900,18810000,2,55206,13803,1,647280000,647280000,20701,6900,13801,6900,0,1,6902,25477113,25.477113
5700,2900,500,16530000,2,4006,1003,1,166640000,166640000,1501,500,1001,500,0,1,502,1772465,1.772465
5700,2900,500,16530000,2,4006,1003,1,166640000,166640000,1501,500,1001,500,0,1,502,1734899,1.734899
5700,2900,500,16530000,2,4006,1003,1,166640000,166640000,1501,500,1001,500,0,1,502,1746725,1.746725
5700,2900,500,16530000,2,4006,1003,1,166640000,166640000,1501,500,1001,500,0,1,502,1723190,1.72319
5700,2900,500,16530000,2,4006,1003,1,166640000,166640000,1501,500,1001,500,0,1,502,1852100,1.8521
5700,2900,500,16530000,2,4006,1003,1,166640000,166640000,1501,500,1001,500,0,1,502,1760822,1.760822
5700,2900,500,16530000,2,4006,1003,1,166640000,166640000,1501,500,1001,500,0,1,502,1840451,1.840451
5700,2900,500,16530000,2,4006,1003,1,166640000,166640000,1501,500,1001,500,0,1,502,1784689,1.784689
5700,2900,900,16530000,2,7206,1803,1,194160000,194160000,2701,900,1801,900,0,1,902,2889449,2.889449
5700,2900,900,16530000,2,7206,1803,1,194160000,194160000,2701,900,1801,900,0,1,902,3116332,3.116332
5700,2900,900,16530000,2,7206,1803,1,194160000,194160000,2701,900,1801,900,0,1,902,2905877,2.905877
5700,2900,900,16530000,2,7206,1803,1,194160000,194160000,2701,900,1801,900,0,1,902,3104245,3.104245
5700,2900,900,16530000,2,7206,1803,1,194160000,194160000,2701,900,1801,900,0,1,902,2867590,2.86759
5700,2900,900,16530000,2,7206,1803,1,194160000,194160000,2701,900,1801,900,0,1,902,3128481,3.128481
5700,2900,900,16530000,2,7206,1803,1,194160000,194160000,2701,900,1801,900,0,1,902,2853821,2.853821
5700,2900,900,16530000,2,7206,1803,1,194160000,194160000,2701,900,1801,900,0,1,902,3140467,3.140467
5700,2900,1300,16530000,2,10406,2603,1,221680000,221680000,3901,1300,2601,1300,0,1,1302,4097360,4.09736
5700,2900,1300,16530000,2,10406,2603,1,221680000,221680000,3901,1300,2601,1300,0,1,1302,4250662,4.250662
5700,2900,1300,16530000,2,10406,2603,1,221680000,221680000,3901,1300,2601,1300,0,1,1302,4154110,4.15411
5700,2900,1300,16530000,2,10406,2603,1,221680000,221680000,3901,1300,2601,1300,0,1,1302,4206331,4.206331
5700,2900,1300,16530000,2,10406,2603,1,221680000,221680000,3901,1300,2601,1300,0,1,1302,4080644,4.080644
5700,2900,1300,16530000,2,10406,2603,1,221680000,221680000,3901,1300,2601,1300,0,1,1302,4262727,4.262727
5700,2900,1300,16530000,2,10406,2603,1,221680000,221680000,3901,1300,2601,1300,0,1,1302,4060769,4.060769
5700,2900,1300,16530000,2,10406,2603,1,221680000,221680000,3901,1300,2601,1300,0,1,1302,4319893,4.319893
5700,2900,1700,16530000,2,13606,3403,1,249200000,249200000,5101,1700,3401,1700,0,1,1702,5327497,5.327497
5700,2900,1700,16530000,2,13606,3403,1,249200000,249200000,5101,1700,3401,1700,0,1,1702,5522174,5.522174
5700,2900,1700,16530000,2,13606,3403,1,249200000,249200000,5101,1700,3401,1700,0,1,1702,5394242,5.394242
5700,2900,1700,16530000,2,13606,3403,1,249200000,249200000,5101,1700,3401,1700,0,1,1702,5471801,5.471801
5700,2900,1700,16530000,2,13606,3403,1,249200000,249200000,5101,1700,3401,1700,0,1,1702,5338845,5.338845
5700,2900,1700,16530000,2,13606,3403,1,249200000,249200000,5101,1700,3401,1700,0,1,1702,5534216,5.534216
5700,2900,1700,16530000,2,13606,3403,1,249200000,249200000,5101,1700,3401,1700,0,1,1702,5271383,5.271383
5700,2900,1700,16530000,2,13606,3403,1,249200000,249200000,5101,1700,3401,1700,0,1,1702,5587721,5.587721
5700,2900,2100,16530000,2,16806,4203,1,276720000,276720000,6301,2100,4201,2100,0,1,2102,6534132,6.534132
5700,2900,2100,16530000,2,16806,4203,1,276720000,276720000,6301,2100,4201,2100,0,1,2102,6779791,6.779791
5700,2900,2100,16530000,2,16806,4203,1,276720000,276720000,6301,2100,4201,2100,0,1,2102,6597197,6.597197
5700,2900,2100,16530000,2,16806,4203,1,276720000,276720000,6301,2100,4201,2100,0,1,2102,6713638,6.713638
5700,2900,2100,16530000,2,16806,4203,1,276720000,276720000,6301,2100,4201,2100,0,1,2102,6500271,6.500271
5700,2900,2100,16530000,2,16806,4203,1,276720000,276720000,6301,2100,4201,2100,0,1,2102,6791815,6.791815
5700,2900,2100,16530000,2,16806,4203,1,276720000,276720000,6301,2100,4201,2100,0,1,2102,6469707,6.469707
5700,2900,2100,16530000,2,16806,4203,1,276720000,276720000,6301,2100,4201,2100,0,1,2102,6866838,6.866838
5700,2900,2500,16530000,2,20006,5003,1,304240000,304240000,7501,2500,5001,2500,0,1,2502,7873793,7.873793
5700,2900,2500,16530000,2,20006,5003,1,304240000,304240000,7501,2500,5001,2500,0,1,2502,8194768,8.194768
5700,2900,2500,16530000,2,20006,5003,1,304240000,304240000,7501,2500,5001,2500,0,1,2502,7987612,7.987612
5700,2900,2500,16530000,2,20006,5003,1,304240000,304240000,7501,2500,5001,2500,0,1,2502,8061701,8.061701
5700,2900,2500,16530000,2,20006,5003,1,304240000,304240000,7501,2500,5001,2500,0,1,2502,7885231,7.885231
5700,2900,2500,16530000,2,20006,5003,1,304240000,304240000,7501,2500,5001,2500,0,1,2502,8177508,8.177508
5700,2900,2500,16530000,2,20006,5003,1,304240000,304240000,7501,2500,5001,2500,0,1,2502,7836089,7.836089
5700,2900,2500,16530000,2,20006,5003,1,304240000,304240000,7501,2500,5001,2500,0,1,2502,8244770,8.24477
5700,2900,2900,16530000,2,23206,5803,1,331760000,331760000,8701,2900,5801,2900,0,1,2902,8970594,8.970594
5700,2900,2900,16530000,2,23206,5803,1,331760000,331760000,8701,2900,5801,2900,0,1,2902,9323219,9.323219
5700,2900,2900,16530000,2,23206,5803,1,331760000,331760000,8701,2900,5801,2900,0,1,2902,9051433,9.051433
5700,2900,2900,16530000,2,23206,5803,1,331760000,331760000,8701,2900,5801,2900,0,1,2902,9212208,9.212208
5700,2900,2900,16530000,2,23206,5803,1,331760000,331760000,8701,2900,5801,2900,0,1,2902,8919001,8.919001
5700,2900,2900,16530000,2,23206,5803,1,331760000,331760000,8701,2900,5801,2900,0,1,2902,9335213,9.335213
5700,2900,2900,16530000,2,23206,5803,1,331760000,331760000,8701,2900,5801,2900,0,1,2902,8864547,8.864547
5700,2900,2900,16530000,2,23206,5803,1,331760000,331760000,8701,2900,5801,2900,0,1,2902,9432589,9.432589
5700,2900,3300,16530000,2,26406,6603,1,359280000,359280000,9901,3300,6601,3300,0,1,3302,10308752,10.308752
5700,2900,3300,16530000,2,26406,6603,1,359280000,359280000,9901,3300,6601,3300,0,1,3302,10705587,10.705587
5700,2900,3300,16530000,2,26406,6603,1,359280000,359280000,9901,3300,6601,3300,0,1,3302,10453751,10.453751
5700,2900,3300,16530000,2,26406,6603,1,359280000,359280000,9901,3300,6601,3300,0,1,3302,10563033,10.563033
5700,2900,3300,16530000,2,26406,6603,1,359280000,359280000,9901,3300,6601,3300,0,1,3302,10290603,10.290603
5700,2900,3300,16530000,2,26406,6603,1,359280000,359280000,9901,3300,6601,3300,0,1,3302,10724441,10.724441
5700,2900,3300,16530000,2,26406,6603,1,359280000,359280000,9901,3300,6601,3300,0,1,3302,10251809,10.251809
5700,2900,3300,16530000,2,26406,6603,1,359280000,359280000,9901,3300,6601,3300,0,1,3302,10804227,10.804227
5700,2900,3700,16530000,2,29606,7403,1,386800000,386800000,11101,3700,7401,3700,0,1,3702,11555372,11.555372
5700,2900,3700,16530000,2,29606,7403,1,386800000,386800000,11101,3700,7401,3700,0,1,3702,11960196,11.960196
5700,2900,3700,16530000,2,29606,7403,1,386800000,386800000,11101,3700,7401,3700,0,1,3702,11652960,11.65296
5700,2900,3700,16530000,2,29606,7403,1,386800000,386800000,11101,3700,7401,3700,0,1,3702,11844453,11.844453
5700,2900,3700,16530000,2,29606,7403,1,386800000,386800000,11101,3700,7401,3700,0,1,3702,11529668,11.529668
5700,2900,3700,16530000,2,29606,7403,1,386800000,386800000,11101,3700,7401,3700,0,1,3702,11972560,11.97256
5700,2900,3700,16530000,2,29606,7403,1,386800000,386800000,11101,3700,7401,3700,0,1,3702,11463874,11.463874
5700,2900,3700,16530000,2,29606,7403,1,386800000,386800000,11101,3700,7401,3700,0,1,3702,12118116,12.118116
5700,2900,4100,16530000,2,32806,8203,1,414320000,414320000,12301,4100,8201,4100,0,1,4102,12630371,12.630371
5700,2900,4100,16530000,2,32806,8203,1,414320000,414320000,12301,4100,8201,4100,0,1,4102,13145655,13.145655
5700,2900,4100,16530000,2,32806,8203,1,414320000,414320000,12301,4100,8201,4100,0,1,4102,12731246,12.731246
5700,2900,4100,16530000,2,32806,8203,1,414320000,414320000,12301,4100,8201,4100,0,1,4102,12982356,12.982356
5700,2900,4100,16530000,2,32806,8203,1,414320000,414320000,12301,4100,8201,4100,0,1,4102,12550802,12.550802
5700,2900,4100,16530000,2,32806,8203,1,414320000,414320000,12301,4100,8201,4100,0,1,4102,13133554,13.133554
5700,2900,4100,16530000,2,32806,8203,1,414320000,414320000,12301,4100,8201,4100,0,1,4102,12503171,12.503171
5700,2900,4100,16530000,2,32806,8203,1,414320000,414320000,12301,4100,8201,4100,0,1,4102,13286791,13.286791
5700,2900,4500,16530000,2,36006,9003,1,441840000,441840000,13501,4500,9001,4500,0,1,4502,13988923,13.988923
5700,2900,4500,16530000,2,36006,9003,1,441840000,441840000,13501,4500,9001,4500,0,1,4502,14495410,14.49541
5700,2900,4500,16530000,2,36006,9003,1,441840000,441840000,13501,4500,9001,4500,0,1,4502,14073692,14.073692
5700,2900,4500,16530000,2,36006,9003,1,441840000,441840000,13501,4500,9001,4500,0,1,4502,14343685,14.343685
5700,2900,4500,16530000,2,36006,9003,1,441840000,441840000,13501,4500,9001,4500,0,1,4502,13944927,13.944927
5700,2900,4500,16530000,2,36006,9003,1,441840000,441840000,13501,4500,9001,4500,0,1,4502,14507482,14.507482
5700,2900,4500,16530000,2,36006,9003,1,441840000,441840000,13501,4500,9001,4500,0,1,4502,13859784,13.859784
5700,2900,4500,16530000,2,36006,9003,1,441840000,441840000,13501,4500,9001,4500,0,1,4502,14680165,14.680165
5700,2900,4900,16530000,2,39206,9803,1,469360000,469360000,14701,4900,9801,4900,0,1,4902,15201335,15.201335
5700,2900,4900,16530000,2,39206,9803,1,469360000,469360000,14701,4900,9801,4900,0,1,4902,15738517,15.738517
5700,2900,4900,16530000,2,39206,9803,1,469360000,469360000,14701,4900,9801,4900,0,1,4902,15293657,15.293657
5700,2900,4900,16530000,2,39206,9803,1,469360000,469360000,14701,4900,9801,4900,0,1,4902,15622955,15.622955
5700,2900,4900,16530000,2,39206,9803,1,469360000,469360000,14701,4900,9801,4900,0,1,4902,15163158,15.163158
5700,2900,4900,16530000,2,39206,9803,1,469360000,469360000,14701,4900,9801,4900,0,1,4902,15769807,15.769807
5700,2900,4900,16530000,2,39206,9803,1,469360000,469360000,14701,4900,9801,4900,0,1,4902,15069163,15.069163
5700,2900,4900,16530000,2,39206,9803,1,469360000,469360000,14701,4900,9801,4900,0,1,4902,15959794,15.959794
5700,2900,5300,16530000,2,42406,10603,1,496880000,496880000,15901,5300,10601,5300,0,1,5302,16420176,16.420176
5700,2900,5300,16530000,2,42406,10603,1,496880000,496880000,15901,5300,10601,5300,0,1,5302,17039387,17.039387
5700,2900,5300,16530000,2,42406,10603,1,496880000,496880000,15901,5300,10601,5300,0,1,5302,16563799,16.563799
5700,2900,5300,16530000,2,42406,10603,1,496880000,496880000,15901,5300,10601,5300,0,1,5302,16881959,16.881959
5700,2900,5300,16530000,2,42406,10603,1,496880000,496880000,15901,5300,10601,5300,0,1,5302,16380509,16.380509
5700,2900,5300,16530000,2,42406,10603,1,496880000,496880000,15901,5300,10601,5300,0,1,5302,17051345,17.051345
5700,2900,5300,16530000,2,42406,10603,1,496880000,496880000,15901,5300,10601,5300,0,1,5302,16297542,16.297542
5700,2900,5300,16530000,2,42406,10603,1,496880000,496880000,15901,5300,10601,5300,0,1,5302,17240180,17.24018
5700,2900,5700,16530000,2,45606,11403,1,524400000,524400000,17101,5700,11401,5700,0,1,5702,17667283,17.667283
5700,2900,5700,16530000,2,45606,11403,1,524400000,524400000,17101,5700,11401,5700,0,1,5702,18263450,18.26345
5700,2900,5700,16530000,2,45606,11403,1,524400000,524400000,17101,5700,11401,5700,0,1,5702,17779800,17.7798
5700,2900,5700,16530000,2,45606,11403,1,524400000,524400000,17101,5700,11401,5700,0,1,5702,18151205,18.151205
5700,2900,5700,16530000,2,45606,11403,1,524400000,524400000,17101,5700,11401,5700,0,1,5702,17594893,17.594893
5700,2900,5700,16530000,2,45606,11403,1,524400000,524400000,17101,5700,11401,5700,0,1,5702,18407184,18.407184
5700,2900,5700,16530000,2,45606,11403,1,524400000,524400000,17101,5700,11401,5700,0,1,5702,17521508,17.521508
5700,2900,5700,16530000,2,45606,11403,1,524400000,524400000,17101,5700,11401,5700,0,1,5702,18531264,18.531264
5700,2900,6100,16530000,2,48806,12203,1,551920000,551920000,18301,6100,12201,6100,0,1,6102,18880864,18.880864
5700,2900,6100,16530000,2,48806,12203,1,551920000,551920000,18301,6100,12201,6100,0,1,6102,19564113,19.564113
5700,2900,6100,16530000,2,48806,12203,1,551920000,551920000,18301,6100,12201,6100,0,1,6102,19063835,19.063835
5700,2900,6100,16530000,2,48806,12203,1,551920000,551920000,18301,6100,12201,6100,0,1,6102,19423476,19.423476
5700,2900,6100,16530000,2,48806,12203,1,551920000,551920000,18301,6100,12201,6100,0,1,6102,18836769,18.836769
5700,2900,6100,16530000,2,48806,12203,1,551920000,551920000,18301,6100,12201,6100,0,1,6102,19599006,19.599006
5700,2900,6100,16530000,2,48806,12203,1,551920000,551920000,18301,6100,12201,6100,0,1,6102,18711164,18.711164
5700,2900,6100,16530000,2,48806,12203,1,551920000,551920000,18301,6100,12201,6100,0,1,6102,19829807,19.829807
5700,2900,6500,16530000,2,52006,13003,1,579440000,579440000,19501,6500,13001,6500,0,1,6502,20119607,20.119607
5700,2900,6500,16530000,2,52006,13003,1,579440000,579440000,19501,6500,13001,6500,0,1,6502,20853228,20.853228
5700,2900,6500,16530000,2,52006,13003,1,579440000,579440000,19501,6500,13001,6500,0,1,6502,20222291,20.222291
5700,2900,6500,16530000,2,52006,13003,1,579440000,579440000,19501,6500,13001,6500,0,1,6502,20669210,20.66921
5700,2900,6500,16530000,2,52006,13003,1,579440000,579440000,19501,6500,13001,6500,0,1,6502,19975283,19.975283
5700,2900,6500,16530000,2,52006,13003,1,579440000,579440000,19501,6500,13001,6500,0,1,6502,20896487,20.896487
5700,2900,6500,16530000,2,52006,13003,1,579440000,579440000,19501,6500,13001,6500,0,1,6502,19949781,19.949781
5700,2900,6500,16530000,2,52006,13003,1,579440000,579440000,19501,6500,13001,6500,0,1,6502,21124784,21.124784
5700,2900,6900,16530000,2,55206,13803,1,606960000,606960000,20701,6900,13801,6900,0,1,6902,21344186,21.344186
5700,2900,6900,16530000,2,55206,13803,1,606960000,606960000,20701,6900,13801,6900,0,1,6902,22108806,22.108806
5700,2900,6900,16530000,2,55206,13803,1,606960000,606960000,20701,6900,13801,6900,0,1,6902,21469142,21.469142
5700,2900,6900,16530000,2,55206,13803,1,606960000,606960000,20701,6900,13801,6900,0,1,6902,21940185,21.940185
5700,2900,6900,16530000,2,55206,13803,1,606960000,606960000,20701,6900,13801,6900,0,1,6902,21227149,21.227149
5700,2900,6900,16530000,2,55206,13803,1,606960000,606960000,20701,6900,13801,6900,0,1,6902,22157413,22.157413
5700,2900,6900,16530000,2,55206,13803,1,606960000,606960000,20701,6900,13801,6900,0,1,6902,21140274,21.140274
5700,2900,6900,16530000,2,55206,13803,1,606960000,606960000,20701,6900,13801,6900,0,1,6902,22412503,22.412503
5700,2500,500,14250000,2,4006,1003,1,146800000,146800000,1501,500,1001,500,0,1,502,1578903,1.578903
5700,2500,500,14250000,2,4006,1003,1,146800000,146800000,1501,500,1001,500,0,1,502,1506423,1.506423
5700,2500,500,14250000,2,4006,1003,1,146800000,146800000,1501,500,1001,500,0,1,502,1535061,1.535061
5700,2500,500,14250000,2,4006,1003,1,146800000,146800000,1501,500,1001,500,0,1,502,1494959,1.494959
5700,2500,500,14250000,2,4006,1003,1,146800000,146800000,1501,500,1001,500,0,1,502,1632590,1.63259
5700,2500,500,14250000,2,4006,1003,1,146800000,146800000,1501,500,1001,500,0,1,502,1484525,1.484525
5700,2500,500,14250000,2,4006,1003,1,146800000,146800000,1501,500,1001,500,0,1,502,1596592,1.596592
5700,2500,500,14250000,2,4006,1003,1,146800000,146800000,1501,500,1001,500,0,1,502,1524873,1.524873
5700,2500,900,14250000,2,7206,1803,1,173040000,173040000,2701,900,1801,900,0,1,902,2499089,2.499089
5700,2500,900,14250000,2,7206,1803,1,173040000,173040000,2701,900,1801,900,0,1,902,2726922,2.726922
5700,2500,900,14250000,2,7206,1803,1,173040000,173040000,2701,900,1801,900,0,1,902,2520612,2.520612
5700,2500,900,14250000,2,7206,1803,1,173040000,173040000,2701,900,1801,900,0,1,902,2666862,2.666862
5700,2500,900,14250000,2,7206,1803,1,173040000,173040000,2701,900,1801,900,0,1,902,2489035,2.489035
5700,2500,900,14250000,2,7206,1803,1,173040000,173040000,2701,900,1801,900,0,1,902,2716501,2.716501
5700,2500,900,14250000,2,7206,1803,1,173040000,173040000,2701,900,1801,900,0,1,902,2508981,2.508981
5700,2500,900,14250000,2,7206,1803,1,173040000,173040000,2701,900,1801,900,0,1,902,2690366,2.690366
5700,2500,1300,14250000,2,10406,2603,1,199280000,199280000,3901,1300,2601,1300,0,1,1302,3537335,3.537335
5700,2500,1300,14250000,2,10406,2603,1,199280000,199280000,3901,1300,2601,1300,0,1,1302,3676707,3.676707
5700,2500,1300,14250000,2,10406,2603,1,199280000,199280000,3901,1300,2601,1300,0,1,1302,3575807,3.575807
5700,2500,1300,14250000,2,10406,2603,1,199280000,199280000,3901,1300,2601,1300,0,1,1302,3638500,3.6385
5700,2500,1300,14250000,2,10406,2603,1,199280000,199280000,3901,1300,2601,1300,0,1,1302,3525084,3.525084
5700,2500,1300,14250000,2,10406,2603,1,199280000,199280000,3901,1300,2601,1300,0,1,1302,3687165,3.687165
5700,2500,1300,14250000,2,10406,2603,1,199280000,199280000,3901,1300,2601,1300,0,1,1302,3498994,3.498994
5700,2500,1300,14250000,2,10406,2603,1,199280000,199280000,3901,1300,2601,1300,0,1,1302,3719351,3.719351
5700,2500,1700,14250000,2,13606,3403,1,225520000,225520000,5101,1700,3401,1700,0,1,1702,4587519,4.587519
5700,2500,1700,14250000,2,13606,3403,1,225520000,225520000,5101,1700,3401,1700,0,1,1702,4758032,4.758032
5700,2500,1700,14250000,2,13606,3403,1,225520000,225520000,5101,1700,3401,1700,0,1,1702,4637256,4.637256
5700,2500,1700,14250000,2,13606,3403,1,225520000,225520000,5101,1700,3401,1700,0,1,1702,4732508,4.732508
5700,2500,1700,14250000,2,13606,3403,1,225520000,225520000,5101,1700,3401,1700,0,1,1702,4568064,4.568064
5700,2500,1700,14250000,2,13606,3403,1,225520000,225520000,5101,1700,3401,1700,0,1,1702,4768448,4.768448
5700,2500,1700,14250000,2,13606,3403,1,225520000,225520000,5101,1700,3401,1700,0,1,1702,4542700,4.5427
5700,2500,1700,14250000,2,13606,3403,1,225520000,225520000,5101,1700,3401,1700,0,1,1702,4825090,4.82509
5700,2500,2100,14250000,2,16806,4203,1,251760000,251760000,6301,2100,4201,2100,0,1,2102,5638376,5.638376
5700,2500,2100,14250000,2,16806,4203,1,251760000,251760000,6301,2100,4201,2100,0,1,2102,5848247,5.848247
5700,2500,2100,14250000,2,16806,4203,1,251760000,251760000,6301,2100,4201,2100,0,1,2102,5696936,5.696936
5700,2500,2100,14250000,2,16806,4203,1,251760000,251760000,6301,2100,4201,2100,0,1,2102,5798668,5.798668
5700,2500,2100,14250000,2,16806,4203,1,251760000,251760000,6301,2100,4201,2100,0,1,2102,5610057,5.610057
5700,2500,2100,14250000,2,16806,4203,1,251760000,251760000,6301,2100,4201,2100,0,1,2102,5858312,5.858312
5700,2500,2100,14250000,2,16806,4203,1,251760000,251760000,6301,2100,4201,2100,0,1,2102,5585396,5.585396
5700,2500,2100,14250000,2,16806,4203,1,251760000,251760000,6301,2100,4201,2100,0,1,2102,5928598,5.928598
5700,2500,2500,14250000,2,20006,5003,1,278000000,278000000,7501,2500,5001,2500,0,1,2502,6850046,6.850046
5700,2500,2500,14250000,2,20006,5003,1,278000000,278000000,7501,2500,5001,2500,0,1,2502,7089922,7.089922
5700,2500,2500,14250000,2,20006,5003,1,278000000,278000000,7501,2500,5001,2500,0,1,2502,6891340,6.89134
5700,2500,2500,14250000,2,20006,5003,1,278000000,278000000,7501,2500,5001,2500,0,1,2502,7035022,7.035022
5700,2500,2500,14250000,2,20006,5003,1,278000000,278000000,7501,2500,5001,2500,0,1,2502,6850477,6.850477
5700,2500,2500,14250000,2,20006,5003,1,278000000,278000000,7501,2500,5001,2500,0,1,2502,7101676,7.101676
5700,2500,2500,14250000,2,20006,5003,1,278000000,278000000,7501,2500,5001,2500,0,1,2502,6814155,6.814155
5700,2500,2500,14250000,2,20006,5003,1,278000000,278000000,7501,2500,5001,2500,0,1,2502,7135343,7.135343
5700,2500,2900,14250000,2,23206,5803,1,304240000,304240000,8701,2900,5801,2900,0,1,2902,7741802,7.741802
5700,2500,2900,14250000,2,23206,5803,1,304240000,304240000,8701,2900,5801,2900,0,1,2902,8029776,8.029776
5700,2500,2900,14250000,2,23206,5803,1,304240000,304240000,8701,2900,5801,2900,0,1,2902,7815044,7.815044
5700,2500,2900,14250000,2,23206,5803,1,304240000,304240000,8701,2900,5801,2900,0,1,2902,7949784,7.949784
5700,2500,2900,14250000,2,23206,5803,1,304240000,304240000,8701,2900,5801,2900,0,1,2902,7707308,7.707308
5700,2500,2900,14250000,2,23206,5803,1,304240000,304240000,8701,2900,5801,2900,0,1,2902,8040203,8.040203
5700,2500,2900,14250000,2,23206,5803,1,304240000,304240000,8701,2900,5801,2900,0,1,2902,7650896,7.650896
5700,2500,2900,14250000,2,23206,5803,1,304240000,304240000,8701,2900,5801,2900,0,1,2902,8123886,8.123886
5700,2500,3300,14250000,2,26406,6603,1,330480000,330480000,9901,3300,6601,3300,0,1,3302,8946210,8.94621
5700,2500,3300,14250000,2,26406,6603,1,330480000,330480000,9901,3300,6601,3300,0,1,3302,9251218,9.251218
5700,2500,3300,14250000,2,26406,6603,1,330480000,330480000,9901,3300,6601,3300,0,1,3302,9019011,9.019011
5700,2500,3300,14250000,2,26406,6603,1,330480000,330480000,9901,3300,6601,3300,0,1,3302,9183018,9.183018
5700,2500,3300,14250000,2,26406,6603,1,330480000,330480000,9901,3300,6601,3300,0,1,3302,8956042,8.956042
5700,2500,3300,14250000,2,26406,6603,1,330480000,330480000,9901,3300,6601,3300,0,1,3302,9250759,9.250759
5700,2500,3300,14250000,2,26406,6603,1,330480000,330480000,9901,3300,6601,3300,0,1,3302,8892923,8.892923
5700,2500,3300,14250000,2,26406,6603,1,330480000,330480000,9901,3300,6601,3300,0,1,3302,9371113,9.371113
5700,2500,3700,14250000,2,29606,7403,1,356720000,356720000,11101,3700,7401,3700,0,1,3702,9850105,9.850105
5700,2500,3700,14250000,2,29606,7403,1,356720000,356720000,11101,3700,7401,3700,0,1,3702,10233899,10.233899
5700,2500,3700,14250000,2,29606,7403,1,356720000,356720000,11101,3700,7401,3700,0,1,3702,9936569,9.936569
5700,2500,3700,14250000,2,29606,7403,1,356720000,356720000,11101,3700,7401,3700,0,1,3702,10131017,10.131017
5700,2500,3700,14250000,2,29606,7403,1,356720000,356720000,11101,3700,7401,3700,0,1,3702,9791754,9.791754
5700,2500,3700,14250000,2,29606,7403,1,356720000,356720000,11101,3700,7401,3700,0,1,3702,10234808,10.234808
5700,2500,3700,14250000,2,29606,7403,1,356720000,356720000,11101,3700,7401,3700,0,1,3702,9744237,9.744237
5700,2500,3700,14250000,2,29606,7403,1,356720000,356720000,11101,3700,7401,3700,0,1,3702,10358998,10.358998
5700,2500,4100,14250000,2,32806,8203,1,382960000,382960000,12301,4100,8201,4100,0,1,4102,11057739,11.057739
5700,2500,4100,14250000,2,32806,8203,1,382960000,382960000,12301,4100,8201,4100,0,1,4102,11391012,11.391012
5700,2500,4100,14250000,2,32806,8203,1,382960000,382960000,12301,4100,8201,4100,0,1,4102,11128054,11.128054
5700,2500,4100,14250000,2,32806,8203,1,382960000,382960000,12301,4100,8201,4100,0,1,4102,11310425,11.310425
5700,2500,4100,14250000,2,32806,8203,1,382960000,382960000,12301,4100,8201,4100,0,1,4102,11008675,11.008675
5700,2500,4100,14250000,2,32806,8203,1,382960000,382960000,12301,4100,8201,4100,0,1,4102,11408778,11.408778
5700,2500,4100,14250000,2,32806,8203,1,382960000,382960000,12301,4100,8201,4100,0,1,4102,10942359,10.942359
5700,2500,4100,14250000,2,32806,8203,1,382960000,382960000,12301,4100,8201,4100,0,1,4102,11541807,11.541807
5700,2500,4500,14250000,2,36006,9003,1,409200000,409200000,13501,4500,9001,4500,0,1,4502,12099597,12.099597
5700,2500,4500,14250000,2,36006,9003,1,409200000,409200000,13501,4500,9001,4500,0,1,4502,12524786,12.524786
5700,2500,4500,14250000,2,36006,9003,1,409200000,409200000,13501,4500,9001,4500,0,1,4502,12166217,12.166217
5700,2500,4500,14250000,2,36006,9003,1,409200000,409200000,13501,4500,9001,4500,0,1,4502,12431950,12.43195
5700,2500,4500,14250000,2,36006,9003,1,409200000,409200000,13501,4500,9001,4500,0,1,4502,12033044,12.033044
5700,2500,4500,14250000,2,36006,9003,1,409200000,409200000,13501,4500,9001,4500,0,1,4502,12543818,12.543818
5700,2500,4500,14250000,2,36006,9003,1,409200000,409200000,13501,4500,9001,4500,0,1,4502,12005677,12.005677
5700,2500,4500,14250000,2,36006,9003,1,409200000,409200000,13501,4500,9001,4500,0,1,4502,12702309,12.702309
5700,2500,4900,14250000,2,39206,9803,1,435440000,435440000,14701,4900,9801,4900,0,1,4902,13180580,13.18058
5700,2500,4900,14250000,2,39206,9803,1,435440000,435440000,14701,4900,9801,4900,0,1,4902,13637361,13.637361
5700,2500,4900,14250000,2,39206,9803,1,435440000,435440000,14701,4900,9801,4900,0,1,4902,13249126,13.249126
5700,2500,4900,14250000,2,39206,9803,1,435440000,435440000,14701,4900,9801,4900,0,1,4902,13476165,13.476165
5700,2500,4900,14250000,2,39206,9803,1,435440000,435440000,14701,4900,9801,4900,0,1,4902,13103577,13.103577
5700,2500,4900,14250000,2,39206,9803,1,435440000,435440000,14701,4900,9801,4900,0,1,4902,13693438,13.693438
5700,2500,4900,14250000,2,39206,9803,1,435440000,435440000,14701,4900,9801,4900,0,1,4902,13033289,13.033289
5700,2500,4900,14250000,2,39206,9803,1,435440000,435440000,14701,4900,9801,4900,0,1,4902,13747029,13.747029
5700,2500,5300,14250000,2,42406,10603,1,461680000,461680000,15901,5300,10601,5300,0,1,5302,14200143,14.200143
5700,2500,5300,14250000,2,42406,10603,1,461680000,461680000,15901,5300,10601,5300,0,1,5302,14708678,14.708678
5700,2500,5300,14250000,2,42406,10603,1,461680000,461680000,15901,5300,10601,5300,0,1,5302,14300413,14.300413
5700,2500,5300,14250000,2,42406,10603,1,461680000,461680000,15901,5300,10601,5300,0,1,5302,14601164,14.601164
5700,2500,5300,14250000,2,42406,10603,1,461680000,461680000,15901,5300,10601,5300,0,1,5302,14143990,14.14399
5700,2500,5300,14250000,2,42406,10603,1,461680000,461680000,15901,5300,10601,5300,0,1,5302,14781865,14.781865
5700,2500,5300,14250000,2,42406,10603,1,461680000,461680000,15901,5300,10601,5300,0,1,5302,14096025,14.096025
5700,2500,5300,14250000,2,42406,10603,1,461680000,461680000,15901,5300,10601,5300,0,1,5302,14886717,14.886717
5700,2500,5700,14250000,2,45606,11403,1,487920000,487920000,17101,5700,11401,5700,0,1,5702,15255086,15.255086
5700,2500,5700,14250000,2,45606,11403,1,487920000,487920000,17101,5700,11401,5700,0,1,5702,15800729,15.800729
5700,2500,5700,14250000,2,45606,11403,1,487920000,487920000,17101,5700,11401,5700,0,1,5702,15416409,15.416409
5700,2500,5700,14250000,2,45606,11403,1,487920000,487920000,17101,5700,11401,5700,0,1,5702,15671505,15.671505
5700,2500,5700,14250000,2,45606,11403,1,487920000,487920000,17101,5700,11401,5700,0,1,5702,15222975,15.222975
5700,2500,5700,14250000,2,45606,11403,1,487920000,487920000,17101,5700,11401,5700,0,1,5702,15827358,15.827358
5700,2500,5700,14250000,2,45606,11403,1,487920000,487920000,17101,5700,11401,5700,0,1,5702,15173404,15.173404
5700,2500,5700,14250000,2,45606,11403,1,487920000,487920000,17101,5700,11401,5700,0,1,5702,16012748,16.012748
5700,2500,6100,14250000,2,48806,12203,1,514160000,514160000,18301,6100,12201,6100,0,1,6102,16302509,16.302509
5700,2500,6100,14250000,2,48806,12203,1,514160000,514160000,18301,6100,12201,6100,0,1,6102,16907071,16.907071
5700,2500,6100,14250000,2,48806,12203,1,514160000,514160000,18301,6100,12201,6100,0,1,6102,16463488,16.463488
5700,2500,6100,14250000,2,48806,12203,1,514160000,514160000,18301,6100,12201,6100,0,1,6102,16776859,16.776859
5700,2500,6100,14250000,2,48806,12203,1,514160000,514160000,18301,6100,12201,6100,0,1,6102,16266773,16.266773
5700,2500,6100,14250000,2,48806,12203,1,514160000,514160000,18301,6100,12201,6100,0,1,6102,16928426,16.928426
5700,2500,6100,14250000,2,48806,12203,1,514160000,514160000,18301,6100,12201,6100,0,1,6102,16160241,16.160241
5700,2500,6100,14250000,2,48806,12203,1,514160000,514160000,18301,6100,12201,6100,0,1,6102,17118358,17.118358
5700,2500,6500,14250000,2,52006,13003,1,540400000,540400000,19501,6500,13001,6500,0,1,6502,17391547,17.391547
5700,2500,6500,14250000,2,52006,13003,1,540400000,540400000,19501,6500,13001,6500,0,1,6502,17969706,17.969706
5700,2500,6500,14250000,2,52006,13003,1,540400000,540400000,19501,6500,13001,6500,0,1,6502,17510574,17.510574
5700,2500,6500,14250000,2,52006,13003,1,540400000,540400000,19501,6500,13001,6500,0,1,6502,17831865,17.831865
5700,2500,6500,14250000,2,52006,13003,1,540400000,540400000,19501,6500,13001,6500,0,1,6502,17304753,17.304753
5700,2500,6500,14250000,2,52006,13003,1,540400000,540400000,19501,6500,13001,6500,0,1,6502,18020037,18.020037
5700,2500,6500,14250000,2,52006,13003,1,540400000,540400000,19501,6500,13001,6500,0,1,6502,17192573,17.192573
5700,2500,6500,14250000,2,52006,13003,1,540400000,540400000,19501,6500,13001,6500,0,1,6502,18227740,18.22774
5700,2500,6900,14250000,2,55206,13803,1,566640000,566640000,20701,6900,13801,6900,0,1,6902,18442712,18.442712
5700,2500,6900,14250000,2,55206,13803,1,566640000,566640000,20701,6900,13801,6900,0,1,6902,19096256,19.096256
5700,2500,6900,14250000,2,55206,13803,1,566640000,566640000,20701,6900,13801,6900,0,1,6902,18530688,18.530688
5700,2500,6900,14250000,2,55206,13803,1,566640000,566640000,20701,6900,13801,6900,0,1,6902,18948289,18.948289
5700,2500,6900,14250000,2,55206,13803,1,566640000,566640000,20701,6900,13801,6900,0,1,6902,18350754,18.350754
5700,2500,6900,14250000,2,55206,13803,1,566640000,566640000,20701,6900,13801,6900,0,1,6902,19137654,19.137654
5700,2500,6900,14250000,2,55206,13803,1,566640000,566640000,20701,6900,13801,6900,0,1,6902,18267887,18.267887
5700,2500,6900,14250000,2,55206,13803,1,566640000,566640000,20701,6900,13801,6900,0,1,6902,19360686,19.360686
5700,2100,500,11970000,2,4006,1003,1,126960000,126960000,1501,500,1001,500,0,1,502,1219322,1.219322
5700,2100,500,11970000,2,4006,1003,1,126960000,126960000,1501,500,1001,500,0,1,502,1258447,1.258447
5700,2100,500,11970000,2,4006,1003,1,126960000,126960000,1501,500,1001,500,0,1,502,1231498,1.231498
5700,2100,500,11970000,2,4006,1003,1,126960000,126960000,1501,500,1001,500,0,1,502,1258152,1.258152
5700,2100,500,11970000,2,4006,1003,1,126960000,126960000,1501,500,1001,500,0,1,502,1240052,1.240052
5700,2100,500,11970000,2,4006,1003,1,126960000,126960000,1501,500,1001,500,0,1,502,1249336,1.249336
5700,2100,500,11970000,2,4006,1003,1,126960000,126960000,1501,500,1001,500,0,1,502,1210812,1.210812
5700,2100,500,11970000,2,4006,1003,1,126960000,126960000,1501,500,1001,500,0,1,502,1267421,1.267421
5700,2100,900,11970000,2,7206,1803,1,151920000,151920000,2701,900,1801,900,0,1,902,2099247,2.099247
5700,2100,900,11970000,2,7206,1803,1,151920000,151920000,2701,900,1801,900,0,1,902,2174749,2.174749
5700,2100,900,11970000,2,7206,1803,1,151920000,151920000,2701,900,1801,900,0,1,902,2114353,2.114353
5700,2100,900,11970000,2,7206,1803,1,151920000,151920000,2701,900,1801,900,0,1,902,2155632,2.155632
5700,2100,900,11970000,2,7206,1803,1,151920000,151920000,2701,900,1801,900,0,1,902,2090730,2.09073
5700,2100,900,11970000,2,7206,1803,1,151920000,151920000,2701,900,1801,900,0,1,902,2165917,2.165917
5700,2100,900,11970000,2,7206,1803,1,151920000,151920000,2701,900,1801,900,0,1,902,2081021,2.081021
5700,2100,900,11970000,2,7206,1803,1,151920000,151920000,2701,900,1801,900,0,1,902,2193895,2.193895
5700,2100,1300,11970000,2,10406,2603,1,176880000,176880000,3901,1300,2601,1300,0,1,1302,3105017,3.105017
5700,2100,1300,11970000,2,10406,2603,1,176880000,176880000,3901,1300,2601,1300,0,1,1302,3205150,3.20515
5700,2100,1300,11970000,2,10406,2603,1,176880000,176880000,3901,1300,2601,1300,0,1,1302,3184192,3.184192
5700,2100,1300,11970000,2,10406,2603,1,176880000,176880000,3901,1300,2601,1300,0,1,1302,3195932,3.195932
5700,2100,1300,11970000,2,10406,2603,1,176880000,176880000,3901,1300,2601,1300,0,1,1302,3118141,3.118141
5700,2100,1300,11970000,2,10406,2603,1,176880000,176880000,3901,1300,2601,1300,0,1,1302,3205552,3.205552
5700,2100,1300,11970000,2,10406,2603,1,176880000,176880000,3901,1300,2601,1300,0,1,1302,3061362,3.061362
5700,2100,1300,11970000,2,10406,2603,1,176880000,176880000,3901,1300,2601,1300,0,1,1302,3255698,3.255698
5700,2100,1700,11970000,2,13606,3403,1,201840000,201840000,5101,1700,3401,1700,0,1,1702,3858106,3.858106
5700,2100,1700,11970000,2,13606,3403,1,201840000,201840000,5101,1700,3401,1700,0,1,1702,4012359,4.012359
5700,2100,1700,11970000,2,13606,3403,1,201840000,201840000,5101,1700,3401,1700,0,1,1702,3905234,3.905234
5700,2100,1700,11970000,2,13606,3403,1,201840000,201840000,5101,1700,3401,1700,0,1,1702,3968301,3.968301
5700,2100,1700,11970000,2,13606,3403,1,201840000,201840000,5101,1700,3401,1700,0,1,1702,3848716,3.848716
5700,2100,1700,11970000,2,13606,3403,1,201840000,201840000,5101,1700,3401,1700,0,1,1702,4000876,4.000876
5700,2100,1700,11970000,2,13606,3403,1,201840000,201840000,5101,1700,3401,1700,0,1,1702,3823429,3.823429
5700,2100,1700,11970000,2,13606,3403,1,201840000,201840000,5101,1700,3401,1700,0,1,1702,4062521,4.062521
5700,2100,2100,11970000,2,16806,4203,1,226800000,226800000,6301,2100,4201,2100,0,1,2102,4749741,4.749741
5700,2100,2100,11970000,2,16806,4203,1,226800000,226800000,6301,2100,4201,2100,0,1,2102,4912453,4.912453
5700,2100,2100,11970000,2,16806,4203,1,226800000,226800000,6301,2100,4201,2100,0,1,2102,4802587,4.802587
5700,2100,2100,11970000,2,16806,4203,1,226800000,226800000,6301,2100,4201,2100,0,1,2102,4874377,4.874377
5700,2100,2100,11970000,2,16806,4203,1,226800000,226800000,6301,2100,4201,2100,0,1,2102,4758079,4.758079
5700,2100,2100,11970000,2,16806,4203,1,226800000,226800000,6301,2100,4201,2100,0,1,2102,4938260,4.93826
5700,2100,2100,11970000,2,16806,4203,1,226800000,226800000,6301,2100,4201,2100,0,1,2102,4715673,4.715673
5700,2100,2100,11970000,2,16806,4203,1,226800000,226800000,6301,2100,4201,2100,0,1,2102,4987358,4.987358
5700,2100,2500,11970000,2,20006,5003,1,251760000,251760000,7501,2500,5001,2500,0,1,2502,5625290,5.62529
5700,2100,2500,11970000,2,20006,5003,1,251760000,251760000,7501,2500,5001,2500,0,1,2502,5836882,5.836882
5700,2100,2500,11970000,2,20006,5003,1,251760000,251760000,7501,2500,5001,2500,0,1,2502,5689862,5.689862
5700,2100,2500,11970000,2,20006,5003,1,251760000,251760000,7501,2500,5001,2500,0,1,2502,5781375,5.781375
5700,2100,2500,11970000,2,20006,5003,1,251760000,251760000,7501,2500,5001,2500,0,1,2502,5602383,5.602383
5700,2100,2500,11970000,2,20006,5003,1,251760000,251760000,7501,2500,5001,2500,0,1,2502,5845683,5.845683
5700,2100,2500,11970000,2,20006,5003,1,251760000,251760000,7501,2500,5001,2500,0,1,2502,5570925,5.570925
5700,2100,2500,11970000,2,20006,5003,1,251760000,251760000,7501,2500,5001,2500,0,1,2502,5920320,5.92032
5700,2100,2900,11970000,2,23206,5803,1,276720000,276720000,8701,2900,5801,2900,0,1,2902,6682630,6.68263
5700,2100,2900,11970000,2,23206,5803,1,276720000,276720000,8701,2900,5801,2900,0,1,2902,6854048,6.854048
5700,2100,2900,11970000,2,23206,5803,1,276720000,276720000,8701,2900,5801,2900,0,1,2902,6748237,6.748237
5700,2100,2900,11970000,2,23206,5803,1,276720000,276720000,8701,2900,5801,2900,0,1,2902,6805286,6.805286
5700,2100,2900,11970000,2,23206,5803,1,276720000,276720000,8701,2900,5801,2900,0,1,2902,6690977,6.690977
5700,2100,2900,11970000,2,23206,5803,1,276720000,276720000,8701,2900,5801,2900,0,1,2902,6862653,6.862653
5700,2100,2900,11970000,2,23206,5803,1,276720000,276720000,8701,2900,5801,2900,0,1,2902,6621546,6.621546
5700,2100,2900,11970000,2,23206,5803,1,276720000,276720000,8701,2900,5801,2900,0,1,2902,6952009,6.952009
5700,2100,3300,11970000,2,26406,6603,1,301680000,301680000,9901,3300,6601,3300,0,1,3302,7409072,7.409072
5700,2100,3300,11970000,2,26406,6603,1,301680000,301680000,9901,3300,6601,3300,0,1,3302,7680309,7.680309
5700,2100,3300,11970000,2,26406,6603,1,301680000,301680000,9901,3300,6601,3300,0,1,3302,7464373,7.464373
5700,2100,3300,11970000,2,26406,6603,1,301680000,301680000,9901,3300,6601,3300,0,1,3302,7607722,7.607722
5700,2100,3300,11970000,2,26406,6603,1,301680000,301680000,9901,3300,6601,3300,0,1,3302,7391386,7.391386
5700,2100,3300,11970000,2,26406,6603,1,301680000,301680000,9901,3300,6601,3300,0,1,3302,7687843,7.687843
5700,2100,3300,11970000,2,26406,6603,1,301680000,301680000,9901,3300,6601,3300,0,1,3302,7308885,7.308885
5700,2100,3300,11970000,2,26406,6603,1,301680000,301680000,9901,3300,6601,3300,0,1,3302,7783295,7.783295
5700,2100,3700,11970000,2,29606,7403,1,326640000,326640000,11101,3700,7401,3700,0,1,3702,8446044,8.446044
5700,2100,3700,11970000,2,29606,7403,1,326640000,326640000,11101,3700,7401,3700,0,1,3702,8719876,8.719876
5700,2100,3700,11970000,2,29606,7403,1,326640000,326640000,11101,3700,7401,3700,0,1,3702,8512114,8.512114
5700,2100,3700,11970000,2,29606,7403,1,326640000,326640000,11101,3700,7401,3700,0,1,3702,8654619,8.654619
5700,2100,3700,11970000,2,29606,7403,1,326640000,326640000,11101,3700,7401,3700,0,1,3702,8420010,8.42001
5700,2100,3700,11970000,2,29606,7403,1,326640000,326640000,11101,3700,7401,3700,0,1,3702,8735137,8.735137
5700,2100,3700,11970000,2,29606,7403,1,326640000,326640000,11101,3700,7401,3700,0,1,3702,8379068,8.379068
5700,2100,3700,11970000,2,29606,7403,1,326640000,326640000,11101,3700,7401,3700,0,1,3702,8836033,8.836033
5700,2100,4100,11970000,2,32806,8203,1,351600000,351600000,12301,4100,8201,4100,0,1,4102,9193083,9.193083
5700,2100,4100,11970000,2,32806,8203,1,351600000,351600000,12301,4100,8201,4100,0,1,4102,9522398,9.522398
5700,2100,4100,11970000,2,32806,8203,1,351600000,351600000,12301,4100,8201,4100,0,1,4102,9264010,9.26401
5700,2100,4100,11970000,2,32806,8203,1,351600000,351600000,12301,4100,8201,4100,0,1,4102,9431070,9.43107
5700,2100,4100,11970000,2,32806,8203,1,351600000,351600000,12301,4100,8201,4100,0,1,4102,9157985,9.157985
5700,2100,4100,11970000,2,32806,8203,1,351600000,351600000,12301,4100,8201,4100,0,1,4102,9569254,9.569254
5700,2100,4100,11970000,2,32806,8203,1,351600000,351600000,12301,4100,8201,4100,0,1,4102,9060295,9.060295
5700,2100,4100,11970000,2,32806,8203,1,351600000,351600000,12301,4100,8201,4100,0,1,4102,9655767,9.655767
5700,2100,4500,11970000,2,36006,9003,1,376560000,376560000,13501,4500,9001,4500,0,1,4502,10215131,10.215131
5700,2100,4500,11970000,2,36006,9003,1,376560000,376560000,13501,4500,9001,4500,0,1,4502,10555510,10.55551
5700,2100,4500,11970000,2,36006,9003,1,376560000,376560000,13501,4500,9001,4500,0,1,4502,10326438,10.326438
5700,2100,4500,11970000,2,36006,9003,1,376560000,376560000,13501,4500,9001,4500,0,1,4502,10476168,10.476168
5700,2100,4500,11970000,2,36006,9003,1,376560000,376560000,13501,4500,9001,4500,0,1,4502,10231288,10.231288
5700,2100,4500,11970000,2,36006,9003,1,376560000,376560000,13501,4500,9001,4500,0,1,4502,10603070,10.60307
5700,2100,4500,11970000,2,36006,9003,1,376560000,376560000,13501,4500,9001,4500,0,1,4502,10115951,10.115951
5700,2100,4500,11970000,2,36006,9003,1,376560000,376560000,13501,4500,9001,4500,0,1,4502,10701821,10.701821
5700,2100,4900,11970000,2,39206,9803,1,401520000,401520000,14701,4900,9801,4900,0,1,4902,11080836,11.080836
5700,2100,4900,11970000,2,39206,9803,1,401520000,401520000,14701,4900,9801,4900,0,1,4902,11471230,11.47123
5700,2100,4900,11970000,2,39206,9803,1,401520000,401520000,14701,4900,9801,4900,0,1,4902,11219639,11.219639
5700,2100,4900,11970000,2,39206,9803,1,401520000,401520000,14701,4900,9801,4900,0,1,4902,11387099,11.387099
5700,2100,4900,11970000,2,39206,9803,1,401520000,401520000,14701,4900,9801,4900,0,1,4902,11115359,11.115359
5700,2100,4900,11970000,2,39206,9803,1,401520000,401520000,14701,4900,9801,4900,0,1,4902,11502794,11.502794
5700,2100,4900,11970000,2,39206,9803,1,401520000,401520000,14701,4900,9801,4900,0,1,4902,10994812,10.994812
5700,2100,4900,11970000,2,39206,9803,1,401520000,401520000,14701,4900,9801,4900,0,1,4902,11633041,11.633041
5700,2100,5300,11970000,2,42406,10603,1,426480000,426480000,15901,5300,10601,5300,0,1,5302,11994854,11.994854
5700,2100,5300,11970000,2,42406,10603,1,426480000,426480000,15901,5300,10601,5300,0,1,5302,12400347,12.400347
5700,2100,5300,11970000,2,42406,10603,1,426480000,426480000,15901,5300,10601,5300,0,1,5302,12121134,12.121134
5700,2100,5300,11970000,2,42406,10603,1,426480000,426480000,15901,5300,10601,5300,0,1,5302,12314900,12.3149
5700,2100,5300,11970000,2,42406,10603,1,426480000,426480000,15901,5300,10601,5300,0,1,5302,11957794,11.957794
5700,2100,5300,11970000,2,42406,10603,1,426480000,426480000,15901,5300,10601,5300,0,1,5302,12443007,12.443007
5700,2100,5300,11970000,2,42406,10603,1,426480000,426480000,15901,5300,10601,5300,0,1,5302,11876417,11.876417
5700,2100,5300,11970000,2,42406,10603,1,426480000,426480000,15901,5300,10601,5300,0,1,5302,12573721,12.573721
5700,2100,5700,11970000,2,45606,11403,1,451440000,451440000,17101,5700,11401,5700,0,1,5702,12870673,12.870673
5700,2100,5700,11970000,2,45606,11403,1,451440000,451440000,17101,5700,11401,5700,0,1,5702,13323470,13.32347
5700,2100,5700,11970000,2,45606,11403,1,451440000,451440000,17101,5700,11401,5700,0,1,5702,12851906,12.851906
5700,2100,5700,11970000,2,45606,11403,1,451440000,451440000,17101,5700,11401,5700,0,1,5702,13213199,13.213199
5700,2100,5700,11970000,2,45606,11403,1,451440000,451440000,17101,5700,11401,5700,0,1,5702,12829485,12.829485
5700,2100,5700,11970000,2,45606,11403,1,451440000,451440000,17101,5700,11401,5700,0,1,5702,13348330,13.34833
5700,2100,5700,11970000,2,45606,11403,1,451440000,451440000,17101,5700,11401,5700,0,1,5702,12760776,12.760776
5700,2100,5700,11970000,2,45606,11403,1,451440000,451440000,17101,5700,11401,5700,0,1,5702,13514424,13.514424
5700,2100,6100,11970000,2,48806,12203,1,476400000,476400000,18301,6100,12201,6100,0,1,6102,13627665,13.627665
5700,2100,6100,11970000,2,48806,12203,1,476400000,476400000,18301,6100,12201,6100,0,1,6102,14166357,14.166357
5700,2100,6100,11970000,2,48806,12203,1,476400000,476400000,18301,6100,12201,6100,0,1,6102,13896975,13.896975
5700,2100,6100,11970000,2,48806,12203,1,476400000,476400000,18301,6100,12201,6100,0,1,6102,13987043,13.987043
5700,2100,6100,11970000,2,48806,12203,1,476400000,476400000,18301,6100,12201,6100,0,1,6102,13740569,13.740569
5700,2100,6100,11970000,2,48806,12203,1,476400000,476400000,18301,6100,12201,6100,0,1,6102,14261495,14.261495
5700,2100,6100,11970000,2,48806,12203,1,476400000,476400000,18301,6100,12201,6100,0,1,6102,13636878,13.636878
5700,2100,6100,11970000,2,48806,12203,1,476400000,476400000,18301,6100,12201,6100,0,1,6102,14344325,14.344325
5700,2100,6500,11970000,2,52006,13003,1,501360000,501360000,19501,6500,13001,6500,0,1,6502,14689432,14.689432
5700,2100,6500,11970000,2,52006,13003,1,501360000,501360000,19501,6500,13001,6500,0,1,6502,15193638,15.193638
5700,2100,6500,11970000,2,52006,13003,1,501360000,501360000,19501,6500,13001,6500,0,1,6502,14735602,14.735602
5700,2100,6500,11970000,2,52006,13003,1,501360000,501360000,19501,6500,13001,6500,0,1,6502,15022619,15.022619
5700,2100,6500,11970000,2,52006,13003,1,501360000,501360000,19501,6500,13001,6500,0,1,6502,14622172,14.622172
5700,2100,6500,11970000,2,52006,13003,1,501360000,501360000,19501,6500,13001,6500,0,1,6502,15168335,15.168335
5700,2100,6500,11970000,2,52006,13003,1,501360000,501360000,19501,6500,13001,6500,0,1,6502,14539990,14.53999
5700,2100,6500,11970000,2,52006,13003,1,501360000,501360000,19501,6500,13001,6500,0,1,6502,15347823,15.347823
5700,2100,6900,11970000,2,55206,13803,1,526320000,526320000,20701,6900,13801,6900,0,1,6902,15551535,15.551535
5700,2100,6900,11970000,2,55206,13803,1,526320000,526320000,20701,6900,13801,6900,0,1,6902,16109072,16.109072
5700,2100,6900,11970000,2,55206,13803,1,526320000,526320000,20701,6900,13801,6900,0,1,6902,15599188,15.599188
5700,2100,6900,11970000,2,55206,13803,1,526320000,526320000,20701,6900,13801,6900,0,1,6902,15964554,15.964554
5700,2100,6900,11970000,2,55206,13803,1,526320000,526320000,20701,6900,13801,6900,0,1,6902,15493009,15.493009
5700,2100,6900,11970000,2,55206,13803,1,526320000,526320000,20701,6900,13801,6900,0,1,6902,16128362,16.128362
5700,2100,6900,11970000,2,55206,13803,1,526320000,526320000,20701,6900,13801,6900,0,1,6902,15400419,15.400419
5700,2100,6900,11970000,2,55206,13803,1,526320000,526320000,20701,6900,13801,6900,0,1,6902,16316388,16.316388
5700,1700,500,9690000,2,4006,1003,1,107120000,107120000,1501,500,1001,500,0,1,502,988834,0.988834
5700,1700,500,9690000,2,4006,1003,1,107120000,107120000,1501,500,1001,500,0,1,502,1021546,1.021546
5700,1700,500,9690000,2,4006,1003,1,107120000,107120000,1501,500,1001,500,0,1,502,1014819,1.014819
5700,1700,500,9690000,2,4006,1003,1,107120000,107120000,1501,500,1001,500,0,1,502,1022459,1.022459
5700,1700,500,9690000,2,4006,1003,1,107120000,107120000,1501,500,1001,500,0,1,502,1006364,1.006364
5700,1700,500,9690000,2,4006,1003,1,107120000,107120000,1501,500,1001,500,0,1,502,1014548,1.014548
5700,1700,500,9690000,2,4006,1003,1,107120000,107120000,1501,500,1001,500,0,1,502,995999,0.995999
5700,1700,500,9690000,2,4006,1003,1,107120000,107120000,1501,500,1001,500,0,1,502,1038041,1.038041
5700,1700,900,9690000,2,7206,1803,1,130800000,130800000,2701,900,1801,900,0,1,902,1708240,1.70824
5700,1700,900,9690000,2,7206,1803,1,130800000,130800000,2701,900,1801,900,0,1,902,1766046,1.766046
5700,1700,900,9690000,2,7206,1803,1,130800000,130800000,2701,900,1801,900,0,1,902,1727431,1.727431
5700,1700,900,9690000,2,7206,1803,1,130800000,130800000,2701,900,1801,900,0,1,902,1756751,1.756751
5700,1700,900,9690000,2,7206,1803,1,130800000,130800000,2701,900,1801,900,0,1,902,1726949,1.726949
5700,1700,900,9690000,2,7206,1803,1,130800000,130800000,2701,900,1801,900,0,1,902,1749575,1.749575
5700,1700,900,9690000,2,7206,1803,1,130800000,130800000,2701,900,1801,900,0,1,902,1715132,1.715132
5700,1700,900,9690000,2,7206,1803,1,130800000,130800000,2701,900,1801,900,0,1,902,1789702,1.789702
5700,1700,1300,9690000,2,10406,2603,1,154480000,154480000,3901,1300,2601,1300,0,1,1302,2427990,2.42799
5700,1700,1300,9690000,2,10406,2603,1,154480000,154480000,3901,1300,2601,1300,0,1,1302,2507576,2.507576
5700,1700,1300,9690000,2,10406,2603,1,154480000,154480000,3901,1300,2601,1300,0,1,1302,2586973,2.586973
5700,1700,1300,9690000,2,10406,2603,1,154480000,154480000,3901,1300,2601,1300,0,1,1302,2613396,2.613396
5700,1700,1300,9690000,2,10406,2603,1,154480000,154480000,3901,1300,2601,1300,0,1,1302,2436369,2.436369
5700,1700,1300,9690000,2,10406,2603,1,154480000,154480000,3901,1300,2601,1300,0,1,1302,2493148,2.493148
5700,1700,1300,9690000,2,10406,2603,1,154480000,154480000,3901,1300,2601,1300,0,1,1302,2420972,2.420972
5700,1700,1300,9690000,2,10406,2603,1,154480000,154480000,3901,1300,2601,1300,0,1,1302,2538566,2.538566
5700,1700,1700,9690000,2,13606,3403,1,178160000,178160000,5101,1700,3401,1700,0,1,1702,3302840,3.30284
5700,1700,1700,9690000,2,13606,3403,1,178160000,178160000,5101,1700,3401,1700,0,1,1702,3358190,3.35819
5700,1700,1700,9690000,2,13606,3403,1,178160000,178160000,5101,1700,3401,1700,0,1,1702,3178439,3.178439
5700,1700,1700,9690000,2,13606,3403,1,178160000,178160000,5101,1700,3401,1700,0,1,1702,3227335,3.227335
5700,1700,1700,9690000,2,13606,3403,1,178160000,178160000,5101,1700,3401,1700,0,1,1702,3156584,3.156584
5700,1700,1700,9690000,2,13606,3403,1,178160000,178160000,5101,1700,3401,1700,0,1,1702,3238482,3.238482
5700,1700,1700,9690000,2,13606,3403,1,178160000,178160000,5101,1700,3401,1700,0,1,1702,3114731,3.114731
5700,1700,1700,9690000,2,13606,3403,1,178160000,178160000,5101,1700,3401,1700,0,1,1702,3407906,3.407906
5700,1700,2100,9690000,2,16806,4203,1,201840000,201840000,6301,2100,4201,2100,0,1,2102,3859668,3.859668
5700,1700,2100,9690000,2,16806,4203,1,201840000,201840000,6301,2100,4201,2100,0,1,2102,4000828,4.000828
5700,1700,2100,9690000,2,16806,4203,1,201840000,201840000,6301,2100,4201,2100,0,1,2102,3899896,3.899896
5700,1700,2100,9690000,2,16806,4203,1,201840000,201840000,6301,2100,4201,2100,0,1,2102,3962995,3.962995
5700,1700,2100,9690000,2,16806,4203,1,201840000,201840000,6301,2100,4201,2100,0,1,2102,3847096,3.847096
5700,1700,2100,9690000,2,16806,4203,1,201840000,201840000,6301,2100,4201,2100,0,1,2102,4095683,4.095683
5700,1700,2100,9690000,2,16806,4203,1,201840000,201840000,6301,2100,4201,2100,0,1,2102,3825750,3.82575
5700,1700,2100,9690000,2,16806,4203,1,201840000,201840000,6301,2100,4201,2100,0,1,2102,4056450,4.05645
5700,1700,2500,9690000,2,20006,5003,1,225520000,225520000,7501,2500,5001,2500,0,1,2502,4584533,4.584533
5700,1700,2500,9690000,2,20006,5003,1,225520000,225520000,7501,2500,5001,2500,0,1,2502,4746223,4.746223
5700,1700,2500,9690000,2,20006,5003,1,225520000,225520000,7501,2500,5001,2500,0,1,2502,4626582,4.626582
5700,1700,2500,9690000,2,20006,5003,1,225520000,225520000,7501,2500,5001,2500,0,1,2502,4698279,4.698279
5700,1700,2500,9690000,2,20006,5003,1,225520000,225520000,7501,2500,5001,2500,0,1,2502,4801248,4.801248
5700,1700,2500,9690000,2,20006,5003,1,225520000,225520000,7501,2500,5001,2500,0,1,2502,4738932,4.738932
5700,1700,2500,9690000,2,20006,5003,1,225520000,225520000,7501,2500,5001,2500,0,1,2502,4728441,4.728441
5700,1700,2500,9690000,2,20006,5003,1,225520000,225520000,7501,2500,5001,2500,0,1,2502,4821521,4.821521
5700,1700,2900,9690000,2,23206,5803,1,249200000,249200000,8701,2900,5801,2900,0,1,2902,5303725,5.303725
5700,1700,2900,9690000,2,23206,5803,1,249200000,249200000,8701,2900,5801,2900,0,1,2902,5490939,5.490939
5700,1700,2900,9690000,2,23206,5803,1,249200000,249200000,8701,2900,5801,2900,0,1,2902,5357569,5.357569
5700,1700,2900,9690000,2,23206,5803,1,249200000,249200000,8701,2900,5801,2900,0,1,2902,5442290,5.44229
5700,1700,2900,9690000,2,23206,5803,1,249200000,249200000,8701,2900,5801,2900,0,1,2902,5310451,5.310451
5700,1700,2900,9690000,2,23206,5803,1,249200000,249200000,8701,2900,5801,2900,0,1,2902,5478053,5.478053
5700,1700,2900,9690000,2,23206,5803,1,249200000,249200000,8701,2900,5801,2900,0,1,2902,5275147,5.275147
5700,1700,2900,9690000,2,23206,5803,1,249200000,249200000,8701,2900,5801,2900,0,1,2902,5555436,5.555436
5700,1700,3300,9690000,2,26406,6603,1,272880000,272880000,9901,3300,6601,3300,0,1,3302,6116039,6.116039
5700,1700,3300,9690000,2,26406,6603,1,272880000,272880000,9901,3300,6601,3300,0,1,3302,6339889,6.339889
5700,1700,3300,9690000,2,26406,6603,1,272880000,272880000,9901,3300,6601,3300,0,1,3302,6225491,6.225491
5700,1700,3300,9690000,2,26406,6603,1,272880000,272880000,9901,3300,6601,3300,0,1,3302,6306591,6.306591
5700,1700,3300,9690000,2,26406,6603,1,272880000,272880000,9901,3300,6601,3300,0,1,3302,6004404,6.004404
5700,1700,3300,9690000,2,26406,6603,1,272880000,272880000,9901,3300,6601,3300,0,1,3302,6232969,6.232969
5700,1700,3300,9690000,2,26406,6603,1,272880000,272880000,9901,3300,6601,3300,0,1,3302,5929924,5.929924
5700,1700,3300,9690000,2,26406,6603,1,272880000,272880000,9901,3300,6601,3300,0,1,3302,6408203,6.408203
5700,1700,3700,9690000,2,29606,7403,1,296560000,296560000,11101,3700,7401,3700,0,1,3702,6723066,6.723066
5700,1700,3700,9690000,2,29606,7403,1,296560000,296560000,11101,3700,7401,3700,0,1,3702,6966259,6.966259
5700,1700,3700,9690000,2,29606,7403,1,296560000,296560000,11101,3700,7401,3700,0,1,3702,6787590,6.78759
5700,1700,3700,9690000,2,29606,7403,1,296560000,296560000,11101,3700,7401,3700,0,1,3702,6914794,6.914794
5700,1700,3700,9690000,2,29606,7403,1,296560000,296560000,11101,3700,7401,3700,0,1,3702,6886393,6.886393
5700,1700,3700,9690000,2,29606,7403,1,296560000,296560000,11101,3700,7401,3700,0,1,3702,7118876,7.118876
5700,1700,3700,9690000,2,29606,7403,1,296560000,296560000,11101,3700,7401,3700,0,1,3702,6870268,6.870268
5700,1700,3700,9690000,2,29606,7403,1,296560000,296560000,11101,3700,7401,3700,0,1,3702,7042923,7.042923
5700,1700,4100,9690000,2,32806,8203,1,320240000,320240000,12301,4100,8201,4100,0,1,4102,7446578,7.446578
5700,1700,4100,9690000,2,32806,8203,1,320240000,320240000,12301,4100,8201,4100,0,1,4102,7827295,7.827295
5700,1700,4100,9690000,2,32806,8203,1,320240000,320240000,12301,4100,8201,4100,0,1,4102,7660845,7.660845
5700,1700,4100,9690000,2,32806,8203,1,320240000,320240000,12301,4100,8201,4100,0,1,4102,7778980,7.77898
5700,1700,4100,9690000,2,32806,8203,1,320240000,320240000,12301,4100,8201,4100,0,1,4102,7439799,7.439799
5700,1700,4100,9690000,2,32806,8203,1,320240000,320240000,12301,4100,8201,4100,0,1,4102,7728698,7.728698
5700,1700,4100,9690000,2,32806,8203,1,320240000,320240000,12301,4100,8201,4100,0,1,4102,7358199,7.358199
5700,1700,4100,9690000,2,32806,8203,1,320240000,320240000,12301,4100,8201,4100,0,1,4102,7805191,7.805191
5700,1700,4500,9690000,2,36006,9003,1,343920000,343920000,13501,4500,9001,4500,0,1,4502,8322411,8.322411
5700,1700,4500,9690000,2,36006,9003,1,343920000,343920000,13501,4500,9001,4500,0,1,4502,8468118,8.468118
5700,1700,4500,9690000,2,36006,9003,1,343920000,343920000,13501,4500,9001,4500,0,1,4502,8238238,8.238238
5700,1700,4500,9690000,2,36006,9003,1,343920000,343920000,13501,4500,9001,4500,0,1,4502,8379991,8.379991
5700,1700,4500,9690000,2,36006,9003,1,343920000,343920000,13501,4500,9001,4500,0,1,4502,8310076,8.310076
5700,1700,4500,9690000,2,36006,9003,1,343920000,343920000,13501,4500,9001,4500,0,1,4502,8600127,8.600127
5700,1700,4500,9690000,2,36006,9003,1,343920000,343920000,13501,4500,9001,4500,0,1,4502,8250436,8.250436
5700,1700,4500,9690000,2,36006,9003,1,343920000,343920000,13501,4500,9001,4500,0,1,4502,8676240,8.67624
5700,1700,4900,9690000,2,39206,9803,1,367600000,367600000,14701,4900,9801,4900,0,1,4902,8899169,8.899169
5700,1700,4900,9690000,2,39206,9803,1,367600000,367600000,14701,4900,9801,4900,0,1,4902,9326642,9.326642
5700,1700,4900,9690000,2,39206,9803,1,367600000,367600000,14701,4900,9801,4900,0,1,4902,9115983,9.115983
5700,1700,4900,9690000,2,39206,9803,1,367600000,367600000,14701,4900,9801,4900,0,1,4902,9248257,9.248257
5700,1700,4900,9690000,2,39206,9803,1,367600000,367600000,14701,4900,9801,4900,0,1,4902,8861918,8.861918
5700,1700,4900,9690000,2,39206,9803,1,367600000,367600000,14701,4900,9801,4900,0,1,4902,9224987,9.224987
5700,1700,4900,9690000,2,39206,9803,1,367600000,367600000,14701,4900,9801,4900,0,1,4902,8779306,8.779306
5700,1700,4900,9690000,2,39206,9803,1,367600000,367600000,14701,4900,9801,4900,0,1,4902,9319222,9.319222
5700,1700,5300,9690000,2,42406,10603,1,391280000,391280000,15901,5300,10601,5300,0,1,5302,9768209,9.768209
5700,1700,5300,9690000,2,42406,10603,1,391280000,391280000,15901,5300,10601,5300,0,1,5302,9955732,9.955732
5700,1700,5300,9690000,2,42406,10603,1,391280000,391280000,15901,5300,10601,5300,0,1,5302,9692357,9.692357
5700,1700,5300,9690000,2,42406,10603,1,391280000,391280000,15901,5300,10601,5300,0,1,5302,9861878,9.861878
5700,1700,5300,9690000,2,42406,10603,1,391280000,391280000,15901,5300,10601,5300,0,1,5302,9717477,9.717477
5700,1700,5300,9690000,2,42406,10603,1,391280000,391280000,15901,5300,10601,5300,0,1,5302,10064138,10.064138
5700,1700,5300,9690000,2,42406,10603,1,391280000,391280000,15901,5300,10601,5300,0,1,5302,9648215,9.648215
5700,1700,5300,9690000,2,42406,10603,1,391280000,391280000,15901,5300,10601,5300,0,1,5302,10165357,10.165357
5700,1700,5700,9690000,2,45606,11403,1,414960000,414960000,17101,5700,11401,5700,0,1,5702,10454062,10.454062
5700,1700,5700,9690000,2,45606,11403,1,414960000,414960000,17101,5700,11401,5700,0,1,5702,10823985,10.823985
5700,1700,5700,9690000,2,45606,11403,1,414960000,414960000,17101,5700,11401,5700,0,1,5702,10558482,10.558482
5700,1700,5700,9690000,2,45606,11403,1,414960000,414960000,17101,5700,11401,5700,0,1,5702,10739780,10.73978
5700,1700,5700,9690000,2,45606,11403,1,414960000,414960000,17101,5700,11401,5700,0,1,5702,10419378,10.419378
5700,1700,5700,9690000,2,45606,11403,1,414960000,414960000,17101,5700,11401,5700,0,1,5702,10851167,10.851167
5700,1700,5700,9690000,2,45606,11403,1,414960000,414960000,17101,5700,11401,5700,0,1,5702,10391917,10.391917
5700,1700,5700,9690000,2,45606,11403,1,414960000,414960000,17101,5700,11401,5700,0,1,5702,10956275,10.956275
5700,1700,6100,9690000,2,48806,12203,1,438640000,438640000,18301,6100,12201,6100,0,1,6102,11055023,11.055023
5700,1700,6100,9690000,2,48806,12203,1,438640000,438640000,18301,6100,12201,6100,0,1,6102,11570011,11.570011
5700,1700,6100,9690000,2,48806,12203,1,438640000,438640000,18301,6100,12201,6100,0,1,6102,11300313,11.300313
5700,1700,6100,9690000,2,48806,12203,1,438640000,438640000,18301,6100,12201,6100,0,1,6102,11495964,11.495964
5700,1700,6100,9690000,2,48806,12203,1,438640000,438640000,18301,6100,12201,6100,0,1,6102,10993810,10.99381
5700,1700,6100,9690000,2,48806,12203,1,438640000,438640000,18301,6100,12201,6100,0,1,6102,11503883,11.503883
5700,1700,6100,9690000,2,48806,12203,1,438640000,438640000,18301,6100,12201,6100,0,1,6102,10930063,10.930063
5700,1700,6100,9690000,2,48806,12203,1,438640000,438640000,18301,6100,12201,6100,0,1,6102,11590663,11.590663
5700,1700,6500,9690000,2,52006,13003,1,462320000,462320000,19501,6500,13001,6500,0,1,6502,11905501,11.905501
5700,1700,6500,9690000,2,52006,13003,1,462320000,462320000,19501,6500,13001,6500,0,1,6502,12366248,12.366248
5700,1700,6500,9690000,2,52006,13003,1,462320000,462320000,19501,6500,13001,6500,0,1,6502,12041304,12.041304
5700,1700,6500,9690000,2,52006,13003,1,462320000,462320000,19501,6500,13001,6500,0,1,6502,12226655,12.226655
5700,1700,6500,9690000,2,52006,13003,1,462320000,462320000,19501,6500,13001,6500,0,1,6502,11890243,11.890243
5700,1700,6500,9690000,2,52006,13003,1,462320000,462320000,19501,6500,13001,6500,0,1,6502,12358145,12.358145
5700,1700,6500,9690000,2,52006,13003,1,462320000,462320000,19501,6500,13001,6500,0,1,6502,11820021,11.820021
5700,1700,6500,9690000,2,52006,13003,1,462320000,462320000,19501,6500,13001,6500,0,1,6502,12470418,12.470418
5700,1700,6900,9690000,2,55206,13803,1,486000000,486000000,20701,6900,13801,6900,0,1,6902,12669498,12.669498
5700,1700,6900,9690000,2,55206,13803,1,486000000,486000000,20701,6900,13801,6900,0,1,6902,12959769,12.959769
5700,1700,6900,9690000,2,55206,13803,1,486000000,486000000,20701,6900,13801,6900,0,1,6902,12586070,12.58607
5700,1700,6900,9690000,2,55206,13803,1,486000000,486000000,20701,6900,13801,6900,0,1,6902,12861936,12.861936
5700,1700,6900,9690000,2,55206,13803,1,486000000,486000000,20701,6900,13801,6900,0,1,6902,12570880,12.57088
5700,1700,6900,9690000,2,55206,13803,1,486000000,486000000,20701,6900,13801,6900,0,1,6902,13118532,13.118532
5700,1700,6900,9690000,2,55206,13803,1,486000000,486000000,20701,6900,13801,6900,0,1,6902,12542748,12.542748
5700,1700,6900,9690000,2,55206,13803,1,486000000,486000000,20701,6900,13801,6900,0,1,6902,13226032,13.226032
5700,1300,500,7410000,2,4006,1003,1,87280000,87280000,1501,500,1001,500,0,1,502,758185,0.758185
5700,1300,500,7410000,2,4006,1003,1,87280000,87280000,1501,500,1001,500,0,1,502,780298,0.780298
5700,1300,500,7410000,2,4006,1003,1,87280000,87280000,1501,500,1001,500,0,1,502,767686,0.767686
5700,1300,500,7410000,2,4006,1003,1,87280000,87280000,1501,500,1001,500,0,1,502,774555,0.774555
5700,1300,500,7410000,2,4006,1003,1,87280000,87280000,1501,500,1001,500,0,1,502,757923,0.757923
5700,1300,500,7410000,2,4006,1003,1,87280000,87280000,1501,500,1001,500,0,1,502,786070,0.78607
5700,1300,500,7410000,2,4006,1003,1,87280000,87280000,1501,500,1001,500,0,1,502,751720,0.75172
5700,1300,500,7410000,2,4006,1003,1,87280000,87280000,1501,500,1001,500,0,1,502,791728,0.791728
5700,1300,900,7410000,2,7206,1803,1,109680000,109680000,2701,900,1801,900,0,1,902,1309071,1.309071
5700,1300,900,7410000,2,7206,1803,1,109680000,109680000,2701,900,1801,900,0,1,902,1354988,1.354988
5700,1300,900,7410000,2,7206,1803,1,109680000,109680000,2701,900,1801,900,0,1,902,1338069,1.338069
5700,1300,900,7410000,2,7206,1803,1,109680000,109680000,2701,900,1801,900,0,1,902,1343682,1.343682
5700,1300,900,7410000,2,7206,1803,1,109680000,109680000,2701,900,1801,900,0,1,902,1308732,1.308732
5700,1300,900,7410000,2,7206,1803,1,109680000,109680000,2701,900,1801,900,0,1,902,1361946,1.361946
5700,1300,900,7410000,2,7206,1803,1,109680000,109680000,2701,900,1801,900,0,1,902,1308441,1.308441
5700,1300,900,7410000,2,7206,1803,1,109680000,109680000,2701,900,1801,900,0,1,902,1370016,1.370016
5700,1300,1300,7410000,2,10406,2603,1,132080000,132080000,3901,1300,2601,1300,0,1,1302,1847509,1.847509
5700,1300,1300,7410000,2,10406,2603,1,132080000,132080000,3901,1300,2601,1300,0,1,1302,1918890,1.91889
5700,1300,1300,7410000,2,10406,2603,1,132080000,132080000,3901,1300,2601,1300,0,1,1302,1876231,1.876231
5700,1300,1300,7410000,2,10406,2603,1,132080000,132080000,3901,1300,2601,1300,0,1,1302,1896767,1.896767
5700,1300,1300,7410000,2,10406,2603,1,132080000,132080000,3901,1300,2601,1300,0,1,1302,1852702,1.852702
5700,1300,1300,7410000,2,10406,2603,1,132080000,132080000,3901,1300,2601,1300,0,1,1302,1911970,1.91197
5700,1300,1300,7410000,2,10406,2603,1,132080000,132080000,3901,1300,2601,1300,0,1,1302,1838317,1.838317
5700,1300,1300,7410000,2,10406,2603,1,132080000,132080000,3901,1300,2601,1300,0,1,1302,1932555,1.932555
5700,1300,1700,7410000,2,13606,3403,1,154480000,154480000,5101,1700,3401,1700,0,1,1702,2395133,2.395133
5700,1300,1700,7410000,2,13606,3403,1,154480000,154480000,5101,1700,3401,1700,0,1,1702,2481860,2.48186
5700,1300,1700,7410000,2,13606,3403,1,154480000,154480000,5101,1700,3401,1700,0,1,1702,2563854,2.563854
5700,1300,1700,7410000,2,13606,3403,1,154480000,154480000,5101,1700,3401,1700,0,1,1702,2549217,2.549217
5700,1300,1700,7410000,2,13606,3403,1,154480000,154480000,5101,1700,3401,1700,0,1,1702,2459361,2.459361
5700,1300,1700,7410000,2,13606,3403,1,154480000,154480000,5101,1700,3401,1700,0,1,1702,2487538,2.487538
5700,1300,1700,7410000,2,13606,3403,1,154480000,154480000,5101,1700,3401,1700,0,1,1702,2381819,2.381819
5700,1300,1700,7410000,2,13606,3403,1,154480000,154480000,5101,1700,3401,1700,0,1,1702,2512431,2.512431
5700,1300,2100,7410000,2,16806,4203,1,176880000,176880000,6301,2100,4201,2100,0,1,2102,3051067,3.051067
5700,1300,2100,7410000,2,16806,4203,1,176880000,176880000,6301,2100,4201,2100,0,1,2102,3179203,3.179203
5700,1300,2100,7410000,2,16806,4203,1,176880000,176880000,6301,2100,4201,2100,0,1,2102,3001070,3.00107
5700,1300,2100,7410000,2,16806,4203,1,176880000,176880000,6301,2100,4201,2100,0,1,2102,3027866,3.027866
5700,1300,2100,7410000,2,16806,4203,1,176880000,176880000,6301,2100,4201,2100,0,1,2102,2945974,2.945974
5700,1300,2100,7410000,2,16806,4203,1,176880000,176880000,6301,2100,4201,2100,0,1,2102,3184863,3.184863
5700,1300,2100,7410000,2,16806,4203,1,176880000,176880000,6301,2100,4201,2100,0,1,2102,3093524,3.093524
5700,1300,2100,7410000,2,16806,4203,1,176880000,176880000,6301,2100,4201,2100,0,1,2102,3221471,3.221471
5700,1300,2500,7410000,2,20006,5003,1,199280000,199280000,7501,2500,5001,2500,0,1,2502,3517673,3.517673
5700,1300,2500,7410000,2,20006,5003,1,199280000,199280000,7501,2500,5001,2500,0,1,2502,3634196,3.634196
5700,1300,2500,7410000,2,20006,5003,1,199280000,199280000,7501,2500,5001,2500,0,1,2502,3561158,3.561158
5700,1300,2500,7410000,2,20006,5003,1,199280000,199280000,7501,2500,5001,2500,0,1,2502,3592620,3.59262
5700,1300,2500,7410000,2,20006,5003,1,199280000,199280000,7501,2500,5001,2500,0,1,2502,3512216,3.512216
5700,1300,2500,7410000,2,20006,5003,1,199280000,199280000,7501,2500,5001,2500,0,1,2502,3628523,3.628523
5700,1300,2500,7410000,2,20006,5003,1,199280000,199280000,7501,2500,5001,2500,0,1,2502,3461571,3.461571
5700,1300,2500,7410000,2,20006,5003,1,199280000,199280000,7501,2500,5001,2500,0,1,2502,3682711,3.682711
5700,1300,2900,7410000,2,23206,5803,1,221680000,221680000,8701,2900,5801,2900,0,1,2902,4072065,4.072065
5700,1300,2900,7410000,2,23206,5803,1,221680000,221680000,8701,2900,5801,2900,0,1,2902,4226185,4.226185
5700,1300,2900,7410000,2,23206,5803,1,221680000,221680000,8701,2900,5801,2900,0,1,2902,4131969,4.131969
5700,1300,2900,7410000,2,23206,5803,1,221680000,221680000,8701,2900,5801,2900,0,1,2902,4163135,4.163135
5700,1300,2900,7410000,2,23206,5803,1,221680000,221680000,8701,2900,5801,2900,0,1,2902,4061957,4.061957
5700,1300,2900,7410000,2,23206,5803,1,221680000,221680000,8701,2900,5801,2900,0,1,2902,4217143,4.217143
5700,1300,2900,7410000,2,23206,5803,1,221680000,221680000,8701,2900,5801,2900,0,1,2902,4061053,4.061053
5700,1300,2900,7410000,2,23206,5803,1,221680000,221680000,8701,2900,5801,2900,0,1,2902,4251563,4.251563
5700,1300,3300,7410000,2,26406,6603,1,244080000,244080000,9901,3300,6601,3300,0,1,3302,4629607,4.629607
5700,1300,3300,7410000,2,26406,6603,1,244080000,244080000,9901,3300,6601,3300,0,1,3302,4779536,4.779536
5700,1300,3300,7410000,2,26406,6603,1,244080000,244080000,9901,3300,6601,3300,0,1,3302,4682524,4.682524
5700,1300,3300,7410000,2,26406,6603,1,244080000,244080000,9901,3300,6601,3300,0,1,3302,4735063,4.735063
5700,1300,3300,7410000,2,26406,6603,1,244080000,244080000,9901,3300,6601,3300,0,1,3302,4611877,4.611877
5700,1300,3300,7410000,2,26406,6603,1,244080000,244080000,9901,3300,6601,3300,0,1,3302,4788391,4.788391
5700,1300,3300,7410000,2,26406,6603,1,244080000,244080000,9901,3300,6601,3300,0,1,3302,4590024,4.590024
5700,1300,3300,7410000,2,26406,6603,1,244080000,244080000,9901,3300,6601,3300,0,1,3302,4833992,4.833992
5700,1300,3700,7410000,2,29606,7403,1,266480000,266480000,11101,3700,7401,3700,0,1,3702,5161489,5.161489
5700,1300,3700,7410000,2,29606,7403,1,266480000,266480000,11101,3700,7401,3700,0,1,3702,5347124,5.347124
5700,1300,3700,7410000,2,29606,7403,1,266480000,266480000,11101,3700,7401,3700,0,1,3702,5234570,5.23457
5700,1300,3700,7410000,2,29606,7403,1,266480000,266480000,11101,3700,7401,3700,0,1,3702,5290266,5.290266
5700,1300,3700,7410000,2,29606,7403,1,266480000,266480000,11101,3700,7401,3700,0,1,3702,5152453,5.152453
5700,1300,3700,7410000,2,29606,7403,1,266480000,266480000,11101,3700,7401,3700,0,1,3702,5356338,5.356338
5700,1300,3700,7410000,2,29606,7403,1,266480000,266480000,11101,3700,7401,3700,0,1,3702,5112421,5.112421
5700,1300,3700,7410000,2,29606,7403,1,266480000,266480000,11101,3700,7401,3700,0,1,3702,5406704,5.406704
5700,1300,4100,7410000,2,32806,8203,1,288880000,288880000,12301,4100,8201,4100,0,1,4102,5840883,5.840883
5700,1300,4100,7410000,2,32806,8203,1,288880000,288880000,12301,4100,8201,4100,0,1,4102,6032322,6.032322
5700,1300,4100,7410000,2,32806,8203,1,288880000,288880000,12301,4100,8201,4100,0,1,4102,5944913,5.944913
5700,1300,4100,7410000,2,32806,8203,1,288880000,288880000,12301,4100,8201,4100,0,1,4102,5992145,5.992145
5700,1300,4100,7410000,2,32806,8203,1,288880000,288880000,12301,4100,8201,4100,0,1,4102,5872698,5.872698
5700,1300,4100,7410000,2,32806,8203,1,288880000,288880000,12301,4100,8201,4100,0,1,4102,6043311,6.043311
5700,1300,4100,7410000,2,32806,8203,1,288880000,288880000,12301,4100,8201,4100,0,1,4102,5830846,5.830846
5700,1300,4100,7410000,2,32806,8203,1,288880000,288880000,12301,4100,8201,4100,0,1,4102,6100979,6.100979
5700,1300,4500,7410000,2,36006,9003,1,311280000,311280000,13501,4500,9001,4500,0,1,4502,6263669,6.263669
5700,1300,4500,7410000,2,36006,9003,1,311280000,311280000,13501,4500,9001,4500,0,1,4502,6490326,6.490326
5700,1300,4500,7410000,2,36006,9003,1,311280000,311280000,13501,4500,9001,4500,0,1,4502,6340720,6.34072
5700,1300,4500,7410000,2,36006,9003,1,311280000,311280000,13501,4500,9001,4500,0,1,4502,6428988,6.428988
5700,1300,4500,7410000,2,36006,9003,1,311280000,311280000,13501,4500,9001,4500,0,1,4502,6258164,6.258164
5700,1300,4500,7410000,2,36006,9003,1,311280000,311280000,13501,4500,9001,4500,0,1,4502,6502460,6.50246
5700,1300,4500,7410000,2,36006,9003,1,311280000,311280000,13501,4500,9001,4500,0,1,4502,6201475,6.201475
5700,1300,4500,7410000,2,36006,9003,1,311280000,311280000,13501,4500,9001,4500,0,1,4502,6563514,6.563514
5700,1300,4900,7410000,2,39206,9803,1,333680000,333680000,14701,4900,9801,4900,0,1,4902,6965396,6.965396
5700,1300,4900,7410000,2,39206,9803,1,333680000,333680000,14701,4900,9801,4900,0,1,4902,7208697,7.208697
5700,1300,4900,7410000,2,39206,9803,1,333680000,333680000,14701,4900,9801,4900,0,1,4902,7025755,7.025755
5700,1300,4900,7410000,2,39206,9803,1,333680000,333680000,14701,4900,9801,4900,0,1,4902,7101769,7.101769
5700,1300,4900,7410000,2,39206,9803,1,333680000,333680000,14701,4900,9801,4900,0,1,4902,6978479,6.978479
5700,1300,4900,7410000,2,39206,9803,1,333680000,333680000,14701,4900,9801,4900,0,1,4902,7185567,7.185567
5700,1300,4900,7410000,2,39206,9803,1,333680000,333680000,14701,4900,9801,4900,0,1,4902,6946965,6.946965
5700,1300,4900,7410000,2,39206,9803,1,333680000,333680000,14701,4900,9801,4900,0,1,4902,7238478,7.238478
5700,1300,5300,7410000,2,42406,10603,1,356080000,356080000,15901,5300,10601,5300,0,1,5302,7375004,7.375004
5700,1300,5300,7410000,2,42406,10603,1,356080000,356080000,15901,5300,10601,5300,0,1,5302,7643032,7.643032
5700,1300,5300,7410000,2,42406,10603,1,356080000,356080000,15901,5300,10601,5300,0,1,5302,7446639,7.446639
5700,1300,5300,7410000,2,42406,10603,1,356080000,356080000,15901,5300,10601,5300,0,1,5302,7567463,7.567463
5700,1300,5300,7410000,2,42406,10603,1,356080000,356080000,15901,5300,10601,5300,0,1,5302,7357571,7.357571
5700,1300,5300,7410000,2,42406,10603,1,356080000,356080000,15901,5300,10601,5300,0,1,5302,7654955,7.654955
5700,1300,5300,7410000,2,42406,10603,1,356080000,356080000,15901,5300,10601,5300,0,1,5302,7291813,7.291813
5700,1300,5300,7410000,2,42406,10603,1,356080000,356080000,15901,5300,10601,5300,0,1,5302,7732009,7.732009
5700,1300,5700,7410000,2,45606,11403,1,378480000,378480000,17101,5700,11401,5700,0,1,5702,8054499,8.054499
5700,1300,5700,7410000,2,45606,11403,1,378480000,378480000,17101,5700,11401,5700,0,1,5702,8324070,8.32407
5700,1300,5700,7410000,2,45606,11403,1,378480000,378480000,17101,5700,11401,5700,0,1,5702,8165687,8.165687
5700,1300,5700,7410000,2,45606,11403,1,378480000,378480000,17101,5700,11401,5700,0,1,5702,8254360,8.25436
5700,1300,5700,7410000,2,45606,11403,1,378480000,378480000,17101,5700,11401,5700,0,1,5702,8087625,8.087625
5700,1300,5700,7410000,2,45606,11403,1,378480000,378480000,17101,5700,11401,5700,0,1,5702,8342409,8.342409
5700,1300,5700,7410000,2,45606,11403,1,378480000,378480000,17101,5700,11401,5700,0,1,5702,8012842,8.012842
5700,1300,5700,7410000,2,45606,11403,1,378480000,378480000,17101,5700,11401,5700,0,1,5702,8418898,8.418898
5700,1300,6100,7410000,2,48806,12203,1,400880000,400880000,18301,6100,12201,6100,0,1,6102,8491966,8.491966
5700,1300,6100,7410000,2,48806,12203,1,400880000,400880000,18301,6100,12201,6100,0,1,6102,8788994,8.788994
5700,1300,6100,7410000,2,48806,12203,1,400880000,400880000,18301,6100,12201,6100,0,1,6102,8589034,8.589034
5700,1300,6100,7410000,2,48806,12203,1,400880000,400880000,18301,6100,12201,6100,0,1,6102,8710683,8.710683
5700,1300,6100,7410000,2,48806,12203,1,400880000,400880000,18301,6100,12201,6100,0,1,6102,8468737,8.468737
5700,1300,6100,7410000,2,48806,12203,1,400880000,400880000,18301,6100,12201,6100,0,1,6102,8808319,8.808319
5700,1300,6100,7410000,2,48806,12203,1,400880000,400880000,18301,6100,12201,6100,0,1,6102,8393549,8.393549
5700,1300,6100,7410000,2,48806,12203,1,400880000,400880000,18301,6100,12201,6100,0,1,6102,8900395,8.900395
5700,1300,6500,7410000,2,52006,13003,1,423280000,423280000,19501,6500,13001,6500,0,1,6502,9177300,9.1773
5700,1300,6500,7410000,2,52006,13003,1,423280000,423280000,19501,6500,13001,6500,0,1,6502,9442841,9.442841
5700,1300,6500,7410000,2,52006,13003,1,423280000,423280000,19501,6500,13001,6500,0,1,6502,9265704,9.265704
5700,1300,6500,7410000,2,52006,13003,1,423280000,423280000,19501,6500,13001,6500,0,1,6502,9373087,9.373087
5700,1300,6500,7410000,2,52006,13003,1,423280000,423280000,19501,6500,13001,6500,0,1,6502,9183598,9.183598
5700,1300,6500,7410000,2,52006,13003,1,423280000,423280000,19501,6500,13001,6500,0,1,6502,9472084,9.472084
5700,1300,6500,7410000,2,52006,13003,1,423280000,423280000,19501,6500,13001,6500,0,1,6502,9129948,9.129948
5700,1300,6500,7410000,2,52006,13003,1,423280000,423280000,19501,6500,13001,6500,0,1,6502,9555855,9.555855
5700,1300,6900,7410000,2,55206,13803,1,445680000,445680000,20701,6900,13801,6900,0,1,6902,9718677,9.718677
5700,1300,6900,7410000,2,55206,13803,1,445680000,445680000,20701,6900,13801,6900,0,1,6902,10068537,10.068537
5700,1300,6900,7410000,2,55206,13803,1,445680000,445680000,20701,6900,13801,6900,0,1,6902,9811156,9.811156
5700,1300,6900,7410000,2,55206,13803,1,445680000,445680000,20701,6900,13801,6900,0,1,6902,9925239,9.925239
5700,1300,6900,7410000,2,55206,13803,1,445680000,445680000,20701,6900,13801,6900,0,1,6902,9679475,9.679475
5700,1300,6900,7410000,2,55206,13803,1,445680000,445680000,20701,6900,13801,6900,0,1,6902,10090117,10.090117
5700,1300,6900,7410000,2,55206,13803,1,445680000,445680000,20701,6900,13801,6900,0,1,6902,9667419,9.667419
5700,1300,6900,7410000,2,55206,13803,1,445680000,445680000,20701,6900,13801,6900,0,1,6902,10180280,10.18028
5700,900,500,5130000,2,4006,1003,1,67440000,67440000,1501,500,1001,500,0,1,502,520187,0.520187
5700,900,500,5130000,2,4006,1003,1,67440000,67440000,1501,500,1001,500,0,1,502,533105,0.533105
5700,900,500,5130000,2,4006,1003,1,67440000,67440000,1501,500,1001,500,0,1,502,537336,0.537336
5700,900,500,5130000,2,4006,1003,1,67440000,67440000,1501,500,1001,500,0,1,502,537125,0.537125
5700,900,500,5130000,2,4006,1003,1,67440000,67440000,1501,500,1001,500,0,1,502,528417,0.528417
5700,900,500,5130000,2,4006,1003,1,67440000,67440000,1501,500,1001,500,0,1,502,536913,0.536913
5700,900,500,5130000,2,4006,1003,1,67440000,67440000,1501,500,1001,500,0,1,502,524340,0.52434
5700,900,500,5130000,2,4006,1003,1,67440000,67440000,1501,500,1001,500,0,1,502,542432,0.542432
5700,900,900,5130000,2,7206,1803,1,88560000,88560000,2701,900,1801,900,0,1,902,909228,0.909228
5700,900,900,5130000,2,7206,1803,1,88560000,88560000,2701,900,1801,900,0,1,902,938055,0.938055
5700,900,900,5130000,2,7206,1803,1,88560000,88560000,2701,900,1801,900,0,1,902,919070,0.91907
5700,900,900,5130000,2,7206,1803,1,88560000,88560000,2701,900,1801,900,0,1,902,929252,0.929252
5700,900,900,5130000,2,7206,1803,1,88560000,88560000,2701,900,1801,900,0,1,902,908909,0.908909
5700,900,900,5130000,2,7206,1803,1,88560000,88560000,2701,900,1801,900,0,1,902,934024,0.934024
5700,900,900,5130000,2,7206,1803,1,88560000,88560000,2701,900,1801,900,0,1,902,905236,0.905236
5700,900,900,5130000,2,7206,1803,1,88560000,88560000,2701,900,1801,900,0,1,902,946267,0.946267
5700,900,1300,5130000,2,10406,2603,1,109680000,109680000,3901,1300,2601,1300,0,1,1302,1286518,1.286518
5700,900,1300,5130000,2,10406,2603,1,109680000,109680000,3901,1300,2601,1300,0,1,1302,1346067,1.346067
5700,900,1300,5130000,2,10406,2603,1,109680000,109680000,3901,1300,2601,1300,0,1,1302,1327258,1.327258
5700,900,1300,5130000,2,10406,2603,1,109680000,109680000,3901,1300,2601,1300,0,1,1302,1322832,1.322832
5700,900,1300,5130000,2,10406,2603,1,109680000,109680000,3901,1300,2601,1300,0,1,1302,1304032,1.304032
5700,900,1300,5130000,2,10406,2603,1,109680000,109680000,3901,1300,2601,1300,0,1,1302,1331466,1.331466
5700,900,1300,5130000,2,10406,2603,1,109680000,109680000,3901,1300,2601,1300,0,1,1302,1291539,1.291539
5700,900,1300,5130000,2,10406,2603,1,109680000,109680000,3901,1300,2601,1300,0,1,1302,1351013,1.351013
5700,900,1700,5130000,2,13606,3403,1,130800000,130800000,5101,1700,3401,1700,0,1,1702,1669810,1.66981
5700,900,1700,5130000,2,13606,3403,1,130800000,130800000,5101,1700,3401,1700,0,1,1702,1743109,1.743109
5700,900,1700,5130000,2,13606,3403,1,130800000,130800000,5101,1700,3401,1700,0,1,1702,1708741,1.708741
5700,900,1700,5130000,2,13606,3403,1,130800000,130800000,5101,1700,3401,1700,0,1,1702,1713943,1.713943
5700,900,1700,5130000,2,13606,3403,1,130800000,130800000,5101,1700,3401,1700,0,1,1702,1676989,1.676989
5700,900,1700,5130000,2,13606,3403,1,130800000,130800000,5101,1700,3401,1700,0,1,1702,1737851,1.737851
5700,900,1700,5130000,2,13606,3403,1,130800000,130800000,5101,1700,3401,1700,0,1,1702,1662125,1.662125
5700,900,1700,5130000,2,13606,3403,1,130800000,130800000,5101,1700,3401,1700,0,1,1702,1752352,1.752352
5700,900,2100,5130000,2,16806,4203,1,151920000,151920000,6301,2100,4201,2100,0,1,2102,2051221,2.051221
5700,900,2100,5130000,2,16806,4203,1,151920000,151920000,6301,2100,4201,2100,0,1,2102,2143192,2.143192
5700,900,2100,5130000,2,16806,4203,1,151920000,151920000,6301,2100,4201,2100,0,1,2102,2094858,2.094858
5700,900,2100,5130000,2,16806,4203,1,151920000,151920000,6301,2100,4201,2100,0,1,2102,2108825,2.108825
5700,900,2100,5130000,2,16806,4203,1,151920000,151920000,6301,2100,4201,2100,0,1,2102,2056971,2.056971
5700,900,2100,5130000,2,16806,4203,1,151920000,151920000,6301,2100,4201,2100,0,1,2102,2135769,2.135769
5700,900,2100,5130000,2,16806,4203,1,151920000,151920000,6301,2100,4201,2100,0,1,2102,2044499,2.044499
5700,900,2100,5130000,2,16806,4203,1,151920000,151920000,6301,2100,4201,2100,0,1,2102,2148704,2.148704
5700,900,2500,5130000,2,20006,5003,1,173040000,173040000,7501,2500,5001,2500,0,1,2502,2441278,2.441278
5700,900,2500,5130000,2,20006,5003,1,173040000,173040000,7501,2500,5001,2500,0,1,2502,2538005,2.538005
5700,900,2500,5130000,2,20006,5003,1,173040000,173040000,7501,2500,5001,2500,0,1,2502,2483574,2.483574
5700,900,2500,5130000,2,20006,5003,1,173040000,173040000,7501,2500,5001,2500,0,1,2502,2501403,2.501403
5700,900,2500,5130000,2,20006,5003,1,173040000,173040000,7501,2500,5001,2500,0,1,2502,2452569,2.452569
5700,900,2500,5130000,2,20006,5003,1,173040000,173040000,7501,2500,5001,2500,0,1,2502,2530581,2.530581
5700,900,2500,5130000,2,20006,5003,1,173040000,173040000,7501,2500,5001,2500,0,1,2502,2426335,2.426335
5700,900,2500,5130000,2,20006,5003,1,173040000,173040000,7501,2500,5001,2500,0,1,2502,2547771,2.547771
5700,900,2900,5130000,2,23206,5803,1,194160000,194160000,8701,2900,5801,2900,0,1,2902,2825166,2.825166
5700,900,2900,5130000,2,23206,5803,1,194160000,194160000,8701,2900,5801,2900,0,1,2902,2922201,2.922201
5700,900,2900,5130000,2,23206,5803,1,194160000,194160000,8701,2900,5801,2900,0,1,2902,2861867,2.861867
5700,900,2900,5130000,2,23206,5803,1,194160000,194160000,8701,2900,5801,2900,0,1,2902,2897604,2.897604
5700,900,2900,5130000,2,23206,5803,1,194160000,194160000,8701,2900,5801,2900,0,1,2902,2829003,2.829003
5700,900,2900,5130000,2,23206,5803,1,194160000,194160000,8701,2900,5801,2900,0,1,2902,2926383,2.926383
5700,900,2900,5130000,2,23206,5803,1,194160000,194160000,8701,2900,5801,2900,0,1,2902,2800577,2.800577
5700,900,2900,5130000,2,23206,5803,1,194160000,194160000,8701,2900,5801,2900,0,1,2902,2959498,2.959498
5700,900,3300,5130000,2,26406,6603,1,215280000,215280000,9901,3300,6601,3300,0,1,3302,3209142,3.209142
5700,900,3300,5130000,2,26406,6603,1,215280000,215280000,9901,3300,6601,3300,0,1,3302,3322736,3.322736
5700,900,3300,5130000,2,26406,6603,1,215280000,215280000,9901,3300,6601,3300,0,1,3302,3263909,3.263909
5700,900,3300,5130000,2,26406,6603,1,215280000,215280000,9901,3300,6601,3300,0,1,3302,3294580,3.29458
5700,900,3300,5130000,2,26406,6603,1,215280000,215280000,9901,3300,6601,3300,0,1,3302,3228408,3.228408
5700,900,3300,5130000,2,26406,6603,1,215280000,215280000,9901,3300,6601,3300,0,1,3302,3329577,3.329577
5700,900,3300,5130000,2,26406,6603,1,215280000,215280000,9901,3300,6601,3300,0,1,3302,3183858,3.183858
5700,900,3300,5130000,2,26406,6603,1,215280000,215280000,9901,3300,6601,3300,0,1,3302,3359668,3.359668
5700,900,3700,5130000,2,29606,7403,1,236400000,236400000,11101,3700,7401,3700,0,1,3702,3739486,3.739486
5700,900,3700,5130000,2,29606,7403,1,236400000,236400000,11101,3700,7401,3700,0,1,3702,3842015,3.842015
5700,900,3700,5130000,2,29606,7403,1,236400000,236400000,11101,3700,7401,3700,0,1,3702,3671197,3.671197
5700,900,3700,5130000,2,29606,7403,1,236400000,236400000,11101,3700,7401,3700,0,1,3702,3824289,3.824289
5700,900,3700,5130000,2,29606,7403,1,236400000,236400000,11101,3700,7401,3700,0,1,3702,3784442,3.784442
5700,900,3700,5130000,2,29606,7403,1,236400000,236400000,11101,3700,7401,3700,0,1,3702,3860325,3.860325
5700,900,3700,5130000,2,29606,7403,1,236400000,236400000,11101,3700,7401,3700,0,1,3702,3617104,3.617104
5700,900,3700,5130000,2,29606,7403,1,236400000,236400000,11101,3700,7401,3700,0,1,3702,3882577,3.882577
5700,900,4100,5130000,2,32806,8203,1,257520000,257520000,12301,4100,8201,4100,0,1,4102,4008852,4.008852
5700,900,4100,5130000,2,32806,8203,1,257520000,257520000,12301,4100,8201,4100,0,1,4102,4130062,4.130062
5700,900,4100,5130000,2,32806,8203,1,257520000,257520000,12301,4100,8201,4100,0,1,4102,4043861,4.043861
5700,900,4100,5130000,2,32806,8203,1,257520000,257520000,12301,4100,8201,4100,0,1,4102,4090838,4.090838
5700,900,4100,5130000,2,32806,8203,1,257520000,257520000,12301,4100,8201,4100,0,1,4102,3989058,3.989058
5700,900,4100,5130000,2,32806,8203,1,257520000,257520000,12301,4100,8201,4100,0,1,4102,4153243,4.153243
5700,900,4100,5130000,2,32806,8203,1,257520000,257520000,12301,4100,8201,4100,0,1,4102,3957282,3.957282
5700,900,4100,5130000,2,32806,8203,1,257520000,257520000,12301,4100,8201,4100,0,1,4102,4172664,4.172664
5700,900,4500,5130000,2,36006,9003,1,278640000,278640000,13501,4500,9001,4500,0,1,4502,4384773,4.384773
5700,900,4500,5130000,2,36006,9003,1,278640000,278640000,13501,4500,9001,4500,0,1,4502,4526270,4.52627
5700,900,4500,5130000,2,36006,9003,1,278640000,278640000,13501,4500,9001,4500,0,1,4502,4440508,4.440508
5700,900,4500,5130000,2,36006,9003,1,278640000,278640000,13501,4500,9001,4500,0,1,4502,4479472,4.479472
5700,900,4500,5130000,2,36006,9003,1,278640000,278640000,13501,4500,9001,4500,0,1,4502,4364093,4.364093
5700,900,4500,5130000,2,36006,9003,1,278640000,278640000,13501,4500,9001,4500,0,1,4502,4553155,4.553155
5700,900,4500,5130000,2,36006,9003,1,278640000,278640000,13501,4500,9001,4500,0,1,4502,4337507,4.337507
5700,900,4500,5130000,2,36006,9003,1,278640000,278640000,13501,4500,9001,4500,0,1,4502,4581525,4.581525
5700,900,4900,5130000,2,39206,9803,1,299760000,299760000,14701,4900,9801,4900,0,1,4902,4753049,4.753049
5700,900,4900,5130000,2,39206,9803,1,299760000,299760000,14701,4900,9801,4900,0,1,4902,4931015,4.931015
5700,900,4900,5130000,2,39206,9803,1,299760000,299760000,14701,4900,9801,4900,0,1,4902,4815325,4.815325
5700,900,4900,5130000,2,39206,9803,1,299760000,299760000,14701,4900,9801,4900,0,1,4902,4872991,4.872991
5700,900,4900,5130000,2,39206,9803,1,299760000,299760000,14701,4900,9801,4900,0,1,4902,4730888,4.730888
5700,900,4900,5130000,2,39206,9803,1,299760000,299760000,14701,4900,9801,4900,0,1,4902,4935064,4.935064
5700,900,4900,5130000,2,39206,9803,1,299760000,299760000,14701,4900,9801,4900,0,1,4902,4699951,4.699951
5700,900,4900,5130000,2,39206,9803,1,299760000,299760000,14701,4900,9801,4900,0,1,4902,4999400,4.9994
5700,900,5300,5130000,2,42406,10603,1,320880000,320880000,15901,5300,10601,5300,0,1,5302,5283376,5.283376
5700,900,5300,5130000,2,42406,10603,1,320880000,320880000,15901,5300,10601,5300,0,1,5302,5484277,5.484277
5700,900,5300,5130000,2,42406,10603,1,320880000,320880000,15901,5300,10601,5300,0,1,5302,5313914,5.313914
5700,900,5300,5130000,2,42406,10603,1,320880000,320880000,15901,5300,10601,5300,0,1,5302,5393269,5.393269
5700,900,5300,5130000,2,42406,10603,1,320880000,320880000,15901,5300,10601,5300,0,1,5302,5287328,5.287328
5700,900,5300,5130000,2,42406,10603,1,320880000,320880000,15901,5300,10601,5300,0,1,5302,5508805,5.508805
5700,900,5300,5130000,2,42406,10603,1,320880000,320880000,15901,5300,10601,5300,0,1,5302,5279435,5.279435
5700,900,5300,5130000,2,42406,10603,1,320880000,320880000,15901,5300,10601,5300,0,1,5302,5501056,5.501056
5700,900,5700,5130000,2,45606,11403,1,342000000,342000000,17101,5700,11401,5700,0,1,5702,5542228,5.542228
5700,900,5700,5130000,2,45606,11403,1,342000000,342000000,17101,5700,11401,5700,0,1,5702,5722928,5.722928
5700,900,5700,5130000,2,45606,11403,1,342000000,342000000,17101,5700,11401,5700,0,1,5702,5561570,5.56157
5700,900,5700,5130000,2,45606,11403,1,342000000,342000000,17101,5700,11401,5700,0,1,5702,5687144,5.687144
5700,900,5700,5130000,2,45606,11403,1,342000000,342000000,17101,5700,11401,5700,0,1,5702,5527133,5.527133
5700,900,5700,5130000,2,45606,11403,1,342000000,342000000,17101,5700,11401,5700,0,1,5702,5761714,5.761714
5700,900,5700,5130000,2,45606,11403,1,342000000,342000000,17101,5700,11401,5700,0,1,5702,5472011,5.472011
5700,900,5700,5130000,2,45606,11403,1,342000000,342000000,17101,5700,11401,5700,0,1,5702,5786240,5.78624
5700,900,6100,5130000,2,48806,12203,1,363120000,363120000,18301,6100,12201,6100,0,1,6102,5914170,5.91417
5700,900,6100,5130000,2,48806,12203,1,363120000,363120000,18301,6100,12201,6100,0,1,6102,6145654,6.145654
5700,900,6100,5130000,2,48806,12203,1,363120000,363120000,18301,6100,12201,6100,0,1,6102,5967294,5.967294
5700,900,6100,5130000,2,48806,12203,1,363120000,363120000,18301,6100,12201,6100,0,1,6102,6078672,6.078672
5700,900,6100,5130000,2,48806,12203,1,363120000,363120000,18301,6100,12201,6100,0,1,6102,5918468,5.918468
5700,900,6100,5130000,2,48806,12203,1,363120000,363120000,18301,6100,12201,6100,0,1,6102,6156472,6.156472
5700,900,6100,5130000,2,48806,12203,1,363120000,363120000,18301,6100,12201,6100,0,1,6102,5841754,5.841754
5700,900,6100,5130000,2,48806,12203,1,363120000,363120000,18301,6100,12201,6100,0,1,6102,6187421,6.187421
5700,900,6500,5130000,2,52006,13003,1,384240000,384240000,19501,6500,13001,6500,0,1,6502,6432533,6.432533
5700,900,6500,5130000,2,52006,13003,1,384240000,384240000,19501,6500,13001,6500,0,1,6502,6665747,6.665747
5700,900,6500,5130000,2,52006,13003,1,384240000,384240000,19501,6500,13001,6500,0,1,6502,6515150,6.51515
5700,900,6500,5130000,2,52006,13003,1,384240000,384240000,19501,6500,13001,6500,0,1,6502,6560646,6.560646
5700,900,6500,5130000,2,52006,13003,1,384240000,384240000,19501,6500,13001,6500,0,1,6502,6454476,6.454476
5700,900,6500,5130000,2,52006,13003,1,384240000,384240000,19501,6500,13001,6500,0,1,6502,6682545,6.682545
5700,900,6500,5130000,2,52006,13003,1,384240000,384240000,19501,6500,13001,6500,0,1,6502,6413495,6.413495
5700,900,6500,5130000,2,52006,13003,1,384240000,384240000,19501,6500,13001,6500,0,1,6502,6721505,6.721505
5700,900,6900,5130000,2,55206,13803,1,405360000,405360000,20701,6900,13801,6900,0,1,6902,6691955,6.691955
5700,900,6900,5130000,2,55206,13803,1,405360000,405360000,20701,6900,13801,6900,0,1,6902,6932870,6.93287
5700,900,6900,5130000,2,55206,13803,1,405360000,405360000,20701,6900,13801,6900,0,1,6902,6754325,6.754325
5700,900,6900,5130000,2,55206,13803,1,405360000,405360000,20701,6900,13801,6900,0,1,6902,6870132,6.870132
5700,900,6900,5130000,2,55206,13803,1,405360000,405360000,20701,6900,13801,6900,0,1,6902,6654563,6.654563
5700,900,6900,5130000,2,55206,13803,1,405360000,405360000,20701,6900,13801,6900,0,1,6902,6975337,6.975337
5700,900,6900,5130000,2,55206,13803,1,405360000,405360000,20701,6900,13801,6900,0,1,6902,6602093,6.602093
5700,900,6900,5130000,2,55206,13803,1,405360000,405360000,20701,6900,13801,6900,0,1,6902,6997680,6.99768
5700,500,500,2850000,2,4006,1003,1,47600000,47600000,1501,500,1001,500,0,1,502,284725,0.284725
5700,500,500,2850000,2,4006,1003,1,47600000,47600000,1501,500,1001,500,0,1,502,298871,0.298871
5700,500,500,2850000,2,4006,1003,1,47600000,47600000,1501,500,1001,500,0,1,502,302056,0.302056
5700,500,500,2850000,2,4006,1003,1,47600000,47600000,1501,500,1001,500,0,1,502,302388,0.302388
5700,500,500,2850000,2,4006,1003,1,47600000,47600000,1501,500,1001,500,0,1,502,299923,0.299923
5700,500,500,2850000,2,4006,1003,1,47600000,47600000,1501,500,1001,500,0,1,502,302272,0.302272
5700,500,500,2850000,2,4006,1003,1,47600000,47600000,1501,500,1001,500,0,1,502,295530,0.29553
5700,500,500,2850000,2,4006,1003,1,47600000,47600000,1501,500,1001,500,0,1,502,299471,0.299471
5700,500,900,2850000,2,7206,1803,1,67440000,67440000,2701,900,1801,900,0,1,902,504605,0.504605
5700,500,900,2850000,2,7206,1803,1,67440000,67440000,2701,900,1801,900,0,1,902,517126,0.517126
5700,500,900,2850000,2,7206,1803,1,67440000,67440000,2701,900,1801,900,0,1,902,509638,0.509638
5700,500,900,2850000,2,7206,1803,1,67440000,67440000,2701,900,1801,900,0,1,902,520048,0.520048
5700,500,900,2850000,2,7206,1803,1,67440000,67440000,2701,900,1801,900,0,1,902,514277,0.514277
5700,500,900,2850000,2,7206,1803,1,67440000,67440000,2701,900,1801,900,0,1,902,520269,0.520269
5700,500,900,2850000,2,7206,1803,1,67440000,67440000,2701,900,1801,900,0,1,902,504198,0.504198
5700,500,900,2850000,2,7206,1803,1,67440000,67440000,2701,900,1801,900,0,1,902,522403,0.522403
5700,500,1300,2850000,2,10406,2603,1,87280000,87280000,3901,1300,2601,1300,0,1,1302,720645,0.720645
5700,500,1300,2850000,2,10406,2603,1,87280000,87280000,3901,1300,2601,1300,0,1,1302,744809,0.744809
5700,500,1300,2850000,2,10406,2603,1,87280000,87280000,3901,1300,2601,1300,0,1,1302,728720,0.72872
5700,500,1300,2850000,2,10406,2603,1,87280000,87280000,3901,1300,2601,1300,0,1,1302,750951,0.750951
5700,500,1300,2850000,2,10406,2603,1,87280000,87280000,3901,1300,2601,1300,0,1,1302,725820,0.72582
5700,500,1300,2850000,2,10406,2603,1,87280000,87280000,3901,1300,2601,1300,0,1,1302,745157,0.745157
5700,500,1300,2850000,2,10406,2603,1,87280000,87280000,3901,1300,2601,1300,0,1,1302,720942,0.720942
5700,500,1300,2850000,2,10406,2603,1,87280000,87280000,3901,1300,2601,1300,0,1,1302,756223,0.756223
5700,500,1700,2850000,2,13606,3403,1,107120000,107120000,5101,1700,3401,1700,0,1,1702,940061,0.940061
5700,500,1700,2850000,2,13606,3403,1,107120000,107120000,5101,1700,3401,1700,0,1,1702,970177,0.970177
5700,500,1700,2850000,2,13606,3403,1,107120000,107120000,5101,1700,3401,1700,0,1,1702,954994,0.954994
5700,500,1700,2850000,2,13606,3403,1,107120000,107120000,5101,1700,3401,1700,0,1,1702,972562,0.972562
5700,500,1700,2850000,2,13606,3403,1,107120000,107120000,5101,1700,3401,1700,0,1,1702,944419,0.944419
5700,500,1700,2850000,2,13606,3403,1,107120000,107120000,5101,1700,3401,1700,0,1,1702,965095,0.965095
5700,500,1700,2850000,2,13606,3403,1,107120000,107120000,5101,1700,3401,1700,0,1,1702,939636,0.939636
5700,500,1700,2850000,2,13606,3403,1,107120000,107120000,5101,1700,3401,1700,0,1,1702,984486,0.984486
5700,500,2100,2850000,2,16806,4203,1,126960000,126960000,6301,2100,4201,2100,0,1,2102,1155868,1.155868
5700,500,2100,2850000,2,16806,4203,1,126960000,126960000,6301,2100,4201,2100,0,1,2102,1197300,1.1973
5700,500,2100,2850000,2,16806,4203,1,126960000,126960000,6301,2100,4201,2100,0,1,2102,1185397,1.185397
5700,500,2100,2850000,2,16806,4203,1,126960000,126960000,6301,2100,4201,2100,0,1,2102,1192479,1.192479
5700,500,2100,2850000,2,16806,4203,1,126960000,126960000,6301,2100,4201,2100,0,1,2102,1164236,1.164236
5700,500,2100,2850000,2,16806,4203,1,126960000,126960000,6301,2100,4201,2100,0,1,2102,1192812,1.192812
5700,500,2100,2850000,2,16806,4203,1,126960000,126960000,6301,2100,4201,2100,0,1,2102,1152860,1.15286
5700,500,2100,2850000,2,16806,4203,1,126960000,126960000,6301,2100,4201,2100,0,1,2102,1207816,1.207816
5700,500,2500,2850000,2,20006,5003,1,146800000,146800000,7501,2500,5001,2500,0,1,2502,1369720,1.36972
5700,500,2500,2850000,2,20006,5003,1,146800000,146800000,7501,2500,5001,2500,0,1,2502,1438058,1.438058
5700,500,2500,2850000,2,20006,5003,1,146800000,146800000,7501,2500,5001,2500,0,1,2502,1402955,1.402955
5700,500,2500,2850000,2,20006,5003,1,146800000,146800000,7501,2500,5001,2500,0,1,2502,1423939,1.423939
5700,500,2500,2850000,2,20006,5003,1,146800000,146800000,7501,2500,5001,2500,0,1,2502,1383665,1.383665
5700,500,2500,2850000,2,20006,5003,1,146800000,146800000,7501,2500,5001,2500,0,1,2502,1428972,1.428972
5700,500,2500,2850000,2,20006,5003,1,146800000,146800000,7501,2500,5001,2500,0,1,2502,1359055,1.359055
5700,500,2500,2850000,2,20006,5003,1,146800000,146800000,7501,2500,5001,2500,0,1,2502,1440469,1.440469
5700,500,2900,2850000,2,23206,5803,1,166640000,166640000,8701,2900,5801,2900,0,1,2902,1630745,1.630745
5700,500,2900,2850000,2,23206,5803,1,166640000,166640000,8701,2900,5801,2900,0,1,2902,1720283,1.720283
5700,500,2900,2850000,2,23206,5803,1,166640000,166640000,8701,2900,5801,2900,0,1,2902,1746266,1.746266
5700,500,2900,2850000,2,23206,5803,1,166640000,166640000,8701,2900,5801,2900,0,1,2902,1771465,1.771465
5700,500,2900,2850000,2,23206,5803,1,166640000,166640000,8701,2900,5801,2900,0,1,2902,1751375,1.751375
5700,500,2900,2850000,2,23206,5803,1,166640000,166640000,8701,2900,5801,2900,0,1,2902,1769085,1.769085
5700,500,2900,2850000,2,23206,5803,1,166640000,166640000,8701,2900,5801,2900,0,1,2902,1691362,1.691362
5700,500,2900,2850000,2,23206,5803,1,166640000,166640000,8701,2900,5801,2900,0,1,2902,1757979,1.757979
5700,500,3300,2850000,2,26406,6603,1,186480000,186480000,9901,3300,6601,3300,0,1,3302,1813540,1.81354
5700,500,3300,2850000,2,26406,6603,1,186480000,186480000,9901,3300,6601,3300,0,1,3302,1875292,1.875292
5700,500,3300,2850000,2,26406,6603,1,186480000,186480000,9901,3300,6601,3300,0,1,3302,1853838,1.853838
5700,500,3300,2850000,2,26406,6603,1,186480000,186480000,9901,3300,6601,3300,0,1,3302,1870996,1.870996
5700,500,3300,2850000,2,26406,6603,1,186480000,186480000,9901,3300,6601,3300,0,1,3302,1824608,1.824608
5700,500,3300,2850000,2,26406,6603,1,186480000,186480000,9901,3300,6601,3300,0,1,3302,1890008,1.890008
5700,500,3300,2850000,2,26406,6603,1,186480000,186480000,9901,3300,6601,3300,0,1,3302,1802515,1.802515
5700,500,3300,2850000,2,26406,6603,1,186480000,186480000,9901,3300,6601,3300,0,1,3302,1885001,1.885001
5700,500,3700,2850000,2,29606,7403,1,206320000,206320000,11101,3700,7401,3700,0,1,3702,2039330,2.03933
5700,500,3700,2850000,2,29606,7403,1,206320000,206320000,11101,3700,7401,3700,0,1,3702,2102571,2.102571
5700,500,3700,2850000,2,29606,7403,1,206320000,206320000,11101,3700,7401,3700,0,1,3702,2062432,2.062432
5700,500,3700,2850000,2,29606,7403,1,206320000,206320000,11101,3700,7401,3700,0,1,3702,2084648,2.084648
5700,500,3700,2850000,2,29606,7403,1,206320000,206320000,11101,3700,7401,3700,0,1,3702,2036925,2.036925
5700,500,3700,2850000,2,29606,7403,1,206320000,206320000,11101,3700,7401,3700,0,1,3702,2116067,2.116067
5700,500,3700,2850000,2,29606,7403,1,206320000,206320000,11101,3700,7401,3700,0,1,3702,2005914,2.005914
5700,500,3700,2850000,2,29606,7403,1,206320000,206320000,11101,3700,7401,3700,0,1,3702,2123174,2.123174
5700,500,4100,2850000,2,32806,8203,1,226160000,226160000,12301,4100,8201,4100,0,1,4102,2246976,2.246976
5700,500,4100,2850000,2,32806,8203,1,226160000,226160000,12301,4100,8201,4100,0,1,4102,2324302,2.324302
5700,500,4100,2850000,2,32806,8203,1,226160000,226160000,12301,4100,8201,4100,0,1,4102,2280175,2.280175
5700,500,4100,2850000,2,32806,8203,1,226160000,226160000,12301,4100,8201,4100,0,1,4102,2310540,2.31054
5700,500,4100,2850000,2,32806,8203,1,226160000,226160000,12301,4100,8201,4100,0,1,4102,2260294,2.260294
5700,500,4100,2850000,2,32806,8203,1,226160000,226160000,12301,4100,8201,4100,0,1,4102,2339954,2.339954
5700,500,4100,2850000,2,32806,8203,1,226160000,226160000,12301,4100,8201,4100,0,1,4102,2227355,2.227355
5700,500,4100,2850000,2,32806,8203,1,226160000,226160000,12301,4100,8201,4100,0,1,4102,2345755,2.345755
5700,500,4500,2850000,2,36006,9003,1,246000000,246000000,13501,4500,9001,4500,0,1,4502,2466740,2.46674
5700,500,4500,2850000,2,36006,9003,1,246000000,246000000,13501,4500,9001,4500,0,1,4502,2548446,2.548446
5700,500,4500,2850000,2,36006,9003,1,246000000,246000000,13501,4500,9001,4500,0,1,4502,2498415,2.498415
5700,500,4500,2850000,2,36006,9003,1,246000000,246000000,13501,4500,9001,4500,0,1,4502,2541349,2.541349
5700,500,4500,2850000,2,36006,9003,1,246000000,246000000,13501,4500,9001,4500,0,1,4502,2491034,2.491034
5700,500,4500,2850000,2,36006,9003,1,246000000,246000000,13501,4500,9001,4500,0,1,4502,2543797,2.543797
5700,500,4500,2850000,2,36006,9003,1,246000000,246000000,13501,4500,9001,4500,0,1,4502,2436213,2.436213
5700,500,4500,2850000,2,36006,9003,1,246000000,246000000,13501,4500,9001,4500,0,1,4502,2577094,2.577094
5700,500,4900,2850000,2,39206,9803,1,265840000,265840000,14701,4900,9801,4900,0,1,4902,2684297,2.684297
5700,500,4900,2850000,2,39206,9803,1,265840000,265840000,14701,4900,9801,4900,0,1,4902,2783397,2.783397
5700,500,4900,2850000,2,39206,9803,1,265840000,265840000,14701,4900,9801,4900,0,1,4902,2717189,2.717189
5700,500,4900,2850000,2,39206,9803,1,265840000,265840000,14701,4900,9801,4900,0,1,4902,2760003,2.760003
5700,500,4900,2850000,2,39206,9803,1,265840000,265840000,14701,4900,9801,4900,0,1,4902,2700596,2.700596
5700,500,4900,2850000,2,39206,9803,1,265840000,265840000,14701,4900,9801,4900,0,1,4902,2780924,2.780924
5700,500,4900,2850000,2,39206,9803,1,265840000,265840000,14701,4900,9801,4900,0,1,4902,2666072,2.666072
5700,500,4900,2850000,2,39206,9803,1,265840000,265840000,14701,4900,9801,4900,0,1,4902,2806259,2.806259
5700,500,5300,2850000,2,42406,10603,1,285680000,285680000,15901,5300,10601,5300,0,1,5302,2912020,2.91202
5700,500,5300,2850000,2,42406,10603,1,285680000,285680000,15901,5300,10601,5300,0,1,5302,3022281,3.022281
5700,500,5300,2850000,2,42406,10603,1,285680000,285680000,15901,5300,10601,5300,0,1,5302,2968846,2.968846
5700,500,5300,2850000,2,42406,10603,1,285680000,285680000,15901,5300,10601,5300,0,1,5302,2988104,2.988104
5700,500,5300,2850000,2,42406,10603,1,285680000,285680000,15901,5300,10601,5300,0,1,5302,2929905,2.929905
5700,500,5300,2850000,2,42406,10603,1,285680000,285680000,15901,5300,10601,5300,0,1,5302,3036006,3.036006
5700,500,5300,2850000,2,42406,10603,1,285680000,285680000,15901,5300,10601,5300,0,1,5302,2890659,2.890659
5700,500,5300,2850000,2,42406,10603,1,285680000,285680000,15901,5300,10601,5300,0,1,5302,3029218,3.029218
5700,500,5700,2850000,2,45606,11403,1,305520000,305520000,17101,5700,11401,5700,0,1,5702,3136084,3.136084
5700,500,5700,2850000,2,45606,11403,1,305520000,305520000,17101,5700,11401,5700,0,1,5702,3247266,3.247266
5700,500,5700,2850000,2,45606,11403,1,305520000,305520000,17101,5700,11401,5700,0,1,5702,3158850,3.15885
5700,500,5700,2850000,2,45606,11403,1,305520000,305520000,17101,5700,11401,5700,0,1,5702,3209728,3.209728
5700,500,5700,2850000,2,45606,11403,1,305520000,305520000,17101,5700,11401,5700,0,1,5702,3131469,3.131469
5700,500,5700,2850000,2,45606,11403,1,305520000,305520000,17101,5700,11401,5700,0,1,5702,3263907,3.263907
5700,500,5700,2850000,2,45606,11403,1,305520000,305520000,17101,5700,11401,5700,0,1,5702,3082705,3.082705
5700,500,5700,2850000,2,45606,11403,1,305520000,305520000,17101,5700,11401,5700,0,1,5702,3268673,3.268673
5700,500,6100,2850000,2,48806,12203,1,325360000,325360000,18301,6100,12201,6100,0,1,6102,3506642,3.506642
5700,500,6100,2850000,2,48806,12203,1,325360000,325360000,18301,6100,12201,6100,0,1,6102,3561191,3.561191
5700,500,6100,2850000,2,48806,12203,1,325360000,325360000,18301,6100,12201,6100,0,1,6102,3546519,3.546519
5700,500,6100,2850000,2,48806,12203,1,325360000,325360000,18301,6100,12201,6100,0,1,6102,3585382,3.585382
5700,500,6100,2850000,2,48806,12203,1,325360000,325360000,18301,6100,12201,6100,0,1,6102,3540923,3.540923
5700,500,6100,2850000,2,48806,12203,1,325360000,325360000,18301,6100,12201,6100,0,1,6102,3580643,3.580643
5700,500,6100,2850000,2,48806,12203,1,325360000,325360000,18301,6100,12201,6100,0,1,6102,3554911,3.554911
5700,500,6100,2850000,2,48806,12203,1,325360000,325360000,18301,6100,12201,6100,0,1,6102,3595300,3.5953
5700,500,6500,2850000,2,52006,13003,1,345200000,345200000,19501,6500,13001,6500,0,1,6502,3560648,3.560648
5700,500,6500,2850000,2,52006,13003,1,345200000,345200000,19501,6500,13001,6500,0,1,6502,3681232,3.681232
5700,500,6500,2850000,2,52006,13003,1,345200000,345200000,19501,6500,13001,6500,0,1,6502,3595151,3.595151
5700,500,6500,2850000,2,52006,13003,1,345200000,345200000,19501,6500,13001,6500,0,1,6502,3666209,3.666209
5700,500,6500,2850000,2,52006,13003,1,345200000,345200000,19501,6500,13001,6500,0,1,6502,3570972,3.570972
5700,500,6500,2850000,2,52006,13003,1,345200000,345200000,19501,6500,13001,6500,0,1,6502,3691595,3.691595
5700,500,6500,2850000,2,52006,13003,1,345200000,345200000,19501,6500,13001,6500,0,1,6502,3528668,3.528668
5700,500,6500,2850000,2,52006,13003,1,345200000,345200000,19501,6500,13001,6500,0,1,6502,3724190,3.72419
5700,500,6900,2850000,2,55206,13803,1,365040000,365040000,20701,6900,13801,6900,0,1,6902,3789276,3.789276
5700,500,6900,2850000,2,55206,13803,1,365040000,365040000,20701,6900,13801,6900,0,1,6902,3913121,3.913121
5700,500,6900,2850000,2,55206,13803,1,365040000,365040000,20701,6900,13801,6900,0,1,6902,3856568,3.856568
5700,500,6900,2850000,2,55206,13803,1,365040000,365040000,20701,6900,13801,6900,0,1,6902,3886243,3.886243
5700,500,6900,2850000,2,55206,13803,1,365040000,365040000,20701,6900,13801,6900,0,1,6902,3812327,3.812327
5700,500,6900,2850000,2,55206,13803,1,365040000,365040000,20701,6900,13801,6900,0,1,6902,3918443,3.918443
5700,500,6900,2850000,2,55206,13803,1,365040000,365040000,20701,6900,13801,6900,0,1,6902,3754716,3.754716
5700,500,6900,2850000,2,55206,13803,1,365040000,365040000,20701,6900,13801,6900,0,1,6902,3985469,3.985469
5700,100,500,570000,2,4006,1003,1,27760000,27760000,1501,500,1001,500,0,1,502,69023,0.069023
5700,100,500,570000,2,4006,1003,1,27760000,27760000,1501,500,1001,500,0,1,502,71504,0.071504
5700,100,500,570000,2,4006,1003,1,27760000,27760000,1501,500,1001,500,0,1,502,72008,0.072008
5700,100,500,570000,2,4006,1003,1,27760000,27760000,1501,500,1001,500,0,1,502,74863,0.074863
5700,100,500,570000,2,4006,1003,1,27760000,27760000,1501,500,1001,500,0,1,502,72228,0.072228
5700,100,500,570000,2,4006,1003,1,27760000,27760000,1501,500,1001,500,0,1,502,72748,0.072748
5700,100,500,570000,2,4006,1003,1,27760000,27760000,1501,500,1001,500,0,1,502,69345,0.069345
5700,100,500,570000,2,4006,1003,1,27760000,27760000,1501,500,1001,500,0,1,502,74346,0.074346
5700,100,900,570000,2,7206,1803,1,46320000,46320000,2701,900,1801,900,0,1,902,119280,0.11928
5700,100,900,570000,2,7206,1803,1,46320000,46320000,2701,900,1801,900,0,1,902,119788,0.119788
5700,100,900,570000,2,7206,1803,1,46320000,46320000,2701,900,1801,900,0,1,902,119526,0.119526
5700,100,900,570000,2,7206,1803,1,46320000,46320000,2701,900,1801,900,0,1,902,122524,0.122524
5700,100,900,570000,2,7206,1803,1,46320000,46320000,2701,900,1801,900,0,1,902,120336,0.120336
5700,100,900,570000,2,7206,1803,1,46320000,46320000,2701,900,1801,900,0,1,902,121495,0.121495
5700,100,900,570000,2,7206,1803,1,46320000,46320000,2701,900,1801,900,0,1,902,120169,0.120169
5700,100,900,570000,2,7206,1803,1,46320000,46320000,2701,900,1801,900,0,1,902,122742,0.122742
5700,100,1300,570000,2,10406,2603,1,64880000,64880000,3901,1300,2601,1300,0,1,1302,154488,0.154488
5700,100,1300,570000,2,10406,2603,1,64880000,64880000,3901,1300,2601,1300,0,1,1302,165431,0.165431
5700,100,1300,570000,2,10406,2603,1,64880000,64880000,3901,1300,2601,1300,0,1,1302,155768,0.155768
5700,100,1300,570000,2,10406,2603,1,64880000,64880000,3901,1300,2601,1300,0,1,1302,170052,0.170052
5700,100,1300,570000,2,10406,2603,1,64880000,64880000,3901,1300,2601,1300,0,1,1302,159277,0.159277
5700,100,1300,570000,2,10406,2603,1,64880000,64880000,3901,1300,2601,1300,0,1,1302,162959,0.162959
5700,100,1300,570000,2,10406,2603,1,64880000,64880000,3901,1300,2601,1300,0,1,1302,167336,0.167336
5700,100,1300,570000,2,10406,2603,1,64880000,64880000,3901,1300,2601,1300,0,1,1302,163527,0.163527
5700,100,1700,570000,2,13606,3403,1,83440000,83440000,5101,1700,3401,1700,0,1,1702,210203,0.210203
5700,100,1700,570000,2,13606,3403,1,83440000,83440000,5101,1700,3401,1700,0,1,1702,212966,0.212966
5700,100,1700,570000,2,13606,3403,1,83440000,83440000,5101,1700,3401,1700,0,1,1702,210875,0.210875
5700,100,1700,570000,2,13606,3403,1,83440000,83440000,5101,1700,3401,1700,0,1,1702,220189,0.220189
5700,100,1700,570000,2,13606,3403,1,83440000,83440000,5101,1700,3401,1700,0,1,1702,215838,0.215838
5700,100,1700,570000,2,13606,3403,1,83440000,83440000,5101,1700,3401,1700,0,1,1702,214811,0.214811
5700,100,1700,570000,2,13606,3403,1,83440000,83440000,5101,1700,3401,1700,0,1,1702,214552,0.214552
5700,100,1700,570000,2,13606,3403,1,83440000,83440000,5101,1700,3401,1700,0,1,1702,215196,0.215196
5700,100,2100,570000,2,16806,4203,1,102000000,102000000,6301,2100,4201,2100,0,1,2102,247088,0.247088
5700,100,2100,570000,2,16806,4203,1,102000000,102000000,6301,2100,4201,2100,0,1,2102,271599,0.271599
5700,100,2100,570000,2,16806,4203,1,102000000,102000000,6301,2100,4201,2100,0,1,2102,249518,0.249518
5700,100,2100,570000,2,16806,4203,1,102000000,102000000,6301,2100,4201,2100,0,1,2102,271870,0.27187
5700,100,2100,570000,2,16806,4203,1,102000000,102000000,6301,2100,4201,2100,0,1,2102,257325,0.257325
5700,100,2100,570000,2,16806,4203,1,102000000,102000000,6301,2100,4201,2100,0,1,2102,259067,0.259067
5700,100,2100,570000,2,16806,4203,1,102000000,102000000,6301,2100,4201,2100,0,1,2102,260024,0.260024
5700,100,2100,570000,2,16806,4203,1,102000000,102000000,6301,2100,4201,2100,0,1,2102,260609,0.260609
5700,100,2500,570000,2,20006,5003,1,120560000,120560000,7501,2500,5001,2500,0,1,2502,299035,0.299035
5700,100,2500,570000,2,20006,5003,1,120560000,120560000,7501,2500,5001,2500,0,1,2502,322031,0.322031
5700,100,2500,570000,2,20006,5003,1,120560000,120560000,7501,2500,5001,2500,0,1,2502,301304,0.301304
5700,100,2500,570000,2,20006,5003,1,120560000,120560000,7501,2500,5001,2500,0,1,2502,322333,0.322333
5700,100,2500,570000,2,20006,5003,1,120560000,120560000,7501,2500,5001,2500,0,1,2502,311704,0.311704
5700,100,2500,570000,2,20006,5003,1,120560000,120560000,7501,2500,5001,2500,0,1,2502,306348,0.306348
5700,100,2500,570000,2,20006,5003,1,120560000,120560000,7501,2500,5001,2500,0,1,2502,305655,0.305655
5700,100,2500,570000,2,20006,5003,1,120560000,120560000,7501,2500,5001,2500,0,1,2502,311099,0.311099
5700,100,2900,570000,2,23206,5803,1,139120000,139120000,8701,2900,5801,2900,0,1,2902,347931,0.347931
5700,100,2900,570000,2,23206,5803,1,139120000,139120000,8701,2900,5801,2900,0,1,2902,355748,0.355748
5700,100,2900,570000,2,23206,5803,1,139120000,139120000,8701,2900,5801,2900,0,1,2902,351007,0.351007
5700,100,2900,570000,2,23206,5803,1,139120000,139120000,8701,2900,5801,2900,0,1,2902,361943,0.361943
5700,100,2900,570000,2,23206,5803,1,139120000,139120000,8701,2900,5801,2900,0,1,2902,364955,0.364955
5700,100,2900,570000,2,23206,5803,1,139120000,139120000,8701,2900,5801,2900,0,1,2902,352382,0.352382
5700,100,2900,570000,2,23206,5803,1,139120000,139120000,8701,2900,5801,2900,0,1,2902,350240,0.35024
5700,100,2900,570000,2,23206,5803,1,139120000,139120000,8701,2900,5801,2900,0,1,2902,354528,0.354528
5700,100,3300,570000,2,26406,6603,1,157680000,157680000,9901,3300,6601,3300,0,1,3302,396368,0.396368
5700,100,3300,570000,2,26406,6603,1,157680000,157680000,9901,3300,6601,3300,0,1,3302,405101,0.405101
5700,100,3300,570000,2,26406,6603,1,157680000,157680000,9901,3300,6601,3300,0,1,3302,401125,0.401125
5700,100,3300,570000,2,26406,6603,1,157680000,157680000,9901,3300,6601,3300,0,1,3302,411046,0.411046
5700,100,3300,570000,2,26406,6603,1,157680000,157680000,9901,3300,6601,3300,0,1,3302,416082,0.416082
5700,100,3300,570000,2,26406,6603,1,157680000,157680000,9901,3300,6601,3300,0,1,3302,397829,0.397829
5700,100,3300,570000,2,26406,6603,1,157680000,157680000,9901,3300,6601,3300,0,1,3302,393340,0.39334
5700,100,3300,570000,2,26406,6603,1,157680000,157680000,9901,3300,6601,3300,0,1,3302,399818,0.399818
5700,100,3700,570000,2,29606,7403,1,176240000,176240000,11101,3700,7401,3700,0,1,3702,439498,0.439498
5700,100,3700,570000,2,29606,7403,1,176240000,176240000,11101,3700,7401,3700,0,1,3702,458717,0.458717
5700,100,3700,570000,2,29606,7403,1,176240000,176240000,11101,3700,7401,3700,0,1,3702,449946,0.449946
5700,100,3700,570000,2,29606,7403,1,176240000,176240000,11101,3700,7401,3700,0,1,3702,459470,0.45947
5700,100,3700,570000,2,29606,7403,1,176240000,176240000,11101,3700,7401,3700,0,1,3702,467068,0.467068
5700,100,3700,570000,2,29606,7403,1,176240000,176240000,11101,3700,7401,3700,0,1,3702,446350,0.44635
5700,100,3700,570000,2,29606,7403,1,176240000,176240000,11101,3700,7401,3700,0,1,3702,436370,0.43637
5700,100,3700,570000,2,29606,7403,1,176240000,176240000,11101,3700,7401,3700,0,1,3702,450306,0.450306
5700,100,4100,570000,2,32806,8203,1,194800000,194800000,12301,4100,8201,4100,0,1,4102,500655,0.500655
5700,100,4100,570000,2,32806,8203,1,194800000,194800000,12301,4100,8201,4100,0,1,4102,514584,0.514584
5700,100,4100,570000,2,32806,8203,1,194800000,194800000,12301,4100,8201,4100,0,1,4102,514980,0.51498
5700,100,4100,570000,2,32806,8203,1,194800000,194800000,12301,4100,8201,4100,0,1,4102,507461,0.507461
5700,100,4100,570000,2,32806,8203,1,194800000,194800000,12301,4100,8201,4100,0,1,4102,536853,0.536853
5700,100,4100,570000,2,32806,8203,1,194800000,194800000,12301,4100,8201,4100,0,1,4102,491898,0.491898
5700,100,4100,570000,2,32806,8203,1,194800000,194800000,12301,4100,8201,4100,0,1,4102,533614,0.533614
5700,100,4100,570000,2,32806,8203,1,194800000,194800000,12301,4100,8201,4100,0,1,4102,500190,0.50019
5700,100,4500,570000,2,36006,9003,1,213360000,213360000,13501,4500,9001,4500,0,1,4502,547060,0.54706
5700,100,4500,570000,2,36006,9003,1,213360000,213360000,13501,4500,9001,4500,0,1,4502,568814,0.568814
5700,100,4500,570000,2,36006,9003,1,213360000,213360000,13501,4500,9001,4500,0,1,4502,564495,0.564495
5700,100,4500,570000,2,36006,9003,1,213360000,213360000,13501,4500,9001,4500,0,1,4502,559717,0.559717
5700,100,4500,570000,2,36006,9003,1,213360000,213360000,13501,4500,9001,4500,0,1,4502,589262,0.589262
5700,100,4500,570000,2,36006,9003,1,213360000,213360000,13501,4500,9001,4500,0,1,4502,548808,0.548808
5700,100,4500,570000,2,36006,9003,1,213360000,213360000,13501,4500,9001,4500,0,1,4502,591594,0.591594
5700,100,4500,570000,2,36006,9003,1,213360000,213360000,13501,4500,9001,4500,0,1,4502,547742,0.547742
5700,100,4900,570000,2,39206,9803,1,231920000,231920000,14701,4900,9801,4900,0,1,4902,602018,0.602018
5700,100,4900,570000,2,39206,9803,1,231920000,231920000,14701,4900,9801,4900,0,1,4902,615975,0.615975
5700,100,4900,570000,2,39206,9803,1,231920000,231920000,14701,4900,9801,4900,0,1,4902,628439,0.628439
5700,100,4900,570000,2,39206,9803,1,231920000,231920000,14701,4900,9801,4900,0,1,4902,624006,0.624006
5700,100,4900,570000,2,39206,9803,1,231920000,231920000,14701,4900,9801,4900,0,1,4902,643227,0.643227
5700,100,4900,570000,2,39206,9803,1,231920000,231920000,14701,4900,9801,4900,0,1,4902,600176,0.600176
5700,100,4900,570000,2,39206,9803,1,231920000,231920000,14701,4900,9801,4900,0,1,4902,640254,0.640254
5700,100,4900,570000,2,39206,9803,1,231920000,231920000,14701,4900,9801,4900,0,1,4902,604700,0.6047
5700,100,5300,570000,2,42406,10603,1,250480000,250480000,15901,5300,10601,5300,0,1,5302,653695,0.653695
5700,100,5300,570000,2,42406,10603,1,250480000,250480000,15901,5300,10601,5300,0,1,5302,672895,0.672895
5700,100,5300,570000,2,42406,10603,1,250480000,250480000,15901,5300,10601,5300,0,1,5302,687025,0.687025
5700,100,5300,570000,2,42406,10603,1,250480000,250480000,15901,5300,10601,5300,0,1,5302,690111,0.690111
5700,100,5300,570000,2,42406,10603,1,250480000,250480000,15901,5300,10601,5300,0,1,5302,698778,0.698778
5700,100,5300,570000,2,42406,10603,1,250480000,250480000,15901,5300,10601,5300,0,1,5302,661103,0.661103
5700,100,5300,570000,2,42406,10603,1,250480000,250480000,15901,5300,10601,5300,0,1,5302,705085,0.705085
5700,100,5300,570000,2,42406,10603,1,250480000,250480000,15901,5300,10601,5300,0,1,5302,669546,0.669546
5700,100,5700,570000,2,45606,11403,1,269040000,269040000,17101,5700,11401,5700,0,1,5702,694900,0.6949
5700,100,5700,570000,2,45606,11403,1,269040000,269040000,17101,5700,11401,5700,0,1,5702,724024,0.724024
5700,100,5700,570000,2,45606,11403,1,269040000,269040000,17101,5700,11401,5700,0,1,5702,725019,0.725019
5700,100,5700,570000,2,45606,11403,1,269040000,269040000,17101,5700,11401,5700,0,1,5702,721457,0.721457
5700,100,5700,570000,2,45606,11403,1,269040000,269040000,17101,5700,11401,5700,0,1,5702,735731,0.735731
5700,100,5700,570000,2,45606,11403,1,269040000,269040000,17101,5700,11401,5700,0,1,5702,709216,0.709216
5700,100,5700,570000,2,45606,11403,1,269040000,269040000,17101,5700,11401,5700,0,1,5702,690639,0.690639
5700,100,5700,570000,2,45606,11403,1,269040000,269040000,17101,5700,11401,5700,0,1,5702,713782,0.713782
5700,100,6100,570000,2,48806,12203,1,287600000,287600000,18301,6100,12201,6100,0,1,6102,746314,0.746314
5700,100,6100,570000,2,48806,12203,1,287600000,287600000,18301,6100,12201,6100,0,1,6102,773155,0.773155
5700,100,6100,570000,2,48806,12203,1,287600000,287600000,18301,6100,12201,6100,0,1,6102,768919,0.768919
5700,100,6100,570000,2,48806,12203,1,287600000,287600000,18301,6100,12201,6100,0,1,6102,773639,0.773639
5700,100,6100,570000,2,48806,12203,1,287600000,287600000,18301,6100,12201,6100,0,1,6102,793173,0.793173
5700,100,6100,570000,2,48806,12203,1,287600000,287600000,18301,6100,12201,6100,0,1,6102,748964,0.748964
5700,100,6100,570000,2,48806,12203,1,287600000,287600000,18301,6100,12201,6100,0,1,6102,728180,0.72818
5700,100,6100,570000,2,48806,12203,1,287600000,287600000,18301,6100,12201,6100,0,1,6102,766802,0.766802
5700,100,6500,570000,2,52006,13003,1,306160000,306160000,19501,6500,13001,6500,0,1,6502,803920,0.80392
5700,100,6500,570000,2,52006,13003,1,306160000,306160000,19501,6500,13001,6500,0,1,6502,832448,0.832448
5700,100,6500,570000,2,52006,13003,1,306160000,306160000,19501,6500,13001,6500,0,1,6502,822671,0.822671
5700,100,6500,570000,2,52006,13003,1,306160000,306160000,19501,6500,13001,6500,0,1,6502,827144,0.827144
5700,100,6500,570000,2,52006,13003,1,306160000,306160000,19501,6500,13001,6500,0,1,6502,852167,0.852167
5700,100,6500,570000,2,52006,13003,1,306160000,306160000,19501,6500,13001,6500,0,1,6502,811208,0.811208
5700,100,6500,570000,2,52006,13003,1,306160000,306160000,19501,6500,13001,6500,0,1,6502,789789,0.789789
5700,100,6500,570000,2,52006,13003,1,306160000,306160000,19501,6500,13001,6500,0,1,6502,817606,0.817606
5700,100,6900,570000,2,55206,13803,1,324720000,324720000,20701,6900,13801,6900,0,1,6902,856738,0.856738
5700,100,6900,570000,2,55206,13803,1,324720000,324720000,20701,6900,13801,6900,0,1,6902,889334,0.889334
5700,100,6900,570000,2,55206,13803,1,324720000,324720000,20701,6900,13801,6900,0,1,6902,879348,0.879348
5700,100,6900,570000,2,55206,13803,1,324720000,324720000,20701,6900,13801,6900,0,1,6902,876745,0.876745
5700,100,6900,570000,2,55206,13803,1,324720000,324720000,20701,6900,13801,6900,0,1,6902,908082,0.908082
5700,100,6900,570000,2,55206,13803,1,324720000,324720000,20701,6900,13801,6900,0,1,6902,857423,0.857423
5700,100,6900,570000,2,55206,13803,1,324720000,324720000,20701,6900,13801,6900,0,1,6902,847003,0.847003
5700,100,6900,570000,2,55206,13803,1,324720000,324720000,20701,6900,13801,6900,0,1,6902,865246,0.865246
5300,6900,500,36570000,2,4006,1003,1,341360000,341360000,1501,500,1001,500,0,1,502,3875115,3.875115
5300,6900,500,36570000,2,4006,1003,1,341360000,341360000,1501,500,1001,500,0,1,502,3935134,3.935134
5300,6900,500,36570000,2,4006,1003,1,341360000,341360000,1501,500,1001,500,0,1,502,3849186,3.849186
5300,6900,500,36570000,2,4006,1003,1,341360000,341360000,1501,500,1001,500,0,1,502,3907120,3.90712
5300,6900,500,36570000,2,4006,1003,1,341360000,341360000,1501,500,1001,500,0,1,502,3908020,3.90802
5300,6900,500,36570000,2,4006,1003,1,341360000,341360000,1501,500,1001,500,0,1,502,3934138,3.934138
5300,6900,500,36570000,2,4006,1003,1,341360000,341360000,1501,500,1001,500,0,1,502,3788833,3.788833
5300,6900,500,36570000,2,4006,1003,1,341360000,341360000,1501,500,1001,500,0,1,502,3962728,3.962728
5300,6900,900,36570000,2,7206,1803,1,380400000,380400000,2701,900,1801,900,0,1,902,6370341,6.370341
5300,6900,900,36570000,2,7206,1803,1,380400000,380400000,2701,900,1801,900,0,1,902,6625753,6.625753
5300,6900,900,36570000,2,7206,1803,1,380400000,380400000,2701,900,1801,900,0,1,902,6432205,6.432205
5300,6900,900,36570000,2,7206,1803,1,380400000,380400000,2701,900,1801,900,0,1,902,6518908,6.518908
5300,6900,900,36570000,2,7206,1803,1,380400000,380400000,2701,900,1801,900,0,1,902,6394989,6.394989
5300,6900,900,36570000,2,7206,1803,1,380400000,380400000,2701,900,1801,900,0,1,902,6600023,6.600023
5300,6900,900,36570000,2,7206,1803,1,380400000,380400000,2701,900,1801,900,0,1,902,6276869,6.276869
5300,6900,900,36570000,2,7206,1803,1,380400000,380400000,2701,900,1801,900,0,1,902,6652227,6.652227
5300,6900,1300,36570000,2,10406,2603,1,419440000,419440000,3901,1300,2601,1300,0,1,1302,9048073,9.048073
5300,6900,1300,36570000,2,10406,2603,1,419440000,419440000,3901,1300,2601,1300,0,1,1302,9361660,9.36166
5300,6900,1300,36570000,2,10406,2603,1,419440000,419440000,3901,1300,2601,1300,0,1,1302,9128405,9.128405
5300,6900,1300,36570000,2,10406,2603,1,419440000,419440000,3901,1300,2601,1300,0,1,1302,9285714,9.285714
5300,6900,1300,36570000,2,10406,2603,1,419440000,419440000,3901,1300,2601,1300,0,1,1302,9023318,9.023318
5300,6900,1300,36570000,2,10406,2603,1,419440000,419440000,3901,1300,2601,1300,0,1,1302,9388393,9.388393
5300,6900,1300,36570000,2,10406,2603,1,419440000,419440000,3901,1300,2601,1300,0,1,1302,8926699,8.926699
5300,6900,1300,36570000,2,10406,2603,1,419440000,419440000,3901,1300,2601,1300,0,1,1302,9469100,9.4691
5300,6900,1700,36570000,2,13606,3403,1,458480000,458480000,5101,1700,3401,1700,0,1,1702,11858219,11.858219
5300,6900,1700,36570000,2,13606,3403,1,458480000,458480000,5101,1700,3401,1700,0,1,1702,12274632,12.274632
5300,6900,1700,36570000,2,13606,3403,1,458480000,458480000,5101,1700,3401,1700,0,1,1702,11979080,11.97908
5300,6900,1700,36570000,2,13606,3403,1,458480000,458480000,5101,1700,3401,1700,0,1,1702,12121924,12.121924
5300,6900,1700,36570000,2,13606,3403,1,458480000,458480000,5101,1700,3401,1700,0,1,1702,11832997,11.832997
5300,6900,1700,36570000,2,13606,3403,1,458480000,458480000,5101,1700,3401,1700,0,1,1702,12301164,12.301164
5300,6900,1700,36570000,2,13606,3403,1,458480000,458480000,5101,1700,3401,1700,0,1,1702,11756136,11.756136
5300,6900,1700,36570000,2,13606,3403,1,458480000,458480000,5101,1700,3401,1700,0,1,1702,12401015,12.401015
5300,6900,2100,36570000,2,16806,4203,1,497520000,497520000,6301,2100,4201,2100,0,1,2102,14533767,14.533767
5300,6900,2100,36570000,2,16806,4203,1,497520000,497520000,6301,2100,4201,2100,0,1,2102,15037168,15.037168
5300,6900,2100,36570000,2,16806,4203,1,497520000,497520000,6301,2100,4201,2100,0,1,2102,14660439,14.660439
5300,6900,2100,36570000,2,16806,4203,1,497520000,497520000,6301,2100,4201,2100,0,1,2102,14928684,14.928684
5300,6900,2100,36570000,2,16806,4203,1,497520000,497520000,6301,2100,4201,2100,0,1,2102,14486164,14.486164
5300,6900,2100,36570000,2,16806,4203,1,497520000,497520000,6301,2100,4201,2100,0,1,2102,15115900,15.1159
5300,6900,2100,36570000,2,16806,4203,1,497520000,497520000,6301,2100,4201,2100,0,1,2102,14437974,14.437974
5300,6900,2100,36570000,2,16806,4203,1,497520000,497520000,6301,2100,4201,2100,0,1,2102,15205722,15.205722
5300,6900,2500,36570000,2,20006,5003,1,536560000,536560000,7501,2500,5001,2500,0,1,2502,17211327,17.211327
5300,6900,2500,36570000,2,20006,5003,1,536560000,536560000,7501,2500,5001,2500,0,1,2502,17840350,17.84035
5300,6900,2500,36570000,2,20006,5003,1,536560000,536560000,7501,2500,5001,2500,0,1,2502,17336988,17.336988
5300,6900,2500,36570000,2,20006,5003,1,536560000,536560000,7501,2500,5001,2500,0,1,2502,17658556,17.658556
5300,6900,2500,36570000,2,20006,5003,1,536560000,536560000,7501,2500,5001,2500,0,1,2502,17174576,17.174576
5300,6900,2500,36570000,2,20006,5003,1,536560000,536560000,7501,2500,5001,2500,0,1,2502,17896514,17.896514
5300,6900,2500,36570000,2,20006,5003,1,536560000,536560000,7501,2500,5001,2500,0,1,2502,17050795,17.050795
5300,6900,2500,36570000,2,20006,5003,1,536560000,536560000,7501,2500,5001,2500,0,1,2502,18048393,18.048393
5300,6900,2900,36570000,2,23206,5803,1,575600000,575600000,8701,2900,5801,2900,0,1,2902,19890971,19.890971
5300,6900,2900,36570000,2,23206,5803,1,575600000,575600000,8701,2900,5801,2900,0,1,2902,20659770,20.65977
5300,6900,2900,36570000,2,23206,5803,1,575600000,575600000,8701,2900,5801,2900,0,1,2902,20071134,20.071134
5300,6900,2900,36570000,2,23206,5803,1,575600000,575600000,8701,2900,5801,2900,0,1,2902,20418223,20.418223
5300,6900,2900,36570000,2,23206,5803,1,575600000,575600000,8701,2900,5801,2900,0,1,2902,19842877,19.842877
5300,6900,2900,36570000,2,23206,5803,1,575600000,575600000,8701,2900,5801,2900,0,1,2902,20703498,20.703498
5300,6900,2900,36570000,2,23206,5803,1,575600000,575600000,8701,2900,5801,2900,0,1,2902,19706762,19.706762
5300,6900,2900,36570000,2,23206,5803,1,575600000,575600000,8701,2900,5801,2900,0,1,2902,20875759,20.875759
5300,6900,3300,36570000,2,26406,6603,1,614640000,614640000,9901,3300,6601,3300,0,1,3302,22611700,22.6117
5300,6900,3300,36570000,2,26406,6603,1,614640000,614640000,9901,3300,6601,3300,0,1,3302,23410385,23.410385
5300,6900,3300,36570000,2,26406,6603,1,614640000,614640000,9901,3300,6601,3300,0,1,3302,22760231,22.760231
5300,6900,3300,36570000,2,26406,6603,1,614640000,614640000,9901,3300,6601,3300,0,1,3302,23245886,23.245886
5300,6900,3300,36570000,2,26406,6603,1,614640000,614640000,9901,3300,6601,3300,0,1,3302,22548647,22.548647
5300,6900,3300,36570000,2,26406,6603,1,614640000,614640000,9901,3300,6601,3300,0,1,3302,23526174,23.526174
5300,6900,3300,36570000,2,26406,6603,1,614640000,614640000,9901,3300,6601,3300,0,1,3302,22364708,22.364708
5300,6900,3300,36570000,2,26406,6603,1,614640000,614640000,9901,3300,6601,3300,0,1,3302,23695652,23.695652
5300,6900,3700,36570000,2,29606,7403,1,653680000,653680000,11101,3700,7401,3700,0,1,3702,25317804,25.317804
5300,6900,3700,36570000,2,29606,7403,1,653680000,653680000,11101,3700,7401,3700,0,1,3702,26244700,26.2447
5300,6900,3700,36570000,2,29606,7403,1,653680000,653680000,11101,3700,7401,3700,0,1,3702,25464672,25.464672
5300,6900,3700,36570000,2,29606,7403,1,653680000,653680000,11101,3700,7401,3700,0,1,3702,25989811,25.989811
5300,6900,3700,36570000,2,29606,7403,1,653680000,653680000,11101,3700,7401,3700,0,1,3702,25234166,25.234166
5300,6900,3700,36570000,2,29606,7403,1,653680000,653680000,11101,3700,7401,3700,0,1,3702,26288818,26.288818
5300,6900,3700,36570000,2,29606,7403,1,653680000,653680000,11101,3700,7401,3700,0,1,3702,25058449,25.058449
5300,6900,3700,36570000,2,29606,7403,1,653680000,653680000,11101,3700,7401,3700,0,1,3702,26595694,26.595694
5300,6900,4100,36570000,2,32806,8203,1,692720000,692720000,12301,4100,8201,4100,0,1,4102,28002688,28.002688
5300,6900,4100,36570000,2,32806,8203,1,692720000,692720000,12301,4100,8201,4100,0,1,4102,29076673,29.076673
5300,6900,4100,36570000,2,32806,8203,1,692720000,692720000,12301,4100,8201,4100,0,1,4102,28141867,28.141867
5300,6900,4100,36570000,2,32806,8203,1,692720000,692720000,12301,4100,8201,4100,0,1,4102,28745400,28.7454
5300,6900,4100,36570000,2,32806,8203,1,692720000,692720000,12301,4100,8201,4100,0,1,4102,27921959,27.921959
5300,6900,4100,36570000,2,32806,8203,1,692720000,692720000,12301,4100,8201,4100,0,1,4102,29104098,29.104098
5300,6900,4100,36570000,2,32806,8203,1,692720000,692720000,12301,4100,8201,4100,0,1,4102,27731595,27.731595
5300,6900,4100,36570000,2,32806,8203,1,692720000,692720000,12301,4100,8201,4100,0,1,4102,29361628,29.361628
5300,6900,4500,36570000,2,36006,9003,1,731760000,731760000,13501,4500,9001,4500,0,1,4502,30764324,30.764324
5300,6900,4500,36570000,2,36006,9003,1,731760000,731760000,13501,4500,9001,4500,0,1,4502,31856843,31.856843
5300,6900,4500,36570000,2,36006,9003,1,731760000,731760000,13501,4500,9001,4500,0,1,4502,30930293,30.930293
5300,6900,4500,36570000,2,36006,9003,1,731760000,731760000,13501,4500,9001,4500,0,1,4502,31688869,31.688869
5300,6900,4500,36570000,2,36006,9003,1,731760000,731760000,13501,4500,9001,4500,0,1,4502,30654414,30.654414
5300,6900,4500,36570000,2,36006,9003,1,731760000,731760000,13501,4500,9001,4500,0,1,4502,31952531,31.952531
5300,6900,4500,36570000,2,36006,9003,1,731760000,731760000,13501,4500,9001,4500,0,1,4502,30384260,30.38426
5300,6900,4500,36570000,2,36006,9003,1,731760000,731760000,13501,4500,9001,4500,0,1,4502,32248007,32.248007
5300,6900,4900,36570000,2,39206,9803,1,770800000,770800000,14701,4900,9801,4900,0,1,4902,33533043,33.533043
5300,6900,4900,36570000,2,39206,9803,1,770800000,770800000,14701,4900,9801,4900,0,1,4902,34692379,34.692379
5300,6900,4900,36570000,2,39206,9803,1,770800000,770800000,14701,4900,9801,4900,0,1,4902,33624755,33.624755
5300,6900,4900,36570000,2,39206,9803,1,770800000,770800000,14701,4900,9801,4900,0,1,4902,34507529,34.507529
5300,6900,4900,36570000,2,39206,9803,1,770800000,770800000,14701,4900,9801,4900,0,1,4902,33301236,33.301236
5300,6900,4900,36570000,2,39206,9803,1,770800000,770800000,14701,4900,9801,4900,0,1,4902,34857250,34.85725
5300,6900,4900,36570000,2,39206,9803,1,770800000,770800000,14701,4900,9801,4900,0,1,4902,33150298,33.150298
5300,6900,4900,36570000,2,39206,9803,1,770800000,770800000,14701,4900,9801,4900,0,1,4902,35179701,35.179701
5300,6900,5300,36570000,2,42406,10603,1,809840000,809840000,15901,5300,10601,5300,0,1,5302,36121913,36.121913
5300,6900,5300,36570000,2,42406,10603,1,809840000,809840000,15901,5300,10601,5300,0,1,5302,37509190,37.50919
5300,6900,5300,36570000,2,42406,10603,1,809840000,809840000,15901,5300,10601,5300,0,1,5302,36413859,36.413859
5300,6900,5300,36570000,2,42406,10603,1,809840000,809840000,15901,5300,10601,5300,0,1,5302,37165415,37.165415
5300,6900,5300,36570000,2,42406,10603,1,809840000,809840000,15901,5300,10601,5300,0,1,5302,36041137,36.041137
5300,6900,5300,36570000,2,42406,10603,1,809840000,809840000,15901,5300,10601,5300,0,1,5302,37590223,37.590223
5300,6900,5300,36570000,2,42406,10603,1,809840000,809840000,15901,5300,10601,5300,0,1,5302,35798044,35.798044
5300,6900,5300,36570000,2,42406,10603,1,809840000,809840000,15901,5300,10601,5300,0,1,5302,37967314,37.967314
5300,6900,5700,36570000,2,45606,11403,1,848880000,848880000,17101,5700,11401,5700,0,1,5702,38832689,38.832689
5300,6900,5700,36570000,2,45606,11403,1,848880000,848880000,17101,5700,11401,5700,0,1,5702,40307652,40.307652
5300,6900,5700,36570000,2,45606,11403,1,848880000,848880000,17101,5700,11401,5700,0,1,5702,39060088,39.060088
5300,6900,5700,36570000,2,45606,11403,1,848880000,848880000,17101,5700,11401,5700,0,1,5702,40080012,40.080012
5300,6900,5700,36570000,2,45606,11403,1,848880000,848880000,17101,5700,11401,5700,0,1,5702,38705143,38.705143
5300,6900,5700,36570000,2,45606,11403,1,848880000,848880000,17101,5700,11401,5700,0,1,5702,40432153,40.432153
5300,6900,5700,36570000,2,45606,11403,1,848880000,848880000,17101,5700,11401,5700,0,1,5702,38487053,38.487053
5300,6900,5700,36570000,2,45606,11403,1,848880000,848880000,17101,5700,11401,5700,0,1,5702,40815746,40.815746
5300,6900,6100,36570000,2,48806,12203,1,887920000,887920000,18301,6100,12201,6100,0,1,6102,41586537,41.586537
5300,6900,6100,36570000,2,48806,12203,1,887920000,887920000,18301,6100,12201,6100,0,1,6102,43164099,43.164099
5300,6900,6100,36570000,2,48806,12203,1,887920000,887920000,18301,6100,12201,6100,0,1,6102,41781291,41.781291
5300,6900,6100,36570000,2,48806,12203,1,887920000,887920000,18301,6100,12201,6100,0,1,6102,42911966,42.911966
5300,6900,6100,36570000,2,48806,12203,1,887920000,887920000,18301,6100,12201,6100,0,1,6102,41438043,41.438043
5300,6900,6100,36570000,2,48806,12203,1,887920000,887920000,18301,6100,12201,6100,0,1,6102,43216696,43.216696
5300,6900,6100,36570000,2,48806,12203,1,887920000,887920000,18301,6100,12201,6100,0,1,6102,41174048,41.174048
5300,6900,6100,36570000,2,48806,12203,1,887920000,887920000,18301,6100,12201,6100,0,1,6102,43618571,43.618571
5300,6900,6500,36570000,2,52006,13003,1,926960000,926960000,19501,6500,13001,6500,0,1,6502,44282470,44.28247
5300,6900,6500,36570000,2,52006,13003,1,926960000,926960000,19501,6500,13001,6500,0,1,6502,45952034,45.952034
5300,6900,6500,36570000,2,52006,13003,1,926960000,926960000,19501,6500,13001,6500,0,1,6502,44508399,44.508399
5300,6900,6500,36570000,2,52006,13003,1,926960000,926960000,19501,6500,13001,6500,0,1,6502,45683631,45.683631
5300,6900,6500,36570000,2,52006,13003,1,926960000,926960000,19501,6500,13001,6500,0,1,6502,44154903,44.154903
5300,6900,6500,36570000,2,52006,13003,1,926960000,926960000,19501,6500,13001,6500,0,1,6502,46061463,46.061463
5300,6900,6500,36570000,2,52006,13003,1,926960000,926960000,19501,6500,13001,6500,0,1,6502,43938360,43.93836
5300,6900,6500,36570000,2,52006,13003,1,926960000,926960000,19501,6500,13001,6500,0,1,6502,46481427,46.481427