168,50,7000,7100,49700000,2,406,103,1,403240000,403240000,151,50,101,50,0,1,52,576014
168,50,7000,7100,49700000,2,406,103,1,403240000,403240000,151,50,101,50,0,1,52,557382
168,50,7000,7100,49700000,2,406,103,1,403240000,403240000,151,50,101,50,0,1,52,557038
168,50,7000,7100,49700000,2,406,103,1,403240000,403240000,151,50,101,50,0,1,52,557205
168,50,7000,7100,49700000,2,406,103,1,403240000,403240000,151,50,101,50,0,1,52,557571
168,50,7000,7100,49700000,2,406,103,1,403240000,403240000,151,50,101,50,0,1,52,556533
168,50,7000,7100,49700000,2,406,103,1,403240000,403240000,151,50,101,50,0,1,52,556895
168,450,7000,7100,49700000,2,3606,903,1,448360000,448360000,1351,450,901,450,0,1,452,5688598
168,450,7000,7100,49700000,2,3606,903,1,448360000,448360000,1351,450,901,450,0,1,452,952732
168,450,7000,7100,49700000,2,3606,903,1,448360000,448360000,1351,450,901,450,0,1,452,951707
168,450,7000,7100,49700000,2,3606,903,1,448360000,448360000,1351,450,901,450,0,1,452,953679
168,450,7000,7100,49700000,2,3606,903,1,448360000,448360000,1351,450,901,450,0,1,452,953146
168,450,7000,7100,49700000,2,3606,903,1,448360000,448360000,1351,450,901,450,0,1,452,920864
168,450,7000,7100,49700000,2,3606,903,1,448360000,448360000,1351,450,901,450,0,1,452,921676
168,850,7000,7100,49700000,2,6806,1703,1,493480000,493480000,2551,850,1701,850,0,1,852,11626501
168,850,7000,7100,49700000,2,6806,1703,1,493480000,493480000,2551,850,1701,850,0,1,852,1368871
168,850,7000,7100,49700000,2,6806,1703,1,493480000,493480000,2551,850,1701,850,0,1,852,1351717
168,850,7000,7100,49700000,2,6806,1703,1,493480000,493480000,2551,850,1701,850,0,1,852,1240666
168,850,7000,7100,49700000,2,6806,1703,1,493480000,493480000,2551,850,1701,850,0,1,852,1368241
168,850,7000,7100,49700000,2,6806,1703,1,493480000,493480000,2551,850,1701,850,0,1,852,1331735
168,850,7000,7100,49700000,2,6806,1703,1,493480000,493480000,2551,850,1701,850,0,1,852,1330777
168,1250,7000,7100,49700000,2,10006,2503,1,538600000,538600000,3751,1250,2501,1250,0,1,1252,17807217
168,1250,7000,7100,49700000,2,10006,2503,1,538600000,538600000,3751,1250,2501,1250,0,1,1252,1736059
168,1250,7000,7100,49700000,2,10006,2503,1,538600000,538600000,3751,1250,2501,1250,0,1,1252,1733915
168,1250,7000,7100,49700000,2,10006,2503,1,538600000,538600000,3751,1250,2501,1250,0,1,1252,1740917
168,1250,7000,7100,49700000,2,10006,2503,1,538600000,538600000,3751,1250,2501,1250,0,1,1252,1740212
168,1250,7000,7100,49700000,2,10006,2503,1,538600000,538600000,3751,1250,2501,1250,0,1,1252,1721084
168,1250,7000,7100,49700000,2,10006,2503,1,538600000,538600000,3751,1250,2501,1250,0,1,1252,1722290
168,1650,7000,7100,49700000,2,13206,3303,1,583720000,583720000,4951,1650,3301,1650,0,1,1652,23308418
168,1650,7000,7100,49700000,2,13206,3303,1,583720000,583720000,4951,1650,3301,1650,0,1,1652,2218837
168,1650,7000,7100,49700000,2,13206,3303,1,583720000,583720000,4951,1650,3301,1650,0,1,1652,2218038
168,1650,7000,7100,49700000,2,13206,3303,1,583720000,583720000,4951,1650,3301,1650,0,1,1652,2210747
168,1650,7000,7100,49700000,2,13206,3303,1,583720000,583720000,4951,1650,3301,1650,0,1,1652,2204731
168,1650,7000,7100,49700000,2,13206,3303,1,583720000,583720000,4951,1650,3301,1650,0,1,1652,2174869
168,1650,7000,7100,49700000,2,13206,3303,1,583720000,583720000,4951,1650,3301,1650,0,1,1652,2173163
168,2050,7000,7100,49700000,2,16406,4103,1,628840000,628840000,6151,2050,4101,2050,0,1,2052,30353219
168,2050,7000,7100,49700000,2,16406,4103,1,628840000,628840000,6151,2050,4101,2050,0,1,2052,2666290
168,2050,7000,7100,49700000,2,16406,4103,1,628840000,628840000,6151,2050,4101,2050,0,1,2052,2667235
168,2050,7000,7100,49700000,2,16406,4103,1,628840000,628840000,6151,2050,4101,2050,0,1,2052,2647452
168,2050,7000,7100,49700000,2,16406,4103,1,628840000,628840000,6151,2050,4101,2050,0,1,2052,2663343
168,2050,7000,7100,49700000,2,16406,4103,1,628840000,628840000,6151,2050,4101,2050,0,1,2052,2605563
168,2050,7000,7100,49700000,2,16406,4103,1,628840000,628840000,6151,2050,4101,2050,0,1,2052,2603818
168,2450,7000,7100,49700000,2,19606,4903,1,673960000,673960000,7351,2450,4901,2450,0,1,2452,36960320
168,2450,7000,7100,49700000,2,19606,4903,1,673960000,673960000,7351,2450,4901,2450,0,1,2452,3037569
168,2450,7000,7100,49700000,2,19606,4903,1,673960000,673960000,7351,2450,4901,2450,0,1,2452,3039756
168,2450,7000,7100,49700000,2,19606,4903,1,673960000,673960000,7351,2450,4901,2450,0,1,2452,3040670
168,2450,7000,7100,49700000,2,19606,4903,1,673960000,673960000,7351,2450,4901,2450,0,1,2452,3038693
168,2450,7000,7100,49700000,2,19606,4903,1,673960000,673960000,7351,2450,4901,2450,0,1,2452,2968210
168,2450,7000,7100,49700000,2,19606,4903,1,673960000,673960000,7351,2450,4901,2450,0,1,2452,2938588
168,2850,7000,7100,49700000,2,22806,5703,1,719080000,719080000,8551,2850,5701,2850,0,1,2852,41889005
168,2850,7000,7100,49700000,2,22806,5703,1,719080000,719080000,8551,2850,5701,2850,0,1,2852,3512012
168,2850,7000,7100,49700000,2,22806,5703,1,719080000,719080000,8551,2850,5701,2850,0,1,2852,3513273
168,2850,7000,7100,49700000,2,22806,5703,1,719080000,719080000,8551,2850,5701,2850,0,1,2852,3492126
168,2850,7000,7100,49700000,2,22806,5703,1,719080000,719080000,8551,2850,5701,2850,0,1,2852,3510251
168,2850,7000,7100,49700000,2,22806,5703,1,719080000,719080000,8551,2850,5701,2850,0,1,2852,3428642
168,2850,7000,7100,49700000,2,22806,5703,1,719080000,719080000,8551,2850,5701,2850,0,1,2852,3423537
168,3250,7000,7100,49700000,2,26006,6503,1,764200000,764200000,9751,3250,6501,3250,0,1,3252,48668456
168,3250,7000,7100,49700000,2,26006,6503,1,764200000,764200000,9751,3250,6501,3250,0,1,3252,3932067
168,3250,7000,7100,49700000,2,26006,6503,1,764200000,764200000,9751,3250,6501,3250,0,1,3252,3933274
168,3250,7000,7100,49700000,2,26006,6503,1,764200000,764200000,9751,3250,6501,3250,0,1,3252,3926772
168,3250,7000,7100,49700000,2,26006,6503,1,764200000,764200000,9751,3250,6501,3250,0,1,3252,3905901
168,3250,7000,7100,49700000,2,26006,6503,1,764200000,764200000,9751,3250,6501,3250,0,1,3252,3839796
168,3250,7000,7100,49700000,2,26006,6503,1,764200000,764200000,9751,3250,6501,3250,0,1,3252,3830190
168,3650,7000,7100,49700000,2,29206,7303,1,809320000,809320000,10951,3650,7301,3650,0,1,3652,55106287
168,3650,7000,7100,49700000,2,29206,7303,1,809320000,809320000,10951,3650,7301,3650,0,1,3652,4360418
168,3650,7000,7100,49700000,2,29206,7303,1,809320000,809320000,10951,3650,7301,3650,0,1,3652,4353618
168,3650,7000,7100,49700000,2,29206,7303,1,809320000,809320000,10951,3650,7301,3650,0,1,3652,4359144
168,3650,7000,7100,49700000,2,29206,7303,1,809320000,809320000,10951,3650,7301,3650,0,1,3652,4350536
168,3650,7000,7100,49700000,2,29206,7303,1,809320000,809320000,10951,3650,7301,3650,0,1,3652,4247004
168,3650,7000,7100,49700000,2,29206,7303,1,809320000,809320000,10951,3650,7301,3650,0,1,3652,4249559
168,4050,7000,7100,49700000,2,32406,8103,1,854440000,854440000,12151,4050,8101,4050,0,1,4052,60885139
168,4050,7000,7100,49700000,2,32406,8103,1,854440000,854440000,12151,4050,8101,4050,0,1,4052,4768654
168,4050,7000,7100,49700000,2,32406,8103,1,854440000,854440000,12151,4050,8101,4050,0,1,4052,4762642
168,4050,7000,7100,49700000,2,32406,8103,1,854440000,854440000,12151,4050,8101,4050,0,1,4052,4767278
168,4050,7000,7100,49700000,2,32406,8103,1,854440000,854440000,12151,4050,8101,4050,0,1,4052,4764764
168,4050,7000,7100,49700000,2,32406,8103,1,854440000,854440000,12151,4050,8101,4050,0,1,4052,4626607
168,4050,7000,7100,49700000,2,32406,8103,1,854440000,854440000,12151,4050,8101,4050,0,1,4052,4629376
168,4450,7000,7100,49700000,2,35606,8903,1,899560000,899560000,13351,4450,8901,4450,0,1,4452,65691181
168,4450,7000,7100,49700000,2,35606,8903,1,899560000,899560000,13351,4450,8901,4450,0,1,4452,5197960
168,4450,7000,7100,49700000,2,35606,8903,1,899560000,899560000,13351,4450,8901,4450,0,1,4452,5193573
168,4450,7000,7100,49700000,2,35606,8903,1,899560000,899560000,13351,4450,8901,4450,0,1,4452,5196459
168,4450,7000,7100,49700000,2,35606,8903,1,899560000,899560000,13351,4450,8901,4450,0,1,4452,5183639
168,4450,7000,7100,49700000,2,35606,8903,1,899560000,899560000,13351,4450,8901,4450,0,1,4452,5068479
168,4450,7000,7100,49700000,2,35606,8903,1,899560000,899560000,13351,4450,8901,4450,0,1,4452,5065453
168,4850,7000,7100,49700000,2,38806,9703,1,944680000,944680000,14551,4850,9701,4850,0,1,4852,70748001
168,4850,7000,7100,49700000,2,38806,9703,1,944680000,944680000,14551,4850,9701,4850,0,1,4852,5663056
168,4850,7000,7100,49700000,2,38806,9703,1,944680000,944680000,14551,4850,9701,4850,0,1,4852,5664636
168,4850,7000,7100,49700000,2,38806,9703,1,944680000,944680000,14551,4850,9701,4850,0,1,4852,5658658
168,4850,7000,7100,49700000,2,38806,9703,1,944680000,944680000,14551,4850,9701,4850,0,1,4852,5655964
168,4850,7000,7100,49700000,2,38806,9703,1,944680000,944680000,14551,4850,9701,4850,0,1,4852,5521474
168,4850,7000,7100,49700000,2,38806,9703,1,944680000,944680000,14551,4850,9701,4850,0,1,4852,5503598
168,5250,7000,7100,49700000,2,42006,10503,1,989800000,989800000,15751,5250,10501,5250,0,1,5252,80507596
168,5250,7000,7100,49700000,2,42006,10503,1,989800000,989800000,15751,5250,10501,5250,0,1,5252,6011029
168,5250,7000,7100,49700000,2,42006,10503,1,989800000,989800000,15751,5250,10501,5250,0,1,5252,6009350
168,5250,7000,7100,49700000,2,42006,10503,1,989800000,989800000,15751,5250,10501,5250,0,1,5252,6006314
168,5250,7000,7100,49700000,2,42006,10503,1,989800000,989800000,15751,5250,10501,5250,0,1,5252,6003815
168,5250,7000,7100,49700000,2,42006,10503,1,989800000,989800000,15751,5250,10501,5250,0,1,5252,5816877
168,5250,7000,7100,49700000,2,42006,10503,1,989800000,989800000,15751,5250,10501,5250,0,1,5252,5819696
168,5650,7000,7100,49700000,2,45206,11303,1,1034920000,1034920000,16951,5650,11301,5650,0,1,5652,80079213
168,5650,7000,7100,49700000,2,45206,11303,1,1034920000,1034920000,16951,5650,11301,5650,0,1,5652,6416006
168,5650,7000,7100,49700000,2,45206,11303,1,1034920000,1034920000,16951,5650,11301,5650,0,1,5652,6414106
168,5650,7000,7100,49700000,2,45206,11303,1,1034920000,1034920000,16951,5650,11301,5650,0,1,5652,6410325
168,5650,7000,7100,49700000,2,45206,11303,1,1034920000,1034920000,16951,5650,11301,5650,0,1,5652,6374036
168,5650,7000,7100,49700000,2,45206,11303,1,1034920000,1034920000,16951,5650,11301,5650,0,1,5652,6254578
168,5650,7000,7100,49700000,2,45206,11303,1,1034920000,1034920000,16951,5650,11301,5650,0,1,5652,6203881
168,6050,7000,7100,49700000,2,48406,12103,1,1080040000,1080040000,18151,6050,12101,6050,0,1,6052,90727921
168,6050,7000,7100,49700000,2,48406,12103,1,1080040000,1080040000,18151,6050,12101,6050,0,1,6052,6884116
168,6050,7000,7100,49700000,2,48406,12103,1,1080040000,1080040000,18151,6050,12101,6050,0,1,6052,6885976
168,6050,7000,7100,49700000,2,48406,12103,1,1080040000,1080040000,18151,6050,12101,6050,0,1,6052,6880781
168,6050,7000,7100,49700000,2,48406,12103,1,1080040000,1080040000,18151,6050,12101,6050,0,1,6052,6878035
168,6050,7000,7100,49700000,2,48406,12103,1,1080040000,1080040000,18151,6050,12101,6050,0,1,6052,6696932
168,6050,7000,7100,49700000,2,48406,12103,1,1080040000,1080040000,18151,6050,12101,6050,0,1,6052,6634272
168,6450,7000,7100,49700000,2,51606,12903,1,1125160000,1125160000,19351,6450,12901,6450,0,1,6452,99518000
168,6450,7000,7100,49700000,2,51606,12903,1,1125160000,1125160000,19351,6450,12901,6450,0,1,6452,7282825
168,6450,7000,7100,49700000,2,51606,12903,1,1125160000,1125160000,19351,6450,12901,6450,0,1,6452,7284562
168,6450,7000,7100,49700000,2,51606,12903,1,1125160000,1125160000,19351,6450,12901,6450,0,1,6452,7281117
168,6450,7000,7100,49700000,2,51606,12903,1,1125160000,1125160000,19351,6450,12901,6450,0,1,6452,7274792
168,6450,7000,7100,49700000,2,51606,12903,1,1125160000,1125160000,19351,6450,12901,6450,0,1,6452,7071524
168,6450,7000,7100,49700000,2,51606,12903,1,1125160000,1125160000,19351,6450,12901,6450,0,1,6452,7036794
168,6850,7000,7100,49700000,2,54806,13703,1,1170280000,1170280000,20551,6850,13701,6850,0,1,6852,105372365
168,6850,7000,7100,49700000,2,54806,13703,1,1170280000,1170280000,20551,6850,13701,6850,0,1,6852,7685894
168,6850,7000,7100,49700000,2,54806,13703,1,1170280000,1170280000,20551,6850,13701,6850,0,1,6852,7687951
168,6850,7000,7100,49700000,2,54806,13703,1,1170280000,1170280000,20551,6850,13701,6850,0,1,6852,7683971
168,6850,7000,7100,49700000,2,54806,13703,1,1170280000,1170280000,20551,6850,13701,6850,0,1,6852,7674738
168,6850,7000,7100,49700000,2,54806,13703,1,1170280000,1170280000,20551,6850,13701,6850,0,1,6852,7483205
168,6850,7000,7100,49700000,2,54806,13703,1,1170280000,1170280000,20551,6850,13701,6850,0,1,6852,7413656
168,50,7000,6700,46900000,2,406,103,1,380680000,380680000,151,50,101,50,0,1,52,559000
168,50,7000,6700,46900000,2,406,103,1,380680000,380680000,151,50,101,50,0,1,52,506702
168,50,7000,6700,46900000,2,406,103,1,380680000,380680000,151,50,101,50,0,1,52,495981
168,50,7000,6700,46900000,2,406,103,1,380680000,380680000,151,50,101,50,0,1,52,502805
168,50,7000,6700,46900000,2,406,103,1,380680000,380680000,151,50,101,50,0,1,52,385919
168,50,7000,6700,46900000,2,406,103,1,380680000,380680000,151,50,101,50,0,1,52,496529
168,50,7000,6700,46900000,2,406,103,1,380680000,380680000,151,50,101,50,0,1,52,497048
168,450,7000,6700,46900000,2,3606,903,1,424520000,424520000,1351,450,901,450,0,1,452,5089578
168,450,7000,6700,46900000,2,3606,903,1,424520000,424520000,1351,450,901,450,0,1,452,908077
168,450,7000,6700,46900000,2,3606,903,1,424520000,424520000,1351,450,901,450,0,1,452,909236
168,450,7000,6700,46900000,2,3606,903,1,424520000,424520000,1351,450,901,450,0,1,452,900616
168,450,7000,6700,46900000,2,3606,903,1,424520000,424520000,1351,450,901,450,0,1,452,908703
168,450,7000,6700,46900000,2,3606,903,1,424520000,424520000,1351,450,901,450,0,1,452,877089
168,450,7000,6700,46900000,2,3606,903,1,424520000,424520000,1351,450,901,450,0,1,452,876189
168,850,7000,6700,46900000,2,6806,1703,1,468360000,468360000,2551,850,1701,850,0,1,852,10553900
168,850,7000,6700,46900000,2,6806,1703,1,468360000,468360000,2551,850,1701,850,0,1,852,1283295
168,850,7000,6700,46900000,2,6806,1703,1,468360000,468360000,2551,850,1701,850,0,1,852,1282915
168,850,7000,6700,46900000,2,6806,1703,1,468360000,468360000,2551,850,1701,850,0,1,852,1281342
168,850,7000,6700,46900000,2,6806,1703,1,468360000,468360000,2551,850,1701,850,0,1,852,1282349
168,850,7000,6700,46900000,2,6806,1703,1,468360000,468360000,2551,850,1701,850,0,1,852,1241532
168,850,7000,6700,46900000,2,6806,1703,1,468360000,468360000,2551,850,1701,850,0,1,852,1240587
168,1250,7000,6700,46900000,2,10006,2503,1,512200000,512200000,3751,1250,2501,1250,0,1,1252,16486347
168,1250,7000,6700,46900000,2,10006,2503,1,512200000,512200000,3751,1250,2501,1250,0,1,1252,1657445
168,1250,7000,6700,46900000,2,10006,2503,1,512200000,512200000,3751,1250,2501,1250,0,1,1252,1656724
168,1250,7000,6700,46900000,2,10006,2503,1,512200000,512200000,3751,1250,2501,1250,0,1,1252,1656145
168,1250,7000,6700,46900000,2,10006,2503,1,512200000,512200000,3751,1250,2501,1250,0,1,1252,1654887
168,1250,7000,6700,46900000,2,10006,2503,1,512200000,512200000,3751,1250,2501,1250,0,1,1252,1626695
168,1250,7000,6700,46900000,2,10006,2503,1,512200000,512200000,3751,1250,2501,1250,0,1,1252,1625509
168,1650,7000,6700,46900000,2,13206,3303,1,556040000,556040000,4951,1650,3301,1650,0,1,1652,22034850
168,1650,7000,6700,46900000,2,13206,3303,1,556040000,556040000,4951,1650,3301,1650,0,1,1652,2104432
168,1650,7000,6700,46900000,2,13206,3303,1,556040000,556040000,4951,1650,3301,1650,0,1,1652,2103599
168,1650,7000,6700,46900000,2,13206,3303,1,556040000,556040000,4951,1650,3301,1650,0,1,1652,2094708
168,1650,7000,6700,46900000,2,13206,3303,1,556040000,556040000,4951,1650,3301,1650,0,1,1652,2102715
168,1650,7000,6700,46900000,2,13206,3303,1,556040000,556040000,4951,1650,3301,1650,0,1,1652,2050739
168,1650,7000,6700,46900000,2,13206,3303,1,556040000,556040000,4951,1650,3301,1650,0,1,1652,2047165
168,2050,7000,6700,46900000,2,16406,4103,1,599880000,599880000,6151,2050,4101,2050,0,1,2052,27230387
168,2050,7000,6700,46900000,2,16406,4103,1,599880000,599880000,6151,2050,4101,2050,0,1,2052,2454113
168,2050,7000,6700,46900000,2,16406,4103,1,599880000,599880000,6151,2050,4101,2050,0,1,2052,2452277
168,2050,7000,6700,46900000,2,16406,4103,1,599880000,599880000,6151,2050,4101,2050,0,1,2052,2453208
168,2050,7000,6700,46900000,2,16406,4103,1,599880000,599880000,6151,2050,4101,2050,0,1,2052,2450201
168,2050,7000,6700,46900000,2,16406,4103,1,599880000,599880000,6151,2050,4101,2050,0,1,2052,2408905
168,2050,7000,6700,46900000,2,16406,4103,1,599880000,599880000,6151,2050,4101,2050,0,1,2052,2405584
168,2450,7000,6700,46900000,2,19606,4903,1,643720000,643720000,7351,2450,4901,2450,0,1,2452,32928837
168,2450,7000,6700,46900000,2,19606,4903,1,643720000,643720000,7351,2450,4901,2450,0,1,2452,2912582
168,2450,7000,6700,46900000,2,19606,4903,1,643720000,643720000,7351,2450,4901,2450,0,1,2452,2911571
168,2450,7000,6700,46900000,2,19606,4903,1,643720000,643720000,7351,2450,4901,2450,0,1,2452,2908264
168,2450,7000,6700,46900000,2,19606,4903,1,643720000,643720000,7351,2450,4901,2450,0,1,2452,2910551
168,2450,7000,6700,46900000,2,19606,4903,1,643720000,643720000,7351,2450,4901,2450,0,1,2452,2830787
168,2450,7000,6700,46900000,2,19606,4903,1,643720000,643720000,7351,2450,4901,2450,0,1,2452,2820183
168,2850,7000,6700,46900000,2,22806,5703,1,687560000,687560000,8551,2850,5701,2850,0,1,2852,40160426
168,2850,7000,6700,46900000,2,22806,5703,1,687560000,687560000,8551,2850,5701,2850,0,1,2852,3348955
168,2850,7000,6700,46900000,2,22806,5703,1,687560000,687560000,8551,2850,5701,2850,0,1,2852,3352068
168,2850,7000,6700,46900000,2,22806,5703,1,687560000,687560000,8551,2850,5701,2850,0,1,2852,3350942
168,2850,7000,6700,46900000,2,22806,5703,1,687560000,687560000,8551,2850,5701,2850,0,1,2852,3347222
168,2850,7000,6700,46900000,2,22806,5703,1,687560000,687560000,8551,2850,5701,2850,0,1,2852,3235860
168,2850,7000,6700,46900000,2,22806,5703,1,687560000,687560000,8551,2850,5701,2850,0,1,2852,3224641
168,3250,7000,6700,46900000,2,26006,6503,1,731400000,731400000,9751,3250,6501,3250,0,1,3252,46132142
168,3250,7000,6700,46900000,2,26006,6503,1,731400000,731400000,9751,3250,6501,3250,0,1,3252,3714851
168,3250,7000,6700,46900000,2,26006,6503,1,731400000,731400000,9751,3250,6501,3250,0,1,3252,3713929
168,3250,7000,6700,46900000,2,26006,6503,1,731400000,731400000,9751,3250,6501,3250,0,1,3252,3711532
168,3250,7000,6700,46900000,2,26006,6503,1,731400000,731400000,9751,3250,6501,3250,0,1,3252,3712879
168,3250,7000,6700,46900000,2,26006,6503,1,731400000,731400000,9751,3250,6501,3250,0,1,3252,3581465
168,3250,7000,6700,46900000,2,26006,6503,1,731400000,731400000,9751,3250,6501,3250,0,1,3252,3583104
168,3650,7000,6700,46900000,2,29206,7303,1,775240000,775240000,10951,3650,7301,3650,0,1,3652,54624472
168,3650,7000,6700,46900000,2,29206,7303,1,775240000,775240000,10951,3650,7301,3650,0,1,3652,4078201
168,3650,7000,6700,46900000,2,29206,7303,1,775240000,775240000,10951,3650,7301,3650,0,1,3652,4075876
168,3650,7000,6700,46900000,2,29206,7303,1,775240000,775240000,10951,3650,7301,3650,0,1,3652,4073882
168,3650,7000,6700,46900000,2,29206,7303,1,775240000,775240000,10951,3650,7301,3650,0,1,3652,4076933
168,3650,7000,6700,46900000,2,29206,7303,1,775240000,775240000,10951,3650,7301,3650,0,1,3652,3971693
168,3650,7000,6700,46900000,2,29206,7303,1,775240000,775240000,10951,3650,7301,3650,0,1,3652,3942327
168,4050,7000,6700,46900000,2,32406,8103,1,819080000,819080000,12151,4050,8101,4050,0,1,4052,58435776
168,4050,7000,6700,46900000,2,32406,8103,1,819080000,819080000,12151,4050,8101,4050,0,1,4052,4492513
168,4050,7000,6700,46900000,2,32406,8103,1,819080000,819080000,12151,4050,8101,4050,0,1,4052,4491263
168,4050,7000,6700,46900000,2,32406,8103,1,819080000,819080000,12151,4050,8101,4050,0,1,4052,4493632
168,4050,7000,6700,46900000,2,32406,8103,1,819080000,819080000,12151,4050,8101,4050,0,1,4052,4485187
168,4050,7000,6700,46900000,2,32406,8103,1,819080000,819080000,12151,4050,8101,4050,0,1,4052,4351538
168,4050,7000,6700,46900000,2,32406,8103,1,819080000,819080000,12151,4050,8101,4050,0,1,4052,4317100
168,4450,7000,6700,46900000,2,35606,8903,1,862920000,862920000,13351,4450,8901,4450,0,1,4452,63192349
168,4450,7000,6700,46900000,2,35606,8903,1,862920000,862920000,13351,4450,8901,4450,0,1,4452,4901003
168,4450,7000,6700,46900000,2,35606,8903,1,862920000,862920000,13351,4450,8901,4450,0,1,4452,4899577
168,4450,7000,6700,46900000,2,35606,8903,1,862920000,862920000,13351,4450,8901,4450,0,1,4452,4902460
168,4450,7000,6700,46900000,2,35606,8903,1,862920000,862920000,13351,4450,8901,4450,0,1,4452,4896398
168,4450,7000,6700,46900000,2,35606,8903,1,862920000,862920000,13351,4450,8901,4450,0,1,4452,4755252
168,4450,7000,6700,46900000,2,35606,8903,1,862920000,862920000,13351,4450,8901,4450,0,1,4452,4720222
168,4850,7000,6700,46900000,2,38806,9703,1,906760000,906760000,14551,4850,9701,4850,0,1,4852,67545840
168,4850,7000,6700,46900000,2,38806,9703,1,906760000,906760000,14551,4850,9701,4850,0,1,4852,5273442
168,4850,7000,6700,46900000,2,38806,9703,1,906760000,906760000,14551,4850,9701,4850,0,1,4852,5275009
168,4850,7000,6700,46900000,2,38806,9703,1,906760000,906760000,14551,4850,9701,4850,0,1,4852,5270651
168,4850,7000,6700,46900000,2,38806,9703,1,906760000,906760000,14551,4850,9701,4850,0,1,4852,5268313
168,4850,7000,6700,46900000,2,38806,9703,1,906760000,906760000,14551,4850,9701,4850,0,1,4852,5126252
168,4850,7000,6700,46900000,2,38806,9703,1,906760000,906760000,14551,4850,9701,4850,0,1,4852,5094059
168,5250,7000,6700,46900000,2,42006,10503,1,950600000,950600000,15751,5250,10501,5250,0,1,5252,74889965
168,5250,7000,6700,46900000,2,42006,10503,1,950600000,950600000,15751,5250,10501,5250,0,1,5252,5705933
168,5250,7000,6700,46900000,2,42006,10503,1,950600000,950600000,15751,5250,10501,5250,0,1,5252,5702425
168,5250,7000,6700,46900000,2,42006,10503,1,950600000,950600000,15751,5250,10501,5250,0,1,5252,5700804
168,5250,7000,6700,46900000,2,42006,10503,1,950600000,950600000,15751,5250,10501,5250,0,1,5252,5680728
168,5250,7000,6700,46900000,2,42006,10503,1,950600000,950600000,15751,5250,10501,5250,0,1,5252,5587632
168,5250,7000,6700,46900000,2,42006,10503,1,950600000,950600000,15751,5250,10501,5250,0,1,5252,5567697
168,5650,7000,6700,46900000,2,45206,11303,1,994440000,994440000,16951,5650,11301,5650,0,1,5652,79532165
168,5650,7000,6700,46900000,2,45206,11303,1,994440000,994440000,16951,5650,11301,5650,0,1,5652,6076019
168,5650,7000,6700,46900000,2,45206,11303,1,994440000,994440000,16951,5650,11301,5650,0,1,5652,6074258
168,5650,7000,6700,46900000,2,45206,11303,1,994440000,994440000,16951,5650,11301,5650,0,1,5652,6069615
168,5650,7000,6700,46900000,2,45206,11303,1,994440000,994440000,16951,5650,11301,5650,0,1,5652,6068251
168,5650,7000,6700,46900000,2,45206,11303,1,994440000,994440000,16951,5650,11301,5650,0,1,5652,5917207
168,5650,7000,6700,46900000,2,45206,11303,1,994440000,994440000,16951,5650,11301,5650,0,1,5652,5887691
168,6050,7000,6700,46900000,2,48406,12103,1,1038280000,1038280000,18151,6050,12101,6050,0,1,6052,88805837
168,6050,7000,6700,46900000,2,48406,12103,1,1038280000,1038280000,18151,6050,12101,6050,0,1,6052,6486602
168,6050,7000,6700,46900000,2,48406,12103,1,1038280000,1038280000,18151,6050,12101,6050,0,1,6052,6484966
168,6050,7000,6700,46900000,2,48406,12103,1,1038280000,1038280000,18151,6050,12101,6050,0,1,6052,6483266
168,6050,7000,6700,46900000,2,48406,12103,1,1038280000,1038280000,18151,6050,12101,6050,0,1,6052,6472322
168,6050,7000,6700,46900000,2,48406,12103,1,1038280000,1038280000,18151,6050,12101,6050,0,1,6052,6314428
168,6050,7000,6700,46900000,2,48406,12103,1,1038280000,1038280000,18151,6050,12101,6050,0,1,6052,6255348
168,6450,7000,6700,46900000,2,51606,12903,1,1082120000,1082120000,19351,6450,12901,6450,0,1,6452,91872934
168,6450,7000,6700,46900000,2,51606,12903,1,1082120000,1082120000,19351,6450,12901,6450,0,1,6452,6920158
168,6450,7000,6700,46900000,2,51606,12903,1,1082120000,1082120000,19351,6450,12901,6450,0,1,6452,6918208
168,6450,7000,6700,46900000,2,51606,12903,1,1082120000,1082120000,19351,6450,12901,6450,0,1,6452,6916344
168,6450,7000,6700,46900000,2,51606,12903,1,1082120000,1082120000,19351,6450,12901,6450,0,1,6452,6904768
168,6450,7000,6700,46900000,2,51606,12903,1,1082120000,1082120000,19351,6450,12901,6450,0,1,6452,6731554
168,6450,7000,6700,46900000,2,51606,12903,1,1082120000,1082120000,19351,6450,12901,6450,0,1,6452,6677934
168,6850,7000,6700,46900000,2,54806,13703,1,1125960000,1125960000,20551,6850,13701,6850,0,1,6852,97383002
168,6850,7000,6700,46900000,2,54806,13703,1,1125960000,1125960000,20551,6850,13701,6850,0,1,6852,7285653
168,6850,7000,6700,46900000,2,54806,13703,1,1125960000,1125960000,20551,6850,13701,6850,0,1,6852,7281691
168,6850,7000,6700,46900000,2,54806,13703,1,1125960000,1125960000,20551,6850,13701,6850,0,1,6852,7283598
168,6850,7000,6700,46900000,2,54806,13703,1,1125960000,1125960000,20551,6850,13701,6850,0,1,6852,7272734
168,6850,7000,6700,46900000,2,54806,13703,1,1125960000,1125960000,20551,6850,13701,6850,0,1,6852,7095455
168,6850,7000,6700,46900000,2,54806,13703,1,1125960000,1125960000,20551,6850,13701,6850,0,1,6852,7044221
168,50,7000,6300,44100000,2,406,103,1,358120000,358120000,151,50,101,50,0,1,52,510127
168,50,7000,6300,44100000,2,406,103,1,358120000,358120000,151,50,101,50,0,1,52,468244
168,50,7000,6300,44100000,2,406,103,1,358120000,358120000,151,50,101,50,0,1,52,467822
168,50,7000,6300,44100000,2,406,103,1,358120000,358120000,151,50,101,50,0,1,52,462322
168,50,7000,6300,44100000,2,406,103,1,358120000,358120000,151,50,101,50,0,1,52,429724
168,50,7000,6300,44100000,2,406,103,1,358120000,358120000,151,50,101,50,0,1,52,458285
168,50,7000,6300,44100000,2,406,103,1,358120000,358120000,151,50,101,50,0,1,52,457701
168,450,7000,6300,44100000,2,3606,903,1,400680000,400680000,1351,450,901,450,0,1,452,4836180
168,450,7000,6300,44100000,2,3606,903,1,400680000,400680000,1351,450,901,450,0,1,452,855484
168,450,7000,6300,44100000,2,3606,903,1,400680000,400680000,1351,450,901,450,0,1,452,856933
168,450,7000,6300,44100000,2,3606,903,1,400680000,400680000,1351,450,901,450,0,1,452,846955
168,450,7000,6300,44100000,2,3606,903,1,400680000,400680000,1351,450,901,450,0,1,452,856232
168,450,7000,6300,44100000,2,3606,903,1,400680000,400680000,1351,450,901,450,0,1,452,826303
168,450,7000,6300,44100000,2,3606,903,1,400680000,400680000,1351,450,901,450,0,1,452,827259
168,850,7000,6300,44100000,2,6806,1703,1,443240000,443240000,2551,850,1701,850,0,1,852,9881213
168,850,7000,6300,44100000,2,6806,1703,1,443240000,443240000,2551,850,1701,850,0,1,852,1199056
168,850,7000,6300,44100000,2,6806,1703,1,443240000,443240000,2551,850,1701,850,0,1,852,1197140
168,850,7000,6300,44100000,2,6806,1703,1,443240000,443240000,2551,850,1701,850,0,1,852,1198680
168,850,7000,6300,44100000,2,6806,1703,1,443240000,443240000,2551,850,1701,850,0,1,852,1198124
168,850,7000,6300,44100000,2,6806,1703,1,443240000,443240000,2551,850,1701,850,0,1,852,1164457
168,850,7000,6300,44100000,2,6806,1703,1,443240000,443240000,2551,850,1701,850,0,1,852,1163466
168,1250,7000,6300,44100000,2,10006,2503,1,485800000,485800000,3751,1250,2501,1250,0,1,1252,15476375
168,1250,7000,6300,44100000,2,10006,2503,1,485800000,485800000,3751,1250,2501,1250,0,1,1252,1597705
168,1250,7000,6300,44100000,2,10006,2503,1,485800000,485800000,3751,1250,2501,1250,0,1,1252,1596519
168,1250,7000,6300,44100000,2,10006,2503,1,485800000,485800000,3751,1250,2501,1250,0,1,1252,1597197
168,1250,7000,6300,44100000,2,10006,2503,1,485800000,485800000,3751,1250,2501,1250,0,1,1252,1595476
168,1250,7000,6300,44100000,2,10006,2503,1,485800000,485800000,3751,1250,2501,1250,0,1,1252,1547438
168,1250,7000,6300,44100000,2,10006,2503,1,485800000,485800000,3751,1250,2501,1250,0,1,1252,1546174
168,1650,7000,6300,44100000,2,13206,3303,1,528360000,528360000,4951,1650,3301,1650,0,1,1652,21913063
168,1650,7000,6300,44100000,2,13206,3303,1,528360000,528360000,4951,1650,3301,1650,0,1,1652,2006467
168,1650,7000,6300,44100000,2,13206,3303,1,528360000,528360000,4951,1650,3301,1650,0,1,1652,2007307
168,1650,7000,6300,44100000,2,13206,3303,1,528360000,528360000,4951,1650,3301,1650,0,1,1652,1903342
168,1650,7000,6300,44100000,2,13206,3303,1,528360000,528360000,4951,1650,3301,1650,0,1,1652,1994994
168,1650,7000,6300,44100000,2,13206,3303,1,528360000,528360000,4951,1650,3301,1650,0,1,1652,1948844
168,1650,7000,6300,44100000,2,13206,3303,1,528360000,528360000,4951,1650,3301,1650,0,1,1652,1947513
168,2050,7000,6300,44100000,2,16406,4103,1,570920000,570920000,6151,2050,4101,2050,0,1,2052,22791256
168,2050,7000,6300,44100000,2,16406,4103,1,570920000,570920000,6151,2050,4101,2050,0,1,2052,2345658
168,2050,7000,6300,44100000,2,16406,4103,1,570920000,570920000,6151,2050,4101,2050,0,1,2052,2343226
168,2050,7000,6300,44100000,2,16406,4103,1,570920000,570920000,6151,2050,4101,2050,0,1,2052,2344580
168,2050,7000,6300,44100000,2,16406,4103,1,570920000,570920000,6151,2050,4101,2050,0,1,2052,2342420
168,2050,7000,6300,44100000,2,16406,4103,1,570920000,570920000,6151,2050,4101,2050,0,1,2052,2295992
168,2050,7000,6300,44100000,2,16406,4103,1,570920000,570920000,6151,2050,4101,2050,0,1,2052,2292327
168,2450,7000,6300,44100000,2,19606,4903,1,613480000,613480000,7351,2450,4901,2450,0,1,2452,31518217
168,2450,7000,6300,44100000,2,19606,4903,1,613480000,613480000,7351,2450,4901,2450,0,1,2452,2745987
168,2450,7000,6300,44100000,2,19606,4903,1,613480000,613480000,7351,2450,4901,2450,0,1,2452,2747998
168,2450,7000,6300,44100000,2,19606,4903,1,613480000,613480000,7351,2450,4901,2450,0,1,2452,2746993
168,2450,7000,6300,44100000,2,19606,4903,1,613480000,613480000,7351,2450,4901,2450,0,1,2452,2736830
168,2450,7000,6300,44100000,2,19606,4903,1,613480000,613480000,7351,2450,4901,2450,0,1,2452,2674147
168,2450,7000,6300,44100000,2,19606,4903,1,613480000,613480000,7351,2450,4901,2450,0,1,2452,2670231
168,2850,7000,6300,44100000,2,22806,5703,1,656040000,656040000,8551,2850,5701,2850,0,1,2852,37318903
168,2850,7000,6300,44100000,2,22806,5703,1,656040000,656040000,8551,2850,5701,2850,0,1,2852,3149604
168,2850,7000,6300,44100000,2,22806,5703,1,656040000,656040000,8551,2850,5701,2850,0,1,2852,3148503
168,2850,7000,6300,44100000,2,22806,5703,1,656040000,656040000,8551,2850,5701,2850,0,1,2852,3136069
168,2850,7000,6300,44100000,2,22806,5703,1,656040000,656040000,8551,2850,5701,2850,0,1,2852,3143828
168,2850,7000,6300,44100000,2,22806,5703,1,656040000,656040000,8551,2850,5701,2850,0,1,2852,3071618
168,2850,7000,6300,44100000,2,22806,5703,1,656040000,656040000,8551,2850,5701,2850,0,1,2852,3066713
168,3250,7000,6300,44100000,2,26006,6503,1,698600000,698600000,9751,3250,6501,3250,0,1,3252,41126429
168,3250,7000,6300,44100000,2,26006,6503,1,698600000,698600000,9751,3250,6501,3250,0,1,3252,3501602
168,3250,7000,6300,44100000,2,26006,6503,1,698600000,698600000,9751,3250,6501,3250,0,1,3252,3500448
168,3250,7000,6300,44100000,2,26006,6503,1,698600000,698600000,9751,3250,6501,3250,0,1,3252,3497341
168,3250,7000,6300,44100000,2,26006,6503,1,698600000,698600000,9751,3250,6501,3250,0,1,3252,3496346
168,3250,7000,6300,44100000,2,26006,6503,1,698600000,698600000,9751,3250,6501,3250,0,1,3252,3409472
168,3250,7000,6300,44100000,2,26006,6503,1,698600000,698600000,9751,3250,6501,3250,0,1,3252,3405233
168,3650,7000,6300,44100000,2,29206,7303,1,741160000,741160000,10951,3650,7301,3650,0,1,3652,47612343
168,3650,7000,6300,44100000,2,29206,7303,1,741160000,741160000,10951,3650,7301,3650,0,1,3652,3879906
168,3650,7000,6300,44100000,2,29206,7303,1,741160000,741160000,10951,3650,7301,3650,0,1,3652,3883244
168,3650,7000,6300,44100000,2,29206,7303,1,741160000,741160000,10951,3650,7301,3650,0,1,3652,3884538
168,3650,7000,6300,44100000,2,29206,7303,1,741160000,741160000,10951,3650,7301,3650,0,1,3652,3877226
168,3650,7000,6300,44100000,2,29206,7303,1,741160000,741160000,10951,3650,7301,3650,0,1,3652,3789763
168,3650,7000,6300,44100000,2,29206,7303,1,741160000,741160000,10951,3650,7301,3650,0,1,3652,3776376
168,4050,7000,6300,44100000,2,32406,8103,1,783720000,783720000,12151,4050,8101,4050,0,1,4052,54432678
168,4050,7000,6300,44100000,2,32406,8103,1,783720000,783720000,12151,4050,8101,4050,0,1,4052,4314601
168,4050,7000,6300,44100000,2,32406,8103,1,783720000,783720000,12151,4050,8101,4050,0,1,4052,4310731
168,4050,7000,6300,44100000,2,32406,8103,1,783720000,783720000,12151,4050,8101,4050,0,1,4052,4313056
168,4050,7000,6300,44100000,2,32406,8103,1,783720000,783720000,12151,4050,8101,4050,0,1,4052,4301589
168,4050,7000,6300,44100000,2,32406,8103,1,783720000,783720000,12151,4050,8101,4050,0,1,4052,4179170
168,4050,7000,6300,44100000,2,32406,8103,1,783720000,783720000,12151,4050,8101,4050,0,1,4052,4159807
168,4450,7000,6300,44100000,2,35606,8903,1,826280000,826280000,13351,4450,8901,4450,0,1,4452,59250969
168,4450,7000,6300,44100000,2,35606,8903,1,826280000,826280000,13351,4450,8901,4450,0,1,4452,4672046
168,4450,7000,6300,44100000,2,35606,8903,1,826280000,826280000,13351,4450,8901,4450,0,1,4452,4670581
168,4450,7000,6300,44100000,2,35606,8903,1,826280000,826280000,13351,4450,8901,4450,0,1,4452,4661080
168,4450,7000,6300,44100000,2,35606,8903,1,826280000,826280000,13351,4450,8901,4450,0,1,4452,4666752
168,4450,7000,6300,44100000,2,35606,8903,1,826280000,826280000,13351,4450,8901,4450,0,1,4452,4535921
168,4450,7000,6300,44100000,2,35606,8903,1,826280000,826280000,13351,4450,8901,4450,0,1,4452,4516061
168,4850,7000,6300,44100000,2,38806,9703,1,868840000,868840000,14551,4850,9701,4850,0,1,4852,63957276
168,4850,7000,6300,44100000,2,38806,9703,1,868840000,868840000,14551,4850,9701,4850,0,1,4852,4986251
168,4850,7000,6300,44100000,2,38806,9703,1,868840000,868840000,14551,4850,9701,4850,0,1,4852,4941208
168,4850,7000,6300,44100000,2,38806,9703,1,868840000,868840000,14551,4850,9701,4850,0,1,4852,4987817
168,4850,7000,6300,44100000,2,38806,9703,1,868840000,868840000,14551,4850,9701,4850,0,1,4852,4977701
168,4850,7000,6300,44100000,2,38806,9703,1,868840000,868840000,14551,4850,9701,4850,0,1,4852,4860995
168,4850,7000,6300,44100000,2,38806,9703,1,868840000,868840000,14551,4850,9701,4850,0,1,4852,4850397
168,5250,7000,6300,44100000,2,42006,10503,1,911400000,911400000,15751,5250,10501,5250,0,1,5252,70858605
168,5250,7000,6300,44100000,2,42006,10503,1,911400000,911400000,15751,5250,10501,5250,0,1,5252,5323089
168,5250,7000,6300,44100000,2,42006,10503,1,911400000,911400000,15751,5250,10501,5250,0,1,5252,5324502
168,5250,7000,6300,44100000,2,42006,10503,1,911400000,911400000,15751,5250,10501,5250,0,1,5252,5321627
168,5250,7000,6300,44100000,2,42006,10503,1,911400000,911400000,15751,5250,10501,5250,0,1,5252,5314871
168,5250,7000,6300,44100000,2,42006,10503,1,911400000,911400000,15751,5250,10501,5250,0,1,5252,5150334
168,5250,7000,6300,44100000,2,42006,10503,1,911400000,911400000,15751,5250,10501,5250,0,1,5252,5139060
168,5650,7000,6300,44100000,2,45206,11303,1,953960000,953960000,16951,5650,11301,5650,0,1,5652,71323608
168,5650,7000,6300,44100000,2,45206,11303,1,953960000,953960000,16951,5650,11301,5650,0,1,5652,5737018
168,5650,7000,6300,44100000,2,45206,11303,1,953960000,953960000,16951,5650,11301,5650,0,1,5652,5752544
168,5650,7000,6300,44100000,2,45206,11303,1,953960000,953960000,16951,5650,11301,5650,0,1,5652,5754291
168,5650,7000,6300,44100000,2,45206,11303,1,953960000,953960000,16951,5650,11301,5650,0,1,5652,5747694
168,5650,7000,6300,44100000,2,45206,11303,1,953960000,953960000,16951,5650,11301,5650,0,1,5652,5601185
168,5650,7000,6300,44100000,2,45206,11303,1,953960000,953960000,16951,5650,11301,5650,0,1,5652,5597779
168,6050,7000,6300,44100000,2,48406,12103,1,996520000,996520000,18151,6050,12101,6050,0,1,6052,81755595
168,6050,7000,6300,44100000,2,48406,12103,1,996520000,996520000,18151,6050,12101,6050,0,1,6052,6084568
168,6050,7000,6300,44100000,2,48406,12103,1,996520000,996520000,18151,6050,12101,6050,0,1,6052,6082654
168,6050,7000,6300,44100000,2,48406,12103,1,996520000,996520000,18151,6050,12101,6050,0,1,6052,6086417
168,6050,7000,6300,44100000,2,48406,12103,1,996520000,996520000,18151,6050,12101,6050,0,1,6052,6079395
168,6050,7000,6300,44100000,2,48406,12103,1,996520000,996520000,18151,6050,12101,6050,0,1,6052,5913133
168,6050,7000,6300,44100000,2,48406,12103,1,996520000,996520000,18151,6050,12101,6050,0,1,6052,5903758
168,6450,7000,6300,44100000,2,51606,12903,1,1039080000,1039080000,19351,6450,12901,6450,0,1,6452,86184521
168,6450,7000,6300,44100000,2,51606,12903,1,1039080000,1039080000,19351,6450,12901,6450,0,1,6452,6467898
168,6450,7000,6300,44100000,2,51606,12903,1,1039080000,1039080000,19351,6450,12901,6450,0,1,6452,6469857
168,6450,7000,6300,44100000,2,51606,12903,1,1039080000,1039080000,19351,6450,12901,6450,0,1,6452,6465890
168,6450,7000,6300,44100000,2,51606,12903,1,1039080000,1039080000,19351,6450,12901,6450,0,1,6452,6462419
168,6450,7000,6300,44100000,2,51606,12903,1,1039080000,1039080000,19351,6450,12901,6450,0,1,6452,6301341
168,6450,7000,6300,44100000,2,51606,12903,1,1039080000,1039080000,19351,6450,12901,6450,0,1,6452,6259158
168,6850,7000,6300,44100000,2,54806,13703,1,1081640000,1081640000,20551,6850,13701,6850,0,1,6852,92262497
168,6850,7000,6300,44100000,2,54806,13703,1,1081640000,1081640000,20551,6850,13701,6850,0,1,6852,6911957
168,6850,7000,6300,44100000,2,54806,13703,1,1081640000,1081640000,20551,6850,13701,6850,0,1,6852,6913999
168,6850,7000,6300,44100000,2,54806,13703,1,1081640000,1081640000,20551,6850,13701,6850,0,1,6852,6901850
168,6850,7000,6300,44100000,2,54806,13703,1,1081640000,1081640000,20551,6850,13701,6850,0,1,6852,6910032
168,6850,7000,6300,44100000,2,54806,13703,1,1081640000,1081640000,20551,6850,13701,6850,0,1,6852,6715612
168,6850,7000,6300,44100000,2,54806,13703,1,1081640000,1081640000,20551,6850,13701,6850,0,1,6852,6685492
168,50,7000,5900,41300000,2,406,103,1,335560000,335560000,151,50,101,50,0,1,52,471202
168,50,7000,5900,41300000,2,406,103,1,335560000,335560000,151,50,101,50,0,1,52,443085
168,50,7000,5900,41300000,2,406,103,1,335560000,335560000,151,50,101,50,0,1,52,443517
168,50,7000,5900,41300000,2,406,103,1,335560000,335560000,151,50,101,50,0,1,52,401759
168,50,7000,5900,41300000,2,406,103,1,335560000,335560000,151,50,101,50,0,1,52,441822
168,50,7000,5900,41300000,2,406,103,1,335560000,335560000,151,50,101,50,0,1,52,439756
168,50,7000,5900,41300000,2,406,103,1,335560000,335560000,151,50,101,50,0,1,52,437479
168,450,7000,5900,41300000,2,3606,903,1,376840000,376840000,1351,450,901,450,0,1,452,4406892
168,450,7000,5900,41300000,2,3606,903,1,376840000,376840000,1351,450,901,450,0,1,452,797216
168,450,7000,5900,41300000,2,3606,903,1,376840000,376840000,1351,450,901,450,0,1,452,795454
168,450,7000,5900,41300000,2,3606,903,1,376840000,376840000,1351,450,901,450,0,1,452,797499
168,450,7000,5900,41300000,2,3606,903,1,376840000,376840000,1351,450,901,450,0,1,452,796743
168,450,7000,5900,41300000,2,3606,903,1,376840000,376840000,1351,450,901,450,0,1,452,794420
168,450,7000,5900,41300000,2,3606,903,1,376840000,376840000,1351,450,901,450,0,1,452,795057
168,850,7000,5900,41300000,2,6806,1703,1,418120000,418120000,2551,850,1701,850,0,1,852,9056123
168,850,7000,5900,41300000,2,6806,1703,1,418120000,418120000,2551,850,1701,850,0,1,852,1137580
168,850,7000,5900,41300000,2,6806,1703,1,418120000,418120000,2551,850,1701,850,0,1,852,1137200
168,850,7000,5900,41300000,2,6806,1703,1,418120000,418120000,2551,850,1701,850,0,1,852,1136645
168,850,7000,5900,41300000,2,6806,1703,1,418120000,418120000,2551,850,1701,850,0,1,852,1135258
168,850,7000,5900,41300000,2,6806,1703,1,418120000,418120000,2551,850,1701,850,0,1,852,1107523
168,850,7000,5900,41300000,2,6806,1703,1,418120000,418120000,2551,850,1701,850,0,1,852,1106532
168,1250,7000,5900,41300000,2,10006,2503,1,459400000,459400000,3751,1250,2501,1250,0,1,1252,14479715
168,1250,7000,5900,41300000,2,10006,2503,1,459400000,459400000,3751,1250,2501,1250,0,1,1252,1484046
168,1250,7000,5900,41300000,2,10006,2503,1,459400000,459400000,3751,1250,2501,1250,0,1,1252,1483536
168,1250,7000,5900,41300000,2,10006,2503,1,459400000,459400000,3751,1250,2501,1250,0,1,1252,1482887
168,1250,7000,5900,41300000,2,10006,2503,1,459400000,459400000,3751,1250,2501,1250,0,1,1252,1481844
168,1250,7000,5900,41300000,2,10006,2503,1,459400000,459400000,3751,1250,2501,1250,0,1,1252,1443927
168,1250,7000,5900,41300000,2,10006,2503,1,459400000,459400000,3751,1250,2501,1250,0,1,1252,1442880
168,1650,7000,5900,41300000,2,13206,3303,1,500680000,500680000,4951,1650,3301,1650,0,1,1652,19173918
168,1650,7000,5900,41300000,2,13206,3303,1,500680000,500680000,4951,1650,3301,1650,0,1,1652,1860564
168,1650,7000,5900,41300000,2,13206,3303,1,500680000,500680000,4951,1650,3301,1650,0,1,1652,1861417
168,1650,7000,5900,41300000,2,13206,3303,1,500680000,500680000,4951,1650,3301,1650,0,1,1652,1862234
168,1650,7000,5900,41300000,2,13206,3303,1,500680000,500680000,4951,1650,3301,1650,0,1,1652,1858679
168,1650,7000,5900,41300000,2,13206,3303,1,500680000,500680000,4951,1650,3301,1650,0,1,1652,1805321
168,1650,7000,5900,41300000,2,13206,3303,1,500680000,500680000,4951,1650,3301,1650,0,1,1652,1806643
168,2050,7000,5900,41300000,2,16406,4103,1,541960000,541960000,6151,2050,4101,2050,0,1,2052,24220004
168,2050,7000,5900,41300000,2,16406,4103,1,541960000,541960000,6151,2050,4101,2050,0,1,2052,2185483
168,2050,7000,5900,41300000,2,16406,4103,1,541960000,541960000,6151,2050,4101,2050,0,1,2052,2184605
168,2050,7000,5900,41300000,2,16406,4103,1,541960000,541960000,6151,2050,4101,2050,0,1,2052,2183624
168,2050,7000,5900,41300000,2,16406,4103,1,541960000,541960000,6151,2050,4101,2050,0,1,2052,2175872
168,2050,7000,5900,41300000,2,16406,4103,1,541960000,541960000,6151,2050,4101,2050,0,1,2052,2147377
168,2050,7000,5900,41300000,2,16406,4103,1,541960000,541960000,6151,2050,4101,2050,0,1,2052,2145890
168,2450,7000,5900,41300000,2,19606,4903,1,583240000,583240000,7351,2450,4901,2450,0,1,2452,28288215
168,2450,7000,5900,41300000,2,19606,4903,1,583240000,583240000,7351,2450,4901,2450,0,1,2452,2581881
168,2450,7000,5900,41300000,2,19606,4903,1,583240000,583240000,7351,2450,4901,2450,0,1,2452,2582903
168,2450,7000,5900,41300000,2,19606,4903,1,583240000,583240000,7351,2450,4901,2450,0,1,2452,2568559
168,2450,7000,5900,41300000,2,19606,4903,1,583240000,583240000,7351,2450,4901,2450,0,1,2452,2580875
168,2450,7000,5900,41300000,2,19606,4903,1,583240000,583240000,7351,2450,4901,2450,0,1,2452,2522694
168,2450,7000,5900,41300000,2,19606,4903,1,583240000,583240000,7351,2450,4901,2450,0,1,2452,2518831
168,2850,7000,5900,41300000,2,22806,5703,1,624520000,624520000,8551,2850,5701,2850,0,1,2852,33710887
168,2850,7000,5900,41300000,2,22806,5703,1,624520000,624520000,8551,2850,5701,2850,0,1,2852,2937083
168,2850,7000,5900,41300000,2,22806,5703,1,624520000,624520000,8551,2850,5701,2850,0,1,2852,2938189
168,2850,7000,5900,41300000,2,22806,5703,1,624520000,624520000,8551,2850,5701,2850,0,1,2852,2929542
168,2850,7000,5900,41300000,2,22806,5703,1,624520000,624520000,8551,2850,5701,2850,0,1,2852,2927787
168,2850,7000,5900,41300000,2,22806,5703,1,624520000,624520000,8551,2850,5701,2850,0,1,2852,2875738
168,2850,7000,5900,41300000,2,22806,5703,1,624520000,624520000,8551,2850,5701,2850,0,1,2852,2871435
168,3250,7000,5900,41300000,2,26006,6503,1,665800000,665800000,9751,3250,6501,3250,0,1,3252,40334992
168,3250,7000,5900,41300000,2,26006,6503,1,665800000,665800000,9751,3250,6501,3250,0,1,3252,3301092
168,3250,7000,5900,41300000,2,26006,6503,1,665800000,665800000,9751,3250,6501,3250,0,1,3252,3297860
168,3250,7000,5900,41300000,2,26006,6503,1,665800000,665800000,9751,3250,6501,3250,0,1,3252,3299931
168,3250,7000,5900,41300000,2,26006,6503,1,665800000,665800000,9751,3250,6501,3250,0,1,3252,3289654
168,3250,7000,5900,41300000,2,26006,6503,1,665800000,665800000,9751,3250,6501,3250,0,1,3252,3234284
168,3250,7000,5900,41300000,2,26006,6503,1,665800000,665800000,9751,3250,6501,3250,0,1,3252,3229646
168,3650,7000,5900,41300000,2,29206,7303,1,707080000,707080000,10951,3650,7301,3650,0,1,3652,44581316
168,3650,7000,5900,41300000,2,29206,7303,1,707080000,707080000,10951,3650,7301,3650,0,1,3652,3657960
168,3650,7000,5900,41300000,2,29206,7303,1,707080000,707080000,10951,3650,7301,3650,0,1,3652,3656669
168,3650,7000,5900,41300000,2,29206,7303,1,707080000,707080000,10951,3650,7301,3650,0,1,3652,3651511
168,3650,7000,5900,41300000,2,29206,7303,1,707080000,707080000,10951,3650,7301,3650,0,1,3652,3649163
168,3650,7000,5900,41300000,2,29206,7303,1,707080000,707080000,10951,3650,7301,3650,0,1,3652,3553140
168,3650,7000,5900,41300000,2,29206,7303,1,707080000,707080000,10951,3650,7301,3650,0,1,3652,3543496
168,4050,7000,5900,41300000,2,32406,8103,1,748360000,748360000,12151,4050,8101,4050,0,1,4052,48329669
168,4050,7000,5900,41300000,2,32406,8103,1,748360000,748360000,12151,4050,8101,4050,0,1,4052,4031172
168,4050,7000,5900,41300000,2,32406,8103,1,748360000,748360000,12151,4050,8101,4050,0,1,4052,4033911
168,4050,7000,5900,41300000,2,32406,8103,1,748360000,748360000,12151,4050,8101,4050,0,1,4052,4032527
168,4050,7000,5900,41300000,2,32406,8103,1,748360000,748360000,12151,4050,8101,4050,0,1,4052,4021053
168,4050,7000,5900,41300000,2,32406,8103,1,748360000,748360000,12151,4050,8101,4050,0,1,4052,3956810
168,4050,7000,5900,41300000,2,32406,8103,1,748360000,748360000,12151,4050,8101,4050,0,1,4052,3952076
168,4450,7000,5900,41300000,2,35606,8903,1,789640000,789640000,13351,4450,8901,4450,0,1,4452,54427188
168,4450,7000,5900,41300000,2,35606,8903,1,789640000,789640000,13351,4450,8901,4450,0,1,4452,4375926
168,4450,7000,5900,41300000,2,35606,8903,1,789640000,789640000,13351,4450,8901,4450,0,1,4452,4374484
168,4450,7000,5900,41300000,2,35606,8903,1,789640000,789640000,13351,4450,8901,4450,0,1,4452,4364845
168,4450,7000,5900,41300000,2,35606,8903,1,789640000,789640000,13351,4450,8901,4450,0,1,4452,4360383
168,4450,7000,5900,41300000,2,35606,8903,1,789640000,789640000,13351,4450,8901,4450,0,1,4452,4290016
168,4450,7000,5900,41300000,2,35606,8903,1,789640000,789640000,13351,4450,8901,4450,0,1,4452,4284161
168,4850,7000,5900,41300000,2,38806,9703,1,830920000,830920000,14551,4850,9701,4850,0,1,4852,59677417
168,4850,7000,5900,41300000,2,38806,9703,1,830920000,830920000,14551,4850,9701,4850,0,1,4852,4732108
168,4850,7000,5900,41300000,2,38806,9703,1,830920000,830920000,14551,4850,9701,4850,0,1,4852,4765692
168,4850,7000,5900,41300000,2,38806,9703,1,830920000,830920000,14551,4850,9701,4850,0,1,4852,4757011
168,4850,7000,5900,41300000,2,38806,9703,1,830920000,830920000,14551,4850,9701,4850,0,1,4852,4750978
168,4850,7000,5900,41300000,2,38806,9703,1,830920000,830920000,14551,4850,9701,4850,0,1,4852,4635781
168,4850,7000,5900,41300000,2,38806,9703,1,830920000,830920000,14551,4850,9701,4850,0,1,4852,4624280
168,5250,7000,5900,41300000,2,42006,10503,1,872200000,872200000,15751,5250,10501,5250,0,1,5252,63373694
168,5250,7000,5900,41300000,2,42006,10503,1,872200000,872200000,15751,5250,10501,5250,0,1,5252,5062036
168,5250,7000,5900,41300000,2,42006,10503,1,872200000,872200000,15751,5250,10501,5250,0,1,5252,5063721
168,5250,7000,5900,41300000,2,42006,10503,1,872200000,872200000,15751,5250,10501,5250,0,1,5252,5053150
168,5250,7000,5900,41300000,2,42006,10503,1,872200000,872200000,15751,5250,10501,5250,0,1,5252,5045452
168,5250,7000,5900,41300000,2,42006,10503,1,872200000,872200000,15751,5250,10501,5250,0,1,5252,4935342
168,5250,7000,5900,41300000,2,42006,10503,1,872200000,872200000,15751,5250,10501,5250,0,1,5252,4923923
168,5650,7000,5900,41300000,2,45206,11303,1,913480000,913480000,16951,5650,11301,5650,0,1,5652,71141112
168,5650,7000,5900,41300000,2,45206,11303,1,913480000,913480000,16951,5650,11301,5650,0,1,5652,5388861
168,5650,7000,5900,41300000,2,45206,11303,1,913480000,913480000,16951,5650,11301,5650,0,1,5652,5385618
168,5650,7000,5900,41300000,2,45206,11303,1,913480000,913480000,16951,5650,11301,5650,0,1,5652,5387086
168,5650,7000,5900,41300000,2,45206,11303,1,913480000,913480000,16951,5650,11301,5650,0,1,5652,5379281
168,5650,7000,5900,41300000,2,45206,11303,1,913480000,913480000,16951,5650,11301,5650,0,1,5652,5239070
168,5650,7000,5900,41300000,2,45206,11303,1,913480000,913480000,16951,5650,11301,5650,0,1,5652,5216805
168,6050,7000,5900,41300000,2,48406,12103,1,954760000,954760000,18151,6050,12101,6050,0,1,6052,76514576
168,6050,7000,5900,41300000,2,48406,12103,1,954760000,954760000,18151,6050,12101,6050,0,1,6052,5789049
168,6050,7000,5900,41300000,2,48406,12103,1,954760000,954760000,18151,6050,12101,6050,0,1,6052,5785336
168,6050,7000,5900,41300000,2,48406,12103,1,954760000,954760000,18151,6050,12101,6050,0,1,6052,5783559
168,6050,7000,5900,41300000,2,48406,12103,1,954760000,954760000,18151,6050,12101,6050,0,1,6052,5775863
168,6050,7000,5900,41300000,2,48406,12103,1,954760000,954760000,18151,6050,12101,6050,0,1,6052,5636830
168,6050,7000,5900,41300000,2,48406,12103,1,954760000,954760000,18151,6050,12101,6050,0,1,6052,5622814
168,6450,7000,5900,41300000,2,51606,12903,1,996040000,996040000,19351,6450,12901,6450,0,1,6452,81695615
168,6450,7000,5900,41300000,2,51606,12903,1,996040000,996040000,19351,6450,12901,6450,0,1,6452,6142919
168,6450,7000,5900,41300000,2,51606,12903,1,996040000,996040000,19351,6450,12901,6450,0,1,6452,6144883
168,6450,7000,5900,41300000,2,51606,12903,1,996040000,996040000,19351,6450,12901,6450,0,1,6452,6138085
168,6450,7000,5900,41300000,2,51606,12903,1,996040000,996040000,19351,6450,12901,6450,0,1,6452,6132054
168,6450,7000,5900,41300000,2,51606,12903,1,996040000,996040000,19351,6450,12901,6450,0,1,6452,5961181
168,6450,7000,5900,41300000,2,51606,12903,1,996040000,996040000,19351,6450,12901,6450,0,1,6452,5941968
168,6850,7000,5900,41300000,2,54806,13703,1,1037320000,1037320000,20551,6850,13701,6850,0,1,6852,82138347
168,6850,7000,5900,41300000,2,54806,13703,1,1037320000,1037320000,20551,6850,13701,6850,0,1,6852,6509357
168,6850,7000,5900,41300000,2,54806,13703,1,1037320000,1037320000,20551,6850,13701,6850,0,1,6852,6507336
168,6850,7000,5900,41300000,2,54806,13703,1,1037320000,1037320000,20551,6850,13701,6850,0,1,6852,6500421
168,6850,7000,5900,41300000,2,54806,13703,1,1037320000,1037320000,20551,6850,13701,6850,0,1,6852,6497524
168,6850,7000,5900,41300000,2,54806,13703,1,1037320000,1037320000,20551,6850,13701,6850,0,1,6852,6330623
168,6850,7000,5900,41300000,2,54806,13703,1,1037320000,1037320000,20551,6850,13701,6850,0,1,6852,6297322
168,50,7000,5500,38500000,2,406,103,1,313000000,313000000,151,50,101,50,0,1,52,440893
168,50,7000,5500,38500000,2,406,103,1,313000000,313000000,151,50,101,50,0,1,52,359337
168,50,7000,5500,38500000,2,406,103,1,313000000,313000000,151,50,101,50,0,1,52,399554
168,50,7000,5500,38500000,2,406,103,1,313000000,313000000,151,50,101,50,0,1,52,410211
168,50,7000,5500,38500000,2,406,103,1,313000000,313000000,151,50,101,50,0,1,52,409518
168,50,7000,5500,38500000,2,406,103,1,313000000,313000000,151,50,101,50,0,1,52,411114
168,50,7000,5500,38500000,2,406,103,1,313000000,313000000,151,50,101,50,0,1,52,410728
168,450,7000,5500,38500000,2,3606,903,1,353000000,353000000,1351,450,901,450,0,1,452,4102983
168,450,7000,5500,38500000,2,3606,903,1,353000000,353000000,1351,450,901,450,0,1,452,765125
168,450,7000,5500,38500000,2,3606,903,1,353000000,353000000,1351,450,901,450,0,1,452,766259
168,450,7000,5500,38500000,2,3606,903,1,353000000,353000000,1351,450,901,450,0,1,452,765737
168,450,7000,5500,38500000,2,3606,903,1,353000000,353000000,1351,450,901,450,0,1,452,754897
168,450,7000,5500,38500000,2,3606,903,1,353000000,353000000,1351,450,901,450,0,1,452,756700
168,450,7000,5500,38500000,2,3606,903,1,353000000,353000000,1351,450,901,450,0,1,452,755400
168,850,7000,5500,38500000,2,6806,1703,1,393000000,393000000,2551,850,1701,850,0,1,852,8683488
168,850,7000,5500,38500000,2,6806,1703,1,393000000,393000000,2551,850,1701,850,0,1,852,1051798
168,850,7000,5500,38500000,2,6806,1703,1,393000000,393000000,2551,850,1701,850,0,1,852,1051458
168,850,7000,5500,38500000,2,6806,1703,1,393000000,393000000,2551,850,1701,850,0,1,852,1052183
168,850,7000,5500,38500000,2,6806,1703,1,393000000,393000000,2551,850,1701,850,0,1,852,1050960
168,850,7000,5500,38500000,2,6806,1703,1,393000000,393000000,2551,850,1701,850,0,1,852,1030540
168,850,7000,5500,38500000,2,6806,1703,1,393000000,393000000,2551,850,1701,850,0,1,852,1029657
168,1250,7000,5500,38500000,2,10006,2503,1,433000000,433000000,3751,1250,2501,1250,0,1,1252,12944852
168,1250,7000,5500,38500000,2,10006,2503,1,433000000,433000000,3751,1250,2501,1250,0,1,1252,1365973
168,1250,7000,5500,38500000,2,10006,2503,1,433000000,433000000,3751,1250,2501,1250,0,1,1252,1365465
168,1250,7000,5500,38500000,2,10006,2503,1,433000000,433000000,3751,1250,2501,1250,0,1,1252,1364823
168,1250,7000,5500,38500000,2,10006,2503,1,433000000,433000000,3751,1250,2501,1250,0,1,1252,1363344
168,1250,7000,5500,38500000,2,10006,2503,1,433000000,433000000,3751,1250,2501,1250,0,1,1252,1350833
168,1250,7000,5500,38500000,2,10006,2503,1,433000000,433000000,3751,1250,2501,1250,0,1,1252,1349785
168,1650,7000,5500,38500000,2,13206,3303,1,473000000,473000000,4951,1650,3301,1650,0,1,1652,17396849
168,1650,7000,5500,38500000,2,13206,3303,1,473000000,473000000,4951,1650,3301,1650,0,1,1652,1754996
168,1650,7000,5500,38500000,2,13206,3303,1,473000000,473000000,4951,1650,3301,1650,0,1,1652,1753160
168,1650,7000,5500,38500000,2,13206,3303,1,473000000,473000000,4951,1650,3301,1650,0,1,1652,1755606
168,1650,7000,5500,38500000,2,13206,3303,1,473000000,473000000,4951,1650,3301,1650,0,1,1652,1754267
168,1650,7000,5500,38500000,2,13206,3303,1,473000000,473000000,4951,1650,3301,1650,0,1,1652,1689423
168,1650,7000,5500,38500000,2,13206,3303,1,473000000,473000000,4951,1650,3301,1650,0,1,1652,1688227
168,2050,7000,5500,38500000,2,16406,4103,1,513000000,513000000,6151,2050,4101,2050,0,1,2052,22389024
168,2050,7000,5500,38500000,2,16406,4103,1,513000000,513000000,6151,2050,4101,2050,0,1,2052,2047857
168,2050,7000,5500,38500000,2,16406,4103,1,513000000,513000000,6151,2050,4101,2050,0,1,2052,2046815
168,2050,7000,5500,38500000,2,16406,4103,1,513000000,513000000,6151,2050,4101,2050,0,1,2052,2045495
168,2050,7000,5500,38500000,2,16406,4103,1,513000000,513000000,6151,2050,4101,2050,0,1,2052,2043800
168,2050,7000,5500,38500000,2,16406,4103,1,513000000,513000000,6151,2050,4101,2050,0,1,2052,2012615
168,2050,7000,5500,38500000,2,16406,4103,1,513000000,513000000,6151,2050,4101,2050,0,1,2052,2009338
168,2450,7000,5500,38500000,2,19606,4903,1,553000000,553000000,7351,2450,4901,2450,0,1,2452,27061611
168,2450,7000,5500,38500000,2,19606,4903,1,553000000,553000000,7351,2450,4901,2450,0,1,2452,2385457
168,2450,7000,5500,38500000,2,19606,4903,1,553000000,553000000,7351,2450,4901,2450,0,1,2452,2384223
168,2450,7000,5500,38500000,2,19606,4903,1,553000000,553000000,7351,2450,4901,2450,0,1,2452,2387144
168,2450,7000,5500,38500000,2,19606,4903,1,553000000,553000000,7351,2450,4901,2450,0,1,2452,2386345
168,2450,7000,5500,38500000,2,19606,4903,1,553000000,553000000,7351,2450,4901,2450,0,1,2452,2353999
168,2450,7000,5500,38500000,2,19606,4903,1,553000000,553000000,7351,2450,4901,2450,0,1,2452,2352494
168,2850,7000,5500,38500000,2,22806,5703,1,593000000,593000000,8551,2850,5701,2850,0,1,2852,31918370
168,2850,7000,5500,38500000,2,22806,5703,1,593000000,593000000,8551,2850,5701,2850,0,1,2852,2738389
168,2850,7000,5500,38500000,2,22806,5703,1,593000000,593000000,8551,2850,5701,2850,0,1,2852,2736378
168,2850,7000,5500,38500000,2,22806,5703,1,593000000,593000000,8551,2850,5701,2850,0,1,2852,2734719
168,2850,7000,5500,38500000,2,22806,5703,1,593000000,593000000,8551,2850,5701,2850,0,1,2852,2737277
168,2850,7000,5500,38500000,2,22806,5703,1,593000000,593000000,8551,2850,5701,2850,0,1,2852,2678784
168,2850,7000,5500,38500000,2,22806,5703,1,593000000,593000000,8551,2850,5701,2850,0,1,2852,2660051
168,3250,7000,5500,38500000,2,26006,6503,1,633000000,633000000,9751,3250,6501,3250,0,1,3252,35007911
168,3250,7000,5500,38500000,2,26006,6503,1,633000000,633000000,9751,3250,6501,3250,0,1,3252,3089845
168,3250,7000,5500,38500000,2,26006,6503,1,633000000,633000000,9751,3250,6501,3250,0,1,3252,3088641
168,3250,7000,5500,38500000,2,26006,6503,1,633000000,633000000,9751,3250,6501,3250,0,1,3252,3087474
168,3250,7000,5500,38500000,2,26006,6503,1,633000000,633000000,9751,3250,6501,3250,0,1,3252,3084997
168,3250,7000,5500,38500000,2,26006,6503,1,633000000,633000000,9751,3250,6501,3250,0,1,3252,3010115
168,3250,7000,5500,38500000,2,26006,6503,1,633000000,633000000,9751,3250,6501,3250,0,1,3252,3000563
168,3650,7000,5500,38500000,2,29206,7303,1,673000000,673000000,10951,3650,7301,3650,0,1,3652,41116318
168,3650,7000,5500,38500000,2,29206,7303,1,673000000,673000000,10951,3650,7301,3650,0,1,3652,3403029
168,3650,7000,5500,38500000,2,29206,7303,1,673000000,673000000,10951,3650,7301,3650,0,1,3652,3404092
168,3650,7000,5500,38500000,2,29206,7303,1,673000000,673000000,10951,3650,7301,3650,0,1,3652,3401896
168,3650,7000,5500,38500000,2,29206,7303,1,673000000,673000000,10951,3650,7301,3650,0,1,3652,3400503
168,3650,7000,5500,38500000,2,29206,7303,1,673000000,673000000,10951,3650,7301,3650,0,1,3652,3311561
168,3650,7000,5500,38500000,2,29206,7303,1,673000000,673000000,10951,3650,7301,3650,0,1,3652,3283165
168,4050,7000,5500,38500000,2,32406,8103,1,713000000,713000000,12151,4050,8101,4050,0,1,4052,46560117
168,4050,7000,5500,38500000,2,32406,8103,1,713000000,713000000,12151,4050,8101,4050,0,1,4052,3764715
168,4050,7000,5500,38500000,2,32406,8103,1,713000000,713000000,12151,4050,8101,4050,0,1,4052,3763173
168,4050,7000,5500,38500000,2,32406,8103,1,713000000,713000000,12151,4050,8101,4050,0,1,4052,3728330
168,4050,7000,5500,38500000,2,32406,8103,1,713000000,713000000,12151,4050,8101,4050,0,1,4052,3761133
168,4050,7000,5500,38500000,2,32406,8103,1,713000000,713000000,12151,4050,8101,4050,0,1,4052,3668374
168,4050,7000,5500,38500000,2,32406,8103,1,713000000,713000000,12151,4050,8101,4050,0,1,4052,3663312
168,4450,7000,5500,38500000,2,35606,8903,1,753000000,753000000,13351,4450,8901,4450,0,1,4452,50410775
168,4450,7000,5500,38500000,2,35606,8903,1,753000000,753000000,13351,4450,8901,4450,0,1,4452,4070027
168,4450,7000,5500,38500000,2,35606,8903,1,753000000,753000000,13351,4450,8901,4450,0,1,4452,4072558
168,4450,7000,5500,38500000,2,35606,8903,1,753000000,753000000,13351,4450,8901,4450,0,1,4452,4071310
168,4450,7000,5500,38500000,2,35606,8903,1,753000000,753000000,13351,4450,8901,4450,0,1,4452,4068505
168,4450,7000,5500,38500000,2,35606,8903,1,753000000,753000000,13351,4450,8901,4450,0,1,4452,3962821
168,4450,7000,5500,38500000,2,35606,8903,1,753000000,753000000,13351,4450,8901,4450,0,1,4452,3942659
168,4850,7000,5500,38500000,2,38806,9703,1,793000000,793000000,14551,4850,9701,4850,0,1,4852,55128356
168,4850,7000,5500,38500000,2,38806,9703,1,793000000,793000000,14551,4850,9701,4850,0,1,4852,4437784
168,4850,7000,5500,38500000,2,38806,9703,1,793000000,793000000,14551,4850,9701,4850,0,1,4852,4436208
168,4850,7000,5500,38500000,2,38806,9703,1,793000000,793000000,14551,4850,9701,4850,0,1,4852,4432038
168,4850,7000,5500,38500000,2,38806,9703,1,793000000,793000000,14551,4850,9701,4850,0,1,4852,4426864
168,4850,7000,5500,38500000,2,38806,9703,1,793000000,793000000,14551,4850,9701,4850,0,1,4852,4350850
168,4850,7000,5500,38500000,2,38806,9703,1,793000000,793000000,14551,4850,9701,4850,0,1,4852,4341397
168,5250,7000,5500,38500000,2,42006,10503,1,833000000,833000000,15751,5250,10501,5250,0,1,5252,60203242
168,5250,7000,5500,38500000,2,42006,10503,1,833000000,833000000,15751,5250,10501,5250,0,1,5252,4741979
168,5250,7000,5500,38500000,2,42006,10503,1,833000000,833000000,15751,5250,10501,5250,0,1,5252,4743628
168,5250,7000,5500,38500000,2,42006,10503,1,833000000,833000000,15751,5250,10501,5250,0,1,5252,4740387
168,5250,7000,5500,38500000,2,42006,10503,1,833000000,833000000,15751,5250,10501,5250,0,1,5252,4733688
168,5250,7000,5500,38500000,2,42006,10503,1,833000000,833000000,15751,5250,10501,5250,0,1,5252,4640784
168,5250,7000,5500,38500000,2,42006,10503,1,833000000,833000000,15751,5250,10501,5250,0,1,5252,4635192
168,5650,7000,5500,38500000,2,45206,11303,1,873000000,873000000,16951,5650,11301,5650,0,1,5652,62568352
168,5650,7000,5500,38500000,2,45206,11303,1,873000000,873000000,16951,5650,11301,5650,0,1,5652,5107787
168,5650,7000,5500,38500000,2,45206,11303,1,873000000,873000000,16951,5650,11301,5650,0,1,5652,5104337
168,5650,7000,5500,38500000,2,45206,11303,1,873000000,873000000,16951,5650,11301,5650,0,1,5652,5099371
168,5650,7000,5500,38500000,2,45206,11303,1,873000000,873000000,16951,5650,11301,5650,0,1,5652,5063407
168,5650,7000,5500,38500000,2,45206,11303,1,873000000,873000000,16951,5650,11301,5650,0,1,5652,4978331
168,5650,7000,5500,38500000,2,45206,11303,1,873000000,873000000,16951,5650,11301,5650,0,1,5652,4959361
168,6050,7000,5500,38500000,2,48406,12103,1,913000000,913000000,18151,6050,12101,6050,0,1,6052,70078578
168,6050,7000,5500,38500000,2,48406,12103,1,913000000,913000000,18151,6050,12101,6050,0,1,6052,5370685
168,6050,7000,5500,38500000,2,48406,12103,1,913000000,913000000,18151,6050,12101,6050,0,1,6052,5378301
168,6050,7000,5500,38500000,2,48406,12103,1,913000000,913000000,18151,6050,12101,6050,0,1,6052,5376240
168,6050,7000,5500,38500000,2,48406,12103,1,913000000,913000000,18151,6050,12101,6050,0,1,6052,5373469
168,6050,7000,5500,38500000,2,48406,12103,1,913000000,913000000,18151,6050,12101,6050,0,1,6052,5245516
168,6050,7000,5500,38500000,2,48406,12103,1,913000000,913000000,18151,6050,12101,6050,0,1,6052,5179298
168,6450,7000,5500,38500000,2,51606,12903,1,953000000,953000000,19351,6450,12901,6450,0,1,6452,76600444
168,6450,7000,5500,38500000,2,51606,12903,1,953000000,953000000,19351,6450,12901,6450,0,1,6452,5715240
168,6450,7000,5500,38500000,2,51606,12903,1,953000000,953000000,19351,6450,12901,6450,0,1,6452,5713297
168,6450,7000,5500,38500000,2,51606,12903,1,953000000,953000000,19351,6450,12901,6450,0,1,6452,5711435
168,6450,7000,5500,38500000,2,51606,12903,1,953000000,953000000,19351,6450,12901,6450,0,1,6452,5707743
168,6450,7000,5500,38500000,2,51606,12903,1,953000000,953000000,19351,6450,12901,6450,0,1,6452,5561357
168,6450,7000,5500,38500000,2,51606,12903,1,953000000,953000000,19351,6450,12901,6450,0,1,6452,5547369
168,6850,7000,5500,38500000,2,54806,13703,1,993000000,993000000,20551,6850,13701,6850,0,1,6852,79436464
168,6850,7000,5500,38500000,2,54806,13703,1,993000000,993000000,20551,6850,13701,6850,0,1,6852,6135102
168,6850,7000,5500,38500000,2,54806,13703,1,993000000,993000000,20551,6850,13701,6850,0,1,6852,6133058
168,6850,7000,5500,38500000,2,54806,13703,1,993000000,993000000,20551,6850,13701,6850,0,1,6852,6131324
168,6850,7000,5500,38500000,2,54806,13703,1,993000000,993000000,20551,6850,13701,6850,0,1,6852,6124593
168,6850,7000,5500,38500000,2,54806,13703,1,993000000,993000000,20551,6850,13701,6850,0,1,6852,5962607
168,6850,7000,5500,38500000,2,54806,13703,1,993000000,993000000,20551,6850,13701,6850,0,1,6852,5913452
168,50,7000,5100,35700000,2,406,103,1,290440000,290440000,151,50,101,50,0,1,52,408335
168,50,7000,5100,35700000,2,406,103,1,290440000,290440000,151,50,101,50,0,1,52,313264
168,50,7000,5100,35700000,2,406,103,1,290440000,290440000,151,50,101,50,0,1,52,371923
168,50,7000,5100,35700000,2,406,103,1,290440000,290440000,151,50,101,50,0,1,52,393439
168,50,7000,5100,35700000,2,406,103,1,290440000,290440000,151,50,101,50,0,1,52,392231
168,50,7000,5100,35700000,2,406,103,1,290440000,290440000,151,50,101,50,0,1,52,393742
168,50,7000,5100,35700000,2,406,103,1,290440000,290440000,151,50,101,50,0,1,52,393907
168,450,7000,5100,35700000,2,3606,903,1,329160000,329160000,1351,450,901,450,0,1,452,3770031
168,450,7000,5100,35700000,2,3606,903,1,329160000,329160000,1351,450,901,450,0,1,452,700511
168,450,7000,5100,35700000,2,3606,903,1,329160000,329160000,1351,450,901,450,0,1,452,698633
168,450,7000,5100,35700000,2,3606,903,1,329160000,329160000,1351,450,901,450,0,1,452,701251
168,450,7000,5100,35700000,2,3606,903,1,329160000,329160000,1351,450,901,450,0,1,452,701699
168,450,7000,5100,35700000,2,3606,903,1,329160000,329160000,1351,450,901,450,0,1,452,701982
168,450,7000,5100,35700000,2,3606,903,1,329160000,329160000,1351,450,901,450,0,1,452,702425
168,850,7000,5100,35700000,2,6806,1703,1,367880000,367880000,2551,850,1701,850,0,1,852,7890346
168,850,7000,5100,35700000,2,6806,1703,1,367880000,367880000,2551,850,1701,850,0,1,852,973108
168,850,7000,5100,35700000,2,6806,1703,1,367880000,367880000,2551,850,1701,850,0,1,852,972478
168,850,7000,5100,35700000,2,6806,1703,1,367880000,367880000,2551,850,1701,850,0,1,852,974031
168,850,7000,5100,35700000,2,6806,1703,1,367880000,367880000,2551,850,1701,850,0,1,852,973659
168,850,7000,5100,35700000,2,6806,1703,1,367880000,367880000,2551,850,1701,850,0,1,852,966246
168,850,7000,5100,35700000,2,6806,1703,1,367880000,367880000,2551,850,1701,850,0,1,852,965091
168,1250,7000,5100,35700000,2,10006,2503,1,406600000,406600000,3751,1250,2501,1250,0,1,1252,11904324
168,1250,7000,5100,35700000,2,10006,2503,1,406600000,406600000,3751,1250,2501,1250,0,1,1252,1290597
168,1250,7000,5100,35700000,2,10006,2503,1,406600000,406600000,3751,1250,2501,1250,0,1,1252,1289310
168,1250,7000,5100,35700000,2,10006,2503,1,406600000,406600000,3751,1250,2501,1250,0,1,1252,1289876
168,1250,7000,5100,35700000,2,10006,2503,1,406600000,406600000,3751,1250,2501,1250,0,1,1252,1288097
168,1250,7000,5100,35700000,2,10006,2503,1,406600000,406600000,3751,1250,2501,1250,0,1,1252,1261254
168,1250,7000,5100,35700000,2,10006,2503,1,406600000,406600000,3751,1250,2501,1250,0,1,1252,1260175
168,1650,7000,5100,35700000,2,13206,3303,1,445320000,445320000,4951,1650,3301,1650,0,1,1652,16037020
168,1650,7000,5100,35700000,2,13206,3303,1,445320000,445320000,4951,1650,3301,1650,0,1,1652,1577771
168,1650,7000,5100,35700000,2,13206,3303,1,445320000,445320000,4951,1650,3301,1650,0,1,1652,1578337
168,1650,7000,5100,35700000,2,13206,3303,1,445320000,445320000,4951,1650,3301,1650,0,1,1652,1577024
168,1650,7000,5100,35700000,2,13206,3303,1,445320000,445320000,4951,1650,3301,1650,0,1,1652,1575437
168,1650,7000,5100,35700000,2,13206,3303,1,445320000,445320000,4951,1650,3301,1650,0,1,1652,1556967
168,1650,7000,5100,35700000,2,13206,3303,1,445320000,445320000,4951,1650,3301,1650,0,1,1652,1555757
168,2050,7000,5100,35700000,2,16406,4103,1,484040000,484040000,6151,2050,4101,2050,0,1,2052,20336806
168,2050,7000,5100,35700000,2,16406,4103,1,484040000,484040000,6151,2050,4101,2050,0,1,2052,1904626
168,2050,7000,5100,35700000,2,16406,4103,1,484040000,484040000,6151,2050,4101,2050,0,1,2052,1903827
168,2050,7000,5100,35700000,2,16406,4103,1,484040000,484040000,6151,2050,4101,2050,0,1,2052,1905295
168,2050,7000,5100,35700000,2,16406,4103,1,484040000,484040000,6151,2050,4101,2050,0,1,2052,1902676
168,2050,7000,5100,35700000,2,16406,4103,1,484040000,484040000,6151,2050,4101,2050,0,1,2052,1881492
168,2050,7000,5100,35700000,2,16406,4103,1,484040000,484040000,6151,2050,4101,2050,0,1,2052,1882792
168,2450,7000,5100,35700000,2,19606,4903,1,522760000,522760000,7351,2450,4901,2450,0,1,2452,24389859
168,2450,7000,5100,35700000,2,19606,4903,1,522760000,522760000,7351,2450,4901,2450,0,1,2452,2244603
168,2450,7000,5100,35700000,2,19606,4903,1,522760000,522760000,7351,2450,4901,2450,0,1,2452,2242934
168,2450,7000,5100,35700000,2,19606,4903,1,522760000,522760000,7351,2450,4901,2450,0,1,2452,2243843
168,2450,7000,5100,35700000,2,19606,4903,1,522760000,522760000,7351,2450,4901,2450,0,1,2452,2241141
168,2450,7000,5100,35700000,2,19606,4903,1,522760000,522760000,7351,2450,4901,2450,0,1,2452,2165447
168,2450,7000,5100,35700000,2,19606,4903,1,522760000,522760000,7351,2450,4901,2450,0,1,2452,2176504
168,2850,7000,5100,35700000,2,22806,5703,1,561480000,561480000,8551,2850,5701,2850,0,1,2852,29501991
168,2850,7000,5100,35700000,2,22806,5703,1,561480000,561480000,8551,2850,5701,2850,0,1,2852,2573185
168,2850,7000,5100,35700000,2,22806,5703,1,561480000,561480000,8551,2850,5701,2850,0,1,2852,2570488
168,2850,7000,5100,35700000,2,22806,5703,1,561480000,561480000,8551,2850,5701,2850,0,1,2852,2574305
168,2850,7000,5100,35700000,2,22806,5703,1,561480000,561480000,8551,2850,5701,2850,0,1,2852,2569125
168,2850,7000,5100,35700000,2,22806,5703,1,561480000,561480000,8551,2850,5701,2850,0,1,2852,2491140
168,2850,7000,5100,35700000,2,22806,5703,1,561480000,561480000,8551,2850,5701,2850,0,1,2852,2457197
168,3250,7000,5100,35700000,2,26006,6503,1,600200000,600200000,9751,3250,6501,3250,0,1,3252,33210451
168,3250,7000,5100,35700000,2,26006,6503,1,600200000,600200000,9751,3250,6501,3250,0,1,3252,2894622
168,3250,7000,5100,35700000,2,26006,6503,1,600200000,600200000,9751,3250,6501,3250,0,1,3252,2895581
168,3250,7000,5100,35700000,2,26006,6503,1,600200000,600200000,9751,3250,6501,3250,0,1,3252,2896776
168,3250,7000,5100,35700000,2,26006,6503,1,600200000,600200000,9751,3250,6501,3250,0,1,3252,2892876
168,3250,7000,5100,35700000,2,26006,6503,1,600200000,600200000,9751,3250,6501,3250,0,1,3252,2817833
168,3250,7000,5100,35700000,2,26006,6503,1,600200000,600200000,9751,3250,6501,3250,0,1,3252,2788764
168,3650,7000,5100,35700000,2,29206,7303,1,638920000,638920000,10951,3650,7301,3650,0,1,3652,37586049
168,3650,7000,5100,35700000,2,29206,7303,1,638920000,638920000,10951,3650,7301,3650,0,1,3652,3172504
168,3650,7000,5100,35700000,2,29206,7303,1,638920000,638920000,10951,3650,7301,3650,0,1,3652,3170330
168,3650,7000,5100,35700000,2,29206,7303,1,638920000,638920000,10951,3650,7301,3650,0,1,3652,3171456
168,3650,7000,5100,35700000,2,29206,7303,1,638920000,638920000,10951,3650,7301,3650,0,1,3652,3168186
168,3650,7000,5100,35700000,2,29206,7303,1,638920000,638920000,10951,3650,7301,3650,0,1,3652,3100748
168,3650,7000,5100,35700000,2,29206,7303,1,638920000,638920000,10951,3650,7301,3650,0,1,3652,3071672
168,4050,7000,5100,35700000,2,32406,8103,1,677640000,677640000,12151,4050,8101,4050,0,1,4052,41539630
168,4050,7000,5100,35700000,2,32406,8103,1,677640000,677640000,12151,4050,8101,4050,0,1,4052,3507252
168,4050,7000,5100,35700000,2,32406,8103,1,677640000,677640000,12151,4050,8101,4050,0,1,4052,3505876
168,4050,7000,5100,35700000,2,32406,8103,1,677640000,677640000,12151,4050,8101,4050,0,1,4052,3496514
168,4050,7000,5100,35700000,2,32406,8103,1,677640000,677640000,12151,4050,8101,4050,0,1,4052,3494779
168,4050,7000,5100,35700000,2,32406,8103,1,677640000,677640000,12151,4050,8101,4050,0,1,4052,3433995
168,4050,7000,5100,35700000,2,32406,8103,1,677640000,677640000,12151,4050,8101,4050,0,1,4052,3429306
168,4450,7000,5100,35700000,2,35606,8903,1,716360000,716360000,13351,4450,8901,4450,0,1,4452,48426943
168,4450,7000,5100,35700000,2,35606,8903,1,716360000,716360000,13351,4450,8901,4450,0,1,4452,3850085
168,4450,7000,5100,35700000,2,35606,8903,1,716360000,716360000,13351,4450,8901,4450,0,1,4452,3848642
168,4450,7000,5100,35700000,2,35606,8903,1,716360000,716360000,13351,4450,8901,4450,0,1,4452,3846175
168,4450,7000,5100,35700000,2,35606,8903,1,716360000,716360000,13351,4450,8901,4450,0,1,4452,3844132
168,4450,7000,5100,35700000,2,35606,8903,1,716360000,716360000,13351,4450,8901,4450,0,1,4452,3742097
168,4450,7000,5100,35700000,2,35606,8903,1,716360000,716360000,13351,4450,8901,4450,0,1,4452,3724950
168,4850,7000,5100,35700000,2,38806,9703,1,755080000,755080000,14551,4850,9701,4850,0,1,4852,51960975
168,4850,7000,5100,35700000,2,38806,9703,1,755080000,755080000,14551,4850,9701,4850,0,1,4852,4110290
168,4850,7000,5100,35700000,2,38806,9703,1,755080000,755080000,14551,4850,9701,4850,0,1,4852,4107593
168,4850,7000,5100,35700000,2,38806,9703,1,755080000,755080000,14551,4850,9701,4850,0,1,4852,4108980
168,4850,7000,5100,35700000,2,38806,9703,1,755080000,755080000,14551,4850,9701,4850,0,1,4852,4098794
168,4850,7000,5100,35700000,2,38806,9703,1,755080000,755080000,14551,4850,9701,4850,0,1,4852,4034554
168,4850,7000,5100,35700000,2,38806,9703,1,755080000,755080000,14551,4850,9701,4850,0,1,4852,4026513
168,5250,7000,5100,35700000,2,42006,10503,1,793800000,793800000,15751,5250,10501,5250,0,1,5252,55907515
168,5250,7000,5100,35700000,2,42006,10503,1,793800000,793800000,15751,5250,10501,5250,0,1,5252,4413051
168,5250,7000,5100,35700000,2,42006,10503,1,793800000,793800000,15751,5250,10501,5250,0,1,5252,4418026
168,5250,7000,5100,35700000,2,42006,10503,1,793800000,793800000,15751,5250,10501,5250,0,1,5252,4419712
168,5250,7000,5100,35700000,2,42006,10503,1,793800000,793800000,15751,5250,10501,5250,0,1,5252,4415304
168,5250,7000,5100,35700000,2,42006,10503,1,793800000,793800000,15751,5250,10501,5250,0,1,5252,4318993
168,5250,7000,5100,35700000,2,42006,10503,1,793800000,793800000,15751,5250,10501,5250,0,1,5252,4310373
168,5650,7000,5100,35700000,2,45206,11303,1,832520000,832520000,16951,5650,11301,5650,0,1,5652,61070007
168,5650,7000,5100,35700000,2,45206,11303,1,832520000,832520000,16951,5650,11301,5650,0,1,5652,4702046
168,5650,7000,5100,35700000,2,45206,11303,1,832520000,832520000,16951,5650,11301,5650,0,1,5652,4698992
168,5650,7000,5100,35700000,2,45206,11303,1,832520000,832520000,16951,5650,11301,5650,0,1,5652,4700552
168,5650,7000,5100,35700000,2,45206,11303,1,832520000,832520000,16951,5650,11301,5650,0,1,5652,4696342
168,5650,7000,5100,35700000,2,45206,11303,1,832520000,832520000,16951,5650,11301,5650,0,1,5652,4591246
168,5650,7000,5100,35700000,2,45206,11303,1,832520000,832520000,16951,5650,11301,5650,0,1,5652,4556758
168,6050,7000,5100,35700000,2,48406,12103,1,871240000,871240000,18151,6050,12101,6050,0,1,6052,63121615
168,6050,7000,5100,35700000,2,48406,12103,1,871240000,871240000,18151,6050,12101,6050,0,1,6052,5014145
168,6050,7000,5100,35700000,2,48406,12103,1,871240000,871240000,18151,6050,12101,6050,0,1,6052,5016027
168,6050,7000,5100,35700000,2,48406,12103,1,871240000,871240000,18151,6050,12101,6050,0,1,6052,5006511
168,6050,7000,5100,35700000,2,48406,12103,1,871240000,871240000,18151,6050,12101,6050,0,1,6052,5008288
168,6050,7000,5100,35700000,2,48406,12103,1,871240000,871240000,18151,6050,12101,6050,0,1,6052,4882906
168,6050,7000,5100,35700000,2,48406,12103,1,871240000,871240000,18151,6050,12101,6050,0,1,6052,4871802
168,6450,7000,5100,35700000,2,51606,12903,1,909960000,909960000,19351,6450,12901,6450,0,1,6452,64525240
168,6450,7000,5100,35700000,2,51606,12903,1,909960000,909960000,19351,6450,12901,6450,0,1,6452,5346629
168,6450,7000,5100,35700000,2,51606,12903,1,909960000,909960000,19351,6450,12901,6450,0,1,6452,5344533
168,6450,7000,5100,35700000,2,51606,12903,1,909960000,909960000,19351,6450,12901,6450,0,1,6452,5338968
168,6450,7000,5100,35700000,2,51606,12903,1,909960000,909960000,19351,6450,12901,6450,0,1,6452,5335861
168,6450,7000,5100,35700000,2,51606,12903,1,909960000,909960000,19351,6450,12901,6450,0,1,6452,5191284
168,6450,7000,5100,35700000,2,51606,12903,1,909960000,909960000,19351,6450,12901,6450,0,1,6452,5164401
168,6850,7000,5100,35700000,2,54806,13703,1,948680000,948680000,20551,6850,13701,6850,0,1,6852,73740938
168,6850,7000,5100,35700000,2,54806,13703,1,948680000,948680000,20551,6850,13701,6850,0,1,6852,5653958
168,6850,7000,5100,35700000,2,54806,13703,1,948680000,948680000,20551,6850,13701,6850,0,1,6852,5627041
168,6850,7000,5100,35700000,2,54806,13703,1,948680000,948680000,20551,6850,13701,6850,0,1,6852,5651936
168,6850,7000,5100,35700000,2,54806,13703,1,948680000,948680000,20551,6850,13701,6850,0,1,6852,5641606
168,6850,7000,5100,35700000,2,54806,13703,1,948680000,948680000,20551,6850,13701,6850,0,1,6852,5507423
168,6850,7000,5100,35700000,2,54806,13703,1,948680000,948680000,20551,6850,13701,6850,0,1,6852,5495383
168,50,7000,4700,32900000,2,406,103,1,267880000,267880000,151,50,101,50,0,1,52,369232
168,50,7000,4700,32900000,2,406,103,1,267880000,267880000,151,50,101,50,0,1,52,319388
168,50,7000,4700,32900000,2,406,103,1,267880000,267880000,151,50,101,50,0,1,52,318631
168,50,7000,4700,32900000,2,406,103,1,267880000,267880000,151,50,101,50,0,1,52,310805
168,50,7000,4700,32900000,2,406,103,1,267880000,267880000,151,50,101,50,0,1,52,283666
168,50,7000,4700,32900000,2,406,103,1,267880000,267880000,151,50,101,50,0,1,52,339905
168,50,7000,4700,32900000,2,406,103,1,267880000,267880000,151,50,101,50,0,1,52,339524
168,450,7000,4700,32900000,2,3606,903,1,305320000,305320000,1351,450,901,450,0,1,452,3447848
168,450,7000,4700,32900000,2,3606,903,1,305320000,305320000,1351,450,901,450,0,1,452,628748
168,450,7000,4700,32900000,2,3606,903,1,305320000,305320000,1351,450,901,450,0,1,452,654084
168,450,7000,4700,32900000,2,3606,903,1,305320000,305320000,1351,450,901,450,0,1,452,655592
168,450,7000,4700,32900000,2,3606,903,1,305320000,305320000,1351,450,901,450,0,1,452,654960
168,450,7000,4700,32900000,2,3606,903,1,305320000,305320000,1351,450,901,450,0,1,452,656321
168,450,7000,4700,32900000,2,3606,903,1,305320000,305320000,1351,450,901,450,0,1,452,656770
168,850,7000,4700,32900000,2,6806,1703,1,342760000,342760000,2551,850,1701,850,0,1,852,7149466
168,850,7000,4700,32900000,2,6806,1703,1,342760000,342760000,2551,850,1701,850,0,1,852,912886
168,850,7000,4700,32900000,2,6806,1703,1,342760000,342760000,2551,850,1701,850,0,1,852,911959
168,850,7000,4700,32900000,2,6806,1703,1,342760000,342760000,2551,850,1701,850,0,1,852,911331
168,850,7000,4700,32900000,2,6806,1703,1,342760000,342760000,2551,850,1701,850,0,1,852,912514
168,850,7000,4700,32900000,2,6806,1703,1,342760000,342760000,2551,850,1701,850,0,1,852,910851
168,850,7000,4700,32900000,2,6806,1703,1,342760000,342760000,2551,850,1701,850,0,1,852,909289
168,1250,7000,4700,32900000,2,10006,2503,1,380200000,380200000,3751,1250,2501,1250,0,1,1252,11039689
168,1250,7000,4700,32900000,2,10006,2503,1,380200000,380200000,3751,1250,2501,1250,0,1,1252,1184348
168,1250,7000,4700,32900000,2,10006,2503,1,380200000,380200000,3751,1250,2501,1250,0,1,1252,1113258
168,1250,7000,4700,32900000,2,10006,2503,1,380200000,380200000,3751,1250,2501,1250,0,1,1252,1177900
168,1250,7000,4700,32900000,2,10006,2503,1,380200000,380200000,3751,1250,2501,1250,0,1,1252,1183645
168,1250,7000,4700,32900000,2,10006,2503,1,380200000,380200000,3751,1250,2501,1250,0,1,1252,1175530
168,1250,7000,4700,32900000,2,10006,2503,1,380200000,380200000,3751,1250,2501,1250,0,1,1252,1173042
168,1650,7000,4700,32900000,2,13206,3303,1,417640000,417640000,4951,1650,3301,1650,0,1,1652,14713071
168,1650,7000,4700,32900000,2,13206,3303,1,417640000,417640000,4951,1650,3301,1650,0,1,1652,1460656
168,1650,7000,4700,32900000,2,13206,3303,1,417640000,417640000,4951,1650,3301,1650,0,1,1652,1458599
168,1650,7000,4700,32900000,2,13206,3303,1,417640000,417640000,4951,1650,3301,1650,0,1,1652,1459357
168,1650,7000,4700,32900000,2,13206,3303,1,417640000,417640000,4951,1650,3301,1650,0,1,1652,1460101
168,1650,7000,4700,32900000,2,13206,3303,1,417640000,417640000,4951,1650,3301,1650,0,1,1652,1447818
168,1650,7000,4700,32900000,2,13206,3303,1,417640000,417640000,4951,1650,3301,1650,0,1,1652,1446648
168,2050,7000,4700,32900000,2,16406,4103,1,455080000,455080000,6151,2050,4101,2050,0,1,2052,18266743
168,2050,7000,4700,32900000,2,16406,4103,1,455080000,455080000,6151,2050,4101,2050,0,1,2052,1795085
168,2050,7000,4700,32900000,2,16406,4103,1,455080000,455080000,6151,2050,4101,2050,0,1,2052,1798870
168,2050,7000,4700,32900000,2,16406,4103,1,455080000,455080000,6151,2050,4101,2050,0,1,2052,1799749
168,2050,7000,4700,32900000,2,16406,4103,1,455080000,455080000,6151,2050,4101,2050,0,1,2052,1783284
168,2050,7000,4700,32900000,2,16406,4103,1,455080000,455080000,6151,2050,4101,2050,0,1,2052,1767704
168,2050,7000,4700,32900000,2,16406,4103,1,455080000,455080000,6151,2050,4101,2050,0,1,2052,1745770
168,2450,7000,4700,32900000,2,19606,4903,1,492520000,492520000,7351,2450,4901,2450,0,1,2452,22468146
168,2450,7000,4700,32900000,2,19606,4903,1,492520000,492520000,7351,2450,4901,2450,0,1,2452,2044660
168,2450,7000,4700,32900000,2,19606,4903,1,492520000,492520000,7351,2450,4901,2450,0,1,2452,2043684
168,2450,7000,4700,32900000,2,19606,4903,1,492520000,492520000,7351,2450,4901,2450,0,1,2452,2041782
168,2450,7000,4700,32900000,2,19606,4903,1,492520000,492520000,7351,2450,4901,2450,0,1,2452,2039280
168,2450,7000,4700,32900000,2,19606,4903,1,492520000,492520000,7351,2450,4901,2450,0,1,2452,2014967
168,2450,7000,4700,32900000,2,19606,4903,1,492520000,492520000,7351,2450,4901,2450,0,1,2452,2011600
168,2850,7000,4700,32900000,2,22806,5703,1,529960000,529960000,8551,2850,5701,2850,0,1,2852,26458307
168,2850,7000,4700,32900000,2,22806,5703,1,529960000,529960000,8551,2850,5701,2850,0,1,2852,2354384
168,2850,7000,4700,32900000,2,22806,5703,1,529960000,529960000,8551,2850,5701,2850,0,1,2852,2357814
168,2850,7000,4700,32900000,2,22806,5703,1,529960000,529960000,8551,2850,5701,2850,0,1,2852,2358939
168,2850,7000,4700,32900000,2,22806,5703,1,529960000,529960000,8551,2850,5701,2850,0,1,2852,2355984
168,2850,7000,4700,32900000,2,22806,5703,1,529960000,529960000,8551,2850,5701,2850,0,1,2852,2320588
168,2850,7000,4700,32900000,2,22806,5703,1,529960000,529960000,8551,2850,5701,2850,0,1,2852,2318933
168,3250,7000,4700,32900000,2,26006,6503,1,567400000,567400000,9751,3250,6501,3250,0,1,3252,30448441
168,3250,7000,4700,32900000,2,26006,6503,1,567400000,567400000,9751,3250,6501,3250,0,1,3252,2667028
168,3250,7000,4700,32900000,2,26006,6503,1,567400000,567400000,9751,3250,6501,3250,0,1,3252,2669026
168,3250,7000,4700,32900000,2,26006,6503,1,567400000,567400000,9751,3250,6501,3250,0,1,3252,2670220
168,3250,7000,4700,32900000,2,26006,6503,1,567400000,567400000,9751,3250,6501,3250,0,1,3252,2665340
168,3250,7000,4700,32900000,2,26006,6503,1,567400000,567400000,9751,3250,6501,3250,0,1,3252,2611695
168,3250,7000,4700,32900000,2,26006,6503,1,567400000,567400000,9751,3250,6501,3250,0,1,3252,2609906
168,3650,7000,4700,32900000,2,29206,7303,1,604840000,604840000,10951,3650,7301,3650,0,1,3652,34139637
168,3650,7000,4700,32900000,2,29206,7303,1,604840000,604840000,10951,3650,7301,3650,0,1,3652,2995194
168,3650,7000,4700,32900000,2,29206,7303,1,604840000,604840000,10951,3650,7301,3650,0,1,3652,2993746
168,3650,7000,4700,32900000,2,29206,7303,1,604840000,604840000,10951,3650,7301,3650,0,1,3652,2991959
168,3650,7000,4700,32900000,2,29206,7303,1,604840000,604840000,10951,3650,7301,3650,0,1,3652,2984236
168,3650,7000,4700,32900000,2,29206,7303,1,604840000,604840000,10951,3650,7301,3650,0,1,3652,2920055
168,3650,7000,4700,32900000,2,29206,7303,1,604840000,604840000,10951,3650,7301,3650,0,1,3652,2915607
168,4050,7000,4700,32900000,2,32406,8103,1,642280000,642280000,12151,4050,8101,4050,0,1,4052,39746272
168,4050,7000,4700,32900000,2,32406,8103,1,642280000,642280000,12151,4050,8101,4050,0,1,4052,3226606
168,4050,7000,4700,32900000,2,32406,8103,1,642280000,642280000,12151,4050,8101,4050,0,1,4052,3225218
168,4050,7000,4700,32900000,2,32406,8103,1,642280000,642280000,12151,4050,8101,4050,0,1,4052,3223716
168,4050,7000,4700,32900000,2,32406,8103,1,642280000,642280000,12151,4050,8101,4050,0,1,4052,3221576
168,4050,7000,4700,32900000,2,32406,8103,1,642280000,642280000,12151,4050,8101,4050,0,1,4052,3160121
168,4050,7000,4700,32900000,2,32406,8103,1,642280000,642280000,12151,4050,8101,4050,0,1,4052,3153224
168,4450,7000,4700,32900000,2,35606,8903,1,679720000,679720000,13351,4450,8901,4450,0,1,4452,41957765
168,4450,7000,4700,32900000,2,35606,8903,1,679720000,679720000,13351,4450,8901,4450,0,1,4452,3515226
168,4450,7000,4700,32900000,2,35606,8903,1,679720000,679720000,13351,4450,8901,4450,0,1,4452,3513773
168,4450,7000,4700,32900000,2,35606,8903,1,679720000,679720000,13351,4450,8901,4450,0,1,4452,3501416
168,4450,7000,4700,32900000,2,35606,8903,1,679720000,679720000,13351,4450,8901,4450,0,1,4452,3503447
168,4450,7000,4700,32900000,2,35606,8903,1,679720000,679720000,13351,4450,8901,4450,0,1,4452,3448397
168,4450,7000,4700,32900000,2,35606,8903,1,679720000,679720000,13351,4450,8901,4450,0,1,4452,3443656
168,4850,7000,4700,32900000,2,38806,9703,1,717160000,717160000,14551,4850,9701,4850,0,1,4852,46605345
168,4850,7000,4700,32900000,2,38806,9703,1,717160000,717160000,14551,4850,9701,4850,0,1,4852,3774426
168,4850,7000,4700,32900000,2,38806,9703,1,717160000,717160000,14551,4850,9701,4850,0,1,4852,3775802
168,4850,7000,4700,32900000,2,38806,9703,1,717160000,717160000,14551,4850,9701,4850,0,1,4852,3777122
168,4850,7000,4700,32900000,2,38806,9703,1,717160000,717160000,14551,4850,9701,4850,0,1,4852,3772043
168,4850,7000,4700,32900000,2,38806,9703,1,717160000,717160000,14551,4850,9701,4850,0,1,4852,3711541
168,4850,7000,4700,32900000,2,38806,9703,1,717160000,717160000,14551,4850,9701,4850,0,1,4852,3707454
168,5250,7000,4700,32900000,2,42006,10503,1,754600000,754600000,15751,5250,10501,5250,0,1,5252,51372995
168,5250,7000,4700,32900000,2,42006,10503,1,754600000,754600000,15751,5250,10501,5250,0,1,5252,4087524
168,5250,7000,4700,32900000,2,42006,10503,1,754600000,754600000,15751,5250,10501,5250,0,1,5252,4088975
168,5250,7000,4700,32900000,2,42006,10503,1,754600000,754600000,15751,5250,10501,5250,0,1,5252,4090396
168,5250,7000,4700,32900000,2,42006,10503,1,754600000,754600000,15751,5250,10501,5250,0,1,5252,4074532
168,5250,7000,4700,32900000,2,42006,10503,1,754600000,754600000,15751,5250,10501,5250,0,1,5252,4008317
168,5250,7000,4700,32900000,2,42006,10503,1,754600000,754600000,15751,5250,10501,5250,0,1,5252,3988233
168,5650,7000,4700,32900000,2,45206,11303,1,792040000,792040000,16951,5650,11301,5650,0,1,5652,54616961
168,5650,7000,4700,32900000,2,45206,11303,1,792040000,792040000,16951,5650,11301,5650,0,1,5652,4395560
168,5650,7000,4700,32900000,2,45206,11303,1,792040000,792040000,16951,5650,11301,5650,0,1,5652,4393628
168,5650,7000,4700,32900000,2,45206,11303,1,792040000,792040000,16951,5650,11301,5650,0,1,5652,4391128
168,5650,7000,4700,32900000,2,45206,11303,1,792040000,792040000,16951,5650,11301,5650,0,1,5652,4363247
168,5650,7000,4700,32900000,2,45206,11303,1,792040000,792040000,16951,5650,11301,5650,0,1,5652,4316928
168,5650,7000,4700,32900000,2,45206,11303,1,792040000,792040000,16951,5650,11301,5650,0,1,5652,4298280
168,6050,7000,4700,32900000,2,48406,12103,1,829480000,829480000,18151,6050,12101,6050,0,1,6052,57121027
168,6050,7000,4700,32900000,2,48406,12103,1,829480000,829480000,18151,6050,12101,6050,0,1,6052,4664999
168,6050,7000,4700,32900000,2,48406,12103,1,829480000,829480000,18151,6050,12101,6050,0,1,6052,4658084
168,6050,7000,4700,32900000,2,48406,12103,1,829480000,829480000,18151,6050,12101,6050,0,1,6052,4659832
168,6050,7000,4700,32900000,2,48406,12103,1,829480000,829480000,18151,6050,12101,6050,0,1,6052,4649927
168,6050,7000,4700,32900000,2,48406,12103,1,829480000,829480000,18151,6050,12101,6050,0,1,6052,4548854
168,6050,7000,4700,32900000,2,48406,12103,1,829480000,829480000,18151,6050,12101,6050,0,1,6052,4542585
168,6450,7000,4700,32900000,2,51606,12903,1,866920000,866920000,19351,6450,12901,6450,0,1,6452,62901915
168,6450,7000,4700,32900000,2,51606,12903,1,866920000,866920000,19351,6450,12901,6450,0,1,6452,4930661
168,6450,7000,4700,32900000,2,51606,12903,1,866920000,866920000,19351,6450,12901,6450,0,1,6452,4932624
168,6450,7000,4700,32900000,2,51606,12903,1,866920000,866920000,19351,6450,12901,6450,0,1,6452,4929028
168,6450,7000,4700,32900000,2,51606,12903,1,866920000,866920000,19351,6450,12901,6450,0,1,6452,4923140
168,6450,7000,4700,32900000,2,51606,12903,1,866920000,866920000,19351,6450,12901,6450,0,1,6452,4814213
168,6450,7000,4700,32900000,2,51606,12903,1,866920000,866920000,19351,6450,12901,6450,0,1,6452,4775323
168,6850,7000,4700,32900000,2,54806,13703,1,904360000,904360000,20551,6850,13701,6850,0,1,6852,65434972
168,6850,7000,4700,32900000,2,54806,13703,1,904360000,904360000,20551,6850,13701,6850,0,1,6852,5228331
168,6850,7000,4700,32900000,2,54806,13703,1,904360000,904360000,20551,6850,13701,6850,0,1,6852,5247797
168,6850,7000,4700,32900000,2,54806,13703,1,904360000,904360000,20551,6850,13701,6850,0,1,6852,5245755
168,6850,7000,4700,32900000,2,54806,13703,1,904360000,904360000,20551,6850,13701,6850,0,1,6852,5242574
168,6850,7000,4700,32900000,2,54806,13703,1,904360000,904360000,20551,6850,13701,6850,0,1,6852,5108983
168,6850,7000,4700,32900000,2,54806,13703,1,904360000,904360000,20551,6850,13701,6850,0,1,6852,5048776
168,50,7000,4300,30100000,2,406,103,1,245320000,245320000,151,50,101,50,0,1,52,334286
168,50,7000,4300,30100000,2,406,103,1,245320000,245320000,151,50,101,50,0,1,52,300992
168,50,7000,4300,30100000,2,406,103,1,245320000,245320000,151,50,101,50,0,1,52,300248
168,50,7000,4300,30100000,2,406,103,1,245320000,245320000,151,50,101,50,0,1,52,295236
168,50,7000,4300,30100000,2,406,103,1,245320000,245320000,151,50,101,50,0,1,52,267362
168,50,7000,4300,30100000,2,406,103,1,245320000,245320000,151,50,101,50,0,1,52,320355
168,50,7000,4300,30100000,2,406,103,1,245320000,245320000,151,50,101,50,0,1,52,319978
168,450,7000,4300,30100000,2,3606,903,1,281480000,281480000,1351,450,901,450,0,1,452,3143778
168,450,7000,4300,30100000,2,3606,903,1,281480000,281480000,1351,450,901,450,0,1,452,578931
168,450,7000,4300,30100000,2,3606,903,1,281480000,281480000,1351,450,901,450,0,1,452,592775
168,450,7000,4300,30100000,2,3606,903,1,281480000,281480000,1351,450,901,450,0,1,452,594020
168,450,7000,4300,30100000,2,3606,903,1,281480000,281480000,1351,450,901,450,0,1,452,595057
168,450,7000,4300,30100000,2,3606,903,1,281480000,281480000,1351,450,901,450,0,1,452,599853
168,450,7000,4300,30100000,2,3606,903,1,281480000,281480000,1351,450,901,450,0,1,452,602108
168,850,7000,4300,30100000,2,6806,1703,1,317640000,317640000,2551,850,1701,850,0,1,852,6407067
168,850,7000,4300,30100000,2,6806,1703,1,317640000,317640000,2551,850,1701,850,0,1,852,839268
168,850,7000,4300,30100000,2,6806,1703,1,317640000,317640000,2551,850,1701,850,0,1,852,836489
168,850,7000,4300,30100000,2,6806,1703,1,317640000,317640000,2551,850,1701,850,0,1,852,837973
168,850,7000,4300,30100000,2,6806,1703,1,317640000,317640000,2551,850,1701,850,0,1,852,838900
168,850,7000,4300,30100000,2,6806,1703,1,317640000,317640000,2551,850,1701,850,0,1,852,840365
168,850,7000,4300,30100000,2,6806,1703,1,317640000,317640000,2551,850,1701,850,0,1,852,839864
168,1250,7000,4300,30100000,2,10006,2503,1,353800000,353800000,3751,1250,2501,1250,0,1,1252,8835820
168,1250,7000,4300,30100000,2,10006,2503,1,353800000,353800000,3751,1250,2501,1250,0,1,1252,1018896
168,1250,7000,4300,30100000,2,10006,2503,1,353800000,353800000,3751,1250,2501,1250,0,1,1252,1090279
168,1250,7000,4300,30100000,2,10006,2503,1,353800000,353800000,3751,1250,2501,1250,0,1,1252,1085159
168,1250,7000,4300,30100000,2,10006,2503,1,353800000,353800000,3751,1250,2501,1250,0,1,1252,1089564
168,1250,7000,4300,30100000,2,10006,2503,1,353800000,353800000,3751,1250,2501,1250,0,1,1252,1087748
168,1250,7000,4300,30100000,2,10006,2503,1,353800000,353800000,3751,1250,2501,1250,0,1,1252,1087039
168,1650,7000,4300,30100000,2,13206,3303,1,389960000,389960000,4951,1650,3301,1650,0,1,1652,12353875
168,1650,7000,4300,30100000,2,13206,3303,1,389960000,389960000,4951,1650,3301,1650,0,1,1652,1350293
168,1650,7000,4300,30100000,2,13206,3303,1,389960000,389960000,4951,1650,3301,1650,0,1,1652,1349538
168,1650,7000,4300,30100000,2,13206,3303,1,389960000,389960000,4951,1650,3301,1650,0,1,1652,1350971
168,1650,7000,4300,30100000,2,13206,3303,1,389960000,389960000,4951,1650,3301,1650,0,1,1652,1344707
168,1650,7000,4300,30100000,2,13206,3303,1,389960000,389960000,4951,1650,3301,1650,0,1,1652,1352191
168,1650,7000,4300,30100000,2,13206,3303,1,389960000,389960000,4951,1650,3301,1650,0,1,1652,1351575
168,2050,7000,4300,30100000,2,16406,4103,1,426120000,426120000,6151,2050,4101,2050,0,1,2052,15789179
168,2050,7000,4300,30100000,2,16406,4103,1,426120000,426120000,6151,2050,4101,2050,0,1,2052,1622130
168,2050,7000,4300,30100000,2,16406,4103,1,426120000,426120000,6151,2050,4101,2050,0,1,2052,1623588
168,2050,7000,4300,30100000,2,16406,4103,1,426120000,426120000,6151,2050,4101,2050,0,1,2052,1622922
168,2050,7000,4300,30100000,2,16406,4103,1,426120000,426120000,6151,2050,4101,2050,0,1,2052,1621167
168,2050,7000,4300,30100000,2,16406,4103,1,426120000,426120000,6151,2050,4101,2050,0,1,2052,1617728
168,2050,7000,4300,30100000,2,16406,4103,1,426120000,426120000,6151,2050,4101,2050,0,1,2052,1619844
168,2450,7000,4300,30100000,2,19606,4903,1,462280000,462280000,7351,2450,4901,2450,0,1,2452,20294904
168,2450,7000,4300,30100000,2,19606,4903,1,462280000,462280000,7351,2450,4901,2450,0,1,2452,1871686
168,2450,7000,4300,30100000,2,19606,4903,1,462280000,462280000,7351,2450,4901,2450,0,1,2452,1870510
168,2450,7000,4300,30100000,2,19606,4903,1,462280000,462280000,7351,2450,4901,2450,0,1,2452,1869114
168,2450,7000,4300,30100000,2,19606,4903,1,462280000,462280000,7351,2450,4901,2450,0,1,2452,1867905
168,2450,7000,4300,30100000,2,19606,4903,1,462280000,462280000,7351,2450,4901,2450,0,1,2452,1847797
168,2450,7000,4300,30100000,2,19606,4903,1,462280000,462280000,7351,2450,4901,2450,0,1,2452,1846123
168,2850,7000,4300,30100000,2,22806,5703,1,498440000,498440000,8551,2850,5701,2850,0,1,2852,22441483
168,2850,7000,4300,30100000,2,22806,5703,1,498440000,498440000,8551,2850,5701,2850,0,1,2852,2173161
168,2850,7000,4300,30100000,2,22806,5703,1,498440000,498440000,8551,2850,5701,2850,0,1,2852,2175322
168,2850,7000,4300,30100000,2,22806,5703,1,498440000,498440000,8551,2850,5701,2850,0,1,2852,2174315
168,2850,7000,4300,30100000,2,22806,5703,1,498440000,498440000,8551,2850,5701,2850,0,1,2852,2149263
168,2850,7000,4300,30100000,2,22806,5703,1,498440000,498440000,8551,2850,5701,2850,0,1,2852,2142108
168,2850,7000,4300,30100000,2,22806,5703,1,498440000,498440000,8551,2850,5701,2850,0,1,2852,2134261
168,3250,7000,4300,30100000,2,26006,6503,1,534600000,534600000,9751,3250,6501,3250,0,1,3252,27986926
168,3250,7000,4300,30100000,2,26006,6503,1,534600000,534600000,9751,3250,6501,3250,0,1,3252,2400484
168,3250,7000,4300,30100000,2,26006,6503,1,534600000,534600000,9751,3250,6501,3250,0,1,3252,2401664
168,3250,7000,4300,30100000,2,26006,6503,1,534600000,534600000,9751,3250,6501,3250,0,1,3252,2399281
168,3250,7000,4300,30100000,2,26006,6503,1,534600000,534600000,9751,3250,6501,3250,0,1,3252,2391556
168,3250,7000,4300,30100000,2,26006,6503,1,534600000,534600000,9751,3250,6501,3250,0,1,3252,2364264
168,3250,7000,4300,30100000,2,26006,6503,1,534600000,534600000,9751,3250,6501,3250,0,1,3252,2360676
168,3650,7000,4300,30100000,2,29206,7303,1,570760000,570760000,10951,3650,7301,3650,0,1,3652,30313049
168,3650,7000,4300,30100000,2,29206,7303,1,570760000,570760000,10951,3650,7301,3650,0,1,3652,2706706
168,3650,7000,4300,30100000,2,29206,7303,1,570760000,570760000,10951,3650,7301,3650,0,1,3652,2710324
168,3650,7000,4300,30100000,2,29206,7303,1,570760000,570760000,10951,3650,7301,3650,0,1,3652,2708095
168,3650,7000,4300,30100000,2,29206,7303,1,570760000,570760000,10951,3650,7301,3650,0,1,3652,2709241
168,3650,7000,4300,30100000,2,29206,7303,1,570760000,570760000,10951,3650,7301,3650,0,1,3652,2645316
168,3650,7000,4300,30100000,2,29206,7303,1,570760000,570760000,10951,3650,7301,3650,0,1,3652,2631355
168,4050,7000,4300,30100000,2,32406,8103,1,606920000,606920000,12151,4050,8101,4050,0,1,4052,32956445
168,4050,7000,4300,30100000,2,32406,8103,1,606920000,606920000,12151,4050,8101,4050,0,1,4052,2978963
168,4050,7000,4300,30100000,2,32406,8103,1,606920000,606920000,12151,4050,8101,4050,0,1,4052,2981315
168,4050,7000,4300,30100000,2,32406,8103,1,606920000,606920000,12151,4050,8101,4050,0,1,4052,2977473
168,4050,7000,4300,30100000,2,32406,8103,1,606920000,606920000,12151,4050,8101,4050,0,1,4052,2980184
168,4050,7000,4300,30100000,2,32406,8103,1,606920000,606920000,12151,4050,8101,4050,0,1,4052,2899247
168,4050,7000,4300,30100000,2,32406,8103,1,606920000,606920000,12151,4050,8101,4050,0,1,4052,2868935
168,4450,7000,4300,30100000,2,35606,8903,1,643080000,643080000,13351,4450,8901,4450,0,1,4452,38858972
168,4450,7000,4300,30100000,2,35606,8903,1,643080000,643080000,13351,4450,8901,4450,0,1,4452,3271257
168,4450,7000,4300,30100000,2,35606,8903,1,643080000,643080000,13351,4450,8901,4450,0,1,4452,3255158
168,4450,7000,4300,30100000,2,35606,8903,1,643080000,643080000,13351,4450,8901,4450,0,1,4452,3231075
168,4450,7000,4300,30100000,2,35606,8903,1,643080000,643080000,13351,4450,8901,4450,0,1,4452,3260172
168,4450,7000,4300,30100000,2,35606,8903,1,643080000,643080000,13351,4450,8901,4450,0,1,4452,3214375
168,4450,7000,4300,30100000,2,35606,8903,1,643080000,643080000,13351,4450,8901,4450,0,1,4452,3211226
168,4850,7000,4300,30100000,2,38806,9703,1,679240000,679240000,14551,4850,9701,4850,0,1,4852,41876578
168,4850,7000,4300,30100000,2,38806,9703,1,679240000,679240000,14551,4850,9701,4850,0,1,4852,3500279
168,4850,7000,4300,30100000,2,38806,9703,1,679240000,679240000,14551,4850,9701,4850,0,1,4852,3503355
168,4850,7000,4300,30100000,2,38806,9703,1,679240000,679240000,14551,4850,9701,4850,0,1,4852,3501799
168,4850,7000,4300,30100000,2,38806,9703,1,679240000,679240000,14551,4850,9701,4850,0,1,4852,3497312
168,4850,7000,4300,30100000,2,38806,9703,1,679240000,679240000,14551,4850,9701,4850,0,1,4852,3430710
168,4850,7000,4300,30100000,2,38806,9703,1,679240000,679240000,14551,4850,9701,4850,0,1,4852,3415431
168,5250,7000,4300,30100000,2,42006,10503,1,715400000,715400000,15751,5250,10501,5250,0,1,5252,46948632
168,5250,7000,4300,30100000,2,42006,10503,1,715400000,715400000,15751,5250,10501,5250,0,1,5252,3751060
168,5250,7000,4300,30100000,2,42006,10503,1,715400000,715400000,15751,5250,10501,5250,0,1,5252,3754351
168,5250,7000,4300,30100000,2,42006,10503,1,715400000,715400000,15751,5250,10501,5250,0,1,5252,3752696
168,5250,7000,4300,30100000,2,42006,10503,1,715400000,715400000,15751,5250,10501,5250,0,1,5252,3748107
168,5250,7000,4300,30100000,2,42006,10503,1,715400000,715400000,15751,5250,10501,5250,0,1,5252,3678201
168,5250,7000,4300,30100000,2,42006,10503,1,715400000,715400000,15751,5250,10501,5250,0,1,5252,3663609
168,5650,7000,4300,30100000,2,45206,11303,1,751560000,751560000,16951,5650,11301,5650,0,1,5652,50493534
168,5650,7000,4300,30100000,2,45206,11303,1,751560000,751560000,16951,5650,11301,5650,0,1,5652,4040729
168,5650,7000,4300,30100000,2,45206,11303,1,751560000,751560000,16951,5650,11301,5650,0,1,5652,4043725
168,5650,7000,4300,30100000,2,45206,11303,1,751560000,751560000,16951,5650,11301,5650,0,1,5652,4039156
168,5650,7000,4300,30100000,2,45206,11303,1,751560000,751560000,16951,5650,11301,5650,0,1,5652,4030949
168,5650,7000,4300,30100000,2,45206,11303,1,751560000,751560000,16951,5650,11301,5650,0,1,5652,3960762
168,5650,7000,4300,30100000,2,45206,11303,1,751560000,751560000,16951,5650,11301,5650,0,1,5652,3947962
168,6050,7000,4300,30100000,2,48406,12103,1,787720000,787720000,18151,6050,12101,6050,0,1,6052,53788998
168,6050,7000,4300,30100000,2,48406,12103,1,787720000,787720000,18151,6050,12101,6050,0,1,6052,4333513
168,6050,7000,4300,30100000,2,48406,12103,1,787720000,787720000,18151,6050,12101,6050,0,1,6052,4331656
168,6050,7000,4300,30100000,2,48406,12103,1,787720000,787720000,18151,6050,12101,6050,0,1,6052,4322561
168,6050,7000,4300,30100000,2,48406,12103,1,787720000,787720000,18151,6050,12101,6050,0,1,6052,4327516
168,6050,7000,4300,30100000,2,48406,12103,1,787720000,787720000,18151,6050,12101,6050,0,1,6052,4214004
168,6050,7000,4300,30100000,2,48406,12103,1,787720000,787720000,18151,6050,12101,6050,0,1,6052,4200466
168,6450,7000,4300,30100000,2,51606,12903,1,823880000,823880000,19351,6450,12901,6450,0,1,6452,56254725
168,6450,7000,4300,30100000,2,51606,12903,1,823880000,823880000,19351,6450,12901,6450,0,1,6452,4540646
168,6450,7000,4300,30100000,2,51606,12903,1,823880000,823880000,19351,6450,12901,6450,0,1,6452,4538544
168,6450,7000,4300,30100000,2,51606,12903,1,823880000,823880000,19351,6450,12901,6450,0,1,6452,4536611
168,6450,7000,4300,30100000,2,51606,12903,1,823880000,823880000,19351,6450,12901,6450,0,1,6452,4533256
168,6450,7000,4300,30100000,2,51606,12903,1,823880000,823880000,19351,6450,12901,6450,0,1,6452,4431568
168,6450,7000,4300,30100000,2,51606,12903,1,823880000,823880000,19351,6450,12901,6450,0,1,6452,4404182
168,6850,7000,4300,30100000,2,54806,13703,1,860040000,860040000,20551,6850,13701,6850,0,1,6852,61438933
168,6850,7000,4300,30100000,2,54806,13703,1,860040000,860040000,20551,6850,13701,6850,0,1,6852,4792265
168,6850,7000,4300,30100000,2,54806,13703,1,860040000,860040000,20551,6850,13701,6850,0,1,6852,4790222
168,6850,7000,4300,30100000,2,54806,13703,1,860040000,860040000,20551,6850,13701,6850,0,1,6852,4788523
168,6850,7000,4300,30100000,2,54806,13703,1,860040000,860040000,20551,6850,13701,6850,0,1,6852,4785967
168,6850,7000,4300,30100000,2,54806,13703,1,860040000,860040000,20551,6850,13701,6850,0,1,6852,4680188
168,6850,7000,4300,30100000,2,54806,13703,1,860040000,860040000,20551,6850,13701,6850,0,1,6852,4649733
168,50,7000,3900,27300000,2,406,103,1,222760000,222760000,151,50,101,50,0,1,52,299054
168,50,7000,3900,27300000,2,406,103,1,222760000,222760000,151,50,101,50,0,1,52,204492
168,50,7000,3900,27300000,2,406,103,1,222760000,222760000,151,50,101,50,0,1,52,264870
168,50,7000,3900,27300000,2,406,103,1,222760000,222760000,151,50,101,50,0,1,52,264116
168,50,7000,3900,27300000,2,406,103,1,222760000,222760000,151,50,101,50,0,1,52,250864
168,50,7000,3900,27300000,2,406,103,1,222760000,222760000,151,50,101,50,0,1,52,288034
168,50,7000,3900,27300000,2,406,103,1,222760000,222760000,151,50,101,50,0,1,52,288413
168,450,7000,3900,27300000,2,3606,903,1,257640000,257640000,1351,450,901,450,0,1,452,2806338
168,450,7000,3900,27300000,2,3606,903,1,257640000,257640000,1351,450,901,450,0,1,452,546388
168,450,7000,3900,27300000,2,3606,903,1,257640000,257640000,1351,450,901,450,0,1,452,550626
168,450,7000,3900,27300000,2,3606,903,1,257640000,257640000,1351,450,901,450,0,1,452,548161
168,450,7000,3900,27300000,2,3606,903,1,257640000,257640000,1351,450,901,450,0,1,452,549782
168,450,7000,3900,27300000,2,3606,903,1,257640000,257640000,1351,450,901,450,0,1,452,554797
168,450,7000,3900,27300000,2,3606,903,1,257640000,257640000,1351,450,901,450,0,1,452,553775
168,850,7000,3900,27300000,2,6806,1703,1,292520000,292520000,2551,850,1701,850,0,1,852,5619944
168,850,7000,3900,27300000,2,6806,1703,1,292520000,292520000,2551,850,1701,850,0,1,852,755316
168,850,7000,3900,27300000,2,6806,1703,1,292520000,292520000,2551,850,1701,850,0,1,852,756652
168,850,7000,3900,27300000,2,6806,1703,1,292520000,292520000,2551,850,1701,850,0,1,852,756121
168,850,7000,3900,27300000,2,6806,1703,1,292520000,292520000,2551,850,1701,850,0,1,852,754240
168,850,7000,3900,27300000,2,6806,1703,1,292520000,292520000,2551,850,1701,850,0,1,852,760585
168,850,7000,3900,27300000,2,6806,1703,1,292520000,292520000,2551,850,1701,850,0,1,852,760087
168,1250,7000,3900,27300000,2,10006,2503,1,327400000,327400000,3751,1250,2501,1250,0,1,1252,9130043
168,1250,7000,3900,27300000,2,10006,2503,1,327400000,327400000,3751,1250,2501,1250,0,1,1252,998158
168,1250,7000,3900,27300000,2,10006,2503,1,327400000,327400000,3751,1250,2501,1250,0,1,1252,985746
168,1250,7000,3900,27300000,2,10006,2503,1,327400000,327400000,3751,1250,2501,1250,0,1,1252,997308
168,1250,7000,3900,27300000,2,10006,2503,1,327400000,327400000,3751,1250,2501,1250,0,1,1252,914774
168,1250,7000,3900,27300000,2,10006,2503,1,327400000,327400000,3751,1250,2501,1250,0,1,1252,999606
168,1250,7000,3900,27300000,2,10006,2503,1,327400000,327400000,3751,1250,2501,1250,0,1,1252,999028
168,1650,7000,3900,27300000,2,13206,3303,1,362280000,362280000,4951,1650,3301,1650,0,1,1652,12186928
168,1650,7000,3900,27300000,2,13206,3303,1,362280000,362280000,4951,1650,3301,1650,0,1,1652,1224618
168,1650,7000,3900,27300000,2,13206,3303,1,362280000,362280000,4951,1650,3301,1650,0,1,1652,1222830
168,1650,7000,3900,27300000,2,13206,3303,1,362280000,362280000,4951,1650,3301,1650,0,1,1652,1223650
168,1650,7000,3900,27300000,2,13206,3303,1,362280000,362280000,4951,1650,3301,1650,0,1,1652,1219940
168,1650,7000,3900,27300000,2,13206,3303,1,362280000,362280000,4951,1650,3301,1650,0,1,1652,1226188
168,1650,7000,3900,27300000,2,13206,3303,1,362280000,362280000,4951,1650,3301,1650,0,1,1652,1225557
168,2050,7000,3900,27300000,2,16406,4103,1,397160000,397160000,6151,2050,4101,2050,0,1,2052,15286926
168,2050,7000,3900,27300000,2,16406,4103,1,397160000,397160000,6151,2050,4101,2050,0,1,2052,1491669
168,2050,7000,3900,27300000,2,16406,4103,1,397160000,397160000,6151,2050,4101,2050,0,1,2052,1494931
168,2050,7000,3900,27300000,2,16406,4103,1,397160000,397160000,6151,2050,4101,2050,0,1,2052,1493769
168,2050,7000,3900,27300000,2,16406,4103,1,397160000,397160000,6151,2050,4101,2050,0,1,2052,1495765
168,2050,7000,3900,27300000,2,16406,4103,1,397160000,397160000,6151,2050,4101,2050,0,1,2052,1496210
168,2050,7000,3900,27300000,2,16406,4103,1,397160000,397160000,6151,2050,4101,2050,0,1,2052,1496898
168,2450,7000,3900,27300000,2,19606,4903,1,432040000,432040000,7351,2450,4901,2450,0,1,2452,18885408
168,2450,7000,3900,27300000,2,19606,4903,1,432040000,432040000,7351,2450,4901,2450,0,1,2452,1705885
168,2450,7000,3900,27300000,2,19606,4903,1,432040000,432040000,7351,2450,4901,2450,0,1,2452,1704360
168,2450,7000,3900,27300000,2,19606,4903,1,432040000,432040000,7351,2450,4901,2450,0,1,2452,1702812
168,2450,7000,3900,27300000,2,19606,4903,1,432040000,432040000,7351,2450,4901,2450,0,1,2452,1703561
168,2450,7000,3900,27300000,2,19606,4903,1,432040000,432040000,7351,2450,4901,2450,0,1,2452,1705114
168,2450,7000,3900,27300000,2,19606,4903,1,432040000,432040000,7351,2450,4901,2450,0,1,2452,1701323
168,2850,7000,3900,27300000,2,22806,5703,1,466920000,466920000,8551,2850,5701,2850,0,1,2852,22201914
168,2850,7000,3900,27300000,2,22806,5703,1,466920000,466920000,8551,2850,5701,2850,0,1,2852,2005433
168,2850,7000,3900,27300000,2,22806,5703,1,466920000,466920000,8551,2850,5701,2850,0,1,2852,1990175
168,2850,7000,3900,27300000,2,22806,5703,1,466920000,466920000,8551,2850,5701,2850,0,1,2852,2007527
168,2850,7000,3900,27300000,2,22806,5703,1,466920000,466920000,8551,2850,5701,2850,0,1,2852,1996899
168,2850,7000,3900,27300000,2,22806,5703,1,466920000,466920000,8551,2850,5701,2850,0,1,2852,1974684
168,2850,7000,3900,27300000,2,22806,5703,1,466920000,466920000,8551,2850,5701,2850,0,1,2852,1967315
168,3250,7000,3900,27300000,2,26006,6503,1,501800000,501800000,9751,3250,6501,3250,0,1,3252,24944757
168,3250,7000,3900,27300000,2,26006,6503,1,501800000,501800000,9751,3250,6501,3250,0,1,3252,2227201
168,3250,7000,3900,27300000,2,26006,6503,1,501800000,501800000,9751,3250,6501,3250,0,1,3252,2225204
168,3250,7000,3900,27300000,2,26006,6503,1,501800000,501800000,9751,3250,6501,3250,0,1,3252,2226268
168,3250,7000,3900,27300000,2,26006,6503,1,501800000,501800000,9751,3250,6501,3250,0,1,3252,2219849
168,3250,7000,3900,27300000,2,26006,6503,1,501800000,501800000,9751,3250,6501,3250,0,1,3252,2179432
168,3250,7000,3900,27300000,2,26006,6503,1,501800000,501800000,9751,3250,6501,3250,0,1,3252,2175830
168,3650,7000,3900,27300000,2,29206,7303,1,536680000,536680000,10951,3650,7301,3650,0,1,3652,28673957
168,3650,7000,3900,27300000,2,29206,7303,1,536680000,536680000,10951,3650,7301,3650,0,1,3652,2500871
168,3650,7000,3900,27300000,2,29206,7303,1,536680000,536680000,10951,3650,7301,3650,0,1,3652,2503596
168,3650,7000,3900,27300000,2,29206,7303,1,536680000,536680000,10951,3650,7301,3650,0,1,3652,2499011
168,3650,7000,3900,27300000,2,29206,7303,1,536680000,536680000,10951,3650,7301,3650,0,1,3652,2502288
168,3650,7000,3900,27300000,2,29206,7303,1,536680000,536680000,10951,3650,7301,3650,0,1,3652,2443639
168,3650,7000,3900,27300000,2,29206,7303,1,536680000,536680000,10951,3650,7301,3650,0,1,3652,2435701
168,4050,7000,3900,27300000,2,32406,8103,1,571560000,571560000,12151,4050,8101,4050,0,1,4052,31423965
168,4050,7000,3900,27300000,2,32406,8103,1,571560000,571560000,12151,4050,8101,4050,0,1,4052,2707021
168,4050,7000,3900,27300000,2,32406,8103,1,571560000,571560000,12151,4050,8101,4050,0,1,4052,2712401
168,4050,7000,3900,27300000,2,32406,8103,1,571560000,571560000,12151,4050,8101,4050,0,1,4052,2710998
168,4050,7000,3900,27300000,2,32406,8103,1,571560000,571560000,12151,4050,8101,4050,0,1,4052,2708884
168,4050,7000,3900,27300000,2,32406,8103,1,571560000,571560000,12151,4050,8101,4050,0,1,4052,2662073
168,4050,7000,3900,27300000,2,32406,8103,1,571560000,571560000,12151,4050,8101,4050,0,1,4052,2652890
168,4450,7000,3900,27300000,2,35606,8903,1,606440000,606440000,13351,4450,8901,4450,0,1,4452,35830361
168,4450,7000,3900,27300000,2,35606,8903,1,606440000,606440000,13351,4450,8901,4450,0,1,4452,2931849
168,4450,7000,3900,27300000,2,35606,8903,1,606440000,606440000,13351,4450,8901,4450,0,1,4452,2929194
168,4450,7000,3900,27300000,2,35606,8903,1,606440000,606440000,13351,4450,8901,4450,0,1,4452,2926450
168,4450,7000,3900,27300000,2,35606,8903,1,606440000,606440000,13351,4450,8901,4450,0,1,4452,2924732
168,4450,7000,3900,27300000,2,35606,8903,1,606440000,606440000,13351,4450,8901,4450,0,1,4452,2884274
168,4450,7000,3900,27300000,2,35606,8903,1,606440000,606440000,13351,4450,8901,4450,0,1,4452,2879349
168,4850,7000,3900,27300000,2,38806,9703,1,641320000,641320000,14551,4850,9701,4850,0,1,4852,38395653
168,4850,7000,3900,27300000,2,38806,9703,1,641320000,641320000,14551,4850,9701,4850,0,1,4852,3225983
168,4850,7000,3900,27300000,2,38806,9703,1,641320000,641320000,14551,4850,9701,4850,0,1,4852,3228689
168,4850,7000,3900,27300000,2,38806,9703,1,641320000,641320000,14551,4850,9701,4850,0,1,4852,3227372
168,4850,7000,3900,27300000,2,38806,9703,1,641320000,641320000,14551,4850,9701,4850,0,1,4852,3224404
168,4850,7000,3900,27300000,2,38806,9703,1,641320000,641320000,14551,4850,9701,4850,0,1,4852,3149675
168,4850,7000,3900,27300000,2,38806,9703,1,641320000,641320000,14551,4850,9701,4850,0,1,4852,3139782
168,5250,7000,3900,27300000,2,42006,10503,1,676200000,676200000,15751,5250,10501,5250,0,1,5252,42733286
168,5250,7000,3900,27300000,2,42006,10503,1,676200000,676200000,15751,5250,10501,5250,0,1,5252,3448627
168,5250,7000,3900,27300000,2,42006,10503,1,676200000,676200000,15751,5250,10501,5250,0,1,5252,3450224
168,5250,7000,3900,27300000,2,42006,10503,1,676200000,676200000,15751,5250,10501,5250,0,1,5252,3447024
168,5250,7000,3900,27300000,2,42006,10503,1,676200000,676200000,15751,5250,10501,5250,0,1,5252,3436397
168,5250,7000,3900,27300000,2,42006,10503,1,676200000,676200000,15751,5250,10501,5250,0,1,5252,3381371
168,5250,7000,3900,27300000,2,42006,10503,1,676200000,676200000,15751,5250,10501,5250,0,1,5252,3372933
168,5650,7000,3900,27300000,2,45206,11303,1,711080000,711080000,16951,5650,11301,5650,0,1,5652,46148907
168,5650,7000,3900,27300000,2,45206,11303,1,711080000,711080000,16951,5650,11301,5650,0,1,5652,3723570
168,5650,7000,3900,27300000,2,45206,11303,1,711080000,711080000,16951,5650,11301,5650,0,1,5652,3719333
168,5650,7000,3900,27300000,2,45206,11303,1,711080000,711080000,16951,5650,11301,5650,0,1,5652,3726749
168,5650,7000,3900,27300000,2,45206,11303,1,711080000,711080000,16951,5650,11301,5650,0,1,5652,3710966
168,5650,7000,3900,27300000,2,45206,11303,1,711080000,711080000,16951,5650,11301,5650,0,1,5652,3656608
168,5650,7000,3900,27300000,2,45206,11303,1,711080000,711080000,16951,5650,11301,5650,0,1,5652,3645740
168,6050,7000,3900,27300000,2,48406,12103,1,745960000,745960000,18151,6050,12101,6050,0,1,6052,48697910
168,6050,7000,3900,27300000,2,48406,12103,1,745960000,745960000,18151,6050,12101,6050,0,1,6052,3946637
168,6050,7000,3900,27300000,2,48406,12103,1,745960000,745960000,18151,6050,12101,6050,0,1,6052,3944757
168,6050,7000,3900,27300000,2,48406,12103,1,745960000,745960000,18151,6050,12101,6050,0,1,6052,3942987
168,6050,7000,3900,27300000,2,48406,12103,1,745960000,745960000,18151,6050,12101,6050,0,1,6052,3936317
168,6050,7000,3900,27300000,2,48406,12103,1,745960000,745960000,18151,6050,12101,6050,0,1,6052,3860736
168,6050,7000,3900,27300000,2,48406,12103,1,745960000,745960000,18151,6050,12101,6050,0,1,6052,3851918
168,6450,7000,3900,27300000,2,51606,12903,1,780840000,780840000,19351,6450,12901,6450,0,1,6452,51638200
168,6450,7000,3900,27300000,2,51606,12903,1,780840000,780840000,19351,6450,12901,6450,0,1,6452,4206937
168,6450,7000,3900,27300000,2,51606,12903,1,780840000,780840000,19351,6450,12901,6450,0,1,6452,4208880
168,6450,7000,3900,27300000,2,51606,12903,1,780840000,780840000,19351,6450,12901,6450,0,1,6452,4203831
168,6450,7000,3900,27300000,2,51606,12903,1,780840000,780840000,19351,6450,12901,6450,0,1,6452,4198363
168,6450,7000,3900,27300000,2,51606,12903,1,780840000,780840000,19351,6450,12901,6450,0,1,6452,4095569
168,6450,7000,3900,27300000,2,51606,12903,1,780840000,780840000,19351,6450,12901,6450,0,1,6452,4082107
168,6850,7000,3900,27300000,2,54806,13703,1,815720000,815720000,20551,6850,13701,6850,0,1,6852,56765147
168,6850,7000,3900,27300000,2,54806,13703,1,815720000,815720000,20551,6850,13701,6850,0,1,6852,4429399
168,6850,7000,3900,27300000,2,54806,13703,1,815720000,815720000,20551,6850,13701,6850,0,1,6852,4420106
168,6850,7000,3900,27300000,2,54806,13703,1,815720000,815720000,20551,6850,13701,6850,0,1,6852,4427369
168,6850,7000,3900,27300000,2,54806,13703,1,815720000,815720000,20551,6850,13701,6850,0,1,6852,4414475
168,6850,7000,3900,27300000,2,54806,13703,1,815720000,815720000,20551,6850,13701,6850,0,1,6852,4293015
168,6850,7000,3900,27300000,2,54806,13703,1,815720000,815720000,20551,6850,13701,6850,0,1,6852,4269269
168,50,7000,3500,24500000,2,406,103,1,200200000,200200000,151,50,101,50,0,1,52,268660
168,50,7000,3500,24500000,2,406,103,1,200200000,200200000,151,50,101,50,0,1,52,210078
168,50,7000,3500,24500000,2,406,103,1,200200000,200200000,151,50,101,50,0,1,52,232956
168,50,7000,3500,24500000,2,406,103,1,200200000,200200000,151,50,101,50,0,1,52,231226
168,50,7000,3500,24500000,2,406,103,1,200200000,200200000,151,50,101,50,0,1,52,232204
168,50,7000,3500,24500000,2,406,103,1,200200000,200200000,151,50,101,50,0,1,52,251472
168,50,7000,3500,24500000,2,406,103,1,200200000,200200000,151,50,101,50,0,1,52,251093
168,450,7000,3500,24500000,2,3606,903,1,233800000,233800000,1351,450,901,450,0,1,452,2467761
168,450,7000,3500,24500000,2,3606,903,1,233800000,233800000,1351,450,901,450,0,1,452,488489
168,450,7000,3500,24500000,2,3606,903,1,233800000,233800000,1351,450,901,450,0,1,452,489654
168,450,7000,3500,24500000,2,3606,903,1,233800000,233800000,1351,450,901,450,0,1,452,489347
168,450,7000,3500,24500000,2,3606,903,1,233800000,233800000,1351,450,901,450,0,1,452,489945
168,450,7000,3500,24500000,2,3606,903,1,233800000,233800000,1351,450,901,450,0,1,452,493425
168,450,7000,3500,24500000,2,3606,903,1,233800000,233800000,1351,450,901,450,0,1,452,492982
168,850,7000,3500,24500000,2,6806,1703,1,267400000,267400000,2551,850,1701,850,0,1,852,5140256
168,850,7000,3500,24500000,2,6806,1703,1,267400000,267400000,2551,850,1701,850,0,1,852,672902
168,850,7000,3500,24500000,2,6806,1703,1,267400000,267400000,2551,850,1701,850,0,1,852,674700
168,850,7000,3500,24500000,2,6806,1703,1,267400000,267400000,2551,850,1701,850,0,1,852,671091
168,850,7000,3500,24500000,2,6806,1703,1,267400000,267400000,2551,850,1701,850,0,1,852,673966
168,850,7000,3500,24500000,2,6806,1703,1,267400000,267400000,2551,850,1701,850,0,1,852,682731
168,850,7000,3500,24500000,2,6806,1703,1,267400000,267400000,2551,850,1701,850,0,1,852,682229
168,1250,7000,3500,24500000,2,10006,2503,1,301000000,301000000,3751,1250,2501,1250,0,1,1252,7543667
168,1250,7000,3500,24500000,2,10006,2503,1,301000000,301000000,3751,1250,2501,1250,0,1,1252,878332
168,1250,7000,3500,24500000,2,10006,2503,1,301000000,301000000,3751,1250,2501,1250,0,1,1252,876052
168,1250,7000,3500,24500000,2,10006,2503,1,301000000,301000000,3751,1250,2501,1250,0,1,1252,873873
168,1250,7000,3500,24500000,2,10006,2503,1,301000000,301000000,3751,1250,2501,1250,0,1,1252,877395
168,1250,7000,3500,24500000,2,10006,2503,1,301000000,301000000,3751,1250,2501,1250,0,1,1252,892025
168,1250,7000,3500,24500000,2,10006,2503,1,301000000,301000000,3751,1250,2501,1250,0,1,1252,891470
168,1650,7000,3500,24500000,2,13206,3303,1,334600000,334600000,4951,1650,3301,1650,0,1,1652,10841310
168,1650,7000,3500,24500000,2,13206,3303,1,334600000,334600000,4951,1650,3301,1650,0,1,1652,1099431
168,1650,7000,3500,24500000,2,13206,3303,1,334600000,334600000,4951,1650,3301,1650,0,1,1652,1098229
168,1650,7000,3500,24500000,2,13206,3303,1,334600000,334600000,4951,1650,3301,1650,0,1,1652,1094256
168,1650,7000,3500,24500000,2,13206,3303,1,334600000,334600000,4951,1650,3301,1650,0,1,1652,1096692
168,1650,7000,3500,24500000,2,13206,3303,1,334600000,334600000,4951,1650,3301,1650,0,1,1652,1104193
168,1650,7000,3500,24500000,2,13206,3303,1,334600000,334600000,4951,1650,3301,1650,0,1,1652,1102856
168,2050,7000,3500,24500000,2,16406,4103,1,368200000,368200000,6151,2050,4101,2050,0,1,2052,14147344
168,2050,7000,3500,24500000,2,16406,4103,1,368200000,368200000,6151,2050,4101,2050,0,1,2052,1314423
168,2050,7000,3500,24500000,2,16406,4103,1,368200000,368200000,6151,2050,4101,2050,0,1,2052,1312164
168,2050,7000,3500,24500000,2,16406,4103,1,368200000,368200000,6151,2050,4101,2050,0,1,2052,1312964
168,2050,7000,3500,24500000,2,16406,4103,1,368200000,368200000,6151,2050,4101,2050,0,1,2052,1311001
168,2050,7000,3500,24500000,2,16406,4103,1,368200000,368200000,6151,2050,4101,2050,0,1,2052,1317403
168,2050,7000,3500,24500000,2,16406,4103,1,368200000,368200000,6151,2050,4101,2050,0,1,2052,1316707
168,2450,7000,3500,24500000,2,19606,4903,1,401800000,401800000,7351,2450,4901,2450,0,1,2452,17138600
168,2450,7000,3500,24500000,2,19606,4903,1,401800000,401800000,7351,2450,4901,2450,0,1,2452,1574162
168,2450,7000,3500,24500000,2,19606,4903,1,401800000,401800000,7351,2450,4901,2450,0,1,2452,1577046
168,2450,7000,3500,24500000,2,19606,4903,1,401800000,401800000,7351,2450,4901,2450,0,1,2452,1575370
168,2450,7000,3500,24500000,2,19606,4903,1,401800000,401800000,7351,2450,4901,2450,0,1,2452,1576259
168,2450,7000,3500,24500000,2,19606,4903,1,401800000,401800000,7351,2450,4901,2450,0,1,2452,1572127
168,2450,7000,3500,24500000,2,19606,4903,1,401800000,401800000,7351,2450,4901,2450,0,1,2452,1566732
168,2850,7000,3500,24500000,2,22806,5703,1,435400000,435400000,8551,2850,5701,2850,0,1,2852,19768163
168,2850,7000,3500,24500000,2,22806,5703,1,435400000,435400000,8551,2850,5701,2850,0,1,2852,1765074
168,2850,7000,3500,24500000,2,22806,5703,1,435400000,435400000,8551,2850,5701,2850,0,1,2852,1764006
168,2850,7000,3500,24500000,2,22806,5703,1,435400000,435400000,8551,2850,5701,2850,0,1,2852,1761568
168,2850,7000,3500,24500000,2,22806,5703,1,435400000,435400000,8551,2850,5701,2850,0,1,2852,1763102
168,2850,7000,3500,24500000,2,22806,5703,1,435400000,435400000,8551,2850,5701,2850,0,1,2852,1754077
168,2850,7000,3500,24500000,2,22806,5703,1,435400000,435400000,8551,2850,5701,2850,0,1,2852,1751101
168,3250,7000,3500,24500000,2,26006,6503,1,469000000,469000000,9751,3250,6501,3250,0,1,3252,22411429
168,3250,7000,3500,24500000,2,26006,6503,1,469000000,469000000,9751,3250,6501,3250,0,1,3252,2011692
168,3250,7000,3500,24500000,2,26006,6503,1,469000000,469000000,9751,3250,6501,3250,0,1,3252,2014677
168,3250,7000,3500,24500000,2,26006,6503,1,469000000,469000000,9751,3250,6501,3250,0,1,3252,2013745
168,3250,7000,3500,24500000,2,26006,6503,1,469000000,469000000,9751,3250,6501,3250,0,1,3252,2012678
168,3250,7000,3500,24500000,2,26006,6503,1,469000000,469000000,9751,3250,6501,3250,0,1,3252,1989953
168,3250,7000,3500,24500000,2,26006,6503,1,469000000,469000000,9751,3250,6501,3250,0,1,3252,1986721
168,3650,7000,3500,24500000,2,29206,7303,1,502600000,502600000,10951,3650,7301,3650,0,1,3652,25245795
168,3650,7000,3500,24500000,2,29206,7303,1,502600000,502600000,10951,3650,7301,3650,0,1,3652,2209279
168,3650,7000,3500,24500000,2,29206,7303,1,502600000,502600000,10951,3650,7301,3650,0,1,3652,2207860
168,3650,7000,3500,24500000,2,29206,7303,1,502600000,502600000,10951,3650,7301,3650,0,1,3652,2206196
168,3650,7000,3500,24500000,2,29206,7303,1,502600000,502600000,10951,3650,7301,3650,0,1,3652,2204718
168,3650,7000,3500,24500000,2,29206,7303,1,502600000,502600000,10951,3650,7301,3650,0,1,3652,2176976
168,3650,7000,3500,24500000,2,29206,7303,1,502600000,502600000,10951,3650,7301,3650,0,1,3652,2173040
168,4050,7000,3500,24500000,2,32406,8103,1,536200000,536200000,12151,4050,8101,4050,0,1,4052,27695535
168,4050,7000,3500,24500000,2,32406,8103,1,536200000,536200000,12151,4050,8101,4050,0,1,4052,2501389
168,4050,7000,3500,24500000,2,32406,8103,1,536200000,536200000,12151,4050,8101,4050,0,1,4052,2502780
168,4050,7000,3500,24500000,2,32406,8103,1,536200000,536200000,12151,4050,8101,4050,0,1,4052,2496300
168,4050,7000,3500,24500000,2,32406,8103,1,536200000,536200000,12151,4050,8101,4050,0,1,4052,2498332
168,4050,7000,3500,24500000,2,32406,8103,1,536200000,536200000,12151,4050,8101,4050,0,1,4052,2442347
168,4050,7000,3500,24500000,2,32406,8103,1,536200000,536200000,12151,4050,8101,4050,0,1,4052,2435118
