168,50,5800,7100,41180000,2,406,103,1,334600000,334600000,151,50,101,50,0,1,52,457184
168,50,5800,7100,41180000,2,406,103,1,334600000,334600000,151,50,101,50,0,1,52,466295
168,50,5800,7100,41180000,2,406,103,1,334600000,334600000,151,50,101,50,0,1,52,466470
168,50,5800,7100,41180000,2,406,103,1,334600000,334600000,151,50,101,50,0,1,52,466663
168,50,5800,7100,41180000,2,406,103,1,334600000,334600000,151,50,101,50,0,1,52,466129
168,50,5800,7100,41180000,2,406,103,1,334600000,334600000,151,50,101,50,0,1,52,465672
168,50,5800,7100,41180000,2,406,103,1,334600000,334600000,151,50,101,50,0,1,52,465991
168,450,5800,7100,41180000,2,3606,903,1,375880000,375880000,1351,450,901,450,0,1,452,4521596
168,450,5800,7100,41180000,2,3606,903,1,375880000,375880000,1351,450,901,450,0,1,452,796289
168,450,5800,7100,41180000,2,3606,903,1,375880000,375880000,1351,450,901,450,0,1,452,798373
168,450,5800,7100,41180000,2,3606,903,1,375880000,375880000,1351,450,901,450,0,1,452,799481
168,450,5800,7100,41180000,2,3606,903,1,375880000,375880000,1351,450,901,450,0,1,452,798974
168,450,5800,7100,41180000,2,3606,903,1,375880000,375880000,1351,450,901,450,0,1,452,795336
168,450,5800,7100,41180000,2,3606,903,1,375880000,375880000,1351,450,901,450,0,1,452,793635
168,850,5800,7100,41180000,2,6806,1703,1,417160000,417160000,2551,850,1701,850,0,1,852,9488514
168,850,5800,7100,41180000,2,6806,1703,1,417160000,417160000,2551,850,1701,850,0,1,852,1118376
168,850,5800,7100,41180000,2,6806,1703,1,417160000,417160000,2551,850,1701,850,0,1,852,1120594
168,850,5800,7100,41180000,2,6806,1703,1,417160000,417160000,2551,850,1701,850,0,1,852,1121191
168,850,5800,7100,41180000,2,6806,1703,1,417160000,417160000,2551,850,1701,850,0,1,852,1119931
168,850,5800,7100,41180000,2,6806,1703,1,417160000,417160000,2551,850,1701,850,0,1,852,1098602
168,850,5800,7100,41180000,2,6806,1703,1,417160000,417160000,2551,850,1701,850,0,1,852,1099535
168,1250,5800,7100,41180000,2,10006,2503,1,458440000,458440000,3751,1250,2501,1250,0,1,1252,14328422
168,1250,5800,7100,41180000,2,10006,2503,1,458440000,458440000,3751,1250,2501,1250,0,1,1252,1440666
168,1250,5800,7100,41180000,2,10006,2503,1,458440000,458440000,3751,1250,2501,1250,0,1,1252,1442914
168,1250,5800,7100,41180000,2,10006,2503,1,458440000,458440000,3751,1250,2501,1250,0,1,1252,1443501
168,1250,5800,7100,41180000,2,10006,2503,1,458440000,458440000,3751,1250,2501,1250,0,1,1252,1442163
168,1250,5800,7100,41180000,2,10006,2503,1,458440000,458440000,3751,1250,2501,1250,0,1,1252,1429405
168,1250,5800,7100,41180000,2,10006,2503,1,458440000,458440000,3751,1250,2501,1250,0,1,1252,1430679
168,1650,5800,7100,41180000,2,13206,3303,1,499720000,499720000,4951,1650,3301,1650,0,1,1652,19862549
168,1650,5800,7100,41180000,2,13206,3303,1,499720000,499720000,4951,1650,3301,1650,0,1,1652,1846955
168,1650,5800,7100,41180000,2,13206,3303,1,499720000,499720000,4951,1650,3301,1650,0,1,1652,1839086
168,1650,5800,7100,41180000,2,13206,3303,1,499720000,499720000,4951,1650,3301,1650,0,1,1652,1846171
168,1650,5800,7100,41180000,2,13206,3303,1,499720000,499720000,4951,1650,3301,1650,0,1,1652,1843940
168,1650,5800,7100,41180000,2,13206,3303,1,499720000,499720000,4951,1650,3301,1650,0,1,1652,1812911
168,1650,5800,7100,41180000,2,13206,3303,1,499720000,499720000,4951,1650,3301,1650,0,1,1652,1809361
168,2050,5800,7100,41180000,2,16406,4103,1,541000000,541000000,6151,2050,4101,2050,0,1,2052,24525609
168,2050,5800,7100,41180000,2,16406,4103,1,541000000,541000000,6151,2050,4101,2050,0,1,2052,2153403
168,2050,5800,7100,41180000,2,16406,4103,1,541000000,541000000,6151,2050,4101,2050,0,1,2052,2154150
168,2050,5800,7100,41180000,2,16406,4103,1,541000000,541000000,6151,2050,4101,2050,0,1,2052,2154742
168,2050,5800,7100,41180000,2,16406,4103,1,541000000,541000000,6151,2050,4101,2050,0,1,2052,2152287
168,2050,5800,7100,41180000,2,16406,4103,1,541000000,541000000,6151,2050,4101,2050,0,1,2052,2125442
168,2050,5800,7100,41180000,2,16406,4103,1,541000000,541000000,6151,2050,4101,2050,0,1,2052,2126815
168,2450,5800,7100,41180000,2,19606,4903,1,582280000,582280000,7351,2450,4901,2450,0,1,2452,27689359
168,2450,5800,7100,41180000,2,19606,4903,1,582280000,582280000,7351,2450,4901,2450,0,1,2452,2550923
168,2450,5800,7100,41180000,2,19606,4903,1,582280000,582280000,7351,2450,4901,2450,0,1,2452,2554110
168,2450,5800,7100,41180000,2,19606,4903,1,582280000,582280000,7351,2450,4901,2450,0,1,2452,2551900
168,2450,5800,7100,41180000,2,19606,4903,1,582280000,582280000,7351,2450,4901,2450,0,1,2452,2544683
168,2450,5800,7100,41180000,2,19606,4903,1,582280000,582280000,7351,2450,4901,2450,0,1,2452,2524007
168,2450,5800,7100,41180000,2,19606,4903,1,582280000,582280000,7351,2450,4901,2450,0,1,2452,2522015
168,2850,5800,7100,41180000,2,22806,5703,1,623560000,623560000,8551,2850,5701,2850,0,1,2852,34341565
168,2850,5800,7100,41180000,2,22806,5703,1,623560000,623560000,8551,2850,5701,2850,0,1,2852,2921372
168,2850,5800,7100,41180000,2,22806,5703,1,623560000,623560000,8551,2850,5701,2850,0,1,2852,2926457
168,2850,5800,7100,41180000,2,22806,5703,1,623560000,623560000,8551,2850,5701,2850,0,1,2852,2928285
168,2850,5800,7100,41180000,2,22806,5703,1,623560000,623560000,8551,2850,5701,2850,0,1,2852,2927288
168,2850,5800,7100,41180000,2,22806,5703,1,623560000,623560000,8551,2850,5701,2850,0,1,2852,2830319
168,2850,5800,7100,41180000,2,22806,5703,1,623560000,623560000,8551,2850,5701,2850,0,1,2852,2821538
168,3250,5800,7100,41180000,2,26006,6503,1,664840000,664840000,9751,3250,6501,3250,0,1,3252,40184120
168,3250,5800,7100,41180000,2,26006,6503,1,664840000,664840000,9751,3250,6501,3250,0,1,3252,3267887
168,3250,5800,7100,41180000,2,26006,6503,1,664840000,664840000,9751,3250,6501,3250,0,1,3252,3279861
168,3250,5800,7100,41180000,2,26006,6503,1,664840000,664840000,9751,3250,6501,3250,0,1,3252,3274911
168,3250,5800,7100,41180000,2,26006,6503,1,664840000,664840000,9751,3250,6501,3250,0,1,3252,3280981
168,3250,5800,7100,41180000,2,26006,6503,1,664840000,664840000,9751,3250,6501,3250,0,1,3252,3206034
168,3250,5800,7100,41180000,2,26006,6503,1,664840000,664840000,9751,3250,6501,3250,0,1,3252,3208052
168,3650,5800,7100,41180000,2,29206,7303,1,706120000,706120000,10951,3650,7301,3650,0,1,3652,44513230
168,3650,5800,7100,41180000,2,29206,7303,1,706120000,706120000,10951,3650,7301,3650,0,1,3652,3653395
168,3650,5800,7100,41180000,2,29206,7303,1,706120000,706120000,10951,3650,7301,3650,0,1,3652,3637258
168,3650,5800,7100,41180000,2,29206,7303,1,706120000,706120000,10951,3650,7301,3650,0,1,3652,3654552
168,3650,5800,7100,41180000,2,29206,7303,1,706120000,706120000,10951,3650,7301,3650,0,1,3652,3648182
168,3650,5800,7100,41180000,2,29206,7303,1,706120000,706120000,10951,3650,7301,3650,0,1,3652,3541303
168,3650,5800,7100,41180000,2,29206,7303,1,706120000,706120000,10951,3650,7301,3650,0,1,3652,3531738
168,4050,5800,7100,41180000,2,32406,8103,1,747400000,747400000,12151,4050,8101,4050,0,1,4052,47785939
168,4050,5800,7100,41180000,2,32406,8103,1,747400000,747400000,12151,4050,8101,4050,0,1,4052,3995043
168,4050,5800,7100,41180000,2,32406,8103,1,747400000,747400000,12151,4050,8101,4050,0,1,4052,4010278
168,4050,5800,7100,41180000,2,32406,8103,1,747400000,747400000,12151,4050,8101,4050,0,1,4052,4016708
168,4050,5800,7100,41180000,2,32406,8103,1,747400000,747400000,12151,4050,8101,4050,0,1,4052,4011622
168,4050,5800,7100,41180000,2,32406,8103,1,747400000,747400000,12151,4050,8101,4050,0,1,4052,3923833
168,4050,5800,7100,41180000,2,32406,8103,1,747400000,747400000,12151,4050,8101,4050,0,1,4052,3912434
168,4450,5800,7100,41180000,2,35606,8903,1,788680000,788680000,13351,4450,8901,4450,0,1,4452,54935195
168,4450,5800,7100,41180000,2,35606,8903,1,788680000,788680000,13351,4450,8901,4450,0,1,4452,4343004
168,4450,5800,7100,41180000,2,35606,8903,1,788680000,788680000,13351,4450,8901,4450,0,1,4452,4349494
168,4450,5800,7100,41180000,2,35606,8903,1,788680000,788680000,13351,4450,8901,4450,0,1,4452,4353272
168,4450,5800,7100,41180000,2,35606,8903,1,788680000,788680000,13351,4450,8901,4450,0,1,4452,4351773
168,4450,5800,7100,41180000,2,35606,8903,1,788680000,788680000,13351,4450,8901,4450,0,1,4452,4253839
168,4450,5800,7100,41180000,2,35606,8903,1,788680000,788680000,13351,4450,8901,4450,0,1,4452,4251320
168,4850,5800,7100,41180000,2,38806,9703,1,829960000,829960000,14551,4850,9701,4850,0,1,4852,59790762
168,4850,5800,7100,41180000,2,38806,9703,1,829960000,829960000,14551,4850,9701,4850,0,1,4852,4699165
168,4850,5800,7100,41180000,2,38806,9703,1,829960000,829960000,14551,4850,9701,4850,0,1,4852,4706703
168,4850,5800,7100,41180000,2,38806,9703,1,829960000,829960000,14551,4850,9701,4850,0,1,4852,4708310
168,4850,5800,7100,41180000,2,38806,9703,1,829960000,829960000,14551,4850,9701,4850,0,1,4852,4704269
168,4850,5800,7100,41180000,2,38806,9703,1,829960000,829960000,14551,4850,9701,4850,0,1,4852,4570672
168,4850,5800,7100,41180000,2,38806,9703,1,829960000,829960000,14551,4850,9701,4850,0,1,4852,4545955
168,5250,5800,7100,41180000,2,42006,10503,1,871240000,871240000,15751,5250,10501,5250,0,1,5252,65014649
168,5250,5800,7100,41180000,2,42006,10503,1,871240000,871240000,15751,5250,10501,5250,0,1,5252,5023426
168,5250,5800,7100,41180000,2,42006,10503,1,871240000,871240000,15751,5250,10501,5250,0,1,5252,5027852
168,5250,5800,7100,41180000,2,42006,10503,1,871240000,871240000,15751,5250,10501,5250,0,1,5252,5021915
168,5250,5800,7100,41180000,2,42006,10503,1,871240000,871240000,15751,5250,10501,5250,0,1,5252,5029379
168,5250,5800,7100,41180000,2,42006,10503,1,871240000,871240000,15751,5250,10501,5250,0,1,5252,4885082
168,5250,5800,7100,41180000,2,42006,10503,1,871240000,871240000,15751,5250,10501,5250,0,1,5252,4853167
168,5650,5800,7100,41180000,2,45206,11303,1,912520000,912520000,16951,5650,11301,5650,0,1,5652,70404389
168,5650,5800,7100,41180000,2,45206,11303,1,912520000,912520000,16951,5650,11301,5650,0,1,5652,5388314
168,5650,5800,7100,41180000,2,45206,11303,1,912520000,912520000,16951,5650,11301,5650,0,1,5652,5395516
168,5650,5800,7100,41180000,2,45206,11303,1,912520000,912520000,16951,5650,11301,5650,0,1,5652,5393926
168,5650,5800,7100,41180000,2,45206,11303,1,912520000,912520000,16951,5650,11301,5650,0,1,5652,5390899
168,5650,5800,7100,41180000,2,45206,11303,1,912520000,912520000,16951,5650,11301,5650,0,1,5652,5237119
168,5650,5800,7100,41180000,2,45206,11303,1,912520000,912520000,16951,5650,11301,5650,0,1,5652,5217384
168,6050,5800,7100,41180000,2,48406,12103,1,953800000,953800000,18151,6050,12101,6050,0,1,6052,75736998
168,6050,5800,7100,41180000,2,48406,12103,1,953800000,953800000,18151,6050,12101,6050,0,1,6052,5754551
168,6050,5800,7100,41180000,2,48406,12103,1,953800000,953800000,18151,6050,12101,6050,0,1,6052,5759259
168,6050,5800,7100,41180000,2,48406,12103,1,953800000,953800000,18151,6050,12101,6050,0,1,6052,5757418
168,6050,5800,7100,41180000,2,48406,12103,1,953800000,953800000,18151,6050,12101,6050,0,1,6052,5747247
168,6050,5800,7100,41180000,2,48406,12103,1,953800000,953800000,18151,6050,12101,6050,0,1,6052,5613267
168,6050,5800,7100,41180000,2,48406,12103,1,953800000,953800000,18151,6050,12101,6050,0,1,6052,5599258
168,6450,5800,7100,41180000,2,51606,12903,1,995080000,995080000,19351,6450,12901,6450,0,1,6452,86261490
168,6450,5800,7100,41180000,2,51606,12903,1,995080000,995080000,19351,6450,12901,6450,0,1,6452,6091433
168,6450,5800,7100,41180000,2,51606,12903,1,995080000,995080000,19351,6450,12901,6450,0,1,6452,6094105
168,6450,5800,7100,41180000,2,51606,12903,1,995080000,995080000,19351,6450,12901,6450,0,1,6452,6099263
168,6450,5800,7100,41180000,2,51606,12903,1,995080000,995080000,19351,6450,12901,6450,0,1,6452,6097526
168,6450,5800,7100,41180000,2,51606,12903,1,995080000,995080000,19351,6450,12901,6450,0,1,6452,5883667
168,6450,5800,7100,41180000,2,51606,12903,1,995080000,995080000,19351,6450,12901,6450,0,1,6452,5877474
168,6850,5800,7100,41180000,2,54806,13703,1,1036360000,1036360000,20551,6850,13701,6850,0,1,6852,87463788
168,6850,5800,7100,41180000,2,54806,13703,1,1036360000,1036360000,20551,6850,13701,6850,0,1,6852,6417564
168,6850,5800,7100,41180000,2,54806,13703,1,1036360000,1036360000,20551,6850,13701,6850,0,1,6852,6414756
168,6850,5800,7100,41180000,2,54806,13703,1,1036360000,1036360000,20551,6850,13701,6850,0,1,6852,6420880
168,6850,5800,7100,41180000,2,54806,13703,1,1036360000,1036360000,20551,6850,13701,6850,0,1,6852,6419057
168,6850,5800,7100,41180000,2,54806,13703,1,1036360000,1036360000,20551,6850,13701,6850,0,1,6852,6254668
168,6850,5800,7100,41180000,2,54806,13703,1,1036360000,1036360000,20551,6850,13701,6850,0,1,6852,6223380
168,50,5800,6700,38860000,2,406,103,1,315880000,315880000,151,50,101,50,0,1,52,453554
168,50,5800,6700,38860000,2,406,103,1,315880000,315880000,151,50,101,50,0,1,52,409012
168,50,5800,6700,38860000,2,406,103,1,315880000,315880000,151,50,101,50,0,1,52,420915
168,50,5800,6700,38860000,2,406,103,1,315880000,315880000,151,50,101,50,0,1,52,421287
168,50,5800,6700,38860000,2,406,103,1,315880000,315880000,151,50,101,50,0,1,52,372347
168,50,5800,6700,38860000,2,406,103,1,315880000,315880000,151,50,101,50,0,1,52,421086
168,50,5800,6700,38860000,2,406,103,1,315880000,315880000,151,50,101,50,0,1,52,420518
168,450,5800,6700,38860000,2,3606,903,1,355880000,355880000,1351,450,901,450,0,1,452,4187267
168,450,5800,6700,38860000,2,3606,903,1,355880000,355880000,1351,450,901,450,0,1,452,751598
168,450,5800,6700,38860000,2,3606,903,1,355880000,355880000,1351,450,901,450,0,1,452,750665
168,450,5800,6700,38860000,2,3606,903,1,355880000,355880000,1351,450,901,450,0,1,452,749668
168,450,5800,6700,38860000,2,3606,903,1,355880000,355880000,1351,450,901,450,0,1,452,751094
168,450,5800,6700,38860000,2,3606,903,1,355880000,355880000,1351,450,901,450,0,1,452,741024
168,450,5800,6700,38860000,2,3606,903,1,355880000,355880000,1351,450,901,450,0,1,452,740154
168,850,5800,6700,38860000,2,6806,1703,1,395880000,395880000,2551,850,1701,850,0,1,852,8686561
168,850,5800,6700,38860000,2,6806,1703,1,395880000,395880000,2551,850,1701,850,0,1,852,1043183
168,850,5800,6700,38860000,2,6806,1703,1,395880000,395880000,2551,850,1701,850,0,1,852,1043772
168,850,5800,6700,38860000,2,6806,1703,1,395880000,395880000,2551,850,1701,850,0,1,852,958622
168,850,5800,6700,38860000,2,6806,1703,1,395880000,395880000,2551,850,1701,850,0,1,852,1037186
168,850,5800,6700,38860000,2,6806,1703,1,395880000,395880000,2551,850,1701,850,0,1,852,1040956
168,850,5800,6700,38860000,2,6806,1703,1,395880000,395880000,2551,850,1701,850,0,1,852,1037704
168,1250,5800,6700,38860000,2,10006,2503,1,435880000,435880000,3751,1250,2501,1250,0,1,1252,13353619
168,1250,5800,6700,38860000,2,10006,2503,1,435880000,435880000,3751,1250,2501,1250,0,1,1252,1368782
168,1250,5800,6700,38860000,2,10006,2503,1,435880000,435880000,3751,1250,2501,1250,0,1,1252,1369215
168,1250,5800,6700,38860000,2,10006,2503,1,435880000,435880000,3751,1250,2501,1250,0,1,1252,1368194
168,1250,5800,6700,38860000,2,10006,2503,1,435880000,435880000,3751,1250,2501,1250,0,1,1252,1367186
168,1250,5800,6700,38860000,2,10006,2503,1,435880000,435880000,3751,1250,2501,1250,0,1,1252,1361248
168,1250,5800,6700,38860000,2,10006,2503,1,435880000,435880000,3751,1250,2501,1250,0,1,1252,1359150
168,1650,5800,6700,38860000,2,13206,3303,1,475880000,475880000,4951,1650,3301,1650,0,1,1652,18091645
168,1650,5800,6700,38860000,2,13206,3303,1,475880000,475880000,4951,1650,3301,1650,0,1,1652,1736965
168,1650,5800,6700,38860000,2,13206,3303,1,475880000,475880000,4951,1650,3301,1650,0,1,1652,1745414
168,1650,5800,6700,38860000,2,13206,3303,1,475880000,475880000,4951,1650,3301,1650,0,1,1652,1747001
168,1650,5800,6700,38860000,2,13206,3303,1,475880000,475880000,4951,1650,3301,1650,0,1,1652,1744741
168,1650,5800,6700,38860000,2,13206,3303,1,475880000,475880000,4951,1650,3301,1650,0,1,1652,1721773
168,1650,5800,6700,38860000,2,13206,3303,1,475880000,475880000,4951,1650,3301,1650,0,1,1652,1720500
168,2050,5800,6700,38860000,2,16406,4103,1,515880000,515880000,6151,2050,4101,2050,0,1,2052,21685370
168,2050,5800,6700,38860000,2,16406,4103,1,515880000,515880000,6151,2050,4101,2050,0,1,2052,2046808
168,2050,5800,6700,38860000,2,16406,4103,1,515880000,515880000,6151,2050,4101,2050,0,1,2052,2048905
168,2050,5800,6700,38860000,2,16406,4103,1,515880000,515880000,6151,2050,4101,2050,0,1,2052,2049778
168,2050,5800,6700,38860000,2,16406,4103,1,515880000,515880000,6151,2050,4101,2050,0,1,2052,2048245
168,2050,5800,6700,38860000,2,16406,4103,1,515880000,515880000,6151,2050,4101,2050,0,1,2052,2024581
168,2050,5800,6700,38860000,2,16406,4103,1,515880000,515880000,6151,2050,4101,2050,0,1,2052,2023207
168,2450,5800,6700,38860000,2,19606,4903,1,555880000,555880000,7351,2450,4901,2450,0,1,2452,27669733
168,2450,5800,6700,38860000,2,19606,4903,1,555880000,555880000,7351,2450,4901,2450,0,1,2452,2417479
168,2450,5800,6700,38860000,2,19606,4903,1,555880000,555880000,7351,2450,4901,2450,0,1,2452,2426388
168,2450,5800,6700,38860000,2,19606,4903,1,555880000,555880000,7351,2450,4901,2450,0,1,2452,2429083
168,2450,5800,6700,38860000,2,19606,4903,1,555880000,555880000,7351,2450,4901,2450,0,1,2452,2428136
168,2450,5800,6700,38860000,2,19606,4903,1,555880000,555880000,7351,2450,4901,2450,0,1,2452,2390687
168,2450,5800,6700,38860000,2,19606,4903,1,555880000,555880000,7351,2450,4901,2450,0,1,2452,2387035
168,2850,5800,6700,38860000,2,22806,5703,1,595880000,595880000,8551,2850,5701,2850,0,1,2852,30833168
168,2850,5800,6700,38860000,2,22806,5703,1,595880000,595880000,8551,2850,5701,2850,0,1,2852,2749213
168,2850,5800,6700,38860000,2,22806,5703,1,595880000,595880000,8551,2850,5701,2850,0,1,2852,2753428
168,2850,5800,6700,38860000,2,22806,5703,1,595880000,595880000,8551,2850,5701,2850,0,1,2852,2752433
168,2850,5800,6700,38860000,2,22806,5703,1,595880000,595880000,8551,2850,5701,2850,0,1,2852,2728923
168,2850,5800,6700,38860000,2,22806,5703,1,595880000,595880000,8551,2850,5701,2850,0,1,2852,2730307
168,2850,5800,6700,38860000,2,22806,5703,1,595880000,595880000,8551,2850,5701,2850,0,1,2852,2725143
168,3250,5800,6700,38860000,2,26006,6503,1,635880000,635880000,9751,3250,6501,3250,0,1,3252,37059817
168,3250,5800,6700,38860000,2,26006,6503,1,635880000,635880000,9751,3250,6501,3250,0,1,3252,3086970
168,3250,5800,6700,38860000,2,26006,6503,1,635880000,635880000,9751,3250,6501,3250,0,1,3252,3092100
168,3250,5800,6700,38860000,2,26006,6503,1,635880000,635880000,9751,3250,6501,3250,0,1,3252,3093235
168,3250,5800,6700,38860000,2,26006,6503,1,635880000,635880000,9751,3250,6501,3250,0,1,3252,3097850
168,3250,5800,6700,38860000,2,26006,6503,1,635880000,635880000,9751,3250,6501,3250,0,1,3252,3025465
168,3250,5800,6700,38860000,2,26006,6503,1,635880000,635880000,9751,3250,6501,3250,0,1,3252,3019997
168,3650,5800,6700,38860000,2,29206,7303,1,675880000,675880000,10951,3650,7301,3650,0,1,3652,42281944
168,3650,5800,6700,38860000,2,29206,7303,1,675880000,675880000,10951,3650,7301,3650,0,1,3652,3440186
168,3650,5800,6700,38860000,2,29206,7303,1,675880000,675880000,10951,3650,7301,3650,0,1,3652,3446574
168,3650,5800,6700,38860000,2,29206,7303,1,675880000,675880000,10951,3650,7301,3650,0,1,3652,3445381
168,3650,5800,6700,38860000,2,29206,7303,1,675880000,675880000,10951,3650,7301,3650,0,1,3652,3431932
168,3650,5800,6700,38860000,2,29206,7303,1,675880000,675880000,10951,3650,7301,3650,0,1,3652,3351038
168,3650,5800,6700,38860000,2,29206,7303,1,675880000,675880000,10951,3650,7301,3650,0,1,3652,3327443
168,4050,5800,6700,38860000,2,32406,8103,1,715880000,715880000,12151,4050,8101,4050,0,1,4052,47098008
168,4050,5800,6700,38860000,2,32406,8103,1,715880000,715880000,12151,4050,8101,4050,0,1,4052,3785688
168,4050,5800,6700,38860000,2,32406,8103,1,715880000,715880000,12151,4050,8101,4050,0,1,4052,3796287
168,4050,5800,6700,38860000,2,32406,8103,1,715880000,715880000,12151,4050,8101,4050,0,1,4052,3797724
168,4050,5800,6700,38860000,2,32406,8103,1,715880000,715880000,12151,4050,8101,4050,0,1,4052,3794251
168,4050,5800,6700,38860000,2,32406,8103,1,715880000,715880000,12151,4050,8101,4050,0,1,4052,3702601
168,4050,5800,6700,38860000,2,32406,8103,1,715880000,715880000,12151,4050,8101,4050,0,1,4052,3697267
168,4450,5800,6700,38860000,2,35606,8903,1,755880000,755880000,13351,4450,8901,4450,0,1,4452,51543358
168,4450,5800,6700,38860000,2,35606,8903,1,755880000,755880000,13351,4450,8901,4450,0,1,4452,4078019
168,4450,5800,6700,38860000,2,35606,8903,1,755880000,755880000,13351,4450,8901,4450,0,1,4452,4080736
168,4450,5800,6700,38860000,2,35606,8903,1,755880000,755880000,13351,4450,8901,4450,0,1,4452,4082062
168,4450,5800,6700,38860000,2,35606,8903,1,755880000,755880000,13351,4450,8901,4450,0,1,4452,4075846
168,4450,5800,6700,38860000,2,35606,8903,1,755880000,755880000,13351,4450,8901,4450,0,1,4452,3960168
168,4450,5800,6700,38860000,2,35606,8903,1,755880000,755880000,13351,4450,8901,4450,0,1,4452,3935299
168,4850,5800,6700,38860000,2,38806,9703,1,795880000,795880000,14551,4850,9701,4850,0,1,4852,56076518
168,4850,5800,6700,38860000,2,38806,9703,1,795880000,795880000,14551,4850,9701,4850,0,1,4852,4411217
168,4850,5800,6700,38860000,2,38806,9703,1,795880000,795880000,14551,4850,9701,4850,0,1,4852,4413974
168,4850,5800,6700,38860000,2,38806,9703,1,795880000,795880000,14551,4850,9701,4850,0,1,4852,4416925
168,4850,5800,6700,38860000,2,38806,9703,1,795880000,795880000,14551,4850,9701,4850,0,1,4852,4415513
168,4850,5800,6700,38860000,2,38806,9703,1,795880000,795880000,14551,4850,9701,4850,0,1,4852,4274446
168,4850,5800,6700,38860000,2,38806,9703,1,795880000,795880000,14551,4850,9701,4850,0,1,4852,4272298
168,5250,5800,6700,38860000,2,42006,10503,1,835880000,835880000,15751,5250,10501,5250,0,1,5252,63237114
168,5250,5800,6700,38860000,2,42006,10503,1,835880000,835880000,15751,5250,10501,5250,0,1,5252,4751613
168,5250,5800,6700,38860000,2,42006,10503,1,835880000,835880000,15751,5250,10501,5250,0,1,5252,4746711
168,5250,5800,6700,38860000,2,42006,10503,1,835880000,835880000,15751,5250,10501,5250,0,1,5252,4753133
168,5250,5800,6700,38860000,2,42006,10503,1,835880000,835880000,15751,5250,10501,5250,0,1,5252,4750117
168,5250,5800,6700,38860000,2,42006,10503,1,835880000,835880000,15751,5250,10501,5250,0,1,5252,4634895
168,5250,5800,6700,38860000,2,42006,10503,1,835880000,835880000,15751,5250,10501,5250,0,1,5252,4617526
168,5650,5800,6700,38860000,2,45206,11303,1,875880000,875880000,16951,5650,11301,5650,0,1,5652,65297712
168,5650,5800,6700,38860000,2,45206,11303,1,875880000,875880000,16951,5650,11301,5650,0,1,5652,5105621
168,5650,5800,6700,38860000,2,45206,11303,1,875880000,875880000,16951,5650,11301,5650,0,1,5652,5114776
168,5650,5800,6700,38860000,2,45206,11303,1,875880000,875880000,16951,5650,11301,5650,0,1,5652,5116372
168,5650,5800,6700,38860000,2,45206,11303,1,875880000,875880000,16951,5650,11301,5650,0,1,5652,5085388
168,5650,5800,6700,38860000,2,45206,11303,1,875880000,875880000,16951,5650,11301,5650,0,1,5652,4990212
168,5650,5800,6700,38860000,2,45206,11303,1,875880000,875880000,16951,5650,11301,5650,0,1,5652,4968411
168,6050,5800,6700,38860000,2,48406,12103,1,915880000,915880000,18151,6050,12101,6050,0,1,6052,70365022
168,6050,5800,6700,38860000,2,48406,12103,1,915880000,915880000,18151,6050,12101,6050,0,1,6052,5422864
168,6050,5800,6700,38860000,2,48406,12103,1,915880000,915880000,18151,6050,12101,6050,0,1,6052,5425965
168,6050,5800,6700,38860000,2,48406,12103,1,915880000,915880000,18151,6050,12101,6050,0,1,6052,5413644
168,6050,5800,6700,38860000,2,48406,12103,1,915880000,915880000,18151,6050,12101,6050,0,1,6052,5427642
168,6050,5800,6700,38860000,2,48406,12103,1,915880000,915880000,18151,6050,12101,6050,0,1,6052,5272219
168,6050,5800,6700,38860000,2,48406,12103,1,915880000,915880000,18151,6050,12101,6050,0,1,6052,5224831
168,6450,5800,6700,38860000,2,51606,12903,1,955880000,955880000,19351,6450,12901,6450,0,1,6452,77683677
168,6450,5800,6700,38860000,2,51606,12903,1,955880000,955880000,19351,6450,12901,6450,0,1,6452,5800907
168,6450,5800,6700,38860000,2,51606,12903,1,955880000,955880000,19351,6450,12901,6450,0,1,6452,5811081
168,6450,5800,6700,38860000,2,51606,12903,1,955880000,955880000,19351,6450,12901,6450,0,1,6452,5812829
168,6450,5800,6700,38860000,2,51606,12903,1,955880000,955880000,19351,6450,12901,6450,0,1,6452,5809450
168,6450,5800,6700,38860000,2,51606,12903,1,955880000,955880000,19351,6450,12901,6450,0,1,6452,5635222
168,6450,5800,6700,38860000,2,51606,12903,1,955880000,955880000,19351,6450,12901,6450,0,1,6452,5611728
168,6850,5800,6700,38860000,2,54806,13703,1,995880000,995880000,20551,6850,13701,6850,0,1,6852,82375556
168,6850,5800,6700,38860000,2,54806,13703,1,995880000,995880000,20551,6850,13701,6850,0,1,6852,6112704
168,6850,5800,6700,38860000,2,54806,13703,1,995880000,995880000,20551,6850,13701,6850,0,1,6852,6114158
168,6850,5800,6700,38860000,2,54806,13703,1,995880000,995880000,20551,6850,13701,6850,0,1,6852,6116045
168,6850,5800,6700,38860000,2,54806,13703,1,995880000,995880000,20551,6850,13701,6850,0,1,6852,6105523
168,6850,5800,6700,38860000,2,54806,13703,1,995880000,995880000,20551,6850,13701,6850,0,1,6852,5941014
168,6850,5800,6700,38860000,2,54806,13703,1,995880000,995880000,20551,6850,13701,6850,0,1,6852,5914650
168,50,5800,6300,36540000,2,406,103,1,297160000,297160000,151,50,101,50,0,1,52,409050
168,50,5800,6300,36540000,2,406,103,1,297160000,297160000,151,50,101,50,0,1,52,367020
168,50,5800,6300,36540000,2,406,103,1,297160000,297160000,151,50,101,50,0,1,52,333083
168,50,5800,6300,36540000,2,406,103,1,297160000,297160000,151,50,101,50,0,1,52,372361
168,50,5800,6300,36540000,2,406,103,1,297160000,297160000,151,50,101,50,0,1,52,373139
168,50,5800,6300,36540000,2,406,103,1,297160000,297160000,151,50,101,50,0,1,52,382307
168,50,5800,6300,36540000,2,406,103,1,297160000,297160000,151,50,101,50,0,1,52,381929
168,450,5800,6300,36540000,2,3606,903,1,335880000,335880000,1351,450,901,450,0,1,452,3862865
168,450,5800,6300,36540000,2,3606,903,1,335880000,335880000,1351,450,901,450,0,1,452,726601
168,450,5800,6300,36540000,2,3606,903,1,335880000,335880000,1351,450,901,450,0,1,452,725118
168,450,5800,6300,36540000,2,3606,903,1,335880000,335880000,1351,450,901,450,0,1,452,710927
168,450,5800,6300,36540000,2,3606,903,1,335880000,335880000,1351,450,901,450,0,1,452,723297
168,450,5800,6300,36540000,2,3606,903,1,335880000,335880000,1351,450,901,450,0,1,452,726329
168,450,5800,6300,36540000,2,3606,903,1,335880000,335880000,1351,450,901,450,0,1,452,725884
168,850,5800,6300,36540000,2,6806,1703,1,374600000,374600000,2551,850,1701,850,0,1,852,8172918
168,850,5800,6300,36540000,2,6806,1703,1,374600000,374600000,2551,850,1701,850,0,1,852,1002240
168,850,5800,6300,36540000,2,6806,1703,1,374600000,374600000,2551,850,1701,850,0,1,852,1002942
168,850,5800,6300,36540000,2,6806,1703,1,374600000,374600000,2551,850,1701,850,0,1,852,1003459
168,850,5800,6300,36540000,2,6806,1703,1,374600000,374600000,2551,850,1701,850,0,1,852,1001302
168,850,5800,6300,36540000,2,6806,1703,1,374600000,374600000,2551,850,1701,850,0,1,852,991101
168,850,5800,6300,36540000,2,6806,1703,1,374600000,374600000,2551,850,1701,850,0,1,852,989807
168,1250,5800,6300,36540000,2,10006,2503,1,413320000,413320000,3751,1250,2501,1250,0,1,1252,11944265
168,1250,5800,6300,36540000,2,10006,2503,1,413320000,413320000,3751,1250,2501,1250,0,1,1252,1293485
168,1250,5800,6300,36540000,2,10006,2503,1,413320000,413320000,3751,1250,2501,1250,0,1,1252,1292678
168,1250,5800,6300,36540000,2,10006,2503,1,413320000,413320000,3751,1250,2501,1250,0,1,1252,1293052
168,1250,5800,6300,36540000,2,10006,2503,1,413320000,413320000,3751,1250,2501,1250,0,1,1252,1292155
168,1250,5800,6300,36540000,2,10006,2503,1,413320000,413320000,3751,1250,2501,1250,0,1,1252,1291645
168,1250,5800,6300,36540000,2,10006,2503,1,413320000,413320000,3751,1250,2501,1250,0,1,1252,1289872
168,1650,5800,6300,36540000,2,13206,3303,1,452040000,452040000,4951,1650,3301,1650,0,1,1652,17104576
168,1650,5800,6300,36540000,2,13206,3303,1,452040000,452040000,4951,1650,3301,1650,0,1,1652,1608170
168,1650,5800,6300,36540000,2,13206,3303,1,452040000,452040000,4951,1650,3301,1650,0,1,1652,1608738
168,1650,5800,6300,36540000,2,13206,3303,1,452040000,452040000,4951,1650,3301,1650,0,1,1652,1609193
168,1650,5800,6300,36540000,2,13206,3303,1,452040000,452040000,4951,1650,3301,1650,0,1,1652,1609723
168,1650,5800,6300,36540000,2,13206,3303,1,452040000,452040000,4951,1650,3301,1650,0,1,1652,1589941
168,1650,5800,6300,36540000,2,13206,3303,1,452040000,452040000,4951,1650,3301,1650,0,1,1652,1588899
168,2050,5800,6300,36540000,2,16406,4103,1,490760000,490760000,6151,2050,4101,2050,0,1,2052,21337741
168,2050,5800,6300,36540000,2,16406,4103,1,490760000,490760000,6151,2050,4101,2050,0,1,2052,1965183
168,2050,5800,6300,36540000,2,16406,4103,1,490760000,490760000,6151,2050,4101,2050,0,1,2052,1960622
168,2050,5800,6300,36540000,2,16406,4103,1,490760000,490760000,6151,2050,4101,2050,0,1,2052,1964144
168,2050,5800,6300,36540000,2,16406,4103,1,490760000,490760000,6151,2050,4101,2050,0,1,2052,1958170
168,2050,5800,6300,36540000,2,16406,4103,1,490760000,490760000,6151,2050,4101,2050,0,1,2052,1927473
168,2050,5800,6300,36540000,2,16406,4103,1,490760000,490760000,6151,2050,4101,2050,0,1,2052,1925900
168,2450,5800,6300,36540000,2,19606,4903,1,529480000,529480000,7351,2450,4901,2450,0,1,2452,24782031
168,2450,5800,6300,36540000,2,19606,4903,1,529480000,529480000,7351,2450,4901,2450,0,1,2452,2260429
168,2450,5800,6300,36540000,2,19606,4903,1,529480000,529480000,7351,2450,4901,2450,0,1,2452,2259751
168,2450,5800,6300,36540000,2,19606,4903,1,529480000,529480000,7351,2450,4901,2450,0,1,2452,2258959
168,2450,5800,6300,36540000,2,19606,4903,1,529480000,529480000,7351,2450,4901,2450,0,1,2452,2258138
168,2450,5800,6300,36540000,2,19606,4903,1,529480000,529480000,7351,2450,4901,2450,0,1,2452,2229344
168,2450,5800,6300,36540000,2,19606,4903,1,529480000,529480000,7351,2450,4901,2450,0,1,2452,2226443
168,2850,5800,6300,36540000,2,22806,5703,1,568200000,568200000,8551,2850,5701,2850,0,1,2852,29744181
168,2850,5800,6300,36540000,2,22806,5703,1,568200000,568200000,8551,2850,5701,2850,0,1,2852,2557186
168,2850,5800,6300,36540000,2,22806,5703,1,568200000,568200000,8551,2850,5701,2850,0,1,2852,2560531
168,2850,5800,6300,36540000,2,22806,5703,1,568200000,568200000,8551,2850,5701,2850,0,1,2852,2561527
168,2850,5800,6300,36540000,2,22806,5703,1,568200000,568200000,8551,2850,5701,2850,0,1,2852,2559511
168,2850,5800,6300,36540000,2,22806,5703,1,568200000,568200000,8551,2850,5701,2850,0,1,2852,2517367
168,2850,5800,6300,36540000,2,22806,5703,1,568200000,568200000,8551,2850,5701,2850,0,1,2852,2513558
168,3250,5800,6300,36540000,2,26006,6503,1,606920000,606920000,9751,3250,6501,3250,0,1,3252,33258740
168,3250,5800,6300,36540000,2,26006,6503,1,606920000,606920000,9751,3250,6501,3250,0,1,3252,2918000
168,3250,5800,6300,36540000,2,26006,6503,1,606920000,606920000,9751,3250,6501,3250,0,1,3252,2921306
168,3250,5800,6300,36540000,2,26006,6503,1,606920000,606920000,9751,3250,6501,3250,0,1,3252,2922379
168,3250,5800,6300,36540000,2,26006,6503,1,606920000,606920000,9751,3250,6501,3250,0,1,3252,2920047
168,3250,5800,6300,36540000,2,26006,6503,1,606920000,606920000,9751,3250,6501,3250,0,1,3252,2838382
168,3250,5800,6300,36540000,2,26006,6503,1,606920000,606920000,9751,3250,6501,3250,0,1,3252,2831285
168,3650,5800,6300,36540000,2,29206,7303,1,645640000,645640000,10951,3650,7301,3650,0,1,3652,39276718
168,3650,5800,6300,36540000,2,29206,7303,1,645640000,645640000,10951,3650,7301,3650,0,1,3652,3240899
168,3650,5800,6300,36540000,2,29206,7303,1,645640000,645640000,10951,3650,7301,3650,0,1,3652,3244402
168,3650,5800,6300,36540000,2,29206,7303,1,645640000,645640000,10951,3650,7301,3650,0,1,3652,3245569
168,3650,5800,6300,36540000,2,29206,7303,1,645640000,645640000,10951,3650,7301,3650,0,1,3652,3243079
168,3650,5800,6300,36540000,2,29206,7303,1,645640000,645640000,10951,3650,7301,3650,0,1,3652,3166403
168,3650,5800,6300,36540000,2,29206,7303,1,645640000,645640000,10951,3650,7301,3650,0,1,3652,3134322
168,4050,5800,6300,36540000,2,32406,8103,1,684360000,684360000,12151,4050,8101,4050,0,1,4052,44668494
168,4050,5800,6300,36540000,2,32406,8103,1,684360000,684360000,12151,4050,8101,4050,0,1,4052,3521232
168,4050,5800,6300,36540000,2,32406,8103,1,684360000,684360000,12151,4050,8101,4050,0,1,4052,3543637
168,4050,5800,6300,36540000,2,32406,8103,1,684360000,684360000,12151,4050,8101,4050,0,1,4052,3546157
168,4050,5800,6300,36540000,2,32406,8103,1,684360000,684360000,12151,4050,8101,4050,0,1,4052,3544895
168,4050,5800,6300,36540000,2,32406,8103,1,684360000,684360000,12151,4050,8101,4050,0,1,4052,3480703
168,4050,5800,6300,36540000,2,32406,8103,1,684360000,684360000,12151,4050,8101,4050,0,1,4052,3478592
168,4450,5800,6300,36540000,2,35606,8903,1,723080000,723080000,13351,4450,8901,4450,0,1,4452,48681853
168,4450,5800,6300,36540000,2,35606,8903,1,723080000,723080000,13351,4450,8901,4450,0,1,4452,3854884
168,4450,5800,6300,36540000,2,35606,8903,1,723080000,723080000,13351,4450,8901,4450,0,1,4452,3852484
168,4450,5800,6300,36540000,2,35606,8903,1,723080000,723080000,13351,4450,8901,4450,0,1,4452,3850450
168,4450,5800,6300,36540000,2,35606,8903,1,723080000,723080000,13351,4450,8901,4450,0,1,4452,3853565
168,4450,5800,6300,36540000,2,35606,8903,1,723080000,723080000,13351,4450,8901,4450,0,1,4452,3764718
168,4450,5800,6300,36540000,2,35606,8903,1,723080000,723080000,13351,4450,8901,4450,0,1,4452,3760404
168,4850,5800,6300,36540000,2,38806,9703,1,761800000,761800000,14551,4850,9701,4850,0,1,4852,52900900
168,4850,5800,6300,36540000,2,38806,9703,1,761800000,761800000,14551,4850,9701,4850,0,1,4852,4208178
168,4850,5800,6300,36540000,2,38806,9703,1,761800000,761800000,14551,4850,9701,4850,0,1,4852,4206645
168,4850,5800,6300,36540000,2,38806,9703,1,761800000,761800000,14551,4850,9701,4850,0,1,4852,4211320
168,4850,5800,6300,36540000,2,38806,9703,1,761800000,761800000,14551,4850,9701,4850,0,1,4852,4203858
168,4850,5800,6300,36540000,2,38806,9703,1,761800000,761800000,14551,4850,9701,4850,0,1,4852,4089518
168,4850,5800,6300,36540000,2,38806,9703,1,761800000,761800000,14551,4850,9701,4850,0,1,4852,4078526
168,5250,5800,6300,36540000,2,42006,10503,1,800520000,800520000,15751,5250,10501,5250,0,1,5252,56139746
168,5250,5800,6300,36540000,2,42006,10503,1,800520000,800520000,15751,5250,10501,5250,0,1,5252,4475225
168,5250,5800,6300,36540000,2,42006,10503,1,800520000,800520000,15751,5250,10501,5250,0,1,5252,4485644
168,5250,5800,6300,36540000,2,42006,10503,1,800520000,800520000,15751,5250,10501,5250,0,1,5252,4487291
168,5250,5800,6300,36540000,2,42006,10503,1,800520000,800520000,15751,5250,10501,5250,0,1,5252,4476745
168,5250,5800,6300,36540000,2,42006,10503,1,800520000,800520000,15751,5250,10501,5250,0,1,5252,4367004
168,5250,5800,6300,36540000,2,42006,10503,1,800520000,800520000,15751,5250,10501,5250,0,1,5252,4317764
168,5650,5800,6300,36540000,2,45206,11303,1,839240000,839240000,16951,5650,11301,5650,0,1,5652,61454796
168,5650,5800,6300,36540000,2,45206,11303,1,839240000,839240000,16951,5650,11301,5650,0,1,5652,4791559
168,5650,5800,6300,36540000,2,45206,11303,1,839240000,839240000,16951,5650,11301,5650,0,1,5652,4786296
168,5650,5800,6300,36540000,2,45206,11303,1,839240000,839240000,16951,5650,11301,5650,0,1,5652,4789974
168,5650,5800,6300,36540000,2,45206,11303,1,839240000,839240000,16951,5650,11301,5650,0,1,5652,4788669
168,5650,5800,6300,36540000,2,45206,11303,1,839240000,839240000,16951,5650,11301,5650,0,1,5652,4675474
168,5650,5800,6300,36540000,2,45206,11303,1,839240000,839240000,16951,5650,11301,5650,0,1,5652,4631309
168,6050,5800,6300,36540000,2,48406,12103,1,877960000,877960000,18151,6050,12101,6050,0,1,6052,66496051
168,6050,5800,6300,36540000,2,48406,12103,1,877960000,877960000,18151,6050,12101,6050,0,1,6052,5055425
168,6050,5800,6300,36540000,2,48406,12103,1,877960000,877960000,18151,6050,12101,6050,0,1,6052,5088878
168,6050,5800,6300,36540000,2,48406,12103,1,877960000,877960000,18151,6050,12101,6050,0,1,6052,5087445
168,6050,5800,6300,36540000,2,48406,12103,1,877960000,877960000,18151,6050,12101,6050,0,1,6052,5086023
168,6050,5800,6300,36540000,2,48406,12103,1,877960000,877960000,18151,6050,12101,6050,0,1,6052,4967250
168,6050,5800,6300,36540000,2,48406,12103,1,877960000,877960000,18151,6050,12101,6050,0,1,6052,4921702
168,6450,5800,6300,36540000,2,51606,12903,1,916680000,916680000,19351,6450,12901,6450,0,1,6452,71601666
168,6450,5800,6300,36540000,2,51606,12903,1,916680000,916680000,19351,6450,12901,6450,0,1,6452,5464889
168,6450,5800,6300,36540000,2,51606,12903,1,916680000,916680000,19351,6450,12901,6450,0,1,6452,5459709
168,6450,5800,6300,36540000,2,51606,12903,1,916680000,916680000,19351,6450,12901,6450,0,1,6452,5468743
168,6450,5800,6300,36540000,2,51606,12903,1,916680000,916680000,19351,6450,12901,6450,0,1,6452,5433279
168,6450,5800,6300,36540000,2,51606,12903,1,916680000,916680000,19351,6450,12901,6450,0,1,6452,5317996
168,6450,5800,6300,36540000,2,51606,12903,1,916680000,916680000,19351,6450,12901,6450,0,1,6452,5303967
168,6850,5800,6300,36540000,2,54806,13703,1,955400000,955400000,20551,6850,13701,6850,0,1,6852,75672519
168,6850,5800,6300,36540000,2,54806,13703,1,955400000,955400000,20551,6850,13701,6850,0,1,6852,5786265
168,6850,5800,6300,36540000,2,54806,13703,1,955400000,955400000,20551,6850,13701,6850,0,1,6852,5783264
168,6850,5800,6300,36540000,2,54806,13703,1,955400000,955400000,20551,6850,13701,6850,0,1,6852,5788277
168,6850,5800,6300,36540000,2,54806,13703,1,955400000,955400000,20551,6850,13701,6850,0,1,6852,5775954
168,6850,5800,6300,36540000,2,54806,13703,1,955400000,955400000,20551,6850,13701,6850,0,1,6852,5615228
168,6850,5800,6300,36540000,2,54806,13703,1,955400000,955400000,20551,6850,13701,6850,0,1,6852,5591294
168,50,5800,5900,34220000,2,406,103,1,278440000,278440000,151,50,101,50,0,1,52,381978
168,50,5800,5900,34220000,2,406,103,1,278440000,278440000,151,50,101,50,0,1,52,375482
168,50,5800,5900,34220000,2,406,103,1,278440000,278440000,151,50,101,50,0,1,52,374662
168,50,5800,5900,34220000,2,406,103,1,278440000,278440000,151,50,101,50,0,1,52,327432
168,50,5800,5900,34220000,2,406,103,1,278440000,278440000,151,50,101,50,0,1,52,369514
168,50,5800,5900,34220000,2,406,103,1,278440000,278440000,151,50,101,50,0,1,52,378523
168,50,5800,5900,34220000,2,406,103,1,278440000,278440000,151,50,101,50,0,1,52,378913
168,450,5800,5900,34220000,2,3606,903,1,315880000,315880000,1351,450,901,450,0,1,452,3626866
168,450,5800,5900,34220000,2,3606,903,1,315880000,315880000,1351,450,901,450,0,1,452,691040
168,450,5800,5900,34220000,2,3606,903,1,315880000,315880000,1351,450,901,450,0,1,452,668236
168,450,5800,5900,34220000,2,3606,903,1,315880000,315880000,1351,450,901,450,0,1,452,690157
168,450,5800,5900,34220000,2,3606,903,1,315880000,315880000,1351,450,901,450,0,1,452,688375
168,450,5800,5900,34220000,2,3606,903,1,315880000,315880000,1351,450,901,450,0,1,452,690524
168,450,5800,5900,34220000,2,3606,903,1,315880000,315880000,1351,450,901,450,0,1,452,686819
168,850,5800,5900,34220000,2,6806,1703,1,353320000,353320000,2551,850,1701,850,0,1,852,7485417
168,850,5800,5900,34220000,2,6806,1703,1,353320000,353320000,2551,850,1701,850,0,1,852,928840
168,850,5800,5900,34220000,2,6806,1703,1,353320000,353320000,2551,850,1701,850,0,1,852,926601
168,850,5800,5900,34220000,2,6806,1703,1,353320000,353320000,2551,850,1701,850,0,1,852,928373
168,850,5800,5900,34220000,2,6806,1703,1,353320000,353320000,2551,850,1701,850,0,1,852,929294
168,850,5800,5900,34220000,2,6806,1703,1,353320000,353320000,2551,850,1701,850,0,1,852,929937
168,850,5800,5900,34220000,2,6806,1703,1,353320000,353320000,2551,850,1701,850,0,1,852,929665
168,1250,5800,5900,34220000,2,10006,2503,1,390760000,390760000,3751,1250,2501,1250,0,1,1252,11181533
168,1250,5800,5900,34220000,2,10006,2503,1,390760000,390760000,3751,1250,2501,1250,0,1,1252,1109558
168,1250,5800,5900,34220000,2,10006,2503,1,390760000,390760000,3751,1250,2501,1250,0,1,1252,1201211
168,1250,5800,5900,34220000,2,10006,2503,1,390760000,390760000,3751,1250,2501,1250,0,1,1252,1203142
168,1250,5800,5900,34220000,2,10006,2503,1,390760000,390760000,3751,1250,2501,1250,0,1,1252,1232809
168,1250,5800,5900,34220000,2,10006,2503,1,390760000,390760000,3751,1250,2501,1250,0,1,1252,1220417
168,1250,5800,5900,34220000,2,10006,2503,1,390760000,390760000,3751,1250,2501,1250,0,1,1252,1219865
168,1650,5800,5900,34220000,2,13206,3303,1,428200000,428200000,4951,1650,3301,1650,0,1,1652,15656650
168,1650,5800,5900,34220000,2,13206,3303,1,428200000,428200000,4951,1650,3301,1650,0,1,1652,1505368
168,1650,5800,5900,34220000,2,13206,3303,1,428200000,428200000,4951,1650,3301,1650,0,1,1652,1507086
168,1650,5800,5900,34220000,2,13206,3303,1,428200000,428200000,4951,1650,3301,1650,0,1,1652,1507605
168,1650,5800,5900,34220000,2,13206,3303,1,428200000,428200000,4951,1650,3301,1650,0,1,1652,1506421
168,1650,5800,5900,34220000,2,13206,3303,1,428200000,428200000,4951,1650,3301,1650,0,1,1652,1500396
168,1650,5800,5900,34220000,2,13206,3303,1,428200000,428200000,4951,1650,3301,1650,0,1,1652,1498890
168,2050,5800,5900,34220000,2,16406,4103,1,465640000,465640000,6151,2050,4101,2050,0,1,2052,19280819
168,2050,5800,5900,34220000,2,16406,4103,1,465640000,465640000,6151,2050,4101,2050,0,1,2052,1825550
168,2050,5800,5900,34220000,2,16406,4103,1,465640000,465640000,6151,2050,4101,2050,0,1,2052,1834506
168,2050,5800,5900,34220000,2,16406,4103,1,465640000,465640000,6151,2050,4101,2050,0,1,2052,1835345
168,2050,5800,5900,34220000,2,16406,4103,1,465640000,465640000,6151,2050,4101,2050,0,1,2052,1832878
168,2050,5800,5900,34220000,2,16406,4103,1,465640000,465640000,6151,2050,4101,2050,0,1,2052,1810869
168,2050,5800,5900,34220000,2,16406,4103,1,465640000,465640000,6151,2050,4101,2050,0,1,2052,1812296
168,2450,5800,5900,34220000,2,19606,4903,1,503080000,503080000,7351,2450,4901,2450,0,1,2452,23595684
168,2450,5800,5900,34220000,2,19606,4903,1,503080000,503080000,7351,2450,4901,2450,0,1,2452,2107058
168,2450,5800,5900,34220000,2,19606,4903,1,503080000,503080000,7351,2450,4901,2450,0,1,2452,2103812
168,2450,5800,5900,34220000,2,19606,4903,1,503080000,503080000,7351,2450,4901,2450,0,1,2452,2108157
168,2450,5800,5900,34220000,2,19606,4903,1,503080000,503080000,7351,2450,4901,2450,0,1,2452,2105782
168,2450,5800,5900,34220000,2,19606,4903,1,503080000,503080000,7351,2450,4901,2450,0,1,2452,2081245
168,2450,5800,5900,34220000,2,19606,4903,1,503080000,503080000,7351,2450,4901,2450,0,1,2452,2079877
168,2850,5800,5900,34220000,2,22806,5703,1,540520000,540520000,8551,2850,5701,2850,0,1,2852,25996641
168,2850,5800,5900,34220000,2,22806,5703,1,540520000,540520000,8551,2850,5701,2850,0,1,2852,2410762
168,2850,5800,5900,34220000,2,22806,5703,1,540520000,540520000,8551,2850,5701,2850,0,1,2852,2414342
168,2850,5800,5900,34220000,2,22806,5703,1,540520000,540520000,8551,2850,5701,2850,0,1,2852,2415347
168,2850,5800,5900,34220000,2,22806,5703,1,540520000,540520000,8551,2850,5701,2850,0,1,2852,2412369
168,2850,5800,5900,34220000,2,22806,5703,1,540520000,540520000,8551,2850,5701,2850,0,1,2852,2383391
168,2850,5800,5900,34220000,2,22806,5703,1,540520000,540520000,8551,2850,5701,2850,0,1,2852,2384915
168,3250,5800,5900,34220000,2,26006,6503,1,577960000,577960000,9751,3250,6501,3250,0,1,3252,31284258
168,3250,5800,5900,34220000,2,26006,6503,1,577960000,577960000,9751,3250,6501,3250,0,1,3252,2716024
168,3250,5800,5900,34220000,2,26006,6503,1,577960000,577960000,9751,3250,6501,3250,0,1,3252,2728069
168,3250,5800,5900,34220000,2,26006,6503,1,577960000,577960000,9751,3250,6501,3250,0,1,3252,2730470
168,3250,5800,5900,34220000,2,26006,6503,1,577960000,577960000,9751,3250,6501,3250,0,1,3252,2726984
168,3250,5800,5900,34220000,2,26006,6503,1,577960000,577960000,9751,3250,6501,3250,0,1,3252,2689193
168,3250,5800,5900,34220000,2,26006,6503,1,577960000,577960000,9751,3250,6501,3250,0,1,3252,2687246
168,3650,5800,5900,34220000,2,29206,7303,1,615400000,615400000,10951,3650,7301,3650,0,1,3652,36829033
168,3650,5800,5900,34220000,2,29206,7303,1,615400000,615400000,10951,3650,7301,3650,0,1,3652,3065347
168,3650,5800,5900,34220000,2,29206,7303,1,615400000,615400000,10951,3650,7301,3650,0,1,3652,3061441
168,3650,5800,5900,34220000,2,29206,7303,1,615400000,615400000,10951,3650,7301,3650,0,1,3652,3067893
168,3650,5800,5900,34220000,2,29206,7303,1,615400000,615400000,10951,3650,7301,3650,0,1,3652,3054119
168,3650,5800,5900,34220000,2,29206,7303,1,615400000,615400000,10951,3650,7301,3650,0,1,3652,2985994
168,3650,5800,5900,34220000,2,29206,7303,1,615400000,615400000,10951,3650,7301,3650,0,1,3652,2983457
168,4050,5800,5900,34220000,2,32406,8103,1,652840000,652840000,12151,4050,8101,4050,0,1,4052,41147266
168,4050,5800,5900,34220000,2,32406,8103,1,652840000,652840000,12151,4050,8101,4050,0,1,4052,3338145
168,4050,5800,5900,34220000,2,32406,8103,1,652840000,652840000,12151,4050,8101,4050,0,1,4052,3336896
168,4050,5800,5900,34220000,2,32406,8103,1,652840000,652840000,12151,4050,8101,4050,0,1,4052,3340937
168,4050,5800,5900,34220000,2,32406,8103,1,652840000,652840000,12151,4050,8101,4050,0,1,4052,3333783
168,4050,5800,5900,34220000,2,32406,8103,1,652840000,652840000,12151,4050,8101,4050,0,1,4052,3273459
168,4050,5800,5900,34220000,2,32406,8103,1,652840000,652840000,12151,4050,8101,4050,0,1,4052,3271378
168,4450,5800,5900,34220000,2,35606,8903,1,690280000,690280000,13351,4450,8901,4450,0,1,4452,44553050
168,4450,5800,5900,34220000,2,35606,8903,1,690280000,690280000,13351,4450,8901,4450,0,1,4452,3616581
168,4450,5800,5900,34220000,2,35606,8903,1,690280000,690280000,13351,4450,8901,4450,0,1,4452,3621069
168,4450,5800,5900,34220000,2,35606,8903,1,690280000,690280000,13351,4450,8901,4450,0,1,4452,3618627
168,4450,5800,5900,34220000,2,35606,8903,1,690280000,690280000,13351,4450,8901,4450,0,1,4452,3619730
168,4450,5800,5900,34220000,2,35606,8903,1,690280000,690280000,13351,4450,8901,4450,0,1,4452,3536967
168,4450,5800,5900,34220000,2,35606,8903,1,690280000,690280000,13351,4450,8901,4450,0,1,4452,3535106
168,4850,5800,5900,34220000,2,38806,9703,1,727720000,727720000,14551,4850,9701,4850,0,1,4852,48810244
168,4850,5800,5900,34220000,2,38806,9703,1,727720000,727720000,14551,4850,9701,4850,0,1,4852,3941842
168,4850,5800,5900,34220000,2,38806,9703,1,727720000,727720000,14551,4850,9701,4850,0,1,4852,3946484
168,4850,5800,5900,34220000,2,38806,9703,1,727720000,727720000,14551,4850,9701,4850,0,1,4852,3947893
168,4850,5800,5900,34220000,2,38806,9703,1,727720000,727720000,14551,4850,9701,4850,0,1,4852,3943969
168,4850,5800,5900,34220000,2,38806,9703,1,727720000,727720000,14551,4850,9701,4850,0,1,4852,3846001
168,4850,5800,5900,34220000,2,38806,9703,1,727720000,727720000,14551,4850,9701,4850,0,1,4852,3840873
168,5250,5800,5900,34220000,2,42006,10503,1,765160000,765160000,15751,5250,10501,5250,0,1,5252,53270892
168,5250,5800,5900,34220000,2,42006,10503,1,765160000,765160000,15751,5250,10501,5250,0,1,5252,4218789
168,5250,5800,5900,34220000,2,42006,10503,1,765160000,765160000,15751,5250,10501,5250,0,1,5252,4228939
168,5250,5800,5900,34220000,2,42006,10503,1,765160000,765160000,15751,5250,10501,5250,0,1,5252,4227440
168,5250,5800,5900,34220000,2,42006,10503,1,765160000,765160000,15751,5250,10501,5250,0,1,5252,4225987
168,5250,5800,5900,34220000,2,42006,10503,1,765160000,765160000,15751,5250,10501,5250,0,1,5252,4112423
168,5250,5800,5900,34220000,2,42006,10503,1,765160000,765160000,15751,5250,10501,5250,0,1,5252,4073977
168,5650,5800,5900,34220000,2,45206,11303,1,802600000,802600000,16951,5650,11301,5650,0,1,5652,55929815
168,5650,5800,5900,34220000,2,45206,11303,1,802600000,802600000,16951,5650,11301,5650,0,1,5652,4502782
168,5650,5800,5900,34220000,2,45206,11303,1,802600000,802600000,16951,5650,11301,5650,0,1,5652,4507607
168,5650,5800,5900,34220000,2,45206,11303,1,802600000,802600000,16951,5650,11301,5650,0,1,5652,4509207
168,5650,5800,5900,34220000,2,45206,11303,1,802600000,802600000,16951,5650,11301,5650,0,1,5652,4504772
168,5650,5800,5900,34220000,2,45206,11303,1,802600000,802600000,16951,5650,11301,5650,0,1,5652,4392471
168,5650,5800,5900,34220000,2,45206,11303,1,802600000,802600000,16951,5650,11301,5650,0,1,5652,4341879
168,6050,5800,5900,34220000,2,48406,12103,1,840040000,840040000,18151,6050,12101,6050,0,1,6052,63216466
168,6050,5800,5900,34220000,2,48406,12103,1,840040000,840040000,18151,6050,12101,6050,0,1,6052,4829207
168,6050,5800,5900,34220000,2,48406,12103,1,840040000,840040000,18151,6050,12101,6050,0,1,6052,4818452
168,6050,5800,5900,34220000,2,48406,12103,1,840040000,840040000,18151,6050,12101,6050,0,1,6052,4830872
168,6050,5800,5900,34220000,2,48406,12103,1,840040000,840040000,18151,6050,12101,6050,0,1,6052,4827634
168,6050,5800,5900,34220000,2,48406,12103,1,840040000,840040000,18151,6050,12101,6050,0,1,6052,4696339
168,6050,5800,5900,34220000,2,48406,12103,1,840040000,840040000,18151,6050,12101,6050,0,1,6052,4689897
168,6450,5800,5900,34220000,2,51606,12903,1,877480000,877480000,19351,6450,12901,6450,0,1,6452,66772314
168,6450,5800,5900,34220000,2,51606,12903,1,877480000,877480000,19351,6450,12901,6450,0,1,6452,5071763
168,6450,5800,5900,34220000,2,51606,12903,1,877480000,877480000,19351,6450,12901,6450,0,1,6452,5105369
168,6450,5800,5900,34220000,2,51606,12903,1,877480000,877480000,19351,6450,12901,6450,0,1,6452,5103631
168,6450,5800,5900,34220000,2,51606,12903,1,877480000,877480000,19351,6450,12901,6450,0,1,6452,5095211
168,6450,5800,5900,34220000,2,51606,12903,1,877480000,877480000,19351,6450,12901,6450,0,1,6452,4972323
168,6450,5800,5900,34220000,2,51606,12903,1,877480000,877480000,19351,6450,12901,6450,0,1,6452,4939603
168,6850,5800,5900,34220000,2,54806,13703,1,914920000,914920000,20551,6850,13701,6850,0,1,6852,71226614
168,6850,5800,5900,34220000,2,54806,13703,1,914920000,914920000,20551,6850,13701,6850,0,1,6852,5373521
168,6850,5800,5900,34220000,2,54806,13703,1,914920000,914920000,20551,6850,13701,6850,0,1,6852,5380892
168,6850,5800,5900,34220000,2,54806,13703,1,914920000,914920000,20551,6850,13701,6850,0,1,6852,5379062
168,6850,5800,5900,34220000,2,54806,13703,1,914920000,914920000,20551,6850,13701,6850,0,1,6852,5377358
168,6850,5800,5900,34220000,2,54806,13703,1,914920000,914920000,20551,6850,13701,6850,0,1,6852,5244655
168,6850,5800,5900,34220000,2,54806,13703,1,914920000,914920000,20551,6850,13701,6850,0,1,6852,5185801
168,50,5800,5500,31900000,2,406,103,1,259720000,259720000,151,50,101,50,0,1,52,349008
168,50,5800,5500,31900000,2,406,103,1,259720000,259720000,151,50,101,50,0,1,52,293506
168,50,5800,5500,31900000,2,406,103,1,259720000,259720000,151,50,101,50,0,1,52,291246
168,50,5800,5500,31900000,2,406,103,1,259720000,259720000,151,50,101,50,0,1,52,273340
168,50,5800,5500,31900000,2,406,103,1,259720000,259720000,151,50,101,50,0,1,52,292821
168,50,5800,5500,31900000,2,406,103,1,259720000,259720000,151,50,101,50,0,1,52,329923
168,50,5800,5500,31900000,2,406,103,1,259720000,259720000,151,50,101,50,0,1,52,329547
168,450,5800,5500,31900000,2,3606,903,1,295880000,295880000,1351,450,901,450,0,1,452,3311732
168,450,5800,5500,31900000,2,3606,903,1,295880000,295880000,1351,450,901,450,0,1,452,622831
168,450,5800,5500,31900000,2,3606,903,1,295880000,295880000,1351,450,901,450,0,1,452,624294
168,450,5800,5500,31900000,2,3606,903,1,295880000,295880000,1351,450,901,450,0,1,452,620194
168,450,5800,5500,31900000,2,3606,903,1,295880000,295880000,1351,450,901,450,0,1,452,623793
168,450,5800,5500,31900000,2,3606,903,1,295880000,295880000,1351,450,901,450,0,1,452,630851
168,450,5800,5500,31900000,2,3606,903,1,295880000,295880000,1351,450,901,450,0,1,452,631884
168,850,5800,5500,31900000,2,6806,1703,1,332040000,332040000,2551,850,1701,850,0,1,852,6665143
168,850,5800,5500,31900000,2,6806,1703,1,332040000,332040000,2551,850,1701,850,0,1,852,879220
168,850,5800,5500,31900000,2,6806,1703,1,332040000,332040000,2551,850,1701,850,0,1,852,877938
168,850,5800,5500,31900000,2,6806,1703,1,332040000,332040000,2551,850,1701,850,0,1,852,878461
168,850,5800,5500,31900000,2,6806,1703,1,332040000,332040000,2551,850,1701,850,0,1,852,876474
168,850,5800,5500,31900000,2,6806,1703,1,332040000,332040000,2551,850,1701,850,0,1,852,880282
168,850,5800,5500,31900000,2,6806,1703,1,332040000,332040000,2551,850,1701,850,0,1,852,879801
168,1250,5800,5500,31900000,2,10006,2503,1,368200000,368200000,3751,1250,2501,1250,0,1,1252,10419128
168,1250,5800,5500,31900000,2,10006,2503,1,368200000,368200000,3751,1250,2501,1250,0,1,1252,1136265
168,1250,5800,5500,31900000,2,10006,2503,1,368200000,368200000,3751,1250,2501,1250,0,1,1252,1145043
168,1250,5800,5500,31900000,2,10006,2503,1,368200000,368200000,3751,1250,2501,1250,0,1,1252,1071458
168,1250,5800,5500,31900000,2,10006,2503,1,368200000,368200000,3751,1250,2501,1250,0,1,1252,1144363
168,1250,5800,5500,31900000,2,10006,2503,1,368200000,368200000,3751,1250,2501,1250,0,1,1252,1143618
168,1250,5800,5500,31900000,2,10006,2503,1,368200000,368200000,3751,1250,2501,1250,0,1,1252,1141476
168,1650,5800,5500,31900000,2,13206,3303,1,404360000,404360000,4951,1650,3301,1650,0,1,1652,14094863
168,1650,5800,5500,31900000,2,13206,3303,1,404360000,404360000,4951,1650,3301,1650,0,1,1652,1401824
168,1650,5800,5500,31900000,2,13206,3303,1,404360000,404360000,4951,1650,3301,1650,0,1,1652,1405262
168,1650,5800,5500,31900000,2,13206,3303,1,404360000,404360000,4951,1650,3301,1650,0,1,1652,1404026
168,1650,5800,5500,31900000,2,13206,3303,1,404360000,404360000,4951,1650,3301,1650,0,1,1652,1404643
168,1650,5800,5500,31900000,2,13206,3303,1,404360000,404360000,4951,1650,3301,1650,0,1,1652,1406082
168,1650,5800,5500,31900000,2,13206,3303,1,404360000,404360000,4951,1650,3301,1650,0,1,1652,1405712
168,2050,5800,5500,31900000,2,16406,4103,1,440520000,440520000,6151,2050,4101,2050,0,1,2052,17687614
168,2050,5800,5500,31900000,2,16406,4103,1,440520000,440520000,6151,2050,4101,2050,0,1,2052,1708132
168,2050,5800,5500,31900000,2,16406,4103,1,440520000,440520000,6151,2050,4101,2050,0,1,2052,1708733
168,2050,5800,5500,31900000,2,16406,4103,1,440520000,440520000,6151,2050,4101,2050,0,1,2052,1707396
168,2050,5800,5500,31900000,2,16406,4103,1,440520000,440520000,6151,2050,4101,2050,0,1,2052,1705741
168,2050,5800,5500,31900000,2,16406,4103,1,440520000,440520000,6151,2050,4101,2050,0,1,2052,1694813
168,2050,5800,5500,31900000,2,16406,4103,1,440520000,440520000,6151,2050,4101,2050,0,1,2052,1696087
168,2450,5800,5500,31900000,2,19606,4903,1,476680000,476680000,7351,2450,4901,2450,0,1,2452,21643416
168,2450,5800,5500,31900000,2,19606,4903,1,476680000,476680000,7351,2450,4901,2450,0,1,2452,1964912
168,2450,5800,5500,31900000,2,19606,4903,1,476680000,476680000,7351,2450,4901,2450,0,1,2452,1966575
168,2450,5800,5500,31900000,2,19606,4903,1,476680000,476680000,7351,2450,4901,2450,0,1,2452,1967511
168,2450,5800,5500,31900000,2,19606,4903,1,476680000,476680000,7351,2450,4901,2450,0,1,2452,1963442
168,2450,5800,5500,31900000,2,19606,4903,1,476680000,476680000,7351,2450,4901,2450,0,1,2452,1952201
168,2450,5800,5500,31900000,2,19606,4903,1,476680000,476680000,7351,2450,4901,2450,0,1,2452,1949085
168,2850,5800,5500,31900000,2,22806,5703,1,512840000,512840000,8551,2850,5701,2850,0,1,2852,25618615
168,2850,5800,5500,31900000,2,22806,5703,1,512840000,512840000,8551,2850,5701,2850,0,1,2852,2260307
168,2850,5800,5500,31900000,2,22806,5703,1,512840000,512840000,8551,2850,5701,2850,0,1,2852,2262510
168,2850,5800,5500,31900000,2,22806,5703,1,512840000,512840000,8551,2850,5701,2850,0,1,2852,2261466
168,2850,5800,5500,31900000,2,22806,5703,1,512840000,512840000,8551,2850,5701,2850,0,1,2852,2258573
168,2850,5800,5500,31900000,2,22806,5703,1,512840000,512840000,8551,2850,5701,2850,0,1,2852,2235893
168,2850,5800,5500,31900000,2,22806,5703,1,512840000,512840000,8551,2850,5701,2850,0,1,2852,2237332
168,3250,5800,5500,31900000,2,26006,6503,1,549000000,549000000,9751,3250,6501,3250,0,1,3252,30114433
168,3250,5800,5500,31900000,2,26006,6503,1,549000000,549000000,9751,3250,6501,3250,0,1,3252,2548726
168,3250,5800,5500,31900000,2,26006,6503,1,549000000,549000000,9751,3250,6501,3250,0,1,3252,2549820
168,3250,5800,5500,31900000,2,26006,6503,1,549000000,549000000,9751,3250,6501,3250,0,1,3252,2550933
168,3250,5800,5500,31900000,2,26006,6503,1,549000000,549000000,9751,3250,6501,3250,0,1,3252,2542913
168,3250,5800,5500,31900000,2,26006,6503,1,549000000,549000000,9751,3250,6501,3250,0,1,3252,2516726
168,3250,5800,5500,31900000,2,26006,6503,1,549000000,549000000,9751,3250,6501,3250,0,1,3252,2515058
168,3650,5800,5500,31900000,2,29206,7303,1,585160000,585160000,10951,3650,7301,3650,0,1,3652,32036649
168,3650,5800,5500,31900000,2,29206,7303,1,585160000,585160000,10951,3650,7301,3650,0,1,3652,2811300
168,3650,5800,5500,31900000,2,29206,7303,1,585160000,585160000,10951,3650,7301,3650,0,1,3652,2815734
168,3650,5800,5500,31900000,2,29206,7303,1,585160000,585160000,10951,3650,7301,3650,0,1,3652,2818908
168,3650,5800,5500,31900000,2,29206,7303,1,585160000,585160000,10951,3650,7301,3650,0,1,3652,2817562
168,3650,5800,5500,31900000,2,29206,7303,1,585160000,585160000,10951,3650,7301,3650,0,1,3652,2767148
168,3650,5800,5500,31900000,2,29206,7303,1,585160000,585160000,10951,3650,7301,3650,0,1,3652,2765124
168,4050,5800,5500,31900000,2,32406,8103,1,621320000,621320000,12151,4050,8101,4050,0,1,4052,37940962
168,4050,5800,5500,31900000,2,32406,8103,1,621320000,621320000,12151,4050,8101,4050,0,1,4052,3122591
168,4050,5800,5500,31900000,2,32406,8103,1,621320000,621320000,12151,4050,8101,4050,0,1,4052,3133122
168,4050,5800,5500,31900000,2,32406,8103,1,621320000,621320000,12151,4050,8101,4050,0,1,4052,3131829
168,4050,5800,5500,31900000,2,32406,8103,1,621320000,621320000,12151,4050,8101,4050,0,1,4052,3130606
168,4050,5800,5500,31900000,2,32406,8103,1,621320000,621320000,12151,4050,8101,4050,0,1,4052,3061354
168,4050,5800,5500,31900000,2,32406,8103,1,621320000,621320000,12151,4050,8101,4050,0,1,4052,3046674
168,4450,5800,5500,31900000,2,35606,8903,1,657480000,657480000,13351,4450,8901,4450,0,1,4452,41852934
168,4450,5800,5500,31900000,2,35606,8903,1,657480000,657480000,13351,4450,8901,4450,0,1,4452,3407206
168,4450,5800,5500,31900000,2,35606,8903,1,657480000,657480000,13351,4450,8901,4450,0,1,4452,3417462
168,4450,5800,5500,31900000,2,35606,8903,1,657480000,657480000,13351,4450,8901,4450,0,1,4452,3418975
168,4450,5800,5500,31900000,2,35606,8903,1,657480000,657480000,13351,4450,8901,4450,0,1,4452,3415379
168,4450,5800,5500,31900000,2,35606,8903,1,657480000,657480000,13351,4450,8901,4450,0,1,4452,3349369
168,4450,5800,5500,31900000,2,35606,8903,1,657480000,657480000,13351,4450,8901,4450,0,1,4452,3347085
168,4850,5800,5500,31900000,2,38806,9703,1,693640000,693640000,14551,4850,9701,4850,0,1,4852,45434036
168,4850,5800,5500,31900000,2,38806,9703,1,693640000,693640000,14551,4850,9701,4850,0,1,4852,3700018
168,4850,5800,5500,31900000,2,38806,9703,1,693640000,693640000,14551,4850,9701,4850,0,1,4852,3694740
168,4850,5800,5500,31900000,2,38806,9703,1,693640000,693640000,14551,4850,9701,4850,0,1,4852,3701412
168,4850,5800,5500,31900000,2,38806,9703,1,693640000,693640000,14551,4850,9701,4850,0,1,4852,3679478
168,4850,5800,5500,31900000,2,38806,9703,1,693640000,693640000,14551,4850,9701,4850,0,1,4852,3605092
168,4850,5800,5500,31900000,2,38806,9703,1,693640000,693640000,14551,4850,9701,4850,0,1,4852,3599497
168,5250,5800,5500,31900000,2,42006,10503,1,729800000,729800000,15751,5250,10501,5250,0,1,5252,50097393
168,5250,5800,5500,31900000,2,42006,10503,1,729800000,729800000,15751,5250,10501,5250,0,1,5252,3968061
168,5250,5800,5500,31900000,2,42006,10503,1,729800000,729800000,15751,5250,10501,5250,0,1,5252,3962958
168,5250,5800,5500,31900000,2,42006,10503,1,729800000,729800000,15751,5250,10501,5250,0,1,5252,3969561
168,5250,5800,5500,31900000,2,42006,10503,1,729800000,729800000,15751,5250,10501,5250,0,1,5252,3964130
168,5250,5800,5500,31900000,2,42006,10503,1,729800000,729800000,15751,5250,10501,5250,0,1,5252,3866263
168,5250,5800,5500,31900000,2,42006,10503,1,729800000,729800000,15751,5250,10501,5250,0,1,5252,3863635
168,5650,5800,5500,31900000,2,45206,11303,1,765960000,765960000,16951,5650,11301,5650,0,1,5652,52373277
168,5650,5800,5500,31900000,2,45206,11303,1,765960000,765960000,16951,5650,11301,5650,0,1,5652,4241089
168,5650,5800,5500,31900000,2,45206,11303,1,765960000,765960000,16951,5650,11301,5650,0,1,5652,4239884
168,5650,5800,5500,31900000,2,45206,11303,1,765960000,765960000,16951,5650,11301,5650,0,1,5652,4246717
168,5650,5800,5500,31900000,2,45206,11303,1,765960000,765960000,16951,5650,11301,5650,0,1,5652,4245124
168,5650,5800,5500,31900000,2,45206,11303,1,765960000,765960000,16951,5650,11301,5650,0,1,5652,4137649
168,5650,5800,5500,31900000,2,45206,11303,1,765960000,765960000,16951,5650,11301,5650,0,1,5652,4132128
168,6050,5800,5500,31900000,2,48406,12103,1,802120000,802120000,18151,6050,12101,6050,0,1,6052,57065835
168,6050,5800,5500,31900000,2,48406,12103,1,802120000,802120000,18151,6050,12101,6050,0,1,6052,4535655
168,6050,5800,5500,31900000,2,48406,12103,1,802120000,802120000,18151,6050,12101,6050,0,1,6052,4529846
168,6050,5800,5500,31900000,2,48406,12103,1,802120000,802120000,18151,6050,12101,6050,0,1,6052,4537318
168,6050,5800,5500,31900000,2,48406,12103,1,802120000,802120000,18151,6050,12101,6050,0,1,6052,4522684
168,6050,5800,5500,31900000,2,48406,12103,1,802120000,802120000,18151,6050,12101,6050,0,1,6052,4430565
168,6050,5800,5500,31900000,2,48406,12103,1,802120000,802120000,18151,6050,12101,6050,0,1,6052,4424109
168,6450,5800,5500,31900000,2,51606,12903,1,838280000,838280000,19351,6450,12901,6450,0,1,6452,60059044
168,6450,5800,5500,31900000,2,51606,12903,1,838280000,838280000,19351,6450,12901,6450,0,1,6452,4765341
168,6450,5800,5500,31900000,2,51606,12903,1,838280000,838280000,19351,6450,12901,6450,0,1,6452,4772555
168,6450,5800,5500,31900000,2,51606,12903,1,838280000,838280000,19351,6450,12901,6450,0,1,6452,4774057
168,6450,5800,5500,31900000,2,51606,12903,1,838280000,838280000,19351,6450,12901,6450,0,1,6452,4771063
168,6450,5800,5500,31900000,2,51606,12903,1,838280000,838280000,19351,6450,12901,6450,0,1,6452,4652114
168,6450,5800,5500,31900000,2,51606,12903,1,838280000,838280000,19351,6450,12901,6450,0,1,6452,4623624
168,6850,5800,5500,31900000,2,54806,13703,1,874440000,874440000,20551,6850,13701,6850,0,1,6852,64922121
168,6850,5800,5500,31900000,2,54806,13703,1,874440000,874440000,20551,6850,13701,6850,0,1,6852,5060834
168,6850,5800,5500,31900000,2,54806,13703,1,874440000,874440000,20551,6850,13701,6850,0,1,6852,5032775
168,6850,5800,5500,31900000,2,54806,13703,1,874440000,874440000,20551,6850,13701,6850,0,1,6852,5066372
168,6850,5800,5500,31900000,2,54806,13703,1,874440000,874440000,20551,6850,13701,6850,0,1,6852,5062535
168,6850,5800,5500,31900000,2,54806,13703,1,874440000,874440000,20551,6850,13701,6850,0,1,6852,4934975
168,6850,5800,5500,31900000,2,54806,13703,1,874440000,874440000,20551,6850,13701,6850,0,1,6852,4924106
168,50,5800,5100,29580000,2,406,103,1,241000000,241000000,151,50,101,50,0,1,52,325672
168,50,5800,5100,29580000,2,406,103,1,241000000,241000000,151,50,101,50,0,1,52,268360
168,50,5800,5100,29580000,2,406,103,1,241000000,241000000,151,50,101,50,0,1,52,267922
168,50,5800,5100,29580000,2,406,103,1,241000000,241000000,151,50,101,50,0,1,52,225889
168,50,5800,5100,29580000,2,406,103,1,241000000,241000000,151,50,101,50,0,1,52,262289
168,50,5800,5100,29580000,2,406,103,1,241000000,241000000,151,50,101,50,0,1,52,310976
168,50,5800,5100,29580000,2,406,103,1,241000000,241000000,151,50,101,50,0,1,52,311356
168,450,5800,5100,29580000,2,3606,903,1,275880000,275880000,1351,450,901,450,0,1,452,3053165
168,450,5800,5100,29580000,2,3606,903,1,275880000,275880000,1351,450,901,450,0,1,452,591046
168,450,5800,5100,29580000,2,3606,903,1,275880000,275880000,1351,450,901,450,0,1,452,592109
168,450,5800,5100,29580000,2,3606,903,1,275880000,275880000,1351,450,901,450,0,1,452,582701
168,450,5800,5100,29580000,2,3606,903,1,275880000,275880000,1351,450,901,450,0,1,452,589802
168,450,5800,5100,29580000,2,3606,903,1,275880000,275880000,1351,450,901,450,0,1,452,595759
168,450,5800,5100,29580000,2,3606,903,1,275880000,275880000,1351,450,901,450,0,1,452,596850
168,850,5800,5100,29580000,2,6806,1703,1,310760000,310760000,2551,850,1701,850,0,1,852,6176490
168,850,5800,5100,29580000,2,6806,1703,1,310760000,310760000,2551,850,1701,850,0,1,852,819492
168,850,5800,5100,29580000,2,6806,1703,1,310760000,310760000,2551,850,1701,850,0,1,852,816537
168,850,5800,5100,29580000,2,6806,1703,1,310760000,310760000,2551,850,1701,850,0,1,852,819146
168,850,5800,5100,29580000,2,6806,1703,1,310760000,310760000,2551,850,1701,850,0,1,852,818058
168,850,5800,5100,29580000,2,6806,1703,1,310760000,310760000,2551,850,1701,850,0,1,852,822099
168,850,5800,5100,29580000,2,6806,1703,1,310760000,310760000,2551,850,1701,850,0,1,852,821613
168,1250,5800,5100,29580000,2,10006,2503,1,345640000,345640000,3751,1250,2501,1250,0,1,1252,9445888
168,1250,5800,5100,29580000,2,10006,2503,1,345640000,345640000,3751,1250,2501,1250,0,1,1252,1072914
168,1250,5800,5100,29580000,2,10006,2503,1,345640000,345640000,3751,1250,2501,1250,0,1,1252,1074513
168,1250,5800,5100,29580000,2,10006,2503,1,345640000,345640000,3751,1250,2501,1250,0,1,1252,1073913
168,1250,5800,5100,29580000,2,10006,2503,1,345640000,345640000,3751,1250,2501,1250,0,1,1252,1074944
168,1250,5800,5100,29580000,2,10006,2503,1,345640000,345640000,3751,1250,2501,1250,0,1,1252,1071170
168,1250,5800,5100,29580000,2,10006,2503,1,345640000,345640000,3751,1250,2501,1250,0,1,1252,1068661
168,1650,5800,5100,29580000,2,13206,3303,1,380520000,380520000,4951,1650,3301,1650,0,1,1652,13412569
168,1650,5800,5100,29580000,2,13206,3303,1,380520000,380520000,4951,1650,3301,1650,0,1,1652,1297855
168,1650,5800,5100,29580000,2,13206,3303,1,380520000,380520000,4951,1650,3301,1650,0,1,1652,1302092
168,1650,5800,5100,29580000,2,13206,3303,1,380520000,380520000,4951,1650,3301,1650,0,1,1652,1303390
168,1650,5800,5100,29580000,2,13206,3303,1,380520000,380520000,4951,1650,3301,1650,0,1,1652,1300464
168,1650,5800,5100,29580000,2,13206,3303,1,380520000,380520000,4951,1650,3301,1650,0,1,1652,1306340
168,1650,5800,5100,29580000,2,13206,3303,1,380520000,380520000,4951,1650,3301,1650,0,1,1652,1305756
168,2050,5800,5100,29580000,2,16406,4103,1,415400000,415400000,6151,2050,4101,2050,0,1,2052,16530683
168,2050,5800,5100,29580000,2,16406,4103,1,415400000,415400000,6151,2050,4101,2050,0,1,2052,1623445
168,2050,5800,5100,29580000,2,16406,4103,1,415400000,415400000,6151,2050,4101,2050,0,1,2052,1619285
168,2050,5800,5100,29580000,2,16406,4103,1,415400000,415400000,6151,2050,4101,2050,0,1,2052,1624047
168,2050,5800,5100,29580000,2,16406,4103,1,415400000,415400000,6151,2050,4101,2050,0,1,2052,1613809
168,2050,5800,5100,29580000,2,16406,4103,1,415400000,415400000,6151,2050,4101,2050,0,1,2052,1622699
168,2050,5800,5100,29580000,2,16406,4103,1,415400000,415400000,6151,2050,4101,2050,0,1,2052,1620255
168,2450,5800,5100,29580000,2,19606,4903,1,450280000,450280000,7351,2450,4901,2450,0,1,2452,20349908
168,2450,5800,5100,29580000,2,19606,4903,1,450280000,450280000,7351,2450,4901,2450,0,1,2452,1824591
168,2450,5800,5100,29580000,2,19606,4903,1,450280000,450280000,7351,2450,4901,2450,0,1,2452,1826049
168,2450,5800,5100,29580000,2,19606,4903,1,450280000,450280000,7351,2450,4901,2450,0,1,2452,1827735
168,2450,5800,5100,29580000,2,19606,4903,1,450280000,450280000,7351,2450,4901,2450,0,1,2452,1826788
168,2450,5800,5100,29580000,2,19606,4903,1,450280000,450280000,7351,2450,4901,2450,0,1,2452,1817665
168,2450,5800,5100,29580000,2,19606,4903,1,450280000,450280000,7351,2450,4901,2450,0,1,2452,1814671
168,2850,5800,5100,29580000,2,22806,5703,1,485160000,485160000,8551,2850,5701,2850,0,1,2852,23601780
168,2850,5800,5100,29580000,2,22806,5703,1,485160000,485160000,8551,2850,5701,2850,0,1,2852,2120992
168,2850,5800,5100,29580000,2,22806,5703,1,485160000,485160000,8551,2850,5701,2850,0,1,2852,2128110
168,2850,5800,5100,29580000,2,22806,5703,1,485160000,485160000,8551,2850,5701,2850,0,1,2852,2126031
168,2850,5800,5100,29580000,2,22806,5703,1,485160000,485160000,8551,2850,5701,2850,0,1,2852,2127065
168,2850,5800,5100,29580000,2,22806,5703,1,485160000,485160000,8551,2850,5701,2850,0,1,2852,2091428
168,2850,5800,5100,29580000,2,22806,5703,1,485160000,485160000,8551,2850,5701,2850,0,1,2852,2084612
168,3250,5800,5100,29580000,2,26006,6503,1,520040000,520040000,9751,3250,6501,3250,0,1,3252,26869026
168,3250,5800,5100,29580000,2,26006,6503,1,520040000,520040000,9751,3250,6501,3250,0,1,3252,2352803
168,3250,5800,5100,29580000,2,26006,6503,1,520040000,520040000,9751,3250,6501,3250,0,1,3252,2351927
168,3250,5800,5100,29580000,2,26006,6503,1,520040000,520040000,9751,3250,6501,3250,0,1,3252,2353867
168,3250,5800,5100,29580000,2,26006,6503,1,520040000,520040000,9751,3250,6501,3250,0,1,3252,2350286
168,3250,5800,5100,29580000,2,26006,6503,1,520040000,520040000,9751,3250,6501,3250,0,1,3252,2320923
168,3250,5800,5100,29580000,2,26006,6503,1,520040000,520040000,9751,3250,6501,3250,0,1,3252,2316891
168,3650,5800,5100,29580000,2,29206,7303,1,554920000,554920000,10951,3650,7301,3650,0,1,3652,29997888
168,3650,5800,5100,29580000,2,29206,7303,1,554920000,554920000,10951,3650,7301,3650,0,1,3652,2657516
168,3650,5800,5100,29580000,2,29206,7303,1,554920000,554920000,10951,3650,7301,3650,0,1,3652,2653561
168,3650,5800,5100,29580000,2,29206,7303,1,554920000,554920000,10951,3650,7301,3650,0,1,3652,2659990
168,3650,5800,5100,29580000,2,29206,7303,1,554920000,554920000,10951,3650,7301,3650,0,1,3652,2649750
168,3650,5800,5100,29580000,2,29206,7303,1,554920000,554920000,10951,3650,7301,3650,0,1,3652,2611369
168,3650,5800,5100,29580000,2,29206,7303,1,554920000,554920000,10951,3650,7301,3650,0,1,3652,2608865
168,4050,5800,5100,29580000,2,32406,8103,1,589800000,589800000,12151,4050,8101,4050,0,1,4052,34307612
168,4050,5800,5100,29580000,2,32406,8103,1,589800000,589800000,12151,4050,8101,4050,0,1,4052,2938673
168,4050,5800,5100,29580000,2,32406,8103,1,589800000,589800000,12151,4050,8101,4050,0,1,4052,2934072
168,4050,5800,5100,29580000,2,32406,8103,1,589800000,589800000,12151,4050,8101,4050,0,1,4052,2939913
168,4050,5800,5100,29580000,2,32406,8103,1,589800000,589800000,12151,4050,8101,4050,0,1,4052,2924362
168,4050,5800,5100,29580000,2,32406,8103,1,589800000,589800000,12151,4050,8101,4050,0,1,4052,2862815
168,4050,5800,5100,29580000,2,32406,8103,1,589800000,589800000,12151,4050,8101,4050,0,1,4052,2871875
168,4450,5800,5100,29580000,2,35606,8903,1,624680000,624680000,13351,4450,8901,4450,0,1,4452,38048953
168,4450,5800,5100,29580000,2,35606,8903,1,624680000,624680000,13351,4450,8901,4450,0,1,4452,3167556
168,4450,5800,5100,29580000,2,35606,8903,1,624680000,624680000,13351,4450,8901,4450,0,1,4452,3182408
168,4450,5800,5100,29580000,2,35606,8903,1,624680000,624680000,13351,4450,8901,4450,0,1,4452,3188308
168,4450,5800,5100,29580000,2,35606,8903,1,624680000,624680000,13351,4450,8901,4450,0,1,4452,3176351
168,4450,5800,5100,29580000,2,35606,8903,1,624680000,624680000,13351,4450,8901,4450,0,1,4452,3118815
168,4450,5800,5100,29580000,2,35606,8903,1,624680000,624680000,13351,4450,8901,4450,0,1,4452,3116111
168,4850,5800,5100,29580000,2,38806,9703,1,659560000,659560000,14551,4850,9701,4850,0,1,4852,41876205
168,4850,5800,5100,29580000,2,38806,9703,1,659560000,659560000,14551,4850,9701,4850,0,1,4852,3445588
168,4850,5800,5100,29580000,2,38806,9703,1,659560000,659560000,14551,4850,9701,4850,0,1,4852,3438057
168,4850,5800,5100,29580000,2,38806,9703,1,659560000,659560000,14551,4850,9701,4850,0,1,4852,3446992
168,4850,5800,5100,29580000,2,38806,9703,1,659560000,659560000,14551,4850,9701,4850,0,1,4852,3431330
168,4850,5800,5100,29580000,2,38806,9703,1,659560000,659560000,14551,4850,9701,4850,0,1,4852,3360235
168,4850,5800,5100,29580000,2,38806,9703,1,659560000,659560000,14551,4850,9701,4850,0,1,4852,3363119
168,5250,5800,5100,29580000,2,42006,10503,1,694440000,694440000,15751,5250,10501,5250,0,1,5252,47217938
168,5250,5800,5100,29580000,2,42006,10503,1,694440000,694440000,15751,5250,10501,5250,0,1,5252,3679181
168,5250,5800,5100,29580000,2,42006,10503,1,694440000,694440000,15751,5250,10501,5250,0,1,5252,3676542
168,5250,5800,5100,29580000,2,42006,10503,1,694440000,694440000,15751,5250,10501,5250,0,1,5252,3680680
168,5250,5800,5100,29580000,2,42006,10503,1,694440000,694440000,15751,5250,10501,5250,0,1,5252,3674395
168,5250,5800,5100,29580000,2,42006,10503,1,694440000,694440000,15751,5250,10501,5250,0,1,5252,3579488
168,5250,5800,5100,29580000,2,42006,10503,1,694440000,694440000,15751,5250,10501,5250,0,1,5252,3555374
168,5650,5800,5100,29580000,2,45206,11303,1,729320000,729320000,16951,5650,11301,5650,0,1,5652,48029434
168,5650,5800,5100,29580000,2,45206,11303,1,729320000,729320000,16951,5650,11301,5650,0,1,5652,3943004
168,5650,5800,5100,29580000,2,45206,11303,1,729320000,729320000,16951,5650,11301,5650,0,1,5652,3944292
168,5650,5800,5100,29580000,2,45206,11303,1,729320000,729320000,16951,5650,11301,5650,0,1,5652,3945872
168,5650,5800,5100,29580000,2,45206,11303,1,729320000,729320000,16951,5650,11301,5650,0,1,5652,3940766
168,5650,5800,5100,29580000,2,45206,11303,1,729320000,729320000,16951,5650,11301,5650,0,1,5652,3841123
168,5650,5800,5100,29580000,2,45206,11303,1,729320000,729320000,16951,5650,11301,5650,0,1,5652,3818960
168,6050,5800,5100,29580000,2,48406,12103,1,764200000,764200000,18151,6050,12101,6050,0,1,6052,53668043
168,6050,5800,5100,29580000,2,48406,12103,1,764200000,764200000,18151,6050,12101,6050,0,1,6052,4196128
168,6050,5800,5100,29580000,2,48406,12103,1,764200000,764200000,18151,6050,12101,6050,0,1,6052,4200662
168,6050,5800,5100,29580000,2,48406,12103,1,764200000,764200000,18151,6050,12101,6050,0,1,6052,4198955
168,6050,5800,5100,29580000,2,48406,12103,1,764200000,764200000,18151,6050,12101,6050,0,1,6052,4202367
168,6050,5800,5100,29580000,2,48406,12103,1,764200000,764200000,18151,6050,12101,6050,0,1,6052,4106941
168,6050,5800,5100,29580000,2,48406,12103,1,764200000,764200000,18151,6050,12101,6050,0,1,6052,4094242
168,6450,5800,5100,29580000,2,51606,12903,1,799080000,799080000,19351,6450,12901,6450,0,1,6452,60378438
168,6450,5800,5100,29580000,2,51606,12903,1,799080000,799080000,19351,6450,12901,6450,0,1,6452,4451579
168,6450,5800,5100,29580000,2,51606,12903,1,799080000,799080000,19351,6450,12901,6450,0,1,6452,4449164
168,6450,5800,5100,29580000,2,51606,12903,1,799080000,799080000,19351,6450,12901,6450,0,1,6452,4454506
168,6450,5800,5100,29580000,2,51606,12903,1,799080000,799080000,19351,6450,12901,6450,0,1,6452,4456272
168,6450,5800,5100,29580000,2,51606,12903,1,799080000,799080000,19351,6450,12901,6450,0,1,6452,4347232
168,6450,5800,5100,29580000,2,51606,12903,1,799080000,799080000,19351,6450,12901,6450,0,1,6452,4324883
168,6850,5800,5100,29580000,2,54806,13703,1,833960000,833960000,20551,6850,13701,6850,0,1,6852,59670452
168,6850,5800,5100,29580000,2,54806,13703,1,833960000,833960000,20551,6850,13701,6850,0,1,6852,4707563
168,6850,5800,5100,29580000,2,54806,13703,1,833960000,833960000,20551,6850,13701,6850,0,1,6852,4719570
168,6850,5800,5100,29580000,2,54806,13703,1,833960000,833960000,20551,6850,13701,6850,0,1,6852,4716211
168,6850,5800,5100,29580000,2,54806,13703,1,833960000,833960000,20551,6850,13701,6850,0,1,6852,4717704
168,6850,5800,5100,29580000,2,54806,13703,1,833960000,833960000,20551,6850,13701,6850,0,1,6852,4602647
168,6850,5800,5100,29580000,2,54806,13703,1,833960000,833960000,20551,6850,13701,6850,0,1,6852,4571826
168,50,5800,4700,27260000,2,406,103,1,222280000,222280000,151,50,101,50,0,1,52,294317
168,50,5800,4700,27260000,2,406,103,1,222280000,222280000,151,50,101,50,0,1,52,258832
168,50,5800,4700,27260000,2,406,103,1,222280000,222280000,151,50,101,50,0,1,52,235107
168,50,5800,4700,27260000,2,406,103,1,222280000,222280000,151,50,101,50,0,1,52,258053
168,50,5800,4700,27260000,2,406,103,1,222280000,222280000,151,50,101,50,0,1,52,255123
168,50,5800,4700,27260000,2,406,103,1,222280000,222280000,151,50,101,50,0,1,52,280557
168,50,5800,4700,27260000,2,406,103,1,222280000,222280000,151,50,101,50,0,1,52,280934
168,450,5800,4700,27260000,2,3606,903,1,255880000,255880000,1351,450,901,450,0,1,452,2780284
168,450,5800,4700,27260000,2,3606,903,1,255880000,255880000,1351,450,901,450,0,1,452,535303
168,450,5800,4700,27260000,2,3606,903,1,255880000,255880000,1351,450,901,450,0,1,452,512652
168,450,5800,4700,27260000,2,3606,903,1,255880000,255880000,1351,450,901,450,0,1,452,533034
168,450,5800,4700,27260000,2,3606,903,1,255880000,255880000,1351,450,901,450,0,1,452,534277
168,450,5800,4700,27260000,2,3606,903,1,255880000,255880000,1351,450,901,450,0,1,452,546952
168,450,5800,4700,27260000,2,3606,903,1,255880000,255880000,1351,450,901,450,0,1,452,546528
168,850,5800,4700,27260000,2,6806,1703,1,289480000,289480000,2551,850,1701,850,0,1,852,5632014
168,850,5800,4700,27260000,2,6806,1703,1,289480000,289480000,2551,850,1701,850,0,1,852,739492
168,850,5800,4700,27260000,2,6806,1703,1,289480000,289480000,2551,850,1701,850,0,1,852,742454
168,850,5800,4700,27260000,2,6806,1703,1,289480000,289480000,2551,850,1701,850,0,1,852,743197
168,850,5800,4700,27260000,2,6806,1703,1,289480000,289480000,2551,850,1701,850,0,1,852,741363
168,850,5800,4700,27260000,2,6806,1703,1,289480000,289480000,2551,850,1701,850,0,1,852,755405
168,850,5800,4700,27260000,2,6806,1703,1,289480000,289480000,2551,850,1701,850,0,1,852,754931
168,1250,5800,4700,27260000,2,10006,2503,1,323080000,323080000,3751,1250,2501,1250,0,1,1252,9055430
168,1250,5800,4700,27260000,2,10006,2503,1,323080000,323080000,3751,1250,2501,1250,0,1,1252,970467
168,1250,5800,4700,27260000,2,10006,2503,1,323080000,323080000,3751,1250,2501,1250,0,1,1252,957235
168,1250,5800,4700,27260000,2,10006,2503,1,323080000,323080000,3751,1250,2501,1250,0,1,1252,903102
168,1250,5800,4700,27260000,2,10006,2503,1,323080000,323080000,3751,1250,2501,1250,0,1,1252,969010
168,1250,5800,4700,27260000,2,10006,2503,1,323080000,323080000,3751,1250,2501,1250,0,1,1252,978925
168,1250,5800,4700,27260000,2,10006,2503,1,323080000,323080000,3751,1250,2501,1250,0,1,1252,978392
168,1650,5800,4700,27260000,2,13206,3303,1,356680000,356680000,4951,1650,3301,1650,0,1,1652,11895390
168,1650,5800,4700,27260000,2,13206,3303,1,356680000,356680000,4951,1650,3301,1650,0,1,1652,1200468
168,1650,5800,4700,27260000,2,13206,3303,1,356680000,356680000,4951,1650,3301,1650,0,1,1652,1205257
168,1650,5800,4700,27260000,2,13206,3303,1,356680000,356680000,4951,1650,3301,1650,0,1,1652,1206362
168,1650,5800,4700,27260000,2,13206,3303,1,356680000,356680000,4951,1650,3301,1650,0,1,1652,1203846
168,1650,5800,4700,27260000,2,13206,3303,1,356680000,356680000,4951,1650,3301,1650,0,1,1652,1210983
168,1650,5800,4700,27260000,2,13206,3303,1,356680000,356680000,4951,1650,3301,1650,0,1,1652,1210397
168,2050,5800,4700,27260000,2,16406,4103,1,390280000,390280000,6151,2050,4101,2050,0,1,2052,15564264
168,2050,5800,4700,27260000,2,16406,4103,1,390280000,390280000,6151,2050,4101,2050,0,1,2052,1497255
168,2050,5800,4700,27260000,2,16406,4103,1,390280000,390280000,6151,2050,4101,2050,0,1,2052,1493272
168,2050,5800,4700,27260000,2,16406,4103,1,390280000,390280000,6151,2050,4101,2050,0,1,2052,1496369
168,2050,5800,4700,27260000,2,16406,4103,1,390280000,390280000,6151,2050,4101,2050,0,1,2052,1498138
168,2050,5800,4700,27260000,2,16406,4103,1,390280000,390280000,6151,2050,4101,2050,0,1,2052,1495433
168,2050,5800,4700,27260000,2,16406,4103,1,390280000,390280000,6151,2050,4101,2050,0,1,2052,1491024
168,2450,5800,4700,27260000,2,19606,4903,1,423880000,423880000,7351,2450,4901,2450,0,1,2452,18559502
168,2450,5800,4700,27260000,2,19606,4903,1,423880000,423880000,7351,2450,4901,2450,0,1,2452,1696046
168,2450,5800,4700,27260000,2,19606,4903,1,423880000,423880000,7351,2450,4901,2450,0,1,2452,1692818
168,2450,5800,4700,27260000,2,19606,4903,1,423880000,423880000,7351,2450,4901,2450,0,1,2452,1697406
168,2450,5800,4700,27260000,2,19606,4903,1,423880000,423880000,7351,2450,4901,2450,0,1,2452,1695247
168,2450,5800,4700,27260000,2,19606,4903,1,423880000,423880000,7351,2450,4901,2450,0,1,2452,1697876
168,2450,5800,4700,27260000,2,19606,4903,1,423880000,423880000,7351,2450,4901,2450,0,1,2452,1696509
168,2850,5800,4700,27260000,2,22806,5703,1,457480000,457480000,8551,2850,5701,2850,0,1,2852,21123785
168,2850,5800,4700,27260000,2,22806,5703,1,457480000,457480000,8551,2850,5701,2850,0,1,2852,1971798
168,2850,5800,4700,27260000,2,22806,5703,1,457480000,457480000,8551,2850,5701,2850,0,1,2852,1978824
168,2850,5800,4700,27260000,2,22806,5703,1,457480000,457480000,8551,2850,5701,2850,0,1,2852,1980013
168,2850,5800,4700,27260000,2,22806,5703,1,457480000,457480000,8551,2850,5701,2850,0,1,2852,1977377
168,2850,5800,4700,27260000,2,22806,5703,1,457480000,457480000,8551,2850,5701,2850,0,1,2852,1973797
168,2850,5800,4700,27260000,2,22806,5703,1,457480000,457480000,8551,2850,5701,2850,0,1,2852,1967746
168,3250,5800,4700,27260000,2,26006,6503,1,491080000,491080000,9751,3250,6501,3250,0,1,3252,24783464
168,3250,5800,4700,27260000,2,26006,6503,1,491080000,491080000,9751,3250,6501,3250,0,1,3252,2174158
168,3250,5800,4700,27260000,2,26006,6503,1,491080000,491080000,9751,3250,6501,3250,0,1,3252,2175813
168,3250,5800,4700,27260000,2,26006,6503,1,491080000,491080000,9751,3250,6501,3250,0,1,3252,2177761
168,3250,5800,4700,27260000,2,26006,6503,1,491080000,491080000,9751,3250,6501,3250,0,1,3252,2176664
168,3250,5800,4700,27260000,2,26006,6503,1,491080000,491080000,9751,3250,6501,3250,0,1,3252,2148952
168,3250,5800,4700,27260000,2,26006,6503,1,491080000,491080000,9751,3250,6501,3250,0,1,3252,2145414
168,3650,5800,4700,27260000,2,29206,7303,1,524680000,524680000,10951,3650,7301,3650,0,1,3652,27704784
168,3650,5800,4700,27260000,2,29206,7303,1,524680000,524680000,10951,3650,7301,3650,0,1,3652,2452052
168,3650,5800,4700,27260000,2,29206,7303,1,524680000,524680000,10951,3650,7301,3650,0,1,3652,2463747
168,3650,5800,4700,27260000,2,29206,7303,1,524680000,524680000,10951,3650,7301,3650,0,1,3652,2466173
168,3650,5800,4700,27260000,2,29206,7303,1,524680000,524680000,10951,3650,7301,3650,0,1,3652,2458316
168,3650,5800,4700,27260000,2,29206,7303,1,524680000,524680000,10951,3650,7301,3650,0,1,3652,2422606
168,3650,5800,4700,27260000,2,29206,7303,1,524680000,524680000,10951,3650,7301,3650,0,1,3652,2427534
168,4050,5800,4700,27260000,2,32406,8103,1,558280000,558280000,12151,4050,8101,4050,0,1,4052,31349624
168,4050,5800,4700,27260000,2,32406,8103,1,558280000,558280000,12151,4050,8101,4050,0,1,4052,2718507
168,4050,5800,4700,27260000,2,32406,8103,1,558280000,558280000,12151,4050,8101,4050,0,1,4052,2725574
168,4050,5800,4700,27260000,2,32406,8103,1,558280000,558280000,12151,4050,8101,4050,0,1,4052,2728171
168,4050,5800,4700,27260000,2,32406,8103,1,558280000,558280000,12151,4050,8101,4050,0,1,4052,2722960
168,4050,5800,4700,27260000,2,32406,8103,1,558280000,558280000,12151,4050,8101,4050,0,1,4052,2664009
168,4050,5800,4700,27260000,2,32406,8103,1,558280000,558280000,12151,4050,8101,4050,0,1,4052,2655162
168,4450,5800,4700,27260000,2,35606,8903,1,591880000,591880000,13351,4450,8901,4450,0,1,4452,35515259
168,4450,5800,4700,27260000,2,35606,8903,1,591880000,591880000,13351,4450,8901,4450,0,1,4452,2912118
168,4450,5800,4700,27260000,2,35606,8903,1,591880000,591880000,13351,4450,8901,4450,0,1,4452,2915479
168,4450,5800,4700,27260000,2,35606,8903,1,591880000,591880000,13351,4450,8901,4450,0,1,4452,2916977
168,4450,5800,4700,27260000,2,35606,8903,1,591880000,591880000,13351,4450,8901,4450,0,1,4452,2913547
168,4450,5800,4700,27260000,2,35606,8903,1,591880000,591880000,13351,4450,8901,4450,0,1,4452,2860784
168,4450,5800,4700,27260000,2,35606,8903,1,591880000,591880000,13351,4450,8901,4450,0,1,4452,2856396
168,4850,5800,4700,27260000,2,38806,9703,1,625480000,625480000,14551,4850,9701,4850,0,1,4852,37762440
168,4850,5800,4700,27260000,2,38806,9703,1,625480000,625480000,14551,4850,9701,4850,0,1,4852,3197735
168,4850,5800,4700,27260000,2,38806,9703,1,625480000,625480000,14551,4850,9701,4850,0,1,4852,3213399
168,4850,5800,4700,27260000,2,38806,9703,1,625480000,625480000,14551,4850,9701,4850,0,1,4852,3214806
168,4850,5800,4700,27260000,2,38806,9703,1,625480000,625480000,14551,4850,9701,4850,0,1,4852,3208583
168,4850,5800,4700,27260000,2,38806,9703,1,625480000,625480000,14551,4850,9701,4850,0,1,4852,3134145
168,4850,5800,4700,27260000,2,38806,9703,1,625480000,625480000,14551,4850,9701,4850,0,1,4852,3124672
168,5250,5800,4700,27260000,2,42006,10503,1,659080000,659080000,15751,5250,10501,5250,0,1,5252,41947791
168,5250,5800,4700,27260000,2,42006,10503,1,659080000,659080000,15751,5250,10501,5250,0,1,5252,3453321
168,5250,5800,4700,27260000,2,42006,10503,1,659080000,659080000,15751,5250,10501,5250,0,1,5252,3460487
168,5250,5800,4700,27260000,2,42006,10503,1,659080000,659080000,15751,5250,10501,5250,0,1,5252,3449097
168,5250,5800,4700,27260000,2,42006,10503,1,659080000,659080000,15751,5250,10501,5250,0,1,5252,3457435
168,5250,5800,4700,27260000,2,42006,10503,1,659080000,659080000,15751,5250,10501,5250,0,1,5252,3373144
168,5250,5800,4700,27260000,2,42006,10503,1,659080000,659080000,15751,5250,10501,5250,0,1,5252,3360188
168,5650,5800,4700,27260000,2,45206,11303,1,692680000,692680000,16951,5650,11301,5650,0,1,5652,45657178
168,5650,5800,4700,27260000,2,45206,11303,1,692680000,692680000,16951,5650,11301,5650,0,1,5652,3676539
168,5650,5800,4700,27260000,2,45206,11303,1,692680000,692680000,16951,5650,11301,5650,0,1,5652,3690418
168,5650,5800,4700,27260000,2,45206,11303,1,692680000,692680000,16951,5650,11301,5650,0,1,5652,3693582
168,5650,5800,4700,27260000,2,45206,11303,1,692680000,692680000,16951,5650,11301,5650,0,1,5652,3684018
168,5650,5800,4700,27260000,2,45206,11303,1,692680000,692680000,16951,5650,11301,5650,0,1,5652,3595311
168,5650,5800,4700,27260000,2,45206,11303,1,692680000,692680000,16951,5650,11301,5650,0,1,5652,3582171
168,6050,5800,4700,27260000,2,48406,12103,1,726280000,726280000,18151,6050,12101,6050,0,1,6052,47894465
168,6050,5800,4700,27260000,2,48406,12103,1,726280000,726280000,18151,6050,12101,6050,0,1,6052,3904521
168,6050,5800,4700,27260000,2,48406,12103,1,726280000,726280000,18151,6050,12101,6050,0,1,6052,3915133
168,6050,5800,4700,27260000,2,48406,12103,1,726280000,726280000,18151,6050,12101,6050,0,1,6052,3919101
168,6050,5800,4700,27260000,2,48406,12103,1,726280000,726280000,18151,6050,12101,6050,0,1,6052,3913230
168,6050,5800,4700,27260000,2,48406,12103,1,726280000,726280000,18151,6050,12101,6050,0,1,6052,3818494
168,6050,5800,4700,27260000,2,48406,12103,1,726280000,726280000,18151,6050,12101,6050,0,1,6052,3802651
168,6450,5800,4700,27260000,2,51606,12903,1,759880000,759880000,19351,6450,12901,6450,0,1,6452,52004912
168,6450,5800,4700,27260000,2,51606,12903,1,759880000,759880000,19351,6450,12901,6450,0,1,6452,4163261
168,6450,5800,4700,27260000,2,51606,12903,1,759880000,759880000,19351,6450,12901,6450,0,1,6452,4170113
168,6450,5800,4700,27260000,2,51606,12903,1,759880000,759880000,19351,6450,12901,6450,0,1,6452,4171849
168,6450,5800,4700,27260000,2,51606,12903,1,759880000,759880000,19351,6450,12901,6450,0,1,6452,4164599
168,6450,5800,4700,27260000,2,51606,12903,1,759880000,759880000,19351,6450,12901,6450,0,1,6452,4058778
168,6450,5800,4700,27260000,2,51606,12903,1,759880000,759880000,19351,6450,12901,6450,0,1,6452,4043658
168,6850,5800,4700,27260000,2,54806,13703,1,793480000,793480000,20551,6850,13701,6850,0,1,6852,54770639
168,6850,5800,4700,27260000,2,54806,13703,1,793480000,793480000,20551,6850,13701,6850,0,1,6852,4390156
168,6850,5800,4700,27260000,2,54806,13703,1,793480000,793480000,20551,6850,13701,6850,0,1,6852,4396986
168,6850,5800,4700,27260000,2,54806,13703,1,793480000,793480000,20551,6850,13701,6850,0,1,6852,4398820
168,6850,5800,4700,27260000,2,54806,13703,1,793480000,793480000,20551,6850,13701,6850,0,1,6852,4392521
168,6850,5800,4700,27260000,2,54806,13703,1,793480000,793480000,20551,6850,13701,6850,0,1,6852,4274812
168,6850,5800,4700,27260000,2,54806,13703,1,793480000,793480000,20551,6850,13701,6850,0,1,6852,4250841
168,50,5800,4300,24940000,2,406,103,1,203560000,203560000,151,50,101,50,0,1,52,269152
168,50,5800,4300,24940000,2,406,103,1,203560000,203560000,151,50,101,50,0,1,52,263452
168,50,5800,4300,24940000,2,406,103,1,203560000,203560000,151,50,101,50,0,1,52,263964
168,50,5800,4300,24940000,2,406,103,1,203560000,203560000,151,50,101,50,0,1,52,264575
168,50,5800,4300,24940000,2,406,103,1,203560000,203560000,151,50,101,50,0,1,52,262318
168,50,5800,4300,24940000,2,406,103,1,203560000,203560000,151,50,101,50,0,1,52,268957
168,50,5800,4300,24940000,2,406,103,1,203560000,203560000,151,50,101,50,0,1,52,268440
168,450,5800,4300,24940000,2,3606,903,1,235880000,235880000,1351,450,901,450,0,1,452,2582282
168,450,5800,4300,24940000,2,3606,903,1,235880000,235880000,1351,450,901,450,0,1,452,496069
168,450,5800,4300,24940000,2,3606,903,1,235880000,235880000,1351,450,901,450,0,1,452,502779
168,450,5800,4300,24940000,2,3606,903,1,235880000,235880000,1351,450,901,450,0,1,452,503047
168,450,5800,4300,24940000,2,3606,903,1,235880000,235880000,1351,450,901,450,0,1,452,502363
168,450,5800,4300,24940000,2,3606,903,1,235880000,235880000,1351,450,901,450,0,1,452,505986
168,450,5800,4300,24940000,2,3606,903,1,235880000,235880000,1351,450,901,450,0,1,452,505554
168,850,5800,4300,24940000,2,6806,1703,1,268200000,268200000,2551,850,1701,850,0,1,852,5173077
168,850,5800,4300,24940000,2,6806,1703,1,268200000,268200000,2551,850,1701,850,0,1,852,679729
168,850,5800,4300,24940000,2,6806,1703,1,268200000,268200000,2551,850,1701,850,0,1,852,678042
168,850,5800,4300,24940000,2,6806,1703,1,268200000,268200000,2551,850,1701,850,0,1,852,676073
168,850,5800,4300,24940000,2,6806,1703,1,268200000,268200000,2551,850,1701,850,0,1,852,679019
168,850,5800,4300,24940000,2,6806,1703,1,268200000,268200000,2551,850,1701,850,0,1,852,693239
168,850,5800,4300,24940000,2,6806,1703,1,268200000,268200000,2551,850,1701,850,0,1,852,692740
168,1250,5800,4300,24940000,2,10006,2503,1,300520000,300520000,3751,1250,2501,1250,0,1,1252,8183770
168,1250,5800,4300,24940000,2,10006,2503,1,300520000,300520000,3751,1250,2501,1250,0,1,1252,914415
168,1250,5800,4300,24940000,2,10006,2503,1,300520000,300520000,3751,1250,2501,1250,0,1,1252,913753
168,1250,5800,4300,24940000,2,10006,2503,1,300520000,300520000,3751,1250,2501,1250,0,1,1252,915012
168,1250,5800,4300,24940000,2,10006,2503,1,300520000,300520000,3751,1250,2501,1250,0,1,1252,912308
168,1250,5800,4300,24940000,2,10006,2503,1,300520000,300520000,3751,1250,2501,1250,0,1,1252,918232
168,1250,5800,4300,24940000,2,10006,2503,1,300520000,300520000,3751,1250,2501,1250,0,1,1252,917702
168,1650,5800,4300,24940000,2,13206,3303,1,332840000,332840000,4951,1650,3301,1650,0,1,1652,11245954
168,1650,5800,4300,24940000,2,13206,3303,1,332840000,332840000,4951,1650,3301,1650,0,1,1652,1097231
168,1650,5800,4300,24940000,2,13206,3303,1,332840000,332840000,4951,1650,3301,1650,0,1,1652,1099673
168,1650,5800,4300,24940000,2,13206,3303,1,332840000,332840000,4951,1650,3301,1650,0,1,1652,1098608
168,1650,5800,4300,24940000,2,13206,3303,1,332840000,332840000,4951,1650,3301,1650,0,1,1652,1092195
168,1650,5800,4300,24940000,2,13206,3303,1,332840000,332840000,4951,1650,3301,1650,0,1,1652,1112744
168,1650,5800,4300,24940000,2,13206,3303,1,332840000,332840000,4951,1650,3301,1650,0,1,1652,1112164
168,2050,5800,4300,24940000,2,16406,4103,1,365160000,365160000,6151,2050,4101,2050,0,1,2052,13887805
168,2050,5800,4300,24940000,2,16406,4103,1,365160000,365160000,6151,2050,4101,2050,0,1,2052,1328628
168,2050,5800,4300,24940000,2,16406,4103,1,365160000,365160000,6151,2050,4101,2050,0,1,2052,1326252
168,2050,5800,4300,24940000,2,16406,4103,1,365160000,365160000,6151,2050,4101,2050,0,1,2052,1329335
168,2050,5800,4300,24940000,2,16406,4103,1,365160000,365160000,6151,2050,4101,2050,0,1,2052,1327929
168,2050,5800,4300,24940000,2,16406,4103,1,365160000,365160000,6151,2050,4101,2050,0,1,2052,1333042
168,2050,5800,4300,24940000,2,16406,4103,1,365160000,365160000,6151,2050,4101,2050,0,1,2052,1332391
168,2450,5800,4300,24940000,2,19606,4903,1,397480000,397480000,7351,2450,4901,2450,0,1,2452,16751042
168,2450,5800,4300,24940000,2,19606,4903,1,397480000,397480000,7351,2450,4901,2450,0,1,2452,1598558
168,2450,5800,4300,24940000,2,19606,4903,1,397480000,397480000,7351,2450,4901,2450,0,1,2452,1600067
168,2450,5800,4300,24940000,2,19606,4903,1,397480000,397480000,7351,2450,4901,2450,0,1,2452,1589016
168,2450,5800,4300,24940000,2,19606,4903,1,397480000,397480000,7351,2450,4901,2450,0,1,2452,1599393
168,2450,5800,4300,24940000,2,19606,4903,1,397480000,397480000,7351,2450,4901,2450,0,1,2452,1597731
168,2450,5800,4300,24940000,2,19606,4903,1,397480000,397480000,7351,2450,4901,2450,0,1,2452,1594760
168,2850,5800,4300,24940000,2,22806,5703,1,429800000,429800000,8551,2850,5701,2850,0,1,2852,19933151
168,2850,5800,4300,24940000,2,22806,5703,1,429800000,429800000,8551,2850,5701,2850,0,1,2852,1781051
168,2850,5800,4300,24940000,2,22806,5703,1,429800000,429800000,8551,2850,5701,2850,0,1,2852,1783368
168,2850,5800,4300,24940000,2,22806,5703,1,429800000,429800000,8551,2850,5701,2850,0,1,2852,1785028
168,2850,5800,4300,24940000,2,22806,5703,1,429800000,429800000,8551,2850,5701,2850,0,1,2852,1784274
168,2850,5800,4300,24940000,2,22806,5703,1,429800000,429800000,8551,2850,5701,2850,0,1,2852,1782482
168,2850,5800,4300,24940000,2,22806,5703,1,429800000,429800000,8551,2850,5701,2850,0,1,2852,1776550
168,3250,5800,4300,24940000,2,26006,6503,1,462120000,462120000,9751,3250,6501,3250,0,1,3252,22988212
168,3250,5800,4300,24940000,2,26006,6503,1,462120000,462120000,9751,3250,6501,3250,0,1,3252,2038189
168,3250,5800,4300,24940000,2,26006,6503,1,462120000,462120000,9751,3250,6501,3250,0,1,3252,2044911
168,3250,5800,4300,24940000,2,26006,6503,1,462120000,462120000,9751,3250,6501,3250,0,1,3252,2045972
168,3250,5800,4300,24940000,2,26006,6503,1,462120000,462120000,9751,3250,6501,3250,0,1,3252,2041924
168,3250,5800,4300,24940000,2,26006,6503,1,462120000,462120000,9751,3250,6501,3250,0,1,3252,2037244
168,3250,5800,4300,24940000,2,26006,6503,1,462120000,462120000,9751,3250,6501,3250,0,1,3252,2029964
168,3650,5800,4300,24940000,2,29206,7303,1,494440000,494440000,10951,3650,7301,3650,0,1,3652,25911892
168,3650,5800,4300,24940000,2,29206,7303,1,494440000,494440000,10951,3650,7301,3650,0,1,3652,2221466
168,3650,5800,4300,24940000,2,29206,7303,1,494440000,494440000,10951,3650,7301,3650,0,1,3652,2223413
168,3650,5800,4300,24940000,2,29206,7303,1,494440000,494440000,10951,3650,7301,3650,0,1,3652,2224557
168,3650,5800,4300,24940000,2,29206,7303,1,494440000,494440000,10951,3650,7301,3650,0,1,3652,2219805
168,3650,5800,4300,24940000,2,29206,7303,1,494440000,494440000,10951,3650,7301,3650,0,1,3652,2196414
168,3650,5800,4300,24940000,2,29206,7303,1,494440000,494440000,10951,3650,7301,3650,0,1,3652,2192521
168,4050,5800,4300,24940000,2,32406,8103,1,526760000,526760000,12151,4050,8101,4050,0,1,4052,28902156
168,4050,5800,4300,24940000,2,32406,8103,1,526760000,526760000,12151,4050,8101,4050,0,1,4052,2474963
168,4050,5800,4300,24940000,2,32406,8103,1,526760000,526760000,12151,4050,8101,4050,0,1,4052,2481038
168,4050,5800,4300,24940000,2,32406,8103,1,526760000,526760000,12151,4050,8101,4050,0,1,4052,2483542
168,4050,5800,4300,24940000,2,32406,8103,1,526760000,526760000,12151,4050,8101,4050,0,1,4052,2477049
168,4050,5800,4300,24940000,2,32406,8103,1,526760000,526760000,12151,4050,8101,4050,0,1,4052,2440144
168,4050,5800,4300,24940000,2,32406,8103,1,526760000,526760000,12151,4050,8101,4050,0,1,4052,2442546
168,4450,5800,4300,24940000,2,35606,8903,1,559080000,559080000,13351,4450,8901,4450,0,1,4452,31394365
168,4450,5800,4300,24940000,2,35606,8903,1,559080000,559080000,13351,4450,8901,4450,0,1,4452,2718918
168,4450,5800,4300,24940000,2,35606,8903,1,559080000,559080000,13351,4450,8901,4450,0,1,4452,2724418
168,4450,5800,4300,24940000,2,35606,8903,1,559080000,559080000,13351,4450,8901,4450,0,1,4452,2725894
168,4450,5800,4300,24940000,2,35606,8903,1,559080000,559080000,13351,4450,8901,4450,0,1,4452,2717012
168,4450,5800,4300,24940000,2,35606,8903,1,559080000,559080000,13351,4450,8901,4450,0,1,4452,2662833
168,4450,5800,4300,24940000,2,35606,8903,1,559080000,559080000,13351,4450,8901,4450,0,1,4452,2653097
168,4850,5800,4300,24940000,2,38806,9703,1,591400000,591400000,14551,4850,9701,4850,0,1,4852,34768149
168,4850,5800,4300,24940000,2,38806,9703,1,591400000,591400000,14551,4850,9701,4850,0,1,4852,2933900
168,4850,5800,4300,24940000,2,38806,9703,1,591400000,591400000,14551,4850,9701,4850,0,1,4852,2924870
168,4850,5800,4300,24940000,2,38806,9703,1,591400000,591400000,14551,4850,9701,4850,0,1,4852,2935897
168,4850,5800,4300,24940000,2,38806,9703,1,591400000,591400000,14551,4850,9701,4850,0,1,4852,2937540
168,4850,5800,4300,24940000,2,38806,9703,1,591400000,591400000,14551,4850,9701,4850,0,1,4852,2880938
168,4850,5800,4300,24940000,2,38806,9703,1,591400000,591400000,14551,4850,9701,4850,0,1,4852,2874137
168,5250,5800,4300,24940000,2,42006,10503,1,623720000,623720000,15751,5250,10501,5250,0,1,5252,38611218
168,5250,5800,4300,24940000,2,42006,10503,1,623720000,623720000,15751,5250,10501,5250,0,1,5252,3132821
168,5250,5800,4300,24940000,2,42006,10503,1,623720000,623720000,15751,5250,10501,5250,0,1,5252,3135620
168,5250,5800,4300,24940000,2,42006,10503,1,623720000,623720000,15751,5250,10501,5250,0,1,5252,3137165
168,5250,5800,4300,24940000,2,42006,10503,1,623720000,623720000,15751,5250,10501,5250,0,1,5252,3130412
168,5250,5800,4300,24940000,2,42006,10503,1,623720000,623720000,15751,5250,10501,5250,0,1,5252,3072645
168,5250,5800,4300,24940000,2,42006,10503,1,623720000,623720000,15751,5250,10501,5250,0,1,5252,3075189
168,5650,5800,4300,24940000,2,45206,11303,1,656040000,656040000,16951,5650,11301,5650,0,1,5652,43123114
168,5650,5800,4300,24940000,2,45206,11303,1,656040000,656040000,16951,5650,11301,5650,0,1,5652,3366682
168,5650,5800,4300,24940000,2,45206,11303,1,656040000,656040000,16951,5650,11301,5650,0,1,5652,3369574
168,5650,5800,4300,24940000,2,45206,11303,1,656040000,656040000,16951,5650,11301,5650,0,1,5652,3371132
168,5650,5800,4300,24940000,2,45206,11303,1,656040000,656040000,16951,5650,11301,5650,0,1,5652,3363973
168,5650,5800,4300,24940000,2,45206,11303,1,656040000,656040000,16951,5650,11301,5650,0,1,5652,3307617
168,5650,5800,4300,24940000,2,45206,11303,1,656040000,656040000,16951,5650,11301,5650,0,1,5652,3302191
168,6050,5800,4300,24940000,2,48406,12103,1,688360000,688360000,18151,6050,12101,6050,0,1,6052,44128283
168,6050,5800,4300,24940000,2,48406,12103,1,688360000,688360000,18151,6050,12101,6050,0,1,6052,3607336
168,6050,5800,4300,24940000,2,48406,12103,1,688360000,688360000,18151,6050,12101,6050,0,1,6052,3617772
168,6050,5800,4300,24940000,2,48406,12103,1,688360000,688360000,18151,6050,12101,6050,0,1,6052,3621220
168,6050,5800,4300,24940000,2,48406,12103,1,688360000,688360000,18151,6050,12101,6050,0,1,6052,3615405
168,6050,5800,4300,24940000,2,48406,12103,1,688360000,688360000,18151,6050,12101,6050,0,1,6052,3524470
168,6050,5800,4300,24940000,2,48406,12103,1,688360000,688360000,18151,6050,12101,6050,0,1,6052,3493282
168,6450,5800,4300,24940000,2,51606,12903,1,720680000,720680000,19351,6450,12901,6450,0,1,6452,46616045
168,6450,5800,4300,24940000,2,51606,12903,1,720680000,720680000,19351,6450,12901,6450,0,1,6452,3819302
168,6450,5800,4300,24940000,2,51606,12903,1,720680000,720680000,19351,6450,12901,6450,0,1,6452,3826974
168,6450,5800,4300,24940000,2,51606,12903,1,720680000,720680000,19351,6450,12901,6450,0,1,6452,3828901
168,6450,5800,4300,24940000,2,51606,12903,1,720680000,720680000,19351,6450,12901,6450,0,1,6452,3824480
168,6450,5800,4300,24940000,2,51606,12903,1,720680000,720680000,19351,6450,12901,6450,0,1,6452,3725018
168,6450,5800,4300,24940000,2,51606,12903,1,720680000,720680000,19351,6450,12901,6450,0,1,6452,3715786
168,6850,5800,4300,24940000,2,54806,13703,1,753000000,753000000,20551,6850,13701,6850,0,1,6852,50125486
168,6850,5800,4300,24940000,2,54806,13703,1,753000000,753000000,20551,6850,13701,6850,0,1,6852,4040254
168,6850,5800,4300,24940000,2,54806,13703,1,753000000,753000000,20551,6850,13701,6850,0,1,6852,4043815
168,6850,5800,4300,24940000,2,54806,13703,1,753000000,753000000,20551,6850,13701,6850,0,1,6852,4033483
168,6850,5800,4300,24940000,2,54806,13703,1,753000000,753000000,20551,6850,13701,6850,0,1,6852,4041967
168,6850,5800,4300,24940000,2,54806,13703,1,753000000,753000000,20551,6850,13701,6850,0,1,6852,3942627
168,6850,5800,4300,24940000,2,54806,13703,1,753000000,753000000,20551,6850,13701,6850,0,1,6852,3934036
168,50,5800,3900,22620000,2,406,103,1,184840000,184840000,151,50,101,50,0,1,52,235026
168,50,5800,3900,22620000,2,406,103,1,184840000,184840000,151,50,101,50,0,1,52,210306
168,50,5800,3900,22620000,2,406,103,1,184840000,184840000,151,50,101,50,0,1,52,214344
168,50,5800,3900,22620000,2,406,103,1,184840000,184840000,151,50,101,50,0,1,52,190282
168,50,5800,3900,22620000,2,406,103,1,184840000,184840000,151,50,101,50,0,1,52,215490
168,50,5800,3900,22620000,2,406,103,1,184840000,184840000,151,50,101,50,0,1,52,243257
168,50,5800,3900,22620000,2,406,103,1,184840000,184840000,151,50,101,50,0,1,52,242882
168,450,5800,3900,22620000,2,3606,903,1,215880000,215880000,1351,450,901,450,0,1,452,2169519
168,450,5800,3900,22620000,2,3606,903,1,215880000,215880000,1351,450,901,450,0,1,452,417332
168,450,5800,3900,22620000,2,3606,903,1,215880000,215880000,1351,450,901,450,0,1,452,416328
168,450,5800,3900,22620000,2,3606,903,1,215880000,215880000,1351,450,901,450,0,1,452,418649
168,450,5800,3900,22620000,2,3606,903,1,215880000,215880000,1351,450,901,450,0,1,452,418170
168,450,5800,3900,22620000,2,3606,903,1,215880000,215880000,1351,450,901,450,0,1,452,432342
168,450,5800,3900,22620000,2,3606,903,1,215880000,215880000,1351,450,901,450,0,1,452,431915
168,850,5800,3900,22620000,2,6806,1703,1,246920000,246920000,2551,850,1701,850,0,1,852,4709236
168,850,5800,3900,22620000,2,6806,1703,1,246920000,246920000,2551,850,1701,850,0,1,852,621839
168,850,5800,3900,22620000,2,6806,1703,1,246920000,246920000,2551,850,1701,850,0,1,852,623895
168,850,5800,3900,22620000,2,6806,1703,1,246920000,246920000,2551,850,1701,850,0,1,852,624960
168,850,5800,3900,22620000,2,6806,1703,1,246920000,246920000,2551,850,1701,850,0,1,852,625616
168,850,5800,3900,22620000,2,6806,1703,1,246920000,246920000,2551,850,1701,850,0,1,852,634413
168,850,5800,3900,22620000,2,6806,1703,1,246920000,246920000,2551,850,1701,850,0,1,852,633936
168,1250,5800,3900,22620000,2,10006,2503,1,277960000,277960000,3751,1250,2501,1250,0,1,1252,7094843
168,1250,5800,3900,22620000,2,10006,2503,1,277960000,277960000,3751,1250,2501,1250,0,1,1252,824841
168,1250,5800,3900,22620000,2,10006,2503,1,277960000,277960000,3751,1250,2501,1250,0,1,1252,828473
168,1250,5800,3900,22620000,2,10006,2503,1,277960000,277960000,3751,1250,2501,1250,0,1,1252,827565
168,1250,5800,3900,22620000,2,10006,2503,1,277960000,277960000,3751,1250,2501,1250,0,1,1252,826293
168,1250,5800,3900,22620000,2,10006,2503,1,277960000,277960000,3751,1250,2501,1250,0,1,1252,834896
168,1250,5800,3900,22620000,2,10006,2503,1,277960000,277960000,3751,1250,2501,1250,0,1,1252,834368
168,1650,5800,3900,22620000,2,13206,3303,1,309000000,309000000,4951,1650,3301,1650,0,1,1652,9637842
168,1650,5800,3900,22620000,2,13206,3303,1,309000000,309000000,4951,1650,3301,1650,0,1,1652,1037343
168,1650,5800,3900,22620000,2,13206,3303,1,309000000,309000000,4951,1650,3301,1650,0,1,1652,1032069
168,1650,5800,3900,22620000,2,13206,3303,1,309000000,309000000,4951,1650,3301,1650,0,1,1652,1035722
168,1650,5800,3900,22620000,2,13206,3303,1,309000000,309000000,4951,1650,3301,1650,0,1,1652,1028424
168,1650,5800,3900,22620000,2,13206,3303,1,309000000,309000000,4951,1650,3301,1650,0,1,1652,1053171
168,1650,5800,3900,22620000,2,13206,3303,1,309000000,309000000,4951,1650,3301,1650,0,1,1652,1052569
168,2050,5800,3900,22620000,2,16406,4103,1,340040000,340040000,6151,2050,4101,2050,0,1,2052,12681958
168,2050,5800,3900,22620000,2,16406,4103,1,340040000,340040000,6151,2050,4101,2050,0,1,2052,1214119
168,2050,5800,3900,22620000,2,16406,4103,1,340040000,340040000,6151,2050,4101,2050,0,1,2052,1215567
168,2050,5800,3900,22620000,2,16406,4103,1,340040000,340040000,6151,2050,4101,2050,0,1,2052,1217359
168,2050,5800,3900,22620000,2,16406,4103,1,340040000,340040000,6151,2050,4101,2050,0,1,2052,1211080
168,2050,5800,3900,22620000,2,16406,4103,1,340040000,340040000,6151,2050,4101,2050,0,1,2052,1224078
168,2050,5800,3900,22620000,2,16406,4103,1,340040000,340040000,6151,2050,4101,2050,0,1,2052,1223347
168,2450,5800,3900,22620000,2,19606,4903,1,371080000,371080000,7351,2450,4901,2450,0,1,2452,15151187
168,2450,5800,3900,22620000,2,19606,4903,1,371080000,371080000,7351,2450,4901,2450,0,1,2452,1410950
168,2450,5800,3900,22620000,2,19606,4903,1,371080000,371080000,7351,2450,4901,2450,0,1,2452,1419907
168,2450,5800,3900,22620000,2,19606,4903,1,371080000,371080000,7351,2450,4901,2450,0,1,2452,1418391
168,2450,5800,3900,22620000,2,19606,4903,1,371080000,371080000,7351,2450,4901,2450,0,1,2452,1417593
168,2450,5800,3900,22620000,2,19606,4903,1,371080000,371080000,7351,2450,4901,2450,0,1,2452,1422930
168,2450,5800,3900,22620000,2,19606,4903,1,371080000,371080000,7351,2450,4901,2450,0,1,2452,1422242
168,2850,5800,3900,22620000,2,22806,5703,1,402120000,402120000,8551,2850,5701,2850,0,1,2852,17964454
168,2850,5800,3900,22620000,2,22806,5703,1,402120000,402120000,8551,2850,5701,2850,0,1,2852,1650526
168,2850,5800,3900,22620000,2,22806,5703,1,402120000,402120000,8551,2850,5701,2850,0,1,2852,1653625
168,2850,5800,3900,22620000,2,22806,5703,1,402120000,402120000,8551,2850,5701,2850,0,1,2852,1654969
168,2850,5800,3900,22620000,2,22806,5703,1,402120000,402120000,8551,2850,5701,2850,0,1,2852,1648790
168,2850,5800,3900,22620000,2,22806,5703,1,402120000,402120000,8551,2850,5701,2850,0,1,2852,1657286
168,2850,5800,3900,22620000,2,22806,5703,1,402120000,402120000,8551,2850,5701,2850,0,1,2852,1656534
168,3250,5800,3900,22620000,2,26006,6503,1,433160000,433160000,9751,3250,6501,3250,0,1,3252,19648512
168,3250,5800,3900,22620000,2,26006,6503,1,433160000,433160000,9751,3250,6501,3250,0,1,3252,1819246
168,3250,5800,3900,22620000,2,26006,6503,1,433160000,433160000,9751,3250,6501,3250,0,1,3252,1820096
168,3250,5800,3900,22620000,2,26006,6503,1,433160000,433160000,9751,3250,6501,3250,0,1,3252,1821197
168,3250,5800,3900,22620000,2,26006,6503,1,433160000,433160000,9751,3250,6501,3250,0,1,3252,1817681
168,3250,5800,3900,22620000,2,26006,6503,1,433160000,433160000,9751,3250,6501,3250,0,1,3252,1813920
168,3250,5800,3900,22620000,2,26006,6503,1,433160000,433160000,9751,3250,6501,3250,0,1,3252,1812015
168,3650,5800,3900,22620000,2,29206,7303,1,464200000,464200000,10951,3650,7301,3650,0,1,3652,22828428
168,3650,5800,3900,22620000,2,29206,7303,1,464200000,464200000,10951,3650,7301,3650,0,1,3652,2064174
168,3650,5800,3900,22620000,2,29206,7303,1,464200000,464200000,10951,3650,7301,3650,0,1,3652,2070428
168,3650,5800,3900,22620000,2,29206,7303,1,464200000,464200000,10951,3650,7301,3650,0,1,3652,2071605
168,3650,5800,3900,22620000,2,29206,7303,1,464200000,464200000,10951,3650,7301,3650,0,1,3652,2065915
168,3650,5800,3900,22620000,2,29206,7303,1,464200000,464200000,10951,3650,7301,3650,0,1,3652,2043071
168,3650,5800,3900,22620000,2,29206,7303,1,464200000,464200000,10951,3650,7301,3650,0,1,3652,2020188
168,4050,5800,3900,22620000,2,32406,8103,1,495240000,495240000,12151,4050,8101,4050,0,1,4052,25490463
168,4050,5800,3900,22620000,2,32406,8103,1,495240000,495240000,12151,4050,8101,4050,0,1,4052,2223608
168,4050,5800,3900,22620000,2,32406,8103,1,495240000,495240000,12151,4050,8101,4050,0,1,4052,2224823
168,4050,5800,3900,22620000,2,32406,8103,1,495240000,495240000,12151,4050,8101,4050,0,1,4052,2226074
168,4050,5800,3900,22620000,2,32406,8103,1,495240000,495240000,12151,4050,8101,4050,0,1,4052,2221236
168,4050,5800,3900,22620000,2,32406,8103,1,495240000,495240000,12151,4050,8101,4050,0,1,4052,2200682
168,4050,5800,3900,22620000,2,32406,8103,1,495240000,495240000,12151,4050,8101,4050,0,1,4052,2197026
168,4450,5800,3900,22620000,2,35606,8903,1,526280000,526280000,13351,4450,8901,4450,0,1,4452,27575605
168,4450,5800,3900,22620000,2,35606,8903,1,526280000,526280000,13351,4450,8901,4450,0,1,4452,2482606
168,4450,5800,3900,22620000,2,35606,8903,1,526280000,526280000,13351,4450,8901,4450,0,1,4452,2483780
168,4450,5800,3900,22620000,2,35606,8903,1,526280000,526280000,13351,4450,8901,4450,0,1,4452,2486154
168,4450,5800,3900,22620000,2,35606,8903,1,526280000,526280000,13351,4450,8901,4450,0,1,4452,2475823
168,4450,5800,3900,22620000,2,35606,8903,1,526280000,526280000,13351,4450,8901,4450,0,1,4452,2439657
168,4450,5800,3900,22620000,2,35606,8903,1,526280000,526280000,13351,4450,8901,4450,0,1,4452,2422848
168,4850,5800,3900,22620000,2,38806,9703,1,557320000,557320000,14551,4850,9701,4850,0,1,4852,31180422
168,4850,5800,3900,22620000,2,38806,9703,1,557320000,557320000,14551,4850,9701,4850,0,1,4852,2671950
168,4850,5800,3900,22620000,2,38806,9703,1,557320000,557320000,14551,4850,9701,4850,0,1,4852,2676842
168,4850,5800,3900,22620000,2,38806,9703,1,557320000,557320000,14551,4850,9701,4850,0,1,4852,2675136
168,4850,5800,3900,22620000,2,38806,9703,1,557320000,557320000,14551,4850,9701,4850,0,1,4852,2667884
168,4850,5800,3900,22620000,2,38806,9703,1,557320000,557320000,14551,4850,9701,4850,0,1,4852,2636823
168,4850,5800,3900,22620000,2,38806,9703,1,557320000,557320000,14551,4850,9701,4850,0,1,4852,2632094
168,5250,5800,3900,22620000,2,42006,10503,1,588360000,588360000,15751,5250,10501,5250,0,1,5252,33968074
168,5250,5800,3900,22620000,2,42006,10503,1,588360000,588360000,15751,5250,10501,5250,0,1,5252,2879013
168,5250,5800,3900,22620000,2,42006,10503,1,588360000,588360000,15751,5250,10501,5250,0,1,5252,2890664
168,5250,5800,3900,22620000,2,42006,10503,1,588360000,588360000,15751,5250,10501,5250,0,1,5252,2894629
168,5250,5800,3900,22620000,2,42006,10503,1,588360000,588360000,15751,5250,10501,5250,0,1,5252,2897587
168,5250,5800,3900,22620000,2,42006,10503,1,588360000,588360000,15751,5250,10501,5250,0,1,5252,2848411
168,5250,5800,3900,22620000,2,42006,10503,1,588360000,588360000,15751,5250,10501,5250,0,1,5252,2842905
168,5650,5800,3900,22620000,2,45206,11303,1,619400000,619400000,16951,5650,11301,5650,0,1,5652,36878792
168,5650,5800,3900,22620000,2,45206,11303,1,619400000,619400000,16951,5650,11301,5650,0,1,5652,3066658
168,5650,5800,3900,22620000,2,45206,11303,1,619400000,619400000,16951,5650,11301,5650,0,1,5652,3070508
168,5650,5800,3900,22620000,2,45206,11303,1,619400000,619400000,16951,5650,11301,5650,0,1,5652,3072098
168,5650,5800,3900,22620000,2,45206,11303,1,619400000,619400000,16951,5650,11301,5650,0,1,5652,3062276
168,5650,5800,3900,22620000,2,45206,11303,1,619400000,619400000,16951,5650,11301,5650,0,1,5652,3002758
168,5650,5800,3900,22620000,2,45206,11303,1,619400000,619400000,16951,5650,11301,5650,0,1,5652,3005589
168,6050,5800,3900,22620000,2,48406,12103,1,650440000,650440000,18151,6050,12101,6050,0,1,6052,39549069
168,6050,5800,3900,22620000,2,48406,12103,1,650440000,650440000,18151,6050,12101,6050,0,1,6052,3249757
168,6050,5800,3900,22620000,2,48406,12103,1,650440000,650440000,18151,6050,12101,6050,0,1,6052,3252791
168,6050,5800,3900,22620000,2,48406,12103,1,650440000,650440000,18151,6050,12101,6050,0,1,6052,3255750
168,6050,5800,3900,22620000,2,48406,12103,1,650440000,650440000,18151,6050,12101,6050,0,1,6052,3251387
168,6050,5800,3900,22620000,2,48406,12103,1,650440000,650440000,18151,6050,12101,6050,0,1,6052,3198687
168,6050,5800,3900,22620000,2,48406,12103,1,650440000,650440000,18151,6050,12101,6050,0,1,6052,3177345
168,6450,5800,3900,22620000,2,51606,12903,1,681480000,681480000,19351,6450,12901,6450,0,1,6452,42967201
168,6450,5800,3900,22620000,2,51606,12903,1,681480000,681480000,19351,6450,12901,6450,0,1,6452,3487060
168,6450,5800,3900,22620000,2,51606,12903,1,681480000,681480000,19351,6450,12901,6450,0,1,6452,3496295
168,6450,5800,3900,22620000,2,51606,12903,1,681480000,681480000,19351,6450,12901,6450,0,1,6452,3494551
168,6450,5800,3900,22620000,2,51606,12903,1,681480000,681480000,19351,6450,12901,6450,0,1,6452,3485168
168,6450,5800,3900,22620000,2,51606,12903,1,681480000,681480000,19351,6450,12901,6450,0,1,6452,3425451
168,6450,5800,3900,22620000,2,51606,12903,1,681480000,681480000,19351,6450,12901,6450,0,1,6452,3408632
168,6850,5800,3900,22620000,2,54806,13703,1,712520000,712520000,20551,6850,13701,6850,0,1,6852,43739557
168,6850,5800,3900,22620000,2,54806,13703,1,712520000,712520000,20551,6850,13701,6850,0,1,6852,3699933
168,6850,5800,3900,22620000,2,54806,13703,1,712520000,712520000,20551,6850,13701,6850,0,1,6852,3688882
168,6850,5800,3900,22620000,2,54806,13703,1,712520000,712520000,20551,6850,13701,6850,0,1,6852,3704599
168,6850,5800,3900,22620000,2,54806,13703,1,712520000,712520000,20551,6850,13701,6850,0,1,6852,3702589
168,6850,5800,3900,22620000,2,54806,13703,1,712520000,712520000,20551,6850,13701,6850,0,1,6852,3611717
168,6850,5800,3900,22620000,2,54806,13703,1,712520000,712520000,20551,6850,13701,6850,0,1,6852,3602535
168,50,5800,3500,20300000,2,406,103,1,166120000,166120000,151,50,101,50,0,1,52,208800
168,50,5800,3500,20300000,2,406,103,1,166120000,166120000,151,50,101,50,0,1,52,193147
168,50,5800,3500,20300000,2,406,103,1,166120000,166120000,151,50,101,50,0,1,52,191905
168,50,5800,3500,20300000,2,406,103,1,166120000,166120000,151,50,101,50,0,1,52,192504
168,50,5800,3500,20300000,2,406,103,1,166120000,166120000,151,50,101,50,0,1,52,180352
168,50,5800,3500,20300000,2,406,103,1,166120000,166120000,151,50,101,50,0,1,52,221620
168,50,5800,3500,20300000,2,406,103,1,166120000,166120000,151,50,101,50,0,1,52,221998
168,450,5800,3500,20300000,2,3606,903,1,195880000,195880000,1351,450,901,450,0,1,452,1943517
168,450,5800,3500,20300000,2,3606,903,1,195880000,195880000,1351,450,901,450,0,1,452,373457
168,450,5800,3500,20300000,2,3606,903,1,195880000,195880000,1351,450,901,450,0,1,452,376555
168,450,5800,3500,20300000,2,3606,903,1,195880000,195880000,1351,450,901,450,0,1,452,376045
168,450,5800,3500,20300000,2,3606,903,1,195880000,195880000,1351,450,901,450,0,1,452,375176
168,450,5800,3500,20300000,2,3606,903,1,195880000,195880000,1351,450,901,450,0,1,452,388947
168,450,5800,3500,20300000,2,3606,903,1,195880000,195880000,1351,450,901,450,0,1,452,388515
168,850,5800,3500,20300000,2,6806,1703,1,225640000,225640000,2551,850,1701,850,0,1,852,4243392
168,850,5800,3500,20300000,2,6806,1703,1,225640000,225640000,2551,850,1701,850,0,1,852,585642
168,850,5800,3500,20300000,2,6806,1703,1,225640000,225640000,2551,850,1701,850,0,1,852,592560
168,850,5800,3500,20300000,2,6806,1703,1,225640000,225640000,2551,850,1701,850,0,1,852,591310
168,850,5800,3500,20300000,2,6806,1703,1,225640000,225640000,2551,850,1701,850,0,1,852,587924
168,850,5800,3500,20300000,2,6806,1703,1,225640000,225640000,2551,850,1701,850,0,1,852,603027
168,850,5800,3500,20300000,2,6806,1703,1,225640000,225640000,2551,850,1701,850,0,1,852,603503
168,1250,5800,3500,20300000,2,10006,2503,1,255400000,255400000,3751,1250,2501,1250,0,1,1252,6385055
168,1250,5800,3500,20300000,2,10006,2503,1,255400000,255400000,3751,1250,2501,1250,0,1,1252,738457
168,1250,5800,3500,20300000,2,10006,2503,1,255400000,255400000,3751,1250,2501,1250,0,1,1252,662139
168,1250,5800,3500,20300000,2,10006,2503,1,255400000,255400000,3751,1250,2501,1250,0,1,1252,725499
168,1250,5800,3500,20300000,2,10006,2503,1,255400000,255400000,3751,1250,2501,1250,0,1,1252,737108
168,1250,5800,3500,20300000,2,10006,2503,1,255400000,255400000,3751,1250,2501,1250,0,1,1252,762829
168,1250,5800,3500,20300000,2,10006,2503,1,255400000,255400000,3751,1250,2501,1250,0,1,1252,762296
168,1650,5800,3500,20300000,2,13206,3303,1,285160000,285160000,4951,1650,3301,1650,0,1,1652,8848280
168,1650,5800,3500,20300000,2,13206,3303,1,285160000,285160000,4951,1650,3301,1650,0,1,1652,887055
168,1650,5800,3500,20300000,2,13206,3303,1,285160000,285160000,4951,1650,3301,1650,0,1,1652,884621
168,1650,5800,3500,20300000,2,13206,3303,1,285160000,285160000,4951,1650,3301,1650,0,1,1652,890660
168,1650,5800,3500,20300000,2,13206,3303,1,285160000,285160000,4951,1650,3301,1650,0,1,1652,889072
168,1650,5800,3500,20300000,2,13206,3303,1,285160000,285160000,4951,1650,3301,1650,0,1,1652,926201
168,1650,5800,3500,20300000,2,13206,3303,1,285160000,285160000,4951,1650,3301,1650,0,1,1652,926803
168,2050,5800,3500,20300000,2,16406,4103,1,314920000,314920000,6151,2050,4101,2050,0,1,2052,11058589
168,2050,5800,3500,20300000,2,16406,4103,1,314920000,314920000,6151,2050,4101,2050,0,1,2052,1086413
168,2050,5800,3500,20300000,2,16406,4103,1,314920000,314920000,6151,2050,4101,2050,0,1,2052,1088142
168,2050,5800,3500,20300000,2,16406,4103,1,314920000,314920000,6151,2050,4101,2050,0,1,2052,1089881
168,2050,5800,3500,20300000,2,16406,4103,1,314920000,314920000,6151,2050,4101,2050,0,1,2052,1082549
168,2050,5800,3500,20300000,2,16406,4103,1,314920000,314920000,6151,2050,4101,2050,0,1,2052,1105086
168,2050,5800,3500,20300000,2,16406,4103,1,314920000,314920000,6151,2050,4101,2050,0,1,2052,1104454
168,2450,5800,3500,20300000,2,19606,4903,1,344680000,344680000,7351,2450,4901,2450,0,1,2452,13890863
168,2450,5800,3500,20300000,2,19606,4903,1,344680000,344680000,7351,2450,4901,2450,0,1,2452,1308416
168,2450,5800,3500,20300000,2,19606,4903,1,344680000,344680000,7351,2450,4901,2450,0,1,2452,1303740
168,2450,5800,3500,20300000,2,19606,4903,1,344680000,344680000,7351,2450,4901,2450,0,1,2452,1310390
168,2450,5800,3500,20300000,2,19606,4903,1,344680000,344680000,7351,2450,4901,2450,0,1,2452,1306819
168,2450,5800,3500,20300000,2,19606,4903,1,344680000,344680000,7351,2450,4901,2450,0,1,2452,1315824
168,2450,5800,3500,20300000,2,19606,4903,1,344680000,344680000,7351,2450,4901,2450,0,1,2452,1315126
168,2850,5800,3500,20300000,2,22806,5703,1,374440000,374440000,8551,2850,5701,2850,0,1,2852,16083350
168,2850,5800,3500,20300000,2,22806,5703,1,374440000,374440000,8551,2850,5701,2850,0,1,2852,1469392
168,2850,5800,3500,20300000,2,22806,5703,1,374440000,374440000,8551,2850,5701,2850,0,1,2852,1470475
168,2850,5800,3500,20300000,2,22806,5703,1,374440000,374440000,8551,2850,5701,2850,0,1,2852,1472199
168,2850,5800,3500,20300000,2,22806,5703,1,374440000,374440000,8551,2850,5701,2850,0,1,2852,1467381
168,2850,5800,3500,20300000,2,22806,5703,1,374440000,374440000,8551,2850,5701,2850,0,1,2852,1475317
168,2850,5800,3500,20300000,2,22806,5703,1,374440000,374440000,8551,2850,5701,2850,0,1,2852,1474569
168,3250,5800,3500,20300000,2,26006,6503,1,404200000,404200000,9751,3250,6501,3250,0,1,3252,17754760
168,3250,5800,3500,20300000,2,26006,6503,1,404200000,404200000,9751,3250,6501,3250,0,1,3252,1645914
168,3250,5800,3500,20300000,2,26006,6503,1,404200000,404200000,9751,3250,6501,3250,0,1,3252,1651547
168,3250,5800,3500,20300000,2,26006,6503,1,404200000,404200000,9751,3250,6501,3250,0,1,3252,1650282
168,3250,5800,3500,20300000,2,26006,6503,1,404200000,404200000,9751,3250,6501,3250,0,1,3252,1648228
168,3250,5800,3500,20300000,2,26006,6503,1,404200000,404200000,9751,3250,6501,3250,0,1,3252,1653057
168,3250,5800,3500,20300000,2,26006,6503,1,404200000,404200000,9751,3250,6501,3250,0,1,3252,1652268
168,3650,5800,3500,20300000,2,29206,7303,1,433960000,433960000,10951,3650,7301,3650,0,1,3652,20390612
168,3650,5800,3500,20300000,2,29206,7303,1,433960000,433960000,10951,3650,7301,3650,0,1,3652,1886413
168,3650,5800,3500,20300000,2,29206,7303,1,433960000,433960000,10951,3650,7301,3650,0,1,3652,1874376
168,3650,5800,3500,20300000,2,29206,7303,1,433960000,433960000,10951,3650,7301,3650,0,1,3652,1888730
168,3650,5800,3500,20300000,2,29206,7303,1,433960000,433960000,10951,3650,7301,3650,0,1,3652,1882893
168,3650,5800,3500,20300000,2,29206,7303,1,433960000,433960000,10951,3650,7301,3650,0,1,3652,1865744
168,3650,5800,3500,20300000,2,29206,7303,1,433960000,433960000,10951,3650,7301,3650,0,1,3652,1857727
168,4050,5800,3500,20300000,2,32406,8103,1,463720000,463720000,12151,4050,8101,4050,0,1,4052,23872779
168,4050,5800,3500,20300000,2,32406,8103,1,463720000,463720000,12151,4050,8101,4050,0,1,4052,2013234
168,4050,5800,3500,20300000,2,32406,8103,1,463720000,463720000,12151,4050,8101,4050,0,1,4052,2015313
168,4050,5800,3500,20300000,2,32406,8103,1,463720000,463720000,12151,4050,8101,4050,0,1,4052,2014296
168,4050,5800,3500,20300000,2,32406,8103,1,463720000,463720000,12151,4050,8101,4050,0,1,4052,2011871
168,4050,5800,3500,20300000,2,32406,8103,1,463720000,463720000,12151,4050,8101,4050,0,1,4052,1997470
168,4050,5800,3500,20300000,2,32406,8103,1,463720000,463720000,12151,4050,8101,4050,0,1,4052,1993944
168,4450,5800,3500,20300000,2,35606,8903,1,493480000,493480000,13351,4450,8901,4450,0,1,4452,25439264
168,4450,5800,3500,20300000,2,35606,8903,1,493480000,493480000,13351,4450,8901,4450,0,1,4452,2241340
168,4450,5800,3500,20300000,2,35606,8903,1,493480000,493480000,13351,4450,8901,4450,0,1,4452,2235587
168,4450,5800,3500,20300000,2,35606,8903,1,493480000,493480000,13351,4450,8901,4450,0,1,4452,2233875
168,4450,5800,3500,20300000,2,35606,8903,1,493480000,493480000,13351,4450,8901,4450,0,1,4452,2239990
168,4450,5800,3500,20300000,2,35606,8903,1,493480000,493480000,13351,4450,8901,4450,0,1,4452,2206291
168,4450,5800,3500,20300000,2,35606,8903,1,493480000,493480000,13351,4450,8901,4450,0,1,4452,2203976
168,4850,5800,3500,20300000,2,38806,9703,1,523240000,523240000,14551,4850,9701,4850,0,1,4852,27761042
168,4850,5800,3500,20300000,2,38806,9703,1,523240000,523240000,14551,4850,9701,4850,0,1,4852,2428141
168,4850,5800,3500,20300000,2,38806,9703,1,523240000,523240000,14551,4850,9701,4850,0,1,4852,2419683
168,4850,5800,3500,20300000,2,38806,9703,1,523240000,523240000,14551,4850,9701,4850,0,1,4852,2426532
168,4850,5800,3500,20300000,2,38806,9703,1,523240000,523240000,14551,4850,9701,4850,0,1,4852,2424622
168,4850,5800,3500,20300000,2,38806,9703,1,523240000,523240000,14551,4850,9701,4850,0,1,4852,2384256
168,4850,5800,3500,20300000,2,38806,9703,1,523240000,523240000,14551,4850,9701,4850,0,1,4852,2381782
168,5250,5800,3500,20300000,2,42006,10503,1,553000000,553000000,15751,5250,10501,5250,0,1,5252,29427906
168,5250,5800,3500,20300000,2,42006,10503,1,553000000,553000000,15751,5250,10501,5250,0,1,5252,2584463
168,5250,5800,3500,20300000,2,42006,10503,1,553000000,553000000,15751,5250,10501,5250,0,1,5252,2589309
168,5250,5800,3500,20300000,2,42006,10503,1,553000000,553000000,15751,5250,10501,5250,0,1,5252,2590821
168,5250,5800,3500,20300000,2,42006,10503,1,553000000,553000000,15751,5250,10501,5250,0,1,5252,2586651
168,5250,5800,3500,20300000,2,42006,10503,1,553000000,553000000,15751,5250,10501,5250,0,1,5252,2542893
168,5250,5800,3500,20300000,2,42006,10503,1,553000000,553000000,15751,5250,10501,5250,0,1,5252,2538138
168,5650,5800,3500,20300000,2,45206,11303,1,582760000,582760000,16951,5650,11301,5650,0,1,5652,32214580
168,5650,5800,3500,20300000,2,45206,11303,1,582760000,582760000,16951,5650,11301,5650,0,1,5652,2810470
168,5650,5800,3500,20300000,2,45206,11303,1,582760000,582760000,16951,5650,11301,5650,0,1,5652,2802847
168,5650,5800,3500,20300000,2,45206,11303,1,582760000,582760000,16951,5650,11301,5650,0,1,5652,2797840
168,5650,5800,3500,20300000,2,45206,11303,1,582760000,582760000,16951,5650,11301,5650,0,1,5652,2808888
168,5650,5800,3500,20300000,2,45206,11303,1,582760000,582760000,16951,5650,11301,5650,0,1,5652,2765566
168,5650,5800,3500,20300000,2,45206,11303,1,582760000,582760000,16951,5650,11301,5650,0,1,5652,2759834
168,6050,5800,3500,20300000,2,48406,12103,1,612520000,612520000,18151,6050,12101,6050,0,1,6052,34900902
168,6050,5800,3500,20300000,2,48406,12103,1,612520000,612520000,18151,6050,12101,6050,0,1,6052,2987203
168,6050,5800,3500,20300000,2,48406,12103,1,612520000,612520000,18151,6050,12101,6050,0,1,6052,2983143
168,6050,5800,3500,20300000,2,48406,12103,1,612520000,612520000,18151,6050,12101,6050,0,1,6052,2992564
168,6050,5800,3500,20300000,2,48406,12103,1,612520000,612520000,18151,6050,12101,6050,0,1,6052,2990907
168,6050,5800,3500,20300000,2,48406,12103,1,612520000,612520000,18151,6050,12101,6050,0,1,6052,2936927
168,6050,5800,3500,20300000,2,48406,12103,1,612520000,612520000,18151,6050,12101,6050,0,1,6052,2931294
168,6450,5800,3500,20300000,2,51606,12903,1,642280000,642280000,19351,6450,12901,6450,0,1,6452,36964387
168,6450,5800,3500,20300000,2,51606,12903,1,642280000,642280000,19351,6450,12901,6450,0,1,6452,3173556
168,6450,5800,3500,20300000,2,51606,12903,1,642280000,642280000,19351,6450,12901,6450,0,1,6452,3186402
168,6450,5800,3500,20300000,2,51606,12903,1,642280000,642280000,19351,6450,12901,6450,0,1,6452,3184645
168,6450,5800,3500,20300000,2,51606,12903,1,642280000,642280000,19351,6450,12901,6450,0,1,6452,3167886
168,6450,5800,3500,20300000,2,51606,12903,1,642280000,642280000,19351,6450,12901,6450,0,1,6452,3115526
168,6450,5800,3500,20300000,2,51606,12903,1,642280000,642280000,19351,6450,12901,6450,0,1,6452,3095388
168,6850,5800,3500,20300000,2,54806,13703,1,672040000,672040000,20551,6850,13701,6850,0,1,6852,41358350
168,6850,5800,3500,20300000,2,54806,13703,1,672040000,672040000,20551,6850,13701,6850,0,1,6852,3317915
168,6850,5800,3500,20300000,2,54806,13703,1,672040000,672040000,20551,6850,13701,6850,0,1,6852,3324909
168,6850,5800,3500,20300000,2,54806,13703,1,672040000,672040000,20551,6850,13701,6850,0,1,6852,3323082
168,6850,5800,3500,20300000,2,54806,13703,1,672040000,672040000,20551,6850,13701,6850,0,1,6852,3316064
168,6850,5800,3500,20300000,2,54806,13703,1,672040000,672040000,20551,6850,13701,6850,0,1,6852,3276309
168,6850,5800,3500,20300000,2,54806,13703,1,672040000,672040000,20551,6850,13701,6850,0,1,6852,3254871
168,50,5800,3100,17980000,2,406,103,1,147400000,147400000,151,50,101,50,0,1,52,181168
168,50,5800,3100,17980000,2,406,103,1,147400000,147400000,151,50,101,50,0,1,52,157934
168,50,5800,3100,17980000,2,406,103,1,147400000,147400000,151,50,101,50,0,1,52,172201
168,50,5800,3100,17980000,2,406,103,1,147400000,147400000,151,50,101,50,0,1,52,171733
168,50,5800,3100,17980000,2,406,103,1,147400000,147400000,151,50,101,50,0,1,52,169075
168,50,5800,3100,17980000,2,406,103,1,147400000,147400000,151,50,101,50,0,1,52,210119
168,50,5800,3100,17980000,2,406,103,1,147400000,147400000,151,50,101,50,0,1,52,210496
168,450,5800,3100,17980000,2,3606,903,1,175880000,175880000,1351,450,901,450,0,1,452,1799119
168,450,5800,3100,17980000,2,3606,903,1,175880000,175880000,1351,450,901,450,0,1,452,332148
168,450,5800,3100,17980000,2,3606,903,1,175880000,175880000,1351,450,901,450,0,1,452,332620
168,450,5800,3100,17980000,2,3606,903,1,175880000,175880000,1351,450,901,450,0,1,452,329635
168,450,5800,3100,17980000,2,3606,903,1,175880000,175880000,1351,450,901,450,0,1,452,331286
168,450,5800,3100,17980000,2,3606,903,1,175880000,175880000,1351,450,901,450,0,1,452,344431
168,450,5800,3100,17980000,2,3606,903,1,175880000,175880000,1351,450,901,450,0,1,452,344000
168,850,5800,3100,17980000,2,6806,1703,1,204360000,204360000,2551,850,1701,850,0,1,852,3761366
168,850,5800,3100,17980000,2,6806,1703,1,204360000,204360000,2551,850,1701,850,0,1,852,501305
168,850,5800,3100,17980000,2,6806,1703,1,204360000,204360000,2551,850,1701,850,0,1,852,500687
168,850,5800,3100,17980000,2,6806,1703,1,204360000,204360000,2551,850,1701,850,0,1,852,498970
168,850,5800,3100,17980000,2,6806,1703,1,204360000,204360000,2551,850,1701,850,0,1,852,500190
168,850,5800,3100,17980000,2,6806,1703,1,204360000,204360000,2551,850,1701,850,0,1,852,509541
168,850,5800,3100,17980000,2,6806,1703,1,204360000,204360000,2551,850,1701,850,0,1,852,508957
168,1250,5800,3100,17980000,2,10006,2503,1,232840000,232840000,3751,1250,2501,1250,0,1,1252,5569072
168,1250,5800,3100,17980000,2,10006,2503,1,232840000,232840000,3751,1250,2501,1250,0,1,1252,608546
168,1250,5800,3100,17980000,2,10006,2503,1,232840000,232840000,3751,1250,2501,1250,0,1,1252,647426
168,1250,5800,3100,17980000,2,10006,2503,1,232840000,232840000,3751,1250,2501,1250,0,1,1252,657644
168,1250,5800,3100,17980000,2,10006,2503,1,232840000,232840000,3751,1250,2501,1250,0,1,1252,656399
168,1250,5800,3100,17980000,2,10006,2503,1,232840000,232840000,3751,1250,2501,1250,0,1,1252,669088
168,1250,5800,3100,17980000,2,10006,2503,1,232840000,232840000,3751,1250,2501,1250,0,1,1252,668559
168,1650,5800,3100,17980000,2,13206,3303,1,261320000,261320000,4951,1650,3301,1650,0,1,1652,7896635
168,1650,5800,3100,17980000,2,13206,3303,1,261320000,261320000,4951,1650,3301,1650,0,1,1652,793167
168,1650,5800,3100,17980000,2,13206,3303,1,261320000,261320000,4951,1650,3301,1650,0,1,1652,793986
168,1650,5800,3100,17980000,2,13206,3303,1,261320000,261320000,4951,1650,3301,1650,0,1,1652,794737
168,1650,5800,3100,17980000,2,13206,3303,1,261320000,261320000,4951,1650,3301,1650,0,1,1652,791555
168,1650,5800,3100,17980000,2,13206,3303,1,261320000,261320000,4951,1650,3301,1650,0,1,1652,837638
168,1650,5800,3100,17980000,2,13206,3303,1,261320000,261320000,4951,1650,3301,1650,0,1,1652,839009
168,2050,5800,3100,17980000,2,16406,4103,1,289800000,289800000,6151,2050,4101,2050,0,1,2052,10050058
168,2050,5800,3100,17980000,2,16406,4103,1,289800000,289800000,6151,2050,4101,2050,0,1,2052,1001049
168,2050,5800,3100,17980000,2,16406,4103,1,289800000,289800000,6151,2050,4101,2050,0,1,2052,961652
168,2050,5800,3100,17980000,2,16406,4103,1,289800000,289800000,6151,2050,4101,2050,0,1,2052,998853
168,2050,5800,3100,17980000,2,16406,4103,1,289800000,289800000,6151,2050,4101,2050,0,1,2052,996753
168,2050,5800,3100,17980000,2,16406,4103,1,289800000,289800000,6151,2050,4101,2050,0,1,2052,1025021
168,2050,5800,3100,17980000,2,16406,4103,1,289800000,289800000,6151,2050,4101,2050,0,1,2052,1019595
168,2450,5800,3100,17980000,2,19606,4903,1,318280000,318280000,7351,2450,4901,2450,0,1,2452,11686752
168,2450,5800,3100,17980000,2,19606,4903,1,318280000,318280000,7351,2450,4901,2450,0,1,2452,1131463
168,2450,5800,3100,17980000,2,19606,4903,1,318280000,318280000,7351,2450,4901,2450,0,1,2452,1137520
168,2450,5800,3100,17980000,2,19606,4903,1,318280000,318280000,7351,2450,4901,2450,0,1,2452,1139644
168,2450,5800,3100,17980000,2,19606,4903,1,318280000,318280000,7351,2450,4901,2450,0,1,2452,1135495
168,2450,5800,3100,17980000,2,19606,4903,1,318280000,318280000,7351,2450,4901,2450,0,1,2452,1151495
168,2450,5800,3100,17980000,2,19606,4903,1,318280000,318280000,7351,2450,4901,2450,0,1,2452,1150812
168,2850,5800,3100,17980000,2,22806,5703,1,346760000,346760000,8551,2850,5701,2850,0,1,2852,14019477
168,2850,5800,3100,17980000,2,22806,5703,1,346760000,346760000,8551,2850,5701,2850,0,1,2852,1294372
168,2850,5800,3100,17980000,2,22806,5703,1,346760000,346760000,8551,2850,5701,2850,0,1,2852,1299175
168,2850,5800,3100,17980000,2,22806,5703,1,346760000,346760000,8551,2850,5701,2850,0,1,2852,1296958
168,2850,5800,3100,17980000,2,22806,5703,1,346760000,346760000,8551,2850,5701,2850,0,1,2852,1291021
168,2850,5800,3100,17980000,2,22806,5703,1,346760000,346760000,8551,2850,5701,2850,0,1,2852,1313173
168,2850,5800,3100,17980000,2,22806,5703,1,346760000,346760000,8551,2850,5701,2850,0,1,2852,1311114
168,3250,5800,3100,17980000,2,26006,6503,1,375240000,375240000,9751,3250,6501,3250,0,1,3252,15513563
168,3250,5800,3100,17980000,2,26006,6503,1,375240000,375240000,9751,3250,6501,3250,0,1,3252,1509847
168,3250,5800,3100,17980000,2,26006,6503,1,375240000,375240000,9751,3250,6501,3250,0,1,3252,1516239
168,3250,5800,3100,17980000,2,26006,6503,1,375240000,375240000,9751,3250,6501,3250,0,1,3252,1514833
168,3250,5800,3100,17980000,2,26006,6503,1,375240000,375240000,9751,3250,6501,3250,0,1,3252,1501553
168,3250,5800,3100,17980000,2,26006,6503,1,375240000,375240000,9751,3250,6501,3250,0,1,3252,1518624
168,3250,5800,3100,17980000,2,26006,6503,1,375240000,375240000,9751,3250,6501,3250,0,1,3252,1519485
168,3650,5800,3100,17980000,2,29206,7303,1,403720000,403720000,10951,3650,7301,3650,0,1,3652,17276949
168,3650,5800,3100,17980000,2,29206,7303,1,403720000,403720000,10951,3650,7301,3650,0,1,3652,1647820
168,3650,5800,3100,17980000,2,29206,7303,1,403720000,403720000,10951,3650,7301,3650,0,1,3652,1645828
168,3650,5800,3100,17980000,2,29206,7303,1,403720000,403720000,10951,3650,7301,3650,0,1,3652,1648830
168,3650,5800,3100,17980000,2,29206,7303,1,403720000,403720000,10951,3650,7301,3650,0,1,3652,1642770
168,3650,5800,3100,17980000,2,29206,7303,1,403720000,403720000,10951,3650,7301,3650,0,1,3652,1650431
168,3650,5800,3100,17980000,2,29206,7303,1,403720000,403720000,10951,3650,7301,3650,0,1,3652,1649576
168,4050,5800,3100,17980000,2,32406,8103,1,432200000,432200000,12151,4050,8101,4050,0,1,4052,19986532
168,4050,5800,3100,17980000,2,32406,8103,1,432200000,432200000,12151,4050,8101,4050,0,1,4052,1844891
168,4050,5800,3100,17980000,2,32406,8103,1,432200000,432200000,12151,4050,8101,4050,0,1,4052,1839548
168,4050,5800,3100,17980000,2,32406,8103,1,432200000,432200000,12151,4050,8101,4050,0,1,4052,1833416
168,4050,5800,3100,17980000,2,32406,8103,1,432200000,432200000,12151,4050,8101,4050,0,1,4052,1846157
168,4050,5800,3100,17980000,2,32406,8103,1,432200000,432200000,12151,4050,8101,4050,0,1,4052,1835856
168,4050,5800,3100,17980000,2,32406,8103,1,432200000,432200000,12151,4050,8101,4050,0,1,4052,1834703
168,4450,5800,3100,17980000,2,35606,8903,1,460680000,460680000,13351,4450,8901,4450,0,1,4452,21611298
168,4450,5800,3100,17980000,2,35606,8903,1,460680000,460680000,13351,4450,8901,4450,0,1,4452,1981131
168,4450,5800,3100,17980000,2,35606,8903,1,460680000,460680000,13351,4450,8901,4450,0,1,4452,1983008
168,4450,5800,3100,17980000,2,35606,8903,1,460680000,460680000,13351,4450,8901,4450,0,1,4452,1985597
168,4450,5800,3100,17980000,2,35606,8903,1,460680000,460680000,13351,4450,8901,4450,0,1,4452,1979712
168,4450,5800,3100,17980000,2,35606,8903,1,460680000,460680000,13351,4450,8901,4450,0,1,4452,1966747
168,4450,5800,3100,17980000,2,35606,8903,1,460680000,460680000,13351,4450,8901,4450,0,1,4452,1962470
168,4850,5800,3100,17980000,2,38806,9703,1,489160000,489160000,14551,4850,9701,4850,0,1,4852,24646859
168,4850,5800,3100,17980000,2,38806,9703,1,489160000,489160000,14551,4850,9701,4850,0,1,4852,2182454
168,4850,5800,3100,17980000,2,38806,9703,1,489160000,489160000,14551,4850,9701,4850,0,1,4852,2180093
168,4850,5800,3100,17980000,2,38806,9703,1,489160000,489160000,14551,4850,9701,4850,0,1,4852,2183864
168,4850,5800,3100,17980000,2,38806,9703,1,489160000,489160000,14551,4850,9701,4850,0,1,4852,2177545
168,4850,5800,3100,17980000,2,38806,9703,1,489160000,489160000,14551,4850,9701,4850,0,1,4852,2149716
168,4850,5800,3100,17980000,2,38806,9703,1,489160000,489160000,14551,4850,9701,4850,0,1,4852,2142156
168,5250,5800,3100,17980000,2,42006,10503,1,517640000,517640000,15751,5250,10501,5250,0,1,5252,26010541
168,5250,5800,3100,17980000,2,42006,10503,1,517640000,517640000,15751,5250,10501,5250,0,1,5252,2313891
168,5250,5800,3100,17980000,2,42006,10503,1,517640000,517640000,15751,5250,10501,5250,0,1,5252,2317012
168,5250,5800,3100,17980000,2,42006,10503,1,517640000,517640000,15751,5250,10501,5250,0,1,5252,2318523
168,5250,5800,3100,17980000,2,42006,10503,1,517640000,517640000,15751,5250,10501,5250,0,1,5252,2315810
168,5250,5800,3100,17980000,2,42006,10503,1,517640000,517640000,15751,5250,10501,5250,0,1,5252,2280006
168,5250,5800,3100,17980000,2,42006,10503,1,517640000,517640000,15751,5250,10501,5250,0,1,5252,2275743
168,5650,5800,3100,17980000,2,45206,11303,1,546120000,546120000,16951,5650,11301,5650,0,1,5652,28081018
168,5650,5800,3100,17980000,2,45206,11303,1,546120000,546120000,16951,5650,11301,5650,0,1,5652,2502628
168,5650,5800,3100,17980000,2,45206,11303,1,546120000,546120000,16951,5650,11301,5650,0,1,5652,2509650
168,5650,5800,3100,17980000,2,45206,11303,1,546120000,546120000,16951,5650,11301,5650,0,1,5652,2508069
168,5650,5800,3100,17980000,2,45206,11303,1,546120000,546120000,16951,5650,11301,5650,0,1,5652,2501013
168,5650,5800,3100,17980000,2,45206,11303,1,546120000,546120000,16951,5650,11301,5650,0,1,5652,2465474
168,5650,5800,3100,17980000,2,45206,11303,1,546120000,546120000,16951,5650,11301,5650,0,1,5652,2448576
168,6050,5800,3100,17980000,2,48406,12103,1,574600000,574600000,18151,6050,12101,6050,0,1,6052,30640392
168,6050,5800,3100,17980000,2,48406,12103,1,574600000,574600000,18151,6050,12101,6050,0,1,6052,2663403
168,6050,5800,3100,17980000,2,48406,12103,1,574600000,574600000,18151,6050,12101,6050,0,1,6052,2659047
168,6050,5800,3100,17980000,2,48406,12103,1,574600000,574600000,18151,6050,12101,6050,0,1,6052,2667586
168,6050,5800,3100,17980000,2,48406,12103,1,574600000,574600000,18151,6050,12101,6050,0,1,6052,2664815
168,6050,5800,3100,17980000,2,48406,12103,1,574600000,574600000,18151,6050,12101,6050,0,1,6052,2617481
168,6050,5800,3100,17980000,2,48406,12103,1,574600000,574600000,18151,6050,12101,6050,0,1,6052,2614771
168,6450,5800,3100,17980000,2,51606,12903,1,603080000,603080000,19351,6450,12901,6450,0,1,6452,32131089
168,6450,5800,3100,17980000,2,51606,12903,1,603080000,603080000,19351,6450,12901,6450,0,1,6452,2804853
168,6450,5800,3100,17980000,2,51606,12903,1,603080000,603080000,19351,6450,12901,6450,0,1,6452,2811408
168,6450,5800,3100,17980000,2,51606,12903,1,603080000,603080000,19351,6450,12901,6450,0,1,6452,2813318
168,6450,5800,3100,17980000,2,51606,12903,1,603080000,603080000,19351,6450,12901,6450,0,1,6452,2809171
168,6450,5800,3100,17980000,2,51606,12903,1,603080000,603080000,19351,6450,12901,6450,0,1,6452,2763568
168,6450,5800,3100,17980000,2,51606,12903,1,603080000,603080000,19351,6450,12901,6450,0,1,6452,2758752
168,6850,5800,3100,17980000,2,54806,13703,1,631560000,631560000,20551,6850,13701,6850,0,1,6852,35191269
168,6850,5800,3100,17980000,2,54806,13703,1,631560000,631560000,20551,6850,13701,6850,0,1,6852,2972315
168,6850,5800,3100,17980000,2,54806,13703,1,631560000,631560000,20551,6850,13701,6850,0,1,6852,2973669
168,6850,5800,3100,17980000,2,54806,13703,1,631560000,631560000,20551,6850,13701,6850,0,1,6852,2978215
168,6850,5800,3100,17980000,2,54806,13703,1,631560000,631560000,20551,6850,13701,6850,0,1,6852,2975258
168,6850,5800,3100,17980000,2,54806,13703,1,631560000,631560000,20551,6850,13701,6850,0,1,6852,2916510
168,6850,5800,3100,17980000,2,54806,13703,1,631560000,631560000,20551,6850,13701,6850,0,1,6852,2913549
168,50,5800,2700,15660000,2,406,103,1,128680000,128680000,151,50,101,50,0,1,52,163138
168,50,5800,2700,15660000,2,406,103,1,128680000,128680000,151,50,101,50,0,1,52,151588
168,50,5800,2700,15660000,2,406,103,1,128680000,128680000,151,50,101,50,0,1,52,137481
168,50,5800,2700,15660000,2,406,103,1,128680000,128680000,151,50,101,50,0,1,52,149375
168,50,5800,2700,15660000,2,406,103,1,128680000,128680000,151,50,101,50,0,1,52,151119
168,50,5800,2700,15660000,2,406,103,1,128680000,128680000,151,50,101,50,0,1,52,195416
168,50,5800,2700,15660000,2,406,103,1,128680000,128680000,151,50,101,50,0,1,52,195899
168,450,5800,2700,15660000,2,3606,903,1,155880000,155880000,1351,450,901,450,0,1,452,1515423
168,450,5800,2700,15660000,2,3606,903,1,155880000,155880000,1351,450,901,450,0,1,452,297377
168,450,5800,2700,15660000,2,3606,903,1,155880000,155880000,1351,450,901,450,0,1,452,295853
168,450,5800,2700,15660000,2,3606,903,1,155880000,155880000,1351,450,901,450,0,1,452,294013
168,450,5800,2700,15660000,2,3606,903,1,155880000,155880000,1351,450,901,450,0,1,452,296824
168,450,5800,2700,15660000,2,3606,903,1,155880000,155880000,1351,450,901,450,0,1,452,305212
168,450,5800,2700,15660000,2,3606,903,1,155880000,155880000,1351,450,901,450,0,1,452,304787
168,850,5800,2700,15660000,2,6806,1703,1,183080000,183080000,2551,850,1701,850,0,1,852,3214708
168,850,5800,2700,15660000,2,6806,1703,1,183080000,183080000,2551,850,1701,850,0,1,852,445280
168,850,5800,2700,15660000,2,6806,1703,1,183080000,183080000,2551,850,1701,850,0,1,852,443265
168,850,5800,2700,15660000,2,6806,1703,1,183080000,183080000,2551,850,1701,850,0,1,852,447043
168,850,5800,2700,15660000,2,6806,1703,1,183080000,183080000,2551,850,1701,850,0,1,852,446405
168,850,5800,2700,15660000,2,6806,1703,1,183080000,183080000,2551,850,1701,850,0,1,852,450560
168,850,5800,2700,15660000,2,6806,1703,1,183080000,183080000,2551,850,1701,850,0,1,852,450083
168,1250,5800,2700,15660000,2,10006,2503,1,210280000,210280000,3751,1250,2501,1250,0,1,1252,4811516
168,1250,5800,2700,15660000,2,10006,2503,1,210280000,210280000,3751,1250,2501,1250,0,1,1252,610628
168,1250,5800,2700,15660000,2,10006,2503,1,210280000,210280000,3751,1250,2501,1250,0,1,1252,614177
168,1250,5800,2700,15660000,2,10006,2503,1,210280000,210280000,3751,1250,2501,1250,0,1,1252,575043
168,1250,5800,2700,15660000,2,10006,2503,1,210280000,210280000,3751,1250,2501,1250,0,1,1252,612571
168,1250,5800,2700,15660000,2,10006,2503,1,210280000,210280000,3751,1250,2501,1250,0,1,1252,621485
168,1250,5800,2700,15660000,2,10006,2503,1,210280000,210280000,3751,1250,2501,1250,0,1,1252,618237
168,1650,5800,2700,15660000,2,13206,3303,1,237480000,237480000,4951,1650,3301,1650,0,1,1652,6501049
168,1650,5800,2700,15660000,2,13206,3303,1,237480000,237480000,4951,1650,3301,1650,0,1,1652,698980
168,1650,5800,2700,15660000,2,13206,3303,1,237480000,237480000,4951,1650,3301,1650,0,1,1652,702665
168,1650,5800,2700,15660000,2,13206,3303,1,237480000,237480000,4951,1650,3301,1650,0,1,1652,717755
168,1650,5800,2700,15660000,2,13206,3303,1,237480000,237480000,4951,1650,3301,1650,0,1,1652,701167
168,1650,5800,2700,15660000,2,13206,3303,1,237480000,237480000,4951,1650,3301,1650,0,1,1652,740029
168,1650,5800,2700,15660000,2,13206,3303,1,237480000,237480000,4951,1650,3301,1650,0,1,1652,739445
168,2050,5800,2700,15660000,2,16406,4103,1,264680000,264680000,6151,2050,4101,2050,0,1,2052,8526096
168,2050,5800,2700,15660000,2,16406,4103,1,264680000,264680000,6151,2050,4101,2050,0,1,2052,830284
168,2050,5800,2700,15660000,2,16406,4103,1,264680000,264680000,6151,2050,4101,2050,0,1,2052,829538
168,2050,5800,2700,15660000,2,16406,4103,1,264680000,264680000,6151,2050,4101,2050,0,1,2052,830886
168,2050,5800,2700,15660000,2,16406,4103,1,264680000,264680000,6151,2050,4101,2050,0,1,2052,827224
168,2050,5800,2700,15660000,2,16406,4103,1,264680000,264680000,6151,2050,4101,2050,0,1,2052,878788
168,2050,5800,2700,15660000,2,16406,4103,1,264680000,264680000,6151,2050,4101,2050,0,1,2052,876536
168,2450,5800,2700,15660000,2,19606,4903,1,291880000,291880000,7351,2450,4901,2450,0,1,2452,10205776
168,2450,5800,2700,15660000,2,19606,4903,1,291880000,291880000,7351,2450,4901,2450,0,1,2452,989464
168,2450,5800,2700,15660000,2,19606,4903,1,291880000,291880000,7351,2450,4901,2450,0,1,2452,995138
168,2450,5800,2700,15660000,2,19606,4903,1,291880000,291880000,7351,2450,4901,2450,0,1,2452,993591
168,2450,5800,2700,15660000,2,19606,4903,1,291880000,291880000,7351,2450,4901,2450,0,1,2452,991879
168,2450,5800,2700,15660000,2,19606,4903,1,291880000,291880000,7351,2450,4901,2450,0,1,2452,1019335
168,2450,5800,2700,15660000,2,19606,4903,1,291880000,291880000,7351,2450,4901,2450,0,1,2452,1018653
168,2850,5800,2700,15660000,2,22806,5703,1,319080000,319080000,8551,2850,5701,2850,0,1,2852,11996576
168,2850,5800,2700,15660000,2,22806,5703,1,319080000,319080000,8551,2850,5701,2850,0,1,2852,1143458
168,2850,5800,2700,15660000,2,22806,5703,1,319080000,319080000,8551,2850,5701,2850,0,1,2852,1145342
168,2850,5800,2700,15660000,2,22806,5703,1,319080000,319080000,8551,2850,5701,2850,0,1,2852,1147050
168,2850,5800,2700,15660000,2,22806,5703,1,319080000,319080000,8551,2850,5701,2850,0,1,2852,1139707
168,2850,5800,2700,15660000,2,22806,5703,1,319080000,319080000,8551,2850,5701,2850,0,1,2852,1160032
168,2850,5800,2700,15660000,2,22806,5703,1,319080000,319080000,8551,2850,5701,2850,0,1,2852,1159298
168,3250,5800,2700,15660000,2,26006,6503,1,346280000,346280000,9751,3250,6501,3250,0,1,3252,13628043
168,3250,5800,2700,15660000,2,26006,6503,1,346280000,346280000,9751,3250,6501,3250,0,1,3252,1339257
168,3250,5800,2700,15660000,2,26006,6503,1,346280000,346280000,9751,3250,6501,3250,0,1,3252,1330367
168,3250,5800,2700,15660000,2,26006,6503,1,346280000,346280000,9751,3250,6501,3250,0,1,3252,1338221
168,3250,5800,2700,15660000,2,26006,6503,1,346280000,346280000,9751,3250,6501,3250,0,1,3252,1337053
168,3250,5800,2700,15660000,2,26006,6503,1,346280000,346280000,9751,3250,6501,3250,0,1,3252,1342312
168,3250,5800,2700,15660000,2,26006,6503,1,346280000,346280000,9751,3250,6501,3250,0,1,3252,1343090
168,3650,5800,2700,15660000,2,29206,7303,1,373480000,373480000,10951,3650,7301,3650,0,1,3652,15109135
168,3650,5800,2700,15660000,2,29206,7303,1,373480000,373480000,10951,3650,7301,3650,0,1,3652,1455199
168,3650,5800,2700,15660000,2,29206,7303,1,373480000,373480000,10951,3650,7301,3650,0,1,3652,1453211
168,3650,5800,2700,15660000,2,29206,7303,1,373480000,373480000,10951,3650,7301,3650,0,1,3652,1457195
168,3650,5800,2700,15660000,2,29206,7303,1,373480000,373480000,10951,3650,7301,3650,0,1,3652,1456181
168,3650,5800,2700,15660000,2,29206,7303,1,373480000,373480000,10951,3650,7301,3650,0,1,3652,1460292
168,3650,5800,2700,15660000,2,29206,7303,1,373480000,373480000,10951,3650,7301,3650,0,1,3652,1459460
168,4050,5800,2700,15660000,2,32406,8103,1,400680000,400680000,12151,4050,8101,4050,0,1,4052,17306545
168,4050,5800,2700,15660000,2,32406,8103,1,400680000,400680000,12151,4050,8101,4050,0,1,4052,1632710
168,4050,5800,2700,15660000,2,32406,8103,1,400680000,400680000,12151,4050,8101,4050,0,1,4052,1636138
168,4050,5800,2700,15660000,2,32406,8103,1,400680000,400680000,12151,4050,8101,4050,0,1,4052,1619238
168,4050,5800,2700,15660000,2,32406,8103,1,400680000,400680000,12151,4050,8101,4050,0,1,4052,1631459
168,4050,5800,2700,15660000,2,32406,8103,1,400680000,400680000,12151,4050,8101,4050,0,1,4052,1628799
168,4050,5800,2700,15660000,2,32406,8103,1,400680000,400680000,12151,4050,8101,4050,0,1,4052,1623824
168,4450,5800,2700,15660000,2,35606,8903,1,427880000,427880000,13351,4450,8901,4450,0,1,4452,19553883
168,4450,5800,2700,15660000,2,35606,8903,1,427880000,427880000,13351,4450,8901,4450,0,1,4452,1749801
168,4450,5800,2700,15660000,2,35606,8903,1,427880000,427880000,13351,4450,8901,4450,0,1,4452,1748736
168,4450,5800,2700,15660000,2,35606,8903,1,427880000,427880000,13351,4450,8901,4450,0,1,4452,1753379
168,4450,5800,2700,15660000,2,35606,8903,1,427880000,427880000,13351,4450,8901,4450,0,1,4452,1747773
168,4450,5800,2700,15660000,2,35606,8903,1,427880000,427880000,13351,4450,8901,4450,0,1,4452,1736206
168,4450,5800,2700,15660000,2,35606,8903,1,427880000,427880000,13351,4450,8901,4450,0,1,4452,1733977
168,4850,5800,2700,15660000,2,38806,9703,1,455080000,455080000,14551,4850,9701,4850,0,1,4852,20099224
168,4850,5800,2700,15660000,2,38806,9703,1,455080000,455080000,14551,4850,9701,4850,0,1,4852,1895348
168,4850,5800,2700,15660000,2,38806,9703,1,455080000,455080000,14551,4850,9701,4850,0,1,4852,1898620
168,4850,5800,2700,15660000,2,38806,9703,1,455080000,455080000,14551,4850,9701,4850,0,1,4852,1900203
168,4850,5800,2700,15660000,2,38806,9703,1,455080000,455080000,14551,4850,9701,4850,0,1,4852,1893527
168,4850,5800,2700,15660000,2,38806,9703,1,455080000,455080000,14551,4850,9701,4850,0,1,4852,1882699
168,4850,5800,2700,15660000,2,38806,9703,1,455080000,455080000,14551,4850,9701,4850,0,1,4852,1878641
168,5250,5800,2700,15660000,2,42006,10503,1,482280000,482280000,15751,5250,10501,5250,0,1,5252,22424032
168,5250,5800,2700,15660000,2,42006,10503,1,482280000,482280000,15751,5250,10501,5250,0,1,5252,2068513
168,5250,5800,2700,15660000,2,42006,10503,1,482280000,482280000,15751,5250,10501,5250,0,1,5252,2077514
168,5250,5800,2700,15660000,2,42006,10503,1,482280000,482280000,15751,5250,10501,5250,0,1,5252,2075979
168,5250,5800,2700,15660000,2,42006,10503,1,482280000,482280000,15751,5250,10501,5250,0,1,5252,2062696
168,5250,5800,2700,15660000,2,42006,10503,1,482280000,482280000,15751,5250,10501,5250,0,1,5252,2053280
168,5250,5800,2700,15660000,2,42006,10503,1,482280000,482280000,15751,5250,10501,5250,0,1,5252,2045168
168,5650,5800,2700,15660000,2,45206,11303,1,509480000,509480000,16951,5650,11301,5650,0,1,5652,24256105
168,5650,5800,2700,15660000,2,45206,11303,1,509480000,509480000,16951,5650,11301,5650,0,1,5652,2195490
168,5650,5800,2700,15660000,2,45206,11303,1,509480000,509480000,16951,5650,11301,5650,0,1,5652,2185519
168,5650,5800,2700,15660000,2,45206,11303,1,509480000,509480000,16951,5650,11301,5650,0,1,5652,2187707
168,5650,5800,2700,15660000,2,45206,11303,1,509480000,509480000,16951,5650,11301,5650,0,1,5652,2192718
168,5650,5800,2700,15660000,2,45206,11303,1,509480000,509480000,16951,5650,11301,5650,0,1,5652,2173811
168,5650,5800,2700,15660000,2,45206,11303,1,509480000,509480000,16951,5650,11301,5650,0,1,5652,2177302
168,6050,5800,2700,15660000,2,48406,12103,1,536680000,536680000,18151,6050,12101,6050,0,1,6052,26646565
168,6050,5800,2700,15660000,2,48406,12103,1,536680000,536680000,18151,6050,12101,6050,0,1,6052,2343137
168,6050,5800,2700,15660000,2,48406,12103,1,536680000,536680000,18151,6050,12101,6050,0,1,6052,2363633
168,6050,5800,2700,15660000,2,48406,12103,1,536680000,536680000,18151,6050,12101,6050,0,1,6052,2360729
168,6050,5800,2700,15660000,2,48406,12103,1,536680000,536680000,18151,6050,12101,6050,0,1,6052,2353159
168,6050,5800,2700,15660000,2,48406,12103,1,536680000,536680000,18151,6050,12101,6050,0,1,6052,2315644
168,6050,5800,2700,15660000,2,48406,12103,1,536680000,536680000,18151,6050,12101,6050,0,1,6052,2309815
168,6450,5800,2700,15660000,2,51606,12903,1,563880000,563880000,19351,6450,12901,6450,0,1,6452,28928105
168,6450,5800,2700,15660000,2,51606,12903,1,563880000,563880000,19351,6450,12901,6450,0,1,6452,2507582
168,6450,5800,2700,15660000,2,51606,12903,1,563880000,563880000,19351,6450,12901,6450,0,1,6452,2501780
168,6450,5800,2700,15660000,2,51606,12903,1,563880000,563880000,19351,6450,12901,6450,0,1,6452,2510343
168,6450,5800,2700,15660000,2,51606,12903,1,563880000,563880000,19351,6450,12901,6450,0,1,6452,2506082
168,6450,5800,2700,15660000,2,51606,12903,1,563880000,563880000,19351,6450,12901,6450,0,1,6452,2462922
168,6450,5800,2700,15660000,2,51606,12903,1,563880000,563880000,19351,6450,12901,6450,0,1,6452,2460002
168,6850,5800,2700,15660000,2,54806,13703,1,591080000,591080000,20551,6850,13701,6850,0,1,6852,29880485
168,6850,5800,2700,15660000,2,54806,13703,1,591080000,591080000,20551,6850,13701,6850,0,1,6852,2656328
168,6850,5800,2700,15660000,2,54806,13703,1,591080000,591080000,20551,6850,13701,6850,0,1,6852,2639490
168,6850,5800,2700,15660000,2,54806,13703,1,591080000,591080000,20551,6850,13701,6850,0,1,6852,2643918
168,6850,5800,2700,15660000,2,54806,13703,1,591080000,591080000,20551,6850,13701,6850,0,1,6852,2659507
168,6850,5800,2700,15660000,2,54806,13703,1,591080000,591080000,20551,6850,13701,6850,0,1,6852,2620917
168,6850,5800,2700,15660000,2,54806,13703,1,591080000,591080000,20551,6850,13701,6850,0,1,6852,2611001
168,50,5800,2300,13340000,2,406,103,1,109960000,109960000,151,50,101,50,0,1,52,135142
168,50,5800,2300,13340000,2,406,103,1,109960000,109960000,151,50,101,50,0,1,52,127087
168,50,5800,2300,13340000,2,406,103,1,109960000,109960000,151,50,101,50,0,1,52,131255
168,50,5800,2300,13340000,2,406,103,1,109960000,109960000,151,50,101,50,0,1,52,120668
168,50,5800,2300,13340000,2,406,103,1,109960000,109960000,151,50,101,50,0,1,52,131731
168,50,5800,2300,13340000,2,406,103,1,109960000,109960000,151,50,101,50,0,1,52,168353
168,50,5800,2300,13340000,2,406,103,1,109960000,109960000,151,50,101,50,0,1,52,167868
168,450,5800,2300,13340000,2,3606,903,1,135880000,135880000,1351,450,901,450,0,1,452,1345564
168,450,5800,2300,13340000,2,3606,903,1,135880000,135880000,1351,450,901,450,0,1,452,247705
168,450,5800,2300,13340000,2,3606,903,1,135880000,135880000,1351,450,901,450,0,1,452,231352
168,450,5800,2300,13340000,2,3606,903,1,135880000,135880000,1351,450,901,450,0,1,452,250226
168,450,5800,2300,13340000,2,3606,903,1,135880000,135880000,1351,450,901,450,0,1,452,251156
168,450,5800,2300,13340000,2,3606,903,1,135880000,135880000,1351,450,901,450,0,1,452,258928
168,450,5800,2300,13340000,2,3606,903,1,135880000,135880000,1351,450,901,450,0,1,452,259355
168,850,5800,2300,13340000,2,6806,1703,1,161800000,161800000,2551,850,1701,850,0,1,852,2620308
168,850,5800,2300,13340000,2,6806,1703,1,161800000,161800000,2551,850,1701,850,0,1,852,388245
168,850,5800,2300,13340000,2,6806,1703,1,161800000,161800000,2551,850,1701,850,0,1,852,399277
168,850,5800,2300,13340000,2,6806,1703,1,161800000,161800000,2551,850,1701,850,0,1,852,393826
168,850,5800,2300,13340000,2,6806,1703,1,161800000,161800000,2551,850,1701,850,0,1,852,387173
168,850,5800,2300,13340000,2,6806,1703,1,161800000,161800000,2551,850,1701,850,0,1,852,396873
168,850,5800,2300,13340000,2,6806,1703,1,161800000,161800000,2551,850,1701,850,0,1,852,396237
168,1250,5800,2300,13340000,2,10006,2503,1,187720000,187720000,3751,1250,2501,1250,0,1,1252,3963410
168,1250,5800,2300,13340000,2,10006,2503,1,187720000,187720000,3751,1250,2501,1250,0,1,1252,513111
168,1250,5800,2300,13340000,2,10006,2503,1,187720000,187720000,3751,1250,2501,1250,0,1,1252,513932
168,1250,5800,2300,13340000,2,10006,2503,1,187720000,187720000,3751,1250,2501,1250,0,1,1252,510525
168,1250,5800,2300,13340000,2,10006,2503,1,187720000,187720000,3751,1250,2501,1250,0,1,1252,512487
168,1250,5800,2300,13340000,2,10006,2503,1,187720000,187720000,3751,1250,2501,1250,0,1,1252,516992
168,1250,5800,2300,13340000,2,10006,2503,1,187720000,187720000,3751,1250,2501,1250,0,1,1252,516458
168,1650,5800,2300,13340000,2,13206,3303,1,213640000,213640000,4951,1650,3301,1650,0,1,1652,5466932
168,1650,5800,2300,13340000,2,13206,3303,1,213640000,213640000,4951,1650,3301,1650,0,1,1652,600982
168,1650,5800,2300,13340000,2,13206,3303,1,213640000,213640000,4951,1650,3301,1650,0,1,1652,603836
168,1650,5800,2300,13340000,2,13206,3303,1,213640000,213640000,4951,1650,3301,1650,0,1,1652,603154
168,1650,5800,2300,13340000,2,13206,3303,1,213640000,213640000,4951,1650,3301,1650,0,1,1652,604368
168,1650,5800,2300,13340000,2,13206,3303,1,213640000,213640000,4951,1650,3301,1650,0,1,1652,660231
168,1650,5800,2300,13340000,2,13206,3303,1,213640000,213640000,4951,1650,3301,1650,0,1,1652,654656
168,2050,5800,2300,13340000,2,16406,4103,1,239560000,239560000,6151,2050,4101,2050,0,1,2052,7040269
168,2050,5800,2300,13340000,2,16406,4103,1,239560000,239560000,6151,2050,4101,2050,0,1,2052,725132
168,2050,5800,2300,13340000,2,16406,4103,1,239560000,239560000,6151,2050,4101,2050,0,1,2052,723971
168,2050,5800,2300,13340000,2,16406,4103,1,239560000,239560000,6151,2050,4101,2050,0,1,2052,724609
168,2050,5800,2300,13340000,2,16406,4103,1,239560000,239560000,6151,2050,4101,2050,0,1,2052,725755
168,2050,5800,2300,13340000,2,16406,4103,1,239560000,239560000,6151,2050,4101,2050,0,1,2052,779844
168,2050,5800,2300,13340000,2,16406,4103,1,239560000,239560000,6151,2050,4101,2050,0,1,2052,779208
168,2450,5800,2300,13340000,2,19606,4903,1,265480000,265480000,7351,2450,4901,2450,0,1,2452,8403800
168,2450,5800,2300,13340000,2,19606,4903,1,265480000,265480000,7351,2450,4901,2450,0,1,2452,845190
168,2450,5800,2300,13340000,2,19606,4903,1,265480000,265480000,7351,2450,4901,2450,0,1,2452,843172
168,2450,5800,2300,13340000,2,19606,4903,1,265480000,265480000,7351,2450,4901,2450,0,1,2452,844515
168,2450,5800,2300,13340000,2,19606,4903,1,265480000,265480000,7351,2450,4901,2450,0,1,2452,843862
168,2450,5800,2300,13340000,2,19606,4903,1,265480000,265480000,7351,2450,4901,2450,0,1,2452,893324
168,2450,5800,2300,13340000,2,19606,4903,1,265480000,265480000,7351,2450,4901,2450,0,1,2452,892473
168,2850,5800,2300,13340000,2,22806,5703,1,291400000,291400000,8551,2850,5701,2850,0,1,2852,10066926
168,2850,5800,2300,13340000,2,22806,5703,1,291400000,291400000,8551,2850,5701,2850,0,1,2852,1002134
168,2850,5800,2300,13340000,2,22806,5703,1,291400000,291400000,8551,2850,5701,2850,0,1,2852,976170
168,2850,5800,2300,13340000,2,22806,5703,1,291400000,291400000,8551,2850,5701,2850,0,1,2852,978549
168,2850,5800,2300,13340000,2,22806,5703,1,291400000,291400000,8551,2850,5701,2850,0,1,2852,999550
168,2850,5800,2300,13340000,2,22806,5703,1,291400000,291400000,8551,2850,5701,2850,0,1,2852,1034188
168,2850,5800,2300,13340000,2,22806,5703,1,291400000,291400000,8551,2850,5701,2850,0,1,2852,1030402
168,3250,5800,2300,13340000,2,26006,6503,1,317320000,317320000,9751,3250,6501,3250,0,1,3252,11643561
168,3250,5800,2300,13340000,2,26006,6503,1,317320000,317320000,9751,3250,6501,3250,0,1,3252,1134377
168,3250,5800,2300,13340000,2,26006,6503,1,317320000,317320000,9751,3250,6501,3250,0,1,3252,1152953
168,3250,5800,2300,13340000,2,26006,6503,1,317320000,317320000,9751,3250,6501,3250,0,1,3252,1160013
168,3250,5800,2300,13340000,2,26006,6503,1,317320000,317320000,9751,3250,6501,3250,0,1,3252,1127066
168,3250,5800,2300,13340000,2,26006,6503,1,317320000,317320000,9751,3250,6501,3250,0,1,3252,1158922
168,3250,5800,2300,13340000,2,26006,6503,1,317320000,317320000,9751,3250,6501,3250,0,1,3252,1157997
168,3650,5800,2300,13340000,2,29206,7303,1,343240000,343240000,10951,3650,7301,3650,0,1,3652,13103746
168,3650,5800,2300,13340000,2,29206,7303,1,343240000,343240000,10951,3650,7301,3650,0,1,3652,1240673
168,3650,5800,2300,13340000,2,29206,7303,1,343240000,343240000,10951,3650,7301,3650,0,1,3652,1249838
168,3650,5800,2300,13340000,2,29206,7303,1,343240000,343240000,10951,3650,7301,3650,0,1,3652,1247852
168,3650,5800,2300,13340000,2,29206,7303,1,343240000,343240000,10951,3650,7301,3650,0,1,3652,1245585
168,3650,5800,2300,13340000,2,29206,7303,1,343240000,343240000,10951,3650,7301,3650,0,1,3652,1256927
168,3650,5800,2300,13340000,2,29206,7303,1,343240000,343240000,10951,3650,7301,3650,0,1,3652,1255349
168,4050,5800,2300,13340000,2,32406,8103,1,369160000,369160000,12151,4050,8101,4050,0,1,4052,14509945
168,4050,5800,2300,13340000,2,32406,8103,1,369160000,369160000,12151,4050,8101,4050,0,1,4052,1413066
168,4050,5800,2300,13340000,2,32406,8103,1,369160000,369160000,12151,4050,8101,4050,0,1,4052,1372070
168,4050,5800,2300,13340000,2,32406,8103,1,369160000,369160000,12151,4050,8101,4050,0,1,4052,1385369
168,4050,5800,2300,13340000,2,32406,8103,1,369160000,369160000,12151,4050,8101,4050,0,1,4052,1415386
168,4050,5800,2300,13340000,2,32406,8103,1,369160000,369160000,12151,4050,8101,4050,0,1,4052,1416735
168,4050,5800,2300,13340000,2,32406,8103,1,369160000,369160000,12151,4050,8101,4050,0,1,4052,1417616
168,4450,5800,2300,13340000,2,35606,8903,1,395080000,395080000,13351,4450,8901,4450,0,1,4452,16006498
168,4450,5800,2300,13340000,2,35606,8903,1,395080000,395080000,13351,4450,8901,4450,0,1,4452,1520670
168,4450,5800,2300,13340000,2,35606,8903,1,395080000,395080000,13351,4450,8901,4450,0,1,4452,1539039
168,4450,5800,2300,13340000,2,35606,8903,1,395080000,395080000,13351,4450,8901,4450,0,1,4452,1543894
168,4450,5800,2300,13340000,2,35606,8903,1,395080000,395080000,13351,4450,8901,4450,0,1,4452,1531981
168,4450,5800,2300,13340000,2,35606,8903,1,395080000,395080000,13351,4450,8901,4450,0,1,4452,1533136
168,4450,5800,2300,13340000,2,35606,8903,1,395080000,395080000,13351,4450,8901,4450,0,1,4452,1529848
168,4850,5800,2300,13340000,2,38806,9703,1,421000000,421000000,14551,4850,9701,4850,0,1,4852,17475997
168,4850,5800,2300,13340000,2,38806,9703,1,421000000,421000000,14551,4850,9701,4850,0,1,4852,1634305
168,4850,5800,2300,13340000,2,38806,9703,1,421000000,421000000,14551,4850,9701,4850,0,1,4852,1635718
168,4850,5800,2300,13340000,2,38806,9703,1,421000000,421000000,14551,4850,9701,4850,0,1,4852,1631567
168,4850,5800,2300,13340000,2,38806,9703,1,421000000,421000000,14551,4850,9701,4850,0,1,4852,1626909
168,4850,5800,2300,13340000,2,38806,9703,1,421000000,421000000,14551,4850,9701,4850,0,1,4852,1630469
168,4850,5800,2300,13340000,2,38806,9703,1,421000000,421000000,14551,4850,9701,4850,0,1,4852,1629209
168,5250,5800,2300,13340000,2,42006,10503,1,446920000,446920000,15751,5250,10501,5250,0,1,5252,18724452
168,5250,5800,2300,13340000,2,42006,10503,1,446920000,446920000,15751,5250,10501,5250,0,1,5252,1796438
168,5250,5800,2300,13340000,2,42006,10503,1,446920000,446920000,15751,5250,10501,5250,0,1,5252,1792431
168,5250,5800,2300,13340000,2,42006,10503,1,446920000,446920000,15751,5250,10501,5250,0,1,5252,1800280
168,5250,5800,2300,13340000,2,42006,10503,1,446920000,446920000,15751,5250,10501,5250,0,1,5252,1798786
168,5250,5800,2300,13340000,2,42006,10503,1,446920000,446920000,15751,5250,10501,5250,0,1,5252,1778622
168,5250,5800,2300,13340000,2,42006,10503,1,446920000,446920000,15751,5250,10501,5250,0,1,5252,1781080
168,5650,5800,2300,13340000,2,45206,11303,1,472840000,472840000,16951,5650,11301,5650,0,1,5652,20754295
168,5650,5800,2300,13340000,2,45206,11303,1,472840000,472840000,16951,5650,11301,5650,0,1,5652,1885348
168,5650,5800,2300,13340000,2,45206,11303,1,472840000,472840000,16951,5650,11301,5650,0,1,5652,1890947
168,5650,5800,2300,13340000,2,45206,11303,1,472840000,472840000,16951,5650,11301,5650,0,1,5652,1892699
168,5650,5800,2300,13340000,2,45206,11303,1,472840000,472840000,16951,5650,11301,5650,0,1,5652,1889006
168,5650,5800,2300,13340000,2,45206,11303,1,472840000,472840000,16951,5650,11301,5650,0,1,5652,1877562
168,5650,5800,2300,13340000,2,45206,11303,1,472840000,472840000,16951,5650,11301,5650,0,1,5652,1872948
168,6050,5800,2300,13340000,2,48406,12103,1,498760000,498760000,18151,6050,12101,6050,0,1,6052,22288564
168,6050,5800,2300,13340000,2,48406,12103,1,498760000,498760000,18151,6050,12101,6050,0,1,6052,2047422
168,6050,5800,2300,13340000,2,48406,12103,1,498760000,498760000,18151,6050,12101,6050,0,1,6052,2044051
168,6050,5800,2300,13340000,2,48406,12103,1,498760000,498760000,18151,6050,12101,6050,0,1,6052,2051294
168,6050,5800,2300,13340000,2,48406,12103,1,498760000,498760000,18151,6050,12101,6050,0,1,6052,2049440
168,6050,5800,2300,13340000,2,48406,12103,1,498760000,498760000,18151,6050,12101,6050,0,1,6052,2022373
168,6050,5800,2300,13340000,2,48406,12103,1,498760000,498760000,18151,6050,12101,6050,0,1,6052,2024690
168,6450,5800,2300,13340000,2,51606,12903,1,524680000,524680000,19351,6450,12901,6450,0,1,6452,23372768
168,6450,5800,2300,13340000,2,51606,12903,1,524680000,524680000,19351,6450,12901,6450,0,1,6452,2146768
168,6450,5800,2300,13340000,2,51606,12903,1,524680000,524680000,19351,6450,12901,6450,0,1,6452,2155069
168,6450,5800,2300,13340000,2,51606,12903,1,524680000,524680000,19351,6450,12901,6450,0,1,6452,2153318
168,6450,5800,2300,13340000,2,51606,12903,1,524680000,524680000,19351,6450,12901,6450,0,1,6452,2151702
168,6450,5800,2300,13340000,2,51606,12903,1,524680000,524680000,19351,6450,12901,6450,0,1,6452,2128326
168,6450,5800,2300,13340000,2,51606,12903,1,524680000,524680000,19351,6450,12901,6450,0,1,6452,2123742
168,6850,5800,2300,13340000,2,54806,13703,1,550600000,550600000,20551,6850,13701,6850,0,1,6852,24673384
168,6850,5800,2300,13340000,2,54806,13703,1,550600000,550600000,20551,6850,13701,6850,0,1,6852,2298088
168,6850,5800,2300,13340000,2,54806,13703,1,550600000,550600000,20551,6850,13701,6850,0,1,6852,2299663
168,6850,5800,2300,13340000,2,54806,13703,1,550600000,550600000,20551,6850,13701,6850,0,1,6852,2281471
168,6850,5800,2300,13340000,2,54806,13703,1,550600000,550600000,20551,6850,13701,6850,0,1,6852,2302478
168,6850,5800,2300,13340000,2,54806,13703,1,550600000,550600000,20551,6850,13701,6850,0,1,6852,2270112
168,6850,5800,2300,13340000,2,54806,13703,1,550600000,550600000,20551,6850,13701,6850,0,1,6852,2267001
168,50,5800,1900,11020000,2,406,103,1,91240000,91240000,151,50,101,50,0,1,52,110775
168,50,5800,1900,11020000,2,406,103,1,91240000,91240000,151,50,101,50,0,1,52,107089
168,50,5800,1900,11020000,2,406,103,1,91240000,91240000,151,50,101,50,0,1,52,108842
168,50,5800,1900,11020000,2,406,103,1,91240000,91240000,151,50,101,50,0,1,52,109312
168,50,5800,1900,11020000,2,406,103,1,91240000,91240000,151,50,101,50,0,1,52,96762
168,50,5800,1900,11020000,2,406,103,1,91240000,91240000,151,50,101,50,0,1,52,141131
168,50,5800,1900,11020000,2,406,103,1,91240000,91240000,151,50,101,50,0,1,52,138508
168,450,5800,1900,11020000,2,3606,903,1,115880000,115880000,1351,450,901,450,0,1,452,1116667
168,450,5800,1900,11020000,2,3606,903,1,115880000,115880000,1351,450,901,450,0,1,452,207652
168,450,5800,1900,11020000,2,3606,903,1,115880000,115880000,1351,450,901,450,0,1,452,206777
168,450,5800,1900,11020000,2,3606,903,1,115880000,115880000,1351,450,901,450,0,1,452,208117
168,450,5800,1900,11020000,2,3606,903,1,115880000,115880000,1351,450,901,450,0,1,452,205039
168,450,5800,1900,11020000,2,3606,903,1,115880000,115880000,1351,450,901,450,0,1,452,217418
168,450,5800,1900,11020000,2,3606,903,1,115880000,115880000,1351,450,901,450,0,1,452,216992
168,850,5800,1900,11020000,2,6806,1703,1,140520000,140520000,2551,850,1701,850,0,1,852,2194791
168,850,5800,1900,11020000,2,6806,1703,1,140520000,140520000,2551,850,1701,850,0,1,852,327252
168,850,5800,1900,11020000,2,6806,1703,1,140520000,140520000,2551,850,1701,850,0,1,852,324545
168,850,5800,1900,11020000,2,6806,1703,1,140520000,140520000,2551,850,1701,850,0,1,852,325750
168,850,5800,1900,11020000,2,6806,1703,1,140520000,140520000,2551,850,1701,850,0,1,852,326589
168,850,5800,1900,11020000,2,6806,1703,1,140520000,140520000,2551,850,1701,850,0,1,852,329158
168,850,5800,1900,11020000,2,6806,1703,1,140520000,140520000,2551,850,1701,850,0,1,852,328673
168,1250,5800,1900,11020000,2,10006,2503,1,165160000,165160000,3751,1250,2501,1250,0,1,1252,3277263
168,1250,5800,1900,11020000,2,10006,2503,1,165160000,165160000,3751,1250,2501,1250,0,1,1252,440270
168,1250,5800,1900,11020000,2,10006,2503,1,165160000,165160000,3751,1250,2501,1250,0,1,1252,441235
168,1250,5800,1900,11020000,2,10006,2503,1,165160000,165160000,3751,1250,2501,1250,0,1,1252,442079
168,1250,5800,1900,11020000,2,10006,2503,1,165160000,165160000,3751,1250,2501,1250,0,1,1252,438025
168,1250,5800,1900,11020000,2,10006,2503,1,165160000,165160000,3751,1250,2501,1250,0,1,1252,443429
168,1250,5800,1900,11020000,2,10006,2503,1,165160000,165160000,3751,1250,2501,1250,0,1,1252,444374
168,1650,5800,1900,11020000,2,13206,3303,1,189800000,189800000,4951,1650,3301,1650,0,1,1652,4425088
168,1650,5800,1900,11020000,2,13206,3303,1,189800000,189800000,4951,1650,3301,1650,0,1,1652,540711
168,1650,5800,1900,11020000,2,13206,3303,1,189800000,189800000,4951,1650,3301,1650,0,1,1652,527299
168,1650,5800,1900,11020000,2,13206,3303,1,189800000,189800000,4951,1650,3301,1650,0,1,1652,541818
168,1650,5800,1900,11020000,2,13206,3303,1,189800000,189800000,4951,1650,3301,1650,0,1,1652,505628
168,1650,5800,1900,11020000,2,13206,3303,1,189800000,189800000,4951,1650,3301,1650,0,1,1652,543088
168,1650,5800,1900,11020000,2,13206,3303,1,189800000,189800000,4951,1650,3301,1650,0,1,1652,542488
168,2050,5800,1900,11020000,2,16406,4103,1,214440000,214440000,6151,2050,4101,2050,0,1,2052,5606605
168,2050,5800,1900,11020000,2,16406,4103,1,214440000,214440000,6151,2050,4101,2050,0,1,2052,614778
168,2050,5800,1900,11020000,2,16406,4103,1,214440000,214440000,6151,2050,4101,2050,0,1,2052,612883
168,2050,5800,1900,11020000,2,16406,4103,1,214440000,214440000,6151,2050,4101,2050,0,1,2052,615617
168,2050,5800,1900,11020000,2,16406,4103,1,214440000,214440000,6151,2050,4101,2050,0,1,2052,614109
168,2050,5800,1900,11020000,2,16406,4103,1,214440000,214440000,6151,2050,4101,2050,0,1,2052,660329
168,2050,5800,1900,11020000,2,16406,4103,1,214440000,214440000,6151,2050,4101,2050,0,1,2052,659687
168,2450,5800,1900,11020000,2,19606,4903,1,239080000,239080000,7351,2450,4901,2450,0,1,2452,6845069
168,2450,5800,1900,11020000,2,19606,4903,1,239080000,239080000,7351,2450,4901,2450,0,1,2452,734168
168,2450,5800,1900,11020000,2,19606,4903,1,239080000,239080000,7351,2450,4901,2450,0,1,2452,722282
168,2450,5800,1900,11020000,2,19606,4903,1,239080000,239080000,7351,2450,4901,2450,0,1,2452,725298
168,2450,5800,1900,11020000,2,19606,4903,1,239080000,239080000,7351,2450,4901,2450,0,1,2452,735883
168,2450,5800,1900,11020000,2,19606,4903,1,239080000,239080000,7351,2450,4901,2450,0,1,2452,796765
168,2450,5800,1900,11020000,2,19606,4903,1,239080000,239080000,7351,2450,4901,2450,0,1,2452,801072
168,2850,5800,1900,11020000,2,22806,5703,1,263720000,263720000,8551,2850,5701,2850,0,1,2852,8259039
168,2850,5800,1900,11020000,2,22806,5703,1,263720000,263720000,8551,2850,5701,2850,0,1,2852,827938
168,2850,5800,1900,11020000,2,22806,5703,1,263720000,263720000,8551,2850,5701,2850,0,1,2852,861502
168,2850,5800,1900,11020000,2,22806,5703,1,263720000,263720000,8551,2850,5701,2850,0,1,2852,868086
168,2850,5800,1900,11020000,2,22806,5703,1,263720000,263720000,8551,2850,5701,2850,0,1,2852,823918
168,2850,5800,1900,11020000,2,22806,5703,1,263720000,263720000,8551,2850,5701,2850,0,1,2852,880924
168,2850,5800,1900,11020000,2,22806,5703,1,263720000,263720000,8551,2850,5701,2850,0,1,2852,880179
168,3250,5800,1900,11020000,2,26006,6503,1,288360000,288360000,9751,3250,6501,3250,0,1,3252,9490192
168,3250,5800,1900,11020000,2,26006,6503,1,288360000,288360000,9751,3250,6501,3250,0,1,3252,933224
168,3250,5800,1900,11020000,2,26006,6503,1,288360000,288360000,9751,3250,6501,3250,0,1,3252,935496
168,3250,5800,1900,11020000,2,26006,6503,1,288360000,288360000,9751,3250,6501,3250,0,1,3252,930005
168,3250,5800,1900,11020000,2,26006,6503,1,288360000,288360000,9751,3250,6501,3250,0,1,3252,923047
168,3250,5800,1900,11020000,2,26006,6503,1,288360000,288360000,9751,3250,6501,3250,0,1,3252,957958
168,3250,5800,1900,11020000,2,26006,6503,1,288360000,288360000,9751,3250,6501,3250,0,1,3252,957168
168,3650,5800,1900,11020000,2,29206,7303,1,313000000,313000000,10951,3650,7301,3650,0,1,3652,10358515
168,3650,5800,1900,11020000,2,29206,7303,1,313000000,313000000,10951,3650,7301,3650,0,1,3652,1041264
168,3650,5800,1900,11020000,2,29206,7303,1,313000000,313000000,10951,3650,7301,3650,0,1,3652,1039031
168,3650,5800,1900,11020000,2,29206,7303,1,313000000,313000000,10951,3650,7301,3650,0,1,3652,1043296
168,3650,5800,1900,11020000,2,29206,7303,1,313000000,313000000,10951,3650,7301,3650,0,1,3652,1036858
168,3650,5800,1900,11020000,2,29206,7303,1,313000000,313000000,10951,3650,7301,3650,0,1,3652,1063103
168,3650,5800,1900,11020000,2,29206,7303,1,313000000,313000000,10951,3650,7301,3650,0,1,3652,1062244
168,4050,5800,1900,11020000,2,32406,8103,1,337640000,337640000,12151,4050,8101,4050,0,1,4052,11781213
168,4050,5800,1900,11020000,2,32406,8103,1,337640000,337640000,12151,4050,8101,4050,0,1,4052,1199822
168,4050,5800,1900,11020000,2,32406,8103,1,337640000,337640000,12151,4050,8101,4050,0,1,4052,1191075
168,4050,5800,1900,11020000,2,32406,8103,1,337640000,337640000,12151,4050,8101,4050,0,1,4052,1194216
168,4050,5800,1900,11020000,2,32406,8103,1,337640000,337640000,12151,4050,8101,4050,0,1,4052,1204628
168,4050,5800,1900,11020000,2,32406,8103,1,337640000,337640000,12151,4050,8101,4050,0,1,4052,1209617
168,4050,5800,1900,11020000,2,32406,8103,1,337640000,337640000,12151,4050,8101,4050,0,1,4052,1207977
168,4450,5800,1900,11020000,2,35606,8903,1,362280000,362280000,13351,4450,8901,4450,0,1,4452,12676276
168,4450,5800,1900,11020000,2,35606,8903,1,362280000,362280000,13351,4450,8901,4450,0,1,4452,1250062
168,4450,5800,1900,11020000,2,35606,8903,1,362280000,362280000,13351,4450,8901,4450,0,1,4452,1303779
168,4450,5800,1900,11020000,2,35606,8903,1,362280000,362280000,13351,4450,8901,4450,0,1,4452,1306130
168,4450,5800,1900,11020000,2,35606,8903,1,362280000,362280000,13351,4450,8901,4450,0,1,4452,1287267
168,4450,5800,1900,11020000,2,35606,8903,1,362280000,362280000,13351,4450,8901,4450,0,1,4452,1296367
168,4450,5800,1900,11020000,2,35606,8903,1,362280000,362280000,13351,4450,8901,4450,0,1,4452,1294857
168,4850,5800,1900,11020000,2,38806,9703,1,386920000,386920000,14551,4850,9701,4850,0,1,4852,14275345
168,4850,5800,1900,11020000,2,38806,9703,1,386920000,386920000,14551,4850,9701,4850,0,1,4852,1387213
168,4850,5800,1900,11020000,2,38806,9703,1,386920000,386920000,14551,4850,9701,4850,0,1,4852,1389496
168,4850,5800,1900,11020000,2,38806,9703,1,386920000,386920000,14551,4850,9701,4850,0,1,4852,1393294
168,4850,5800,1900,11020000,2,38806,9703,1,386920000,386920000,14551,4850,9701,4850,0,1,4852,1391243
168,4850,5800,1900,11020000,2,38806,9703,1,386920000,386920000,14551,4850,9701,4850,0,1,4852,1395512
168,4850,5800,1900,11020000,2,38806,9703,1,386920000,386920000,14551,4850,9701,4850,0,1,4852,1394514
168,5250,5800,1900,11020000,2,42006,10503,1,411560000,411560000,15751,5250,10501,5250,0,1,5252,15437705
168,5250,5800,1900,11020000,2,42006,10503,1,411560000,411560000,15751,5250,10501,5250,0,1,5252,1515447
168,5250,5800,1900,11020000,2,42006,10503,1,411560000,411560000,15751,5250,10501,5250,0,1,5252,1484636
168,5250,5800,1900,11020000,2,42006,10503,1,411560000,411560000,15751,5250,10501,5250,0,1,5252,1488910
168,5250,5800,1900,11020000,2,42006,10503,1,411560000,411560000,15751,5250,10501,5250,0,1,5252,1516962
168,5250,5800,1900,11020000,2,42006,10503,1,411560000,411560000,15751,5250,10501,5250,0,1,5252,1507902
168,5250,5800,1900,11020000,2,42006,10503,1,411560000,411560000,15751,5250,10501,5250,0,1,5252,1509960
168,5650,5800,1900,11020000,2,45206,11303,1,436200000,436200000,16951,5650,11301,5650,0,1,5652,16195415
168,5650,5800,1900,11020000,2,45206,11303,1,436200000,436200000,16951,5650,11301,5650,0,1,5652,1610766
168,5650,5800,1900,11020000,2,45206,11303,1,436200000,436200000,16951,5650,11301,5650,0,1,5652,1619545
168,5650,5800,1900,11020000,2,45206,11303,1,436200000,436200000,16951,5650,11301,5650,0,1,5652,1621291
168,5650,5800,1900,11020000,2,45206,11303,1,436200000,436200000,16951,5650,11301,5650,0,1,5652,1612578
168,5650,5800,1900,11020000,2,45206,11303,1,436200000,436200000,16951,5650,11301,5650,0,1,5652,1608438
168,5650,5800,1900,11020000,2,45206,11303,1,436200000,436200000,16951,5650,11301,5650,0,1,5652,1599264
