168,50,2400,7100,17040000,2,406,103,1,140120000,140120000,151,50,101,50,0,1,52,195116
168,50,2400,7100,17040000,2,406,103,1,140120000,140120000,151,50,101,50,0,1,52,214138
168,50,2400,7100,17040000,2,406,103,1,140120000,140120000,151,50,101,50,0,1,52,214864
168,50,2400,7100,17040000,2,406,103,1,140120000,140120000,151,50,101,50,0,1,52,215024
168,50,2400,7100,17040000,2,406,103,1,140120000,140120000,151,50,101,50,0,1,52,214441
168,50,2400,7100,17040000,2,406,103,1,140120000,140120000,151,50,101,50,0,1,52,214568
168,50,2400,7100,17040000,2,406,103,1,140120000,140120000,151,50,101,50,0,1,52,214713
168,450,2400,7100,17040000,2,3606,903,1,170520000,170520000,1351,450,901,450,0,1,452,2040125
168,450,2400,7100,17040000,2,3606,903,1,170520000,170520000,1351,450,901,450,0,1,452,350685
168,450,2400,7100,17040000,2,3606,903,1,170520000,170520000,1351,450,901,450,0,1,452,352908
168,450,2400,7100,17040000,2,3606,903,1,170520000,170520000,1351,450,901,450,0,1,452,352022
168,450,2400,7100,17040000,2,3606,903,1,170520000,170520000,1351,450,901,450,0,1,452,354589
168,450,2400,7100,17040000,2,3606,903,1,170520000,170520000,1351,450,901,450,0,1,452,355958
168,450,2400,7100,17040000,2,3606,903,1,170520000,170520000,1351,450,901,450,0,1,452,355611
168,850,2400,7100,17040000,2,6806,1703,1,200920000,200920000,2551,850,1701,850,0,1,852,4182959
168,850,2400,7100,17040000,2,6806,1703,1,200920000,200920000,2551,850,1701,850,0,1,852,529742
168,850,2400,7100,17040000,2,6806,1703,1,200920000,200920000,2551,850,1701,850,0,1,852,528885
168,850,2400,7100,17040000,2,6806,1703,1,200920000,200920000,2551,850,1701,850,0,1,852,520929
168,850,2400,7100,17040000,2,6806,1703,1,200920000,200920000,2551,850,1701,850,0,1,852,523733
168,850,2400,7100,17040000,2,6806,1703,1,200920000,200920000,2551,850,1701,850,0,1,852,530259
168,850,2400,7100,17040000,2,6806,1703,1,200920000,200920000,2551,850,1701,850,0,1,852,530622
168,1250,2400,7100,17040000,2,10006,2503,1,231320000,231320000,3751,1250,2501,1250,0,1,1252,6373954
168,1250,2400,7100,17040000,2,10006,2503,1,231320000,231320000,3751,1250,2501,1250,0,1,1252,643895
168,1250,2400,7100,17040000,2,10006,2503,1,231320000,231320000,3751,1250,2501,1250,0,1,1252,644922
168,1250,2400,7100,17040000,2,10006,2503,1,231320000,231320000,3751,1250,2501,1250,0,1,1252,645399
168,1250,2400,7100,17040000,2,10006,2503,1,231320000,231320000,3751,1250,2501,1250,0,1,1252,646445
168,1250,2400,7100,17040000,2,10006,2503,1,231320000,231320000,3751,1250,2501,1250,0,1,1252,648028
168,1250,2400,7100,17040000,2,10006,2503,1,231320000,231320000,3751,1250,2501,1250,0,1,1252,648416
168,1650,2400,7100,17040000,2,13206,3303,1,261720000,261720000,4951,1650,3301,1650,0,1,1652,8441743
168,1650,2400,7100,17040000,2,13206,3303,1,261720000,261720000,4951,1650,3301,1650,0,1,1652,803755
168,1650,2400,7100,17040000,2,13206,3303,1,261720000,261720000,4951,1650,3301,1650,0,1,1652,802687
168,1650,2400,7100,17040000,2,13206,3303,1,261720000,261720000,4951,1650,3301,1650,0,1,1652,805053
168,1650,2400,7100,17040000,2,13206,3303,1,261720000,261720000,4951,1650,3301,1650,0,1,1652,804434
168,1650,2400,7100,17040000,2,13206,3303,1,261720000,261720000,4951,1650,3301,1650,0,1,1652,808117
168,1650,2400,7100,17040000,2,13206,3303,1,261720000,261720000,4951,1650,3301,1650,0,1,1652,808523
168,2050,2400,7100,17040000,2,16406,4103,1,292120000,292120000,6151,2050,4101,2050,0,1,2052,10490848
168,2050,2400,7100,17040000,2,16406,4103,1,292120000,292120000,6151,2050,4101,2050,0,1,2052,947351
168,2050,2400,7100,17040000,2,16406,4103,1,292120000,292120000,6151,2050,4101,2050,0,1,2052,945462
168,2050,2400,7100,17040000,2,16406,4103,1,292120000,292120000,6151,2050,4101,2050,0,1,2052,949023
168,2050,2400,7100,17040000,2,16406,4103,1,292120000,292120000,6151,2050,4101,2050,0,1,2052,948388
168,2050,2400,7100,17040000,2,16406,4103,1,292120000,292120000,6151,2050,4101,2050,0,1,2052,957819
168,2050,2400,7100,17040000,2,16406,4103,1,292120000,292120000,6151,2050,4101,2050,0,1,2052,957394
168,2450,2400,7100,17040000,2,19606,4903,1,322520000,322520000,7351,2450,4901,2450,0,1,2452,12591055
168,2450,2400,7100,17040000,2,19606,4903,1,322520000,322520000,7351,2450,4901,2450,0,1,2452,1121632
168,2450,2400,7100,17040000,2,19606,4903,1,322520000,322520000,7351,2450,4901,2450,0,1,2452,1121128
168,2450,2400,7100,17040000,2,19606,4903,1,322520000,322520000,7351,2450,4901,2450,0,1,2452,1122341
168,2450,2400,7100,17040000,2,19606,4903,1,322520000,322520000,7351,2450,4901,2450,0,1,2452,1119824
168,2450,2400,7100,17040000,2,19606,4903,1,322520000,322520000,7351,2450,4901,2450,0,1,2452,1123950
168,2450,2400,7100,17040000,2,19606,4903,1,322520000,322520000,7351,2450,4901,2450,0,1,2452,1124396
168,2850,2400,7100,17040000,2,22806,5703,1,352920000,352920000,8551,2850,5701,2850,0,1,2852,15136803
168,2850,2400,7100,17040000,2,22806,5703,1,352920000,352920000,8551,2850,5701,2850,0,1,2852,1283440
168,2850,2400,7100,17040000,2,22806,5703,1,352920000,352920000,8551,2850,5701,2850,0,1,2852,1288115
168,2850,2400,7100,17040000,2,22806,5703,1,352920000,352920000,8551,2850,5701,2850,0,1,2852,1285816
168,2850,2400,7100,17040000,2,22806,5703,1,352920000,352920000,8551,2850,5701,2850,0,1,2852,1288608
168,2850,2400,7100,17040000,2,22806,5703,1,352920000,352920000,8551,2850,5701,2850,0,1,2852,1290505
168,2850,2400,7100,17040000,2,22806,5703,1,352920000,352920000,8551,2850,5701,2850,0,1,2852,1290971
168,3250,2400,7100,17040000,2,26006,6503,1,383320000,383320000,9751,3250,6501,3250,0,1,3252,17620815
168,3250,2400,7100,17040000,2,26006,6503,1,383320000,383320000,9751,3250,6501,3250,0,1,3252,1445167
168,3250,2400,7100,17040000,2,26006,6503,1,383320000,383320000,9751,3250,6501,3250,0,1,3252,1444015
168,3250,2400,7100,17040000,2,26006,6503,1,383320000,383320000,9751,3250,6501,3250,0,1,3252,1445582
168,3250,2400,7100,17040000,2,26006,6503,1,383320000,383320000,9751,3250,6501,3250,0,1,3252,1444604
168,3250,2400,7100,17040000,2,26006,6503,1,383320000,383320000,9751,3250,6501,3250,0,1,3252,1442215
168,3250,2400,7100,17040000,2,26006,6503,1,383320000,383320000,9751,3250,6501,3250,0,1,3252,1440521
168,3650,2400,7100,17040000,2,29206,7303,1,413720000,413720000,10951,3650,7301,3650,0,1,3652,18955577
168,3650,2400,7100,17040000,2,29206,7303,1,413720000,413720000,10951,3650,7301,3650,0,1,3652,1600126
168,3650,2400,7100,17040000,2,29206,7303,1,413720000,413720000,10951,3650,7301,3650,0,1,3652,1592211
168,3650,2400,7100,17040000,2,29206,7303,1,413720000,413720000,10951,3650,7301,3650,0,1,3652,1553885
168,3650,2400,7100,17040000,2,29206,7303,1,413720000,413720000,10951,3650,7301,3650,0,1,3652,1602249
168,3650,2400,7100,17040000,2,29206,7303,1,413720000,413720000,10951,3650,7301,3650,0,1,3652,1598633
168,3650,2400,7100,17040000,2,29206,7303,1,413720000,413720000,10951,3650,7301,3650,0,1,3652,1598310
168,4050,2400,7100,17040000,2,32406,8103,1,444120000,444120000,12151,4050,8101,4050,0,1,4052,21731108
168,4050,2400,7100,17040000,2,32406,8103,1,444120000,444120000,12151,4050,8101,4050,0,1,4052,1737254
168,4050,2400,7100,17040000,2,32406,8103,1,444120000,444120000,12151,4050,8101,4050,0,1,4052,1734726
168,4050,2400,7100,17040000,2,32406,8103,1,444120000,444120000,12151,4050,8101,4050,0,1,4052,1738723
168,4050,2400,7100,17040000,2,32406,8103,1,444120000,444120000,12151,4050,8101,4050,0,1,4052,1738011
168,4050,2400,7100,17040000,2,32406,8103,1,444120000,444120000,12151,4050,8101,4050,0,1,4052,1732888
168,4050,2400,7100,17040000,2,32406,8103,1,444120000,444120000,12151,4050,8101,4050,0,1,4052,1731194
168,4450,2400,7100,17040000,2,35606,8903,1,474520000,474520000,13351,4450,8901,4450,0,1,4452,22941621
168,4450,2400,7100,17040000,2,35606,8903,1,474520000,474520000,13351,4450,8901,4450,0,1,4452,1953608
168,4450,2400,7100,17040000,2,35606,8903,1,474520000,474520000,13351,4450,8901,4450,0,1,4452,1948785
168,4450,2400,7100,17040000,2,35606,8903,1,474520000,474520000,13351,4450,8901,4450,0,1,4452,1955564
168,4450,2400,7100,17040000,2,35606,8903,1,474520000,474520000,13351,4450,8901,4450,0,1,4452,1956307
168,4450,2400,7100,17040000,2,35606,8903,1,474520000,474520000,13351,4450,8901,4450,0,1,4452,1906135
168,4450,2400,7100,17040000,2,35606,8903,1,474520000,474520000,13351,4450,8901,4450,0,1,4452,1904479
168,4850,2400,7100,17040000,2,38806,9703,1,504920000,504920000,14551,4850,9701,4850,0,1,4852,25338263
168,4850,2400,7100,17040000,2,38806,9703,1,504920000,504920000,14551,4850,9701,4850,0,1,4852,2060537
168,4850,2400,7100,17040000,2,38806,9703,1,504920000,504920000,14551,4850,9701,4850,0,1,4852,2055761
168,4850,2400,7100,17040000,2,38806,9703,1,504920000,504920000,14551,4850,9701,4850,0,1,4852,2063827
168,4850,2400,7100,17040000,2,38806,9703,1,504920000,504920000,14551,4850,9701,4850,0,1,4852,2061360
168,4850,2400,7100,17040000,2,38806,9703,1,504920000,504920000,14551,4850,9701,4850,0,1,4852,2033584
168,4850,2400,7100,17040000,2,38806,9703,1,504920000,504920000,14551,4850,9701,4850,0,1,4852,2031835
168,5250,2400,7100,17040000,2,42006,10503,1,535320000,535320000,15751,5250,10501,5250,0,1,5252,28013373
168,5250,2400,7100,17040000,2,42006,10503,1,535320000,535320000,15751,5250,10501,5250,0,1,5252,2299245
168,5250,2400,7100,17040000,2,42006,10503,1,535320000,535320000,15751,5250,10501,5250,0,1,5252,2295698
168,5250,2400,7100,17040000,2,42006,10503,1,535320000,535320000,15751,5250,10501,5250,0,1,5252,2301812
168,5250,2400,7100,17040000,2,42006,10503,1,535320000,535320000,15751,5250,10501,5250,0,1,5252,2278458
168,5250,2400,7100,17040000,2,42006,10503,1,535320000,535320000,15751,5250,10501,5250,0,1,5252,2247826
168,5250,2400,7100,17040000,2,42006,10503,1,535320000,535320000,15751,5250,10501,5250,0,1,5252,2245850
168,5650,2400,7100,17040000,2,45206,11303,1,565720000,565720000,16951,5650,11301,5650,0,1,5652,30582397
168,5650,2400,7100,17040000,2,45206,11303,1,565720000,565720000,16951,5650,11301,5650,0,1,5652,2413924
168,5650,2400,7100,17040000,2,45206,11303,1,565720000,565720000,16951,5650,11301,5650,0,1,5652,2410038
168,5650,2400,7100,17040000,2,45206,11303,1,565720000,565720000,16951,5650,11301,5650,0,1,5652,2418916
168,5650,2400,7100,17040000,2,45206,11303,1,565720000,565720000,16951,5650,11301,5650,0,1,5652,2418087
168,5650,2400,7100,17040000,2,45206,11303,1,565720000,565720000,16951,5650,11301,5650,0,1,5652,2348424
168,5650,2400,7100,17040000,2,45206,11303,1,565720000,565720000,16951,5650,11301,5650,0,1,5652,2355004
168,6050,2400,7100,17040000,2,48406,12103,1,596120000,596120000,18151,6050,12101,6050,0,1,6052,33067941
168,6050,2400,7100,17040000,2,48406,12103,1,596120000,596120000,18151,6050,12101,6050,0,1,6052,2522650
168,6050,2400,7100,17040000,2,48406,12103,1,596120000,596120000,18151,6050,12101,6050,0,1,6052,2516331
168,6050,2400,7100,17040000,2,48406,12103,1,596120000,596120000,18151,6050,12101,6050,0,1,6052,2525804
168,6050,2400,7100,17040000,2,48406,12103,1,596120000,596120000,18151,6050,12101,6050,0,1,6052,2524799
168,6050,2400,7100,17040000,2,48406,12103,1,596120000,596120000,18151,6050,12101,6050,0,1,6052,2472082
168,6050,2400,7100,17040000,2,48406,12103,1,596120000,596120000,18151,6050,12101,6050,0,1,6052,2473861
168,6450,2400,7100,17040000,2,51606,12903,1,626520000,626520000,19351,6450,12901,6450,0,1,6452,35837090
168,6450,2400,7100,17040000,2,51606,12903,1,626520000,626520000,19351,6450,12901,6450,0,1,6452,2732594
168,6450,2400,7100,17040000,2,51606,12903,1,626520000,626520000,19351,6450,12901,6450,0,1,6452,2731682
168,6450,2400,7100,17040000,2,51606,12903,1,626520000,626520000,19351,6450,12901,6450,0,1,6452,2717735
168,6450,2400,7100,17040000,2,51606,12903,1,626520000,626520000,19351,6450,12901,6450,0,1,6452,2680281
168,6450,2400,7100,17040000,2,51606,12903,1,626520000,626520000,19351,6450,12901,6450,0,1,6452,2678079
168,6450,2400,7100,17040000,2,51606,12903,1,626520000,626520000,19351,6450,12901,6450,0,1,6452,2657306
168,6850,2400,7100,17040000,2,54806,13703,1,656920000,656920000,20551,6850,13701,6850,0,1,6852,37230727
168,6850,2400,7100,17040000,2,54806,13703,1,656920000,656920000,20551,6850,13701,6850,0,1,6852,2911245
168,6850,2400,7100,17040000,2,54806,13703,1,656920000,656920000,20551,6850,13701,6850,0,1,6852,2913411
168,6850,2400,7100,17040000,2,54806,13703,1,656920000,656920000,20551,6850,13701,6850,0,1,6852,2916984
168,6850,2400,7100,17040000,2,54806,13703,1,656920000,656920000,20551,6850,13701,6850,0,1,6852,2916041
168,6850,2400,7100,17040000,2,54806,13703,1,656920000,656920000,20551,6850,13701,6850,0,1,6852,2830615
168,6850,2400,7100,17040000,2,54806,13703,1,656920000,656920000,20551,6850,13701,6850,0,1,6852,2832528
168,50,2400,6700,16080000,2,406,103,1,132280000,132280000,151,50,101,50,0,1,52,193759
168,50,2400,6700,16080000,2,406,103,1,132280000,132280000,151,50,101,50,0,1,52,156340
168,50,2400,6700,16080000,2,406,103,1,132280000,132280000,151,50,101,50,0,1,52,159960
168,50,2400,6700,16080000,2,406,103,1,132280000,132280000,151,50,101,50,0,1,52,160365
168,50,2400,6700,16080000,2,406,103,1,132280000,132280000,151,50,101,50,0,1,52,140972
168,50,2400,6700,16080000,2,406,103,1,132280000,132280000,151,50,101,50,0,1,52,198357
168,50,2400,6700,16080000,2,406,103,1,132280000,132280000,151,50,101,50,0,1,52,197931
168,450,2400,6700,16080000,2,3606,903,1,161400000,161400000,1351,450,901,450,0,1,452,1831687
168,450,2400,6700,16080000,2,3606,903,1,161400000,161400000,1351,450,901,450,0,1,452,327772
168,450,2400,6700,16080000,2,3606,903,1,161400000,161400000,1351,450,901,450,0,1,452,327004
168,450,2400,6700,16080000,2,3606,903,1,161400000,161400000,1351,450,901,450,0,1,452,324026
168,450,2400,6700,16080000,2,3606,903,1,161400000,161400000,1351,450,901,450,0,1,452,326434
168,450,2400,6700,16080000,2,3606,903,1,161400000,161400000,1351,450,901,450,0,1,452,329530
168,450,2400,6700,16080000,2,3606,903,1,161400000,161400000,1351,450,901,450,0,1,452,330023
168,850,2400,6700,16080000,2,6806,1703,1,190520000,190520000,2551,850,1701,850,0,1,852,3804500
168,850,2400,6700,16080000,2,6806,1703,1,190520000,190520000,2551,850,1701,850,0,1,852,464351
168,850,2400,6700,16080000,2,6806,1703,1,190520000,190520000,2551,850,1701,850,0,1,852,465160
168,850,2400,6700,16080000,2,6806,1703,1,190520000,190520000,2551,850,1701,850,0,1,852,440371
168,850,2400,6700,16080000,2,6806,1703,1,190520000,190520000,2551,850,1701,850,0,1,852,456740
168,850,2400,6700,16080000,2,6806,1703,1,190520000,190520000,2551,850,1701,850,0,1,852,467674
168,850,2400,6700,16080000,2,6806,1703,1,190520000,190520000,2551,850,1701,850,0,1,852,468039
168,1250,2400,6700,16080000,2,10006,2503,1,219640000,219640000,3751,1250,2501,1250,0,1,1252,5935499
168,1250,2400,6700,16080000,2,10006,2503,1,219640000,219640000,3751,1250,2501,1250,0,1,1252,619404
168,1250,2400,6700,16080000,2,10006,2503,1,219640000,219640000,3751,1250,2501,1250,0,1,1252,616650
168,1250,2400,6700,16080000,2,10006,2503,1,219640000,219640000,3751,1250,2501,1250,0,1,1252,618917
168,1250,2400,6700,16080000,2,10006,2503,1,219640000,219640000,3751,1250,2501,1250,0,1,1252,617860
168,1250,2400,6700,16080000,2,10006,2503,1,219640000,219640000,3751,1250,2501,1250,0,1,1252,622319
168,1250,2400,6700,16080000,2,10006,2503,1,219640000,219640000,3751,1250,2501,1250,0,1,1252,622708
168,1650,2400,6700,16080000,2,13206,3303,1,248760000,248760000,4951,1650,3301,1650,0,1,1652,7469192
168,1650,2400,6700,16080000,2,13206,3303,1,248760000,248760000,4951,1650,3301,1650,0,1,1652,773696
168,1650,2400,6700,16080000,2,13206,3303,1,248760000,248760000,4951,1650,3301,1650,0,1,1652,767966
168,1650,2400,6700,16080000,2,13206,3303,1,248760000,248760000,4951,1650,3301,1650,0,1,1652,777240
168,1650,2400,6700,16080000,2,13206,3303,1,248760000,248760000,4951,1650,3301,1650,0,1,1652,725811
168,1650,2400,6700,16080000,2,13206,3303,1,248760000,248760000,4951,1650,3301,1650,0,1,1652,789748
168,1650,2400,6700,16080000,2,13206,3303,1,248760000,248760000,4951,1650,3301,1650,0,1,1652,791722
168,2050,2400,6700,16080000,2,16406,4103,1,277880000,277880000,6151,2050,4101,2050,0,1,2052,9645485
168,2050,2400,6700,16080000,2,16406,4103,1,277880000,277880000,6151,2050,4101,2050,0,1,2052,885416
168,2050,2400,6700,16080000,2,16406,4103,1,277880000,277880000,6151,2050,4101,2050,0,1,2052,878953
168,2050,2400,6700,16080000,2,16406,4103,1,277880000,277880000,6151,2050,4101,2050,0,1,2052,884807
168,2050,2400,6700,16080000,2,16406,4103,1,277880000,277880000,6151,2050,4101,2050,0,1,2052,883875
168,2050,2400,6700,16080000,2,16406,4103,1,277880000,277880000,6151,2050,4101,2050,0,1,2052,903778
168,2050,2400,6700,16080000,2,16406,4103,1,277880000,277880000,6151,2050,4101,2050,0,1,2052,904204
168,2450,2400,6700,16080000,2,19606,4903,1,307000000,307000000,7351,2450,4901,2450,0,1,2452,11441444
168,2450,2400,6700,16080000,2,19606,4903,1,307000000,307000000,7351,2450,4901,2450,0,1,2452,1055246
168,2450,2400,6700,16080000,2,19606,4903,1,307000000,307000000,7351,2450,4901,2450,0,1,2452,1053479
168,2450,2400,6700,16080000,2,19606,4903,1,307000000,307000000,7351,2450,4901,2450,0,1,2452,1060165
168,2450,2400,6700,16080000,2,19606,4903,1,307000000,307000000,7351,2450,4901,2450,0,1,2452,1059627
168,2450,2400,6700,16080000,2,19606,4903,1,307000000,307000000,7351,2450,4901,2450,0,1,2452,1063217
168,2450,2400,6700,16080000,2,19606,4903,1,307000000,307000000,7351,2450,4901,2450,0,1,2452,1062770
168,2850,2400,6700,16080000,2,22806,5703,1,336120000,336120000,8551,2850,5701,2850,0,1,2852,13860865
168,2850,2400,6700,16080000,2,22806,5703,1,336120000,336120000,8551,2850,5701,2850,0,1,2852,1211685
168,2850,2400,6700,16080000,2,22806,5703,1,336120000,336120000,8551,2850,5701,2850,0,1,2852,1210056
168,2850,2400,6700,16080000,2,22806,5703,1,336120000,336120000,8551,2850,5701,2850,0,1,2852,1213728
168,2850,2400,6700,16080000,2,22806,5703,1,336120000,336120000,8551,2850,5701,2850,0,1,2852,1212321
168,2850,2400,6700,16080000,2,22806,5703,1,336120000,336120000,8551,2850,5701,2850,0,1,2852,1214790
168,2850,2400,6700,16080000,2,22806,5703,1,336120000,336120000,8551,2850,5701,2850,0,1,2852,1214320
168,3250,2400,6700,16080000,2,26006,6503,1,365240000,365240000,9751,3250,6501,3250,0,1,3252,16272719
168,3250,2400,6700,16080000,2,26006,6503,1,365240000,365240000,9751,3250,6501,3250,0,1,3252,1375499
168,3250,2400,6700,16080000,2,26006,6503,1,365240000,365240000,9751,3250,6501,3250,0,1,3252,1376469
168,3250,2400,6700,16080000,2,26006,6503,1,365240000,365240000,9751,3250,6501,3250,0,1,3252,1380755
168,3250,2400,6700,16080000,2,26006,6503,1,365240000,365240000,9751,3250,6501,3250,0,1,3252,1380132
168,3250,2400,6700,16080000,2,26006,6503,1,365240000,365240000,9751,3250,6501,3250,0,1,3252,1360686
168,3250,2400,6700,16080000,2,26006,6503,1,365240000,365240000,9751,3250,6501,3250,0,1,3252,1370774
168,3650,2400,6700,16080000,2,29206,7303,1,394360000,394360000,10951,3650,7301,3650,0,1,3652,17998738
168,3650,2400,6700,16080000,2,29206,7303,1,394360000,394360000,10951,3650,7301,3650,0,1,3652,1505666
168,3650,2400,6700,16080000,2,29206,7303,1,394360000,394360000,10951,3650,7301,3650,0,1,3652,1501279
168,3650,2400,6700,16080000,2,29206,7303,1,394360000,394360000,10951,3650,7301,3650,0,1,3652,1506310
168,3650,2400,6700,16080000,2,29206,7303,1,394360000,394360000,10951,3650,7301,3650,0,1,3652,1505119
168,3650,2400,6700,16080000,2,29206,7303,1,394360000,394360000,10951,3650,7301,3650,0,1,3652,1493665
168,3650,2400,6700,16080000,2,29206,7303,1,394360000,394360000,10951,3650,7301,3650,0,1,3652,1496625
168,4050,2400,6700,16080000,2,32406,8103,1,423480000,423480000,12151,4050,8101,4050,0,1,4052,20218866
168,4050,2400,6700,16080000,2,32406,8103,1,423480000,423480000,12151,4050,8101,4050,0,1,4052,1682316
168,4050,2400,6700,16080000,2,32406,8103,1,423480000,423480000,12151,4050,8101,4050,0,1,4052,1676300
168,4050,2400,6700,16080000,2,32406,8103,1,423480000,423480000,12151,4050,8101,4050,0,1,4052,1686336
168,4050,2400,6700,16080000,2,32406,8103,1,423480000,423480000,12151,4050,8101,4050,0,1,4052,1685634
168,4050,2400,6700,16080000,2,32406,8103,1,423480000,423480000,12151,4050,8101,4050,0,1,4052,1652758
168,4050,2400,6700,16080000,2,32406,8103,1,423480000,423480000,12151,4050,8101,4050,0,1,4052,1654269
168,4450,2400,6700,16080000,2,35606,8903,1,452600000,452600000,13351,4450,8901,4450,0,1,4452,22050018
168,4450,2400,6700,16080000,2,35606,8903,1,452600000,452600000,13351,4450,8901,4450,0,1,4452,1698511
168,4450,2400,6700,16080000,2,35606,8903,1,452600000,452600000,13351,4450,8901,4450,0,1,4452,1783605
168,4450,2400,6700,16080000,2,35606,8903,1,452600000,452600000,13351,4450,8901,4450,0,1,4452,1788171
168,4450,2400,6700,16080000,2,35606,8903,1,452600000,452600000,13351,4450,8901,4450,0,1,4452,1781159
168,4450,2400,6700,16080000,2,35606,8903,1,452600000,452600000,13351,4450,8901,4450,0,1,4452,1776784
168,4450,2400,6700,16080000,2,35606,8903,1,452600000,452600000,13351,4450,8901,4450,0,1,4452,1775605
168,4850,2400,6700,16080000,2,38806,9703,1,481720000,481720000,14551,4850,9701,4850,0,1,4852,24127218
168,4850,2400,6700,16080000,2,38806,9703,1,481720000,481720000,14551,4850,9701,4850,0,1,4852,1971982
168,4850,2400,6700,16080000,2,38806,9703,1,481720000,481720000,14551,4850,9701,4850,0,1,4852,1950261
168,4850,2400,6700,16080000,2,38806,9703,1,481720000,481720000,14551,4850,9701,4850,0,1,4852,1968257
168,4850,2400,6700,16080000,2,38806,9703,1,481720000,481720000,14551,4850,9701,4850,0,1,4852,1959352
168,4850,2400,6700,16080000,2,38806,9703,1,481720000,481720000,14551,4850,9701,4850,0,1,4852,1958086
168,4850,2400,6700,16080000,2,38806,9703,1,481720000,481720000,14551,4850,9701,4850,0,1,4852,1952777
168,5250,2400,6700,16080000,2,42006,10503,1,510840000,510840000,15751,5250,10501,5250,0,1,5252,26334082
168,5250,2400,6700,16080000,2,42006,10503,1,510840000,510840000,15751,5250,10501,5250,0,1,5252,2086344
168,5250,2400,6700,16080000,2,42006,10503,1,510840000,510840000,15751,5250,10501,5250,0,1,5252,2084636
168,5250,2400,6700,16080000,2,42006,10503,1,510840000,510840000,15751,5250,10501,5250,0,1,5252,2088673
168,5250,2400,6700,16080000,2,42006,10503,1,510840000,510840000,15751,5250,10501,5250,0,1,5252,2085646
168,5250,2400,6700,16080000,2,42006,10503,1,510840000,510840000,15751,5250,10501,5250,0,1,5252,2054577
168,5250,2400,6700,16080000,2,42006,10503,1,510840000,510840000,15751,5250,10501,5250,0,1,5252,2056276
168,5650,2400,6700,16080000,2,45206,11303,1,539960000,539960000,16951,5650,11301,5650,0,1,5652,28213435
168,5650,2400,6700,16080000,2,45206,11303,1,539960000,539960000,16951,5650,11301,5650,0,1,5652,2275654
168,5650,2400,6700,16080000,2,45206,11303,1,539960000,539960000,16951,5650,11301,5650,0,1,5652,2266227
168,5650,2400,6700,16080000,2,45206,11303,1,539960000,539960000,16951,5650,11301,5650,0,1,5652,2243531
168,5650,2400,6700,16080000,2,45206,11303,1,539960000,539960000,16951,5650,11301,5650,0,1,5652,2281166
168,5650,2400,6700,16080000,2,45206,11303,1,539960000,539960000,16951,5650,11301,5650,0,1,5652,2244887
168,5650,2400,6700,16080000,2,45206,11303,1,539960000,539960000,16951,5650,11301,5650,0,1,5652,2249382
168,6050,2400,6700,16080000,2,48406,12103,1,569080000,569080000,18151,6050,12101,6050,0,1,6052,30133606
168,6050,2400,6700,16080000,2,48406,12103,1,569080000,569080000,18151,6050,12101,6050,0,1,6052,2428232
168,6050,2400,6700,16080000,2,48406,12103,1,569080000,569080000,18151,6050,12101,6050,0,1,6052,2427350
168,6050,2400,6700,16080000,2,48406,12103,1,569080000,569080000,18151,6050,12101,6050,0,1,6052,2391054
168,6050,2400,6700,16080000,2,48406,12103,1,569080000,569080000,18151,6050,12101,6050,0,1,6052,2423194
168,6050,2400,6700,16080000,2,48406,12103,1,569080000,569080000,18151,6050,12101,6050,0,1,6052,2381146
168,6050,2400,6700,16080000,2,48406,12103,1,569080000,569080000,18151,6050,12101,6050,0,1,6052,2389165
168,6450,2400,6700,16080000,2,51606,12903,1,598200000,598200000,19351,6450,12901,6450,0,1,6452,31466005
168,6450,2400,6700,16080000,2,51606,12903,1,598200000,598200000,19351,6450,12901,6450,0,1,6452,2589687
168,6450,2400,6700,16080000,2,51606,12903,1,598200000,598200000,19351,6450,12901,6450,0,1,6452,2590603
168,6450,2400,6700,16080000,2,51606,12903,1,598200000,598200000,19351,6450,12901,6450,0,1,6452,2550009
168,6450,2400,6700,16080000,2,51606,12903,1,598200000,598200000,19351,6450,12901,6450,0,1,6452,2584730
168,6450,2400,6700,16080000,2,51606,12903,1,598200000,598200000,19351,6450,12901,6450,0,1,6452,2540527
168,6450,2400,6700,16080000,2,51606,12903,1,598200000,598200000,19351,6450,12901,6450,0,1,6452,2542546
168,6850,2400,6700,16080000,2,54806,13703,1,627320000,627320000,20551,6850,13701,6850,0,1,6852,33336179
168,6850,2400,6700,16080000,2,54806,13703,1,627320000,627320000,20551,6850,13701,6850,0,1,6852,2707073
168,6850,2400,6700,16080000,2,54806,13703,1,627320000,627320000,20551,6850,13701,6850,0,1,6852,2692869
168,6850,2400,6700,16080000,2,54806,13703,1,627320000,627320000,20551,6850,13701,6850,0,1,6852,2662049
168,6850,2400,6700,16080000,2,54806,13703,1,627320000,627320000,20551,6850,13701,6850,0,1,6852,2706133
168,6850,2400,6700,16080000,2,54806,13703,1,627320000,627320000,20551,6850,13701,6850,0,1,6852,2657550
168,6850,2400,6700,16080000,2,54806,13703,1,627320000,627320000,20551,6850,13701,6850,0,1,6852,2659610
168,50,2400,6300,15120000,2,406,103,1,124440000,124440000,151,50,101,50,0,1,52,176164
168,50,2400,6300,15120000,2,406,103,1,124440000,124440000,151,50,101,50,0,1,52,128631
168,50,2400,6300,15120000,2,406,103,1,124440000,124440000,151,50,101,50,0,1,52,147155
168,50,2400,6300,15120000,2,406,103,1,124440000,124440000,151,50,101,50,0,1,52,144720
168,50,2400,6300,15120000,2,406,103,1,124440000,124440000,151,50,101,50,0,1,52,145126
168,50,2400,6300,15120000,2,406,103,1,124440000,124440000,151,50,101,50,0,1,52,184663
168,50,2400,6300,15120000,2,406,103,1,124440000,124440000,151,50,101,50,0,1,52,176502
168,450,2400,6300,15120000,2,3606,903,1,152280000,152280000,1351,450,901,450,0,1,452,1708454
168,450,2400,6300,15120000,2,3606,903,1,152280000,152280000,1351,450,901,450,0,1,452,298992
168,450,2400,6300,15120000,2,3606,903,1,152280000,152280000,1351,450,901,450,0,1,452,301342
168,450,2400,6300,15120000,2,3606,903,1,152280000,152280000,1351,450,901,450,0,1,452,301708
168,450,2400,6300,15120000,2,3606,903,1,152280000,152280000,1351,450,901,450,0,1,452,300605
168,450,2400,6300,15120000,2,3606,903,1,152280000,152280000,1351,450,901,450,0,1,452,303799
168,450,2400,6300,15120000,2,3606,903,1,152280000,152280000,1351,450,901,450,0,1,452,304144
168,850,2400,6300,15120000,2,6806,1703,1,180120000,180120000,2551,850,1701,850,0,1,852,3402892
168,850,2400,6300,15120000,2,6806,1703,1,180120000,180120000,2551,850,1701,850,0,1,852,468604
168,850,2400,6300,15120000,2,6806,1703,1,180120000,180120000,2551,850,1701,850,0,1,852,472292
168,850,2400,6300,15120000,2,6806,1703,1,180120000,180120000,2551,850,1701,850,0,1,852,472496
168,850,2400,6300,15120000,2,6806,1703,1,180120000,180120000,2551,850,1701,850,0,1,852,472722
168,850,2400,6300,15120000,2,6806,1703,1,180120000,180120000,2551,850,1701,850,0,1,852,470524
168,850,2400,6300,15120000,2,6806,1703,1,180120000,180120000,2551,850,1701,850,0,1,852,471922
168,1250,2400,6300,15120000,2,10006,2503,1,207960000,207960000,3751,1250,2501,1250,0,1,1252,5264675
168,1250,2400,6300,15120000,2,10006,2503,1,207960000,207960000,3751,1250,2501,1250,0,1,1252,578666
168,1250,2400,6300,15120000,2,10006,2503,1,207960000,207960000,3751,1250,2501,1250,0,1,1252,579083
168,1250,2400,6300,15120000,2,10006,2503,1,207960000,207960000,3751,1250,2501,1250,0,1,1252,580056
168,1250,2400,6300,15120000,2,10006,2503,1,207960000,207960000,3751,1250,2501,1250,0,1,1252,576557
168,1250,2400,6300,15120000,2,10006,2503,1,207960000,207960000,3751,1250,2501,1250,0,1,1252,582282
168,1250,2400,6300,15120000,2,10006,2503,1,207960000,207960000,3751,1250,2501,1250,0,1,1252,581617
168,1650,2400,6300,15120000,2,13206,3303,1,235800000,235800000,4951,1650,3301,1650,0,1,1652,7043461
168,1650,2400,6300,15120000,2,13206,3303,1,235800000,235800000,4951,1650,3301,1650,0,1,1652,698211
168,1650,2400,6300,15120000,2,13206,3303,1,235800000,235800000,4951,1650,3301,1650,0,1,1652,691138
168,1650,2400,6300,15120000,2,13206,3303,1,235800000,235800000,4951,1650,3301,1650,0,1,1652,697206
168,1650,2400,6300,15120000,2,13206,3303,1,235800000,235800000,4951,1650,3301,1650,0,1,1652,698830
168,1650,2400,6300,15120000,2,13206,3303,1,235800000,235800000,4951,1650,3301,1650,0,1,1652,713255
168,1650,2400,6300,15120000,2,13206,3303,1,235800000,235800000,4951,1650,3301,1650,0,1,1652,712849
168,2050,2400,6300,15120000,2,16406,4103,1,263640000,263640000,6151,2050,4101,2050,0,1,2052,9172157
168,2050,2400,6300,15120000,2,16406,4103,1,263640000,263640000,6151,2050,4101,2050,0,1,2052,843999
168,2050,2400,6300,15120000,2,16406,4103,1,263640000,263640000,6151,2050,4101,2050,0,1,2052,843040
168,2050,2400,6300,15120000,2,16406,4103,1,263640000,263640000,6151,2050,4101,2050,0,1,2052,844612
168,2050,2400,6300,15120000,2,16406,4103,1,263640000,263640000,6151,2050,4101,2050,0,1,2052,841959
168,2050,2400,6300,15120000,2,16406,4103,1,263640000,263640000,6151,2050,4101,2050,0,1,2052,859467
168,2050,2400,6300,15120000,2,16406,4103,1,263640000,263640000,6151,2050,4101,2050,0,1,2052,859043
168,2450,2400,6300,15120000,2,19606,4903,1,291480000,291480000,7351,2450,4901,2450,0,1,2452,10659254
168,2450,2400,6300,15120000,2,19606,4903,1,291480000,291480000,7351,2450,4901,2450,0,1,2452,992577
168,2450,2400,6300,15120000,2,19606,4903,1,291480000,291480000,7351,2450,4901,2450,0,1,2452,989938
168,2450,2400,6300,15120000,2,19606,4903,1,291480000,291480000,7351,2450,4901,2450,0,1,2452,993411
168,2450,2400,6300,15120000,2,19606,4903,1,291480000,291480000,7351,2450,4901,2450,0,1,2452,991344
168,2450,2400,6300,15120000,2,19606,4903,1,291480000,291480000,7351,2450,4901,2450,0,1,2452,999278
168,2450,2400,6300,15120000,2,19606,4903,1,291480000,291480000,7351,2450,4901,2450,0,1,2452,999721
168,2850,2400,6300,15120000,2,22806,5703,1,319320000,319320000,8551,2850,5701,2850,0,1,2852,11984225
168,2850,2400,6300,15120000,2,22806,5703,1,319320000,319320000,8551,2850,5701,2850,0,1,2852,1170026
168,2850,2400,6300,15120000,2,22806,5703,1,319320000,319320000,8551,2850,5701,2850,0,1,2852,1175485
168,2850,2400,6300,15120000,2,22806,5703,1,319320000,319320000,8551,2850,5701,2850,0,1,2852,1177032
168,2850,2400,6300,15120000,2,22806,5703,1,319320000,319320000,8551,2850,5701,2850,0,1,2852,1160690
168,2850,2400,6300,15120000,2,22806,5703,1,319320000,319320000,8551,2850,5701,2850,0,1,2852,1178020
168,2850,2400,6300,15120000,2,22806,5703,1,319320000,319320000,8551,2850,5701,2850,0,1,2852,1178490
168,3250,2400,6300,15120000,2,26006,6503,1,347160000,347160000,9751,3250,6501,3250,0,1,3252,15389648
168,3250,2400,6300,15120000,2,26006,6503,1,347160000,347160000,9751,3250,6501,3250,0,1,3252,1284438
168,3250,2400,6300,15120000,2,26006,6503,1,347160000,347160000,9751,3250,6501,3250,0,1,3252,1281922
168,3250,2400,6300,15120000,2,26006,6503,1,347160000,347160000,9751,3250,6501,3250,0,1,3252,1285409
168,3250,2400,6300,15120000,2,26006,6503,1,347160000,347160000,9751,3250,6501,3250,0,1,3252,1283949
168,3250,2400,6300,15120000,2,26006,6503,1,347160000,347160000,9751,3250,6501,3250,0,1,3252,1287534
168,3250,2400,6300,15120000,2,26006,6503,1,347160000,347160000,9751,3250,6501,3250,0,1,3252,1287050
168,3650,2400,6300,15120000,2,29206,7303,1,375000000,375000000,10951,3650,7301,3650,0,1,3652,16921222
168,3650,2400,6300,15120000,2,29206,7303,1,375000000,375000000,10951,3650,7301,3650,0,1,3652,1425197
168,3650,2400,6300,15120000,2,29206,7303,1,375000000,375000000,10951,3650,7301,3650,0,1,3652,1423565
168,3650,2400,6300,15120000,2,29206,7303,1,375000000,375000000,10951,3650,7301,3650,0,1,3652,1426246
168,3650,2400,6300,15120000,2,29206,7303,1,375000000,375000000,10951,3650,7301,3650,0,1,3652,1425789
168,3650,2400,6300,15120000,2,29206,7303,1,375000000,375000000,10951,3650,7301,3650,0,1,3652,1423295
168,3650,2400,6300,15120000,2,29206,7303,1,375000000,375000000,10951,3650,7301,3650,0,1,3652,1421336
168,4050,2400,6300,15120000,2,32406,8103,1,402840000,402840000,12151,4050,8101,4050,0,1,4052,19590329
168,4050,2400,6300,15120000,2,32406,8103,1,402840000,402840000,12151,4050,8101,4050,0,1,4052,1581220
168,4050,2400,6300,15120000,2,32406,8103,1,402840000,402840000,12151,4050,8101,4050,0,1,4052,1576234
168,4050,2400,6300,15120000,2,32406,8103,1,402840000,402840000,12151,4050,8101,4050,0,1,4052,1580514
168,4050,2400,6300,15120000,2,32406,8103,1,402840000,402840000,12151,4050,8101,4050,0,1,4052,1579769
168,4050,2400,6300,15120000,2,32406,8103,1,402840000,402840000,12151,4050,8101,4050,0,1,4052,1568886
168,4050,2400,6300,15120000,2,32406,8103,1,402840000,402840000,12151,4050,8101,4050,0,1,4052,1574824
168,4450,2400,6300,15120000,2,35606,8903,1,430680000,430680000,13351,4450,8901,4450,0,1,4452,20820992
168,4450,2400,6300,15120000,2,35606,8903,1,430680000,430680000,13351,4450,8901,4450,0,1,4452,1686728
168,4450,2400,6300,15120000,2,35606,8903,1,430680000,430680000,13351,4450,8901,4450,0,1,4452,1629309
168,4450,2400,6300,15120000,2,35606,8903,1,430680000,430680000,13351,4450,8901,4450,0,1,4452,1688949
168,4450,2400,6300,15120000,2,35606,8903,1,430680000,430680000,13351,4450,8901,4450,0,1,4452,1683755
168,4450,2400,6300,15120000,2,35606,8903,1,430680000,430680000,13351,4450,8901,4450,0,1,4452,1678842
168,4450,2400,6300,15120000,2,35606,8903,1,430680000,430680000,13351,4450,8901,4450,0,1,4452,1680359
168,4850,2400,6300,15120000,2,38806,9703,1,458520000,458520000,14551,4850,9701,4850,0,1,4852,21298713
168,4850,2400,6300,15120000,2,38806,9703,1,458520000,458520000,14551,4850,9701,4850,0,1,4852,1867106
168,4850,2400,6300,15120000,2,38806,9703,1,458520000,458520000,14551,4850,9701,4850,0,1,4852,1877096
168,4850,2400,6300,15120000,2,38806,9703,1,458520000,458520000,14551,4850,9701,4850,0,1,4852,1882772
168,4850,2400,6300,15120000,2,38806,9703,1,458520000,458520000,14551,4850,9701,4850,0,1,4852,1883545
168,4850,2400,6300,15120000,2,38806,9703,1,458520000,458520000,14551,4850,9701,4850,0,1,4852,1857159
168,4850,2400,6300,15120000,2,38806,9703,1,458520000,458520000,14551,4850,9701,4850,0,1,4852,1858442
168,5250,2400,6300,15120000,2,42006,10503,1,486360000,486360000,15751,5250,10501,5250,0,1,5252,24663853
168,5250,2400,6300,15120000,2,42006,10503,1,486360000,486360000,15751,5250,10501,5250,0,1,5252,1977665
168,5250,2400,6300,15120000,2,42006,10503,1,486360000,486360000,15751,5250,10501,5250,0,1,5252,1976837
168,5250,2400,6300,15120000,2,42006,10503,1,486360000,486360000,15751,5250,10501,5250,0,1,5252,1980148
168,5250,2400,6300,15120000,2,42006,10503,1,486360000,486360000,15751,5250,10501,5250,0,1,5252,1972394
168,5250,2400,6300,15120000,2,42006,10503,1,486360000,486360000,15751,5250,10501,5250,0,1,5252,1960121
168,5250,2400,6300,15120000,2,42006,10503,1,486360000,486360000,15751,5250,10501,5250,0,1,5252,1961861
168,5650,2400,6300,15120000,2,45206,11303,1,514200000,514200000,16951,5650,11301,5650,0,1,5652,26211827
168,5650,2400,6300,15120000,2,45206,11303,1,514200000,514200000,16951,5650,11301,5650,0,1,5652,2134619
168,5650,2400,6300,15120000,2,45206,11303,1,514200000,514200000,16951,5650,11301,5650,0,1,5652,2141889
168,5650,2400,6300,15120000,2,45206,11303,1,514200000,514200000,16951,5650,11301,5650,0,1,5652,2148456
168,5650,2400,6300,15120000,2,45206,11303,1,514200000,514200000,16951,5650,11301,5650,0,1,5652,2149301
168,5650,2400,6300,15120000,2,45206,11303,1,514200000,514200000,16951,5650,11301,5650,0,1,5652,2119410
168,5650,2400,6300,15120000,2,45206,11303,1,514200000,514200000,16951,5650,11301,5650,0,1,5652,2123735
168,6050,2400,6300,15120000,2,48406,12103,1,542040000,542040000,18151,6050,12101,6050,0,1,6052,27557552
168,6050,2400,6300,15120000,2,48406,12103,1,542040000,542040000,18151,6050,12101,6050,0,1,6052,2293143
168,6050,2400,6300,15120000,2,48406,12103,1,542040000,542040000,18151,6050,12101,6050,0,1,6052,2297110
168,6050,2400,6300,15120000,2,48406,12103,1,542040000,542040000,18151,6050,12101,6050,0,1,6052,2301379
168,6050,2400,6300,15120000,2,48406,12103,1,542040000,542040000,18151,6050,12101,6050,0,1,6052,2288229
168,6050,2400,6300,15120000,2,48406,12103,1,542040000,542040000,18151,6050,12101,6050,0,1,6052,2260175
168,6050,2400,6300,15120000,2,48406,12103,1,542040000,542040000,18151,6050,12101,6050,0,1,6052,2254159
168,6450,2400,6300,15120000,2,51606,12903,1,569880000,569880000,19351,6450,12901,6450,0,1,6452,30100390
168,6450,2400,6300,15120000,2,51606,12903,1,569880000,569880000,19351,6450,12901,6450,0,1,6452,2397357
168,6450,2400,6300,15120000,2,51606,12903,1,569880000,569880000,19351,6450,12901,6450,0,1,6452,2396299
168,6450,2400,6300,15120000,2,51606,12903,1,569880000,569880000,19351,6450,12901,6450,0,1,6452,2402167
168,6450,2400,6300,15120000,2,51606,12903,1,569880000,569880000,19351,6450,12901,6450,0,1,6452,2401259
168,6450,2400,6300,15120000,2,51606,12903,1,569880000,569880000,19351,6450,12901,6450,0,1,6452,2356949
168,6450,2400,6300,15120000,2,51606,12903,1,569880000,569880000,19351,6450,12901,6450,0,1,6452,2358778
168,6850,2400,6300,15120000,2,54806,13703,1,597720000,597720000,20551,6850,13701,6850,0,1,6852,31748833
168,6850,2400,6300,15120000,2,54806,13703,1,597720000,597720000,20551,6850,13701,6850,0,1,6852,2579698
168,6850,2400,6300,15120000,2,54806,13703,1,597720000,597720000,20551,6850,13701,6850,0,1,6852,2582879
168,6850,2400,6300,15120000,2,54806,13703,1,597720000,597720000,20551,6850,13701,6850,0,1,6852,2587030
168,6850,2400,6300,15120000,2,54806,13703,1,597720000,597720000,20551,6850,13701,6850,0,1,6852,2575524
168,6850,2400,6300,15120000,2,54806,13703,1,597720000,597720000,20551,6850,13701,6850,0,1,6852,2525456
168,6850,2400,6300,15120000,2,54806,13703,1,597720000,597720000,20551,6850,13701,6850,0,1,6852,2518253
168,50,2400,5900,14160000,2,406,103,1,116600000,116600000,151,50,101,50,0,1,52,161423
168,50,2400,5900,14160000,2,406,103,1,116600000,116600000,151,50,101,50,0,1,52,159098
168,50,2400,5900,14160000,2,406,103,1,116600000,116600000,151,50,101,50,0,1,52,158688
168,50,2400,5900,14160000,2,406,103,1,116600000,116600000,151,50,101,50,0,1,52,142839
168,50,2400,5900,14160000,2,406,103,1,116600000,116600000,151,50,101,50,0,1,52,156359
168,50,2400,5900,14160000,2,406,103,1,116600000,116600000,151,50,101,50,0,1,52,190265
168,50,2400,5900,14160000,2,406,103,1,116600000,116600000,151,50,101,50,0,1,52,190686
168,450,2400,5900,14160000,2,3606,903,1,143160000,143160000,1351,450,901,450,0,1,452,1521289
168,450,2400,5900,14160000,2,3606,903,1,143160000,143160000,1351,450,901,450,0,1,452,280988
168,450,2400,5900,14160000,2,3606,903,1,143160000,143160000,1351,450,901,450,0,1,452,282776
168,450,2400,5900,14160000,2,3606,903,1,143160000,143160000,1351,450,901,450,0,1,452,281712
168,450,2400,5900,14160000,2,3606,903,1,143160000,143160000,1351,450,901,450,0,1,452,282970
168,450,2400,5900,14160000,2,3606,903,1,143160000,143160000,1351,450,901,450,0,1,452,284329
168,450,2400,5900,14160000,2,3606,903,1,143160000,143160000,1351,450,901,450,0,1,452,284674
168,850,2400,5900,14160000,2,6806,1703,1,169720000,169720000,2551,850,1701,850,0,1,852,3256362
168,850,2400,5900,14160000,2,6806,1703,1,169720000,169720000,2551,850,1701,850,0,1,852,422955
168,850,2400,5900,14160000,2,6806,1703,1,169720000,169720000,2551,850,1701,850,0,1,852,421094
168,850,2400,5900,14160000,2,6806,1703,1,169720000,169720000,2551,850,1701,850,0,1,852,423747
168,850,2400,5900,14160000,2,6806,1703,1,169720000,169720000,2551,850,1701,850,0,1,852,423969
168,850,2400,5900,14160000,2,6806,1703,1,169720000,169720000,2551,850,1701,850,0,1,852,424562
168,850,2400,5900,14160000,2,6806,1703,1,169720000,169720000,2551,850,1701,850,0,1,852,424929
168,1250,2400,5900,14160000,2,10006,2503,1,196280000,196280000,3751,1250,2501,1250,0,1,1252,4879312
168,1250,2400,5900,14160000,2,10006,2503,1,196280000,196280000,3751,1250,2501,1250,0,1,1252,555553
168,1250,2400,5900,14160000,2,10006,2503,1,196280000,196280000,3751,1250,2501,1250,0,1,1252,556493
168,1250,2400,5900,14160000,2,10006,2503,1,196280000,196280000,3751,1250,2501,1250,0,1,1252,558665
168,1250,2400,5900,14160000,2,10006,2503,1,196280000,196280000,3751,1250,2501,1250,0,1,1252,558242
168,1250,2400,5900,14160000,2,10006,2503,1,196280000,196280000,3751,1250,2501,1250,0,1,1252,558838
168,1250,2400,5900,14160000,2,10006,2503,1,196280000,196280000,3751,1250,2501,1250,0,1,1252,559038
168,1650,2400,5900,14160000,2,13206,3303,1,222840000,222840000,4951,1650,3301,1650,0,1,1652,6483673
168,1650,2400,5900,14160000,2,13206,3303,1,222840000,222840000,4951,1650,3301,1650,0,1,1652,703202
168,1650,2400,5900,14160000,2,13206,3303,1,222840000,222840000,4951,1650,3301,1650,0,1,1652,700194
168,1650,2400,5900,14160000,2,13206,3303,1,222840000,222840000,4951,1650,3301,1650,0,1,1652,681875
168,1650,2400,5900,14160000,2,13206,3303,1,222840000,222840000,4951,1650,3301,1650,0,1,1652,703769
168,1650,2400,5900,14160000,2,13206,3303,1,222840000,222840000,4951,1650,3301,1650,0,1,1652,705040
168,1650,2400,5900,14160000,2,13206,3303,1,222840000,222840000,4951,1650,3301,1650,0,1,1652,705452
168,2050,2400,5900,14160000,2,16406,4103,1,249400000,249400000,6151,2050,4101,2050,0,1,2052,8546741
168,2050,2400,5900,14160000,2,16406,4103,1,249400000,249400000,6151,2050,4101,2050,0,1,2052,798909
168,2050,2400,5900,14160000,2,16406,4103,1,249400000,249400000,6151,2050,4101,2050,0,1,2052,794118
168,2050,2400,5900,14160000,2,16406,4103,1,249400000,249400000,6151,2050,4101,2050,0,1,2052,799505
168,2050,2400,5900,14160000,2,16406,4103,1,249400000,249400000,6151,2050,4101,2050,0,1,2052,798084
168,2050,2400,5900,14160000,2,16406,4103,1,249400000,249400000,6151,2050,4101,2050,0,1,2052,806566
168,2050,2400,5900,14160000,2,16406,4103,1,249400000,249400000,6151,2050,4101,2050,0,1,2052,806143
168,2450,2400,5900,14160000,2,19606,4903,1,275960000,275960000,7351,2450,4901,2450,0,1,2452,9709721
168,2450,2400,5900,14160000,2,19606,4903,1,275960000,275960000,7351,2450,4901,2450,0,1,2452,928023
168,2450,2400,5900,14160000,2,19606,4903,1,275960000,275960000,7351,2450,4901,2450,0,1,2452,918911
168,2450,2400,5900,14160000,2,19606,4903,1,275960000,275960000,7351,2450,4901,2450,0,1,2452,929210
168,2450,2400,5900,14160000,2,19606,4903,1,275960000,275960000,7351,2450,4901,2450,0,1,2452,927073
168,2450,2400,5900,14160000,2,19606,4903,1,275960000,275960000,7351,2450,4901,2450,0,1,2452,941562
168,2450,2400,5900,14160000,2,19606,4903,1,275960000,275960000,7351,2450,4901,2450,0,1,2452,942009
168,2850,2400,5900,14160000,2,22806,5703,1,302520000,302520000,8551,2850,5701,2850,0,1,2852,11646896
168,2850,2400,5900,14160000,2,22806,5703,1,302520000,302520000,8551,2850,5701,2850,0,1,2852,1062308
168,2850,2400,5900,14160000,2,22806,5703,1,302520000,302520000,8551,2850,5701,2850,0,1,2852,1060592
168,2850,2400,5900,14160000,2,22806,5703,1,302520000,302520000,8551,2850,5701,2850,0,1,2852,1067639
168,2850,2400,5900,14160000,2,22806,5703,1,302520000,302520000,8551,2850,5701,2850,0,1,2852,1066793
168,2850,2400,5900,14160000,2,22806,5703,1,302520000,302520000,8551,2850,5701,2850,0,1,2852,1070663
168,2850,2400,5900,14160000,2,22806,5703,1,302520000,302520000,8551,2850,5701,2850,0,1,2852,1071130
168,3250,2400,5900,14160000,2,26006,6503,1,329080000,329080000,9751,3250,6501,3250,0,1,3252,13211001
168,3250,2400,5900,14160000,2,26006,6503,1,329080000,329080000,9751,3250,6501,3250,0,1,3252,1228235
168,3250,2400,5900,14160000,2,26006,6503,1,329080000,329080000,9751,3250,6501,3250,0,1,3252,1233536
168,3250,2400,5900,14160000,2,26006,6503,1,329080000,329080000,9751,3250,6501,3250,0,1,3252,1234172
168,3250,2400,5900,14160000,2,26006,6503,1,329080000,329080000,9751,3250,6501,3250,0,1,3252,1226418
168,3250,2400,5900,14160000,2,26006,6503,1,329080000,329080000,9751,3250,6501,3250,0,1,3252,1232027
168,3250,2400,5900,14160000,2,26006,6503,1,329080000,329080000,9751,3250,6501,3250,0,1,3252,1227645
168,3650,2400,5900,14160000,2,29206,7303,1,355640000,355640000,10951,3650,7301,3650,0,1,3652,15482334
168,3650,2400,5900,14160000,2,29206,7303,1,355640000,355640000,10951,3650,7301,3650,0,1,3652,1338781
168,3650,2400,5900,14160000,2,29206,7303,1,355640000,355640000,10951,3650,7301,3650,0,1,3652,1335192
168,3650,2400,5900,14160000,2,29206,7303,1,355640000,355640000,10951,3650,7301,3650,0,1,3652,1339254
168,3650,2400,5900,14160000,2,29206,7303,1,355640000,355640000,10951,3650,7301,3650,0,1,3652,1338187
168,3650,2400,5900,14160000,2,29206,7303,1,355640000,355640000,10951,3650,7301,3650,0,1,3652,1334678
168,3650,2400,5900,14160000,2,29206,7303,1,355640000,355640000,10951,3650,7301,3650,0,1,3652,1332781
168,4050,2400,5900,14160000,2,32406,8103,1,382200000,382200000,12151,4050,8101,4050,0,1,4052,17244822
168,4050,2400,5900,14160000,2,32406,8103,1,382200000,382200000,12151,4050,8101,4050,0,1,4052,1443519
168,4050,2400,5900,14160000,2,32406,8103,1,382200000,382200000,12151,4050,8101,4050,0,1,4052,1438540
168,4050,2400,5900,14160000,2,32406,8103,1,382200000,382200000,12151,4050,8101,4050,0,1,4052,1442361
168,4050,2400,5900,14160000,2,32406,8103,1,382200000,382200000,12151,4050,8101,4050,0,1,4052,1438020
168,4050,2400,5900,14160000,2,32406,8103,1,382200000,382200000,12151,4050,8101,4050,0,1,4052,1445173
168,4050,2400,5900,14160000,2,32406,8103,1,382200000,382200000,12151,4050,8101,4050,0,1,4052,1444641
168,4450,2400,5900,14160000,2,35606,8903,1,408760000,408760000,13351,4450,8901,4450,0,1,4452,20047465
168,4450,2400,5900,14160000,2,35606,8903,1,408760000,408760000,13351,4450,8901,4450,0,1,4452,1600518
168,4450,2400,5900,14160000,2,35606,8903,1,408760000,408760000,13351,4450,8901,4450,0,1,4452,1616938
168,4450,2400,5900,14160000,2,35606,8903,1,408760000,408760000,13351,4450,8901,4450,0,1,4452,1623041
168,4450,2400,5900,14160000,2,35606,8903,1,408760000,408760000,13351,4450,8901,4450,0,1,4452,1622322
168,4450,2400,5900,14160000,2,35606,8903,1,408760000,408760000,13351,4450,8901,4450,0,1,4452,1611806
168,4450,2400,5900,14160000,2,35606,8903,1,408760000,408760000,13351,4450,8901,4450,0,1,4452,1618180
168,4850,2400,5900,14160000,2,38806,9703,1,435320000,435320000,14551,4850,9701,4850,0,1,4852,21028453
168,4850,2400,5900,14160000,2,38806,9703,1,435320000,435320000,14551,4850,9701,4850,0,1,4852,1719829
168,4850,2400,5900,14160000,2,38806,9703,1,435320000,435320000,14551,4850,9701,4850,0,1,4852,1715750
168,4850,2400,5900,14160000,2,38806,9703,1,435320000,435320000,14551,4850,9701,4850,0,1,4852,1722690
168,4850,2400,5900,14160000,2,38806,9703,1,435320000,435320000,14551,4850,9701,4850,0,1,4852,1721939
168,4850,2400,5900,14160000,2,38806,9703,1,435320000,435320000,14551,4850,9701,4850,0,1,4852,1704246
168,4850,2400,5900,14160000,2,38806,9703,1,435320000,435320000,14551,4850,9701,4850,0,1,4852,1705816
168,5250,2400,5900,14160000,2,42006,10503,1,461880000,461880000,15751,5250,10501,5250,0,1,5252,22643981
168,5250,2400,5900,14160000,2,42006,10503,1,461880000,461880000,15751,5250,10501,5250,0,1,5252,1883652
168,5250,2400,5900,14160000,2,42006,10503,1,461880000,461880000,15751,5250,10501,5250,0,1,5252,1889536
168,5250,2400,5900,14160000,2,42006,10503,1,461880000,461880000,15751,5250,10501,5250,0,1,5252,1890504
168,5250,2400,5900,14160000,2,42006,10503,1,461880000,461880000,15751,5250,10501,5250,0,1,5252,1878828
168,5250,2400,5900,14160000,2,42006,10503,1,461880000,461880000,15751,5250,10501,5250,0,1,5252,1876011
168,5250,2400,5900,14160000,2,42006,10503,1,461880000,461880000,15751,5250,10501,5250,0,1,5252,1864007
168,5650,2400,5900,14160000,2,45206,11303,1,488440000,488440000,16951,5650,11301,5650,0,1,5652,25474919
168,5650,2400,5900,14160000,2,45206,11303,1,488440000,488440000,16951,5650,11301,5650,0,1,5652,2009234
168,5650,2400,5900,14160000,2,45206,11303,1,488440000,488440000,16951,5650,11301,5650,0,1,5652,1996535
168,5650,2400,5900,14160000,2,45206,11303,1,488440000,488440000,16951,5650,11301,5650,0,1,5652,2010926
168,5650,2400,5900,14160000,2,45206,11303,1,488440000,488440000,16951,5650,11301,5650,0,1,5652,2010088
168,5650,2400,5900,14160000,2,45206,11303,1,488440000,488440000,16951,5650,11301,5650,0,1,5652,1951028
168,5650,2400,5900,14160000,2,45206,11303,1,488440000,488440000,16951,5650,11301,5650,0,1,5652,1971707
168,6050,2400,5900,14160000,2,48406,12103,1,515000000,515000000,18151,6050,12101,6050,0,1,6052,27023526
168,6050,2400,5900,14160000,2,48406,12103,1,515000000,515000000,18151,6050,12101,6050,0,1,6052,2135324
168,6050,2400,5900,14160000,2,48406,12103,1,515000000,515000000,18151,6050,12101,6050,0,1,6052,2130473
168,6050,2400,5900,14160000,2,48406,12103,1,515000000,515000000,18151,6050,12101,6050,0,1,6052,2138839
168,6050,2400,5900,14160000,2,48406,12103,1,515000000,515000000,18151,6050,12101,6050,0,1,6052,2136211
168,6050,2400,5900,14160000,2,48406,12103,1,515000000,515000000,18151,6050,12101,6050,0,1,6052,2117382
168,6050,2400,5900,14160000,2,48406,12103,1,515000000,515000000,18151,6050,12101,6050,0,1,6052,2094898
168,6450,2400,5900,14160000,2,51606,12903,1,541560000,541560000,19351,6450,12901,6450,0,1,6452,28293293
168,6450,2400,5900,14160000,2,51606,12903,1,541560000,541560000,19351,6450,12901,6450,0,1,6452,2288683
168,6450,2400,5900,14160000,2,51606,12903,1,541560000,541560000,19351,6450,12901,6450,0,1,6452,2272773
168,6450,2400,5900,14160000,2,51606,12903,1,541560000,541560000,19351,6450,12901,6450,0,1,6452,2287787
168,6450,2400,5900,14160000,2,51606,12903,1,541560000,541560000,19351,6450,12901,6450,0,1,6452,2286881
168,6450,2400,5900,14160000,2,51606,12903,1,541560000,541560000,19351,6450,12901,6450,0,1,6452,2253627
168,6450,2400,5900,14160000,2,51606,12903,1,541560000,541560000,19351,6450,12901,6450,0,1,6452,2248155
168,6850,2400,5900,14160000,2,54806,13703,1,568120000,568120000,20551,6850,13701,6850,0,1,6852,30477723
168,6850,2400,5900,14160000,2,54806,13703,1,568120000,568120000,20551,6850,13701,6850,0,1,6852,2404879
168,6850,2400,5900,14160000,2,54806,13703,1,568120000,568120000,20551,6850,13701,6850,0,1,6852,2396871
168,6850,2400,5900,14160000,2,54806,13703,1,568120000,568120000,20551,6850,13701,6850,0,1,6852,2405612
168,6850,2400,5900,14160000,2,54806,13703,1,568120000,568120000,20551,6850,13701,6850,0,1,6852,2404066
168,6850,2400,5900,14160000,2,54806,13703,1,568120000,568120000,20551,6850,13701,6850,0,1,6852,2296982
168,6850,2400,5900,14160000,2,54806,13703,1,568120000,568120000,20551,6850,13701,6850,0,1,6852,2330471
168,50,2400,5500,13200000,2,406,103,1,108760000,108760000,151,50,101,50,0,1,52,149118
168,50,2400,5500,13200000,2,406,103,1,108760000,108760000,151,50,101,50,0,1,52,144129
168,50,2400,5500,13200000,2,406,103,1,108760000,108760000,151,50,101,50,0,1,52,103713
168,50,2400,5500,13200000,2,406,103,1,108760000,108760000,151,50,101,50,0,1,52,138401
168,50,2400,5500,13200000,2,406,103,1,108760000,108760000,151,50,101,50,0,1,52,143724
168,50,2400,5500,13200000,2,406,103,1,108760000,108760000,151,50,101,50,0,1,52,181947
168,50,2400,5500,13200000,2,406,103,1,108760000,108760000,151,50,101,50,0,1,52,182368
168,450,2400,5500,13200000,2,3606,903,1,134040000,134040000,1351,450,901,450,0,1,452,1404445
168,450,2400,5500,13200000,2,3606,903,1,134040000,134040000,1351,450,901,450,0,1,452,269009
168,450,2400,5500,13200000,2,3606,903,1,134040000,134040000,1351,450,901,450,0,1,452,272142
168,450,2400,5500,13200000,2,3606,903,1,134040000,134040000,1351,450,901,450,0,1,452,271783
168,450,2400,5500,13200000,2,3606,903,1,134040000,134040000,1351,450,901,450,0,1,452,271062
168,450,2400,5500,13200000,2,3606,903,1,134040000,134040000,1351,450,901,450,0,1,452,273319
168,450,2400,5500,13200000,2,3606,903,1,134040000,134040000,1351,450,901,450,0,1,452,272973
168,850,2400,5500,13200000,2,6806,1703,1,159320000,159320000,2551,850,1701,850,0,1,852,2995549
168,850,2400,5500,13200000,2,6806,1703,1,159320000,159320000,2551,850,1701,850,0,1,852,396553
168,850,2400,5500,13200000,2,6806,1703,1,159320000,159320000,2551,850,1701,850,0,1,852,399047
168,850,2400,5500,13200000,2,6806,1703,1,159320000,159320000,2551,850,1701,850,0,1,852,399503
168,850,2400,5500,13200000,2,6806,1703,1,159320000,159320000,2551,850,1701,850,0,1,852,398509
168,850,2400,5500,13200000,2,6806,1703,1,159320000,159320000,2551,850,1701,850,0,1,852,399993
168,850,2400,5500,13200000,2,6806,1703,1,159320000,159320000,2551,850,1701,850,0,1,852,398847
168,1250,2400,5500,13200000,2,10006,2503,1,184600000,184600000,3751,1250,2501,1250,0,1,1252,4657217
168,1250,2400,5500,13200000,2,10006,2503,1,184600000,184600000,3751,1250,2501,1250,0,1,1252,550809
168,1250,2400,5500,13200000,2,10006,2503,1,184600000,184600000,3751,1250,2501,1250,0,1,1252,550286
168,1250,2400,5500,13200000,2,10006,2503,1,184600000,184600000,3751,1250,2501,1250,0,1,1252,495282
168,1250,2400,5500,13200000,2,10006,2503,1,184600000,184600000,3751,1250,2501,1250,0,1,1252,547803
168,1250,2400,5500,13200000,2,10006,2503,1,184600000,184600000,3751,1250,2501,1250,0,1,1252,551146
168,1250,2400,5500,13200000,2,10006,2503,1,184600000,184600000,3751,1250,2501,1250,0,1,1252,551345
168,1650,2400,5500,13200000,2,13206,3303,1,209880000,209880000,4951,1650,3301,1650,0,1,1652,6197543
168,1650,2400,5500,13200000,2,13206,3303,1,209880000,209880000,4951,1650,3301,1650,0,1,1652,643545
168,1650,2400,5500,13200000,2,13206,3303,1,209880000,209880000,4951,1650,3301,1650,0,1,1652,642875
168,1650,2400,5500,13200000,2,13206,3303,1,209880000,209880000,4951,1650,3301,1650,0,1,1652,643839
168,1650,2400,5500,13200000,2,13206,3303,1,209880000,209880000,4951,1650,3301,1650,0,1,1652,643279
168,1650,2400,5500,13200000,2,13206,3303,1,209880000,209880000,4951,1650,3301,1650,0,1,1652,641018
168,1650,2400,5500,13200000,2,13206,3303,1,209880000,209880000,4951,1650,3301,1650,0,1,1652,639588
168,2050,2400,5500,13200000,2,16406,4103,1,235160000,235160000,6151,2050,4101,2050,0,1,2052,7510854
168,2050,2400,5500,13200000,2,16406,4103,1,235160000,235160000,6151,2050,4101,2050,0,1,2052,738228
168,2050,2400,5500,13200000,2,16406,4103,1,235160000,235160000,6151,2050,4101,2050,0,1,2052,736126
168,2050,2400,5500,13200000,2,16406,4103,1,235160000,235160000,6151,2050,4101,2050,0,1,2052,738829
168,2050,2400,5500,13200000,2,16406,4103,1,235160000,235160000,6151,2050,4101,2050,0,1,2052,737236
168,2050,2400,5500,13200000,2,16406,4103,1,235160000,235160000,6151,2050,4101,2050,0,1,2052,749413
168,2050,2400,5500,13200000,2,16406,4103,1,235160000,235160000,6151,2050,4101,2050,0,1,2052,748995
168,2450,2400,5500,13200000,2,19606,4903,1,260440000,260440000,7351,2450,4901,2450,0,1,2452,8880590
168,2450,2400,5500,13200000,2,19606,4903,1,260440000,260440000,7351,2450,4901,2450,0,1,2452,864949
168,2450,2400,5500,13200000,2,19606,4903,1,260440000,260440000,7351,2450,4901,2450,0,1,2452,860501
168,2450,2400,5500,13200000,2,19606,4903,1,260440000,260440000,7351,2450,4901,2450,0,1,2452,866237
168,2450,2400,5500,13200000,2,19606,4903,1,260440000,260440000,7351,2450,4901,2450,0,1,2452,867036
168,2450,2400,5500,13200000,2,19606,4903,1,260440000,260440000,7351,2450,4901,2450,0,1,2452,876694
168,2450,2400,5500,13200000,2,19606,4903,1,260440000,260440000,7351,2450,4901,2450,0,1,2452,876251
168,2850,2400,5500,13200000,2,22806,5703,1,285720000,285720000,8551,2850,5701,2850,0,1,2852,10555749
168,2850,2400,5500,13200000,2,22806,5703,1,285720000,285720000,8551,2850,5701,2850,0,1,2852,1023486
168,2850,2400,5500,13200000,2,22806,5703,1,285720000,285720000,8551,2850,5701,2850,0,1,2852,988159
168,2850,2400,5500,13200000,2,22806,5703,1,285720000,285720000,8551,2850,5701,2850,0,1,2852,1025267
168,2850,2400,5500,13200000,2,22806,5703,1,285720000,285720000,8551,2850,5701,2850,0,1,2852,1026974
168,2850,2400,5500,13200000,2,22806,5703,1,285720000,285720000,8551,2850,5701,2850,0,1,2852,1025900
168,2850,2400,5500,13200000,2,22806,5703,1,285720000,285720000,8551,2850,5701,2850,0,1,2852,1027570
168,3250,2400,5500,13200000,2,26006,6503,1,311000000,311000000,9751,3250,6501,3250,0,1,3252,12551030
168,3250,2400,5500,13200000,2,26006,6503,1,311000000,311000000,9751,3250,6501,3250,0,1,3252,1126105
168,3250,2400,5500,13200000,2,26006,6503,1,311000000,311000000,9751,3250,6501,3250,0,1,3252,1122738
168,3250,2400,5500,13200000,2,26006,6503,1,311000000,311000000,9751,3250,6501,3250,0,1,3252,1126514
168,3250,2400,5500,13200000,2,26006,6503,1,311000000,311000000,9751,3250,6501,3250,0,1,3252,1124733
168,3250,2400,5500,13200000,2,26006,6503,1,311000000,311000000,9751,3250,6501,3250,0,1,3252,1129070
168,3250,2400,5500,13200000,2,26006,6503,1,311000000,311000000,9751,3250,6501,3250,0,1,3252,1127731
168,3650,2400,5500,13200000,2,29206,7303,1,336280000,336280000,10951,3650,7301,3650,0,1,3652,14570300
168,3650,2400,5500,13200000,2,29206,7303,1,336280000,336280000,10951,3650,7301,3650,0,1,3652,1241915
168,3650,2400,5500,13200000,2,29206,7303,1,336280000,336280000,10951,3650,7301,3650,0,1,3652,1240897
168,3650,2400,5500,13200000,2,29206,7303,1,336280000,336280000,10951,3650,7301,3650,0,1,3652,1236547
168,3650,2400,5500,13200000,2,29206,7303,1,336280000,336280000,10951,3650,7301,3650,0,1,3652,1164653
168,3650,2400,5500,13200000,2,29206,7303,1,336280000,336280000,10951,3650,7301,3650,0,1,3652,1243578
168,3650,2400,5500,13200000,2,29206,7303,1,336280000,336280000,10951,3650,7301,3650,0,1,3652,1244085
168,4050,2400,5500,13200000,2,32406,8103,1,361560000,361560000,12151,4050,8101,4050,0,1,4052,15939605
168,4050,2400,5500,13200000,2,32406,8103,1,361560000,361560000,12151,4050,8101,4050,0,1,4052,1395610
168,4050,2400,5500,13200000,2,32406,8103,1,361560000,361560000,12151,4050,8101,4050,0,1,4052,1376343
168,4050,2400,5500,13200000,2,32406,8103,1,361560000,361560000,12151,4050,8101,4050,0,1,4052,1405037
168,4050,2400,5500,13200000,2,32406,8103,1,361560000,361560000,12151,4050,8101,4050,0,1,4052,1392317
168,4050,2400,5500,13200000,2,32406,8103,1,361560000,361560000,12151,4050,8101,4050,0,1,4052,1382730
168,4050,2400,5500,13200000,2,32406,8103,1,361560000,361560000,12151,4050,8101,4050,0,1,4052,1389448
168,4450,2400,5500,13200000,2,35606,8903,1,386840000,386840000,13351,4450,8901,4450,0,1,4452,17594881
168,4450,2400,5500,13200000,2,35606,8903,1,386840000,386840000,13351,4450,8901,4450,0,1,4452,1489962
168,4450,2400,5500,13200000,2,35606,8903,1,386840000,386840000,13351,4450,8901,4450,0,1,4452,1487093
168,4450,2400,5500,13200000,2,35606,8903,1,386840000,386840000,13351,4450,8901,4450,0,1,4452,1490657
168,4450,2400,5500,13200000,2,35606,8903,1,386840000,386840000,13351,4450,8901,4450,0,1,4452,1485767
168,4450,2400,5500,13200000,2,35606,8903,1,386840000,386840000,13351,4450,8901,4450,0,1,4452,1491021
168,4450,2400,5500,13200000,2,35606,8903,1,386840000,386840000,13351,4450,8901,4450,0,1,4452,1484545
168,4850,2400,5500,13200000,2,38806,9703,1,412120000,412120000,14551,4850,9701,4850,0,1,4852,19443744
168,4850,2400,5500,13200000,2,38806,9703,1,412120000,412120000,14551,4850,9701,4850,0,1,4852,1617060
168,4850,2400,5500,13200000,2,38806,9703,1,412120000,412120000,14551,4850,9701,4850,0,1,4852,1630749
168,4850,2400,5500,13200000,2,38806,9703,1,412120000,412120000,14551,4850,9701,4850,0,1,4852,1629998
168,4850,2400,5500,13200000,2,38806,9703,1,412120000,412120000,14551,4850,9701,4850,0,1,4852,1612600
168,4850,2400,5500,13200000,2,38806,9703,1,412120000,412120000,14551,4850,9701,4850,0,1,4852,1594073
168,4850,2400,5500,13200000,2,38806,9703,1,412120000,412120000,14551,4850,9701,4850,0,1,4852,1611358
168,5250,2400,5500,13200000,2,42006,10503,1,437400000,437400000,15751,5250,10501,5250,0,1,5252,20365482
168,5250,2400,5500,13200000,2,42006,10503,1,437400000,437400000,15751,5250,10501,5250,0,1,5252,1741029
168,5250,2400,5500,13200000,2,42006,10503,1,437400000,437400000,15751,5250,10501,5250,0,1,5252,1737864
168,5250,2400,5500,13200000,2,42006,10503,1,437400000,437400000,15751,5250,10501,5250,0,1,5252,1744441
168,5250,2400,5500,13200000,2,42006,10503,1,437400000,437400000,15751,5250,10501,5250,0,1,5252,1743662
168,5250,2400,5500,13200000,2,42006,10503,1,437400000,437400000,15751,5250,10501,5250,0,1,5252,1743005
168,5250,2400,5500,13200000,2,42006,10503,1,437400000,437400000,15751,5250,10501,5250,0,1,5252,1724278
168,5650,2400,5500,13200000,2,45206,11303,1,462680000,462680000,16951,5650,11301,5650,0,1,5652,23504341
168,5650,2400,5500,13200000,2,45206,11303,1,462680000,462680000,16951,5650,11301,5650,0,1,5652,1878156
168,5650,2400,5500,13200000,2,45206,11303,1,462680000,462680000,16951,5650,11301,5650,0,1,5652,1887158
168,5650,2400,5500,13200000,2,45206,11303,1,462680000,462680000,16951,5650,11301,5650,0,1,5652,1891591
168,5650,2400,5500,13200000,2,45206,11303,1,462680000,462680000,16951,5650,11301,5650,0,1,5652,1873342
168,5650,2400,5500,13200000,2,45206,11303,1,462680000,462680000,16951,5650,11301,5650,0,1,5652,1847519
168,5650,2400,5500,13200000,2,45206,11303,1,462680000,462680000,16951,5650,11301,5650,0,1,5652,1858019
168,6050,2400,5500,13200000,2,48406,12103,1,487960000,487960000,18151,6050,12101,6050,0,1,6052,23883487
168,6050,2400,5500,13200000,2,48406,12103,1,487960000,487960000,18151,6050,12101,6050,0,1,6052,1977880
168,6050,2400,5500,13200000,2,48406,12103,1,487960000,487960000,18151,6050,12101,6050,0,1,6052,1974107
168,6050,2400,5500,13200000,2,48406,12103,1,487960000,487960000,18151,6050,12101,6050,0,1,6052,1980979
168,6050,2400,5500,13200000,2,48406,12103,1,487960000,487960000,18151,6050,12101,6050,0,1,6052,1978643
168,6050,2400,5500,13200000,2,48406,12103,1,487960000,487960000,18151,6050,12101,6050,0,1,6052,1961919
168,6050,2400,5500,13200000,2,48406,12103,1,487960000,487960000,18151,6050,12101,6050,0,1,6052,1956653
168,6450,2400,5500,13200000,2,51606,12903,1,513240000,513240000,19351,6450,12901,6450,0,1,6452,25999755
168,6450,2400,5500,13200000,2,51606,12903,1,513240000,513240000,19351,6450,12901,6450,0,1,6452,2138620
168,6450,2400,5500,13200000,2,51606,12903,1,513240000,513240000,19351,6450,12901,6450,0,1,6452,2139674
168,6450,2400,5500,13200000,2,51606,12903,1,513240000,513240000,19351,6450,12901,6450,0,1,6452,2142307
168,6450,2400,5500,13200000,2,51606,12903,1,513240000,513240000,19351,6450,12901,6450,0,1,6452,2136671
168,6450,2400,5500,13200000,2,51606,12903,1,513240000,513240000,19351,6450,12901,6450,0,1,6452,2096592
168,6450,2400,5500,13200000,2,51606,12903,1,513240000,513240000,19351,6450,12901,6450,0,1,6452,2104643
168,6850,2400,5500,13200000,2,54806,13703,1,538520000,538520000,20551,6850,13701,6850,0,1,6852,26872697
168,6850,2400,5500,13200000,2,54806,13703,1,538520000,538520000,20551,6850,13701,6850,0,1,6852,2232938
168,6850,2400,5500,13200000,2,54806,13703,1,538520000,538520000,20551,6850,13701,6850,0,1,6852,2226064
168,6850,2400,5500,13200000,2,54806,13703,1,538520000,538520000,20551,6850,13701,6850,0,1,6852,2233875
168,6850,2400,5500,13200000,2,54806,13703,1,538520000,538520000,20551,6850,13701,6850,0,1,6852,2230445
168,6850,2400,5500,13200000,2,54806,13703,1,538520000,538520000,20551,6850,13701,6850,0,1,6852,2199328
168,6850,2400,5500,13200000,2,54806,13703,1,538520000,538520000,20551,6850,13701,6850,0,1,6852,2197343
168,50,2400,5100,12240000,2,406,103,1,100920000,100920000,151,50,101,50,0,1,52,137184
168,50,2400,5100,12240000,2,406,103,1,100920000,100920000,151,50,101,50,0,1,52,123852
168,50,2400,5100,12240000,2,406,103,1,100920000,100920000,151,50,101,50,0,1,52,106486
168,50,2400,5100,12240000,2,406,103,1,100920000,100920000,151,50,101,50,0,1,52,123476
168,50,2400,5100,12240000,2,406,103,1,100920000,100920000,151,50,101,50,0,1,52,124031
168,50,2400,5100,12240000,2,406,103,1,100920000,100920000,151,50,101,50,0,1,52,151343
168,50,2400,5100,12240000,2,406,103,1,100920000,100920000,151,50,101,50,0,1,52,151764
168,450,2400,5100,12240000,2,3606,903,1,124920000,124920000,1351,450,901,450,0,1,452,1308336
168,450,2400,5100,12240000,2,3606,903,1,124920000,124920000,1351,450,901,450,0,1,452,252670
168,450,2400,5100,12240000,2,3606,903,1,124920000,124920000,1351,450,901,450,0,1,452,253038
168,450,2400,5100,12240000,2,3606,903,1,124920000,124920000,1351,450,901,450,0,1,452,251710
168,450,2400,5100,12240000,2,3606,903,1,124920000,124920000,1351,450,901,450,0,1,452,253660
168,450,2400,5100,12240000,2,3606,903,1,124920000,124920000,1351,450,901,450,0,1,452,254173
168,450,2400,5100,12240000,2,3606,903,1,124920000,124920000,1351,450,901,450,0,1,452,254518
168,850,2400,5100,12240000,2,6806,1703,1,148920000,148920000,2551,850,1701,850,0,1,852,2789586
168,850,2400,5100,12240000,2,6806,1703,1,148920000,148920000,2551,850,1701,850,0,1,852,374015
168,850,2400,5100,12240000,2,6806,1703,1,148920000,148920000,2551,850,1701,850,0,1,852,384355
168,850,2400,5100,12240000,2,6806,1703,1,148920000,148920000,2551,850,1701,850,0,1,852,384794
168,850,2400,5100,12240000,2,6806,1703,1,148920000,148920000,2551,850,1701,850,0,1,852,380827
168,850,2400,5100,12240000,2,6806,1703,1,148920000,148920000,2551,850,1701,850,0,1,852,372189
168,850,2400,5100,12240000,2,6806,1703,1,148920000,148920000,2551,850,1701,850,0,1,852,381203
168,1250,2400,5100,12240000,2,10006,2503,1,172920000,172920000,3751,1250,2501,1250,0,1,1252,4295764
168,1250,2400,5100,12240000,2,10006,2503,1,172920000,172920000,3751,1250,2501,1250,0,1,1252,488103
168,1250,2400,5100,12240000,2,10006,2503,1,172920000,172920000,3751,1250,2501,1250,0,1,1252,490737
168,1250,2400,5100,12240000,2,10006,2503,1,172920000,172920000,3751,1250,2501,1250,0,1,1252,490994
168,1250,2400,5100,12240000,2,10006,2503,1,172920000,172920000,3751,1250,2501,1250,0,1,1252,489528
168,1250,2400,5100,12240000,2,10006,2503,1,172920000,172920000,3751,1250,2501,1250,0,1,1252,489811
168,1250,2400,5100,12240000,2,10006,2503,1,172920000,172920000,3751,1250,2501,1250,0,1,1252,490314
168,1650,2400,5100,12240000,2,13206,3303,1,196920000,196920000,4951,1650,3301,1650,0,1,1652,5629447
168,1650,2400,5100,12240000,2,13206,3303,1,196920000,196920000,4951,1650,3301,1650,0,1,1652,603456
168,1650,2400,5100,12240000,2,13206,3303,1,196920000,196920000,4951,1650,3301,1650,0,1,1652,604763
168,1650,2400,5100,12240000,2,13206,3303,1,196920000,196920000,4951,1650,3301,1650,0,1,1652,605056
168,1650,2400,5100,12240000,2,13206,3303,1,196920000,196920000,4951,1650,3301,1650,0,1,1652,603968
168,1650,2400,5100,12240000,2,13206,3303,1,196920000,196920000,4951,1650,3301,1650,0,1,1652,605595
168,1650,2400,5100,12240000,2,13206,3303,1,196920000,196920000,4951,1650,3301,1650,0,1,1652,595768
168,2050,2400,5100,12240000,2,16406,4103,1,220920000,220920000,6151,2050,4101,2050,0,1,2052,6842874
168,2050,2400,5100,12240000,2,16406,4103,1,220920000,220920000,6151,2050,4101,2050,0,1,2052,694136
168,2050,2400,5100,12240000,2,16406,4103,1,220920000,220920000,6151,2050,4101,2050,0,1,2052,691522
168,2050,2400,5100,12240000,2,16406,4103,1,220920000,220920000,6151,2050,4101,2050,0,1,2052,696156
168,2050,2400,5100,12240000,2,16406,4103,1,220920000,220920000,6151,2050,4101,2050,0,1,2052,695102
168,2050,2400,5100,12240000,2,16406,4103,1,220920000,220920000,6151,2050,4101,2050,0,1,2052,704261
168,2050,2400,5100,12240000,2,16406,4103,1,220920000,220920000,6151,2050,4101,2050,0,1,2052,704682
168,2450,2400,5100,12240000,2,19606,4903,1,244920000,244920000,7351,2450,4901,2450,0,1,2452,8447098
168,2450,2400,5100,12240000,2,19606,4903,1,244920000,244920000,7351,2450,4901,2450,0,1,2452,809382
168,2450,2400,5100,12240000,2,19606,4903,1,244920000,244920000,7351,2450,4901,2450,0,1,2452,805253
168,2450,2400,5100,12240000,2,19606,4903,1,244920000,244920000,7351,2450,4901,2450,0,1,2452,810474
168,2450,2400,5100,12240000,2,19606,4903,1,244920000,244920000,7351,2450,4901,2450,0,1,2452,806943
168,2450,2400,5100,12240000,2,19606,4903,1,244920000,244920000,7351,2450,4901,2450,0,1,2452,817941
168,2450,2400,5100,12240000,2,19606,4903,1,244920000,244920000,7351,2450,4901,2450,0,1,2452,818384
168,2850,2400,5100,12240000,2,22806,5703,1,268920000,268920000,8551,2850,5701,2850,0,1,2852,10311575
168,2850,2400,5100,12240000,2,22806,5703,1,268920000,268920000,8551,2850,5701,2850,0,1,2852,929839
168,2850,2400,5100,12240000,2,22806,5703,1,268920000,268920000,8551,2850,5701,2850,0,1,2852,926735
168,2850,2400,5100,12240000,2,22806,5703,1,268920000,268920000,8551,2850,5701,2850,0,1,2852,932105
168,2850,2400,5100,12240000,2,22806,5703,1,268920000,268920000,8551,2850,5701,2850,0,1,2852,931034
168,2850,2400,5100,12240000,2,22806,5703,1,268920000,268920000,8551,2850,5701,2850,0,1,2852,935048
168,2850,2400,5100,12240000,2,22806,5703,1,268920000,268920000,8551,2850,5701,2850,0,1,2852,935514
168,3250,2400,5100,12240000,2,26006,6503,1,292920000,292920000,9751,3250,6501,3250,0,1,3252,11658818
168,3250,2400,5100,12240000,2,26006,6503,1,292920000,292920000,9751,3250,6501,3250,0,1,3252,1079075
168,3250,2400,5100,12240000,2,26006,6503,1,292920000,292920000,9751,3250,6501,3250,0,1,3252,1074367
168,3250,2400,5100,12240000,2,26006,6503,1,292920000,292920000,9751,3250,6501,3250,0,1,3252,1079674
168,3250,2400,5100,12240000,2,26006,6503,1,292920000,292920000,9751,3250,6501,3250,0,1,3252,1078407
168,3250,2400,5100,12240000,2,26006,6503,1,292920000,292920000,9751,3250,6501,3250,0,1,3252,1061647
168,3250,2400,5100,12240000,2,26006,6503,1,292920000,292920000,9751,3250,6501,3250,0,1,3252,1080806
168,3650,2400,5100,12240000,2,29206,7303,1,316920000,316920000,10951,3650,7301,3650,0,1,3652,13152659
168,3650,2400,5100,12240000,2,29206,7303,1,316920000,316920000,10951,3650,7301,3650,0,1,3652,1150271
168,3650,2400,5100,12240000,2,29206,7303,1,316920000,316920000,10951,3650,7301,3650,0,1,3652,1146608
168,3650,2400,5100,12240000,2,29206,7303,1,316920000,316920000,10951,3650,7301,3650,0,1,3652,1153529
168,3650,2400,5100,12240000,2,29206,7303,1,316920000,316920000,10951,3650,7301,3650,0,1,3652,1154939
168,3650,2400,5100,12240000,2,29206,7303,1,316920000,316920000,10951,3650,7301,3650,0,1,3652,1159152
168,3650,2400,5100,12240000,2,29206,7303,1,316920000,316920000,10951,3650,7301,3650,0,1,3652,1156870
168,4050,2400,5100,12240000,2,32406,8103,1,340920000,340920000,12151,4050,8101,4050,0,1,4052,13951290
168,4050,2400,5100,12240000,2,32406,8103,1,340920000,340920000,12151,4050,8101,4050,0,1,4052,1266351
168,4050,2400,5100,12240000,2,32406,8103,1,340920000,340920000,12151,4050,8101,4050,0,1,4052,1257759
168,4050,2400,5100,12240000,2,32406,8103,1,340920000,340920000,12151,4050,8101,4050,0,1,4052,1271694
168,4050,2400,5100,12240000,2,32406,8103,1,340920000,340920000,12151,4050,8101,4050,0,1,4052,1270091
168,4050,2400,5100,12240000,2,32406,8103,1,340920000,340920000,12151,4050,8101,4050,0,1,4052,1275378
168,4050,2400,5100,12240000,2,32406,8103,1,340920000,340920000,12151,4050,8101,4050,0,1,4052,1275906
168,4450,2400,5100,12240000,2,35606,8903,1,364920000,364920000,13351,4450,8901,4450,0,1,4452,15721191
168,4450,2400,5100,12240000,2,35606,8903,1,364920000,364920000,13351,4450,8901,4450,0,1,4452,1415896
168,4450,2400,5100,12240000,2,35606,8903,1,364920000,364920000,13351,4450,8901,4450,0,1,4452,1412234
168,4450,2400,5100,12240000,2,35606,8903,1,364920000,364920000,13351,4450,8901,4450,0,1,4452,1418518
168,4450,2400,5100,12240000,2,35606,8903,1,364920000,364920000,13351,4450,8901,4450,0,1,4452,1417793
168,4450,2400,5100,12240000,2,35606,8903,1,364920000,364920000,13351,4450,8901,4450,0,1,4452,1390667
168,4450,2400,5100,12240000,2,35606,8903,1,364920000,364920000,13351,4450,8901,4450,0,1,4452,1403249
168,4850,2400,5100,12240000,2,38806,9703,1,388920000,388920000,14551,4850,9701,4850,0,1,4852,18350573
168,4850,2400,5100,12240000,2,38806,9703,1,388920000,388920000,14551,4850,9701,4850,0,1,4852,1508402
168,4850,2400,5100,12240000,2,38806,9703,1,388920000,388920000,14551,4850,9701,4850,0,1,4852,1498437
168,4850,2400,5100,12240000,2,38806,9703,1,388920000,388920000,14551,4850,9701,4850,0,1,4852,1510665
168,4850,2400,5100,12240000,2,38806,9703,1,388920000,388920000,14551,4850,9701,4850,0,1,4852,1510009
168,4850,2400,5100,12240000,2,38806,9703,1,388920000,388920000,14551,4850,9701,4850,0,1,4852,1512255
168,4850,2400,5100,12240000,2,38806,9703,1,388920000,388920000,14551,4850,9701,4850,0,1,4852,1509324
168,5250,2400,5100,12240000,2,42006,10503,1,412920000,412920000,15751,5250,10501,5250,0,1,5252,19332736
168,5250,2400,5100,12240000,2,42006,10503,1,412920000,412920000,15751,5250,10501,5250,0,1,5252,1650655
168,5250,2400,5100,12240000,2,42006,10503,1,412920000,412920000,15751,5250,10501,5250,0,1,5252,1644766
168,5250,2400,5100,12240000,2,42006,10503,1,412920000,412920000,15751,5250,10501,5250,0,1,5252,1651612
168,5250,2400,5100,12240000,2,42006,10503,1,412920000,412920000,15751,5250,10501,5250,0,1,5252,1649008
168,5250,2400,5100,12240000,2,42006,10503,1,412920000,412920000,15751,5250,10501,5250,0,1,5252,1612568
168,5250,2400,5100,12240000,2,42006,10503,1,412920000,412920000,15751,5250,10501,5250,0,1,5252,1623403
168,5650,2400,5100,12240000,2,45206,11303,1,436920000,436920000,16951,5650,11301,5650,0,1,5652,21150206
168,5650,2400,5100,12240000,2,45206,11303,1,436920000,436920000,16951,5650,11301,5650,0,1,5652,1737276
168,5650,2400,5100,12240000,2,45206,11303,1,436920000,436920000,16951,5650,11301,5650,0,1,5652,1727490
168,5650,2400,5100,12240000,2,45206,11303,1,436920000,436920000,16951,5650,11301,5650,0,1,5652,1738109
168,5650,2400,5100,12240000,2,45206,11303,1,436920000,436920000,16951,5650,11301,5650,0,1,5652,1736613
168,5650,2400,5100,12240000,2,45206,11303,1,436920000,436920000,16951,5650,11301,5650,0,1,5652,1734970
168,5650,2400,5100,12240000,2,45206,11303,1,436920000,436920000,16951,5650,11301,5650,0,1,5652,1719150
168,6050,2400,5100,12240000,2,48406,12103,1,460920000,460920000,18151,6050,12101,6050,0,1,6052,22117732
168,6050,2400,5100,12240000,2,48406,12103,1,460920000,460920000,18151,6050,12101,6050,0,1,6052,1874108
168,6050,2400,5100,12240000,2,48406,12103,1,460920000,460920000,18151,6050,12101,6050,0,1,6052,1864510
168,6050,2400,5100,12240000,2,48406,12103,1,460920000,460920000,18151,6050,12101,6050,0,1,6052,1877043
168,6050,2400,5100,12240000,2,48406,12103,1,460920000,460920000,18151,6050,12101,6050,0,1,6052,1876170
168,6050,2400,5100,12240000,2,48406,12103,1,460920000,460920000,18151,6050,12101,6050,0,1,6052,1828030
168,6050,2400,5100,12240000,2,48406,12103,1,460920000,460920000,18151,6050,12101,6050,0,1,6052,1837491
168,6450,2400,5100,12240000,2,51606,12903,1,484920000,484920000,19351,6450,12901,6450,0,1,6452,24352315
168,6450,2400,5100,12240000,2,51606,12903,1,484920000,484920000,19351,6450,12901,6450,0,1,6452,1959744
168,6450,2400,5100,12240000,2,51606,12903,1,484920000,484920000,19351,6450,12901,6450,0,1,6452,1956078
168,6450,2400,5100,12240000,2,51606,12903,1,484920000,484920000,19351,6450,12901,6450,0,1,6452,1965018
168,6450,2400,5100,12240000,2,51606,12903,1,484920000,484920000,19351,6450,12901,6450,0,1,6452,1964139
168,6450,2400,5100,12240000,2,51606,12903,1,484920000,484920000,19351,6450,12901,6450,0,1,6452,1943306
168,6450,2400,5100,12240000,2,51606,12903,1,484920000,484920000,19351,6450,12901,6450,0,1,6452,1931361
168,6850,2400,5100,12240000,2,54806,13703,1,508920000,508920000,20551,6850,13701,6850,0,1,6852,25387861
168,6850,2400,5100,12240000,2,54806,13703,1,508920000,508920000,20551,6850,13701,6850,0,1,6852,2114278
168,6850,2400,5100,12240000,2,54806,13703,1,508920000,508920000,20551,6850,13701,6850,0,1,6852,2111577
168,6850,2400,5100,12240000,2,54806,13703,1,508920000,508920000,20551,6850,13701,6850,0,1,6852,2104277
168,6850,2400,5100,12240000,2,54806,13703,1,508920000,508920000,20551,6850,13701,6850,0,1,6852,2108012
168,6850,2400,5100,12240000,2,54806,13703,1,508920000,508920000,20551,6850,13701,6850,0,1,6852,2087179
168,6850,2400,5100,12240000,2,54806,13703,1,508920000,508920000,20551,6850,13701,6850,0,1,6852,2079074
168,50,2400,4700,11280000,2,406,103,1,93080000,93080000,151,50,101,50,0,1,52,125129
168,50,2400,4700,11280000,2,406,103,1,93080000,93080000,151,50,101,50,0,1,52,114642
168,50,2400,4700,11280000,2,406,103,1,93080000,93080000,151,50,101,50,0,1,52,101922
168,50,2400,4700,11280000,2,406,103,1,93080000,93080000,151,50,101,50,0,1,52,115036
168,50,2400,4700,11280000,2,406,103,1,93080000,93080000,151,50,101,50,0,1,52,115842
168,50,2400,4700,11280000,2,406,103,1,93080000,93080000,151,50,101,50,0,1,52,141045
168,50,2400,4700,11280000,2,406,103,1,93080000,93080000,151,50,101,50,0,1,52,140609
168,450,2400,4700,11280000,2,3606,903,1,115800000,115800000,1351,450,901,450,0,1,452,1183545
168,450,2400,4700,11280000,2,3606,903,1,115800000,115800000,1351,450,901,450,0,1,452,232213
168,450,2400,4700,11280000,2,3606,903,1,115800000,115800000,1351,450,901,450,0,1,452,235263
168,450,2400,4700,11280000,2,3606,903,1,115800000,115800000,1351,450,901,450,0,1,452,234544
168,450,2400,4700,11280000,2,3606,903,1,115800000,115800000,1351,450,901,450,0,1,452,235467
168,450,2400,4700,11280000,2,3606,903,1,115800000,115800000,1351,450,901,450,0,1,452,235971
168,450,2400,4700,11280000,2,3606,903,1,115800000,115800000,1351,450,901,450,0,1,452,236322
168,850,2400,4700,11280000,2,6806,1703,1,138520000,138520000,2551,850,1701,850,0,1,852,2441692
168,850,2400,4700,11280000,2,6806,1703,1,138520000,138520000,2551,850,1701,850,0,1,852,344615
168,850,2400,4700,11280000,2,6806,1703,1,138520000,138520000,2551,850,1701,850,0,1,852,343861
168,850,2400,4700,11280000,2,6806,1703,1,138520000,138520000,2551,850,1701,850,0,1,852,344833
168,850,2400,4700,11280000,2,6806,1703,1,138520000,138520000,2551,850,1701,850,0,1,852,342866
168,850,2400,4700,11280000,2,6806,1703,1,138520000,138520000,2551,850,1701,850,0,1,852,345349
168,850,2400,4700,11280000,2,6806,1703,1,138520000,138520000,2551,850,1701,850,0,1,852,345713
168,1250,2400,4700,11280000,2,10006,2503,1,161240000,161240000,3751,1250,2501,1250,0,1,1252,3869227
168,1250,2400,4700,11280000,2,10006,2503,1,161240000,161240000,3751,1250,2501,1250,0,1,1252,447678
168,1250,2400,4700,11280000,2,10006,2503,1,161240000,161240000,3751,1250,2501,1250,0,1,1252,448865
168,1250,2400,4700,11280000,2,10006,2503,1,161240000,161240000,3751,1250,2501,1250,0,1,1252,450067
168,1250,2400,4700,11280000,2,10006,2503,1,161240000,161240000,3751,1250,2501,1250,0,1,1252,449648
168,1250,2400,4700,11280000,2,10006,2503,1,161240000,161240000,3751,1250,2501,1250,0,1,1252,450241
168,1250,2400,4700,11280000,2,10006,2503,1,161240000,161240000,3751,1250,2501,1250,0,1,1252,450441
168,1650,2400,4700,11280000,2,13206,3303,1,183960000,183960000,4951,1650,3301,1650,0,1,1652,5101601
168,1650,2400,4700,11280000,2,13206,3303,1,183960000,183960000,4951,1650,3301,1650,0,1,1652,556515
168,1650,2400,4700,11280000,2,13206,3303,1,183960000,183960000,4951,1650,3301,1650,0,1,1652,555879
168,1650,2400,4700,11280000,2,13206,3303,1,183960000,183960000,4951,1650,3301,1650,0,1,1652,557274
168,1650,2400,4700,11280000,2,13206,3303,1,183960000,183960000,4951,1650,3301,1650,0,1,1652,556978
168,1650,2400,4700,11280000,2,13206,3303,1,183960000,183960000,4951,1650,3301,1650,0,1,1652,554806
168,1650,2400,4700,11280000,2,13206,3303,1,183960000,183960000,4951,1650,3301,1650,0,1,1652,552657
168,2050,2400,4700,11280000,2,16406,4103,1,206680000,206680000,6151,2050,4101,2050,0,1,2052,6222586
168,2050,2400,4700,11280000,2,16406,4103,1,206680000,206680000,6151,2050,4101,2050,0,1,2052,643745
168,2050,2400,4700,11280000,2,16406,4103,1,206680000,206680000,6151,2050,4101,2050,0,1,2052,641744
168,2050,2400,4700,11280000,2,16406,4103,1,206680000,206680000,6151,2050,4101,2050,0,1,2052,645627
168,2050,2400,4700,11280000,2,16406,4103,1,206680000,206680000,6151,2050,4101,2050,0,1,2052,644585
168,2050,2400,4700,11280000,2,16406,4103,1,206680000,206680000,6151,2050,4101,2050,0,1,2052,650320
168,2050,2400,4700,11280000,2,16406,4103,1,206680000,206680000,6151,2050,4101,2050,0,1,2052,649895
168,2450,2400,4700,11280000,2,19606,4903,1,229400000,229400000,7351,2450,4901,2450,0,1,2452,7754120
168,2450,2400,4700,11280000,2,19606,4903,1,229400000,229400000,7351,2450,4901,2450,0,1,2452,751915
168,2450,2400,4700,11280000,2,19606,4903,1,229400000,229400000,7351,2450,4901,2450,0,1,2452,749484
168,2450,2400,4700,11280000,2,19606,4903,1,229400000,229400000,7351,2450,4901,2450,0,1,2452,741362
168,2450,2400,4700,11280000,2,19606,4903,1,229400000,229400000,7351,2450,4901,2450,0,1,2452,738745
168,2450,2400,4700,11280000,2,19606,4903,1,229400000,229400000,7351,2450,4901,2450,0,1,2452,769995
168,2450,2400,4700,11280000,2,19606,4903,1,229400000,229400000,7351,2450,4901,2450,0,1,2452,785821
168,2850,2400,4700,11280000,2,22806,5703,1,252120000,252120000,8551,2850,5701,2850,0,1,2852,9171169
168,2850,2400,4700,11280000,2,22806,5703,1,252120000,252120000,8551,2850,5701,2850,0,1,2852,854530
168,2850,2400,4700,11280000,2,22806,5703,1,252120000,252120000,8551,2850,5701,2850,0,1,2852,851198
168,2850,2400,4700,11280000,2,22806,5703,1,252120000,252120000,8551,2850,5701,2850,0,1,2852,855696
168,2850,2400,4700,11280000,2,22806,5703,1,252120000,252120000,8551,2850,5701,2850,0,1,2852,853601
168,2850,2400,4700,11280000,2,22806,5703,1,252120000,252120000,8551,2850,5701,2850,0,1,2852,863275
168,2850,2400,4700,11280000,2,22806,5703,1,252120000,252120000,8551,2850,5701,2850,0,1,2852,863741
168,3250,2400,4700,11280000,2,26006,6503,1,274840000,274840000,9751,3250,6501,3250,0,1,3252,10165754
168,3250,2400,4700,11280000,2,26006,6503,1,274840000,274840000,9751,3250,6501,3250,0,1,3252,956162
168,3250,2400,4700,11280000,2,26006,6503,1,274840000,274840000,9751,3250,6501,3250,0,1,3252,942901
168,3250,2400,4700,11280000,2,26006,6503,1,274840000,274840000,9751,3250,6501,3250,0,1,3252,955145
168,3250,2400,4700,11280000,2,26006,6503,1,274840000,274840000,9751,3250,6501,3250,0,1,3252,953727
168,3250,2400,4700,11280000,2,26006,6503,1,274840000,274840000,9751,3250,6501,3250,0,1,3252,974039
168,3250,2400,4700,11280000,2,26006,6503,1,274840000,274840000,9751,3250,6501,3250,0,1,3252,966454
168,3650,2400,4700,11280000,2,29206,7303,1,297560000,297560000,10951,3650,7301,3650,0,1,3652,11710691
168,3650,2400,4700,11280000,2,29206,7303,1,297560000,297560000,10951,3650,7301,3650,0,1,3652,1057491
168,3650,2400,4700,11280000,2,29206,7303,1,297560000,297560000,10951,3650,7301,3650,0,1,3652,1045473
168,3650,2400,4700,11280000,2,29206,7303,1,297560000,297560000,10951,3650,7301,3650,0,1,3652,1026711
168,3650,2400,4700,11280000,2,29206,7303,1,297560000,297560000,10951,3650,7301,3650,0,1,3652,1055969
168,3650,2400,4700,11280000,2,29206,7303,1,297560000,297560000,10951,3650,7301,3650,0,1,3652,1071360
168,3650,2400,4700,11280000,2,29206,7303,1,297560000,297560000,10951,3650,7301,3650,0,1,3652,1071866
168,4050,2400,4700,11280000,2,32406,8103,1,320280000,320280000,12151,4050,8101,4050,0,1,4052,13806614
168,4050,2400,4700,11280000,2,32406,8103,1,320280000,320280000,12151,4050,8101,4050,0,1,4052,1211832
168,4050,2400,4700,11280000,2,32406,8103,1,320280000,320280000,12151,4050,8101,4050,0,1,4052,1209257
168,4050,2400,4700,11280000,2,32406,8103,1,320280000,320280000,12151,4050,8101,4050,0,1,4052,1213734
168,4050,2400,4700,11280000,2,32406,8103,1,320280000,320280000,12151,4050,8101,4050,0,1,4052,1194090
168,4050,2400,4700,11280000,2,32406,8103,1,320280000,320280000,12151,4050,8101,4050,0,1,4052,1186270
168,4050,2400,4700,11280000,2,32406,8103,1,320280000,320280000,12151,4050,8101,4050,0,1,4052,1199233
168,4450,2400,4700,11280000,2,35606,8903,1,343000000,343000000,13351,4450,8901,4450,0,1,4452,15783769
168,4450,2400,4700,11280000,2,35606,8903,1,343000000,343000000,13351,4450,8901,4450,0,1,4452,1291838
168,4450,2400,4700,11280000,2,35606,8903,1,343000000,343000000,13351,4450,8901,4450,0,1,4452,1290052
168,4450,2400,4700,11280000,2,35606,8903,1,343000000,343000000,13351,4450,8901,4450,0,1,4452,1295087
168,4450,2400,4700,11280000,2,35606,8903,1,343000000,343000000,13351,4450,8901,4450,0,1,4452,1293781
168,4450,2400,4700,11280000,2,35606,8903,1,343000000,343000000,13351,4450,8901,4450,0,1,4452,1295755
168,4450,2400,4700,11280000,2,35606,8903,1,343000000,343000000,13351,4450,8901,4450,0,1,4452,1276186
168,4850,2400,4700,11280000,2,38806,9703,1,365720000,365720000,14551,4850,9701,4850,0,1,4852,16766477
168,4850,2400,4700,11280000,2,38806,9703,1,365720000,365720000,14551,4850,9701,4850,0,1,4852,1381787
168,4850,2400,4700,11280000,2,38806,9703,1,365720000,365720000,14551,4850,9701,4850,0,1,4852,1377737
168,4850,2400,4700,11280000,2,38806,9703,1,365720000,365720000,14551,4850,9701,4850,0,1,4852,1384211
168,4850,2400,4700,11280000,2,38806,9703,1,365720000,365720000,14551,4850,9701,4850,0,1,4852,1382410
168,4850,2400,4700,11280000,2,38806,9703,1,365720000,365720000,14551,4850,9701,4850,0,1,4852,1389891
168,4850,2400,4700,11280000,2,38806,9703,1,365720000,365720000,14551,4850,9701,4850,0,1,4852,1389101
168,5250,2400,4700,11280000,2,42006,10503,1,388440000,388440000,15751,5250,10501,5250,0,1,5252,18127010
168,5250,2400,4700,11280000,2,42006,10503,1,388440000,388440000,15751,5250,10501,5250,0,1,5252,1513207
168,5250,2400,4700,11280000,2,42006,10503,1,388440000,388440000,15751,5250,10501,5250,0,1,5252,1488213
168,5250,2400,4700,11280000,2,42006,10503,1,388440000,388440000,15751,5250,10501,5250,0,1,5252,1522442
168,5250,2400,4700,11280000,2,42006,10503,1,388440000,388440000,15751,5250,10501,5250,0,1,5252,1521629
168,5250,2400,4700,11280000,2,42006,10503,1,388440000,388440000,15751,5250,10501,5250,0,1,5252,1499636
168,5250,2400,4700,11280000,2,42006,10503,1,388440000,388440000,15751,5250,10501,5250,0,1,5252,1516785
168,5650,2400,4700,11280000,2,45206,11303,1,411160000,411160000,16951,5650,11301,5650,0,1,5652,19694310
168,5650,2400,4700,11280000,2,45206,11303,1,411160000,411160000,16951,5650,11301,5650,0,1,5652,1599969
168,5650,2400,4700,11280000,2,45206,11303,1,411160000,411160000,16951,5650,11301,5650,0,1,5652,1601918
168,5650,2400,4700,11280000,2,45206,11303,1,411160000,411160000,16951,5650,11301,5650,0,1,5652,1604406
168,5650,2400,4700,11280000,2,45206,11303,1,411160000,411160000,16951,5650,11301,5650,0,1,5652,1602879
168,5650,2400,4700,11280000,2,45206,11303,1,411160000,411160000,16951,5650,11301,5650,0,1,5652,1605131
168,5650,2400,4700,11280000,2,45206,11303,1,411160000,411160000,16951,5650,11301,5650,0,1,5652,1582987
168,6050,2400,4700,11280000,2,48406,12103,1,433880000,433880000,18151,6050,12101,6050,0,1,6052,20701650
168,6050,2400,4700,11280000,2,48406,12103,1,433880000,433880000,18151,6050,12101,6050,0,1,6052,1719033
168,6050,2400,4700,11280000,2,48406,12103,1,433880000,433880000,18151,6050,12101,6050,0,1,6052,1732824
168,6050,2400,4700,11280000,2,48406,12103,1,433880000,433880000,18151,6050,12101,6050,0,1,6052,1730467
168,6050,2400,4700,11280000,2,48406,12103,1,433880000,433880000,18151,6050,12101,6050,0,1,6052,1727487
168,6050,2400,4700,11280000,2,48406,12103,1,433880000,433880000,18151,6050,12101,6050,0,1,6052,1688751
168,6050,2400,4700,11280000,2,48406,12103,1,433880000,433880000,18151,6050,12101,6050,0,1,6052,1712523
168,6450,2400,4700,11280000,2,51606,12903,1,456600000,456600000,19351,6450,12901,6450,0,1,6452,22314022
168,6450,2400,4700,11280000,2,51606,12903,1,456600000,456600000,19351,6450,12901,6450,0,1,6452,1815830
168,6450,2400,4700,11280000,2,51606,12903,1,456600000,456600000,19351,6450,12901,6450,0,1,6452,1807249
168,6450,2400,4700,11280000,2,51606,12903,1,456600000,456600000,19351,6450,12901,6450,0,1,6452,1816716
168,6450,2400,4700,11280000,2,51606,12903,1,456600000,456600000,19351,6450,12901,6450,0,1,6452,1817633
168,6450,2400,4700,11280000,2,51606,12903,1,456600000,456600000,19351,6450,12901,6450,0,1,6452,1811042
168,6450,2400,4700,11280000,2,51606,12903,1,456600000,456600000,19351,6450,12901,6450,0,1,6452,1786662
168,6850,2400,4700,11280000,2,54806,13703,1,479320000,479320000,20551,6850,13701,6850,0,1,6852,22794695
168,6850,2400,4700,11280000,2,54806,13703,1,479320000,479320000,20551,6850,13701,6850,0,1,6852,1928778
168,6850,2400,4700,11280000,2,54806,13703,1,479320000,479320000,20551,6850,13701,6850,0,1,6852,1946333
168,6850,2400,4700,11280000,2,54806,13703,1,479320000,479320000,20551,6850,13701,6850,0,1,6852,1947578
168,6850,2400,4700,11280000,2,54806,13703,1,479320000,479320000,20551,6850,13701,6850,0,1,6852,1948706
168,6850,2400,4700,11280000,2,54806,13703,1,479320000,479320000,20551,6850,13701,6850,0,1,6852,1889408
168,6850,2400,4700,11280000,2,54806,13703,1,479320000,479320000,20551,6850,13701,6850,0,1,6852,1914011
168,50,2400,4300,10320000,2,406,103,1,85240000,85240000,151,50,101,50,0,1,52,115380
168,50,2400,4300,10320000,2,406,103,1,85240000,85240000,151,50,101,50,0,1,52,117353
168,50,2400,4300,10320000,2,406,103,1,85240000,85240000,151,50,101,50,0,1,52,118175
168,50,2400,4300,10320000,2,406,103,1,85240000,85240000,151,50,101,50,0,1,52,118474
168,50,2400,4300,10320000,2,406,103,1,85240000,85240000,151,50,101,50,0,1,52,118891
168,50,2400,4300,10320000,2,406,103,1,85240000,85240000,151,50,101,50,0,1,52,138430
168,50,2400,4300,10320000,2,406,103,1,85240000,85240000,151,50,101,50,0,1,52,138854
168,450,2400,4300,10320000,2,3606,903,1,106680000,106680000,1351,450,901,450,0,1,452,1137911
168,450,2400,4300,10320000,2,3606,903,1,106680000,106680000,1351,450,901,450,0,1,452,213984
168,450,2400,4300,10320000,2,3606,903,1,106680000,106680000,1351,450,901,450,0,1,452,215089
168,450,2400,4300,10320000,2,3606,903,1,106680000,106680000,1351,450,901,450,0,1,452,212944
168,450,2400,4300,10320000,2,3606,903,1,106680000,106680000,1351,450,901,450,0,1,452,214722
168,450,2400,4300,10320000,2,3606,903,1,106680000,106680000,1351,450,901,450,0,1,452,217010
168,450,2400,4300,10320000,2,3606,903,1,106680000,106680000,1351,450,901,450,0,1,452,217357
168,850,2400,4300,10320000,2,6806,1703,1,128120000,128120000,2551,850,1701,850,0,1,852,2301187
168,850,2400,4300,10320000,2,6806,1703,1,128120000,128120000,2551,850,1701,850,0,1,852,315780
168,850,2400,4300,10320000,2,6806,1703,1,128120000,128120000,2551,850,1701,850,0,1,852,315294
168,850,2400,4300,10320000,2,6806,1703,1,128120000,128120000,2551,850,1701,850,0,1,852,314994
168,850,2400,4300,10320000,2,6806,1703,1,128120000,128120000,2551,850,1701,850,0,1,852,313732
168,850,2400,4300,10320000,2,6806,1703,1,128120000,128120000,2551,850,1701,850,0,1,852,316274
168,850,2400,4300,10320000,2,6806,1703,1,128120000,128120000,2551,850,1701,850,0,1,852,316099
168,1250,2400,4300,10320000,2,10006,2503,1,149560000,149560000,3751,1250,2501,1250,0,1,1252,3486448
168,1250,2400,4300,10320000,2,10006,2503,1,149560000,149560000,3751,1250,2501,1250,0,1,1252,408949
168,1250,2400,4300,10320000,2,10006,2503,1,149560000,149560000,3751,1250,2501,1250,0,1,1252,409306
168,1250,2400,4300,10320000,2,10006,2503,1,149560000,149560000,3751,1250,2501,1250,0,1,1252,408552
168,1250,2400,4300,10320000,2,10006,2503,1,149560000,149560000,3751,1250,2501,1250,0,1,1252,406372
168,1250,2400,4300,10320000,2,10006,2503,1,149560000,149560000,3751,1250,2501,1250,0,1,1252,410428
168,1250,2400,4300,10320000,2,10006,2503,1,149560000,149560000,3751,1250,2501,1250,0,1,1252,409644
168,1650,2400,4300,10320000,2,13206,3303,1,171000000,171000000,4951,1650,3301,1650,0,1,1652,4833108
168,1650,2400,4300,10320000,2,13206,3303,1,171000000,171000000,4951,1650,3301,1650,0,1,1652,517721
168,1650,2400,4300,10320000,2,13206,3303,1,171000000,171000000,4951,1650,3301,1650,0,1,1652,516759
168,1650,2400,4300,10320000,2,13206,3303,1,171000000,171000000,4951,1650,3301,1650,0,1,1652,517156
168,1650,2400,4300,10320000,2,13206,3303,1,171000000,171000000,4951,1650,3301,1650,0,1,1652,517424
168,1650,2400,4300,10320000,2,13206,3303,1,171000000,171000000,4951,1650,3301,1650,0,1,1652,515233
168,1650,2400,4300,10320000,2,13206,3303,1,171000000,171000000,4951,1650,3301,1650,0,1,1652,513045
168,2050,2400,4300,10320000,2,16406,4103,1,192440000,192440000,6151,2050,4101,2050,0,1,2052,6153031
168,2050,2400,4300,10320000,2,16406,4103,1,192440000,192440000,6151,2050,4101,2050,0,1,2052,601404
168,2050,2400,4300,10320000,2,16406,4103,1,192440000,192440000,6151,2050,4101,2050,0,1,2052,597560
168,2050,2400,4300,10320000,2,16406,4103,1,192440000,192440000,6151,2050,4101,2050,0,1,2052,600102
168,2050,2400,4300,10320000,2,16406,4103,1,192440000,192440000,6151,2050,4101,2050,0,1,2052,601823
168,2050,2400,4300,10320000,2,16406,4103,1,192440000,192440000,6151,2050,4101,2050,0,1,2052,602712
168,2050,2400,4300,10320000,2,16406,4103,1,192440000,192440000,6151,2050,4101,2050,0,1,2052,602287
168,2450,2400,4300,10320000,2,19606,4903,1,213880000,213880000,7351,2450,4901,2450,0,1,2452,7315929
168,2450,2400,4300,10320000,2,19606,4903,1,213880000,213880000,7351,2450,4901,2450,0,1,2452,696072
168,2450,2400,4300,10320000,2,19606,4903,1,213880000,213880000,7351,2450,4901,2450,0,1,2452,697441
168,2450,2400,4300,10320000,2,19606,4903,1,213880000,213880000,7351,2450,4901,2450,0,1,2452,697950
168,2450,2400,4300,10320000,2,19606,4903,1,213880000,213880000,7351,2450,4901,2450,0,1,2452,698885
168,2450,2400,4300,10320000,2,19606,4903,1,213880000,213880000,7351,2450,4901,2450,0,1,2452,700572
168,2450,2400,4300,10320000,2,19606,4903,1,213880000,213880000,7351,2450,4901,2450,0,1,2452,701016
168,2850,2400,4300,10320000,2,22806,5703,1,235320000,235320000,8551,2850,5701,2850,0,1,2852,8625768
168,2850,2400,4300,10320000,2,22806,5703,1,235320000,235320000,8551,2850,5701,2850,0,1,2852,833600
168,2850,2400,4300,10320000,2,22806,5703,1,235320000,235320000,8551,2850,5701,2850,0,1,2852,829371
168,2850,2400,4300,10320000,2,22806,5703,1,235320000,235320000,8551,2850,5701,2850,0,1,2852,834302
168,2850,2400,4300,10320000,2,22806,5703,1,235320000,235320000,8551,2850,5701,2850,0,1,2852,801810
168,2850,2400,4300,10320000,2,22806,5703,1,235320000,235320000,8551,2850,5701,2850,0,1,2852,824754
168,2850,2400,4300,10320000,2,22806,5703,1,235320000,235320000,8551,2850,5701,2850,0,1,2852,834772
168,3250,2400,4300,10320000,2,26006,6503,1,256760000,256760000,9751,3250,6501,3250,0,1,3252,9598199
168,3250,2400,4300,10320000,2,26006,6503,1,256760000,256760000,9751,3250,6501,3250,0,1,3252,867560
168,3250,2400,4300,10320000,2,26006,6503,1,256760000,256760000,9751,3250,6501,3250,0,1,3252,866466
168,3250,2400,4300,10320000,2,26006,6503,1,256760000,256760000,9751,3250,6501,3250,0,1,3252,868391
168,3250,2400,4300,10320000,2,26006,6503,1,256760000,256760000,9751,3250,6501,3250,0,1,3252,865264
168,3250,2400,4300,10320000,2,26006,6503,1,256760000,256760000,9751,3250,6501,3250,0,1,3252,884804
168,3250,2400,4300,10320000,2,26006,6503,1,256760000,256760000,9751,3250,6501,3250,0,1,3252,885287
168,3650,2400,4300,10320000,2,29206,7303,1,278200000,278200000,10951,3650,7301,3650,0,1,3652,11047838
168,3650,2400,4300,10320000,2,29206,7303,1,278200000,278200000,10951,3650,7301,3650,0,1,3652,953286
168,3650,2400,4300,10320000,2,29206,7303,1,278200000,278200000,10951,3650,7301,3650,0,1,3652,955358
168,3650,2400,4300,10320000,2,29206,7303,1,278200000,278200000,10951,3650,7301,3650,0,1,3652,956092
168,3650,2400,4300,10320000,2,29206,7303,1,278200000,278200000,10951,3650,7301,3650,0,1,3652,954463
168,3650,2400,4300,10320000,2,29206,7303,1,278200000,278200000,10951,3650,7301,3650,0,1,3652,990376
168,3650,2400,4300,10320000,2,29206,7303,1,278200000,278200000,10951,3650,7301,3650,0,1,3652,972190
168,4050,2400,4300,10320000,2,32406,8103,1,299640000,299640000,12151,4050,8101,4050,0,1,4052,12599107
168,4050,2400,4300,10320000,2,32406,8103,1,299640000,299640000,12151,4050,8101,4050,0,1,4052,1054188
168,4050,2400,4300,10320000,2,32406,8103,1,299640000,299640000,12151,4050,8101,4050,0,1,4052,1065241
168,4050,2400,4300,10320000,2,32406,8103,1,299640000,299640000,12151,4050,8101,4050,0,1,4052,1066994
168,4050,2400,4300,10320000,2,32406,8103,1,299640000,299640000,12151,4050,8101,4050,0,1,4052,1051452
168,4050,2400,4300,10320000,2,32406,8103,1,299640000,299640000,12151,4050,8101,4050,0,1,4052,1079821
168,4050,2400,4300,10320000,2,32406,8103,1,299640000,299640000,12151,4050,8101,4050,0,1,4052,1080349
168,4450,2400,4300,10320000,2,35606,8903,1,321080000,321080000,13351,4450,8901,4450,0,1,4452,13869323
168,4450,2400,4300,10320000,2,35606,8903,1,321080000,321080000,13351,4450,8901,4450,0,1,4452,1176273
168,4450,2400,4300,10320000,2,35606,8903,1,321080000,321080000,13351,4450,8901,4450,0,1,4452,1178994
168,4450,2400,4300,10320000,2,35606,8903,1,321080000,321080000,13351,4450,8901,4450,0,1,4452,1187752
168,4450,2400,4300,10320000,2,35606,8903,1,321080000,321080000,13351,4450,8901,4450,0,1,4452,1185533
168,4450,2400,4300,10320000,2,35606,8903,1,321080000,321080000,13351,4450,8901,4450,0,1,4452,1190669
168,4450,2400,4300,10320000,2,35606,8903,1,321080000,321080000,13351,4450,8901,4450,0,1,4452,1197529
168,4850,2400,4300,10320000,2,38806,9703,1,342520000,342520000,14551,4850,9701,4850,0,1,4852,15047559
168,4850,2400,4300,10320000,2,38806,9703,1,342520000,342520000,14551,4850,9701,4850,0,1,4852,1278888
168,4850,2400,4300,10320000,2,38806,9703,1,342520000,342520000,14551,4850,9701,4850,0,1,4852,1267395
168,4850,2400,4300,10320000,2,38806,9703,1,342520000,342520000,14551,4850,9701,4850,0,1,4852,1280430
168,4850,2400,4300,10320000,2,38806,9703,1,342520000,342520000,14551,4850,9701,4850,0,1,4852,1276868
168,4850,2400,4300,10320000,2,38806,9703,1,342520000,342520000,14551,4850,9701,4850,0,1,4852,1284646
168,4850,2400,4300,10320000,2,38806,9703,1,342520000,342520000,14551,4850,9701,4850,0,1,4852,1283161
168,5250,2400,4300,10320000,2,42006,10503,1,363960000,363960000,15751,5250,10501,5250,0,1,5252,16520463
168,5250,2400,4300,10320000,2,42006,10503,1,363960000,363960000,15751,5250,10501,5250,0,1,5252,1391875
168,5250,2400,4300,10320000,2,42006,10503,1,363960000,363960000,15751,5250,10501,5250,0,1,5252,1374194
168,5250,2400,4300,10320000,2,42006,10503,1,363960000,363960000,15751,5250,10501,5250,0,1,5252,1393028
168,5250,2400,4300,10320000,2,42006,10503,1,363960000,363960000,15751,5250,10501,5250,0,1,5252,1357120
168,5250,2400,4300,10320000,2,42006,10503,1,363960000,363960000,15751,5250,10501,5250,0,1,5252,1383327
168,5250,2400,4300,10320000,2,42006,10503,1,363960000,363960000,15751,5250,10501,5250,0,1,5252,1394847
168,5650,2400,4300,10320000,2,45206,11303,1,385400000,385400000,16951,5650,11301,5650,0,1,5652,18193613
168,5650,2400,4300,10320000,2,45206,11303,1,385400000,385400000,16951,5650,11301,5650,0,1,5652,1468667
168,5650,2400,4300,10320000,2,45206,11303,1,385400000,385400000,16951,5650,11301,5650,0,1,5652,1471632
168,5650,2400,4300,10320000,2,45206,11303,1,385400000,385400000,16951,5650,11301,5650,0,1,5652,1478822
168,5650,2400,4300,10320000,2,45206,11303,1,385400000,385400000,16951,5650,11301,5650,0,1,5652,1482871
168,5650,2400,4300,10320000,2,45206,11303,1,385400000,385400000,16951,5650,11301,5650,0,1,5652,1483492
168,5650,2400,4300,10320000,2,45206,11303,1,385400000,385400000,16951,5650,11301,5650,0,1,5652,1480990
168,6050,2400,4300,10320000,2,48406,12103,1,406840000,406840000,18151,6050,12101,6050,0,1,6052,18843785
168,6050,2400,4300,10320000,2,48406,12103,1,406840000,406840000,18151,6050,12101,6050,0,1,6052,1579836
168,6050,2400,4300,10320000,2,48406,12103,1,406840000,406840000,18151,6050,12101,6050,0,1,6052,1575562
168,6050,2400,4300,10320000,2,48406,12103,1,406840000,406840000,18151,6050,12101,6050,0,1,6052,1580707
168,6050,2400,4300,10320000,2,48406,12103,1,406840000,406840000,18151,6050,12101,6050,0,1,6052,1577492
168,6050,2400,4300,10320000,2,48406,12103,1,406840000,406840000,18151,6050,12101,6050,0,1,6052,1578953
168,6050,2400,4300,10320000,2,48406,12103,1,406840000,406840000,18151,6050,12101,6050,0,1,6052,1576849
168,6450,2400,4300,10320000,2,51606,12903,1,428280000,428280000,19351,6450,12901,6450,0,1,6452,19651154
168,6450,2400,4300,10320000,2,51606,12903,1,428280000,428280000,19351,6450,12901,6450,0,1,6452,1699022
168,6450,2400,4300,10320000,2,51606,12903,1,428280000,428280000,19351,6450,12901,6450,0,1,6452,1695046
168,6450,2400,4300,10320000,2,51606,12903,1,428280000,428280000,19351,6450,12901,6450,0,1,6452,1705775
168,6450,2400,4300,10320000,2,51606,12903,1,428280000,428280000,19351,6450,12901,6450,0,1,6452,1703378
168,6450,2400,4300,10320000,2,51606,12903,1,428280000,428280000,19351,6450,12901,6450,0,1,6452,1666613
168,6450,2400,4300,10320000,2,51606,12903,1,428280000,428280000,19351,6450,12901,6450,0,1,6452,1677712
168,6850,2400,4300,10320000,2,54806,13703,1,449720000,449720000,20551,6850,13701,6850,0,1,6852,21502360
168,6850,2400,4300,10320000,2,54806,13703,1,449720000,449720000,20551,6850,13701,6850,0,1,6852,1775407
168,6850,2400,4300,10320000,2,54806,13703,1,449720000,449720000,20551,6850,13701,6850,0,1,6852,1768919
168,6850,2400,4300,10320000,2,54806,13703,1,449720000,449720000,20551,6850,13701,6850,0,1,6852,1776346
168,6850,2400,4300,10320000,2,54806,13703,1,449720000,449720000,20551,6850,13701,6850,0,1,6852,1774398
168,6850,2400,4300,10320000,2,54806,13703,1,449720000,449720000,20551,6850,13701,6850,0,1,6852,1770595
168,6850,2400,4300,10320000,2,54806,13703,1,449720000,449720000,20551,6850,13701,6850,0,1,6852,1745084
168,50,2400,3900,9360000,2,406,103,1,77400000,77400000,151,50,101,50,0,1,52,100757
168,50,2400,3900,9360000,2,406,103,1,77400000,77400000,151,50,101,50,0,1,52,94382
168,50,2400,3900,9360000,2,406,103,1,77400000,77400000,151,50,101,50,0,1,52,97060
168,50,2400,3900,9360000,2,406,103,1,77400000,77400000,151,50,101,50,0,1,52,81730
168,50,2400,3900,9360000,2,406,103,1,77400000,77400000,151,50,101,50,0,1,52,96642
168,50,2400,3900,9360000,2,406,103,1,77400000,77400000,151,50,101,50,0,1,52,115975
168,50,2400,3900,9360000,2,406,103,1,77400000,77400000,151,50,101,50,0,1,52,118037
168,450,2400,3900,9360000,2,3606,903,1,97560000,97560000,1351,450,901,450,0,1,452,985572
168,450,2400,3900,9360000,2,3606,903,1,97560000,97560000,1351,450,901,450,0,1,452,179869
168,450,2400,3900,9360000,2,3606,903,1,97560000,97560000,1351,450,901,450,0,1,452,181854
168,450,2400,3900,9360000,2,3606,903,1,97560000,97560000,1351,450,901,450,0,1,452,181224
168,450,2400,3900,9360000,2,3606,903,1,97560000,97560000,1351,450,901,450,0,1,452,181637
168,450,2400,3900,9360000,2,3606,903,1,97560000,97560000,1351,450,901,450,0,1,452,203788
168,450,2400,3900,9360000,2,3606,903,1,97560000,97560000,1351,450,901,450,0,1,452,204131
168,850,2400,3900,9360000,2,6806,1703,1,117720000,117720000,2551,850,1701,850,0,1,852,1995511
168,850,2400,3900,9360000,2,6806,1703,1,117720000,117720000,2551,850,1701,850,0,1,852,286273
168,850,2400,3900,9360000,2,6806,1703,1,117720000,117720000,2551,850,1701,850,0,1,852,281540
168,850,2400,3900,9360000,2,6806,1703,1,117720000,117720000,2551,850,1701,850,0,1,852,288078
168,850,2400,3900,9360000,2,6806,1703,1,117720000,117720000,2551,850,1701,850,0,1,852,287308
168,850,2400,3900,9360000,2,6806,1703,1,117720000,117720000,2551,850,1701,850,0,1,852,288960
168,850,2400,3900,9360000,2,6806,1703,1,117720000,117720000,2551,850,1701,850,0,1,852,288597
168,1250,2400,3900,9360000,2,10006,2503,1,137880000,137880000,3751,1250,2501,1250,0,1,1252,3152315
168,1250,2400,3900,9360000,2,10006,2503,1,137880000,137880000,3751,1250,2501,1250,0,1,1252,391036
168,1250,2400,3900,9360000,2,10006,2503,1,137880000,137880000,3751,1250,2501,1250,0,1,1252,391499
168,1250,2400,3900,9360000,2,10006,2503,1,137880000,137880000,3751,1250,2501,1250,0,1,1252,386282
168,1250,2400,3900,9360000,2,10006,2503,1,137880000,137880000,3751,1250,2501,1250,0,1,1252,355358
168,1250,2400,3900,9360000,2,10006,2503,1,137880000,137880000,3751,1250,2501,1250,0,1,1252,366059
168,1250,2400,3900,9360000,2,10006,2503,1,137880000,137880000,3751,1250,2501,1250,0,1,1252,387789
168,1650,2400,3900,9360000,2,13206,3303,1,158040000,158040000,4951,1650,3301,1650,0,1,1652,4197053
168,1650,2400,3900,9360000,2,13206,3303,1,158040000,158040000,4951,1650,3301,1650,0,1,1652,469262
168,1650,2400,3900,9360000,2,13206,3303,1,158040000,158040000,4951,1650,3301,1650,0,1,1652,471436
168,1650,2400,3900,9360000,2,13206,3303,1,158040000,158040000,4951,1650,3301,1650,0,1,1652,472469
168,1650,2400,3900,9360000,2,13206,3303,1,158040000,158040000,4951,1650,3301,1650,0,1,1652,473959
168,1650,2400,3900,9360000,2,13206,3303,1,158040000,158040000,4951,1650,3301,1650,0,1,1652,471904
168,1650,2400,3900,9360000,2,13206,3303,1,158040000,158040000,4951,1650,3301,1650,0,1,1652,472898
168,2050,2400,3900,9360000,2,16406,4103,1,178200000,178200000,6151,2050,4101,2050,0,1,2052,5469457
168,2050,2400,3900,9360000,2,16406,4103,1,178200000,178200000,6151,2050,4101,2050,0,1,2052,526464
168,2050,2400,3900,9360000,2,16406,4103,1,178200000,178200000,6151,2050,4101,2050,0,1,2052,518827
168,2050,2400,3900,9360000,2,16406,4103,1,178200000,178200000,6151,2050,4101,2050,0,1,2052,527585
168,2050,2400,3900,9360000,2,16406,4103,1,178200000,178200000,6151,2050,4101,2050,0,1,2052,528309
168,2050,2400,3900,9360000,2,16406,4103,1,178200000,178200000,6151,2050,4101,2050,0,1,2052,548922
168,2050,2400,3900,9360000,2,16406,4103,1,178200000,178200000,6151,2050,4101,2050,0,1,2052,549348
168,2450,2400,3900,9360000,2,19606,4903,1,198360000,198360000,7351,2450,4901,2450,0,1,2452,6553439
168,2450,2400,3900,9360000,2,19606,4903,1,198360000,198360000,7351,2450,4901,2450,0,1,2452,645814
168,2450,2400,3900,9360000,2,19606,4903,1,198360000,198360000,7351,2450,4901,2450,0,1,2452,646944
168,2450,2400,3900,9360000,2,19606,4903,1,198360000,198360000,7351,2450,4901,2450,0,1,2452,648143
168,2450,2400,3900,9360000,2,19606,4903,1,198360000,198360000,7351,2450,4901,2450,0,1,2452,647792
168,2450,2400,3900,9360000,2,19606,4903,1,198360000,198360000,7351,2450,4901,2450,0,1,2452,648719
168,2450,2400,3900,9360000,2,19606,4903,1,198360000,198360000,7351,2450,4901,2450,0,1,2452,640188
168,2850,2400,3900,9360000,2,22806,5703,1,218520000,218520000,8551,2850,5701,2850,0,1,2852,7683669
168,2850,2400,3900,9360000,2,22806,5703,1,218520000,218520000,8551,2850,5701,2850,0,1,2852,732430
168,2850,2400,3900,9360000,2,22806,5703,1,218520000,218520000,8551,2850,5701,2850,0,1,2852,724329
168,2850,2400,3900,9360000,2,22806,5703,1,218520000,218520000,8551,2850,5701,2850,0,1,2852,733092
168,2850,2400,3900,9360000,2,22806,5703,1,218520000,218520000,8551,2850,5701,2850,0,1,2852,731660
168,2850,2400,3900,9360000,2,22806,5703,1,218520000,218520000,8551,2850,5701,2850,0,1,2852,735518
168,2850,2400,3900,9360000,2,22806,5703,1,218520000,218520000,8551,2850,5701,2850,0,1,2852,735986
168,3250,2400,3900,9360000,2,26006,6503,1,238680000,238680000,9751,3250,6501,3250,0,1,3252,8740401
168,3250,2400,3900,9360000,2,26006,6503,1,238680000,238680000,9751,3250,6501,3250,0,1,3252,814959
168,3250,2400,3900,9360000,2,26006,6503,1,238680000,238680000,9751,3250,6501,3250,0,1,3252,803428
168,3250,2400,3900,9360000,2,26006,6503,1,238680000,238680000,9751,3250,6501,3250,0,1,3252,813838
168,3250,2400,3900,9360000,2,26006,6503,1,238680000,238680000,9751,3250,6501,3250,0,1,3252,812384
168,3250,2400,3900,9360000,2,26006,6503,1,238680000,238680000,9751,3250,6501,3250,0,1,3252,819822
168,3250,2400,3900,9360000,2,26006,6503,1,238680000,238680000,9751,3250,6501,3250,0,1,3252,820430
168,3650,2400,3900,9360000,2,29206,7303,1,258840000,258840000,10951,3650,7301,3650,0,1,3652,10262744
168,3650,2400,3900,9360000,2,29206,7303,1,258840000,258840000,10951,3650,7301,3650,0,1,3652,899171
168,3650,2400,3900,9360000,2,29206,7303,1,258840000,258840000,10951,3650,7301,3650,0,1,3652,901583
168,3650,2400,3900,9360000,2,29206,7303,1,258840000,258840000,10951,3650,7301,3650,0,1,3652,908223
168,3650,2400,3900,9360000,2,29206,7303,1,258840000,258840000,10951,3650,7301,3650,0,1,3652,859640
168,3650,2400,3900,9360000,2,29206,7303,1,258840000,258840000,10951,3650,7301,3650,0,1,3652,921100
168,3650,2400,3900,9360000,2,29206,7303,1,258840000,258840000,10951,3650,7301,3650,0,1,3652,928125
168,4050,2400,3900,9360000,2,32406,8103,1,279000000,279000000,12151,4050,8101,4050,0,1,4052,11007143
168,4050,2400,3900,9360000,2,32406,8103,1,279000000,279000000,12151,4050,8101,4050,0,1,4052,968104
168,4050,2400,3900,9360000,2,32406,8103,1,279000000,279000000,12151,4050,8101,4050,0,1,4052,965656
168,4050,2400,3900,9360000,2,32406,8103,1,279000000,279000000,12151,4050,8101,4050,0,1,4052,969195
168,4050,2400,3900,9360000,2,32406,8103,1,279000000,279000000,12151,4050,8101,4050,0,1,4052,972774
168,4050,2400,3900,9360000,2,32406,8103,1,279000000,279000000,12151,4050,8101,4050,0,1,4052,989394
168,4050,2400,3900,9360000,2,32406,8103,1,279000000,279000000,12151,4050,8101,4050,0,1,4052,988869
168,4450,2400,3900,9360000,2,35606,8903,1,299160000,299160000,13351,4450,8901,4450,0,1,4452,12305225
168,4450,2400,3900,9360000,2,35606,8903,1,299160000,299160000,13351,4450,8901,4450,0,1,4452,1059152
168,4450,2400,3900,9360000,2,35606,8903,1,299160000,299160000,13351,4450,8901,4450,0,1,4452,1046767
168,4450,2400,3900,9360000,2,35606,8903,1,299160000,299160000,13351,4450,8901,4450,0,1,4452,1060857
168,4450,2400,3900,9360000,2,35606,8903,1,299160000,299160000,13351,4450,8901,4450,0,1,4452,1057197
168,4450,2400,3900,9360000,2,35606,8903,1,299160000,299160000,13351,4450,8901,4450,0,1,4452,1086200
168,4450,2400,3900,9360000,2,35606,8903,1,299160000,299160000,13351,4450,8901,4450,0,1,4452,1077619
168,4850,2400,3900,9360000,2,38806,9703,1,319320000,319320000,14551,4850,9701,4850,0,1,4852,13373691
168,4850,2400,3900,9360000,2,38806,9703,1,319320000,319320000,14551,4850,9701,4850,0,1,4852,1156214
168,4850,2400,3900,9360000,2,38806,9703,1,319320000,319320000,14551,4850,9701,4850,0,1,4852,1148101
168,4850,2400,3900,9360000,2,38806,9703,1,319320000,319320000,14551,4850,9701,4850,0,1,4852,1164827
168,4850,2400,3900,9360000,2,38806,9703,1,319320000,319320000,14551,4850,9701,4850,0,1,4852,1163005
168,4850,2400,3900,9360000,2,38806,9703,1,319320000,319320000,14551,4850,9701,4850,0,1,4852,1172242
168,4850,2400,3900,9360000,2,38806,9703,1,319320000,319320000,14551,4850,9701,4850,0,1,4852,1172912
168,5250,2400,3900,9360000,2,42006,10503,1,339480000,339480000,15751,5250,10501,5250,0,1,5252,15134383
168,5250,2400,3900,9360000,2,42006,10503,1,339480000,339480000,15751,5250,10501,5250,0,1,5252,1290072
168,5250,2400,3900,9360000,2,42006,10503,1,339480000,339480000,15751,5250,10501,5250,0,1,5252,1291491
168,5250,2400,3900,9360000,2,42006,10503,1,339480000,339480000,15751,5250,10501,5250,0,1,5252,1283884
168,5250,2400,3900,9360000,2,42006,10503,1,339480000,339480000,15751,5250,10501,5250,0,1,5252,1264974
168,5250,2400,3900,9360000,2,42006,10503,1,339480000,339480000,15751,5250,10501,5250,0,1,5252,1282219
168,5250,2400,3900,9360000,2,42006,10503,1,339480000,339480000,15751,5250,10501,5250,0,1,5252,1292201
168,5650,2400,3900,9360000,2,45206,11303,1,359640000,359640000,16951,5650,11301,5650,0,1,5652,16235398
168,5650,2400,3900,9360000,2,45206,11303,1,359640000,359640000,16951,5650,11301,5650,0,1,5652,1340962
168,5650,2400,3900,9360000,2,45206,11303,1,359640000,359640000,16951,5650,11301,5650,0,1,5652,1345162
168,5650,2400,3900,9360000,2,45206,11303,1,359640000,359640000,16951,5650,11301,5650,0,1,5652,1348298
168,5650,2400,3900,9360000,2,45206,11303,1,359640000,359640000,16951,5650,11301,5650,0,1,5652,1347120
168,5650,2400,3900,9360000,2,45206,11303,1,359640000,359640000,16951,5650,11301,5650,0,1,5652,1351474
168,5650,2400,3900,9360000,2,45206,11303,1,359640000,359640000,16951,5650,11301,5650,0,1,5652,1349899
168,6050,2400,3900,9360000,2,48406,12103,1,379800000,379800000,18151,6050,12101,6050,0,1,6052,17732175
168,6050,2400,3900,9360000,2,48406,12103,1,379800000,379800000,18151,6050,12101,6050,0,1,6052,1454820
168,6050,2400,3900,9360000,2,48406,12103,1,379800000,379800000,18151,6050,12101,6050,0,1,6052,1459287
168,6050,2400,3900,9360000,2,48406,12103,1,379800000,379800000,18151,6050,12101,6050,0,1,6052,1460582
168,6050,2400,3900,9360000,2,48406,12103,1,379800000,379800000,18151,6050,12101,6050,0,1,6052,1407775
168,6050,2400,3900,9360000,2,48406,12103,1,379800000,379800000,18151,6050,12101,6050,0,1,6052,1442691
168,6050,2400,3900,9360000,2,48406,12103,1,379800000,379800000,18151,6050,12101,6050,0,1,6052,1459944
168,6450,2400,3900,9360000,2,51606,12903,1,399960000,399960000,19351,6450,12901,6450,0,1,6452,17841343
168,6450,2400,3900,9360000,2,51606,12903,1,399960000,399960000,19351,6450,12901,6450,0,1,6452,1531582
168,6450,2400,3900,9360000,2,51606,12903,1,399960000,399960000,19351,6450,12901,6450,0,1,6452,1529134
168,6450,2400,3900,9360000,2,51606,12903,1,399960000,399960000,19351,6450,12901,6450,0,1,6452,1536132
168,6450,2400,3900,9360000,2,51606,12903,1,399960000,399960000,19351,6450,12901,6450,0,1,6452,1538939
168,6450,2400,3900,9360000,2,51606,12903,1,399960000,399960000,19351,6450,12901,6450,0,1,6452,1538013
168,6450,2400,3900,9360000,2,51606,12903,1,399960000,399960000,19351,6450,12901,6450,0,1,6452,1534074
168,6850,2400,3900,9360000,2,54806,13703,1,420120000,420120000,20551,6850,13701,6850,0,1,6852,18985070
168,6850,2400,3900,9360000,2,54806,13703,1,420120000,420120000,20551,6850,13701,6850,0,1,6852,1626302
168,6850,2400,3900,9360000,2,54806,13703,1,420120000,420120000,20551,6850,13701,6850,0,1,6852,1578800
168,6850,2400,3900,9360000,2,54806,13703,1,420120000,420120000,20551,6850,13701,6850,0,1,6852,1622827
168,6850,2400,3900,9360000,2,54806,13703,1,420120000,420120000,20551,6850,13701,6850,0,1,6852,1598951
168,6850,2400,3900,9360000,2,54806,13703,1,420120000,420120000,20551,6850,13701,6850,0,1,6852,1607924
168,6850,2400,3900,9360000,2,54806,13703,1,420120000,420120000,20551,6850,13701,6850,0,1,6852,1612459
168,50,2400,3500,8400000,2,406,103,1,69560000,69560000,151,50,101,50,0,1,52,90360
168,50,2400,3500,8400000,2,406,103,1,69560000,69560000,151,50,101,50,0,1,52,86757
168,50,2400,3500,8400000,2,406,103,1,69560000,69560000,151,50,101,50,0,1,52,88801
168,50,2400,3500,8400000,2,406,103,1,69560000,69560000,151,50,101,50,0,1,52,88378
168,50,2400,3500,8400000,2,406,103,1,69560000,69560000,151,50,101,50,0,1,52,75131
168,50,2400,3500,8400000,2,406,103,1,69560000,69560000,151,50,101,50,0,1,52,107505
168,50,2400,3500,8400000,2,406,103,1,69560000,69560000,151,50,101,50,0,1,52,104987
168,450,2400,3500,8400000,2,3606,903,1,88440000,88440000,1351,450,901,450,0,1,452,864553
168,450,2400,3500,8400000,2,3606,903,1,88440000,88440000,1351,450,901,450,0,1,452,170994
168,450,2400,3500,8400000,2,3606,903,1,88440000,88440000,1351,450,901,450,0,1,452,169975
168,450,2400,3500,8400000,2,3606,903,1,88440000,88440000,1351,450,901,450,0,1,452,170534
168,450,2400,3500,8400000,2,3606,903,1,88440000,88440000,1351,450,901,450,0,1,452,167085
168,450,2400,3500,8400000,2,3606,903,1,88440000,88440000,1351,450,901,450,0,1,452,186193
168,450,2400,3500,8400000,2,3606,903,1,88440000,88440000,1351,450,901,450,0,1,452,188767
168,850,2400,3500,8400000,2,6806,1703,1,107320000,107320000,2551,850,1701,850,0,1,852,1744557
168,850,2400,3500,8400000,2,6806,1703,1,107320000,107320000,2551,850,1701,850,0,1,852,260753
168,850,2400,3500,8400000,2,6806,1703,1,107320000,107320000,2551,850,1701,850,0,1,852,262504
168,850,2400,3500,8400000,2,6806,1703,1,107320000,107320000,2551,850,1701,850,0,1,852,263251
168,850,2400,3500,8400000,2,6806,1703,1,107320000,107320000,2551,850,1701,850,0,1,852,263633
168,850,2400,3500,8400000,2,6806,1703,1,107320000,107320000,2551,850,1701,850,0,1,852,263965
168,850,2400,3500,8400000,2,6806,1703,1,107320000,107320000,2551,850,1701,850,0,1,852,263790
168,1250,2400,3500,8400000,2,10006,2503,1,126200000,126200000,3751,1250,2501,1250,0,1,1252,2807360
168,1250,2400,3500,8400000,2,10006,2503,1,126200000,126200000,3751,1250,2501,1250,0,1,1252,343773
168,1250,2400,3500,8400000,2,10006,2503,1,126200000,126200000,3751,1250,2501,1250,0,1,1252,347095
168,1250,2400,3500,8400000,2,10006,2503,1,126200000,126200000,3751,1250,2501,1250,0,1,1252,344976
168,1250,2400,3500,8400000,2,10006,2503,1,126200000,126200000,3751,1250,2501,1250,0,1,1252,340656
168,1250,2400,3500,8400000,2,10006,2503,1,126200000,126200000,3751,1250,2501,1250,0,1,1252,346302
168,1250,2400,3500,8400000,2,10006,2503,1,126200000,126200000,3751,1250,2501,1250,0,1,1252,346629
168,1650,2400,3500,8400000,2,13206,3303,1,145080000,145080000,4951,1650,3301,1650,0,1,1652,3793570
168,1650,2400,3500,8400000,2,13206,3303,1,145080000,145080000,4951,1650,3301,1650,0,1,1652,401983
168,1650,2400,3500,8400000,2,13206,3303,1,145080000,145080000,4951,1650,3301,1650,0,1,1652,418432
168,1650,2400,3500,8400000,2,13206,3303,1,145080000,145080000,4951,1650,3301,1650,0,1,1652,419543
168,1650,2400,3500,8400000,2,13206,3303,1,145080000,145080000,4951,1650,3301,1650,0,1,1652,422093
168,1650,2400,3500,8400000,2,13206,3303,1,145080000,145080000,4951,1650,3301,1650,0,1,1652,420169
168,1650,2400,3500,8400000,2,13206,3303,1,145080000,145080000,4951,1650,3301,1650,0,1,1652,419947
168,2050,2400,3500,8400000,2,16406,4103,1,163960000,163960000,6151,2050,4101,2050,0,1,2052,4873054
168,2050,2400,3500,8400000,2,16406,4103,1,163960000,163960000,6151,2050,4101,2050,0,1,2052,506285
168,2050,2400,3500,8400000,2,16406,4103,1,163960000,163960000,6151,2050,4101,2050,0,1,2052,505865
168,2050,2400,3500,8400000,2,16406,4103,1,163960000,163960000,6151,2050,4101,2050,0,1,2052,506572
168,2050,2400,3500,8400000,2,16406,4103,1,163960000,163960000,6151,2050,4101,2050,0,1,2052,506904
168,2050,2400,3500,8400000,2,16406,4103,1,163960000,163960000,6151,2050,4101,2050,0,1,2052,504103
168,2050,2400,3500,8400000,2,16406,4103,1,163960000,163960000,6151,2050,4101,2050,0,1,2052,502972
168,2450,2400,3500,8400000,2,19606,4903,1,182840000,182840000,7351,2450,4901,2450,0,1,2452,5870538
168,2450,2400,3500,8400000,2,19606,4903,1,182840000,182840000,7351,2450,4901,2450,0,1,2452,571960
168,2450,2400,3500,8400000,2,19606,4903,1,182840000,182840000,7351,2450,4901,2450,0,1,2452,573945
168,2450,2400,3500,8400000,2,19606,4903,1,182840000,182840000,7351,2450,4901,2450,0,1,2452,574622
168,2450,2400,3500,8400000,2,19606,4903,1,182840000,182840000,7351,2450,4901,2450,0,1,2452,573040
168,2450,2400,3500,8400000,2,19606,4903,1,182840000,182840000,7351,2450,4901,2450,0,1,2452,577094
168,2450,2400,3500,8400000,2,19606,4903,1,182840000,182840000,7351,2450,4901,2450,0,1,2452,575990
168,2850,2400,3500,8400000,2,22806,5703,1,201720000,201720000,8551,2850,5701,2850,0,1,2852,6694068
168,2850,2400,3500,8400000,2,22806,5703,1,201720000,201720000,8551,2850,5701,2850,0,1,2852,656829
168,2850,2400,3500,8400000,2,22806,5703,1,201720000,201720000,8551,2850,5701,2850,0,1,2852,655786
168,2850,2400,3500,8400000,2,22806,5703,1,201720000,201720000,8551,2850,5701,2850,0,1,2852,657514
168,2850,2400,3500,8400000,2,22806,5703,1,201720000,201720000,8551,2850,5701,2850,0,1,2852,650114
168,2850,2400,3500,8400000,2,22806,5703,1,201720000,201720000,8551,2850,5701,2850,0,1,2852,660741
168,2850,2400,3500,8400000,2,22806,5703,1,201720000,201720000,8551,2850,5701,2850,0,1,2852,660270
168,3250,2400,3500,8400000,2,26006,6503,1,220600000,220600000,9751,3250,6501,3250,0,1,3252,7836902
168,3250,2400,3500,8400000,2,26006,6503,1,220600000,220600000,9751,3250,6501,3250,0,1,3252,735490
168,3250,2400,3500,8400000,2,26006,6503,1,220600000,220600000,9751,3250,6501,3250,0,1,3252,736567
168,3250,2400,3500,8400000,2,26006,6503,1,220600000,220600000,9751,3250,6501,3250,0,1,3252,737365
168,3250,2400,3500,8400000,2,26006,6503,1,220600000,220600000,9751,3250,6501,3250,0,1,3252,732661
168,3250,2400,3500,8400000,2,26006,6503,1,220600000,220600000,9751,3250,6501,3250,0,1,3252,741303
168,3250,2400,3500,8400000,2,26006,6503,1,220600000,220600000,9751,3250,6501,3250,0,1,3252,740819
168,3650,2400,3500,8400000,2,29206,7303,1,239480000,239480000,10951,3650,7301,3650,0,1,3652,8706893
168,3650,2400,3500,8400000,2,29206,7303,1,239480000,239480000,10951,3650,7301,3650,0,1,3652,795560
168,3650,2400,3500,8400000,2,29206,7303,1,239480000,239480000,10951,3650,7301,3650,0,1,3652,760865
168,3650,2400,3500,8400000,2,29206,7303,1,239480000,239480000,10951,3650,7301,3650,0,1,3652,787506
168,3650,2400,3500,8400000,2,29206,7303,1,239480000,239480000,10951,3650,7301,3650,0,1,3652,740028
168,3650,2400,3500,8400000,2,29206,7303,1,239480000,239480000,10951,3650,7301,3650,0,1,3652,806205
168,3650,2400,3500,8400000,2,29206,7303,1,239480000,239480000,10951,3650,7301,3650,0,1,3652,830956
168,4050,2400,3500,8400000,2,32406,8103,1,258360000,258360000,12151,4050,8101,4050,0,1,4052,9674844
168,4050,2400,3500,8400000,2,32406,8103,1,258360000,258360000,12151,4050,8101,4050,0,1,4052,853638
168,4050,2400,3500,8400000,2,32406,8103,1,258360000,258360000,12151,4050,8101,4050,0,1,4052,883903
168,4050,2400,3500,8400000,2,32406,8103,1,258360000,258360000,12151,4050,8101,4050,0,1,4052,860926
168,4050,2400,3500,8400000,2,32406,8103,1,258360000,258360000,12151,4050,8101,4050,0,1,4052,870891
168,4050,2400,3500,8400000,2,32406,8103,1,258360000,258360000,12151,4050,8101,4050,0,1,4052,914388
168,4050,2400,3500,8400000,2,32406,8103,1,258360000,258360000,12151,4050,8101,4050,0,1,4052,914907
168,4450,2400,3500,8400000,2,35606,8903,1,277240000,277240000,13351,4450,8901,4450,0,1,4452,10966688
168,4450,2400,3500,8400000,2,35606,8903,1,277240000,277240000,13351,4450,8901,4450,0,1,4452,953650
168,4450,2400,3500,8400000,2,35606,8903,1,277240000,277240000,13351,4450,8901,4450,0,1,4452,943767
168,4450,2400,3500,8400000,2,35606,8903,1,277240000,277240000,13351,4450,8901,4450,0,1,4452,955517
168,4450,2400,3500,8400000,2,35606,8903,1,277240000,277240000,13351,4450,8901,4450,0,1,4452,952206
168,4450,2400,3500,8400000,2,35606,8903,1,277240000,277240000,13351,4450,8901,4450,0,1,4452,982641
168,4450,2400,3500,8400000,2,35606,8903,1,277240000,277240000,13351,4450,8901,4450,0,1,4452,973672
168,4850,2400,3500,8400000,2,38806,9703,1,296120000,296120000,14551,4850,9701,4850,0,1,4852,11130638
168,4850,2400,3500,8400000,2,38806,9703,1,296120000,296120000,14551,4850,9701,4850,0,1,4852,1013147
168,4850,2400,3500,8400000,2,38806,9703,1,296120000,296120000,14551,4850,9701,4850,0,1,4852,1008542
168,4850,2400,3500,8400000,2,38806,9703,1,296120000,296120000,14551,4850,9701,4850,0,1,4852,1016347
168,4850,2400,3500,8400000,2,38806,9703,1,296120000,296120000,14551,4850,9701,4850,0,1,4852,1014485
168,4850,2400,3500,8400000,2,38806,9703,1,296120000,296120000,14551,4850,9701,4850,0,1,4852,1070158
168,4850,2400,3500,8400000,2,38806,9703,1,296120000,296120000,14551,4850,9701,4850,0,1,4852,1070717
168,5250,2400,3500,8400000,2,42006,10503,1,315000000,315000000,15751,5250,10501,5250,0,1,5252,13264185
168,5250,2400,3500,8400000,2,42006,10503,1,315000000,315000000,15751,5250,10501,5250,0,1,5252,1155961
168,5250,2400,3500,8400000,2,42006,10503,1,315000000,315000000,15751,5250,10501,5250,0,1,5252,1157777
168,5250,2400,3500,8400000,2,42006,10503,1,315000000,315000000,15751,5250,10501,5250,0,1,5252,1152059
168,5250,2400,3500,8400000,2,42006,10503,1,315000000,315000000,15751,5250,10501,5250,0,1,5252,1083294
168,5250,2400,3500,8400000,2,42006,10503,1,315000000,315000000,15751,5250,10501,5250,0,1,5252,1157003
168,5250,2400,3500,8400000,2,42006,10503,1,315000000,315000000,15751,5250,10501,5250,0,1,5252,1159727
168,5650,2400,3500,8400000,2,45206,11303,1,333880000,333880000,16951,5650,11301,5650,0,1,5652,13800013
168,5650,2400,3500,8400000,2,45206,11303,1,333880000,333880000,16951,5650,11301,5650,0,1,5652,1208219
168,5650,2400,3500,8400000,2,45206,11303,1,333880000,333880000,16951,5650,11301,5650,0,1,5652,1196947
168,5650,2400,3500,8400000,2,45206,11303,1,333880000,333880000,16951,5650,11301,5650,0,1,5652,1210377
168,5650,2400,3500,8400000,2,45206,11303,1,333880000,333880000,16951,5650,11301,5650,0,1,5652,1218812
168,5650,2400,3500,8400000,2,45206,11303,1,333880000,333880000,16951,5650,11301,5650,0,1,5652,1227581
168,5650,2400,3500,8400000,2,45206,11303,1,333880000,333880000,16951,5650,11301,5650,0,1,5652,1221633
168,6050,2400,3500,8400000,2,48406,12103,1,352760000,352760000,18151,6050,12101,6050,0,1,6052,15025418
168,6050,2400,3500,8400000,2,48406,12103,1,352760000,352760000,18151,6050,12101,6050,0,1,6052,1295158
168,6050,2400,3500,8400000,2,48406,12103,1,352760000,352760000,18151,6050,12101,6050,0,1,6052,1301478
168,6050,2400,3500,8400000,2,48406,12103,1,352760000,352760000,18151,6050,12101,6050,0,1,6052,1303866
168,6050,2400,3500,8400000,2,48406,12103,1,352760000,352760000,18151,6050,12101,6050,0,1,6052,1302930
168,6050,2400,3500,8400000,2,48406,12103,1,352760000,352760000,18151,6050,12101,6050,0,1,6052,1306671
168,6050,2400,3500,8400000,2,48406,12103,1,352760000,352760000,18151,6050,12101,6050,0,1,6052,1307301
168,6450,2400,3500,8400000,2,51606,12903,1,371640000,371640000,19351,6450,12901,6450,0,1,6452,16071741
168,6450,2400,3500,8400000,2,51606,12903,1,371640000,371640000,19351,6450,12901,6450,0,1,6452,1415370
168,6450,2400,3500,8400000,2,51606,12903,1,371640000,371640000,19351,6450,12901,6450,0,1,6452,1411700
168,6450,2400,3500,8400000,2,51606,12903,1,371640000,371640000,19351,6450,12901,6450,0,1,6452,1418034
168,6450,2400,3500,8400000,2,51606,12903,1,371640000,371640000,19351,6450,12901,6450,0,1,6452,1417000
168,6450,2400,3500,8400000,2,51606,12903,1,371640000,371640000,19351,6450,12901,6450,0,1,6452,1395517
168,6450,2400,3500,8400000,2,51606,12903,1,371640000,371640000,19351,6450,12901,6450,0,1,6452,1413574
168,6850,2400,3500,8400000,2,54806,13703,1,390520000,390520000,20551,6850,13701,6850,0,1,6852,16164403
168,6850,2400,3500,8400000,2,54806,13703,1,390520000,390520000,20551,6850,13701,6850,0,1,6852,1467281
168,6850,2400,3500,8400000,2,54806,13703,1,390520000,390520000,20551,6850,13701,6850,0,1,6852,1458511
168,6850,2400,3500,8400000,2,54806,13703,1,390520000,390520000,20551,6850,13701,6850,0,1,6852,1469064
168,6850,2400,3500,8400000,2,54806,13703,1,390520000,390520000,20551,6850,13701,6850,0,1,6852,1468042
168,6850,2400,3500,8400000,2,54806,13703,1,390520000,390520000,20551,6850,13701,6850,0,1,6852,1469730
168,6850,2400,3500,8400000,2,54806,13703,1,390520000,390520000,20551,6850,13701,6850,0,1,6852,1465057
168,50,2400,3100,7440000,2,406,103,1,61720000,61720000,151,50,101,50,0,1,52,78272
168,50,2400,3100,7440000,2,406,103,1,61720000,61720000,151,50,101,50,0,1,52,79743
168,50,2400,3100,7440000,2,406,103,1,61720000,61720000,151,50,101,50,0,1,52,65460
168,50,2400,3100,7440000,2,406,103,1,61720000,61720000,151,50,101,50,0,1,52,79342
168,50,2400,3100,7440000,2,406,103,1,61720000,61720000,151,50,101,50,0,1,52,77268
168,50,2400,3100,7440000,2,406,103,1,61720000,61720000,151,50,101,50,0,1,52,95787
168,50,2400,3100,7440000,2,406,103,1,61720000,61720000,151,50,101,50,0,1,52,95365
168,450,2400,3100,7440000,2,3606,903,1,79320000,79320000,1351,450,901,450,0,1,452,736918
168,450,2400,3100,7440000,2,3606,903,1,79320000,79320000,1351,450,901,450,0,1,452,161118
168,450,2400,3100,7440000,2,3606,903,1,79320000,79320000,1351,450,901,450,0,1,452,160755
168,450,2400,3100,7440000,2,3606,903,1,79320000,79320000,1351,450,901,450,0,1,452,161533
168,450,2400,3100,7440000,2,3606,903,1,79320000,79320000,1351,450,901,450,0,1,452,161320
168,450,2400,3100,7440000,2,3606,903,1,79320000,79320000,1351,450,901,450,0,1,452,167325
168,450,2400,3100,7440000,2,3606,903,1,79320000,79320000,1351,450,901,450,0,1,452,167784
168,850,2400,3100,7440000,2,6806,1703,1,96920000,96920000,2551,850,1701,850,0,1,852,1573017
168,850,2400,3100,7440000,2,6806,1703,1,96920000,96920000,2551,850,1701,850,0,1,852,234145
168,850,2400,3100,7440000,2,6806,1703,1,96920000,96920000,2551,850,1701,850,0,1,852,233661
168,850,2400,3100,7440000,2,6806,1703,1,96920000,96920000,2551,850,1701,850,0,1,852,234906
168,850,2400,3100,7440000,2,6806,1703,1,96920000,96920000,2551,850,1701,850,0,1,852,232971
168,850,2400,3100,7440000,2,6806,1703,1,96920000,96920000,2551,850,1701,850,0,1,852,234499
168,850,2400,3100,7440000,2,6806,1703,1,96920000,96920000,2551,850,1701,850,0,1,852,234675
168,1250,2400,3100,7440000,2,10006,2503,1,114520000,114520000,3751,1250,2501,1250,0,1,1252,2410949
168,1250,2400,3100,7440000,2,10006,2503,1,114520000,114520000,3751,1250,2501,1250,0,1,1252,309477
168,1250,2400,3100,7440000,2,10006,2503,1,114520000,114520000,3751,1250,2501,1250,0,1,1252,308271
168,1250,2400,3100,7440000,2,10006,2503,1,114520000,114520000,3751,1250,2501,1250,0,1,1252,310845
168,1250,2400,3100,7440000,2,10006,2503,1,114520000,114520000,3751,1250,2501,1250,0,1,1252,310585
168,1250,2400,3100,7440000,2,10006,2503,1,114520000,114520000,3751,1250,2501,1250,0,1,1252,310347
168,1250,2400,3100,7440000,2,10006,2503,1,114520000,114520000,3751,1250,2501,1250,0,1,1252,309958
168,1650,2400,3100,7440000,2,13206,3303,1,132120000,132120000,4951,1650,3301,1650,0,1,1652,3367683
168,1650,2400,3100,7440000,2,13206,3303,1,132120000,132120000,4951,1650,3301,1650,0,1,1652,369908
168,1650,2400,3100,7440000,2,13206,3303,1,132120000,132120000,4951,1650,3301,1650,0,1,1652,371025
168,1650,2400,3100,7440000,2,13206,3303,1,132120000,132120000,4951,1650,3301,1650,0,1,1652,371484
168,1650,2400,3100,7440000,2,13206,3303,1,132120000,132120000,4951,1650,3301,1650,0,1,1652,367581
168,1650,2400,3100,7440000,2,13206,3303,1,132120000,132120000,4951,1650,3301,1650,0,1,1652,372847
168,1650,2400,3100,7440000,2,13206,3303,1,132120000,132120000,4951,1650,3301,1650,0,1,1652,372440
168,2050,2400,3100,7440000,2,16406,4103,1,149720000,149720000,6151,2050,4101,2050,0,1,2052,4339538
168,2050,2400,3100,7440000,2,16406,4103,1,149720000,149720000,6151,2050,4101,2050,0,1,2052,456260
168,2050,2400,3100,7440000,2,16406,4103,1,149720000,149720000,6151,2050,4101,2050,0,1,2052,454178
168,2050,2400,3100,7440000,2,16406,4103,1,149720000,149720000,6151,2050,4101,2050,0,1,2052,457053
168,2050,2400,3100,7440000,2,16406,4103,1,149720000,149720000,6151,2050,4101,2050,0,1,2052,456734
168,2050,2400,3100,7440000,2,16406,4103,1,149720000,149720000,6151,2050,4101,2050,0,1,2052,455602
168,2050,2400,3100,7440000,2,16406,4103,1,149720000,149720000,6151,2050,4101,2050,0,1,2052,454532
168,2450,2400,3100,7440000,2,19606,4903,1,167320000,167320000,7351,2450,4901,2450,0,1,2452,5223338
168,2450,2400,3100,7440000,2,19606,4903,1,167320000,167320000,7351,2450,4901,2450,0,1,2452,501529
168,2450,2400,3100,7440000,2,19606,4903,1,167320000,167320000,7351,2450,4901,2450,0,1,2452,483069
168,2450,2400,3100,7440000,2,19606,4903,1,167320000,167320000,7351,2450,4901,2450,0,1,2452,505934
168,2450,2400,3100,7440000,2,19606,4903,1,167320000,167320000,7351,2450,4901,2450,0,1,2452,482002
168,2450,2400,3100,7440000,2,19606,4903,1,167320000,167320000,7351,2450,4901,2450,0,1,2452,515831
168,2450,2400,3100,7440000,2,19606,4903,1,167320000,167320000,7351,2450,4901,2450,0,1,2452,536347
168,2850,2400,3100,7440000,2,22806,5703,1,184920000,184920000,8551,2850,5701,2850,0,1,2852,5988053
168,2850,2400,3100,7440000,2,22806,5703,1,184920000,184920000,8551,2850,5701,2850,0,1,2852,571604
168,2850,2400,3100,7440000,2,22806,5703,1,184920000,184920000,8551,2850,5701,2850,0,1,2852,595688
168,2850,2400,3100,7440000,2,22806,5703,1,184920000,184920000,8551,2850,5701,2850,0,1,2852,577389
168,2850,2400,3100,7440000,2,22806,5703,1,184920000,184920000,8551,2850,5701,2850,0,1,2852,600945
168,2850,2400,3100,7440000,2,22806,5703,1,184920000,184920000,8551,2850,5701,2850,0,1,2852,598880
168,2850,2400,3100,7440000,2,22806,5703,1,184920000,184920000,8551,2850,5701,2850,0,1,2852,598386
168,3250,2400,3100,7440000,2,26006,6503,1,202520000,202520000,9751,3250,6501,3250,0,1,3252,6788484
168,3250,2400,3100,7440000,2,26006,6503,1,202520000,202520000,9751,3250,6501,3250,0,1,3252,640269
168,3250,2400,3100,7440000,2,26006,6503,1,202520000,202520000,9751,3250,6501,3250,0,1,3252,632859
168,3250,2400,3100,7440000,2,26006,6503,1,202520000,202520000,9751,3250,6501,3250,0,1,3252,637869
168,3250,2400,3100,7440000,2,26006,6503,1,202520000,202520000,9751,3250,6501,3250,0,1,3252,639260
168,3250,2400,3100,7440000,2,26006,6503,1,202520000,202520000,9751,3250,6501,3250,0,1,3252,668666
168,3250,2400,3100,7440000,2,26006,6503,1,202520000,202520000,9751,3250,6501,3250,0,1,3252,668187
168,3650,2400,3100,7440000,2,29206,7303,1,220120000,220120000,10951,3650,7301,3650,0,1,3652,7739853
168,3650,2400,3100,7440000,2,29206,7303,1,220120000,220120000,10951,3650,7301,3650,0,1,3652,705829
168,3650,2400,3100,7440000,2,29206,7303,1,220120000,220120000,10951,3650,7301,3650,0,1,3652,706351
168,3650,2400,3100,7440000,2,29206,7303,1,220120000,220120000,10951,3650,7301,3650,0,1,3652,707006
168,3650,2400,3100,7440000,2,29206,7303,1,220120000,220120000,10951,3650,7301,3650,0,1,3652,704665
168,3650,2400,3100,7440000,2,29206,7303,1,220120000,220120000,10951,3650,7301,3650,0,1,3652,754622
168,3650,2400,3100,7440000,2,29206,7303,1,220120000,220120000,10951,3650,7301,3650,0,1,3652,735959
168,4050,2400,3100,7440000,2,32406,8103,1,237720000,237720000,12151,4050,8101,4050,0,1,4052,8707716
168,4050,2400,3100,7440000,2,32406,8103,1,237720000,237720000,12151,4050,8101,4050,0,1,4052,775915
168,4050,2400,3100,7440000,2,32406,8103,1,237720000,237720000,12151,4050,8101,4050,0,1,4052,774170
168,4050,2400,3100,7440000,2,32406,8103,1,237720000,237720000,12151,4050,8101,4050,0,1,4052,776650
168,4050,2400,3100,7440000,2,32406,8103,1,237720000,237720000,12151,4050,8101,4050,0,1,4052,777356
168,4050,2400,3100,7440000,2,32406,8103,1,237720000,237720000,12151,4050,8101,4050,0,1,4052,832440
168,4050,2400,3100,7440000,2,32406,8103,1,237720000,237720000,12151,4050,8101,4050,0,1,4052,833019
168,4450,2400,3100,7440000,2,35606,8903,1,255320000,255320000,13351,4450,8901,4450,0,1,4452,9345483
168,4450,2400,3100,7440000,2,35606,8903,1,255320000,255320000,13351,4450,8901,4450,0,1,4452,841302
168,4450,2400,3100,7440000,2,35606,8903,1,255320000,255320000,13351,4450,8901,4450,0,1,4452,837317
168,4450,2400,3100,7440000,2,35606,8903,1,255320000,255320000,13351,4450,8901,4450,0,1,4452,840789
168,4450,2400,3100,7440000,2,35606,8903,1,255320000,255320000,13351,4450,8901,4450,0,1,4452,840143
168,4450,2400,3100,7440000,2,35606,8903,1,255320000,255320000,13351,4450,8901,4450,0,1,4452,883330
168,4450,2400,3100,7440000,2,35606,8903,1,255320000,255320000,13351,4450,8901,4450,0,1,4452,884679
168,4850,2400,3100,7440000,2,38806,9703,1,272920000,272920000,14551,4850,9701,4850,0,1,4852,10535756
168,4850,2400,3100,7440000,2,38806,9703,1,272920000,272920000,14551,4850,9701,4850,0,1,4852,956893
168,4850,2400,3100,7440000,2,38806,9703,1,272920000,272920000,14551,4850,9701,4850,0,1,4852,916261
168,4850,2400,3100,7440000,2,38806,9703,1,272920000,272920000,14551,4850,9701,4850,0,1,4852,952351
168,4850,2400,3100,7440000,2,38806,9703,1,272920000,272920000,14551,4850,9701,4850,0,1,4852,943037
168,4850,2400,3100,7440000,2,38806,9703,1,272920000,272920000,14551,4850,9701,4850,0,1,4852,964883
168,4850,2400,3100,7440000,2,38806,9703,1,272920000,272920000,14551,4850,9701,4850,0,1,4852,978525
168,5250,2400,3100,7440000,2,42006,10503,1,290520000,290520000,15751,5250,10501,5250,0,1,5252,11491479
168,5250,2400,3100,7440000,2,42006,10503,1,290520000,290520000,15751,5250,10501,5250,0,1,5252,992212
168,5250,2400,3100,7440000,2,42006,10503,1,290520000,290520000,15751,5250,10501,5250,0,1,5252,991145
168,5250,2400,3100,7440000,2,42006,10503,1,290520000,290520000,15751,5250,10501,5250,0,1,5252,993123
168,5250,2400,3100,7440000,2,42006,10503,1,290520000,290520000,15751,5250,10501,5250,0,1,5252,985521
168,5250,2400,3100,7440000,2,42006,10503,1,290520000,290520000,15751,5250,10501,5250,0,1,5252,1028457
168,5250,2400,3100,7440000,2,42006,10503,1,290520000,290520000,15751,5250,10501,5250,0,1,5252,1006674
168,5650,2400,3100,7440000,2,45206,11303,1,308120000,308120000,16951,5650,11301,5650,0,1,5652,11884994
168,5650,2400,3100,7440000,2,45206,11303,1,308120000,308120000,16951,5650,11301,5650,0,1,5652,1074092
168,5650,2400,3100,7440000,2,45206,11303,1,308120000,308120000,16951,5650,11301,5650,0,1,5652,1079990
168,5650,2400,3100,7440000,2,45206,11303,1,308120000,308120000,16951,5650,11301,5650,0,1,5652,1081456
168,5650,2400,3100,7440000,2,45206,11303,1,308120000,308120000,16951,5650,11301,5650,0,1,5652,1078219
168,5650,2400,3100,7440000,2,45206,11303,1,308120000,308120000,16951,5650,11301,5650,0,1,5652,1094654
168,5650,2400,3100,7440000,2,45206,11303,1,308120000,308120000,16951,5650,11301,5650,0,1,5652,1095276
168,6050,2400,3100,7440000,2,48406,12103,1,325720000,325720000,18151,6050,12101,6050,0,1,6052,12997267
168,6050,2400,3100,7440000,2,48406,12103,1,325720000,325720000,18151,6050,12101,6050,0,1,6052,1164992
168,6050,2400,3100,7440000,2,48406,12103,1,325720000,325720000,18151,6050,12101,6050,0,1,6052,1176219
168,6050,2400,3100,7440000,2,48406,12103,1,325720000,325720000,18151,6050,12101,6050,0,1,6052,1184147
168,6050,2400,3100,7440000,2,48406,12103,1,325720000,325720000,18151,6050,12101,6050,0,1,6052,1125252
168,6050,2400,3100,7440000,2,48406,12103,1,325720000,325720000,18151,6050,12101,6050,0,1,6052,1187080
168,6050,2400,3100,7440000,2,48406,12103,1,325720000,325720000,18151,6050,12101,6050,0,1,6052,1189458
168,6450,2400,3100,7440000,2,51606,12903,1,343320000,343320000,19351,6450,12901,6450,0,1,6452,13943735
168,6450,2400,3100,7440000,2,51606,12903,1,343320000,343320000,19351,6450,12901,6450,0,1,6452,1238024
168,6450,2400,3100,7440000,2,51606,12903,1,343320000,343320000,19351,6450,12901,6450,0,1,6452,1226248
168,6450,2400,3100,7440000,2,51606,12903,1,343320000,343320000,19351,6450,12901,6450,0,1,6452,1240286
168,6450,2400,3100,7440000,2,51606,12903,1,343320000,343320000,19351,6450,12901,6450,0,1,6452,1248963
168,6450,2400,3100,7440000,2,51606,12903,1,343320000,343320000,19351,6450,12901,6450,0,1,6452,1251815
168,6450,2400,3100,7440000,2,51606,12903,1,343320000,343320000,19351,6450,12901,6450,0,1,6452,1249622
168,6850,2400,3100,7440000,2,54806,13703,1,360920000,360920000,20551,6850,13701,6850,0,1,6852,14829707
168,6850,2400,3100,7440000,2,54806,13703,1,360920000,360920000,20551,6850,13701,6850,0,1,6852,1314658
168,6850,2400,3100,7440000,2,54806,13703,1,360920000,360920000,20551,6850,13701,6850,0,1,6852,1304422
168,6850,2400,3100,7440000,2,54806,13703,1,360920000,360920000,20551,6850,13701,6850,0,1,6852,1315969
168,6850,2400,3100,7440000,2,54806,13703,1,360920000,360920000,20551,6850,13701,6850,0,1,6852,1313918
168,6850,2400,3100,7440000,2,54806,13703,1,360920000,360920000,20551,6850,13701,6850,0,1,6852,1319431
168,6850,2400,3100,7440000,2,54806,13703,1,360920000,360920000,20551,6850,13701,6850,0,1,6852,1318764
168,50,2400,2700,6480000,2,406,103,1,53880000,53880000,151,50,101,50,0,1,52,68719
168,50,2400,2700,6480000,2,406,103,1,53880000,53880000,151,50,101,50,0,1,52,65720
168,50,2400,2700,6480000,2,406,103,1,53880000,53880000,151,50,101,50,0,1,52,58553
168,50,2400,2700,6480000,2,406,103,1,53880000,53880000,151,50,101,50,0,1,52,67099
168,50,2400,2700,6480000,2,406,103,1,53880000,53880000,151,50,101,50,0,1,52,66513
168,50,2400,2700,6480000,2,406,103,1,53880000,53880000,151,50,101,50,0,1,52,80812
168,50,2400,2700,6480000,2,406,103,1,53880000,53880000,151,50,101,50,0,1,52,81235
168,450,2400,2700,6480000,2,3606,903,1,70200000,70200000,1351,450,901,450,0,1,452,688914
168,450,2400,2700,6480000,2,3606,903,1,70200000,70200000,1351,450,901,450,0,1,452,127906
168,450,2400,2700,6480000,2,3606,903,1,70200000,70200000,1351,450,901,450,0,1,452,120107
168,450,2400,2700,6480000,2,3606,903,1,70200000,70200000,1351,450,901,450,0,1,452,128328
168,450,2400,2700,6480000,2,3606,903,1,70200000,70200000,1351,450,901,450,0,1,452,129203
168,450,2400,2700,6480000,2,3606,903,1,70200000,70200000,1351,450,901,450,0,1,452,145500
168,450,2400,2700,6480000,2,3606,903,1,70200000,70200000,1351,450,901,450,0,1,452,145029
168,850,2400,2700,6480000,2,6806,1703,1,86520000,86520000,2551,850,1701,850,0,1,852,1347270
168,850,2400,2700,6480000,2,6806,1703,1,86520000,86520000,2551,850,1701,850,0,1,852,196796
168,850,2400,2700,6480000,2,6806,1703,1,86520000,86520000,2551,850,1701,850,0,1,852,196554
168,850,2400,2700,6480000,2,6806,1703,1,86520000,86520000,2551,850,1701,850,0,1,852,195596
168,850,2400,2700,6480000,2,6806,1703,1,86520000,86520000,2551,850,1701,850,0,1,852,196116
168,850,2400,2700,6480000,2,6806,1703,1,86520000,86520000,2551,850,1701,850,0,1,852,207616
168,850,2400,2700,6480000,2,6806,1703,1,86520000,86520000,2551,850,1701,850,0,1,852,207261
168,1250,2400,2700,6480000,2,10006,2503,1,102840000,102840000,3751,1250,2501,1250,0,1,1252,2094661
168,1250,2400,2700,6480000,2,10006,2503,1,102840000,102840000,3751,1250,2501,1250,0,1,1252,267761
168,1250,2400,2700,6480000,2,10006,2503,1,102840000,102840000,3751,1250,2501,1250,0,1,1252,268281
168,1250,2400,2700,6480000,2,10006,2503,1,102840000,102840000,3751,1250,2501,1250,0,1,1252,267425
168,1250,2400,2700,6480000,2,10006,2503,1,102840000,102840000,3751,1250,2501,1250,0,1,1252,263658
168,1250,2400,2700,6480000,2,10006,2503,1,102840000,102840000,3751,1250,2501,1250,0,1,1252,268620
168,1250,2400,2700,6480000,2,10006,2503,1,102840000,102840000,3751,1250,2501,1250,0,1,1252,268819
168,1650,2400,2700,6480000,2,13206,3303,1,119160000,119160000,4951,1650,3301,1650,0,1,1652,2797249
168,1650,2400,2700,6480000,2,13206,3303,1,119160000,119160000,4951,1650,3301,1650,0,1,1652,334218
168,1650,2400,2700,6480000,2,13206,3303,1,119160000,119160000,4951,1650,3301,1650,0,1,1652,334510
168,1650,2400,2700,6480000,2,13206,3303,1,119160000,119160000,4951,1650,3301,1650,0,1,1652,333505
168,1650,2400,2700,6480000,2,13206,3303,1,119160000,119160000,4951,1650,3301,1650,0,1,1652,333952
168,1650,2400,2700,6480000,2,13206,3303,1,119160000,119160000,4951,1650,3301,1650,0,1,1652,333728
168,1650,2400,2700,6480000,2,13206,3303,1,119160000,119160000,4951,1650,3301,1650,0,1,1652,333171
168,2050,2400,2700,6480000,2,16406,4103,1,135480000,135480000,6151,2050,4101,2050,0,1,2052,3552740
168,2050,2400,2700,6480000,2,16406,4103,1,135480000,135480000,6151,2050,4101,2050,0,1,2052,402640
168,2050,2400,2700,6480000,2,16406,4103,1,135480000,135480000,6151,2050,4101,2050,0,1,2052,388992
168,2050,2400,2700,6480000,2,16406,4103,1,135480000,135480000,6151,2050,4101,2050,0,1,2052,401139
168,2050,2400,2700,6480000,2,16406,4103,1,135480000,135480000,6151,2050,4101,2050,0,1,2052,391819
168,2050,2400,2700,6480000,2,16406,4103,1,135480000,135480000,6151,2050,4101,2050,0,1,2052,393794
168,2050,2400,2700,6480000,2,16406,4103,1,135480000,135480000,6151,2050,4101,2050,0,1,2052,401584
168,2450,2400,2700,6480000,2,19606,4903,1,151800000,151800000,7351,2450,4901,2450,0,1,2452,4461705
168,2450,2400,2700,6480000,2,19606,4903,1,151800000,151800000,7351,2450,4901,2450,0,1,2452,461812
168,2450,2400,2700,6480000,2,19606,4903,1,151800000,151800000,7351,2450,4901,2450,0,1,2452,469474
168,2450,2400,2700,6480000,2,19606,4903,1,151800000,151800000,7351,2450,4901,2450,0,1,2452,465495
168,2450,2400,2700,6480000,2,19606,4903,1,151800000,151800000,7351,2450,4901,2450,0,1,2452,468912
168,2450,2400,2700,6480000,2,19606,4903,1,151800000,151800000,7351,2450,4901,2450,0,1,2452,465018
168,2450,2400,2700,6480000,2,19606,4903,1,151800000,151800000,7351,2450,4901,2450,0,1,2452,464423
168,2850,2400,2700,6480000,2,22806,5703,1,168120000,168120000,8551,2850,5701,2850,0,1,2852,5216027
168,2850,2400,2700,6480000,2,22806,5703,1,168120000,168120000,8551,2850,5701,2850,0,1,2852,512819
168,2850,2400,2700,6480000,2,22806,5703,1,168120000,168120000,8551,2850,5701,2850,0,1,2852,501200
168,2850,2400,2700,6480000,2,22806,5703,1,168120000,168120000,8551,2850,5701,2850,0,1,2852,511994
168,2850,2400,2700,6480000,2,22806,5703,1,168120000,168120000,8551,2850,5701,2850,0,1,2852,510820
168,2850,2400,2700,6480000,2,22806,5703,1,168120000,168120000,8551,2850,5701,2850,0,1,2852,523721
168,2850,2400,2700,6480000,2,22806,5703,1,168120000,168120000,8551,2850,5701,2850,0,1,2852,523258
168,3250,2400,2700,6480000,2,26006,6503,1,184440000,184440000,9751,3250,6501,3250,0,1,3252,5946382
168,3250,2400,2700,6480000,2,26006,6503,1,184440000,184440000,9751,3250,6501,3250,0,1,3252,589388
168,3250,2400,2700,6480000,2,26006,6503,1,184440000,184440000,9751,3250,6501,3250,0,1,3252,590941
168,3250,2400,2700,6480000,2,26006,6503,1,184440000,184440000,9751,3250,6501,3250,0,1,3252,592008
168,3250,2400,2700,6480000,2,26006,6503,1,184440000,184440000,9751,3250,6501,3250,0,1,3252,591592
168,3250,2400,2700,6480000,2,26006,6503,1,184440000,184440000,9751,3250,6501,3250,0,1,3252,593291
168,3250,2400,2700,6480000,2,26006,6503,1,184440000,184440000,9751,3250,6501,3250,0,1,3252,590469
168,3650,2400,2700,6480000,2,29206,7303,1,200760000,200760000,10951,3650,7301,3650,0,1,3652,6577649
168,3650,2400,2700,6480000,2,29206,7303,1,200760000,200760000,10951,3650,7301,3650,0,1,3652,619684
168,3650,2400,2700,6480000,2,29206,7303,1,200760000,200760000,10951,3650,7301,3650,0,1,3652,613901
168,3650,2400,2700,6480000,2,29206,7303,1,200760000,200760000,10951,3650,7301,3650,0,1,3652,619231
168,3650,2400,2700,6480000,2,29206,7303,1,200760000,200760000,10951,3650,7301,3650,0,1,3652,618638
168,3650,2400,2700,6480000,2,29206,7303,1,200760000,200760000,10951,3650,7301,3650,0,1,3652,650143
168,3650,2400,2700,6480000,2,29206,7303,1,200760000,200760000,10951,3650,7301,3650,0,1,3652,649640
168,4050,2400,2700,6480000,2,32406,8103,1,217080000,217080000,12151,4050,8101,4050,0,1,4052,7494713
168,4050,2400,2700,6480000,2,32406,8103,1,217080000,217080000,12151,4050,8101,4050,0,1,4052,721944
168,4050,2400,2700,6480000,2,32406,8103,1,217080000,217080000,12151,4050,8101,4050,0,1,4052,720147
168,4050,2400,2700,6480000,2,32406,8103,1,217080000,217080000,12151,4050,8101,4050,0,1,4052,723072
168,4050,2400,2700,6480000,2,32406,8103,1,217080000,217080000,12151,4050,8101,4050,0,1,4052,722580
168,4050,2400,2700,6480000,2,32406,8103,1,217080000,217080000,12151,4050,8101,4050,0,1,4052,719872
168,4050,2400,2700,6480000,2,32406,8103,1,217080000,217080000,12151,4050,8101,4050,0,1,4052,718578
168,4450,2400,2700,6480000,2,35606,8903,1,233400000,233400000,13351,4450,8901,4450,0,1,4452,8207936
168,4450,2400,2700,6480000,2,35606,8903,1,233400000,233400000,13351,4450,8901,4450,0,1,4452,745048
168,4450,2400,2700,6480000,2,35606,8903,1,233400000,233400000,13351,4450,8901,4450,0,1,4452,744391
168,4450,2400,2700,6480000,2,35606,8903,1,233400000,233400000,13351,4450,8901,4450,0,1,4452,747873
168,4450,2400,2700,6480000,2,35606,8903,1,233400000,233400000,13351,4450,8901,4450,0,1,4452,747138
168,4450,2400,2700,6480000,2,35606,8903,1,233400000,233400000,13351,4450,8901,4450,0,1,4452,797126
168,4450,2400,2700,6480000,2,35606,8903,1,233400000,233400000,13351,4450,8901,4450,0,1,4452,796571
168,4850,2400,2700,6480000,2,38806,9703,1,249720000,249720000,14551,4850,9701,4850,0,1,4852,8953020
168,4850,2400,2700,6480000,2,38806,9703,1,249720000,249720000,14551,4850,9701,4850,0,1,4852,834357
168,4850,2400,2700,6480000,2,38806,9703,1,249720000,249720000,14551,4850,9701,4850,0,1,4852,835625
168,4850,2400,2700,6480000,2,38806,9703,1,249720000,249720000,14551,4850,9701,4850,0,1,4852,826699
168,4850,2400,2700,6480000,2,38806,9703,1,249720000,249720000,14551,4850,9701,4850,0,1,4852,810201
168,4850,2400,2700,6480000,2,38806,9703,1,249720000,249720000,14551,4850,9701,4850,0,1,4852,849121
168,4850,2400,2700,6480000,2,38806,9703,1,249720000,249720000,14551,4850,9701,4850,0,1,4852,871026
168,5250,2400,2700,6480000,2,42006,10503,1,266040000,266040000,15751,5250,10501,5250,0,1,5252,9561968
168,5250,2400,2700,6480000,2,42006,10503,1,266040000,266040000,15751,5250,10501,5250,0,1,5252,866337
168,5250,2400,2700,6480000,2,42006,10503,1,266040000,266040000,15751,5250,10501,5250,0,1,5252,863127
168,5250,2400,2700,6480000,2,42006,10503,1,266040000,266040000,15751,5250,10501,5250,0,1,5252,870320
168,5250,2400,2700,6480000,2,42006,10503,1,266040000,266040000,15751,5250,10501,5250,0,1,5252,869054
168,5250,2400,2700,6480000,2,42006,10503,1,266040000,266040000,15751,5250,10501,5250,0,1,5252,924568
168,5250,2400,2700,6480000,2,42006,10503,1,266040000,266040000,15751,5250,10501,5250,0,1,5252,891952
168,5650,2400,2700,6480000,2,45206,11303,1,282360000,282360000,16951,5650,11301,5650,0,1,5652,10651446
168,5650,2400,2700,6480000,2,45206,11303,1,282360000,282360000,16951,5650,11301,5650,0,1,5652,923515
168,5650,2400,2700,6480000,2,45206,11303,1,282360000,282360000,16951,5650,11301,5650,0,1,5652,917903
168,5650,2400,2700,6480000,2,45206,11303,1,282360000,282360000,16951,5650,11301,5650,0,1,5652,925165
168,5650,2400,2700,6480000,2,45206,11303,1,282360000,282360000,16951,5650,11301,5650,0,1,5652,921821
168,5650,2400,2700,6480000,2,45206,11303,1,282360000,282360000,16951,5650,11301,5650,0,1,5652,954093
168,5650,2400,2700,6480000,2,45206,11303,1,282360000,282360000,16951,5650,11301,5650,0,1,5652,954698
168,6050,2400,2700,6480000,2,48406,12103,1,298680000,298680000,18151,6050,12101,6050,0,1,6052,11104134
168,6050,2400,2700,6480000,2,48406,12103,1,298680000,298680000,18151,6050,12101,6050,0,1,6052,1002725
168,6050,2400,2700,6480000,2,48406,12103,1,298680000,298680000,18151,6050,12101,6050,0,1,6052,999867
168,6050,2400,2700,6480000,2,48406,12103,1,298680000,298680000,18151,6050,12101,6050,0,1,6052,1007547
168,6050,2400,2700,6480000,2,48406,12103,1,298680000,298680000,18151,6050,12101,6050,0,1,6052,1005919
168,6050,2400,2700,6480000,2,48406,12103,1,298680000,298680000,18151,6050,12101,6050,0,1,6052,1026242
168,6050,2400,2700,6480000,2,48406,12103,1,298680000,298680000,18151,6050,12101,6050,0,1,6052,1025598
168,6450,2400,2700,6480000,2,51606,12903,1,315000000,315000000,19351,6450,12901,6450,0,1,6452,11681674
168,6450,2400,2700,6480000,2,51606,12903,1,315000000,315000000,19351,6450,12901,6450,0,1,6452,1131612
168,6450,2400,2700,6480000,2,51606,12903,1,315000000,315000000,19351,6450,12901,6450,0,1,6452,1100623
168,6450,2400,2700,6480000,2,51606,12903,1,315000000,315000000,19351,6450,12901,6450,0,1,6452,1129682
168,6450,2400,2700,6480000,2,51606,12903,1,315000000,315000000,19351,6450,12901,6450,0,1,6452,1118910
168,6450,2400,2700,6480000,2,51606,12903,1,315000000,315000000,19351,6450,12901,6450,0,1,6452,1127955
168,6450,2400,2700,6480000,2,51606,12903,1,315000000,315000000,19351,6450,12901,6450,0,1,6452,1132282
168,6850,2400,2700,6480000,2,54806,13703,1,331320000,331320000,20551,6850,13701,6850,0,1,6852,13277886
168,6850,2400,2700,6480000,2,54806,13703,1,331320000,331320000,20551,6850,13701,6850,0,1,6852,1151163
168,6850,2400,2700,6480000,2,54806,13703,1,331320000,331320000,20551,6850,13701,6850,0,1,6852,1142970
168,6850,2400,2700,6480000,2,54806,13703,1,331320000,331320000,20551,6850,13701,6850,0,1,6852,1159984
168,6850,2400,2700,6480000,2,54806,13703,1,331320000,331320000,20551,6850,13701,6850,0,1,6852,1157907
168,6850,2400,2700,6480000,2,54806,13703,1,331320000,331320000,20551,6850,13701,6850,0,1,6852,1171164
168,6850,2400,2700,6480000,2,54806,13703,1,331320000,331320000,20551,6850,13701,6850,0,1,6852,1164528
168,50,2400,2300,5520000,2,406,103,1,46040000,46040000,151,50,101,50,0,1,52,58400
168,50,2400,2300,5520000,2,406,103,1,46040000,46040000,151,50,101,50,0,1,52,57545
168,50,2400,2300,5520000,2,406,103,1,46040000,46040000,151,50,101,50,0,1,52,54850
168,50,2400,2300,5520000,2,406,103,1,46040000,46040000,151,50,101,50,0,1,52,45679
168,50,2400,2300,5520000,2,406,103,1,46040000,46040000,151,50,101,50,0,1,52,57101
168,50,2400,2300,5520000,2,406,103,1,46040000,46040000,151,50,101,50,0,1,52,69948
168,50,2400,2300,5520000,2,406,103,1,46040000,46040000,151,50,101,50,0,1,52,67298
168,450,2400,2300,5520000,2,3606,903,1,61080000,61080000,1351,450,901,450,0,1,452,546571
168,450,2400,2300,5520000,2,3606,903,1,61080000,61080000,1351,450,901,450,0,1,452,109139
168,450,2400,2300,5520000,2,3606,903,1,61080000,61080000,1351,450,901,450,0,1,452,91074
168,450,2400,2300,5520000,2,3606,903,1,61080000,61080000,1351,450,901,450,0,1,452,105883
168,450,2400,2300,5520000,2,3606,903,1,61080000,61080000,1351,450,901,450,0,1,452,108679
168,450,2400,2300,5520000,2,3606,903,1,61080000,61080000,1351,450,901,450,0,1,452,124441
168,450,2400,2300,5520000,2,3606,903,1,61080000,61080000,1351,450,901,450,0,1,452,123333
168,850,2400,2300,5520000,2,6806,1703,1,76120000,76120000,2551,850,1701,850,0,1,852,1123288
168,850,2400,2300,5520000,2,6806,1703,1,76120000,76120000,2551,850,1701,850,0,1,852,172293
168,850,2400,2300,5520000,2,6806,1703,1,76120000,76120000,2551,850,1701,850,0,1,852,170148
168,850,2400,2300,5520000,2,6806,1703,1,76120000,76120000,2551,850,1701,850,0,1,852,172035
168,850,2400,2300,5520000,2,6806,1703,1,76120000,76120000,2551,850,1701,850,0,1,852,171585
168,850,2400,2300,5520000,2,6806,1703,1,76120000,76120000,2551,850,1701,850,0,1,852,186128
168,850,2400,2300,5520000,2,6806,1703,1,76120000,76120000,2551,850,1701,850,0,1,852,184953
168,1250,2400,2300,5520000,2,10006,2503,1,91160000,91160000,3751,1250,2501,1250,0,1,1252,1718532
168,1250,2400,2300,5520000,2,10006,2503,1,91160000,91160000,3751,1250,2501,1250,0,1,1252,236791
168,1250,2400,2300,5520000,2,10006,2503,1,91160000,91160000,3751,1250,2501,1250,0,1,1252,233246
168,1250,2400,2300,5520000,2,10006,2503,1,91160000,91160000,3751,1250,2501,1250,0,1,1252,236111
168,1250,2400,2300,5520000,2,10006,2503,1,91160000,91160000,3751,1250,2501,1250,0,1,1252,236533
168,1250,2400,2300,5520000,2,10006,2503,1,91160000,91160000,3751,1250,2501,1250,0,1,1252,234608
168,1250,2400,2300,5520000,2,10006,2503,1,91160000,91160000,3751,1250,2501,1250,0,1,1252,235004
168,1650,2400,2300,5520000,2,13206,3303,1,106200000,106200000,4951,1650,3301,1650,0,1,1652,2369086
168,1650,2400,2300,5520000,2,13206,3303,1,106200000,106200000,4951,1650,3301,1650,0,1,1652,275162
168,1650,2400,2300,5520000,2,13206,3303,1,106200000,106200000,4951,1650,3301,1650,0,1,1652,264163
168,1650,2400,2300,5520000,2,13206,3303,1,106200000,106200000,4951,1650,3301,1650,0,1,1652,286985
168,1650,2400,2300,5520000,2,13206,3303,1,106200000,106200000,4951,1650,3301,1650,0,1,1652,286385
168,1650,2400,2300,5520000,2,13206,3303,1,106200000,106200000,4951,1650,3301,1650,0,1,1652,287318
168,1650,2400,2300,5520000,2,13206,3303,1,106200000,106200000,4951,1650,3301,1650,0,1,1652,287681
168,2050,2400,2300,5520000,2,16406,4103,1,121240000,121240000,6151,2050,4101,2050,0,1,2052,3091949
168,2050,2400,2300,5520000,2,16406,4103,1,121240000,121240000,6151,2050,4101,2050,0,1,2052,342858
168,2050,2400,2300,5520000,2,16406,4103,1,121240000,121240000,6151,2050,4101,2050,0,1,2052,344030
168,2050,2400,2300,5520000,2,16406,4103,1,121240000,121240000,6151,2050,4101,2050,0,1,2052,344448
168,2050,2400,2300,5520000,2,16406,4103,1,121240000,121240000,6151,2050,4101,2050,0,1,2052,340645
168,2050,2400,2300,5520000,2,16406,4103,1,121240000,121240000,6151,2050,4101,2050,0,1,2052,344910
168,2050,2400,2300,5520000,2,16406,4103,1,121240000,121240000,6151,2050,4101,2050,0,1,2052,345337
168,2450,2400,2300,5520000,2,19606,4903,1,136280000,136280000,7351,2450,4901,2450,0,1,2452,3743115
168,2450,2400,2300,5520000,2,19606,4903,1,136280000,136280000,7351,2450,4901,2450,0,1,2452,393301
168,2450,2400,2300,5520000,2,19606,4903,1,136280000,136280000,7351,2450,4901,2450,0,1,2452,399380
168,2450,2400,2300,5520000,2,19606,4903,1,136280000,136280000,7351,2450,4901,2450,0,1,2452,395298
168,2450,2400,2300,5520000,2,19606,4903,1,136280000,136280000,7351,2450,4901,2450,0,1,2452,399737
168,2450,2400,2300,5520000,2,19606,4903,1,136280000,136280000,7351,2450,4901,2450,0,1,2452,398865
168,2450,2400,2300,5520000,2,19606,4903,1,136280000,136280000,7351,2450,4901,2450,0,1,2452,398297
168,2850,2400,2300,5520000,2,22806,5703,1,151320000,151320000,8551,2850,5701,2850,0,1,2852,4292212
168,2850,2400,2300,5520000,2,22806,5703,1,151320000,151320000,8551,2850,5701,2850,0,1,2852,429774
168,2850,2400,2300,5520000,2,22806,5703,1,151320000,151320000,8551,2850,5701,2850,0,1,2852,431849
168,2850,2400,2300,5520000,2,22806,5703,1,151320000,151320000,8551,2850,5701,2850,0,1,2852,431308
168,2850,2400,2300,5520000,2,22806,5703,1,151320000,151320000,8551,2850,5701,2850,0,1,2852,432239
168,2850,2400,2300,5520000,2,22806,5703,1,151320000,151320000,8551,2850,5701,2850,0,1,2852,467369
168,2850,2400,2300,5520000,2,22806,5703,1,151320000,151320000,8551,2850,5701,2850,0,1,2852,467831
168,3250,2400,2300,5520000,2,26006,6503,1,166360000,166360000,9751,3250,6501,3250,0,1,3252,4900656
168,3250,2400,2300,5520000,2,26006,6503,1,166360000,166360000,9751,3250,6501,3250,0,1,3252,512459
168,3250,2400,2300,5520000,2,26006,6503,1,166360000,166360000,9751,3250,6501,3250,0,1,3252,477558
168,3250,2400,2300,5520000,2,26006,6503,1,166360000,166360000,9751,3250,6501,3250,0,1,3252,516902
168,3250,2400,2300,5520000,2,26006,6503,1,166360000,166360000,9751,3250,6501,3250,0,1,3252,502042
168,3250,2400,2300,5520000,2,26006,6503,1,166360000,166360000,9751,3250,6501,3250,0,1,3252,504828
168,3250,2400,2300,5520000,2,26006,6503,1,166360000,166360000,9751,3250,6501,3250,0,1,3252,504094
168,3650,2400,2300,5520000,2,29206,7303,1,181400000,181400000,10951,3650,7301,3650,0,1,3652,5536093
168,3650,2400,2300,5520000,2,29206,7303,1,181400000,181400000,10951,3650,7301,3650,0,1,3652,532288
168,3650,2400,2300,5520000,2,29206,7303,1,181400000,181400000,10951,3650,7301,3650,0,1,3652,547998
168,3650,2400,2300,5520000,2,29206,7303,1,181400000,181400000,10951,3650,7301,3650,0,1,3652,536469
168,3650,2400,2300,5520000,2,29206,7303,1,181400000,181400000,10951,3650,7301,3650,0,1,3652,554098
168,3650,2400,2300,5520000,2,29206,7303,1,181400000,181400000,10951,3650,7301,3650,0,1,3652,569915
168,3650,2400,2300,5520000,2,29206,7303,1,181400000,181400000,10951,3650,7301,3650,0,1,3652,596023
168,4050,2400,2300,5520000,2,32406,8103,1,196440000,196440000,12151,4050,8101,4050,0,1,4052,6090078
168,4050,2400,2300,5520000,2,32406,8103,1,196440000,196440000,12151,4050,8101,4050,0,1,4052,605022
168,4050,2400,2300,5520000,2,32406,8103,1,196440000,196440000,12151,4050,8101,4050,0,1,4052,588909
168,4050,2400,2300,5520000,2,32406,8103,1,196440000,196440000,12151,4050,8101,4050,0,1,4052,604325
168,4050,2400,2300,5520000,2,32406,8103,1,196440000,196440000,12151,4050,8101,4050,0,1,4052,603587
168,4050,2400,2300,5520000,2,32406,8103,1,196440000,196440000,12151,4050,8101,4050,0,1,4052,660905
168,4050,2400,2300,5520000,2,32406,8103,1,196440000,196440000,12151,4050,8101,4050,0,1,4052,660368
168,4450,2400,2300,5520000,2,35606,8903,1,211480000,211480000,13351,4450,8901,4450,0,1,4452,7068825
168,4450,2400,2300,5520000,2,35606,8903,1,211480000,211480000,13351,4450,8901,4450,0,1,4452,668978
168,4450,2400,2300,5520000,2,35606,8903,1,211480000,211480000,13351,4450,8901,4450,0,1,4452,662025
168,4450,2400,2300,5520000,2,35606,8903,1,211480000,211480000,13351,4450,8901,4450,0,1,4452,667456
168,4450,2400,2300,5520000,2,35606,8903,1,211480000,211480000,13351,4450,8901,4450,0,1,4452,665809
168,4450,2400,2300,5520000,2,35606,8903,1,211480000,211480000,13351,4450,8901,4450,0,1,4452,679229
168,4450,2400,2300,5520000,2,35606,8903,1,211480000,211480000,13351,4450,8901,4450,0,1,4452,672014
168,4850,2400,2300,5520000,2,38806,9703,1,226520000,226520000,14551,4850,9701,4850,0,1,4852,7372527
168,4850,2400,2300,5520000,2,38806,9703,1,226520000,226520000,14551,4850,9701,4850,0,1,4852,700129
168,4850,2400,2300,5520000,2,38806,9703,1,226520000,226520000,14551,4850,9701,4850,0,1,4852,700921
168,4850,2400,2300,5520000,2,38806,9703,1,226520000,226520000,14551,4850,9701,4850,0,1,4852,701677
168,4850,2400,2300,5520000,2,38806,9703,1,226520000,226520000,14551,4850,9701,4850,0,1,4852,698409
168,4850,2400,2300,5520000,2,38806,9703,1,226520000,226520000,14551,4850,9701,4850,0,1,4852,746125
168,4850,2400,2300,5520000,2,38806,9703,1,226520000,226520000,14551,4850,9701,4850,0,1,4852,745546
168,5250,2400,2300,5520000,2,42006,10503,1,241560000,241560000,15751,5250,10501,5250,0,1,5252,8190202
168,5250,2400,2300,5520000,2,42006,10503,1,241560000,241560000,15751,5250,10501,5250,0,1,5252,756739
168,5250,2400,2300,5520000,2,42006,10503,1,241560000,241560000,15751,5250,10501,5250,0,1,5252,755732
168,5250,2400,2300,5520000,2,42006,10503,1,241560000,241560000,15751,5250,10501,5250,0,1,5252,757418
168,5250,2400,2300,5520000,2,42006,10503,1,241560000,241560000,15751,5250,10501,5250,0,1,5252,758004
168,5250,2400,2300,5520000,2,42006,10503,1,241560000,241560000,15751,5250,10501,5250,0,1,5252,799574
168,5250,2400,2300,5520000,2,42006,10503,1,241560000,241560000,15751,5250,10501,5250,0,1,5252,800905
168,5650,2400,2300,5520000,2,45206,11303,1,256600000,256600000,16951,5650,11301,5650,0,1,5652,9091179
168,5650,2400,2300,5520000,2,45206,11303,1,256600000,256600000,16951,5650,11301,5650,0,1,5652,814103
168,5650,2400,2300,5520000,2,45206,11303,1,256600000,256600000,16951,5650,11301,5650,0,1,5652,787069
168,5650,2400,2300,5520000,2,45206,11303,1,256600000,256600000,16951,5650,11301,5650,0,1,5652,822094
168,5650,2400,2300,5520000,2,45206,11303,1,256600000,256600000,16951,5650,11301,5650,0,1,5652,792319
168,5650,2400,2300,5520000,2,45206,11303,1,256600000,256600000,16951,5650,11301,5650,0,1,5652,853335
168,5650,2400,2300,5520000,2,45206,11303,1,256600000,256600000,16951,5650,11301,5650,0,1,5652,853954
168,6050,2400,2300,5520000,2,48406,12103,1,271640000,271640000,18151,6050,12101,6050,0,1,6052,9134794
168,6050,2400,2300,5520000,2,48406,12103,1,271640000,271640000,18151,6050,12101,6050,0,1,6052,854384
168,6050,2400,2300,5520000,2,48406,12103,1,271640000,271640000,18151,6050,12101,6050,0,1,6052,877960
168,6050,2400,2300,5520000,2,48406,12103,1,271640000,271640000,18151,6050,12101,6050,0,1,6052,860556
168,6050,2400,2300,5520000,2,48406,12103,1,271640000,271640000,18151,6050,12101,6050,0,1,6052,881030
168,6050,2400,2300,5520000,2,48406,12103,1,271640000,271640000,18151,6050,12101,6050,0,1,6052,899792
168,6050,2400,2300,5520000,2,48406,12103,1,271640000,271640000,18151,6050,12101,6050,0,1,6052,916360
168,6450,2400,2300,5520000,2,51606,12903,1,286680000,286680000,19351,6450,12901,6450,0,1,6452,10225593
168,6450,2400,2300,5520000,2,51606,12903,1,286680000,286680000,19351,6450,12901,6450,0,1,6452,914123
168,6450,2400,2300,5520000,2,51606,12903,1,286680000,286680000,19351,6450,12901,6450,0,1,6452,905529
168,6450,2400,2300,5520000,2,51606,12903,1,286680000,286680000,19351,6450,12901,6450,0,1,6452,915533
168,6450,2400,2300,5520000,2,51606,12903,1,286680000,286680000,19351,6450,12901,6450,0,1,6452,912955
168,6450,2400,2300,5520000,2,51606,12903,1,286680000,286680000,19351,6450,12901,6450,0,1,6452,955879
168,6450,2400,2300,5520000,2,51606,12903,1,286680000,286680000,19351,6450,12901,6450,0,1,6452,939717
168,6850,2400,2300,5520000,2,54806,13703,1,301720000,301720000,20551,6850,13701,6850,0,1,6852,10879589
168,6850,2400,2300,5520000,2,54806,13703,1,301720000,301720000,20551,6850,13701,6850,0,1,6852,1010080
168,6850,2400,2300,5520000,2,54806,13703,1,301720000,301720000,20551,6850,13701,6850,0,1,6852,1000839
168,6850,2400,2300,5520000,2,54806,13703,1,301720000,301720000,20551,6850,13701,6850,0,1,6852,1012282
168,6850,2400,2300,5520000,2,54806,13703,1,301720000,301720000,20551,6850,13701,6850,0,1,6852,1003943
168,6850,2400,2300,5520000,2,54806,13703,1,301720000,301720000,20551,6850,13701,6850,0,1,6852,1018470
168,6850,2400,2300,5520000,2,54806,13703,1,301720000,301720000,20551,6850,13701,6850,0,1,6852,1019152
168,50,2400,1900,4560000,2,406,103,1,38200000,38200000,151,50,101,50,0,1,52,46895
168,50,2400,1900,4560000,2,406,103,1,38200000,38200000,151,50,101,50,0,1,52,44872
168,50,2400,1900,4560000,2,406,103,1,38200000,38200000,151,50,101,50,0,1,52,37308
168,50,2400,1900,4560000,2,406,103,1,38200000,38200000,151,50,101,50,0,1,52,49233
168,50,2400,1900,4560000,2,406,103,1,38200000,38200000,151,50,101,50,0,1,52,48778
168,50,2400,1900,4560000,2,406,103,1,38200000,38200000,151,50,101,50,0,1,52,57665
168,50,2400,1900,4560000,2,406,103,1,38200000,38200000,151,50,101,50,0,1,52,58906
168,450,2400,1900,4560000,2,3606,903,1,51960000,51960000,1351,450,901,450,0,1,452,468611
168,450,2400,1900,4560000,2,3606,903,1,51960000,51960000,1351,450,901,450,0,1,452,91044
168,450,2400,1900,4560000,2,3606,903,1,51960000,51960000,1351,450,901,450,0,1,452,91504
168,450,2400,1900,4560000,2,3606,903,1,51960000,51960000,1351,450,901,450,0,1,452,89385
168,450,2400,1900,4560000,2,3606,903,1,51960000,51960000,1351,450,901,450,0,1,452,88052
168,450,2400,1900,4560000,2,3606,903,1,51960000,51960000,1351,450,901,450,0,1,452,107624
168,450,2400,1900,4560000,2,3606,903,1,51960000,51960000,1351,450,901,450,0,1,452,103602
168,850,2400,1900,4560000,2,6806,1703,1,65720000,65720000,2551,850,1701,850,0,1,852,934838
168,850,2400,1900,4560000,2,6806,1703,1,65720000,65720000,2551,850,1701,850,0,1,852,144685
168,850,2400,1900,4560000,2,6806,1703,1,65720000,65720000,2551,850,1701,850,0,1,852,145130
168,850,2400,1900,4560000,2,6806,1703,1,65720000,65720000,2551,850,1701,850,0,1,852,143525
168,850,2400,1900,4560000,2,6806,1703,1,65720000,65720000,2551,850,1701,850,0,1,852,145391
168,850,2400,1900,4560000,2,6806,1703,1,65720000,65720000,2551,850,1701,850,0,1,852,158433
168,850,2400,1900,4560000,2,6806,1703,1,65720000,65720000,2551,850,1701,850,0,1,852,157920
168,1250,2400,1900,4560000,2,10006,2503,1,79480000,79480000,3751,1250,2501,1250,0,1,1252,1437793
168,1250,2400,1900,4560000,2,10006,2503,1,79480000,79480000,3751,1250,2501,1250,0,1,1252,181951
168,1250,2400,1900,4560000,2,10006,2503,1,79480000,79480000,3751,1250,2501,1250,0,1,1252,177438
168,1250,2400,1900,4560000,2,10006,2503,1,79480000,79480000,3751,1250,2501,1250,0,1,1252,178501
168,1250,2400,1900,4560000,2,10006,2503,1,79480000,79480000,3751,1250,2501,1250,0,1,1252,182479
168,1250,2400,1900,4560000,2,10006,2503,1,79480000,79480000,3751,1250,2501,1250,0,1,1252,201044
168,1250,2400,1900,4560000,2,10006,2503,1,79480000,79480000,3751,1250,2501,1250,0,1,1252,201426
168,1650,2400,1900,4560000,2,13206,3303,1,93240000,93240000,4951,1650,3301,1650,0,1,1652,1934835
168,1650,2400,1900,4560000,2,13206,3303,1,93240000,93240000,4951,1650,3301,1650,0,1,1652,248980
168,1650,2400,1900,4560000,2,13206,3303,1,93240000,93240000,4951,1650,3301,1650,0,1,1652,248523
168,1650,2400,1900,4560000,2,13206,3303,1,93240000,93240000,4951,1650,3301,1650,0,1,1652,249272
168,1650,2400,1900,4560000,2,13206,3303,1,93240000,93240000,4951,1650,3301,1650,0,1,1652,247893
168,1650,2400,1900,4560000,2,13206,3303,1,93240000,93240000,4951,1650,3301,1650,0,1,1652,245045
168,1650,2400,1900,4560000,2,13206,3303,1,93240000,93240000,4951,1650,3301,1650,0,1,1652,246952
168,2050,2400,1900,4560000,2,16406,4103,1,107000000,107000000,6151,2050,4101,2050,0,1,2052,2340967
168,2050,2400,1900,4560000,2,16406,4103,1,107000000,107000000,6151,2050,4101,2050,0,1,2052,292785
168,2050,2400,1900,4560000,2,16406,4103,1,107000000,107000000,6151,2050,4101,2050,0,1,2052,292309
168,2050,2400,1900,4560000,2,16406,4103,1,107000000,107000000,6151,2050,4101,2050,0,1,2052,293103
168,2050,2400,1900,4560000,2,16406,4103,1,107000000,107000000,6151,2050,4101,2050,0,1,2052,291783
168,2050,2400,1900,4560000,2,16406,4103,1,107000000,107000000,6151,2050,4101,2050,0,1,2052,288432
168,2050,2400,1900,4560000,2,16406,4103,1,107000000,107000000,6151,2050,4101,2050,0,1,2052,289746
168,2450,2400,1900,4560000,2,19606,4903,1,120760000,120760000,7351,2450,4901,2450,0,1,2452,2934556
168,2450,2400,1900,4560000,2,19606,4903,1,120760000,120760000,7351,2450,4901,2450,0,1,2452,344901
168,2450,2400,1900,4560000,2,19606,4903,1,120760000,120760000,7351,2450,4901,2450,0,1,2452,323017
168,2450,2400,1900,4560000,2,19606,4903,1,120760000,120760000,7351,2450,4901,2450,0,1,2452,345465
168,2450,2400,1900,4560000,2,19606,4903,1,120760000,120760000,7351,2450,4901,2450,0,1,2452,328287
168,2450,2400,1900,4560000,2,19606,4903,1,120760000,120760000,7351,2450,4901,2450,0,1,2452,338397
168,2450,2400,1900,4560000,2,19606,4903,1,120760000,120760000,7351,2450,4901,2450,0,1,2452,339043
168,2850,2400,1900,4560000,2,22806,5703,1,134520000,134520000,8551,2850,5701,2850,0,1,2852,3596712
168,2850,2400,1900,4560000,2,22806,5703,1,134520000,134520000,8551,2850,5701,2850,0,1,2852,368962
168,2850,2400,1900,4560000,2,22806,5703,1,134520000,134520000,8551,2850,5701,2850,0,1,2852,382404
168,2850,2400,1900,4560000,2,22806,5703,1,134520000,134520000,8551,2850,5701,2850,0,1,2852,363916
168,2850,2400,1900,4560000,2,22806,5703,1,134520000,134520000,8551,2850,5701,2850,0,1,2852,385905
168,2850,2400,1900,4560000,2,22806,5703,1,134520000,134520000,8551,2850,5701,2850,0,1,2852,386727
168,2850,2400,1900,4560000,2,22806,5703,1,134520000,134520000,8551,2850,5701,2850,0,1,2852,397048
168,3250,2400,1900,4560000,2,26006,6503,1,148280000,148280000,9751,3250,6501,3250,0,1,3252,4077457
168,3250,2400,1900,4560000,2,26006,6503,1,148280000,148280000,9751,3250,6501,3250,0,1,3252,417320
168,3250,2400,1900,4560000,2,26006,6503,1,148280000,148280000,9751,3250,6501,3250,0,1,3252,410922
168,3250,2400,1900,4560000,2,26006,6503,1,148280000,148280000,9751,3250,6501,3250,0,1,3252,419927
168,3250,2400,1900,4560000,2,26006,6503,1,148280000,148280000,9751,3250,6501,3250,0,1,3252,418719
168,3250,2400,1900,4560000,2,26006,6503,1,148280000,148280000,9751,3250,6501,3250,0,1,3252,427767
168,3250,2400,1900,4560000,2,26006,6503,1,148280000,148280000,9751,3250,6501,3250,0,1,3252,427286
168,3650,2400,1900,4560000,2,29206,7303,1,162040000,162040000,10951,3650,7301,3650,0,1,3652,4510254
168,3650,2400,1900,4560000,2,29206,7303,1,162040000,162040000,10951,3650,7301,3650,0,1,3652,472457
168,3650,2400,1900,4560000,2,29206,7303,1,162040000,162040000,10951,3650,7301,3650,0,1,3652,465137
168,3650,2400,1900,4560000,2,29206,7303,1,162040000,162040000,10951,3650,7301,3650,0,1,3652,471163
168,3650,2400,1900,4560000,2,29206,7303,1,162040000,162040000,10951,3650,7301,3650,0,1,3652,467699
168,3650,2400,1900,4560000,2,29206,7303,1,162040000,162040000,10951,3650,7301,3650,0,1,3652,477765
168,3650,2400,1900,4560000,2,29206,7303,1,162040000,162040000,10951,3650,7301,3650,0,1,3652,477257
168,4050,2400,1900,4560000,2,32406,8103,1,175800000,175800000,12151,4050,8101,4050,0,1,4052,5070907
168,4050,2400,1900,4560000,2,32406,8103,1,175800000,175800000,12151,4050,8101,4050,0,1,4052,495177
168,4050,2400,1900,4560000,2,32406,8103,1,175800000,175800000,12151,4050,8101,4050,0,1,4052,496520
168,4050,2400,1900,4560000,2,32406,8103,1,175800000,175800000,12151,4050,8101,4050,0,1,4052,497633
168,4050,2400,1900,4560000,2,32406,8103,1,175800000,175800000,12151,4050,8101,4050,0,1,4052,497145
168,4050,2400,1900,4560000,2,32406,8103,1,175800000,175800000,12151,4050,8101,4050,0,1,4052,560442
168,4050,2400,1900,4560000,2,32406,8103,1,175800000,175800000,12151,4050,8101,4050,0,1,4052,539907
168,4450,2400,1900,4560000,2,35606,8903,1,189560000,189560000,13351,4450,8901,4450,0,1,4452,5514533
168,4450,2400,1900,4560000,2,35606,8903,1,189560000,189560000,13351,4450,8901,4450,0,1,4452,544181
168,4450,2400,1900,4560000,2,35606,8903,1,189560000,189560000,13351,4450,8901,4450,0,1,4452,539647
168,4450,2400,1900,4560000,2,35606,8903,1,189560000,189560000,13351,4450,8901,4450,0,1,4452,543666
168,4450,2400,1900,4560000,2,35606,8903,1,189560000,189560000,13351,4450,8901,4450,0,1,4452,543019
168,4450,2400,1900,4560000,2,35606,8903,1,189560000,189560000,13351,4450,8901,4450,0,1,4452,599020
168,4450,2400,1900,4560000,2,35606,8903,1,189560000,189560000,13351,4450,8901,4450,0,1,4452,597813
168,4850,2400,1900,4560000,2,38806,9703,1,203320000,203320000,14551,4850,9701,4850,0,1,4852,5988820
168,4850,2400,1900,4560000,2,38806,9703,1,203320000,203320000,14551,4850,9701,4850,0,1,4852,596210
168,4850,2400,1900,4560000,2,38806,9703,1,203320000,203320000,14551,4850,9701,4850,0,1,4852,595028
168,4850,2400,1900,4560000,2,38806,9703,1,203320000,203320000,14551,4850,9701,4850,0,1,4852,598316
168,4850,2400,1900,4560000,2,38806,9703,1,203320000,203320000,14551,4850,9701,4850,0,1,4852,597561
168,4850,2400,1900,4560000,2,38806,9703,1,203320000,203320000,14551,4850,9701,4850,0,1,4852,648965
168,4850,2400,1900,4560000,2,38806,9703,1,203320000,203320000,14551,4850,9701,4850,0,1,4852,648388
168,5250,2400,1900,4560000,2,42006,10503,1,217080000,217080000,15751,5250,10501,5250,0,1,5252,6717121
168,5250,2400,1900,4560000,2,42006,10503,1,217080000,217080000,15751,5250,10501,5250,0,1,5252,638326
168,5250,2400,1900,4560000,2,42006,10503,1,217080000,217080000,15751,5250,10501,5250,0,1,5252,637590
168,5250,2400,1900,4560000,2,42006,10503,1,217080000,217080000,15751,5250,10501,5250,0,1,5252,638877
168,5250,2400,1900,4560000,2,42006,10503,1,217080000,217080000,15751,5250,10501,5250,0,1,5252,636144
168,5250,2400,1900,4560000,2,42006,10503,1,217080000,217080000,15751,5250,10501,5250,0,1,5252,691138
168,5250,2400,1900,4560000,2,42006,10503,1,217080000,217080000,15751,5250,10501,5250,0,1,5252,690553
168,5650,2400,1900,4560000,2,45206,11303,1,230840000,230840000,16951,5650,11301,5650,0,1,5652,6970814
168,5650,2400,1900,4560000,2,45206,11303,1,230840000,230840000,16951,5650,11301,5650,0,1,5652,696459
168,5650,2400,1900,4560000,2,45206,11303,1,230840000,230840000,16951,5650,11301,5650,0,1,5652,671736
168,5650,2400,1900,4560000,2,45206,11303,1,230840000,230840000,16951,5650,11301,5650,0,1,5652,682410
168,5650,2400,1900,4560000,2,45206,11303,1,230840000,230840000,16951,5650,11301,5650,0,1,5652,673910
168,5650,2400,1900,4560000,2,45206,11303,1,230840000,230840000,16951,5650,11301,5650,0,1,5652,721629
168,5650,2400,1900,4560000,2,45206,11303,1,230840000,230840000,16951,5650,11301,5650,0,1,5652,720832
168,6050,2400,1900,4560000,2,48406,12103,1,244600000,244600000,18151,6050,12101,6050,0,1,6052,7510939
168,6050,2400,1900,4560000,2,48406,12103,1,244600000,244600000,18151,6050,12101,6050,0,1,6052,715374
168,6050,2400,1900,4560000,2,48406,12103,1,244600000,244600000,18151,6050,12101,6050,0,1,6052,742215
168,6050,2400,1900,4560000,2,48406,12103,1,244600000,244600000,18151,6050,12101,6050,0,1,6052,719366
168,6050,2400,1900,4560000,2,48406,12103,1,244600000,244600000,18151,6050,12101,6050,0,1,6052,737417
168,6050,2400,1900,4560000,2,48406,12103,1,244600000,244600000,18151,6050,12101,6050,0,1,6052,762597
168,6050,2400,1900,4560000,2,48406,12103,1,244600000,244600000,18151,6050,12101,6050,0,1,6052,782186
168,6450,2400,1900,4560000,2,51606,12903,1,258360000,258360000,19351,6450,12901,6450,0,1,6452,7895898
168,6450,2400,1900,4560000,2,51606,12903,1,258360000,258360000,19351,6450,12901,6450,0,1,6452,778317
168,6450,2400,1900,4560000,2,51606,12903,1,258360000,258360000,19351,6450,12901,6450,0,1,6452,774979
168,6450,2400,1900,4560000,2,51606,12903,1,258360000,258360000,19351,6450,12901,6450,0,1,6452,779950
168,6450,2400,1900,4560000,2,51606,12903,1,258360000,258360000,19351,6450,12901,6450,0,1,6452,779049
168,6450,2400,1900,4560000,2,51606,12903,1,258360000,258360000,19351,6450,12901,6450,0,1,6452,841110
168,6450,2400,1900,4560000,2,51606,12903,1,258360000,258360000,19351,6450,12901,6450,0,1,6452,805559
168,6850,2400,1900,4560000,2,54806,13703,1,272120000,272120000,20551,6850,13701,6850,0,1,6852,8800108
168,6850,2400,1900,4560000,2,54806,13703,1,272120000,272120000,20551,6850,13701,6850,0,1,6852,833086
168,6850,2400,1900,4560000,2,54806,13703,1,272120000,272120000,20551,6850,13701,6850,0,1,6852,831538
168,6850,2400,1900,4560000,2,54806,13703,1,272120000,272120000,20551,6850,13701,6850,0,1,6852,834539
168,6850,2400,1900,4560000,2,54806,13703,1,272120000,272120000,20551,6850,13701,6850,0,1,6852,829909
168,6850,2400,1900,4560000,2,54806,13703,1,272120000,272120000,20551,6850,13701,6850,0,1,6852,856040
168,6850,2400,1900,4560000,2,54806,13703,1,272120000,272120000,20551,6850,13701,6850,0,1,6852,856707
168,50,2400,1500,3600000,2,406,103,1,30360000,30360000,151,50,101,50,0,1,52,36255
168,50,2400,1500,3600000,2,406,103,1,30360000,30360000,151,50,101,50,0,1,52,41166
168,50,2400,1500,3600000,2,406,103,1,30360000,30360000,151,50,101,50,0,1,52,43434
168,50,2400,1500,3600000,2,406,103,1,30360000,30360000,151,50,101,50,0,1,52,37643
168,50,2400,1500,3600000,2,406,103,1,30360000,30360000,151,50,101,50,0,1,52,43022
168,50,2400,1500,3600000,2,406,103,1,30360000,30360000,151,50,101,50,0,1,52,47575
168,50,2400,1500,3600000,2,406,103,1,30360000,30360000,151,50,101,50,0,1,52,48781
168,450,2400,1500,3600000,2,3606,903,1,42840000,42840000,1351,450,901,450,0,1,452,386796
168,450,2400,1500,3600000,2,3606,903,1,42840000,42840000,1351,450,901,450,0,1,452,75017
168,450,2400,1500,3600000,2,3606,903,1,42840000,42840000,1351,450,901,450,0,1,452,73571
168,450,2400,1500,3600000,2,3606,903,1,42840000,42840000,1351,450,901,450,0,1,452,67850
168,450,2400,1500,3600000,2,3606,903,1,42840000,42840000,1351,450,901,450,0,1,452,76122
168,450,2400,1500,3600000,2,3606,903,1,42840000,42840000,1351,450,901,450,0,1,452,86365
168,450,2400,1500,3600000,2,3606,903,1,42840000,42840000,1351,450,901,450,0,1,452,84011
168,850,2400,1500,3600000,2,6806,1703,1,55320000,55320000,2551,850,1701,850,0,1,852,726937
168,850,2400,1500,3600000,2,6806,1703,1,55320000,55320000,2551,850,1701,850,0,1,852,114381
168,850,2400,1500,3600000,2,6806,1703,1,55320000,55320000,2551,850,1701,850,0,1,852,106598
168,850,2400,1500,3600000,2,6806,1703,1,55320000,55320000,2551,850,1701,850,0,1,852,114865
168,850,2400,1500,3600000,2,6806,1703,1,55320000,55320000,2551,850,1701,850,0,1,852,113027
168,850,2400,1500,3600000,2,6806,1703,1,55320000,55320000,2551,850,1701,850,0,1,852,126557
168,850,2400,1500,3600000,2,6806,1703,1,55320000,55320000,2551,850,1701,850,0,1,852,127046
168,1250,2400,1500,3600000,2,10006,2503,1,67800000,67800000,3751,1250,2501,1250,0,1,1252,1131694
168,1250,2400,1500,3600000,2,10006,2503,1,67800000,67800000,3751,1250,2501,1250,0,1,1252,159801
168,1250,2400,1500,3600000,2,10006,2503,1,67800000,67800000,3751,1250,2501,1250,0,1,1252,160325
168,1250,2400,1500,3600000,2,10006,2503,1,67800000,67800000,3751,1250,2501,1250,0,1,1252,159181
168,1250,2400,1500,3600000,2,10006,2503,1,67800000,67800000,3751,1250,2501,1250,0,1,1252,157879
168,1250,2400,1500,3600000,2,10006,2503,1,67800000,67800000,3751,1250,2501,1250,0,1,1252,167577
168,1250,2400,1500,3600000,2,10006,2503,1,67800000,67800000,3751,1250,2501,1250,0,1,1252,169836
168,1650,2400,1500,3600000,2,13206,3303,1,80280000,80280000,4951,1650,3301,1650,0,1,1652,1520204
168,1650,2400,1500,3600000,2,13206,3303,1,80280000,80280000,4951,1650,3301,1650,0,1,1652,190732
168,1650,2400,1500,3600000,2,13206,3303,1,80280000,80280000,4951,1650,3301,1650,0,1,1652,187343
168,1650,2400,1500,3600000,2,13206,3303,1,80280000,80280000,4951,1650,3301,1650,0,1,1652,191301
168,1650,2400,1500,3600000,2,13206,3303,1,80280000,80280000,4951,1650,3301,1650,0,1,1652,188392
168,1650,2400,1500,3600000,2,13206,3303,1,80280000,80280000,4951,1650,3301,1650,0,1,1652,204062
168,1650,2400,1500,3600000,2,13206,3303,1,80280000,80280000,4951,1650,3301,1650,0,1,1652,204467
168,2050,2400,1500,3600000,2,16406,4103,1,92760000,92760000,6151,2050,4101,2050,0,1,2052,1898256
168,2050,2400,1500,3600000,2,16406,4103,1,92760000,92760000,6151,2050,4101,2050,0,1,2052,239900
168,2050,2400,1500,3600000,2,16406,4103,1,92760000,92760000,6151,2050,4101,2050,0,1,2052,231593
168,2050,2400,1500,3600000,2,16406,4103,1,92760000,92760000,6151,2050,4101,2050,0,1,2052,239297
168,2050,2400,1500,3600000,2,16406,4103,1,92760000,92760000,6151,2050,4101,2050,0,1,2052,240436
168,2050,2400,1500,3600000,2,16406,4103,1,92760000,92760000,6151,2050,4101,2050,0,1,2052,237036
168,2050,2400,1500,3600000,2,16406,4103,1,92760000,92760000,6151,2050,4101,2050,0,1,2052,238053
168,2450,2400,1500,3600000,2,19606,4903,1,105240000,105240000,7351,2450,4901,2450,0,1,2452,2237261
168,2450,2400,1500,3600000,2,19606,4903,1,105240000,105240000,7351,2450,4901,2450,0,1,2452,279097
168,2450,2400,1500,3600000,2,19606,4903,1,105240000,105240000,7351,2450,4901,2450,0,1,2452,278534
168,2450,2400,1500,3600000,2,19606,4903,1,105240000,105240000,7351,2450,4901,2450,0,1,2452,276897
168,2450,2400,1500,3600000,2,19606,4903,1,105240000,105240000,7351,2450,4901,2450,0,1,2452,276161
168,2450,2400,1500,3600000,2,19606,4903,1,105240000,105240000,7351,2450,4901,2450,0,1,2452,277276
168,2450,2400,1500,3600000,2,19606,4903,1,105240000,105240000,7351,2450,4901,2450,0,1,2452,277915
168,2850,2400,1500,3600000,2,22806,5703,1,117720000,117720000,8551,2850,5701,2850,0,1,2852,2681668
168,2850,2400,1500,3600000,2,22806,5703,1,117720000,117720000,8551,2850,5701,2850,0,1,2852,319283
168,2850,2400,1500,3600000,2,22806,5703,1,117720000,117720000,8551,2850,5701,2850,0,1,2852,317850
168,2850,2400,1500,3600000,2,22806,5703,1,117720000,117720000,8551,2850,5701,2850,0,1,2852,318891
168,2850,2400,1500,3600000,2,22806,5703,1,117720000,117720000,8551,2850,5701,2850,0,1,2852,315915
168,2850,2400,1500,3600000,2,22806,5703,1,117720000,117720000,8551,2850,5701,2850,0,1,2852,318545
168,2850,2400,1500,3600000,2,22806,5703,1,117720000,117720000,8551,2850,5701,2850,0,1,2852,318265
168,3250,2400,1500,3600000,2,26006,6503,1,130200000,130200000,9751,3250,6501,3250,0,1,3252,3019597
168,3250,2400,1500,3600000,2,26006,6503,1,130200000,130200000,9751,3250,6501,3250,0,1,3252,354687
168,3250,2400,1500,3600000,2,26006,6503,1,130200000,130200000,9751,3250,6501,3250,0,1,3252,324054
168,3250,2400,1500,3600000,2,26006,6503,1,130200000,130200000,9751,3250,6501,3250,0,1,3252,363976
168,3250,2400,1500,3600000,2,26006,6503,1,130200000,130200000,9751,3250,6501,3250,0,1,3252,326586
168,3250,2400,1500,3600000,2,26006,6503,1,130200000,130200000,9751,3250,6501,3250,0,1,3252,366838
168,3250,2400,1500,3600000,2,26006,6503,1,130200000,130200000,9751,3250,6501,3250,0,1,3252,366356
168,3650,2400,1500,3600000,2,29206,7303,1,142680000,142680000,10951,3650,7301,3650,0,1,3652,3634450
168,3650,2400,1500,3600000,2,29206,7303,1,142680000,142680000,10951,3650,7301,3650,0,1,3652,387604
168,3650,2400,1500,3600000,2,29206,7303,1,142680000,142680000,10951,3650,7301,3650,0,1,3652,381106
168,3650,2400,1500,3600000,2,29206,7303,1,142680000,142680000,10951,3650,7301,3650,0,1,3652,391880
168,3650,2400,1500,3600000,2,29206,7303,1,142680000,142680000,10951,3650,7301,3650,0,1,3652,389078
168,3650,2400,1500,3600000,2,29206,7303,1,142680000,142680000,10951,3650,7301,3650,0,1,3652,395750
168,3650,2400,1500,3600000,2,29206,7303,1,142680000,142680000,10951,3650,7301,3650,0,1,3652,394625
168,4050,2400,1500,3600000,2,32406,8103,1,155160000,155160000,12151,4050,8101,4050,0,1,4052,4043175
168,4050,2400,1500,3600000,2,32406,8103,1,155160000,155160000,12151,4050,8101,4050,0,1,4052,400443
168,4050,2400,1500,3600000,2,32406,8103,1,155160000,155160000,12151,4050,8101,4050,0,1,4052,414068
168,4050,2400,1500,3600000,2,32406,8103,1,155160000,155160000,12151,4050,8101,4050,0,1,4052,403207
168,4050,2400,1500,3600000,2,32406,8103,1,155160000,155160000,12151,4050,8101,4050,0,1,4052,422034
168,4050,2400,1500,3600000,2,32406,8103,1,155160000,155160000,12151,4050,8101,4050,0,1,4052,432245
168,4050,2400,1500,3600000,2,32406,8103,1,155160000,155160000,12151,4050,8101,4050,0,1,4052,459324
168,4450,2400,1500,3600000,2,35606,8903,1,167640000,167640000,13351,4450,8901,4450,0,1,4452,4406199
168,4450,2400,1500,3600000,2,35606,8903,1,167640000,167640000,13351,4450,8901,4450,0,1,4452,448127
168,4450,2400,1500,3600000,2,35606,8903,1,167640000,167640000,13351,4450,8901,4450,0,1,4452,445628
168,4450,2400,1500,3600000,2,35606,8903,1,167640000,167640000,13351,4450,8901,4450,0,1,4452,446963
168,4450,2400,1500,3600000,2,35606,8903,1,167640000,167640000,13351,4450,8901,4450,0,1,4452,447610
168,4450,2400,1500,3600000,2,35606,8903,1,167640000,167640000,13351,4450,8901,4450,0,1,4452,490140
168,4450,2400,1500,3600000,2,35606,8903,1,167640000,167640000,13351,4450,8901,4450,0,1,4452,489451
168,4850,2400,1500,3600000,2,38806,9703,1,180120000,180120000,14551,4850,9701,4850,0,1,4852,4950910
168,4850,2400,1500,3600000,2,38806,9703,1,180120000,180120000,14551,4850,9701,4850,0,1,4852,481695
168,4850,2400,1500,3600000,2,38806,9703,1,180120000,180120000,14551,4850,9701,4850,0,1,4852,481024
168,4850,2400,1500,3600000,2,38806,9703,1,180120000,180120000,14551,4850,9701,4850,0,1,4852,482242
168,4850,2400,1500,3600000,2,38806,9703,1,180120000,180120000,14551,4850,9701,4850,0,1,4852,478318
168,4850,2400,1500,3600000,2,38806,9703,1,180120000,180120000,14551,4850,9701,4850,0,1,4852,524882
168,4850,2400,1500,3600000,2,38806,9703,1,180120000,180120000,14551,4850,9701,4850,0,1,4852,525470
168,5250,2400,1500,3600000,2,42006,10503,1,192600000,192600000,15751,5250,10501,5250,0,1,5252,4978468
168,5250,2400,1500,3600000,2,42006,10503,1,192600000,192600000,15751,5250,10501,5250,0,1,5252,522368
168,5250,2400,1500,3600000,2,42006,10503,1,192600000,192600000,15751,5250,10501,5250,0,1,5252,518912
168,5250,2400,1500,3600000,2,42006,10503,1,192600000,192600000,15751,5250,10501,5250,0,1,5252,521402
168,5250,2400,1500,3600000,2,42006,10503,1,192600000,192600000,15751,5250,10501,5250,0,1,5252,520319
168,5250,2400,1500,3600000,2,42006,10503,1,192600000,192600000,15751,5250,10501,5250,0,1,5252,573642
168,5250,2400,1500,3600000,2,42006,10503,1,192600000,192600000,15751,5250,10501,5250,0,1,5252,557165
168,5650,2400,1500,3600000,2,45206,11303,1,205080000,205080000,16951,5650,11301,5650,0,1,5652,5498965
168,5650,2400,1500,3600000,2,45206,11303,1,205080000,205080000,16951,5650,11301,5650,0,1,5652,563809
168,5650,2400,1500,3600000,2,45206,11303,1,205080000,205080000,16951,5650,11301,5650,0,1,5652,561625
168,5650,2400,1500,3600000,2,45206,11303,1,205080000,205080000,16951,5650,11301,5650,0,1,5652,562997
168,5650,2400,1500,3600000,2,45206,11303,1,205080000,205080000,16951,5650,11301,5650,0,1,5652,560714
168,5650,2400,1500,3600000,2,45206,11303,1,205080000,205080000,16951,5650,11301,5650,0,1,5652,599131
168,5650,2400,1500,3600000,2,45206,11303,1,205080000,205080000,16951,5650,11301,5650,0,1,5652,598516
168,6050,2400,1500,3600000,2,48406,12103,1,217560000,217560000,18151,6050,12101,6050,0,1,6052,5610697
168,6050,2400,1500,3600000,2,48406,12103,1,217560000,217560000,18151,6050,12101,6050,0,1,6052,593238
168,6050,2400,1500,3600000,2,48406,12103,1,217560000,217560000,18151,6050,12101,6050,0,1,6052,594927
168,6050,2400,1500,3600000,2,48406,12103,1,217560000,217560000,18151,6050,12101,6050,0,1,6052,595838
168,6050,2400,1500,3600000,2,48406,12103,1,217560000,217560000,18151,6050,12101,6050,0,1,6052,596729
168,6050,2400,1500,3600000,2,48406,12103,1,217560000,217560000,18151,6050,12101,6050,0,1,6052,641657
168,6050,2400,1500,3600000,2,48406,12103,1,217560000,217560000,18151,6050,12101,6050,0,1,6052,642280
168,6450,2400,1500,3600000,2,51606,12903,1,230040000,230040000,19351,6450,12901,6450,0,1,6452,6391459
168,6450,2400,1500,3600000,2,51606,12903,1,230040000,230040000,19351,6450,12901,6450,0,1,6452,632690
168,6450,2400,1500,3600000,2,51606,12903,1,230040000,230040000,19351,6450,12901,6450,0,1,6452,631645
168,6450,2400,1500,3600000,2,51606,12903,1,230040000,230040000,19351,6450,12901,6450,0,1,6452,633480
168,6450,2400,1500,3600000,2,51606,12903,1,230040000,230040000,19351,6450,12901,6450,0,1,6452,634187
168,6450,2400,1500,3600000,2,51606,12903,1,230040000,230040000,19351,6450,12901,6450,0,1,6452,690144
168,6450,2400,1500,3600000,2,51606,12903,1,230040000,230040000,19351,6450,12901,6450,0,1,6452,689500
168,6850,2400,1500,3600000,2,54806,13703,1,242520000,242520000,20551,6850,13701,6850,0,1,6852,6861543
168,6850,2400,1500,3600000,2,54806,13703,1,242520000,242520000,20551,6850,13701,6850,0,1,6852,711311
168,6850,2400,1500,3600000,2,54806,13703,1,242520000,242520000,20551,6850,13701,6850,0,1,6852,697315
168,6850,2400,1500,3600000,2,54806,13703,1,242520000,242520000,20551,6850,13701,6850,0,1,6852,709176
168,6850,2400,1500,3600000,2,54806,13703,1,242520000,242520000,20551,6850,13701,6850,0,1,6852,703992
168,6850,2400,1500,3600000,2,54806,13703,1,242520000,242520000,20551,6850,13701,6850,0,1,6852,718590
168,6850,2400,1500,3600000,2,54806,13703,1,242520000,242520000,20551,6850,13701,6850,0,1,6852,717908
168,50,2400,1100,2640000,2,406,103,1,22520000,22520000,151,50,101,50,0,1,52,26481
168,50,2400,1100,2640000,2,406,103,1,22520000,22520000,151,50,101,50,0,1,52,31115
168,50,2400,1100,2640000,2,406,103,1,22520000,22520000,151,50,101,50,0,1,52,25679
168,50,2400,1100,2640000,2,406,103,1,22520000,22520000,151,50,101,50,0,1,52,29279
168,50,2400,1100,2640000,2,406,103,1,22520000,22520000,151,50,101,50,0,1,52,30699
168,50,2400,1100,2640000,2,406,103,1,22520000,22520000,151,50,101,50,0,1,52,38833
168,50,2400,1100,2640000,2,406,103,1,22520000,22520000,151,50,101,50,0,1,52,38411
168,450,2400,1100,2640000,2,3606,903,1,33720000,33720000,1351,450,901,450,0,1,452,272441
168,450,2400,1100,2640000,2,3606,903,1,33720000,33720000,1351,450,901,450,0,1,452,56611
168,450,2400,1100,2640000,2,3606,903,1,33720000,33720000,1351,450,901,450,0,1,452,61046
168,450,2400,1100,2640000,2,3606,903,1,33720000,33720000,1351,450,901,450,0,1,452,62304
168,450,2400,1100,2640000,2,3606,903,1,33720000,33720000,1351,450,901,450,0,1,452,61657
168,450,2400,1100,2640000,2,3606,903,1,33720000,33720000,1351,450,901,450,0,1,452,67727
168,450,2400,1100,2640000,2,3606,903,1,33720000,33720000,1351,450,901,450,0,1,452,68807
168,850,2400,1100,2640000,2,6806,1703,1,44920000,44920000,2551,850,1701,850,0,1,852,557581
168,850,2400,1100,2640000,2,6806,1703,1,44920000,44920000,2551,850,1701,850,0,1,852,87013
168,850,2400,1100,2640000,2,6806,1703,1,44920000,44920000,2551,850,1701,850,0,1,852,90539
168,850,2400,1100,2640000,2,6806,1703,1,44920000,44920000,2551,850,1701,850,0,1,852,88360
168,850,2400,1100,2640000,2,6806,1703,1,44920000,44920000,2551,850,1701,850,0,1,852,90059
168,850,2400,1100,2640000,2,6806,1703,1,44920000,44920000,2551,850,1701,850,0,1,852,99206
168,850,2400,1100,2640000,2,6806,1703,1,44920000,44920000,2551,850,1701,850,0,1,852,99695
168,1250,2400,1100,2640000,2,10006,2503,1,56120000,56120000,3751,1250,2501,1250,0,1,1252,775966
168,1250,2400,1100,2640000,2,10006,2503,1,56120000,56120000,3751,1250,2501,1250,0,1,1252,109425
168,1250,2400,1100,2640000,2,10006,2503,1,56120000,56120000,3751,1250,2501,1250,0,1,1252,119058
168,1250,2400,1100,2640000,2,10006,2503,1,56120000,56120000,3751,1250,2501,1250,0,1,1252,118540
168,1250,2400,1100,2640000,2,10006,2503,1,56120000,56120000,3751,1250,2501,1250,0,1,1252,117100
168,1250,2400,1100,2640000,2,10006,2503,1,56120000,56120000,3751,1250,2501,1250,0,1,1252,130059
168,1250,2400,1100,2640000,2,10006,2503,1,56120000,56120000,3751,1250,2501,1250,0,1,1252,130594
168,1650,2400,1100,2640000,2,13206,3303,1,67320000,67320000,4951,1650,3301,1650,0,1,1652,1081079
168,1650,2400,1100,2640000,2,13206,3303,1,67320000,67320000,4951,1650,3301,1650,0,1,1652,144632
168,1650,2400,1100,2640000,2,13206,3303,1,67320000,67320000,4951,1650,3301,1650,0,1,1652,147345
168,1650,2400,1100,2640000,2,13206,3303,1,67320000,67320000,4951,1650,3301,1650,0,1,1652,145891
168,1650,2400,1100,2640000,2,13206,3303,1,67320000,67320000,4951,1650,3301,1650,0,1,1652,147905
168,1650,2400,1100,2640000,2,13206,3303,1,67320000,67320000,4951,1650,3301,1650,0,1,1652,161195
168,1650,2400,1100,2640000,2,13206,3303,1,67320000,67320000,4951,1650,3301,1650,0,1,1652,161770
168,2050,2400,1100,2640000,2,16406,4103,1,78520000,78520000,6151,2050,4101,2050,0,1,2052,1417644
168,2050,2400,1100,2640000,2,16406,4103,1,78520000,78520000,6151,2050,4101,2050,0,1,2052,177121
168,2050,2400,1100,2640000,2,16406,4103,1,78520000,78520000,6151,2050,4101,2050,0,1,2052,176653
168,2050,2400,1100,2640000,2,16406,4103,1,78520000,78520000,6151,2050,4101,2050,0,1,2052,177726
168,2050,2400,1100,2640000,2,16406,4103,1,78520000,78520000,6151,2050,4101,2050,0,1,2052,175615
168,2050,2400,1100,2640000,2,16406,4103,1,78520000,78520000,6151,2050,4101,2050,0,1,2052,190885
168,2050,2400,1100,2640000,2,16406,4103,1,78520000,78520000,6151,2050,4101,2050,0,1,2052,194887
168,2450,2400,1100,2640000,2,19606,4903,1,89720000,89720000,7351,2450,4901,2450,0,1,2452,1594266
168,2450,2400,1100,2640000,2,19606,4903,1,89720000,89720000,7351,2450,4901,2450,0,1,2452,212176
168,2450,2400,1100,2640000,2,19606,4903,1,89720000,89720000,7351,2450,4901,2450,0,1,2452,210016
168,2450,2400,1100,2640000,2,19606,4903,1,89720000,89720000,7351,2450,4901,2450,0,1,2452,213802
168,2450,2400,1100,2640000,2,19606,4903,1,89720000,89720000,7351,2450,4901,2450,0,1,2452,213345
168,2450,2400,1100,2640000,2,19606,4903,1,89720000,89720000,7351,2450,4901,2450,0,1,2452,215124
168,2450,2400,1100,2640000,2,19606,4903,1,89720000,89720000,7351,2450,4901,2450,0,1,2452,215571
168,2850,2400,1100,2640000,2,22806,5703,1,100920000,100920000,8551,2850,5701,2850,0,1,2852,1932797
168,2850,2400,1100,2640000,2,22806,5703,1,100920000,100920000,8551,2850,5701,2850,0,1,2852,248902
168,2850,2400,1100,2640000,2,22806,5703,1,100920000,100920000,8551,2850,5701,2850,0,1,2852,247009
168,2850,2400,1100,2640000,2,22806,5703,1,100920000,100920000,8551,2850,5701,2850,0,1,2852,248363
168,2850,2400,1100,2640000,2,22806,5703,1,100920000,100920000,8551,2850,5701,2850,0,1,2852,249295
168,2850,2400,1100,2640000,2,22806,5703,1,100920000,100920000,8551,2850,5701,2850,0,1,2852,247405
168,2850,2400,1100,2640000,2,22806,5703,1,100920000,100920000,8551,2850,5701,2850,0,1,2852,247794
168,3250,2400,1100,2640000,2,26006,6503,1,112120000,112120000,9751,3250,6501,3250,0,1,3252,2185420
168,3250,2400,1100,2640000,2,26006,6503,1,112120000,112120000,9751,3250,6501,3250,0,1,3252,271036
168,3250,2400,1100,2640000,2,26006,6503,1,112120000,112120000,9751,3250,6501,3250,0,1,3252,261973
168,3250,2400,1100,2640000,2,26006,6503,1,112120000,112120000,9751,3250,6501,3250,0,1,3252,270116
168,3250,2400,1100,2640000,2,26006,6503,1,112120000,112120000,9751,3250,6501,3250,0,1,3252,268810
168,3250,2400,1100,2640000,2,26006,6503,1,112120000,112120000,9751,3250,6501,3250,0,1,3252,276455
168,3250,2400,1100,2640000,2,26006,6503,1,112120000,112120000,9751,3250,6501,3250,0,1,3252,275972
168,3650,2400,1100,2640000,2,29206,7303,1,123320000,123320000,10951,3650,7301,3650,0,1,3652,2545866
168,3650,2400,1100,2640000,2,29206,7303,1,123320000,123320000,10951,3650,7301,3650,0,1,3652,295402
168,3650,2400,1100,2640000,2,29206,7303,1,123320000,123320000,10951,3650,7301,3650,0,1,3652,294258
168,3650,2400,1100,2640000,2,29206,7303,1,123320000,123320000,10951,3650,7301,3650,0,1,3652,291873
168,3650,2400,1100,2640000,2,29206,7303,1,123320000,123320000,10951,3650,7301,3650,0,1,3652,298475
168,3650,2400,1100,2640000,2,29206,7303,1,123320000,123320000,10951,3650,7301,3650,0,1,3652,316208
168,3650,2400,1100,2640000,2,29206,7303,1,123320000,123320000,10951,3650,7301,3650,0,1,3652,300357
168,4050,2400,1100,2640000,2,32406,8103,1,134520000,134520000,12151,4050,8101,4050,0,1,4052,2834373
168,4050,2400,1100,2640000,2,32406,8103,1,134520000,134520000,12151,4050,8101,4050,0,1,4052,316804
168,4050,2400,1100,2640000,2,32406,8103,1,134520000,134520000,12151,4050,8101,4050,0,1,4052,329017
168,4050,2400,1100,2640000,2,32406,8103,1,134520000,134520000,12151,4050,8101,4050,0,1,4052,317522
168,4050,2400,1100,2640000,2,32406,8103,1,134520000,134520000,12151,4050,8101,4050,0,1,4052,313495
168,4050,2400,1100,2640000,2,32406,8103,1,134520000,134520000,12151,4050,8101,4050,0,1,4052,348420
168,4050,2400,1100,2640000,2,32406,8103,1,134520000,134520000,12151,4050,8101,4050,0,1,4052,345128
168,4450,2400,1100,2640000,2,35606,8903,1,145720000,145720000,13351,4450,8901,4450,0,1,4452,3196969
168,4450,2400,1100,2640000,2,35606,8903,1,145720000,145720000,13351,4450,8901,4450,0,1,4452,345152
168,4450,2400,1100,2640000,2,35606,8903,1,145720000,145720000,13351,4450,8901,4450,0,1,4452,346316
168,4450,2400,1100,2640000,2,35606,8903,1,145720000,145720000,13351,4450,8901,4450,0,1,4452,340797
168,4450,2400,1100,2640000,2,35606,8903,1,145720000,145720000,13351,4450,8901,4450,0,1,4452,345798
168,4450,2400,1100,2640000,2,35606,8903,1,145720000,145720000,13351,4450,8901,4450,0,1,4452,379768
168,4450,2400,1100,2640000,2,35606,8903,1,145720000,145720000,13351,4450,8901,4450,0,1,4452,380308
168,4850,2400,1100,2640000,2,38806,9703,1,156920000,156920000,14551,4850,9701,4850,0,1,4852,3284878
168,4850,2400,1100,2640000,2,38806,9703,1,156920000,156920000,14551,4850,9701,4850,0,1,4852,375495
168,4850,2400,1100,2640000,2,38806,9703,1,156920000,156920000,14551,4850,9701,4850,0,1,4852,372742
168,4850,2400,1100,2640000,2,38806,9703,1,156920000,156920000,14551,4850,9701,4850,0,1,4852,374728
168,4850,2400,1100,2640000,2,38806,9703,1,156920000,156920000,14551,4850,9701,4850,0,1,4852,373812
168,4850,2400,1100,2640000,2,38806,9703,1,156920000,156920000,14551,4850,9701,4850,0,1,4852,407510
168,4850,2400,1100,2640000,2,38806,9703,1,156920000,156920000,14551,4850,9701,4850,0,1,4852,408677
168,5250,2400,1100,2640000,2,42006,10503,1,168120000,168120000,15751,5250,10501,5250,0,1,5252,3669388
168,5250,2400,1100,2640000,2,42006,10503,1,168120000,168120000,15751,5250,10501,5250,0,1,5252,400834
168,5250,2400,1100,2640000,2,42006,10503,1,168120000,168120000,15751,5250,10501,5250,0,1,5252,396653
168,5250,2400,1100,2640000,2,42006,10503,1,168120000,168120000,15751,5250,10501,5250,0,1,5252,401547
168,5250,2400,1100,2640000,2,42006,10503,1,168120000,168120000,15751,5250,10501,5250,0,1,5252,402132
168,5250,2400,1100,2640000,2,42006,10503,1,168120000,168120000,15751,5250,10501,5250,0,1,5252,443024
168,5250,2400,1100,2640000,2,42006,10503,1,168120000,168120000,15751,5250,10501,5250,0,1,5252,443638
168,5650,2400,1100,2640000,2,45206,11303,1,179320000,179320000,16951,5650,11301,5650,0,1,5652,3871120
168,5650,2400,1100,2640000,2,45206,11303,1,179320000,179320000,16951,5650,11301,5650,0,1,5652,431297
168,5650,2400,1100,2640000,2,45206,11303,1,179320000,179320000,16951,5650,11301,5650,0,1,5652,428643
168,5650,2400,1100,2640000,2,45206,11303,1,179320000,179320000,16951,5650,11301,5650,0,1,5652,429809
168,5650,2400,1100,2640000,2,45206,11303,1,179320000,179320000,16951,5650,11301,5650,0,1,5652,430468
168,5650,2400,1100,2640000,2,45206,11303,1,179320000,179320000,16951,5650,11301,5650,0,1,5652,482659
168,5650,2400,1100,2640000,2,45206,11303,1,179320000,179320000,16951,5650,11301,5650,0,1,5652,481445
168,6050,2400,1100,2640000,2,48406,12103,1,190520000,190520000,18151,6050,12101,6050,0,1,6052,4174019
168,6050,2400,1100,2640000,2,48406,12103,1,190520000,190520000,18151,6050,12101,6050,0,1,6052,457484
168,6050,2400,1100,2640000,2,48406,12103,1,190520000,190520000,18151,6050,12101,6050,0,1,6052,455151
168,6050,2400,1100,2640000,2,48406,12103,1,190520000,190520000,18151,6050,12101,6050,0,1,6052,455781
168,6050,2400,1100,2640000,2,48406,12103,1,190520000,190520000,18151,6050,12101,6050,0,1,6052,458334
168,6050,2400,1100,2640000,2,48406,12103,1,190520000,190520000,18151,6050,12101,6050,0,1,6052,507698
168,6050,2400,1100,2640000,2,48406,12103,1,190520000,190520000,18151,6050,12101,6050,0,1,6052,507065
168,6450,2400,1100,2640000,2,51606,12903,1,201720000,201720000,19351,6450,12901,6450,0,1,6452,4501714
168,6450,2400,1100,2640000,2,51606,12903,1,201720000,201720000,19351,6450,12901,6450,0,1,6452,491921
168,6450,2400,1100,2640000,2,51606,12903,1,201720000,201720000,19351,6450,12901,6450,0,1,6452,473597
168,6450,2400,1100,2640000,2,51606,12903,1,201720000,201720000,19351,6450,12901,6450,0,1,6452,499257
168,6450,2400,1100,2640000,2,51606,12903,1,201720000,201720000,19351,6450,12901,6450,0,1,6452,475266
168,6450,2400,1100,2640000,2,51606,12903,1,201720000,201720000,19351,6450,12901,6450,0,1,6452,543845
168,6450,2400,1100,2640000,2,51606,12903,1,201720000,201720000,19351,6450,12901,6450,0,1,6452,545154
168,6850,2400,1100,2640000,2,54806,13703,1,212920000,212920000,20551,6850,13701,6850,0,1,6852,4713935
168,6850,2400,1100,2640000,2,54806,13703,1,212920000,212920000,20551,6850,13701,6850,0,1,6852,512245
168,6850,2400,1100,2640000,2,54806,13703,1,212920000,212920000,20551,6850,13701,6850,0,1,6852,513533
168,6850,2400,1100,2640000,2,54806,13703,1,212920000,212920000,20551,6850,13701,6850,0,1,6852,514236
168,6850,2400,1100,2640000,2,54806,13703,1,212920000,212920000,20551,6850,13701,6850,0,1,6852,512908
168,6850,2400,1100,2640000,2,54806,13703,1,212920000,212920000,20551,6850,13701,6850,0,1,6852,583806
168,6850,2400,1100,2640000,2,54806,13703,1,212920000,212920000,20551,6850,13701,6850,0,1,6852,584456
168,50,2400,700,1680000,2,406,103,1,14680000,14680000,151,50,101,50,0,1,52,17511
168,50,2400,700,1680000,2,406,103,1,14680000,14680000,151,50,101,50,0,1,52,25296
168,50,2400,700,1680000,2,406,103,1,14680000,14680000,151,50,101,50,0,1,52,23924
168,50,2400,700,1680000,2,406,103,1,14680000,14680000,151,50,101,50,0,1,52,26052
168,50,2400,700,1680000,2,406,103,1,14680000,14680000,151,50,101,50,0,1,52,20852
168,50,2400,700,1680000,2,406,103,1,14680000,14680000,151,50,101,50,0,1,52,27608
168,50,2400,700,1680000,2,406,103,1,14680000,14680000,151,50,101,50,0,1,52,27181
168,450,2400,700,1680000,2,3606,903,1,24600000,24600000,1351,450,901,450,0,1,452,166272
168,450,2400,700,1680000,2,3606,903,1,24600000,24600000,1351,450,901,450,0,1,452,44266
168,450,2400,700,1680000,2,3606,903,1,24600000,24600000,1351,450,901,450,0,1,452,42490
168,450,2400,700,1680000,2,3606,903,1,24600000,24600000,1351,450,901,450,0,1,452,44722
168,450,2400,700,1680000,2,3606,903,1,24600000,24600000,1351,450,901,450,0,1,452,43387
168,450,2400,700,1680000,2,3606,903,1,24600000,24600000,1351,450,901,450,0,1,452,50247
168,450,2400,700,1680000,2,3606,903,1,24600000,24600000,1351,450,901,450,0,1,452,51341
168,850,2400,700,1680000,2,6806,1703,1,34520000,34520000,2551,850,1701,850,0,1,852,350394
168,850,2400,700,1680000,2,6806,1703,1,34520000,34520000,2551,850,1701,850,0,1,852,62903
168,850,2400,700,1680000,2,6806,1703,1,34520000,34520000,2551,850,1701,850,0,1,852,65055
168,850,2400,700,1680000,2,6806,1703,1,34520000,34520000,2551,850,1701,850,0,1,852,65528
168,850,2400,700,1680000,2,6806,1703,1,34520000,34520000,2551,850,1701,850,0,1,852,63754
168,850,2400,700,1680000,2,6806,1703,1,34520000,34520000,2551,850,1701,850,0,1,852,71798
168,850,2400,700,1680000,2,6806,1703,1,34520000,34520000,2551,850,1701,850,0,1,852,72302
168,1250,2400,700,1680000,2,10006,2503,1,44440000,44440000,3751,1250,2501,1250,0,1,1252,503023
168,1250,2400,700,1680000,2,10006,2503,1,44440000,44440000,3751,1250,2501,1250,0,1,1252,82751
168,1250,2400,700,1680000,2,10006,2503,1,44440000,44440000,3751,1250,2501,1250,0,1,1252,85171
168,1250,2400,700,1680000,2,10006,2503,1,44440000,44440000,3751,1250,2501,1250,0,1,1252,85560
168,1250,2400,700,1680000,2,10006,2503,1,44440000,44440000,3751,1250,2501,1250,0,1,1252,86078
168,1250,2400,700,1680000,2,10006,2503,1,44440000,44440000,3751,1250,2501,1250,0,1,1252,95135
168,1250,2400,700,1680000,2,10006,2503,1,44440000,44440000,3751,1250,2501,1250,0,1,1252,94597
168,1650,2400,700,1680000,2,13206,3303,1,54360000,54360000,4951,1650,3301,1650,0,1,1652,676205
168,1650,2400,700,1680000,2,13206,3303,1,54360000,54360000,4951,1650,3301,1650,0,1,1652,106082
168,1650,2400,700,1680000,2,13206,3303,1,54360000,54360000,4951,1650,3301,1650,0,1,1652,107334
168,1650,2400,700,1680000,2,13206,3303,1,54360000,54360000,4951,1650,3301,1650,0,1,1652,108536
168,1650,2400,700,1680000,2,13206,3303,1,54360000,54360000,4951,1650,3301,1650,0,1,1652,107976
168,1650,2400,700,1680000,2,13206,3303,1,54360000,54360000,4951,1650,3301,1650,0,1,1652,118860
168,1650,2400,700,1680000,2,13206,3303,1,54360000,54360000,4951,1650,3301,1650,0,1,1652,119447
168,2050,2400,700,1680000,2,16406,4103,1,64280000,64280000,6151,2050,4101,2050,0,1,2052,833020
168,2050,2400,700,1680000,2,16406,4103,1,64280000,64280000,6151,2050,4101,2050,0,1,2052,128128
168,2050,2400,700,1680000,2,16406,4103,1,64280000,64280000,6151,2050,4101,2050,0,1,2052,123186
168,2050,2400,700,1680000,2,16406,4103,1,64280000,64280000,6151,2050,4101,2050,0,1,2052,127543
168,2050,2400,700,1680000,2,16406,4103,1,64280000,64280000,6151,2050,4101,2050,0,1,2052,128498
168,2050,2400,700,1680000,2,16406,4103,1,64280000,64280000,6151,2050,4101,2050,0,1,2052,137827
168,2050,2400,700,1680000,2,16406,4103,1,64280000,64280000,6151,2050,4101,2050,0,1,2052,143198
168,2450,2400,700,1680000,2,19606,4903,1,74200000,74200000,7351,2450,4901,2450,0,1,2452,946796
168,2450,2400,700,1680000,2,19606,4903,1,74200000,74200000,7351,2450,4901,2450,0,1,2452,146966
168,2450,2400,700,1680000,2,19606,4903,1,74200000,74200000,7351,2450,4901,2450,0,1,2452,148348
168,2450,2400,700,1680000,2,19606,4903,1,74200000,74200000,7351,2450,4901,2450,0,1,2452,149064
168,2450,2400,700,1680000,2,19606,4903,1,74200000,74200000,7351,2450,4901,2450,0,1,2452,149712
168,2450,2400,700,1680000,2,19606,4903,1,74200000,74200000,7351,2450,4901,2450,0,1,2452,164948
168,2450,2400,700,1680000,2,19606,4903,1,74200000,74200000,7351,2450,4901,2450,0,1,2452,166925
168,2850,2400,700,1680000,2,22806,5703,1,84120000,84120000,8551,2850,5701,2850,0,1,2852,1221237
168,2850,2400,700,1680000,2,22806,5703,1,84120000,84120000,8551,2850,5701,2850,0,1,2852,171603
168,2850,2400,700,1680000,2,22806,5703,1,84120000,84120000,8551,2850,5701,2850,0,1,2852,172605
168,2850,2400,700,1680000,2,22806,5703,1,84120000,84120000,8551,2850,5701,2850,0,1,2852,170312
168,2850,2400,700,1680000,2,22806,5703,1,84120000,84120000,8551,2850,5701,2850,0,1,2852,172187
168,2850,2400,700,1680000,2,22806,5703,1,84120000,84120000,8551,2850,5701,2850,0,1,2852,185483
168,2850,2400,700,1680000,2,22806,5703,1,84120000,84120000,8551,2850,5701,2850,0,1,2852,186182
168,3250,2400,700,1680000,2,26006,6503,1,94040000,94040000,9751,3250,6501,3250,0,1,3252,1388655
168,3250,2400,700,1680000,2,26006,6503,1,94040000,94040000,9751,3250,6501,3250,0,1,3252,192204
168,3250,2400,700,1680000,2,26006,6503,1,94040000,94040000,9751,3250,6501,3250,0,1,3252,192830
168,3250,2400,700,1680000,2,26006,6503,1,94040000,94040000,9751,3250,6501,3250,0,1,3252,191549
168,3250,2400,700,1680000,2,26006,6503,1,94040000,94040000,9751,3250,6501,3250,0,1,3252,193290
168,3250,2400,700,1680000,2,26006,6503,1,94040000,94040000,9751,3250,6501,3250,0,1,3252,204907
168,3250,2400,700,1680000,2,26006,6503,1,94040000,94040000,9751,3250,6501,3250,0,1,3252,205390
168,3650,2400,700,1680000,2,29206,7303,1,103960000,103960000,10951,3650,7301,3650,0,1,3652,1578146
168,3650,2400,700,1680000,2,29206,7303,1,103960000,103960000,10951,3650,7301,3650,0,1,3652,205785
168,3650,2400,700,1680000,2,29206,7303,1,103960000,103960000,10951,3650,7301,3650,0,1,3652,203089
168,3650,2400,700,1680000,2,29206,7303,1,103960000,103960000,10951,3650,7301,3650,0,1,3652,205083
168,3650,2400,700,1680000,2,29206,7303,1,103960000,103960000,10951,3650,7301,3650,0,1,3652,204379
168,3650,2400,700,1680000,2,29206,7303,1,103960000,103960000,10951,3650,7301,3650,0,1,3652,223540
168,3650,2400,700,1680000,2,29206,7303,1,103960000,103960000,10951,3650,7301,3650,0,1,3652,224068
168,4050,2400,700,1680000,2,32406,8103,1,113880000,113880000,12151,4050,8101,4050,0,1,4052,1664176
168,4050,2400,700,1680000,2,32406,8103,1,113880000,113880000,12151,4050,8101,4050,0,1,4052,223682
168,4050,2400,700,1680000,2,32406,8103,1,113880000,113880000,12151,4050,8101,4050,0,1,4052,225117
168,4050,2400,700,1680000,2,32406,8103,1,113880000,113880000,12151,4050,8101,4050,0,1,4052,222368
168,4050,2400,700,1680000,2,32406,8103,1,113880000,113880000,12151,4050,8101,4050,0,1,4052,224427
168,4050,2400,700,1680000,2,32406,8103,1,113880000,113880000,12151,4050,8101,4050,0,1,4052,257089
168,4050,2400,700,1680000,2,32406,8103,1,113880000,113880000,12151,4050,8101,4050,0,1,4052,256538
168,4450,2400,700,1680000,2,35606,8903,1,123800000,123800000,13351,4450,8901,4450,0,1,4452,1963050
168,4450,2400,700,1680000,2,35606,8903,1,123800000,123800000,13351,4450,8901,4450,0,1,4452,248269
168,4450,2400,700,1680000,2,35606,8903,1,123800000,123800000,13351,4450,8901,4450,0,1,4452,245674
168,4450,2400,700,1680000,2,35606,8903,1,123800000,123800000,13351,4450,8901,4450,0,1,4452,246407
168,4450,2400,700,1680000,2,35606,8903,1,123800000,123800000,13351,4450,8901,4450,0,1,4452,247545
168,4450,2400,700,1680000,2,35606,8903,1,123800000,123800000,13351,4450,8901,4450,0,1,4452,268064
168,4450,2400,700,1680000,2,35606,8903,1,123800000,123800000,13351,4450,8901,4450,0,1,4452,267522
168,4850,2400,700,1680000,2,38806,9703,1,133720000,133720000,14551,4850,9701,4850,0,1,4852,2042646
168,4850,2400,700,1680000,2,38806,9703,1,133720000,133720000,14551,4850,9701,4850,0,1,4852,263752
168,4850,2400,700,1680000,2,38806,9703,1,133720000,133720000,14551,4850,9701,4850,0,1,4852,262062
168,4850,2400,700,1680000,2,38806,9703,1,133720000,133720000,14551,4850,9701,4850,0,1,4852,261086
168,4850,2400,700,1680000,2,38806,9703,1,133720000,133720000,14551,4850,9701,4850,0,1,4852,262984
168,4850,2400,700,1680000,2,38806,9703,1,133720000,133720000,14551,4850,9701,4850,0,1,4852,294668
168,4850,2400,700,1680000,2,38806,9703,1,133720000,133720000,14551,4850,9701,4850,0,1,4852,295233
168,5250,2400,700,1680000,2,42006,10503,1,143640000,143640000,15751,5250,10501,5250,0,1,5252,2278344
168,5250,2400,700,1680000,2,42006,10503,1,143640000,143640000,15751,5250,10501,5250,0,1,5252,284060
168,5250,2400,700,1680000,2,42006,10503,1,143640000,143640000,15751,5250,10501,5250,0,1,5252,283262
168,5250,2400,700,1680000,2,42006,10503,1,143640000,143640000,15751,5250,10501,5250,0,1,5252,281013
168,5250,2400,700,1680000,2,42006,10503,1,143640000,143640000,15751,5250,10501,5250,0,1,5252,282443
168,5250,2400,700,1680000,2,42006,10503,1,143640000,143640000,15751,5250,10501,5250,0,1,5252,325815
168,5250,2400,700,1680000,2,42006,10503,1,143640000,143640000,15751,5250,10501,5250,0,1,5252,326371
168,5650,2400,700,1680000,2,45206,11303,1,153560000,153560000,16951,5650,11301,5650,0,1,5652,2462243
168,5650,2400,700,1680000,2,45206,11303,1,153560000,153560000,16951,5650,11301,5650,0,1,5652,310187
168,5650,2400,700,1680000,2,45206,11303,1,153560000,153560000,16951,5650,11301,5650,0,1,5652,309468
168,5650,2400,700,1680000,2,45206,11303,1,153560000,153560000,16951,5650,11301,5650,0,1,5652,311113
168,5650,2400,700,1680000,2,45206,11303,1,153560000,153560000,16951,5650,11301,5650,0,1,5652,312753
168,5650,2400,700,1680000,2,45206,11303,1,153560000,153560000,16951,5650,11301,5650,0,1,5652,359471
168,5650,2400,700,1680000,2,45206,11303,1,153560000,153560000,16951,5650,11301,5650,0,1,5652,339252
168,6050,2400,700,1680000,2,48406,12103,1,163480000,163480000,18151,6050,12101,6050,0,1,6052,2625351
168,6050,2400,700,1680000,2,48406,12103,1,163480000,163480000,18151,6050,12101,6050,0,1,6052,328357
168,6050,2400,700,1680000,2,48406,12103,1,163480000,163480000,18151,6050,12101,6050,0,1,6052,335485
168,6050,2400,700,1680000,2,48406,12103,1,163480000,163480000,18151,6050,12101,6050,0,1,6052,329794
168,6050,2400,700,1680000,2,48406,12103,1,163480000,163480000,18151,6050,12101,6050,0,1,6052,332234
168,6050,2400,700,1680000,2,48406,12103,1,163480000,163480000,18151,6050,12101,6050,0,1,6052,379012
168,6050,2400,700,1680000,2,48406,12103,1,163480000,163480000,18151,6050,12101,6050,0,1,6052,374692
168,6450,2400,700,1680000,2,51606,12903,1,173400000,173400000,19351,6450,12901,6450,0,1,6452,2822391
168,6450,2400,700,1680000,2,51606,12903,1,173400000,173400000,19351,6450,12901,6450,0,1,6452,340334
168,6450,2400,700,1680000,2,51606,12903,1,173400000,173400000,19351,6450,12901,6450,0,1,6452,341826
168,6450,2400,700,1680000,2,51606,12903,1,173400000,173400000,19351,6450,12901,6450,0,1,6452,341114
168,6450,2400,700,1680000,2,51606,12903,1,173400000,173400000,19351,6450,12901,6450,0,1,6452,339581
168,6450,2400,700,1680000,2,51606,12903,1,173400000,173400000,19351,6450,12901,6450,0,1,6452,395341
168,6450,2400,700,1680000,2,51606,12903,1,173400000,173400000,19351,6450,12901,6450,0,1,6452,396028
168,6850,2400,700,1680000,2,54806,13703,1,183320000,183320000,20551,6850,13701,6850,0,1,6852,2893402
168,6850,2400,700,1680000,2,54806,13703,1,183320000,183320000,20551,6850,13701,6850,0,1,6852,369681
168,6850,2400,700,1680000,2,54806,13703,1,183320000,183320000,20551,6850,13701,6850,0,1,6852,367700
168,6850,2400,700,1680000,2,54806,13703,1,183320000,183320000,20551,6850,13701,6850,0,1,6852,368747
168,6850,2400,700,1680000,2,54806,13703,1,183320000,183320000,20551,6850,13701,6850,0,1,6852,366561
168,6850,2400,700,1680000,2,54806,13703,1,183320000,183320000,20551,6850,13701,6850,0,1,6852,422730
168,6850,2400,700,1680000,2,54806,13703,1,183320000,183320000,20551,6850,13701,6850,0,1,6852,424167
168,50,2400,300,720000,2,406,103,1,6840000,6840000,151,50,101,50,0,1,52,7297
168,50,2400,300,720000,2,406,103,1,6840000,6840000,151,50,101,50,0,1,52,15531
168,50,2400,300,720000,2,406,103,1,6840000,6840000,151,50,101,50,0,1,52,18139
168,50,2400,300,720000,2,406,103,1,6840000,6840000,151,50,101,50,0,1,52,16960
168,50,2400,300,720000,2,406,103,1,6840000,6840000,151,50,101,50,0,1,52,12648
168,50,2400,300,720000,2,406,103,1,6840000,6840000,151,50,101,50,0,1,52,18536
168,50,2400,300,720000,2,406,103,1,6840000,6840000,151,50,101,50,0,1,52,18720
168,450,2400,300,720000,2,3606,903,1,15480000,15480000,1351,450,901,450,0,1,452,66166
168,450,2400,300,720000,2,3606,903,1,15480000,15480000,1351,450,901,450,0,1,452,29742
168,450,2400,300,720000,2,3606,903,1,15480000,15480000,1351,450,901,450,0,1,452,32567
168,450,2400,300,720000,2,3606,903,1,15480000,15480000,1351,450,901,450,0,1,452,32899
168,450,2400,300,720000,2,3606,903,1,15480000,15480000,1351,450,901,450,0,1,452,31499
168,450,2400,300,720000,2,3606,903,1,15480000,15480000,1351,450,901,450,0,1,452,35018
168,450,2400,300,720000,2,3606,903,1,15480000,15480000,1351,450,901,450,0,1,452,34542
168,850,2400,300,720000,2,6806,1703,1,24120000,24120000,2551,850,1701,850,0,1,852,145192
168,850,2400,300,720000,2,6806,1703,1,24120000,24120000,2551,850,1701,850,0,1,852,41720
168,850,2400,300,720000,2,6806,1703,1,24120000,24120000,2551,850,1701,850,0,1,852,35627
168,850,2400,300,720000,2,6806,1703,1,24120000,24120000,2551,850,1701,850,0,1,852,39631
168,850,2400,300,720000,2,6806,1703,1,24120000,24120000,2551,850,1701,850,0,1,852,41243
168,850,2400,300,720000,2,6806,1703,1,24120000,24120000,2551,850,1701,850,0,1,852,45991
168,850,2400,300,720000,2,6806,1703,1,24120000,24120000,2551,850,1701,850,0,1,852,46481
168,1250,2400,300,720000,2,10006,2503,1,32760000,32760000,3751,1250,2501,1250,0,1,1252,217765
168,1250,2400,300,720000,2,10006,2503,1,32760000,32760000,3751,1250,2501,1250,0,1,1252,53473
168,1250,2400,300,720000,2,10006,2503,1,32760000,32760000,3751,1250,2501,1250,0,1,1252,55965
168,1250,2400,300,720000,2,10006,2503,1,32760000,32760000,3751,1250,2501,1250,0,1,1252,56250
168,1250,2400,300,720000,2,10006,2503,1,32760000,32760000,3751,1250,2501,1250,0,1,1252,55490
168,1250,2400,300,720000,2,10006,2503,1,32760000,32760000,3751,1250,2501,1250,0,1,1252,60674
168,1250,2400,300,720000,2,10006,2503,1,32760000,32760000,3751,1250,2501,1250,0,1,1252,61219
168,1650,2400,300,720000,2,13206,3303,1,41400000,41400000,4951,1650,3301,1650,0,1,1652,289704
168,1650,2400,300,720000,2,13206,3303,1,41400000,41400000,4951,1650,3301,1650,0,1,1652,68632
168,1650,2400,300,720000,2,13206,3303,1,41400000,41400000,4951,1650,3301,1650,0,1,1652,69203
168,1650,2400,300,720000,2,13206,3303,1,41400000,41400000,4951,1650,3301,1650,0,1,1652,67797
168,1650,2400,300,720000,2,13206,3303,1,41400000,41400000,4951,1650,3301,1650,0,1,1652,67014
168,1650,2400,300,720000,2,13206,3303,1,41400000,41400000,4951,1650,3301,1650,0,1,1652,74702
168,1650,2400,300,720000,2,13206,3303,1,41400000,41400000,4951,1650,3301,1650,0,1,1652,75903
168,2050,2400,300,720000,2,16406,4103,1,50040000,50040000,6151,2050,4101,2050,0,1,2052,361891
168,2050,2400,300,720000,2,16406,4103,1,50040000,50040000,6151,2050,4101,2050,0,1,2052,82561
168,2050,2400,300,720000,2,16406,4103,1,50040000,50040000,6151,2050,4101,2050,0,1,2052,83133
168,2050,2400,300,720000,2,16406,4103,1,50040000,50040000,6151,2050,4101,2050,0,1,2052,80654
168,2050,2400,300,720000,2,16406,4103,1,50040000,50040000,6151,2050,4101,2050,0,1,2052,81901
168,2050,2400,300,720000,2,16406,4103,1,50040000,50040000,6151,2050,4101,2050,0,1,2052,90474
168,2050,2400,300,720000,2,16406,4103,1,50040000,50040000,6151,2050,4101,2050,0,1,2052,89870
168,2450,2400,300,720000,2,19606,4903,1,58680000,58680000,7351,2450,4901,2450,0,1,2452,429056
168,2450,2400,300,720000,2,19606,4903,1,58680000,58680000,7351,2450,4901,2450,0,1,2452,95713
168,2450,2400,300,720000,2,19606,4903,1,58680000,58680000,7351,2450,4901,2450,0,1,2452,96411
168,2450,2400,300,720000,2,19606,4903,1,58680000,58680000,7351,2450,4901,2450,0,1,2452,94133
168,2450,2400,300,720000,2,19606,4903,1,58680000,58680000,7351,2450,4901,2450,0,1,2452,96931
168,2450,2400,300,720000,2,19606,4903,1,58680000,58680000,7351,2450,4901,2450,0,1,2452,103869
168,2450,2400,300,720000,2,19606,4903,1,58680000,58680000,7351,2450,4901,2450,0,1,2452,104525
168,2850,2400,300,720000,2,22806,5703,1,67320000,67320000,8551,2850,5701,2850,0,1,2852,488576
168,2850,2400,300,720000,2,22806,5703,1,67320000,67320000,8551,2850,5701,2850,0,1,2852,102335
168,2850,2400,300,720000,2,22806,5703,1,67320000,67320000,8551,2850,5701,2850,0,1,2852,105390
168,2850,2400,300,720000,2,22806,5703,1,67320000,67320000,8551,2850,5701,2850,0,1,2852,105811
168,2850,2400,300,720000,2,22806,5703,1,67320000,67320000,8551,2850,5701,2850,0,1,2852,104801
168,2850,2400,300,720000,2,22806,5703,1,67320000,67320000,8551,2850,5701,2850,0,1,2852,119433
168,2850,2400,300,720000,2,22806,5703,1,67320000,67320000,8551,2850,5701,2850,0,1,2852,118612
168,3250,2400,300,720000,2,26006,6503,1,75960000,75960000,9751,3250,6501,3250,0,1,3252,577068
168,3250,2400,300,720000,2,26006,6503,1,75960000,75960000,9751,3250,6501,3250,0,1,3252,140010
168,3250,2400,300,720000,2,26006,6503,1,75960000,75960000,9751,3250,6501,3250,0,1,3252,137615
168,3250,2400,300,720000,2,26006,6503,1,75960000,75960000,9751,3250,6501,3250,0,1,3252,139548
168,3250,2400,300,720000,2,26006,6503,1,75960000,75960000,9751,3250,6501,3250,0,1,3252,138929
168,3250,2400,300,720000,2,26006,6503,1,75960000,75960000,9751,3250,6501,3250,0,1,3252,157742
168,3250,2400,300,720000,2,26006,6503,1,75960000,75960000,9751,3250,6501,3250,0,1,3252,158612
168,3650,2400,300,720000,2,29206,7303,1,84600000,84600000,10951,3650,7301,3650,0,1,3652,639805
168,3650,2400,300,720000,2,29206,7303,1,84600000,84600000,10951,3650,7301,3650,0,1,3652,124912
168,3650,2400,300,720000,2,29206,7303,1,84600000,84600000,10951,3650,7301,3650,0,1,3652,127621
168,3650,2400,300,720000,2,29206,7303,1,84600000,84600000,10951,3650,7301,3650,0,1,3652,125870
168,3650,2400,300,720000,2,29206,7303,1,84600000,84600000,10951,3650,7301,3650,0,1,3652,126867
168,3650,2400,300,720000,2,29206,7303,1,84600000,84600000,10951,3650,7301,3650,0,1,3652,147487
168,3650,2400,300,720000,2,29206,7303,1,84600000,84600000,10951,3650,7301,3650,0,1,3652,151551
168,4050,2400,300,720000,2,32406,8103,1,93240000,93240000,12151,4050,8101,4050,0,1,4052,725401
168,4050,2400,300,720000,2,32406,8103,1,93240000,93240000,12151,4050,8101,4050,0,1,4052,137769
168,4050,2400,300,720000,2,32406,8103,1,93240000,93240000,12151,4050,8101,4050,0,1,4052,136379
168,4050,2400,300,720000,2,32406,8103,1,93240000,93240000,12151,4050,8101,4050,0,1,4052,137072
168,4050,2400,300,720000,2,32406,8103,1,93240000,93240000,12151,4050,8101,4050,0,1,4052,138307
168,4050,2400,300,720000,2,32406,8103,1,93240000,93240000,12151,4050,8101,4050,0,1,4052,166897
168,4050,2400,300,720000,2,32406,8103,1,93240000,93240000,12151,4050,8101,4050,0,1,4052,165948
168,4450,2400,300,720000,2,35606,8903,1,101880000,101880000,13351,4450,8901,4450,0,1,4452,782784
168,4450,2400,300,720000,2,35606,8903,1,101880000,101880000,13351,4450,8901,4450,0,1,4452,147768
168,4450,2400,300,720000,2,35606,8903,1,101880000,101880000,13351,4450,8901,4450,0,1,4452,149895
168,4450,2400,300,720000,2,35606,8903,1,101880000,101880000,13351,4450,8901,4450,0,1,4452,150639
168,4450,2400,300,720000,2,35606,8903,1,101880000,101880000,13351,4450,8901,4450,0,1,4452,149105
168,4450,2400,300,720000,2,35606,8903,1,101880000,101880000,13351,4450,8901,4450,0,1,4452,190525
168,4450,2400,300,720000,2,35606,8903,1,101880000,101880000,13351,4450,8901,4450,0,1,4452,191510
168,4850,2400,300,720000,2,38806,9703,1,110520000,110520000,14551,4850,9701,4850,0,1,4852,872839
168,4850,2400,300,720000,2,38806,9703,1,110520000,110520000,14551,4850,9701,4850,0,1,4852,155627
168,4850,2400,300,720000,2,38806,9703,1,110520000,110520000,14551,4850,9701,4850,0,1,4852,157028
168,4850,2400,300,720000,2,38806,9703,1,110520000,110520000,14551,4850,9701,4850,0,1,4852,156327
168,4850,2400,300,720000,2,38806,9703,1,110520000,110520000,14551,4850,9701,4850,0,1,4852,157596
168,4850,2400,300,720000,2,38806,9703,1,110520000,110520000,14551,4850,9701,4850,0,1,4852,206737
168,4850,2400,300,720000,2,38806,9703,1,110520000,110520000,14551,4850,9701,4850,0,1,4852,207334
168,5250,2400,300,720000,2,42006,10503,1,119160000,119160000,15751,5250,10501,5250,0,1,5252,964311
168,5250,2400,300,720000,2,42006,10503,1,119160000,119160000,15751,5250,10501,5250,0,1,5252,169927
168,5250,2400,300,720000,2,42006,10503,1,119160000,119160000,15751,5250,10501,5250,0,1,5252,168587
168,5250,2400,300,720000,2,42006,10503,1,119160000,119160000,15751,5250,10501,5250,0,1,5252,167856
168,5250,2400,300,720000,2,42006,10503,1,119160000,119160000,15751,5250,10501,5250,0,1,5252,169318
168,5250,2400,300,720000,2,42006,10503,1,119160000,119160000,15751,5250,10501,5250,0,1,5252,212912
168,5250,2400,300,720000,2,42006,10503,1,119160000,119160000,15751,5250,10501,5250,0,1,5252,212292
168,5650,2400,300,720000,2,45206,11303,1,127800000,127800000,16951,5650,11301,5650,0,1,5652,985629
168,5650,2400,300,720000,2,45206,11303,1,127800000,127800000,16951,5650,11301,5650,0,1,5652,187158
168,5650,2400,300,720000,2,45206,11303,1,127800000,127800000,16951,5650,11301,5650,0,1,5652,186299
168,5650,2400,300,720000,2,45206,11303,1,127800000,127800000,16951,5650,11301,5650,0,1,5652,185420
168,5650,2400,300,720000,2,45206,11303,1,127800000,127800000,16951,5650,11301,5650,0,1,5652,184017
168,5650,2400,300,720000,2,45206,11303,1,127800000,127800000,16951,5650,11301,5650,0,1,5652,218779
168,5650,2400,300,720000,2,45206,11303,1,127800000,127800000,16951,5650,11301,5650,0,1,5652,219421
168,6050,2400,300,720000,2,48406,12103,1,136440000,136440000,18151,6050,12101,6050,0,1,6052,1069381
168,6050,2400,300,720000,2,48406,12103,1,136440000,136440000,18151,6050,12101,6050,0,1,6052,192834
168,6050,2400,300,720000,2,48406,12103,1,136440000,136440000,18151,6050,12101,6050,0,1,6052,193615
168,6050,2400,300,720000,2,48406,12103,1,136440000,136440000,18151,6050,12101,6050,0,1,6052,194280
168,6050,2400,300,720000,2,48406,12103,1,136440000,136440000,18151,6050,12101,6050,0,1,6052,191461
168,6050,2400,300,720000,2,48406,12103,1,136440000,136440000,18151,6050,12101,6050,0,1,6052,239260
168,6050,2400,300,720000,2,48406,12103,1,136440000,136440000,18151,6050,12101,6050,0,1,6052,238564
168,6450,2400,300,720000,2,51606,12903,1,145080000,145080000,19351,6450,12901,6450,0,1,6452,1201851
168,6450,2400,300,720000,2,51606,12903,1,145080000,145080000,19351,6450,12901,6450,0,1,6452,208591
168,6450,2400,300,720000,2,51606,12903,1,145080000,145080000,19351,6450,12901,6450,0,1,6452,207075
168,6450,2400,300,720000,2,51606,12903,1,145080000,145080000,19351,6450,12901,6450,0,1,6452,205742
168,6450,2400,300,720000,2,51606,12903,1,145080000,145080000,19351,6450,12901,6450,0,1,6452,207888
168,6450,2400,300,720000,2,51606,12903,1,145080000,145080000,19351,6450,12901,6450,0,1,6452,251115
168,6450,2400,300,720000,2,51606,12903,1,145080000,145080000,19351,6450,12901,6450,0,1,6452,250428
168,6850,2400,300,720000,2,54806,13703,1,153720000,153720000,20551,6850,13701,6850,0,1,6852,1234409
168,6850,2400,300,720000,2,54806,13703,1,153720000,153720000,20551,6850,13701,6850,0,1,6852,220410
168,6850,2400,300,720000,2,54806,13703,1,153720000,153720000,20551,6850,13701,6850,0,1,6852,217051
168,6850,2400,300,720000,2,54806,13703,1,153720000,153720000,20551,6850,13701,6850,0,1,6852,218147
168,6850,2400,300,720000,2,54806,13703,1,153720000,153720000,20551,6850,13701,6850,0,1,6852,218891
168,6850,2400,300,720000,2,54806,13703,1,153720000,153720000,20551,6850,13701,6850,0,1,6852,270113
168,6850,2400,300,720000,2,54806,13703,1,153720000,153720000,20551,6850,13701,6850,0,1,6852,270822
168,50,2000,7100,14200000,2,406,103,1,117240000,117240000,151,50,101,50,0,1,52,159338
168,50,2000,7100,14200000,2,406,103,1,117240000,117240000,151,50,101,50,0,1,52,146977
168,50,2000,7100,14200000,2,406,103,1,117240000,117240000,151,50,101,50,0,1,52,144368
168,50,2000,7100,14200000,2,406,103,1,117240000,117240000,151,50,101,50,0,1,52,137026
168,50,2000,7100,14200000,2,406,103,1,117240000,117240000,151,50,101,50,0,1,52,146577
168,50,2000,7100,14200000,2,406,103,1,117240000,117240000,151,50,101,50,0,1,52,176936
168,50,2000,7100,14200000,2,406,103,1,117240000,117240000,151,50,101,50,0,1,52,177358
168,450,2000,7100,14200000,2,3606,903,1,146360000,146360000,1351,450,901,450,0,1,452,1564754
168,450,2000,7100,14200000,2,3606,903,1,146360000,146360000,1351,450,901,450,0,1,452,296579
168,450,2000,7100,14200000,2,3606,903,1,146360000,146360000,1351,450,901,450,0,1,452,294225
168,450,2000,7100,14200000,2,3606,903,1,146360000,146360000,1351,450,901,450,0,1,452,289024
168,450,2000,7100,14200000,2,3606,903,1,146360000,146360000,1351,450,901,450,0,1,452,295354
168,450,2000,7100,14200000,2,3606,903,1,146360000,146360000,1351,450,901,450,0,1,452,296884
168,450,2000,7100,14200000,2,3606,903,1,146360000,146360000,1351,450,901,450,0,1,452,297038
168,850,2000,7100,14200000,2,6806,1703,1,175480000,175480000,2551,850,1701,850,0,1,852,3120640
168,850,2000,7100,14200000,2,6806,1703,1,175480000,175480000,2551,850,1701,850,0,1,852,427045
168,850,2000,7100,14200000,2,6806,1703,1,175480000,175480000,2551,850,1701,850,0,1,852,426439
168,850,2000,7100,14200000,2,6806,1703,1,175480000,175480000,2551,850,1701,850,0,1,852,431554
168,850,2000,7100,14200000,2,6806,1703,1,175480000,175480000,2551,850,1701,850,0,1,852,427484
168,850,2000,7100,14200000,2,6806,1703,1,175480000,175480000,2551,850,1701,850,0,1,852,430455
168,850,2000,7100,14200000,2,6806,1703,1,175480000,175480000,2551,850,1701,850,0,1,852,431911
168,1250,2000,7100,14200000,2,10006,2503,1,204600000,204600000,3751,1250,2501,1250,0,1,1252,5239403
168,1250,2000,7100,14200000,2,10006,2503,1,204600000,204600000,3751,1250,2501,1250,0,1,1252,542336
168,1250,2000,7100,14200000,2,10006,2503,1,204600000,204600000,3751,1250,2501,1250,0,1,1252,550354
168,1250,2000,7100,14200000,2,10006,2503,1,204600000,204600000,3751,1250,2501,1250,0,1,1252,511881
168,1250,2000,7100,14200000,2,10006,2503,1,204600000,204600000,3751,1250,2501,1250,0,1,1252,551982
168,1250,2000,7100,14200000,2,10006,2503,1,204600000,204600000,3751,1250,2501,1250,0,1,1252,553351
168,1250,2000,7100,14200000,2,10006,2503,1,204600000,204600000,3751,1250,2501,1250,0,1,1252,553727
168,1650,2000,7100,14200000,2,13206,3303,1,233720000,233720000,4951,1650,3301,1650,0,1,1652,6605803
168,1650,2000,7100,14200000,2,13206,3303,1,233720000,233720000,4951,1650,3301,1650,0,1,1652,698678
168,1650,2000,7100,14200000,2,13206,3303,1,233720000,233720000,4951,1650,3301,1650,0,1,1652,695360
168,1650,2000,7100,14200000,2,13206,3303,1,233720000,233720000,4951,1650,3301,1650,0,1,1652,697171
168,1650,2000,7100,14200000,2,13206,3303,1,233720000,233720000,4951,1650,3301,1650,0,1,1652,698111
168,1650,2000,7100,14200000,2,13206,3303,1,233720000,233720000,4951,1650,3301,1650,0,1,1652,711451
168,1650,2000,7100,14200000,2,13206,3303,1,233720000,233720000,4951,1650,3301,1650,0,1,1652,711839
168,2050,2000,7100,14200000,2,16406,4103,1,262840000,262840000,6151,2050,4101,2050,0,1,2052,8778116
168,2050,2000,7100,14200000,2,16406,4103,1,262840000,262840000,6151,2050,4101,2050,0,1,2052,780965
168,2050,2000,7100,14200000,2,16406,4103,1,262840000,262840000,6151,2050,4101,2050,0,1,2052,830563
168,2050,2000,7100,14200000,2,16406,4103,1,262840000,262840000,6151,2050,4101,2050,0,1,2052,793322
168,2050,2000,7100,14200000,2,16406,4103,1,262840000,262840000,6151,2050,4101,2050,0,1,2052,829258
168,2050,2000,7100,14200000,2,16406,4103,1,262840000,262840000,6151,2050,4101,2050,0,1,2052,839489
168,2050,2000,7100,14200000,2,16406,4103,1,262840000,262840000,6151,2050,4101,2050,0,1,2052,834310
168,2450,2000,7100,14200000,2,19606,4903,1,291960000,291960000,7351,2450,4901,2450,0,1,2452,10117169
168,2450,2000,7100,14200000,2,19606,4903,1,291960000,291960000,7351,2450,4901,2450,0,1,2452,946887
168,2450,2000,7100,14200000,2,19606,4903,1,291960000,291960000,7351,2450,4901,2450,0,1,2452,941073
168,2450,2000,7100,14200000,2,19606,4903,1,291960000,291960000,7351,2450,4901,2450,0,1,2452,947915
168,2450,2000,7100,14200000,2,19606,4903,1,291960000,291960000,7351,2450,4901,2450,0,1,2452,943857
168,2450,2000,7100,14200000,2,19606,4903,1,291960000,291960000,7351,2450,4901,2450,0,1,2452,956664
168,2450,2000,7100,14200000,2,19606,4903,1,291960000,291960000,7351,2450,4901,2450,0,1,2452,956143
168,2850,2000,7100,14200000,2,22806,5703,1,321080000,321080000,8551,2850,5701,2850,0,1,2852,11953589
168,2850,2000,7100,14200000,2,22806,5703,1,321080000,321080000,8551,2850,5701,2850,0,1,2852,1103698
168,2850,2000,7100,14200000,2,22806,5703,1,321080000,321080000,8551,2850,5701,2850,0,1,2852,1059097
168,2850,2000,7100,14200000,2,22806,5703,1,321080000,321080000,8551,2850,5701,2850,0,1,2852,1106655
168,2850,2000,7100,14200000,2,22806,5703,1,321080000,321080000,8551,2850,5701,2850,0,1,2852,1085055
168,2850,2000,7100,14200000,2,22806,5703,1,321080000,321080000,8551,2850,5701,2850,0,1,2852,1102348
168,2850,2000,7100,14200000,2,22806,5703,1,321080000,321080000,8551,2850,5701,2850,0,1,2852,1106097
168,3250,2000,7100,14200000,2,26006,6503,1,350200000,350200000,9751,3250,6501,3250,0,1,3252,13418200
168,3250,2000,7100,14200000,2,26006,6503,1,350200000,350200000,9751,3250,6501,3250,0,1,3252,1232884
168,3250,2000,7100,14200000,2,26006,6503,1,350200000,350200000,9751,3250,6501,3250,0,1,3252,1215390
168,3250,2000,7100,14200000,2,26006,6503,1,350200000,350200000,9751,3250,6501,3250,0,1,3252,1237210
168,3250,2000,7100,14200000,2,26006,6503,1,350200000,350200000,9751,3250,6501,3250,0,1,3252,1239440
168,3250,2000,7100,14200000,2,26006,6503,1,350200000,350200000,9751,3250,6501,3250,0,1,3252,1238840
168,3250,2000,7100,14200000,2,26006,6503,1,350200000,350200000,9751,3250,6501,3250,0,1,3252,1233948
168,3650,2000,7100,14200000,2,29206,7303,1,379320000,379320000,10951,3650,7301,3650,0,1,3652,15301753
168,3650,2000,7100,14200000,2,29206,7303,1,379320000,379320000,10951,3650,7301,3650,0,1,3652,1363010
168,3650,2000,7100,14200000,2,29206,7303,1,379320000,379320000,10951,3650,7301,3650,0,1,3652,1365385
168,3650,2000,7100,14200000,2,29206,7303,1,379320000,379320000,10951,3650,7301,3650,0,1,3652,1363554
168,3650,2000,7100,14200000,2,29206,7303,1,379320000,379320000,10951,3650,7301,3650,0,1,3652,1362428
168,3650,2000,7100,14200000,2,29206,7303,1,379320000,379320000,10951,3650,7301,3650,0,1,3652,1361333
168,3650,2000,7100,14200000,2,29206,7303,1,379320000,379320000,10951,3650,7301,3650,0,1,3652,1358716
168,4050,2000,7100,14200000,2,32406,8103,1,408440000,408440000,12151,4050,8101,4050,0,1,4052,16934619
168,4050,2000,7100,14200000,2,32406,8103,1,408440000,408440000,12151,4050,8101,4050,0,1,4052,1503127
168,4050,2000,7100,14200000,2,32406,8103,1,408440000,408440000,12151,4050,8101,4050,0,1,4052,1489728
168,4050,2000,7100,14200000,2,32406,8103,1,408440000,408440000,12151,4050,8101,4050,0,1,4052,1511343
168,4050,2000,7100,14200000,2,32406,8103,1,408440000,408440000,12151,4050,8101,4050,0,1,4052,1494814
168,4050,2000,7100,14200000,2,32406,8103,1,408440000,408440000,12151,4050,8101,4050,0,1,4052,1486867
168,4050,2000,7100,14200000,2,32406,8103,1,408440000,408440000,12151,4050,8101,4050,0,1,4052,1495620
168,4450,2000,7100,14200000,2,35606,8903,1,437560000,437560000,13351,4450,8901,4450,0,1,4452,18094939
168,4450,2000,7100,14200000,2,35606,8903,1,437560000,437560000,13351,4450,8901,4450,0,1,4452,1646310
168,4450,2000,7100,14200000,2,35606,8903,1,437560000,437560000,13351,4450,8901,4450,0,1,4452,1655298
168,4450,2000,7100,14200000,2,35606,8903,1,437560000,437560000,13351,4450,8901,4450,0,1,4452,1650498
168,4450,2000,7100,14200000,2,35606,8903,1,437560000,437560000,13351,4450,8901,4450,0,1,4452,1654579
168,4450,2000,7100,14200000,2,35606,8903,1,437560000,437560000,13351,4450,8901,4450,0,1,4452,1625930
168,4450,2000,7100,14200000,2,35606,8903,1,437560000,437560000,13351,4450,8901,4450,0,1,4452,1621134
168,4850,2000,7100,14200000,2,38806,9703,1,466680000,466680000,14551,4850,9701,4850,0,1,4852,19991137
168,4850,2000,7100,14200000,2,38806,9703,1,466680000,466680000,14551,4850,9701,4850,0,1,4852,1785212
168,4850,2000,7100,14200000,2,38806,9703,1,466680000,466680000,14551,4850,9701,4850,0,1,4852,1763122
168,4850,2000,7100,14200000,2,38806,9703,1,466680000,466680000,14551,4850,9701,4850,0,1,4852,1784530
168,4850,2000,7100,14200000,2,38806,9703,1,466680000,466680000,14551,4850,9701,4850,0,1,4852,1764595
168,4850,2000,7100,14200000,2,38806,9703,1,466680000,466680000,14551,4850,9701,4850,0,1,4852,1727767
168,4850,2000,7100,14200000,2,38806,9703,1,466680000,466680000,14551,4850,9701,4850,0,1,4852,1759917
168,5250,2000,7100,14200000,2,42006,10503,1,495800000,495800000,15751,5250,10501,5250,0,1,5252,19905083
168,5250,2000,7100,14200000,2,42006,10503,1,495800000,495800000,15751,5250,10501,5250,0,1,5252,1905512
168,5250,2000,7100,14200000,2,42006,10503,1,495800000,495800000,15751,5250,10501,5250,0,1,5252,1924301
168,5250,2000,7100,14200000,2,42006,10503,1,495800000,495800000,15751,5250,10501,5250,0,1,5252,1917803
168,5250,2000,7100,14200000,2,42006,10503,1,495800000,495800000,15751,5250,10501,5250,0,1,5252,1925034
168,5250,2000,7100,14200000,2,42006,10503,1,495800000,495800000,15751,5250,10501,5250,0,1,5252,1881734
168,5250,2000,7100,14200000,2,42006,10503,1,495800000,495800000,15751,5250,10501,5250,0,1,5252,1868915
168,5650,2000,7100,14200000,2,45206,11303,1,524920000,524920000,16951,5650,11301,5650,0,1,5652,24511807
168,5650,2000,7100,14200000,2,45206,11303,1,524920000,524920000,16951,5650,11301,5650,0,1,5652,2040219
168,5650,2000,7100,14200000,2,45206,11303,1,524920000,524920000,16951,5650,11301,5650,0,1,5652,2027231
168,5650,2000,7100,14200000,2,45206,11303,1,524920000,524920000,16951,5650,11301,5650,0,1,5652,2036295
168,5650,2000,7100,14200000,2,45206,11303,1,524920000,524920000,16951,5650,11301,5650,0,1,5652,2028501
168,5650,2000,7100,14200000,2,45206,11303,1,524920000,524920000,16951,5650,11301,5650,0,1,5652,1989569
168,5650,2000,7100,14200000,2,45206,11303,1,524920000,524920000,16951,5650,11301,5650,0,1,5652,2005881
168,6050,2000,7100,14200000,2,48406,12103,1,554040000,554040000,18151,6050,12101,6050,0,1,6052,25608604
168,6050,2000,7100,14200000,2,48406,12103,1,554040000,554040000,18151,6050,12101,6050,0,1,6052,2182199
168,6050,2000,7100,14200000,2,48406,12103,1,554040000,554040000,18151,6050,12101,6050,0,1,6052,2202128
168,6050,2000,7100,14200000,2,48406,12103,1,554040000,554040000,18151,6050,12101,6050,0,1,6052,2194967
168,6050,2000,7100,14200000,2,48406,12103,1,554040000,554040000,18151,6050,12101,6050,0,1,6052,2204975
168,6050,2000,7100,14200000,2,48406,12103,1,554040000,554040000,18151,6050,12101,6050,0,1,6052,2143122
168,6050,2000,7100,14200000,2,48406,12103,1,554040000,554040000,18151,6050,12101,6050,0,1,6052,2128358
168,6450,2000,7100,14200000,2,51606,12903,1,583160000,583160000,19351,6450,12901,6450,0,1,6452,27637948
168,6450,2000,7100,14200000,2,51606,12903,1,583160000,583160000,19351,6450,12901,6450,0,1,6452,2322051
168,6450,2000,7100,14200000,2,51606,12903,1,583160000,583160000,19351,6450,12901,6450,0,1,6452,2280835
168,6450,2000,7100,14200000,2,51606,12903,1,583160000,583160000,19351,6450,12901,6450,0,1,6452,2322881
168,6450,2000,7100,14200000,2,51606,12903,1,583160000,583160000,19351,6450,12901,6450,0,1,6452,2317069
168,6450,2000,7100,14200000,2,51606,12903,1,583160000,583160000,19351,6450,12901,6450,0,1,6452,2267470
168,6450,2000,7100,14200000,2,51606,12903,1,583160000,583160000,19351,6450,12901,6450,0,1,6452,2265700
168,6850,2000,7100,14200000,2,54806,13703,1,612280000,612280000,20551,6850,13701,6850,0,1,6852,28925179
168,6850,2000,7100,14200000,2,54806,13703,1,612280000,612280000,20551,6850,13701,6850,0,1,6852,2456251
168,6850,2000,7100,14200000,2,54806,13703,1,612280000,612280000,20551,6850,13701,6850,0,1,6852,2464024
168,6850,2000,7100,14200000,2,54806,13703,1,612280000,612280000,20551,6850,13701,6850,0,1,6852,2468254
168,6850,2000,7100,14200000,2,54806,13703,1,612280000,612280000,20551,6850,13701,6850,0,1,6852,2442648
168,6850,2000,7100,14200000,2,54806,13703,1,612280000,612280000,20551,6850,13701,6850,0,1,6852,2387727
168,6850,2000,7100,14200000,2,54806,13703,1,612280000,612280000,20551,6850,13701,6850,0,1,6852,2402774
168,50,2000,6700,13400000,2,406,103,1,110680000,110680000,151,50,101,50,0,1,52,153011
168,50,2000,6700,13400000,2,406,103,1,110680000,110680000,151,50,101,50,0,1,52,144074
168,50,2000,6700,13400000,2,406,103,1,110680000,110680000,151,50,101,50,0,1,52,129536
168,50,2000,6700,13400000,2,406,103,1,110680000,110680000,151,50,101,50,0,1,52,142923
168,50,2000,6700,13400000,2,406,103,1,110680000,110680000,151,50,101,50,0,1,52,143293
168,50,2000,6700,13400000,2,406,103,1,110680000,110680000,151,50,101,50,0,1,52,176483
168,50,2000,6700,13400000,2,406,103,1,110680000,110680000,151,50,101,50,0,1,52,175907
168,450,2000,6700,13400000,2,3606,903,1,138520000,138520000,1351,450,901,450,0,1,452,1469017
168,450,2000,6700,13400000,2,3606,903,1,138520000,138520000,1351,450,901,450,0,1,452,261301
168,450,2000,6700,13400000,2,3606,903,1,138520000,138520000,1351,450,901,450,0,1,452,260496
168,450,2000,6700,13400000,2,3606,903,1,138520000,138520000,1351,450,901,450,0,1,452,257359
168,450,2000,6700,13400000,2,3606,903,1,138520000,138520000,1351,450,901,450,0,1,452,237952
168,450,2000,6700,13400000,2,3606,903,1,138520000,138520000,1351,450,901,450,0,1,452,266713
168,450,2000,6700,13400000,2,3606,903,1,138520000,138520000,1351,450,901,450,0,1,452,267052
168,850,2000,6700,13400000,2,6806,1703,1,166360000,166360000,2551,850,1701,850,0,1,852,3132374
168,850,2000,6700,13400000,2,6806,1703,1,166360000,166360000,2551,850,1701,850,0,1,852,396956
168,850,2000,6700,13400000,2,6806,1703,1,166360000,166360000,2551,850,1701,850,0,1,852,400579
168,850,2000,6700,13400000,2,6806,1703,1,166360000,166360000,2551,850,1701,850,0,1,852,400786
168,850,2000,6700,13400000,2,6806,1703,1,166360000,166360000,2551,850,1701,850,0,1,852,400221
168,850,2000,6700,13400000,2,6806,1703,1,166360000,166360000,2551,850,1701,850,0,1,852,401719
168,850,2000,6700,13400000,2,6806,1703,1,166360000,166360000,2551,850,1701,850,0,1,852,402075
168,1250,2000,6700,13400000,2,10006,2503,1,194200000,194200000,3751,1250,2501,1250,0,1,1252,4581027
168,1250,2000,6700,13400000,2,10006,2503,1,194200000,194200000,3751,1250,2501,1250,0,1,1252,528361
168,1250,2000,6700,13400000,2,10006,2503,1,194200000,194200000,3751,1250,2501,1250,0,1,1252,517999
168,1250,2000,6700,13400000,2,10006,2503,1,194200000,194200000,3751,1250,2501,1250,0,1,1252,529541
168,1250,2000,6700,13400000,2,10006,2503,1,194200000,194200000,3751,1250,2501,1250,0,1,1252,516120
168,1250,2000,6700,13400000,2,10006,2503,1,194200000,194200000,3751,1250,2501,1250,0,1,1252,530378
168,1250,2000,6700,13400000,2,10006,2503,1,194200000,194200000,3751,1250,2501,1250,0,1,1252,529119
168,1650,2000,6700,13400000,2,13206,3303,1,222040000,222040000,4951,1650,3301,1650,0,1,1652,6280416
168,1650,2000,6700,13400000,2,13206,3303,1,222040000,222040000,4951,1650,3301,1650,0,1,1652,635650
168,1650,2000,6700,13400000,2,13206,3303,1,222040000,222040000,4951,1650,3301,1650,0,1,1652,647795
168,1650,2000,6700,13400000,2,13206,3303,1,222040000,222040000,4951,1650,3301,1650,0,1,1652,637468
168,1650,2000,6700,13400000,2,13206,3303,1,222040000,222040000,4951,1650,3301,1650,0,1,1652,632304
168,1650,2000,6700,13400000,2,13206,3303,1,222040000,222040000,4951,1650,3301,1650,0,1,1652,652550
168,1650,2000,6700,13400000,2,13206,3303,1,222040000,222040000,4951,1650,3301,1650,0,1,1652,652158
168,2050,2000,6700,13400000,2,16406,4103,1,249880000,249880000,6151,2050,4101,2050,0,1,2052,7808841
168,2050,2000,6700,13400000,2,16406,4103,1,249880000,249880000,6151,2050,4101,2050,0,1,2052,763594
168,2050,2000,6700,13400000,2,16406,4103,1,249880000,249880000,6151,2050,4101,2050,0,1,2052,762515
168,2050,2000,6700,13400000,2,16406,4103,1,249880000,249880000,6151,2050,4101,2050,0,1,2052,768535
168,2050,2000,6700,13400000,2,16406,4103,1,249880000,249880000,6151,2050,4101,2050,0,1,2052,767550
168,2050,2000,6700,13400000,2,16406,4103,1,249880000,249880000,6151,2050,4101,2050,0,1,2052,778397
168,2050,2000,6700,13400000,2,16406,4103,1,249880000,249880000,6151,2050,4101,2050,0,1,2052,777993
168,2450,2000,6700,13400000,2,19606,4903,1,277720000,277720000,7351,2450,4901,2450,0,1,2452,9260590
168,2450,2000,6700,13400000,2,19606,4903,1,277720000,277720000,7351,2450,4901,2450,0,1,2452,906505
168,2450,2000,6700,13400000,2,19606,4903,1,277720000,277720000,7351,2450,4901,2450,0,1,2452,897486
168,2450,2000,6700,13400000,2,19606,4903,1,277720000,277720000,7351,2450,4901,2450,0,1,2452,903023
168,2450,2000,6700,13400000,2,19606,4903,1,277720000,277720000,7351,2450,4901,2450,0,1,2452,895935
168,2450,2000,6700,13400000,2,19606,4903,1,277720000,277720000,7351,2450,4901,2450,0,1,2452,914822
168,2450,2000,6700,13400000,2,19606,4903,1,277720000,277720000,7351,2450,4901,2450,0,1,2452,914398
168,2850,2000,6700,13400000,2,22806,5703,1,305560000,305560000,8551,2850,5701,2850,0,1,2852,10204011
168,2850,2000,6700,13400000,2,22806,5703,1,305560000,305560000,8551,2850,5701,2850,0,1,2852,1015968
168,2850,2000,6700,13400000,2,22806,5703,1,305560000,305560000,8551,2850,5701,2850,0,1,2852,1018345
168,2850,2000,6700,13400000,2,22806,5703,1,305560000,305560000,8551,2850,5701,2850,0,1,2852,1038219
168,2850,2000,6700,13400000,2,22806,5703,1,305560000,305560000,8551,2850,5701,2850,0,1,2852,1024259
168,2850,2000,6700,13400000,2,22806,5703,1,305560000,305560000,8551,2850,5701,2850,0,1,2852,1038933
168,2850,2000,6700,13400000,2,22806,5703,1,305560000,305560000,8551,2850,5701,2850,0,1,2852,1040375
168,3250,2000,6700,13400000,2,26006,6503,1,333400000,333400000,9751,3250,6501,3250,0,1,3252,12761455
168,3250,2000,6700,13400000,2,26006,6503,1,333400000,333400000,9751,3250,6501,3250,0,1,3252,1165440
168,3250,2000,6700,13400000,2,26006,6503,1,333400000,333400000,9751,3250,6501,3250,0,1,3252,1153032
168,3250,2000,6700,13400000,2,26006,6503,1,333400000,333400000,9751,3250,6501,3250,0,1,3252,1167845
168,3250,2000,6700,13400000,2,26006,6503,1,333400000,333400000,9751,3250,6501,3250,0,1,3252,1170659
168,3250,2000,6700,13400000,2,26006,6503,1,333400000,333400000,9751,3250,6501,3250,0,1,3252,1171118
168,3250,2000,6700,13400000,2,26006,6503,1,333400000,333400000,9751,3250,6501,3250,0,1,3252,1166973
168,3650,2000,6700,13400000,2,29206,7303,1,361240000,361240000,10951,3650,7301,3650,0,1,3652,14359574
168,3650,2000,6700,13400000,2,29206,7303,1,361240000,361240000,10951,3650,7301,3650,0,1,3652,1289974
168,3650,2000,6700,13400000,2,29206,7303,1,361240000,361240000,10951,3650,7301,3650,0,1,3652,1296754
168,3650,2000,6700,13400000,2,29206,7303,1,361240000,361240000,10951,3650,7301,3650,0,1,3652,1294087
168,3650,2000,6700,13400000,2,29206,7303,1,361240000,361240000,10951,3650,7301,3650,0,1,3652,1292036
168,3650,2000,6700,13400000,2,29206,7303,1,361240000,361240000,10951,3650,7301,3650,0,1,3652,1295729
168,3650,2000,6700,13400000,2,29206,7303,1,361240000,361240000,10951,3650,7301,3650,0,1,3652,1296144
168,4050,2000,6700,13400000,2,32406,8103,1,389080000,389080000,12151,4050,8101,4050,0,1,4052,16069208
168,4050,2000,6700,13400000,2,32406,8103,1,389080000,389080000,12151,4050,8101,4050,0,1,4052,1427255
168,4050,2000,6700,13400000,2,32406,8103,1,389080000,389080000,12151,4050,8101,4050,0,1,4052,1414827
168,4050,2000,6700,13400000,2,32406,8103,1,389080000,389080000,12151,4050,8101,4050,0,1,4052,1425145
168,4050,2000,6700,13400000,2,32406,8103,1,389080000,389080000,12151,4050,8101,4050,0,1,4052,1416157
168,4050,2000,6700,13400000,2,32406,8103,1,389080000,389080000,12151,4050,8101,4050,0,1,4052,1409948
168,4050,2000,6700,13400000,2,32406,8103,1,389080000,389080000,12151,4050,8101,4050,0,1,4052,1418766
168,4450,2000,6700,13400000,2,35606,8903,1,416920000,416920000,13351,4450,8901,4450,0,1,4452,17380464
168,4450,2000,6700,13400000,2,35606,8903,1,416920000,416920000,13351,4450,8901,4450,0,1,4452,1541308
168,4450,2000,6700,13400000,2,35606,8903,1,416920000,416920000,13351,4450,8901,4450,0,1,4452,1562299
168,4450,2000,6700,13400000,2,35606,8903,1,416920000,416920000,13351,4450,8901,4450,0,1,4452,1549704
168,4450,2000,6700,13400000,2,35606,8903,1,416920000,416920000,13351,4450,8901,4450,0,1,4452,1556443
168,4450,2000,6700,13400000,2,35606,8903,1,416920000,416920000,13351,4450,8901,4450,0,1,4452,1545934
168,4450,2000,6700,13400000,2,35606,8903,1,416920000,416920000,13351,4450,8901,4450,0,1,4452,1524135
168,4850,2000,6700,13400000,2,38806,9703,1,444760000,444760000,14551,4850,9701,4850,0,1,4852,18299146
168,4850,2000,6700,13400000,2,38806,9703,1,444760000,444760000,14551,4850,9701,4850,0,1,4852,1703591
168,4850,2000,6700,13400000,2,38806,9703,1,444760000,444760000,14551,4850,9701,4850,0,1,4852,1694799
168,4850,2000,6700,13400000,2,38806,9703,1,444760000,444760000,14551,4850,9701,4850,0,1,4852,1707127
168,4850,2000,6700,13400000,2,38806,9703,1,444760000,444760000,14551,4850,9701,4850,0,1,4852,1678459
168,4850,2000,6700,13400000,2,38806,9703,1,444760000,444760000,14551,4850,9701,4850,0,1,4852,1628849
168,4850,2000,6700,13400000,2,38806,9703,1,444760000,444760000,14551,4850,9701,4850,0,1,4852,1648142
168,5250,2000,6700,13400000,2,42006,10503,1,472600000,472600000,15751,5250,10501,5250,0,1,5252,20775611
168,5250,2000,6700,13400000,2,42006,10503,1,472600000,472600000,15751,5250,10501,5250,0,1,5252,1665229
168,5250,2000,6700,13400000,2,42006,10503,1,472600000,472600000,15751,5250,10501,5250,0,1,5252,1788561
168,5250,2000,6700,13400000,2,42006,10503,1,472600000,472600000,15751,5250,10501,5250,0,1,5252,1791258
168,5250,2000,6700,13400000,2,42006,10503,1,472600000,472600000,15751,5250,10501,5250,0,1,5252,1790388
168,5250,2000,6700,13400000,2,42006,10503,1,472600000,472600000,15751,5250,10501,5250,0,1,5252,1774210
168,5250,2000,6700,13400000,2,42006,10503,1,472600000,472600000,15751,5250,10501,5250,0,1,5252,1749351
168,5650,2000,6700,13400000,2,45206,11303,1,500440000,500440000,16951,5650,11301,5650,0,1,5652,22297513
168,5650,2000,6700,13400000,2,45206,11303,1,500440000,500440000,16951,5650,11301,5650,0,1,5652,1878666
168,5650,2000,6700,13400000,2,45206,11303,1,500440000,500440000,16951,5650,11301,5650,0,1,5652,1919658
168,5650,2000,6700,13400000,2,45206,11303,1,500440000,500440000,16951,5650,11301,5650,0,1,5652,1945641
168,5650,2000,6700,13400000,2,45206,11303,1,500440000,500440000,16951,5650,11301,5650,0,1,5652,1927862
168,5650,2000,6700,13400000,2,45206,11303,1,500440000,500440000,16951,5650,11301,5650,0,1,5652,1901204
168,5650,2000,6700,13400000,2,45206,11303,1,500440000,500440000,16951,5650,11301,5650,0,1,5652,1913265
168,6050,2000,6700,13400000,2,48406,12103,1,528280000,528280000,18151,6050,12101,6050,0,1,6052,24924234
168,6050,2000,6700,13400000,2,48406,12103,1,528280000,528280000,18151,6050,12101,6050,0,1,6052,2041460
168,6050,2000,6700,13400000,2,48406,12103,1,528280000,528280000,18151,6050,12101,6050,0,1,6052,2069433
168,6050,2000,6700,13400000,2,48406,12103,1,528280000,528280000,18151,6050,12101,6050,0,1,6052,2047790
168,6050,2000,6700,13400000,2,48406,12103,1,528280000,528280000,18151,6050,12101,6050,0,1,6052,2068654
168,6050,2000,6700,13400000,2,48406,12103,1,528280000,528280000,18151,6050,12101,6050,0,1,6052,2031273
168,6050,2000,6700,13400000,2,48406,12103,1,528280000,528280000,18151,6050,12101,6050,0,1,6052,2007502
168,6450,2000,6700,13400000,2,51606,12903,1,556120000,556120000,19351,6450,12901,6450,0,1,6452,25372621
168,6450,2000,6700,13400000,2,51606,12903,1,556120000,556120000,19351,6450,12901,6450,0,1,6452,2190511
168,6450,2000,6700,13400000,2,51606,12903,1,556120000,556120000,19351,6450,12901,6450,0,1,6452,2161901
168,6450,2000,6700,13400000,2,51606,12903,1,556120000,556120000,19351,6450,12901,6450,0,1,6452,2194502
168,6450,2000,6700,13400000,2,51606,12903,1,556120000,556120000,19351,6450,12901,6450,0,1,6452,2169143
168,6450,2000,6700,13400000,2,51606,12903,1,556120000,556120000,19351,6450,12901,6450,0,1,6452,2140090
168,6450,2000,6700,13400000,2,51606,12903,1,556120000,556120000,19351,6450,12901,6450,0,1,6452,2149239
168,6850,2000,6700,13400000,2,54806,13703,1,583960000,583960000,20551,6850,13701,6850,0,1,6852,28224724
168,6850,2000,6700,13400000,2,54806,13703,1,583960000,583960000,20551,6850,13701,6850,0,1,6852,2338695
168,6850,2000,6700,13400000,2,54806,13703,1,583960000,583960000,20551,6850,13701,6850,0,1,6852,2329363
168,6850,2000,6700,13400000,2,54806,13703,1,583960000,583960000,20551,6850,13701,6850,0,1,6852,2321706
168,6850,2000,6700,13400000,2,54806,13703,1,583960000,583960000,20551,6850,13701,6850,0,1,6852,2337877
168,6850,2000,6700,13400000,2,54806,13703,1,583960000,583960000,20551,6850,13701,6850,0,1,6852,2271735
168,6850,2000,6700,13400000,2,54806,13703,1,583960000,583960000,20551,6850,13701,6850,0,1,6852,2259451
168,50,2000,6300,12600000,2,406,103,1,104120000,104120000,151,50,101,50,0,1,52,141525
168,50,2000,6300,12600000,2,406,103,1,104120000,104120000,151,50,101,50,0,1,52,111671
168,50,2000,6300,12600000,2,406,103,1,104120000,104120000,151,50,101,50,0,1,52,129241
168,50,2000,6300,12600000,2,406,103,1,104120000,104120000,151,50,101,50,0,1,52,129648
168,50,2000,6300,12600000,2,406,103,1,104120000,104120000,151,50,101,50,0,1,52,126957
168,50,2000,6300,12600000,2,406,103,1,104120000,104120000,151,50,101,50,0,1,52,158200
168,50,2000,6300,12600000,2,406,103,1,104120000,104120000,151,50,101,50,0,1,52,157779
168,450,2000,6300,12600000,2,3606,903,1,130680000,130680000,1351,450,901,450,0,1,452,1413090
168,450,2000,6300,12600000,2,3606,903,1,130680000,130680000,1351,450,901,450,0,1,452,235522
168,450,2000,6300,12600000,2,3606,903,1,130680000,130680000,1351,450,901,450,0,1,452,269990
168,450,2000,6300,12600000,2,3606,903,1,130680000,130680000,1351,450,901,450,0,1,452,270674
168,450,2000,6300,12600000,2,3606,903,1,130680000,130680000,1351,450,901,450,0,1,452,236192
168,450,2000,6300,12600000,2,3606,903,1,130680000,130680000,1351,450,901,450,0,1,452,263238
168,450,2000,6300,12600000,2,3606,903,1,130680000,130680000,1351,450,901,450,0,1,452,273666
168,850,2000,6300,12600000,2,6806,1703,1,157240000,157240000,2551,850,1701,850,0,1,852,2810940
168,850,2000,6300,12600000,2,6806,1703,1,157240000,157240000,2551,850,1701,850,0,1,852,319656
168,850,2000,6300,12600000,2,6806,1703,1,157240000,157240000,2551,850,1701,850,0,1,852,354773
168,850,2000,6300,12600000,2,6806,1703,1,157240000,157240000,2551,850,1701,850,0,1,852,374580
168,850,2000,6300,12600000,2,6806,1703,1,157240000,157240000,2551,850,1701,850,0,1,852,350676
168,850,2000,6300,12600000,2,6806,1703,1,157240000,157240000,2551,850,1701,850,0,1,852,373911
168,850,2000,6300,12600000,2,6806,1703,1,157240000,157240000,2551,850,1701,850,0,1,852,375064
168,1250,2000,6300,12600000,2,10006,2503,1,183800000,183800000,3751,1250,2501,1250,0,1,1252,4511911
168,1250,2000,6300,12600000,2,10006,2503,1,183800000,183800000,3751,1250,2501,1250,0,1,1252,486993
168,1250,2000,6300,12600000,2,10006,2503,1,183800000,183800000,3751,1250,2501,1250,0,1,1252,487642
168,1250,2000,6300,12600000,2,10006,2503,1,183800000,183800000,3751,1250,2501,1250,0,1,1252,472716
168,1250,2000,6300,12600000,2,10006,2503,1,183800000,183800000,3751,1250,2501,1250,0,1,1252,471260
168,1250,2000,6300,12600000,2,10006,2503,1,183800000,183800000,3751,1250,2501,1250,0,1,1252,488413
168,1250,2000,6300,12600000,2,10006,2503,1,183800000,183800000,3751,1250,2501,1250,0,1,1252,488789
168,1650,2000,6300,12600000,2,13206,3303,1,210360000,210360000,4951,1650,3301,1650,0,1,1652,5691300
168,1650,2000,6300,12600000,2,13206,3303,1,210360000,210360000,4951,1650,3301,1650,0,1,1652,631994
168,1650,2000,6300,12600000,2,13206,3303,1,210360000,210360000,4951,1650,3301,1650,0,1,1652,631212
168,1650,2000,6300,12600000,2,13206,3303,1,210360000,210360000,4951,1650,3301,1650,0,1,1652,632419
168,1650,2000,6300,12600000,2,13206,3303,1,210360000,210360000,4951,1650,3301,1650,0,1,1652,634008
168,1650,2000,6300,12600000,2,13206,3303,1,210360000,210360000,4951,1650,3301,1650,0,1,1652,634402
168,1650,2000,6300,12600000,2,13206,3303,1,210360000,210360000,4951,1650,3301,1650,0,1,1652,629808
168,2050,2000,6300,12600000,2,16406,4103,1,236920000,236920000,6151,2050,4101,2050,0,1,2052,7168231
168,2050,2000,6300,12600000,2,16406,4103,1,236920000,236920000,6151,2050,4101,2050,0,1,2052,718149
168,2050,2000,6300,12600000,2,16406,4103,1,236920000,236920000,6151,2050,4101,2050,0,1,2052,719183
168,2050,2000,6300,12600000,2,16406,4103,1,236920000,236920000,6151,2050,4101,2050,0,1,2052,719801
168,2050,2000,6300,12600000,2,16406,4103,1,236920000,236920000,6151,2050,4101,2050,0,1,2052,716959
168,2050,2000,6300,12600000,2,16406,4103,1,236920000,236920000,6151,2050,4101,2050,0,1,2052,730840
168,2050,2000,6300,12600000,2,16406,4103,1,236920000,236920000,6151,2050,4101,2050,0,1,2052,730436
168,2450,2000,6300,12600000,2,19606,4903,1,263480000,263480000,7351,2450,4901,2450,0,1,2452,8372766
168,2450,2000,6300,12600000,2,19606,4903,1,263480000,263480000,7351,2450,4901,2450,0,1,2452,839175
168,2450,2000,6300,12600000,2,19606,4903,1,263480000,263480000,7351,2450,4901,2450,0,1,2452,843894
168,2450,2000,6300,12600000,2,19606,4903,1,263480000,263480000,7351,2450,4901,2450,0,1,2452,841581
168,2450,2000,6300,12600000,2,19606,4903,1,263480000,263480000,7351,2450,4901,2450,0,1,2452,842393
168,2450,2000,6300,12600000,2,19606,4903,1,263480000,263480000,7351,2450,4901,2450,0,1,2452,853867
168,2450,2000,6300,12600000,2,19606,4903,1,263480000,263480000,7351,2450,4901,2450,0,1,2452,853444
168,2850,2000,6300,12600000,2,22806,5703,1,290040000,290040000,8551,2850,5701,2850,0,1,2852,10320036
168,2850,2000,6300,12600000,2,22806,5703,1,290040000,290040000,8551,2850,5701,2850,0,1,2852,960582
168,2850,2000,6300,12600000,2,22806,5703,1,290040000,290040000,8551,2850,5701,2850,0,1,2852,954740
168,2850,2000,6300,12600000,2,22806,5703,1,290040000,290040000,8551,2850,5701,2850,0,1,2852,959562
168,2850,2000,6300,12600000,2,22806,5703,1,290040000,290040000,8551,2850,5701,2850,0,1,2852,952272
168,2850,2000,6300,12600000,2,22806,5703,1,290040000,290040000,8551,2850,5701,2850,0,1,2852,968909
168,2850,2000,6300,12600000,2,22806,5703,1,290040000,290040000,8551,2850,5701,2850,0,1,2852,969350
168,3250,2000,6300,12600000,2,26006,6503,1,316600000,316600000,9751,3250,6501,3250,0,1,3252,12239828
168,3250,2000,6300,12600000,2,26006,6503,1,316600000,316600000,9751,3250,6501,3250,0,1,3252,1086759
168,3250,2000,6300,12600000,2,26006,6503,1,316600000,316600000,9751,3250,6501,3250,0,1,3252,1081182
168,3250,2000,6300,12600000,2,26006,6503,1,316600000,316600000,9751,3250,6501,3250,0,1,3252,1096663
168,3250,2000,6300,12600000,2,26006,6503,1,316600000,316600000,9751,3250,6501,3250,0,1,3252,1089431
168,3250,2000,6300,12600000,2,26006,6503,1,316600000,316600000,9751,3250,6501,3250,0,1,3252,1095668
168,3250,2000,6300,12600000,2,26006,6503,1,316600000,316600000,9751,3250,6501,3250,0,1,3252,1098162
168,3650,2000,6300,12600000,2,29206,7303,1,343160000,343160000,10951,3650,7301,3650,0,1,3652,13713631
168,3650,2000,6300,12600000,2,29206,7303,1,343160000,343160000,10951,3650,7301,3650,0,1,3652,1207457
168,3650,2000,6300,12600000,2,29206,7303,1,343160000,343160000,10951,3650,7301,3650,0,1,3652,1228008
168,3650,2000,6300,12600000,2,29206,7303,1,343160000,343160000,10951,3650,7301,3650,0,1,3652,1209289
168,3650,2000,6300,12600000,2,29206,7303,1,343160000,343160000,10951,3650,7301,3650,0,1,3652,1225060
168,3650,2000,6300,12600000,2,29206,7303,1,343160000,343160000,10951,3650,7301,3650,0,1,3652,1224336
168,3650,2000,6300,12600000,2,29206,7303,1,343160000,343160000,10951,3650,7301,3650,0,1,3652,1216541
168,4050,2000,6300,12600000,2,32406,8103,1,369720000,369720000,12151,4050,8101,4050,0,1,4052,15766692
168,4050,2000,6300,12600000,2,32406,8103,1,369720000,369720000,12151,4050,8101,4050,0,1,4052,1338038
168,4050,2000,6300,12600000,2,32406,8103,1,369720000,369720000,12151,4050,8101,4050,0,1,4052,1329801
168,4050,2000,6300,12600000,2,32406,8103,1,369720000,369720000,12151,4050,8101,4050,0,1,4052,1338740
168,4050,2000,6300,12600000,2,32406,8103,1,369720000,369720000,12151,4050,8101,4050,0,1,4052,1337224
168,4050,2000,6300,12600000,2,32406,8103,1,369720000,369720000,12151,4050,8101,4050,0,1,4052,1335077
168,4050,2000,6300,12600000,2,32406,8103,1,369720000,369720000,12151,4050,8101,4050,0,1,4052,1336237
168,4450,2000,6300,12600000,2,35606,8903,1,396280000,396280000,13351,4450,8901,4450,0,1,4452,16521367
168,4450,2000,6300,12600000,2,35606,8903,1,396280000,396280000,13351,4450,8901,4450,0,1,4452,1485412
168,4450,2000,6300,12600000,2,35606,8903,1,396280000,396280000,13351,4450,8901,4450,0,1,4452,1469049
168,4450,2000,6300,12600000,2,35606,8903,1,396280000,396280000,13351,4450,8901,4450,0,1,4452,1500557
168,4450,2000,6300,12600000,2,35606,8903,1,396280000,396280000,13351,4450,8901,4450,0,1,4452,1499858
168,4450,2000,6300,12600000,2,35606,8903,1,396280000,396280000,13351,4450,8901,4450,0,1,4452,1488171
168,4450,2000,6300,12600000,2,35606,8903,1,396280000,396280000,13351,4450,8901,4450,0,1,4452,1488850
168,4850,2000,6300,12600000,2,38806,9703,1,422840000,422840000,14551,4850,9701,4850,0,1,4852,17782072
168,4850,2000,6300,12600000,2,38806,9703,1,422840000,422840000,14551,4850,9701,4850,0,1,4852,1573335
168,4850,2000,6300,12600000,2,38806,9703,1,422840000,422840000,14551,4850,9701,4850,0,1,4852,1583394
168,4850,2000,6300,12600000,2,38806,9703,1,422840000,422840000,14551,4850,9701,4850,0,1,4852,1575683
168,4850,2000,6300,12600000,2,38806,9703,1,422840000,422840000,14551,4850,9701,4850,0,1,4852,1572541
168,4850,2000,6300,12600000,2,38806,9703,1,422840000,422840000,14551,4850,9701,4850,0,1,4852,1556383
168,4850,2000,6300,12600000,2,38806,9703,1,422840000,422840000,14551,4850,9701,4850,0,1,4852,1557904
168,5250,2000,6300,12600000,2,42006,10503,1,449400000,449400000,15751,5250,10501,5250,0,1,5252,18494584
168,5250,2000,6300,12600000,2,42006,10503,1,449400000,449400000,15751,5250,10501,5250,0,1,5252,1691394
168,5250,2000,6300,12600000,2,42006,10503,1,449400000,449400000,15751,5250,10501,5250,0,1,5252,1671495
168,5250,2000,6300,12600000,2,42006,10503,1,449400000,449400000,15751,5250,10501,5250,0,1,5252,1684819
168,5250,2000,6300,12600000,2,42006,10503,1,449400000,449400000,15751,5250,10501,5250,0,1,5252,1564887
168,5250,2000,6300,12600000,2,42006,10503,1,449400000,449400000,15751,5250,10501,5250,0,1,5252,1664041
168,5250,2000,6300,12600000,2,42006,10503,1,449400000,449400000,15751,5250,10501,5250,0,1,5252,1674952
168,5650,2000,6300,12600000,2,45206,11303,1,475960000,475960000,16951,5650,11301,5650,0,1,5652,21765123
168,5650,2000,6300,12600000,2,45206,11303,1,475960000,475960000,16951,5650,11301,5650,0,1,5652,1813710
168,5650,2000,6300,12600000,2,45206,11303,1,475960000,475960000,16951,5650,11301,5650,0,1,5652,1824030
168,5650,2000,6300,12600000,2,45206,11303,1,475960000,475960000,16951,5650,11301,5650,0,1,5652,1817768
168,5650,2000,6300,12600000,2,45206,11303,1,475960000,475960000,16951,5650,11301,5650,0,1,5652,1823272
168,5650,2000,6300,12600000,2,45206,11303,1,475960000,475960000,16951,5650,11301,5650,0,1,5652,1806521
168,5650,2000,6300,12600000,2,45206,11303,1,475960000,475960000,16951,5650,11301,5650,0,1,5652,1790924
168,6050,2000,6300,12600000,2,48406,12103,1,502520000,502520000,18151,6050,12101,6050,0,1,6052,22935439
168,6050,2000,6300,12600000,2,48406,12103,1,502520000,502520000,18151,6050,12101,6050,0,1,6052,1941232
168,6050,2000,6300,12600000,2,48406,12103,1,502520000,502520000,18151,6050,12101,6050,0,1,6052,1925595
168,6050,2000,6300,12600000,2,48406,12103,1,502520000,502520000,18151,6050,12101,6050,0,1,6052,1946228
168,6050,2000,6300,12600000,2,48406,12103,1,502520000,502520000,18151,6050,12101,6050,0,1,6052,1933112
168,6050,2000,6300,12600000,2,48406,12103,1,502520000,502520000,18151,6050,12101,6050,0,1,6052,1903805
168,6050,2000,6300,12600000,2,48406,12103,1,502520000,502520000,18151,6050,12101,6050,0,1,6052,1931767
168,6450,2000,6300,12600000,2,51606,12903,1,529080000,529080000,19351,6450,12901,6450,0,1,6452,25295283
168,6450,2000,6300,12600000,2,51606,12903,1,529080000,529080000,19351,6450,12901,6450,0,1,6452,2044279
168,6450,2000,6300,12600000,2,51606,12903,1,529080000,529080000,19351,6450,12901,6450,0,1,6452,2060341
168,6450,2000,6300,12600000,2,51606,12903,1,529080000,529080000,19351,6450,12901,6450,0,1,6452,2054468
168,6450,2000,6300,12600000,2,51606,12903,1,529080000,529080000,19351,6450,12901,6450,0,1,6452,2069920
168,6450,2000,6300,12600000,2,51606,12903,1,529080000,529080000,19351,6450,12901,6450,0,1,6452,2027474
168,6450,2000,6300,12600000,2,51606,12903,1,529080000,529080000,19351,6450,12901,6450,0,1,6452,2013693
168,6850,2000,6300,12600000,2,54806,13703,1,555640000,555640000,20551,6850,13701,6850,0,1,6852,27054194
168,6850,2000,6300,12600000,2,54806,13703,1,555640000,555640000,20551,6850,13701,6850,0,1,6852,2191122
168,6850,2000,6300,12600000,2,54806,13703,1,555640000,555640000,20551,6850,13701,6850,0,1,6852,2154685
168,6850,2000,6300,12600000,2,54806,13703,1,555640000,555640000,20551,6850,13701,6850,0,1,6852,2194001
168,6850,2000,6300,12600000,2,54806,13703,1,555640000,555640000,20551,6850,13701,6850,0,1,6852,2174800
168,6850,2000,6300,12600000,2,54806,13703,1,555640000,555640000,20551,6850,13701,6850,0,1,6852,2162411
168,6850,2000,6300,12600000,2,54806,13703,1,555640000,555640000,20551,6850,13701,6850,0,1,6852,2164040
168,50,2000,5900,11800000,2,406,103,1,97560000,97560000,151,50,101,50,0,1,52,129149
168,50,2000,5900,11800000,2,406,103,1,97560000,97560000,151,50,101,50,0,1,52,125025
168,50,2000,5900,11800000,2,406,103,1,97560000,97560000,151,50,101,50,0,1,52,127717
168,50,2000,5900,11800000,2,406,103,1,97560000,97560000,151,50,101,50,0,1,52,127136
168,50,2000,5900,11800000,2,406,103,1,97560000,97560000,151,50,101,50,0,1,52,105527
168,50,2000,5900,11800000,2,406,103,1,97560000,97560000,151,50,101,50,0,1,52,148512
168,50,2000,5900,11800000,2,406,103,1,97560000,97560000,151,50,101,50,0,1,52,150697
168,450,2000,5900,11800000,2,3606,903,1,122840000,122840000,1351,450,901,450,0,1,452,1290603
168,450,2000,5900,11800000,2,3606,903,1,122840000,122840000,1351,450,901,450,0,1,452,246361
168,450,2000,5900,11800000,2,3606,903,1,122840000,122840000,1351,450,901,450,0,1,452,247078
168,450,2000,5900,11800000,2,3606,903,1,122840000,122840000,1351,450,901,450,0,1,452,247432
168,450,2000,5900,11800000,2,3606,903,1,122840000,122840000,1351,450,901,450,0,1,452,245508
168,450,2000,5900,11800000,2,3606,903,1,122840000,122840000,1351,450,901,450,0,1,452,248263
168,450,2000,5900,11800000,2,3606,903,1,122840000,122840000,1351,450,901,450,0,1,452,248604
168,850,2000,5900,11800000,2,6806,1703,1,148120000,148120000,2551,850,1701,850,0,1,852,2567132
168,850,2000,5900,11800000,2,6806,1703,1,148120000,148120000,2551,850,1701,850,0,1,852,360817
168,850,2000,5900,11800000,2,6806,1703,1,148120000,148120000,2551,850,1701,850,0,1,852,364215
168,850,2000,5900,11800000,2,6806,1703,1,148120000,148120000,2551,850,1701,850,0,1,852,356527
168,850,2000,5900,11800000,2,6806,1703,1,148120000,148120000,2551,850,1701,850,0,1,852,362120
168,850,2000,5900,11800000,2,6806,1703,1,148120000,148120000,2551,850,1701,850,0,1,852,363298
168,850,2000,5900,11800000,2,6806,1703,1,148120000,148120000,2551,850,1701,850,0,1,852,362926
168,1250,2000,5900,11800000,2,10006,2503,1,173400000,173400000,3751,1250,2501,1250,0,1,1252,3883135
168,1250,2000,5900,11800000,2,10006,2503,1,173400000,173400000,3751,1250,2501,1250,0,1,1252,472279
168,1250,2000,5900,11800000,2,10006,2503,1,173400000,173400000,3751,1250,2501,1250,0,1,1252,471897
168,1250,2000,5900,11800000,2,10006,2503,1,173400000,173400000,3751,1250,2501,1250,0,1,1252,472525
168,1250,2000,5900,11800000,2,10006,2503,1,173400000,173400000,3751,1250,2501,1250,0,1,1252,470025
168,1250,2000,5900,11800000,2,10006,2503,1,173400000,173400000,3751,1250,2501,1250,0,1,1252,472694
168,1250,2000,5900,11800000,2,10006,2503,1,173400000,173400000,3751,1250,2501,1250,0,1,1252,472882
168,1650,2000,5900,11800000,2,13206,3303,1,198680000,198680000,4951,1650,3301,1650,0,1,1652,5275516
168,1650,2000,5900,11800000,2,13206,3303,1,198680000,198680000,4951,1650,3301,1650,0,1,1652,564297
168,1650,2000,5900,11800000,2,13206,3303,1,198680000,198680000,4951,1650,3301,1650,0,1,1652,560912
168,1650,2000,5900,11800000,2,13206,3303,1,198680000,198680000,4951,1650,3301,1650,0,1,1652,566677
168,1650,2000,5900,11800000,2,13206,3303,1,198680000,198680000,4951,1650,3301,1650,0,1,1652,565615
168,1650,2000,5900,11800000,2,13206,3303,1,198680000,198680000,4951,1650,3301,1650,0,1,1652,575473
168,1650,2000,5900,11800000,2,13206,3303,1,198680000,198680000,4951,1650,3301,1650,0,1,1652,575064
168,2050,2000,5900,11800000,2,16406,4103,1,223960000,223960000,6151,2050,4101,2050,0,1,2052,6728539
168,2050,2000,5900,11800000,2,16406,4103,1,223960000,223960000,6151,2050,4101,2050,0,1,2052,686279
168,2050,2000,5900,11800000,2,16406,4103,1,223960000,223960000,6151,2050,4101,2050,0,1,2052,678818
168,2050,2000,5900,11800000,2,16406,4103,1,223960000,223960000,6151,2050,4101,2050,0,1,2052,683500
168,2050,2000,5900,11800000,2,16406,4103,1,223960000,223960000,6151,2050,4101,2050,0,1,2052,681085
168,2050,2000,5900,11800000,2,16406,4103,1,223960000,223960000,6151,2050,4101,2050,0,1,2052,693117
168,2050,2000,5900,11800000,2,16406,4103,1,223960000,223960000,6151,2050,4101,2050,0,1,2052,693523
168,2450,2000,5900,11800000,2,19606,4903,1,249240000,249240000,7351,2450,4901,2450,0,1,2452,7987088
168,2450,2000,5900,11800000,2,19606,4903,1,249240000,249240000,7351,2450,4901,2450,0,1,2452,779612
168,2450,2000,5900,11800000,2,19606,4903,1,249240000,249240000,7351,2450,4901,2450,0,1,2452,766237
168,2450,2000,5900,11800000,2,19606,4903,1,249240000,249240000,7351,2450,4901,2450,0,1,2452,792805
168,2450,2000,5900,11800000,2,19606,4903,1,249240000,249240000,7351,2450,4901,2450,0,1,2452,781019
168,2450,2000,5900,11800000,2,19606,4903,1,249240000,249240000,7351,2450,4901,2450,0,1,2452,796807
168,2450,2000,5900,11800000,2,19606,4903,1,249240000,249240000,7351,2450,4901,2450,0,1,2452,812971
168,2850,2000,5900,11800000,2,22806,5703,1,274520000,274520000,8551,2850,5701,2850,0,1,2852,10029216
168,2850,2000,5900,11800000,2,22806,5703,1,274520000,274520000,8551,2850,5701,2850,0,1,2852,890546
168,2850,2000,5900,11800000,2,22806,5703,1,274520000,274520000,8551,2850,5701,2850,0,1,2852,901898
168,2850,2000,5900,11800000,2,22806,5703,1,274520000,274520000,8551,2850,5701,2850,0,1,2852,903538
168,2850,2000,5900,11800000,2,22806,5703,1,274520000,274520000,8551,2850,5701,2850,0,1,2852,910174
168,2850,2000,5900,11800000,2,22806,5703,1,274520000,274520000,8551,2850,5701,2850,0,1,2852,927698
168,2850,2000,5900,11800000,2,22806,5703,1,274520000,274520000,8551,2850,5701,2850,0,1,2852,917809
168,3250,2000,5900,11800000,2,26006,6503,1,299800000,299800000,9751,3250,6501,3250,0,1,3252,11052357
168,3250,2000,5900,11800000,2,26006,6503,1,299800000,299800000,9751,3250,6501,3250,0,1,3252,1020387
168,3250,2000,5900,11800000,2,26006,6503,1,299800000,299800000,9751,3250,6501,3250,0,1,3252,1033226
168,3250,2000,5900,11800000,2,26006,6503,1,299800000,299800000,9751,3250,6501,3250,0,1,3252,1026976
168,3250,2000,5900,11800000,2,26006,6503,1,299800000,299800000,9751,3250,6501,3250,0,1,3252,1024810
168,3250,2000,5900,11800000,2,26006,6503,1,299800000,299800000,9751,3250,6501,3250,0,1,3252,1035532
168,3250,2000,5900,11800000,2,26006,6503,1,299800000,299800000,9751,3250,6501,3250,0,1,3252,1035074
168,3650,2000,5900,11800000,2,29206,7303,1,325080000,325080000,10951,3650,7301,3650,0,1,3652,12938211
168,3650,2000,5900,11800000,2,29206,7303,1,325080000,325080000,10951,3650,7301,3650,0,1,3652,1147255
168,3650,2000,5900,11800000,2,29206,7303,1,325080000,325080000,10951,3650,7301,3650,0,1,3652,1129274
168,3650,2000,5900,11800000,2,29206,7303,1,325080000,325080000,10951,3650,7301,3650,0,1,3652,1145985
168,3650,2000,5900,11800000,2,29206,7303,1,325080000,325080000,10951,3650,7301,3650,0,1,3652,1140829
168,3650,2000,5900,11800000,2,29206,7303,1,325080000,325080000,10951,3650,7301,3650,0,1,3652,1146220
168,3650,2000,5900,11800000,2,29206,7303,1,325080000,325080000,10951,3650,7301,3650,0,1,3652,1146634
168,4050,2000,5900,11800000,2,32406,8103,1,350360000,350360000,12151,4050,8101,4050,0,1,4052,14460395
168,4050,2000,5900,11800000,2,32406,8103,1,350360000,350360000,12151,4050,8101,4050,0,1,4052,1216351
168,4050,2000,5900,11800000,2,32406,8103,1,350360000,350360000,12151,4050,8101,4050,0,1,4052,1219492
168,4050,2000,5900,11800000,2,32406,8103,1,350360000,350360000,12151,4050,8101,4050,0,1,4052,1252741
168,4050,2000,5900,11800000,2,32406,8103,1,350360000,350360000,12151,4050,8101,4050,0,1,4052,1251216
168,4050,2000,5900,11800000,2,32406,8103,1,350360000,350360000,12151,4050,8101,4050,0,1,4052,1259454
168,4050,2000,5900,11800000,2,32406,8103,1,350360000,350360000,12151,4050,8101,4050,0,1,4052,1259942
168,4450,2000,5900,11800000,2,35606,8903,1,375640000,375640000,13351,4450,8901,4450,0,1,4452,16787044
168,4450,2000,5900,11800000,2,35606,8903,1,375640000,375640000,13351,4450,8901,4450,0,1,4452,1376871
168,4450,2000,5900,11800000,2,35606,8903,1,375640000,375640000,13351,4450,8901,4450,0,1,4452,1379193
168,4450,2000,5900,11800000,2,35606,8903,1,375640000,375640000,13351,4450,8901,4450,0,1,4452,1378385
168,4450,2000,5900,11800000,2,35606,8903,1,375640000,375640000,13351,4450,8901,4450,0,1,4452,1368292
168,4450,2000,5900,11800000,2,35606,8903,1,375640000,375640000,13351,4450,8901,4450,0,1,4452,1374758
168,4450,2000,5900,11800000,2,35606,8903,1,375640000,375640000,13351,4450,8901,4450,0,1,4452,1373117
168,4850,2000,5900,11800000,2,38806,9703,1,400920000,400920000,14551,4850,9701,4850,0,1,4852,16472360
168,4850,2000,5900,11800000,2,38806,9703,1,400920000,400920000,14551,4850,9701,4850,0,1,4852,1474399
168,4850,2000,5900,11800000,2,38806,9703,1,400920000,400920000,14551,4850,9701,4850,0,1,4852,1447416
168,4850,2000,5900,11800000,2,38806,9703,1,400920000,400920000,14551,4850,9701,4850,0,1,4852,1479390
168,4850,2000,5900,11800000,2,38806,9703,1,400920000,400920000,14551,4850,9701,4850,0,1,4852,1456596
168,4850,2000,5900,11800000,2,38806,9703,1,400920000,400920000,14551,4850,9701,4850,0,1,4852,1464299
168,4850,2000,5900,11800000,2,38806,9703,1,400920000,400920000,14551,4850,9701,4850,0,1,4852,1466942
168,5250,2000,5900,11800000,2,42006,10503,1,426200000,426200000,15751,5250,10501,5250,0,1,5252,18710820
168,5250,2000,5900,11800000,2,42006,10503,1,426200000,426200000,15751,5250,10501,5250,0,1,5252,1584953
168,5250,2000,5900,11800000,2,42006,10503,1,426200000,426200000,15751,5250,10501,5250,0,1,5252,1582534
168,5250,2000,5900,11800000,2,42006,10503,1,426200000,426200000,15751,5250,10501,5250,0,1,5252,1589679
168,5250,2000,5900,11800000,2,42006,10503,1,426200000,426200000,15751,5250,10501,5250,0,1,5252,1592030
168,5250,2000,5900,11800000,2,42006,10503,1,426200000,426200000,15751,5250,10501,5250,0,1,5252,1588913
168,5250,2000,5900,11800000,2,42006,10503,1,426200000,426200000,15751,5250,10501,5250,0,1,5252,1568045
168,5650,2000,5900,11800000,2,45206,11303,1,451480000,451480000,16951,5650,11301,5650,0,1,5652,19430946
168,5650,2000,5900,11800000,2,45206,11303,1,451480000,451480000,16951,5650,11301,5650,0,1,5652,1696151
168,5650,2000,5900,11800000,2,45206,11303,1,451480000,451480000,16951,5650,11301,5650,0,1,5652,1692509
168,5650,2000,5900,11800000,2,45206,11303,1,451480000,451480000,16951,5650,11301,5650,0,1,5652,1681159
168,5650,2000,5900,11800000,2,45206,11303,1,451480000,451480000,16951,5650,11301,5650,0,1,5652,1679927
168,5650,2000,5900,11800000,2,45206,11303,1,451480000,451480000,16951,5650,11301,5650,0,1,5652,1669451
168,5650,2000,5900,11800000,2,45206,11303,1,451480000,451480000,16951,5650,11301,5650,0,1,5652,1671018
168,6050,2000,5900,11800000,2,48406,12103,1,476760000,476760000,18151,6050,12101,6050,0,1,6052,21722442
168,6050,2000,5900,11800000,2,48406,12103,1,476760000,476760000,18151,6050,12101,6050,0,1,6052,1807638
168,6050,2000,5900,11800000,2,48406,12103,1,476760000,476760000,18151,6050,12101,6050,0,1,6052,1796143
168,6050,2000,5900,11800000,2,48406,12103,1,476760000,476760000,18151,6050,12101,6050,0,1,6052,1830954
168,6050,2000,5900,11800000,2,48406,12103,1,476760000,476760000,18151,6050,12101,6050,0,1,6052,1827243
168,6050,2000,5900,11800000,2,48406,12103,1,476760000,476760000,18151,6050,12101,6050,0,1,6052,1815643
168,6050,2000,5900,11800000,2,48406,12103,1,476760000,476760000,18151,6050,12101,6050,0,1,6052,1812744
168,6450,2000,5900,11800000,2,51606,12903,1,502040000,502040000,19351,6450,12901,6450,0,1,6452,22904602
168,6450,2000,5900,11800000,2,51606,12903,1,502040000,502040000,19351,6450,12901,6450,0,1,6452,1966498
168,6450,2000,5900,11800000,2,51606,12903,1,502040000,502040000,19351,6450,12901,6450,0,1,6452,1965672
168,6450,2000,5900,11800000,2,51606,12903,1,502040000,502040000,19351,6450,12901,6450,0,1,6452,1961180
168,6450,2000,5900,11800000,2,51606,12903,1,502040000,502040000,19351,6450,12901,6450,0,1,6452,1956718
168,6450,2000,5900,11800000,2,51606,12903,1,502040000,502040000,19351,6450,12901,6450,0,1,6452,1902158
168,6450,2000,5900,11800000,2,51606,12903,1,502040000,502040000,19351,6450,12901,6450,0,1,6452,1903857
168,6850,2000,5900,11800000,2,54806,13703,1,527320000,527320000,20551,6850,13701,6850,0,1,6852,25270954
168,6850,2000,5900,11800000,2,54806,13703,1,527320000,527320000,20551,6850,13701,6850,0,1,6852,2045108
168,6850,2000,5900,11800000,2,54806,13703,1,527320000,527320000,20551,6850,13701,6850,0,1,6852,2051795
168,6850,2000,5900,11800000,2,54806,13703,1,527320000,527320000,20551,6850,13701,6850,0,1,6852,2060203
168,6850,2000,5900,11800000,2,54806,13703,1,527320000,527320000,20551,6850,13701,6850,0,1,6852,2059227
168,6850,2000,5900,11800000,2,54806,13703,1,527320000,527320000,20551,6850,13701,6850,0,1,6852,2049452
168,6850,2000,5900,11800000,2,54806,13703,1,527320000,527320000,20551,6850,13701,6850,0,1,6852,2050562
168,50,2000,5500,11000000,2,406,103,1,91000000,91000000,151,50,101,50,0,1,52,120929
168,50,2000,5500,11000000,2,406,103,1,91000000,91000000,151,50,101,50,0,1,52,113526
168,50,2000,5500,11000000,2,406,103,1,91000000,91000000,151,50,101,50,0,1,52,111225
168,50,2000,5500,11000000,2,406,103,1,91000000,91000000,151,50,101,50,0,1,52,113946
168,50,2000,5500,11000000,2,406,103,1,91000000,91000000,151,50,101,50,0,1,52,96881
168,50,2000,5500,11000000,2,406,103,1,91000000,91000000,151,50,101,50,0,1,52,136111
168,50,2000,5500,11000000,2,406,103,1,91000000,91000000,151,50,101,50,0,1,52,138251
168,450,2000,5500,11000000,2,3606,903,1,115000000,115000000,1351,450,901,450,0,1,452,1117905
168,450,2000,5500,11000000,2,3606,903,1,115000000,115000000,1351,450,901,450,0,1,452,230980
168,450,2000,5500,11000000,2,3606,903,1,115000000,115000000,1351,450,901,450,0,1,452,233092
168,450,2000,5500,11000000,2,3606,903,1,115000000,115000000,1351,450,901,450,0,1,452,232908
168,450,2000,5500,11000000,2,3606,903,1,115000000,115000000,1351,450,901,450,0,1,452,232229
168,450,2000,5500,11000000,2,3606,903,1,115000000,115000000,1351,450,901,450,0,1,452,233597
168,450,2000,5500,11000000,2,3606,903,1,115000000,115000000,1351,450,901,450,0,1,452,233940
168,850,2000,5500,11000000,2,6806,1703,1,139000000,139000000,2551,850,1701,850,0,1,852,2451700
168,850,2000,5500,11000000,2,6806,1703,1,139000000,139000000,2551,850,1701,850,0,1,852,336902
168,850,2000,5500,11000000,2,6806,1703,1,139000000,139000000,2551,850,1701,850,0,1,852,335949
168,850,2000,5500,11000000,2,6806,1703,1,139000000,139000000,2551,850,1701,850,0,1,852,336423
168,850,2000,5500,11000000,2,6806,1703,1,139000000,139000000,2551,850,1701,850,0,1,852,334837
168,850,2000,5500,11000000,2,6806,1703,1,139000000,139000000,2551,850,1701,850,0,1,852,337387
168,850,2000,5500,11000000,2,6806,1703,1,139000000,139000000,2551,850,1701,850,0,1,852,337216
168,1250,2000,5500,11000000,2,10006,2503,1,163000000,163000000,3751,1250,2501,1250,0,1,1252,3703467
168,1250,2000,5500,11000000,2,10006,2503,1,163000000,163000000,3751,1250,2501,1250,0,1,1252,442349
168,1250,2000,5500,11000000,2,10006,2503,1,163000000,163000000,3751,1250,2501,1250,0,1,1252,436981
168,1250,2000,5500,11000000,2,10006,2503,1,163000000,163000000,3751,1250,2501,1250,0,1,1252,438057
168,1250,2000,5500,11000000,2,10006,2503,1,163000000,163000000,3751,1250,2501,1250,0,1,1252,405849
168,1250,2000,5500,11000000,2,10006,2503,1,163000000,163000000,3751,1250,2501,1250,0,1,1252,439655
168,1250,2000,5500,11000000,2,10006,2503,1,163000000,163000000,3751,1250,2501,1250,0,1,1252,440171
168,1650,2000,5500,11000000,2,13206,3303,1,187000000,187000000,4951,1650,3301,1650,0,1,1652,4897264
168,1650,2000,5500,11000000,2,13206,3303,1,187000000,187000000,4951,1650,3301,1650,0,1,1652,553888
168,1650,2000,5500,11000000,2,13206,3303,1,187000000,187000000,4951,1650,3301,1650,0,1,1652,554279
168,1650,2000,5500,11000000,2,13206,3303,1,187000000,187000000,4951,1650,3301,1650,0,1,1652,555117
168,1650,2000,5500,11000000,2,13206,3303,1,187000000,187000000,4951,1650,3301,1650,0,1,1652,554645
168,1650,2000,5500,11000000,2,13206,3303,1,187000000,187000000,4951,1650,3301,1650,0,1,1652,553195
168,1650,2000,5500,11000000,2,13206,3303,1,187000000,187000000,4951,1650,3301,1650,0,1,1652,551310
168,2050,2000,5500,11000000,2,16406,4103,1,211000000,211000000,6151,2050,4101,2050,0,1,2052,6044430
168,2050,2000,5500,11000000,2,16406,4103,1,211000000,211000000,6151,2050,4101,2050,0,1,2052,642625
168,2050,2000,5500,11000000,2,16406,4103,1,211000000,211000000,6151,2050,4101,2050,0,1,2052,652468
168,2050,2000,5500,11000000,2,16406,4103,1,211000000,211000000,6151,2050,4101,2050,0,1,2052,655277
168,2050,2000,5500,11000000,2,16406,4103,1,211000000,211000000,6151,2050,4101,2050,0,1,2052,653908
168,2050,2000,5500,11000000,2,16406,4103,1,211000000,211000000,6151,2050,4101,2050,0,1,2052,655565
168,2050,2000,5500,11000000,2,16406,4103,1,211000000,211000000,6151,2050,4101,2050,0,1,2052,656732
168,2450,2000,5500,11000000,2,19606,4903,1,235000000,235000000,7351,2450,4901,2450,0,1,2452,7471887
168,2450,2000,5500,11000000,2,19606,4903,1,235000000,235000000,7351,2450,4901,2450,0,1,2452,736113
168,2450,2000,5500,11000000,2,19606,4903,1,235000000,235000000,7351,2450,4901,2450,0,1,2452,734253
168,2450,2000,5500,11000000,2,19606,4903,1,235000000,235000000,7351,2450,4901,2450,0,1,2452,732041
168,2450,2000,5500,11000000,2,19606,4903,1,235000000,235000000,7351,2450,4901,2450,0,1,2452,742568
168,2450,2000,5500,11000000,2,19606,4903,1,235000000,235000000,7351,2450,4901,2450,0,1,2452,757444
168,2450,2000,5500,11000000,2,19606,4903,1,235000000,235000000,7351,2450,4901,2450,0,1,2452,755078
168,2850,2000,5500,11000000,2,22806,5703,1,259000000,259000000,8551,2850,5701,2850,0,1,2852,8827206
168,2850,2000,5500,11000000,2,22806,5703,1,259000000,259000000,8551,2850,5701,2850,0,1,2852,838343
168,2850,2000,5500,11000000,2,22806,5703,1,259000000,259000000,8551,2850,5701,2850,0,1,2852,836966
168,2850,2000,5500,11000000,2,22806,5703,1,259000000,259000000,8551,2850,5701,2850,0,1,2852,844686
168,2850,2000,5500,11000000,2,22806,5703,1,259000000,259000000,8551,2850,5701,2850,0,1,2852,843420
168,2850,2000,5500,11000000,2,22806,5703,1,259000000,259000000,8551,2850,5701,2850,0,1,2852,858974
168,2850,2000,5500,11000000,2,22806,5703,1,259000000,259000000,8551,2850,5701,2850,0,1,2852,859414
168,3250,2000,5500,11000000,2,26006,6503,1,283000000,283000000,9751,3250,6501,3250,0,1,3252,10145145
168,3250,2000,5500,11000000,2,26006,6503,1,283000000,283000000,9751,3250,6501,3250,0,1,3252,940675
168,3250,2000,5500,11000000,2,26006,6503,1,283000000,283000000,9751,3250,6501,3250,0,1,3252,950282
168,3250,2000,5500,11000000,2,26006,6503,1,283000000,283000000,9751,3250,6501,3250,0,1,3252,946867
168,3250,2000,5500,11000000,2,26006,6503,1,283000000,283000000,9751,3250,6501,3250,0,1,3252,942102
168,3250,2000,5500,11000000,2,26006,6503,1,283000000,283000000,9751,3250,6501,3250,0,1,3252,960452
168,3250,2000,5500,11000000,2,26006,6503,1,283000000,283000000,9751,3250,6501,3250,0,1,3252,959907
168,3650,2000,5500,11000000,2,29206,7303,1,307000000,307000000,10951,3650,7301,3650,0,1,3652,11492694
168,3650,2000,5500,11000000,2,29206,7303,1,307000000,307000000,10951,3650,7301,3650,0,1,3652,1072841
168,3650,2000,5500,11000000,2,29206,7303,1,307000000,307000000,10951,3650,7301,3650,0,1,3652,1052935
168,3650,2000,5500,11000000,2,29206,7303,1,307000000,307000000,10951,3650,7301,3650,0,1,3652,1066332
168,3650,2000,5500,11000000,2,29206,7303,1,307000000,307000000,10951,3650,7301,3650,0,1,3652,1064362
168,3650,2000,5500,11000000,2,29206,7303,1,307000000,307000000,10951,3650,7301,3650,0,1,3652,1074937
168,3650,2000,5500,11000000,2,29206,7303,1,307000000,307000000,10951,3650,7301,3650,0,1,3652,1074463
168,4050,2000,5500,11000000,2,32406,8103,1,331000000,331000000,12151,4050,8101,4050,0,1,4052,13783768
168,4050,2000,5500,11000000,2,32406,8103,1,331000000,331000000,12151,4050,8101,4050,0,1,4052,1089902
168,4050,2000,5500,11000000,2,32406,8103,1,331000000,331000000,12151,4050,8101,4050,0,1,4052,1051330
168,4050,2000,5500,11000000,2,32406,8103,1,331000000,331000000,12151,4050,8101,4050,0,1,4052,1181291
168,4050,2000,5500,11000000,2,32406,8103,1,331000000,331000000,12151,4050,8101,4050,0,1,4052,1180716
168,4050,2000,5500,11000000,2,32406,8103,1,331000000,331000000,12151,4050,8101,4050,0,1,4052,1181840
168,4050,2000,5500,11000000,2,32406,8103,1,331000000,331000000,12151,4050,8101,4050,0,1,4052,1181538
168,4450,2000,5500,11000000,2,35606,8903,1,355000000,355000000,13351,4450,8901,4450,0,1,4452,14249068
168,4450,2000,5500,11000000,2,35606,8903,1,355000000,355000000,13351,4450,8901,4450,0,1,4452,1278911
168,4450,2000,5500,11000000,2,35606,8903,1,355000000,355000000,13351,4450,8901,4450,0,1,4452,1289968
168,4450,2000,5500,11000000,2,35606,8903,1,355000000,355000000,13351,4450,8901,4450,0,1,4452,1289144
168,4450,2000,5500,11000000,2,35606,8903,1,355000000,355000000,13351,4450,8901,4450,0,1,4452,1287069
168,4450,2000,5500,11000000,2,35606,8903,1,355000000,355000000,13351,4450,8901,4450,0,1,4452,1286628
168,4450,2000,5500,11000000,2,35606,8903,1,355000000,355000000,13351,4450,8901,4450,0,1,4452,1287694
168,4850,2000,5500,11000000,2,38806,9703,1,379000000,379000000,14551,4850,9701,4850,0,1,4852,16106651
168,4850,2000,5500,11000000,2,38806,9703,1,379000000,379000000,14551,4850,9701,4850,0,1,4852,1374092
168,4850,2000,5500,11000000,2,38806,9703,1,379000000,379000000,14551,4850,9701,4850,0,1,4852,1290413
168,4850,2000,5500,11000000,2,38806,9703,1,379000000,379000000,14551,4850,9701,4850,0,1,4852,1361748
168,4850,2000,5500,11000000,2,38806,9703,1,379000000,379000000,14551,4850,9701,4850,0,1,4852,1342288
168,4850,2000,5500,11000000,2,38806,9703,1,379000000,379000000,14551,4850,9701,4850,0,1,4852,1365443
168,4850,2000,5500,11000000,2,38806,9703,1,379000000,379000000,14551,4850,9701,4850,0,1,4852,1364890
168,5250,2000,5500,11000000,2,42006,10503,1,403000000,403000000,15751,5250,10501,5250,0,1,5252,16899776
168,5250,2000,5500,11000000,2,42006,10503,1,403000000,403000000,15751,5250,10501,5250,0,1,5252,1432924
168,5250,2000,5500,11000000,2,42006,10503,1,403000000,403000000,15751,5250,10501,5250,0,1,5252,1359447
168,5250,2000,5500,11000000,2,42006,10503,1,403000000,403000000,15751,5250,10501,5250,0,1,5252,1482763
168,5250,2000,5500,11000000,2,42006,10503,1,403000000,403000000,15751,5250,10501,5250,0,1,5252,1479418
168,5250,2000,5500,11000000,2,42006,10503,1,403000000,403000000,15751,5250,10501,5250,0,1,5252,1466136
168,5250,2000,5500,11000000,2,42006,10503,1,403000000,403000000,15751,5250,10501,5250,0,1,5252,1472399
168,5650,2000,5500,11000000,2,45206,11303,1,427000000,427000000,16951,5650,11301,5650,0,1,5652,17727518
168,5650,2000,5500,11000000,2,45206,11303,1,427000000,427000000,16951,5650,11301,5650,0,1,5652,1596284
168,5650,2000,5500,11000000,2,45206,11303,1,427000000,427000000,16951,5650,11301,5650,0,1,5652,1598662
168,5650,2000,5500,11000000,2,45206,11303,1,427000000,427000000,16951,5650,11301,5650,0,1,5652,1595498
168,5650,2000,5500,11000000,2,45206,11303,1,427000000,427000000,16951,5650,11301,5650,0,1,5652,1593086
168,5650,2000,5500,11000000,2,45206,11303,1,427000000,427000000,16951,5650,11301,5650,0,1,5652,1586732
168,5650,2000,5500,11000000,2,45206,11303,1,427000000,427000000,16951,5650,11301,5650,0,1,5652,1584662
168,6050,2000,5500,11000000,2,48406,12103,1,451000000,451000000,18151,6050,12101,6050,0,1,6052,19852482
168,6050,2000,5500,11000000,2,48406,12103,1,451000000,451000000,18151,6050,12101,6050,0,1,6052,1669923
168,6050,2000,5500,11000000,2,48406,12103,1,451000000,451000000,18151,6050,12101,6050,0,1,6052,1648638
168,6050,2000,5500,11000000,2,48406,12103,1,451000000,451000000,18151,6050,12101,6050,0,1,6052,1698492
168,6050,2000,5500,11000000,2,48406,12103,1,451000000,451000000,18151,6050,12101,6050,0,1,6052,1697698
168,6050,2000,5500,11000000,2,48406,12103,1,451000000,451000000,18151,6050,12101,6050,0,1,6052,1689184
168,6050,2000,5500,11000000,2,48406,12103,1,451000000,451000000,18151,6050,12101,6050,0,1,6052,1686147
168,6450,2000,5500,11000000,2,51606,12903,1,475000000,475000000,19351,6450,12901,6450,0,1,6452,20641667
168,6450,2000,5500,11000000,2,51606,12903,1,475000000,475000000,19351,6450,12901,6450,0,1,6452,1793531
168,6450,2000,5500,11000000,2,51606,12903,1,475000000,475000000,19351,6450,12901,6450,0,1,6452,1799196
168,6450,2000,5500,11000000,2,51606,12903,1,475000000,475000000,19351,6450,12901,6450,0,1,6452,1798388
168,6450,2000,5500,11000000,2,51606,12903,1,475000000,475000000,19351,6450,12901,6450,0,1,6452,1794776
168,6450,2000,5500,11000000,2,51606,12903,1,475000000,475000000,19351,6450,12901,6450,0,1,6452,1775042
168,6450,2000,5500,11000000,2,51606,12903,1,475000000,475000000,19351,6450,12901,6450,0,1,6452,1769536
168,6850,2000,5500,11000000,2,54806,13703,1,499000000,499000000,20551,6850,13701,6850,0,1,6852,22565217
168,6850,2000,5500,11000000,2,54806,13703,1,499000000,499000000,20551,6850,13701,6850,0,1,6852,1935595
168,6850,2000,5500,11000000,2,54806,13703,1,499000000,499000000,20551,6850,13701,6850,0,1,6852,1887275
168,6850,2000,5500,11000000,2,54806,13703,1,499000000,499000000,20551,6850,13701,6850,0,1,6852,1938819
168,6850,2000,5500,11000000,2,54806,13703,1,499000000,499000000,20551,6850,13701,6850,0,1,6852,1934424
168,6850,2000,5500,11000000,2,54806,13703,1,499000000,499000000,20551,6850,13701,6850,0,1,6852,1907917
168,6850,2000,5500,11000000,2,54806,13703,1,499000000,499000000,20551,6850,13701,6850,0,1,6852,1903357
168,50,2000,5100,10200000,2,406,103,1,84440000,84440000,151,50,101,50,0,1,52,110036
168,50,2000,5100,10200000,2,406,103,1,84440000,84440000,151,50,101,50,0,1,52,105740
168,50,2000,5100,10200000,2,406,103,1,84440000,84440000,151,50,101,50,0,1,52,104121
168,50,2000,5100,10200000,2,406,103,1,84440000,84440000,151,50,101,50,0,1,52,89443
168,50,2000,5100,10200000,2,406,103,1,84440000,84440000,151,50,101,50,0,1,52,105332
168,50,2000,5100,10200000,2,406,103,1,84440000,84440000,151,50,101,50,0,1,52,129092
168,50,2000,5100,10200000,2,406,103,1,84440000,84440000,151,50,101,50,0,1,52,128670
168,450,2000,5100,10200000,2,3606,903,1,107160000,107160000,1351,450,901,450,0,1,452,1025009
168,450,2000,5100,10200000,2,3606,903,1,107160000,107160000,1351,450,901,450,0,1,452,212456
168,450,2000,5100,10200000,2,3606,903,1,107160000,107160000,1351,450,901,450,0,1,452,209897
168,450,2000,5100,10200000,2,3606,903,1,107160000,107160000,1351,450,901,450,0,1,452,214100
168,450,2000,5100,10200000,2,3606,903,1,107160000,107160000,1351,450,901,450,0,1,452,213336
168,450,2000,5100,10200000,2,3606,903,1,107160000,107160000,1351,450,901,450,0,1,452,216620
168,450,2000,5100,10200000,2,3606,903,1,107160000,107160000,1351,450,901,450,0,1,452,216245
168,850,2000,5100,10200000,2,6806,1703,1,129880000,129880000,2551,850,1701,850,0,1,852,2264938
168,850,2000,5100,10200000,2,6806,1703,1,129880000,129880000,2551,850,1701,850,0,1,852,313851
168,850,2000,5100,10200000,2,6806,1703,1,129880000,129880000,2551,850,1701,850,0,1,852,314147
168,850,2000,5100,10200000,2,6806,1703,1,129880000,129880000,2551,850,1701,850,0,1,852,314625
168,850,2000,5100,10200000,2,6806,1703,1,129880000,129880000,2551,850,1701,850,0,1,852,312571
168,850,2000,5100,10200000,2,6806,1703,1,129880000,129880000,2551,850,1701,850,0,1,852,314940
168,850,2000,5100,10200000,2,6806,1703,1,129880000,129880000,2551,850,1701,850,0,1,852,315111
168,1250,2000,5100,10200000,2,10006,2503,1,152600000,152600000,3751,1250,2501,1250,0,1,1252,3373305
168,1250,2000,5100,10200000,2,10006,2503,1,152600000,152600000,3751,1250,2501,1250,0,1,1252,427461
168,1250,2000,5100,10200000,2,10006,2503,1,152600000,152600000,3751,1250,2501,1250,0,1,1252,429014
168,1250,2000,5100,10200000,2,10006,2503,1,152600000,152600000,3751,1250,2501,1250,0,1,1252,427114
168,1250,2000,5100,10200000,2,10006,2503,1,152600000,152600000,3751,1250,2501,1250,0,1,1252,427681
168,1250,2000,5100,10200000,2,10006,2503,1,152600000,152600000,3751,1250,2501,1250,0,1,1252,428411
168,1250,2000,5100,10200000,2,10006,2503,1,152600000,152600000,3751,1250,2501,1250,0,1,1252,427848
168,1650,2000,5100,10200000,2,13206,3303,1,175320000,175320000,4951,1650,3301,1650,0,1,1652,4541690
168,1650,2000,5100,10200000,2,13206,3303,1,175320000,175320000,4951,1650,3301,1650,0,1,1652,501386
168,1650,2000,5100,10200000,2,13206,3303,1,175320000,175320000,4951,1650,3301,1650,0,1,1652,496381
168,1650,2000,5100,10200000,2,13206,3303,1,175320000,175320000,4951,1650,3301,1650,0,1,1652,502561
168,1650,2000,5100,10200000,2,13206,3303,1,175320000,175320000,4951,1650,3301,1650,0,1,1652,500104
168,1650,2000,5100,10200000,2,13206,3303,1,175320000,175320000,4951,1650,3301,1650,0,1,1652,506884
168,1650,2000,5100,10200000,2,13206,3303,1,175320000,175320000,4951,1650,3301,1650,0,1,1652,507276
168,2050,2000,5100,10200000,2,16406,4103,1,198040000,198040000,6151,2050,4101,2050,0,1,2052,5802726
168,2050,2000,5100,10200000,2,16406,4103,1,198040000,198040000,6151,2050,4101,2050,0,1,2052,633360
168,2050,2000,5100,10200000,2,16406,4103,1,198040000,198040000,6151,2050,4101,2050,0,1,2052,633796
168,2050,2000,5100,10200000,2,16406,4103,1,198040000,198040000,6151,2050,4101,2050,0,1,2052,634085
168,2050,2000,5100,10200000,2,16406,4103,1,198040000,198040000,6151,2050,4101,2050,0,1,2052,632011
168,2050,2000,5100,10200000,2,16406,4103,1,198040000,198040000,6151,2050,4101,2050,0,1,2052,636294
168,2050,2000,5100,10200000,2,16406,4103,1,198040000,198040000,6151,2050,4101,2050,0,1,2052,636703
168,2450,2000,5100,10200000,2,19606,4903,1,220760000,220760000,7351,2450,4901,2450,0,1,2452,6988689
168,2450,2000,5100,10200000,2,19606,4903,1,220760000,220760000,7351,2450,4901,2450,0,1,2452,687411
168,2450,2000,5100,10200000,2,19606,4903,1,220760000,220760000,7351,2450,4901,2450,0,1,2452,680305
168,2450,2000,5100,10200000,2,19606,4903,1,220760000,220760000,7351,2450,4901,2450,0,1,2452,683134
168,2450,2000,5100,10200000,2,19606,4903,1,220760000,220760000,7351,2450,4901,2450,0,1,2452,682174
168,2450,2000,5100,10200000,2,19606,4903,1,220760000,220760000,7351,2450,4901,2450,0,1,2452,701950
168,2450,2000,5100,10200000,2,19606,4903,1,220760000,220760000,7351,2450,4901,2450,0,1,2452,701442
168,2850,2000,5100,10200000,2,22806,5703,1,243480000,243480000,8551,2850,5701,2850,0,1,2852,8213219
168,2850,2000,5100,10200000,2,22806,5703,1,243480000,243480000,8551,2850,5701,2850,0,1,2852,776703
168,2850,2000,5100,10200000,2,22806,5703,1,243480000,243480000,8551,2850,5701,2850,0,1,2852,764935
168,2850,2000,5100,10200000,2,22806,5703,1,243480000,243480000,8551,2850,5701,2850,0,1,2852,805527
168,2850,2000,5100,10200000,2,22806,5703,1,243480000,243480000,8551,2850,5701,2850,0,1,2852,806559
168,2850,2000,5100,10200000,2,22806,5703,1,243480000,243480000,8551,2850,5701,2850,0,1,2852,808828
168,2850,2000,5100,10200000,2,22806,5703,1,243480000,243480000,8551,2850,5701,2850,0,1,2852,807585
168,3250,2000,5100,10200000,2,26006,6503,1,266200000,266200000,9751,3250,6501,3250,0,1,3252,9524267
168,3250,2000,5100,10200000,2,26006,6503,1,266200000,266200000,9751,3250,6501,3250,0,1,3252,883309
168,3250,2000,5100,10200000,2,26006,6503,1,266200000,266200000,9751,3250,6501,3250,0,1,3252,871906
168,3250,2000,5100,10200000,2,26006,6503,1,266200000,266200000,9751,3250,6501,3250,0,1,3252,881997
168,3250,2000,5100,10200000,2,26006,6503,1,266200000,266200000,9751,3250,6501,3250,0,1,3252,884196
168,3250,2000,5100,10200000,2,26006,6503,1,266200000,266200000,9751,3250,6501,3250,0,1,3252,898625
168,3250,2000,5100,10200000,2,26006,6503,1,266200000,266200000,9751,3250,6501,3250,0,1,3252,898152
168,3650,2000,5100,10200000,2,29206,7303,1,288920000,288920000,10951,3650,7301,3650,0,1,3652,10268263
168,3650,2000,5100,10200000,2,29206,7303,1,288920000,288920000,10951,3650,7301,3650,0,1,3652,978149
168,3650,2000,5100,10200000,2,29206,7303,1,288920000,288920000,10951,3650,7301,3650,0,1,3652,1000703
168,3650,2000,5100,10200000,2,29206,7303,1,288920000,288920000,10951,3650,7301,3650,0,1,3652,995220
168,3650,2000,5100,10200000,2,29206,7303,1,288920000,288920000,10951,3650,7301,3650,0,1,3652,993779
168,3650,2000,5100,10200000,2,29206,7303,1,288920000,288920000,10951,3650,7301,3650,0,1,3652,1002544
168,3650,2000,5100,10200000,2,29206,7303,1,288920000,288920000,10951,3650,7301,3650,0,1,3652,1003021
168,4050,2000,5100,10200000,2,32406,8103,1,311640000,311640000,12151,4050,8101,4050,0,1,4052,11695442
168,4050,2000,5100,10200000,2,32406,8103,1,311640000,311640000,12151,4050,8101,4050,0,1,4052,1093913
168,4050,2000,5100,10200000,2,32406,8103,1,311640000,311640000,12151,4050,8101,4050,0,1,4052,1079343
168,4050,2000,5100,10200000,2,32406,8103,1,311640000,311640000,12151,4050,8101,4050,0,1,4052,1087859
168,4050,2000,5100,10200000,2,32406,8103,1,311640000,311640000,12151,4050,8101,4050,0,1,4052,1082467
168,4050,2000,5100,10200000,2,32406,8103,1,311640000,311640000,12151,4050,8101,4050,0,1,4052,1094911
168,4050,2000,5100,10200000,2,32406,8103,1,311640000,311640000,12151,4050,8101,4050,0,1,4052,1094423
168,4450,2000,5100,10200000,2,35606,8903,1,334360000,334360000,13351,4450,8901,4450,0,1,4452,12883898
168,4450,2000,5100,10200000,2,35606,8903,1,334360000,334360000,13351,4450,8901,4450,0,1,4452,1147599
168,4450,2000,5100,10200000,2,35606,8903,1,334360000,334360000,13351,4450,8901,4450,0,1,4452,1135096
168,4450,2000,5100,10200000,2,35606,8903,1,334360000,334360000,13351,4450,8901,4450,0,1,4452,1195238
168,4450,2000,5100,10200000,2,35606,8903,1,334360000,334360000,13351,4450,8901,4450,0,1,4452,1190545
168,4450,2000,5100,10200000,2,35606,8903,1,334360000,334360000,13351,4450,8901,4450,0,1,4452,1202332
168,4450,2000,5100,10200000,2,35606,8903,1,334360000,334360000,13351,4450,8901,4450,0,1,4452,1203800
168,4850,2000,5100,10200000,2,38806,9703,1,357080000,357080000,14551,4850,9701,4850,0,1,4852,14368534
168,4850,2000,5100,10200000,2,38806,9703,1,357080000,357080000,14551,4850,9701,4850,0,1,4852,1286185
168,4850,2000,5100,10200000,2,38806,9703,1,357080000,357080000,14551,4850,9701,4850,0,1,4852,1294273
168,4850,2000,5100,10200000,2,38806,9703,1,357080000,357080000,14551,4850,9701,4850,0,1,4852,1290356
168,4850,2000,5100,10200000,2,38806,9703,1,357080000,357080000,14551,4850,9701,4850,0,1,4852,1284191
168,4850,2000,5100,10200000,2,38806,9703,1,357080000,357080000,14551,4850,9701,4850,0,1,4852,1291271
168,4850,2000,5100,10200000,2,38806,9703,1,357080000,357080000,14551,4850,9701,4850,0,1,4852,1290797
168,5250,2000,5100,10200000,2,42006,10503,1,379800000,379800000,15751,5250,10501,5250,0,1,5252,15517241
168,5250,2000,5100,10200000,2,42006,10503,1,379800000,379800000,15751,5250,10501,5250,0,1,5252,1379923
168,5250,2000,5100,10200000,2,42006,10503,1,379800000,379800000,15751,5250,10501,5250,0,1,5252,1372147
168,5250,2000,5100,10200000,2,42006,10503,1,379800000,379800000,15751,5250,10501,5250,0,1,5252,1379195
168,5250,2000,5100,10200000,2,42006,10503,1,379800000,379800000,15751,5250,10501,5250,0,1,5252,1304651
168,5250,2000,5100,10200000,2,42006,10503,1,379800000,379800000,15751,5250,10501,5250,0,1,5252,1378419
168,5250,2000,5100,10200000,2,42006,10503,1,379800000,379800000,15751,5250,10501,5250,0,1,5252,1376915
168,5650,2000,5100,10200000,2,45206,11303,1,402520000,402520000,16951,5650,11301,5650,0,1,5652,16947617
168,5650,2000,5100,10200000,2,45206,11303,1,402520000,402520000,16951,5650,11301,5650,0,1,5652,1438490
168,5650,2000,5100,10200000,2,45206,11303,1,402520000,402520000,16951,5650,11301,5650,0,1,5652,1435124
168,5650,2000,5100,10200000,2,45206,11303,1,402520000,402520000,16951,5650,11301,5650,0,1,5652,1481648
168,5650,2000,5100,10200000,2,45206,11303,1,402520000,402520000,16951,5650,11301,5650,0,1,5652,1480344
168,5650,2000,5100,10200000,2,45206,11303,1,402520000,402520000,16951,5650,11301,5650,0,1,5652,1484533
168,5650,2000,5100,10200000,2,45206,11303,1,402520000,402520000,16951,5650,11301,5650,0,1,5652,1483955
168,6050,2000,5100,10200000,2,48406,12103,1,425240000,425240000,18151,6050,12101,6050,0,1,6052,18394775
168,6050,2000,5100,10200000,2,48406,12103,1,425240000,425240000,18151,6050,12101,6050,0,1,6052,1568630
168,6050,2000,5100,10200000,2,48406,12103,1,425240000,425240000,18151,6050,12101,6050,0,1,6052,1575846
168,6050,2000,5100,10200000,2,48406,12103,1,425240000,425240000,18151,6050,12101,6050,0,1,6052,1573483
168,6050,2000,5100,10200000,2,48406,12103,1,425240000,425240000,18151,6050,12101,6050,0,1,6052,1572664
168,6050,2000,5100,10200000,2,48406,12103,1,425240000,425240000,18151,6050,12101,6050,0,1,6052,1567073
168,6050,2000,5100,10200000,2,48406,12103,1,425240000,425240000,18151,6050,12101,6050,0,1,6052,1564060
168,6450,2000,5100,10200000,2,51606,12903,1,447960000,447960000,19351,6450,12901,6450,0,1,6452,19120202
168,6450,2000,5100,10200000,2,51606,12903,1,447960000,447960000,19351,6450,12901,6450,0,1,6452,1681645
168,6450,2000,5100,10200000,2,51606,12903,1,447960000,447960000,19351,6450,12901,6450,0,1,6452,1635632
168,6450,2000,5100,10200000,2,51606,12903,1,447960000,447960000,19351,6450,12901,6450,0,1,6452,1688713
168,6450,2000,5100,10200000,2,51606,12903,1,447960000,447960000,19351,6450,12901,6450,0,1,6452,1687745
168,6450,2000,5100,10200000,2,51606,12903,1,447960000,447960000,19351,6450,12901,6450,0,1,6452,1680348
168,6450,2000,5100,10200000,2,51606,12903,1,447960000,447960000,19351,6450,12901,6450,0,1,6452,1672462
168,6850,2000,5100,10200000,2,54806,13703,1,470680000,470680000,20551,6850,13701,6850,0,1,6852,20554824
168,6850,2000,5100,10200000,2,54806,13703,1,470680000,470680000,20551,6850,13701,6850,0,1,6852,1778033
168,6850,2000,5100,10200000,2,54806,13703,1,470680000,470680000,20551,6850,13701,6850,0,1,6852,1783420
168,6850,2000,5100,10200000,2,54806,13703,1,470680000,470680000,20551,6850,13701,6850,0,1,6852,1780826
168,6850,2000,5100,10200000,2,54806,13703,1,470680000,470680000,20551,6850,13701,6850,0,1,6852,1777014
168,6850,2000,5100,10200000,2,54806,13703,1,470680000,470680000,20551,6850,13701,6850,0,1,6852,1762375
168,6850,2000,5100,10200000,2,54806,13703,1,470680000,470680000,20551,6850,13701,6850,0,1,6852,1764160
168,50,2000,4700,9400000,2,406,103,1,77880000,77880000,151,50,101,50,0,1,52,100846
168,50,2000,4700,9400000,2,406,103,1,77880000,77880000,151,50,101,50,0,1,52,88391
168,50,2000,4700,9400000,2,406,103,1,77880000,77880000,151,50,101,50,0,1,52,99928
168,50,2000,4700,9400000,2,406,103,1,77880000,77880000,151,50,101,50,0,1,52,99518
168,50,2000,4700,9400000,2,406,103,1,77880000,77880000,151,50,101,50,0,1,52,97462
168,50,2000,4700,9400000,2,406,103,1,77880000,77880000,151,50,101,50,0,1,52,120914
168,50,2000,4700,9400000,2,406,103,1,77880000,77880000,151,50,101,50,0,1,52,121336
168,450,2000,4700,9400000,2,3606,903,1,99320000,99320000,1351,450,901,450,0,1,452,983382
168,450,2000,4700,9400000,2,3606,903,1,99320000,99320000,1351,450,901,450,0,1,452,190316
168,450,2000,4700,9400000,2,3606,903,1,99320000,99320000,1351,450,901,450,0,1,452,190114
168,450,2000,4700,9400000,2,3606,903,1,99320000,99320000,1351,450,901,450,0,1,452,188895
168,450,2000,4700,9400000,2,3606,903,1,99320000,99320000,1351,450,901,450,0,1,452,189710
168,450,2000,4700,9400000,2,3606,903,1,99320000,99320000,1351,450,901,450,0,1,452,206157
168,450,2000,4700,9400000,2,3606,903,1,99320000,99320000,1351,450,901,450,0,1,452,205822
168,850,2000,4700,9400000,2,6806,1703,1,120760000,120760000,2551,850,1701,850,0,1,852,1933510
168,850,2000,4700,9400000,2,6806,1703,1,120760000,120760000,2551,850,1701,850,0,1,852,290680
168,850,2000,4700,9400000,2,6806,1703,1,120760000,120760000,2551,850,1701,850,0,1,852,287146
168,850,2000,4700,9400000,2,6806,1703,1,120760000,120760000,2551,850,1701,850,0,1,852,289905
168,850,2000,4700,9400000,2,6806,1703,1,120760000,120760000,2551,850,1701,850,0,1,852,290203
168,850,2000,4700,9400000,2,6806,1703,1,120760000,120760000,2551,850,1701,850,0,1,852,290997
168,850,2000,4700,9400000,2,6806,1703,1,120760000,120760000,2551,850,1701,850,0,1,852,291169
168,1250,2000,4700,9400000,2,10006,2503,1,142200000,142200000,3751,1250,2501,1250,0,1,1252,2851422
168,1250,2000,4700,9400000,2,10006,2503,1,142200000,142200000,3751,1250,2501,1250,0,1,1252,389109
168,1250,2000,4700,9400000,2,10006,2503,1,142200000,142200000,3751,1250,2501,1250,0,1,1252,382760
168,1250,2000,4700,9400000,2,10006,2503,1,142200000,142200000,3751,1250,2501,1250,0,1,1252,388119
168,1250,2000,4700,9400000,2,10006,2503,1,142200000,142200000,3751,1250,2501,1250,0,1,1252,387711
168,1250,2000,4700,9400000,2,10006,2503,1,142200000,142200000,3751,1250,2501,1250,0,1,1252,387227
168,1250,2000,4700,9400000,2,10006,2503,1,142200000,142200000,3751,1250,2501,1250,0,1,1252,386740
168,1650,2000,4700,9400000,2,13206,3303,1,163640000,163640000,4951,1650,3301,1650,0,1,1652,4168618
168,1650,2000,4700,9400000,2,13206,3303,1,163640000,163640000,4951,1650,3301,1650,0,1,1652,462046
168,1650,2000,4700,9400000,2,13206,3303,1,163640000,163640000,4951,1650,3301,1650,0,1,1652,467482
168,1650,2000,4700,9400000,2,13206,3303,1,163640000,163640000,4951,1650,3301,1650,0,1,1652,434973
168,1650,2000,4700,9400000,2,13206,3303,1,163640000,163640000,4951,1650,3301,1650,0,1,1652,467915
168,1650,2000,4700,9400000,2,13206,3303,1,163640000,163640000,4951,1650,3301,1650,0,1,1652,468297
168,1650,2000,4700,9400000,2,13206,3303,1,163640000,163640000,4951,1650,3301,1650,0,1,1652,468092
168,2050,2000,4700,9400000,2,16406,4103,1,185080000,185080000,6151,2050,4101,2050,0,1,2052,5294727
168,2050,2000,4700,9400000,2,16406,4103,1,185080000,185080000,6151,2050,4101,2050,0,1,2052,530595
168,2050,2000,4700,9400000,2,16406,4103,1,185080000,185080000,6151,2050,4101,2050,0,1,2052,533145
168,2050,2000,4700,9400000,2,16406,4103,1,185080000,185080000,6151,2050,4101,2050,0,1,2052,569131
168,2050,2000,4700,9400000,2,16406,4103,1,185080000,185080000,6151,2050,4101,2050,0,1,2052,571889
168,2050,2000,4700,9400000,2,16406,4103,1,185080000,185080000,6151,2050,4101,2050,0,1,2052,572246
168,2050,2000,4700,9400000,2,16406,4103,1,185080000,185080000,6151,2050,4101,2050,0,1,2052,573151
168,2450,2000,4700,9400000,2,19606,4903,1,206520000,206520000,7351,2450,4901,2450,0,1,2452,6381008
168,2450,2000,4700,9400000,2,19606,4903,1,206520000,206520000,7351,2450,4901,2450,0,1,2452,632952
168,2450,2000,4700,9400000,2,19606,4903,1,206520000,206520000,7351,2450,4901,2450,0,1,2452,627348
168,2450,2000,4700,9400000,2,19606,4903,1,206520000,206520000,7351,2450,4901,2450,0,1,2452,631257
168,2450,2000,4700,9400000,2,19606,4903,1,206520000,206520000,7351,2450,4901,2450,0,1,2452,632293
168,2450,2000,4700,9400000,2,19606,4903,1,206520000,206520000,7351,2450,4901,2450,0,1,2452,646009
168,2450,2000,4700,9400000,2,19606,4903,1,206520000,206520000,7351,2450,4901,2450,0,1,2452,646429
168,2850,2000,4700,9400000,2,22806,5703,1,227960000,227960000,8551,2850,5701,2850,0,1,2852,7330344
168,2850,2000,4700,9400000,2,22806,5703,1,227960000,227960000,8551,2850,5701,2850,0,1,2852,732065
168,2850,2000,4700,9400000,2,22806,5703,1,227960000,227960000,8551,2850,5701,2850,0,1,2852,724646
168,2850,2000,4700,9400000,2,22806,5703,1,227960000,227960000,8551,2850,5701,2850,0,1,2852,733157
168,2850,2000,4700,9400000,2,22806,5703,1,227960000,227960000,8551,2850,5701,2850,0,1,2852,731218
168,2850,2000,4700,9400000,2,22806,5703,1,227960000,227960000,8551,2850,5701,2850,0,1,2852,739680
168,2850,2000,4700,9400000,2,22806,5703,1,227960000,227960000,8551,2850,5701,2850,0,1,2852,739240
168,3250,2000,4700,9400000,2,26006,6503,1,249400000,249400000,9751,3250,6501,3250,0,1,3252,9407624
168,3250,2000,4700,9400000,2,26006,6503,1,249400000,249400000,9751,3250,6501,3250,0,1,3252,800105
168,3250,2000,4700,9400000,2,26006,6503,1,249400000,249400000,9751,3250,6501,3250,0,1,3252,822550
168,3250,2000,4700,9400000,2,26006,6503,1,249400000,249400000,9751,3250,6501,3250,0,1,3252,816109
168,3250,2000,4700,9400000,2,26006,6503,1,249400000,249400000,9751,3250,6501,3250,0,1,3252,814422
168,3250,2000,4700,9400000,2,26006,6503,1,249400000,249400000,9751,3250,6501,3250,0,1,3252,832772
168,3250,2000,4700,9400000,2,26006,6503,1,249400000,249400000,9751,3250,6501,3250,0,1,3252,832319
168,3650,2000,4700,9400000,2,29206,7303,1,270840000,270840000,10951,3650,7301,3650,0,1,3652,10080625
168,3650,2000,4700,9400000,2,29206,7303,1,270840000,270840000,10951,3650,7301,3650,0,1,3652,915822
168,3650,2000,4700,9400000,2,29206,7303,1,270840000,270840000,10951,3650,7301,3650,0,1,3652,898127
168,3650,2000,4700,9400000,2,29206,7303,1,270840000,270840000,10951,3650,7301,3650,0,1,3652,911167
168,3650,2000,4700,9400000,2,29206,7303,1,270840000,270840000,10951,3650,7301,3650,0,1,3652,908874
168,3650,2000,4700,9400000,2,29206,7303,1,270840000,270840000,10951,3650,7301,3650,0,1,3652,928866
168,3650,2000,4700,9400000,2,29206,7303,1,270840000,270840000,10951,3650,7301,3650,0,1,3652,929335
168,4050,2000,4700,9400000,2,32406,8103,1,292280000,292280000,12151,4050,8101,4050,0,1,4052,11346920
168,4050,2000,4700,9400000,2,32406,8103,1,292280000,292280000,12151,4050,8101,4050,0,1,4052,962560
168,4050,2000,4700,9400000,2,32406,8103,1,292280000,292280000,12151,4050,8101,4050,0,1,4052,961447
168,4050,2000,4700,9400000,2,32406,8103,1,292280000,292280000,12151,4050,8101,4050,0,1,4052,1002575
168,4050,2000,4700,9400000,2,32406,8103,1,292280000,292280000,12151,4050,8101,4050,0,1,4052,980292
168,4050,2000,4700,9400000,2,32406,8103,1,292280000,292280000,12151,4050,8101,4050,0,1,4052,1022725
168,4050,2000,4700,9400000,2,32406,8103,1,292280000,292280000,12151,4050,8101,4050,0,1,4052,1025152
168,4450,2000,4700,9400000,2,35606,8903,1,313720000,313720000,13351,4450,8901,4450,0,1,4452,11942913
168,4450,2000,4700,9400000,2,35606,8903,1,313720000,313720000,13351,4450,8901,4450,0,1,4452,1088304
168,4450,2000,4700,9400000,2,35606,8903,1,313720000,313720000,13351,4450,8901,4450,0,1,4452,1084487
168,4450,2000,4700,9400000,2,35606,8903,1,313720000,313720000,13351,4450,8901,4450,0,1,4452,1089613
168,4450,2000,4700,9400000,2,35606,8903,1,313720000,313720000,13351,4450,8901,4450,0,1,4452,1087273
168,4450,2000,4700,9400000,2,35606,8903,1,313720000,313720000,13351,4450,8901,4450,0,1,4452,1094377
168,4450,2000,4700,9400000,2,35606,8903,1,313720000,313720000,13351,4450,8901,4450,0,1,4452,1094884
168,4850,2000,4700,9400000,2,38806,9703,1,335160000,335160000,14551,4850,9701,4850,0,1,4852,12775201
168,4850,2000,4700,9400000,2,38806,9703,1,335160000,335160000,14551,4850,9701,4850,0,1,4852,1099640
168,4850,2000,4700,9400000,2,38806,9703,1,335160000,335160000,14551,4850,9701,4850,0,1,4852,1183093
168,4850,2000,4700,9400000,2,38806,9703,1,335160000,335160000,14551,4850,9701,4850,0,1,4852,1162122
168,4850,2000,4700,9400000,2,38806,9703,1,335160000,335160000,14551,4850,9701,4850,0,1,4852,1168960
168,4850,2000,4700,9400000,2,38806,9703,1,335160000,335160000,14551,4850,9701,4850,0,1,4852,1184196
168,4850,2000,4700,9400000,2,38806,9703,1,335160000,335160000,14551,4850,9701,4850,0,1,4852,1184727
168,5250,2000,4700,9400000,2,42006,10503,1,356600000,356600000,15751,5250,10501,5250,0,1,5252,14956634
168,5250,2000,4700,9400000,2,42006,10503,1,356600000,356600000,15751,5250,10501,5250,0,1,5252,1289280
168,5250,2000,4700,9400000,2,42006,10503,1,356600000,356600000,15751,5250,10501,5250,0,1,5252,1205558
168,5250,2000,4700,9400000,2,42006,10503,1,356600000,356600000,15751,5250,10501,5250,0,1,5252,1281494
168,5250,2000,4700,9400000,2,42006,10503,1,356600000,356600000,15751,5250,10501,5250,0,1,5252,1270545
168,5250,2000,4700,9400000,2,42006,10503,1,356600000,356600000,15751,5250,10501,5250,0,1,5252,1295212
168,5250,2000,4700,9400000,2,42006,10503,1,356600000,356600000,15751,5250,10501,5250,0,1,5252,1292955
168,5650,2000,4700,9400000,2,45206,11303,1,378040000,378040000,16951,5650,11301,5650,0,1,5652,16574232
168,5650,2000,4700,9400000,2,45206,11303,1,378040000,378040000,16951,5650,11301,5650,0,1,5652,1356099
168,5650,2000,4700,9400000,2,45206,11303,1,378040000,378040000,16951,5650,11301,5650,0,1,5652,1356758
168,5650,2000,4700,9400000,2,45206,11303,1,378040000,378040000,16951,5650,11301,5650,0,1,5652,1358512
168,5650,2000,4700,9400000,2,45206,11303,1,378040000,378040000,16951,5650,11301,5650,0,1,5652,1357963
168,5650,2000,4700,9400000,2,45206,11303,1,378040000,378040000,16951,5650,11301,5650,0,1,5652,1360736
168,5650,2000,4700,9400000,2,45206,11303,1,378040000,378040000,16951,5650,11301,5650,0,1,5652,1361300
168,6050,2000,4700,9400000,2,48406,12103,1,399480000,399480000,18151,6050,12101,6050,0,1,6052,16234059
168,6050,2000,4700,9400000,2,48406,12103,1,399480000,399480000,18151,6050,12101,6050,0,1,6052,1468357
168,6050,2000,4700,9400000,2,48406,12103,1,399480000,399480000,18151,6050,12101,6050,0,1,6052,1467560
168,6050,2000,4700,9400000,2,48406,12103,1,399480000,399480000,18151,6050,12101,6050,0,1,6052,1456263
168,6050,2000,4700,9400000,2,48406,12103,1,399480000,399480000,18151,6050,12101,6050,0,1,6052,1449822
168,6050,2000,4700,9400000,2,48406,12103,1,399480000,399480000,18151,6050,12101,6050,0,1,6052,1460769
168,6050,2000,4700,9400000,2,48406,12103,1,399480000,399480000,18151,6050,12101,6050,0,1,6052,1459759
168,6450,2000,4700,9400000,2,51606,12903,1,420920000,420920000,19351,6450,12901,6450,0,1,6452,16978623
168,6450,2000,4700,9400000,2,51606,12903,1,420920000,420920000,19351,6450,12901,6450,0,1,6452,1530055
168,6450,2000,4700,9400000,2,51606,12903,1,420920000,420920000,19351,6450,12901,6450,0,1,6452,1519353
168,6450,2000,4700,9400000,2,51606,12903,1,420920000,420920000,19351,6450,12901,6450,0,1,6452,1562119
168,6450,2000,4700,9400000,2,51606,12903,1,420920000,420920000,19351,6450,12901,6450,0,1,6452,1558606
168,6450,2000,4700,9400000,2,51606,12903,1,420920000,420920000,19351,6450,12901,6450,0,1,6452,1562716
168,6450,2000,4700,9400000,2,51606,12903,1,420920000,420920000,19351,6450,12901,6450,0,1,6452,1561224
168,6850,2000,4700,9400000,2,54806,13703,1,442360000,442360000,20551,6850,13701,6850,0,1,6852,18820325
168,6850,2000,4700,9400000,2,54806,13703,1,442360000,442360000,20551,6850,13701,6850,0,1,6852,1628567
168,6850,2000,4700,9400000,2,54806,13703,1,442360000,442360000,20551,6850,13701,6850,0,1,6852,1633753
168,6850,2000,4700,9400000,2,54806,13703,1,442360000,442360000,20551,6850,13701,6850,0,1,6852,1631259
168,6850,2000,4700,9400000,2,54806,13703,1,442360000,442360000,20551,6850,13701,6850,0,1,6852,1627779
168,6850,2000,4700,9400000,2,54806,13703,1,442360000,442360000,20551,6850,13701,6850,0,1,6852,1621647
168,6850,2000,4700,9400000,2,54806,13703,1,442360000,442360000,20551,6850,13701,6850,0,1,6852,1618956
168,50,2000,4300,8600000,2,406,103,1,71320000,71320000,151,50,101,50,0,1,52,91385
168,50,2000,4300,8600000,2,406,103,1,71320000,71320000,151,50,101,50,0,1,52,91730
168,50,2000,4300,8600000,2,406,103,1,71320000,71320000,151,50,101,50,0,1,52,77881
168,50,2000,4300,8600000,2,406,103,1,71320000,71320000,151,50,101,50,0,1,52,91310
168,50,2000,4300,8600000,2,406,103,1,71320000,71320000,151,50,101,50,0,1,52,90061
168,50,2000,4300,8600000,2,406,103,1,71320000,71320000,151,50,101,50,0,1,52,108470
168,50,2000,4300,8600000,2,406,103,1,71320000,71320000,151,50,101,50,0,1,52,110474
168,450,2000,4300,8600000,2,3606,903,1,91480000,91480000,1351,450,901,450,0,1,452,852523
168,450,2000,4300,8600000,2,3606,903,1,91480000,91480000,1351,450,901,450,0,1,452,176183
168,450,2000,4300,8600000,2,3606,903,1,91480000,91480000,1351,450,901,450,0,1,452,175729
168,450,2000,4300,8600000,2,3606,903,1,91480000,91480000,1351,450,901,450,0,1,452,174574
168,450,2000,4300,8600000,2,3606,903,1,91480000,91480000,1351,450,901,450,0,1,452,176393
168,450,2000,4300,8600000,2,3606,903,1,91480000,91480000,1351,450,901,450,0,1,452,193081
168,450,2000,4300,8600000,2,3606,903,1,91480000,91480000,1351,450,901,450,0,1,452,193537
168,850,2000,4300,8600000,2,6806,1703,1,111640000,111640000,2551,850,1701,850,0,1,852,1784798
168,850,2000,4300,8600000,2,6806,1703,1,111640000,111640000,2551,850,1701,850,0,1,852,240781
168,850,2000,4300,8600000,2,6806,1703,1,111640000,111640000,2551,850,1701,850,0,1,852,254923
168,850,2000,4300,8600000,2,6806,1703,1,111640000,111640000,2551,850,1701,850,0,1,852,260822
168,850,2000,4300,8600000,2,6806,1703,1,111640000,111640000,2551,850,1701,850,0,1,852,260326
168,850,2000,4300,8600000,2,6806,1703,1,111640000,111640000,2551,850,1701,850,0,1,852,261237
168,850,2000,4300,8600000,2,6806,1703,1,111640000,111640000,2551,850,1701,850,0,1,852,261592
168,1250,2000,4300,8600000,2,10006,2503,1,131800000,131800000,3751,1250,2501,1250,0,1,1252,2751245
168,1250,2000,4300,8600000,2,10006,2503,1,131800000,131800000,3751,1250,2501,1250,0,1,1252,354259
168,1250,2000,4300,8600000,2,10006,2503,1,131800000,131800000,3751,1250,2501,1250,0,1,1252,352026
168,1250,2000,4300,8600000,2,10006,2503,1,131800000,131800000,3751,1250,2501,1250,0,1,1252,351567
168,1250,2000,4300,8600000,2,10006,2503,1,131800000,131800000,3751,1250,2501,1250,0,1,1252,352811
168,1250,2000,4300,8600000,2,10006,2503,1,131800000,131800000,3751,1250,2501,1250,0,1,1252,353664
168,1250,2000,4300,8600000,2,10006,2503,1,131800000,131800000,3751,1250,2501,1250,0,1,1252,353141
168,1650,2000,4300,8600000,2,13206,3303,1,151960000,151960000,4951,1650,3301,1650,0,1,1652,3681238
168,1650,2000,4300,8600000,2,13206,3303,1,151960000,151960000,4951,1650,3301,1650,0,1,1652,441844
168,1650,2000,4300,8600000,2,13206,3303,1,151960000,151960000,4951,1650,3301,1650,0,1,1652,437765
168,1650,2000,4300,8600000,2,13206,3303,1,151960000,151960000,4951,1650,3301,1650,0,1,1652,443097
168,1650,2000,4300,8600000,2,13206,3303,1,151960000,151960000,4951,1650,3301,1650,0,1,1652,441293
168,1650,2000,4300,8600000,2,13206,3303,1,151960000,151960000,4951,1650,3301,1650,0,1,1652,439679
168,1650,2000,4300,8600000,2,13206,3303,1,151960000,151960000,4951,1650,3301,1650,0,1,1652,440970
168,2050,2000,4300,8600000,2,16406,4103,1,172120000,172120000,6151,2050,4101,2050,0,1,2052,4808053
168,2050,2000,4300,8600000,2,16406,4103,1,172120000,172120000,6151,2050,4101,2050,0,1,2052,515676
168,2050,2000,4300,8600000,2,16406,4103,1,172120000,172120000,6151,2050,4101,2050,0,1,2052,507061
168,2050,2000,4300,8600000,2,16406,4103,1,172120000,172120000,6151,2050,4101,2050,0,1,2052,518437
168,2050,2000,4300,8600000,2,16406,4103,1,172120000,172120000,6151,2050,4101,2050,0,1,2052,521625
168,2050,2000,4300,8600000,2,16406,4103,1,172120000,172120000,6151,2050,4101,2050,0,1,2052,528209
168,2050,2000,4300,8600000,2,16406,4103,1,172120000,172120000,6151,2050,4101,2050,0,1,2052,527703
168,2450,2000,4300,8600000,2,19606,4903,1,192280000,192280000,7351,2450,4901,2450,0,1,2452,5756944
168,2450,2000,4300,8600000,2,19606,4903,1,192280000,192280000,7351,2450,4901,2450,0,1,2452,587711
168,2450,2000,4300,8600000,2,19606,4903,1,192280000,192280000,7351,2450,4901,2450,0,1,2452,584303
168,2450,2000,4300,8600000,2,19606,4903,1,192280000,192280000,7351,2450,4901,2450,0,1,2452,589944
168,2450,2000,4300,8600000,2,19606,4903,1,192280000,192280000,7351,2450,4901,2450,0,1,2452,588904
168,2450,2000,4300,8600000,2,19606,4903,1,192280000,192280000,7351,2450,4901,2450,0,1,2452,595703
168,2450,2000,4300,8600000,2,19606,4903,1,192280000,192280000,7351,2450,4901,2450,0,1,2452,595277
168,2850,2000,4300,8600000,2,22806,5703,1,212440000,212440000,8551,2850,5701,2850,0,1,2852,6605208
168,2850,2000,4300,8600000,2,22806,5703,1,212440000,212440000,8551,2850,5701,2850,0,1,2852,694151
168,2850,2000,4300,8600000,2,22806,5703,1,212440000,212440000,8551,2850,5701,2850,0,1,2852,693652
168,2850,2000,4300,8600000,2,22806,5703,1,212440000,212440000,8551,2850,5701,2850,0,1,2852,694501
168,2850,2000,4300,8600000,2,22806,5703,1,212440000,212440000,8551,2850,5701,2850,0,1,2852,692299
168,2850,2000,4300,8600000,2,22806,5703,1,212440000,212440000,8551,2850,5701,2850,0,1,2852,683760
168,2850,2000,4300,8600000,2,22806,5703,1,212440000,212440000,8551,2850,5701,2850,0,1,2852,684888
168,3250,2000,4300,8600000,2,26006,6503,1,232600000,232600000,9751,3250,6501,3250,0,1,3252,7775273
168,3250,2000,4300,8600000,2,26006,6503,1,232600000,232600000,9751,3250,6501,3250,0,1,3252,766827
168,3250,2000,4300,8600000,2,26006,6503,1,232600000,232600000,9751,3250,6501,3250,0,1,3252,774902
168,3250,2000,4300,8600000,2,26006,6503,1,232600000,232600000,9751,3250,6501,3250,0,1,3252,768857
168,3250,2000,4300,8600000,2,26006,6503,1,232600000,232600000,9751,3250,6501,3250,0,1,3252,763160
168,3250,2000,4300,8600000,2,26006,6503,1,232600000,232600000,9751,3250,6501,3250,0,1,3252,772161
168,3250,2000,4300,8600000,2,26006,6503,1,232600000,232600000,9751,3250,6501,3250,0,1,3252,773298
168,3650,2000,4300,8600000,2,29206,7303,1,252760000,252760000,10951,3650,7301,3650,0,1,3652,9007799
168,3650,2000,4300,8600000,2,29206,7303,1,252760000,252760000,10951,3650,7301,3650,0,1,3652,830869
168,3650,2000,4300,8600000,2,29206,7303,1,252760000,252760000,10951,3650,7301,3650,0,1,3652,826963
168,3650,2000,4300,8600000,2,29206,7303,1,252760000,252760000,10951,3650,7301,3650,0,1,3652,833427
168,3650,2000,4300,8600000,2,29206,7303,1,252760000,252760000,10951,3650,7301,3650,0,1,3652,832248
168,3650,2000,4300,8600000,2,29206,7303,1,252760000,252760000,10951,3650,7301,3650,0,1,3652,850544
168,3650,2000,4300,8600000,2,29206,7303,1,252760000,252760000,10951,3650,7301,3650,0,1,3652,851014
168,4050,2000,4300,8600000,2,32406,8103,1,272920000,272920000,12151,4050,8101,4050,0,1,4052,9795837
168,4050,2000,4300,8600000,2,32406,8103,1,272920000,272920000,12151,4050,8101,4050,0,1,4052,924815
168,4050,2000,4300,8600000,2,32406,8103,1,272920000,272920000,12151,4050,8101,4050,0,1,4052,894726
168,4050,2000,4300,8600000,2,32406,8103,1,272920000,272920000,12151,4050,8101,4050,0,1,4052,920498
168,4050,2000,4300,8600000,2,32406,8103,1,272920000,272920000,12151,4050,8101,4050,0,1,4052,897848
168,4050,2000,4300,8600000,2,32406,8103,1,272920000,272920000,12151,4050,8101,4050,0,1,4052,936383
168,4050,2000,4300,8600000,2,32406,8103,1,272920000,272920000,12151,4050,8101,4050,0,1,4052,935860
168,4450,2000,4300,8600000,2,35606,8903,1,293080000,293080000,13351,4450,8901,4450,0,1,4452,11584425
168,4450,2000,4300,8600000,2,35606,8903,1,293080000,293080000,13351,4450,8901,4450,0,1,4452,963376
168,4450,2000,4300,8600000,2,35606,8903,1,293080000,293080000,13351,4450,8901,4450,0,1,4452,964079
168,4450,2000,4300,8600000,2,35606,8903,1,293080000,293080000,13351,4450,8901,4450,0,1,4452,944786
168,4450,2000,4300,8600000,2,35606,8903,1,293080000,293080000,13351,4450,8901,4450,0,1,4452,977193
168,4450,2000,4300,8600000,2,35606,8903,1,293080000,293080000,13351,4450,8901,4450,0,1,4452,1020055
168,4450,2000,4300,8600000,2,35606,8903,1,293080000,293080000,13351,4450,8901,4450,0,1,4452,1015792
168,4850,2000,4300,8600000,2,38806,9703,1,313240000,313240000,14551,4850,9701,4850,0,1,4852,11935216
168,4850,2000,4300,8600000,2,38806,9703,1,313240000,313240000,14551,4850,9701,4850,0,1,4852,1072087
168,4850,2000,4300,8600000,2,38806,9703,1,313240000,313240000,14551,4850,9701,4850,0,1,4852,1075790
168,4850,2000,4300,8600000,2,38806,9703,1,313240000,313240000,14551,4850,9701,4850,0,1,4852,1067026
168,4850,2000,4300,8600000,2,38806,9703,1,313240000,313240000,14551,4850,9701,4850,0,1,4852,1018887
168,4850,2000,4300,8600000,2,38806,9703,1,313240000,313240000,14551,4850,9701,4850,0,1,4852,1086744
168,4850,2000,4300,8600000,2,38806,9703,1,313240000,313240000,14551,4850,9701,4850,0,1,4852,1086202
168,5250,2000,4300,8600000,2,42006,10503,1,333400000,333400000,15751,5250,10501,5250,0,1,5252,13662573
168,5250,2000,4300,8600000,2,42006,10503,1,333400000,333400000,15751,5250,10501,5250,0,1,5252,1180516
168,5250,2000,4300,8600000,2,42006,10503,1,333400000,333400000,15751,5250,10501,5250,0,1,5252,1163733
168,5250,2000,4300,8600000,2,42006,10503,1,333400000,333400000,15751,5250,10501,5250,0,1,5252,1177176
168,5250,2000,4300,8600000,2,42006,10503,1,333400000,333400000,15751,5250,10501,5250,0,1,5252,1175722
168,5250,2000,4300,8600000,2,42006,10503,1,333400000,333400000,15751,5250,10501,5250,0,1,5252,1181615
168,5250,2000,4300,8600000,2,42006,10503,1,333400000,333400000,15751,5250,10501,5250,0,1,5252,1181066
168,5650,2000,4300,8600000,2,45206,11303,1,353560000,353560000,16951,5650,11301,5650,0,1,5652,14013483
168,5650,2000,4300,8600000,2,45206,11303,1,353560000,353560000,16951,5650,11301,5650,0,1,5652,1242384
168,5650,2000,4300,8600000,2,45206,11303,1,353560000,353560000,16951,5650,11301,5650,0,1,5652,1238874
168,5650,2000,4300,8600000,2,45206,11303,1,353560000,353560000,16951,5650,11301,5650,0,1,5652,1272805
168,5650,2000,4300,8600000,2,45206,11303,1,353560000,353560000,16951,5650,11301,5650,0,1,5652,1267608
168,5650,2000,4300,8600000,2,45206,11303,1,353560000,353560000,16951,5650,11301,5650,0,1,5652,1280686
168,5650,2000,4300,8600000,2,45206,11303,1,353560000,353560000,16951,5650,11301,5650,0,1,5652,1279108
168,6050,2000,4300,8600000,2,48406,12103,1,373720000,373720000,18151,6050,12101,6050,0,1,6052,15982917
168,6050,2000,4300,8600000,2,48406,12103,1,373720000,373720000,18151,6050,12101,6050,0,1,6052,1346082
168,6050,2000,4300,8600000,2,48406,12103,1,373720000,373720000,18151,6050,12101,6050,0,1,6052,1353108
168,6050,2000,4300,8600000,2,48406,12103,1,373720000,373720000,18151,6050,12101,6050,0,1,6052,1347592
168,6050,2000,4300,8600000,2,48406,12103,1,373720000,373720000,18151,6050,12101,6050,0,1,6052,1330225
168,6050,2000,4300,8600000,2,48406,12103,1,373720000,373720000,18151,6050,12101,6050,0,1,6052,1352545
168,6050,2000,4300,8600000,2,48406,12103,1,373720000,373720000,18151,6050,12101,6050,0,1,6052,1351941
168,6450,2000,4300,8600000,2,51606,12903,1,393880000,393880000,19351,6450,12901,6450,0,1,6452,16649330
168,6450,2000,4300,8600000,2,51606,12903,1,393880000,393880000,19351,6450,12901,6450,0,1,6452,1425397
168,6450,2000,4300,8600000,2,51606,12903,1,393880000,393880000,19351,6450,12901,6450,0,1,6452,1399915
168,6450,2000,4300,8600000,2,51606,12903,1,393880000,393880000,19351,6450,12901,6450,0,1,6452,1423087
168,6450,2000,4300,8600000,2,51606,12903,1,393880000,393880000,19351,6450,12901,6450,0,1,6452,1403799
168,6450,2000,4300,8600000,2,51606,12903,1,393880000,393880000,19351,6450,12901,6450,0,1,6452,1417298
168,6450,2000,4300,8600000,2,51606,12903,1,393880000,393880000,19351,6450,12901,6450,0,1,6452,1416248
168,6850,2000,4300,8600000,2,54806,13703,1,414040000,414040000,20551,6850,13701,6850,0,1,6852,16861950
168,6850,2000,4300,8600000,2,54806,13703,1,414040000,414040000,20551,6850,13701,6850,0,1,6852,1498164
168,6850,2000,4300,8600000,2,54806,13703,1,414040000,414040000,20551,6850,13701,6850,0,1,6852,1476974
168,6850,2000,4300,8600000,2,54806,13703,1,414040000,414040000,20551,6850,13701,6850,0,1,6852,1508142
168,6850,2000,4300,8600000,2,54806,13703,1,414040000,414040000,20551,6850,13701,6850,0,1,6852,1510274
168,6850,2000,4300,8600000,2,54806,13703,1,414040000,414040000,20551,6850,13701,6850,0,1,6852,1518028
168,6850,2000,4300,8600000,2,54806,13703,1,414040000,414040000,20551,6850,13701,6850,0,1,6852,1521482
168,50,2000,3900,7800000,2,406,103,1,64760000,64760000,151,50,101,50,0,1,52,81808
168,50,2000,3900,7800000,2,406,103,1,64760000,64760000,151,50,101,50,0,1,52,79557
168,50,2000,3900,7800000,2,406,103,1,64760000,64760000,151,50,101,50,0,1,52,82825
168,50,2000,3900,7800000,2,406,103,1,64760000,64760000,151,50,101,50,0,1,52,69387
168,50,2000,3900,7800000,2,406,103,1,64760000,64760000,151,50,101,50,0,1,52,82405
168,50,2000,3900,7800000,2,406,103,1,64760000,64760000,151,50,101,50,0,1,52,99007
168,50,2000,3900,7800000,2,406,103,1,64760000,64760000,151,50,101,50,0,1,52,100034
168,450,2000,3900,7800000,2,3606,903,1,83640000,83640000,1351,450,901,450,0,1,452,785031
168,450,2000,3900,7800000,2,3606,903,1,83640000,83640000,1351,450,901,450,0,1,452,160365
168,450,2000,3900,7800000,2,3606,903,1,83640000,83640000,1351,450,901,450,0,1,452,158544
168,450,2000,3900,7800000,2,3606,903,1,83640000,83640000,1351,450,901,450,0,1,452,160815
168,450,2000,3900,7800000,2,3606,903,1,83640000,83640000,1351,450,901,450,0,1,452,159809
168,450,2000,3900,7800000,2,3606,903,1,83640000,83640000,1351,450,901,450,0,1,452,178553
168,450,2000,3900,7800000,2,3606,903,1,83640000,83640000,1351,450,901,450,0,1,452,177429
168,850,2000,3900,7800000,2,6806,1703,1,102520000,102520000,2551,850,1701,850,0,1,852,1645987
168,850,2000,3900,7800000,2,6806,1703,1,102520000,102520000,2551,850,1701,850,0,1,852,243063
168,850,2000,3900,7800000,2,6806,1703,1,102520000,102520000,2551,850,1701,850,0,1,852,243423
168,850,2000,3900,7800000,2,6806,1703,1,102520000,102520000,2551,850,1701,850,0,1,852,243631
168,850,2000,3900,7800000,2,6806,1703,1,102520000,102520000,2551,850,1701,850,0,1,852,241132
168,850,2000,3900,7800000,2,6806,1703,1,102520000,102520000,2551,850,1701,850,0,1,852,243787
168,850,2000,3900,7800000,2,6806,1703,1,102520000,102520000,2551,850,1701,850,0,1,852,243956
168,1250,2000,3900,7800000,2,10006,2503,1,121400000,121400000,3751,1250,2501,1250,0,1,1252,2550607
168,1250,2000,3900,7800000,2,10006,2503,1,121400000,121400000,3751,1250,2501,1250,0,1,1252,315425
168,1250,2000,3900,7800000,2,10006,2503,1,121400000,121400000,3751,1250,2501,1250,0,1,1252,324846
168,1250,2000,3900,7800000,2,10006,2503,1,121400000,121400000,3751,1250,2501,1250,0,1,1252,322775
168,1250,2000,3900,7800000,2,10006,2503,1,121400000,121400000,3751,1250,2501,1250,0,1,1252,322382
168,1250,2000,3900,7800000,2,10006,2503,1,121400000,121400000,3751,1250,2501,1250,0,1,1252,322939
168,1250,2000,3900,7800000,2,10006,2503,1,121400000,121400000,3751,1250,2501,1250,0,1,1252,323549
168,1650,2000,3900,7800000,2,13206,3303,1,140280000,140280000,4951,1650,3301,1650,0,1,1652,3366507
168,1650,2000,3900,7800000,2,13206,3303,1,140280000,140280000,4951,1650,3301,1650,0,1,1652,400937
168,1650,2000,3900,7800000,2,13206,3303,1,140280000,140280000,4951,1650,3301,1650,0,1,1652,403133
168,1650,2000,3900,7800000,2,13206,3303,1,140280000,140280000,4951,1650,3301,1650,0,1,1652,402866
168,1650,2000,3900,7800000,2,13206,3303,1,140280000,140280000,4951,1650,3301,1650,0,1,1652,402437
168,1650,2000,3900,7800000,2,13206,3303,1,140280000,140280000,4951,1650,3301,1650,0,1,1652,400289
168,1650,2000,3900,7800000,2,13206,3303,1,140280000,140280000,4951,1650,3301,1650,0,1,1652,399933
168,2050,2000,3900,7800000,2,16406,4103,1,159160000,159160000,6151,2050,4101,2050,0,1,2052,4379081
168,2050,2000,3900,7800000,2,16406,4103,1,159160000,159160000,6151,2050,4101,2050,0,1,2052,469879
168,2050,2000,3900,7800000,2,16406,4103,1,159160000,159160000,6151,2050,4101,2050,0,1,2052,465133
168,2050,2000,3900,7800000,2,16406,4103,1,159160000,159160000,6151,2050,4101,2050,0,1,2052,470378
168,2050,2000,3900,7800000,2,16406,4103,1,159160000,159160000,6151,2050,4101,2050,0,1,2052,439365
168,2050,2000,3900,7800000,2,16406,4103,1,159160000,159160000,6151,2050,4101,2050,0,1,2052,468796
168,2050,2000,3900,7800000,2,16406,4103,1,159160000,159160000,6151,2050,4101,2050,0,1,2052,468004
168,2450,2000,3900,7800000,2,19606,4903,1,178040000,178040000,7351,2450,4901,2450,0,1,2452,5127344
168,2450,2000,3900,7800000,2,19606,4903,1,178040000,178040000,7351,2450,4901,2450,0,1,2452,555898
168,2450,2000,3900,7800000,2,19606,4903,1,178040000,178040000,7351,2450,4901,2450,0,1,2452,554182
168,2450,2000,3900,7800000,2,19606,4903,1,178040000,178040000,7351,2450,4901,2450,0,1,2452,554684
168,2450,2000,3900,7800000,2,19606,4903,1,178040000,178040000,7351,2450,4901,2450,0,1,2452,553651
168,2450,2000,3900,7800000,2,19606,4903,1,178040000,178040000,7351,2450,4901,2450,0,1,2452,550475
168,2450,2000,3900,7800000,2,19606,4903,1,178040000,178040000,7351,2450,4901,2450,0,1,2452,552687
168,2850,2000,3900,7800000,2,22806,5703,1,196920000,196920000,8551,2850,5701,2850,0,1,2852,6120175
168,2850,2000,3900,7800000,2,22806,5703,1,196920000,196920000,8551,2850,5701,2850,0,1,2852,594145
168,2850,2000,3900,7800000,2,22806,5703,1,196920000,196920000,8551,2850,5701,2850,0,1,2852,587518
168,2850,2000,3900,7800000,2,22806,5703,1,196920000,196920000,8551,2850,5701,2850,0,1,2852,623225
168,2850,2000,3900,7800000,2,22806,5703,1,196920000,196920000,8551,2850,5701,2850,0,1,2852,593306
168,2850,2000,3900,7800000,2,22806,5703,1,196920000,196920000,8551,2850,5701,2850,0,1,2852,633488
168,2850,2000,3900,7800000,2,22806,5703,1,196920000,196920000,8551,2850,5701,2850,0,1,2852,633049
168,3250,2000,3900,7800000,2,26006,6503,1,215800000,215800000,9751,3250,6501,3250,0,1,3252,6872228
168,3250,2000,3900,7800000,2,26006,6503,1,215800000,215800000,9751,3250,6501,3250,0,1,3252,692589
168,3250,2000,3900,7800000,2,26006,6503,1,215800000,215800000,9751,3250,6501,3250,0,1,3252,704525
168,3250,2000,3900,7800000,2,26006,6503,1,215800000,215800000,9751,3250,6501,3250,0,1,3252,702417
168,3250,2000,3900,7800000,2,26006,6503,1,215800000,215800000,9751,3250,6501,3250,0,1,3252,708701
168,3250,2000,3900,7800000,2,26006,6503,1,215800000,215800000,9751,3250,6501,3250,0,1,3252,713049
168,3250,2000,3900,7800000,2,26006,6503,1,215800000,215800000,9751,3250,6501,3250,0,1,3252,711836
168,3650,2000,3900,7800000,2,29206,7303,1,234680000,234680000,10951,3650,7301,3650,0,1,3652,7891896
168,3650,2000,3900,7800000,2,29206,7303,1,234680000,234680000,10951,3650,7301,3650,0,1,3652,760556
168,3650,2000,3900,7800000,2,29206,7303,1,234680000,234680000,10951,3650,7301,3650,0,1,3652,755216
168,3650,2000,3900,7800000,2,29206,7303,1,234680000,234680000,10951,3650,7301,3650,0,1,3652,761760
168,3650,2000,3900,7800000,2,29206,7303,1,234680000,234680000,10951,3650,7301,3650,0,1,3652,756422
168,3650,2000,3900,7800000,2,29206,7303,1,234680000,234680000,10951,3650,7301,3650,0,1,3652,773669
168,3650,2000,3900,7800000,2,29206,7303,1,234680000,234680000,10951,3650,7301,3650,0,1,3652,774139
168,4050,2000,3900,7800000,2,32406,8103,1,253560000,253560000,12151,4050,8101,4050,0,1,4052,8927718
168,4050,2000,3900,7800000,2,32406,8103,1,253560000,253560000,12151,4050,8101,4050,0,1,4052,835194
168,4050,2000,3900,7800000,2,32406,8103,1,253560000,253560000,12151,4050,8101,4050,0,1,4052,843348
168,4050,2000,3900,7800000,2,32406,8103,1,253560000,253560000,12151,4050,8101,4050,0,1,4052,841965
168,4050,2000,3900,7800000,2,32406,8103,1,253560000,253560000,12151,4050,8101,4050,0,1,4052,832945
168,4050,2000,3900,7800000,2,32406,8103,1,253560000,253560000,12151,4050,8101,4050,0,1,4052,858069
168,4050,2000,3900,7800000,2,32406,8103,1,253560000,253560000,12151,4050,8101,4050,0,1,4052,858556
168,4450,2000,3900,7800000,2,35606,8903,1,272440000,272440000,13351,4450,8901,4450,0,1,4452,9771380
168,4450,2000,3900,7800000,2,35606,8903,1,272440000,272440000,13351,4450,8901,4450,0,1,4452,856671
168,4450,2000,3900,7800000,2,35606,8903,1,272440000,272440000,13351,4450,8901,4450,0,1,4452,889161
168,4450,2000,3900,7800000,2,35606,8903,1,272440000,272440000,13351,4450,8901,4450,0,1,4452,886190
168,4450,2000,3900,7800000,2,35606,8903,1,272440000,272440000,13351,4450,8901,4450,0,1,4452,890486
168,4450,2000,3900,7800000,2,35606,8903,1,272440000,272440000,13351,4450,8901,4450,0,1,4452,912973
168,4450,2000,3900,7800000,2,35606,8903,1,272440000,272440000,13351,4450,8901,4450,0,1,4452,912467
168,4850,2000,3900,7800000,2,38806,9703,1,291320000,291320000,14551,4850,9701,4850,0,1,4852,11351640
168,4850,2000,3900,7800000,2,38806,9703,1,291320000,291320000,14551,4850,9701,4850,0,1,4852,1000773
168,4850,2000,3900,7800000,2,38806,9703,1,291320000,291320000,14551,4850,9701,4850,0,1,4852,954626
168,4850,2000,3900,7800000,2,38806,9703,1,291320000,291320000,14551,4850,9701,4850,0,1,4852,1013622
168,4850,2000,3900,7800000,2,38806,9703,1,291320000,291320000,14551,4850,9701,4850,0,1,4852,988174
168,4850,2000,3900,7800000,2,38806,9703,1,291320000,291320000,14551,4850,9701,4850,0,1,4852,1028242
168,4850,2000,3900,7800000,2,38806,9703,1,291320000,291320000,14551,4850,9701,4850,0,1,4852,1026829
168,5250,2000,3900,7800000,2,42006,10503,1,310200000,310200000,15751,5250,10501,5250,0,1,5252,12090650
168,5250,2000,3900,7800000,2,42006,10503,1,310200000,310200000,15751,5250,10501,5250,0,1,5252,1061813
168,5250,2000,3900,7800000,2,42006,10503,1,310200000,310200000,15751,5250,10501,5250,0,1,5252,1053242
168,5250,2000,3900,7800000,2,42006,10503,1,310200000,310200000,15751,5250,10501,5250,0,1,5252,1066244
168,5250,2000,3900,7800000,2,42006,10503,1,310200000,310200000,15751,5250,10501,5250,0,1,5252,1024657
168,5250,2000,3900,7800000,2,42006,10503,1,310200000,310200000,15751,5250,10501,5250,0,1,5252,1075485
168,5250,2000,3900,7800000,2,42006,10503,1,310200000,310200000,15751,5250,10501,5250,0,1,5252,1076028
168,5650,2000,3900,7800000,2,45206,11303,1,329080000,329080000,16951,5650,11301,5650,0,1,5652,12526377
168,5650,2000,3900,7800000,2,45206,11303,1,329080000,329080000,16951,5650,11301,5650,0,1,5652,1138800
168,5650,2000,3900,7800000,2,45206,11303,1,329080000,329080000,16951,5650,11301,5650,0,1,5652,1148988
168,5650,2000,3900,7800000,2,45206,11303,1,329080000,329080000,16951,5650,11301,5650,0,1,5652,1144890
168,5650,2000,3900,7800000,2,45206,11303,1,329080000,329080000,16951,5650,11301,5650,0,1,5652,1136224
168,5650,2000,3900,7800000,2,45206,11303,1,329080000,329080000,16951,5650,11301,5650,0,1,5652,1153605
168,5650,2000,3900,7800000,2,45206,11303,1,329080000,329080000,16951,5650,11301,5650,0,1,5652,1154166
168,6050,2000,3900,7800000,2,48406,12103,1,347960000,347960000,18151,6050,12101,6050,0,1,6052,14399011
168,6050,2000,3900,7800000,2,48406,12103,1,347960000,347960000,18151,6050,12101,6050,0,1,6052,1238512
168,6050,2000,3900,7800000,2,48406,12103,1,347960000,347960000,18151,6050,12101,6050,0,1,6052,1192352
168,6050,2000,3900,7800000,2,48406,12103,1,347960000,347960000,18151,6050,12101,6050,0,1,6052,1234378
168,6050,2000,3900,7800000,2,48406,12103,1,347960000,347960000,18151,6050,12101,6050,0,1,6052,1205723
168,6050,2000,3900,7800000,2,48406,12103,1,347960000,347960000,18151,6050,12101,6050,0,1,6052,1239669
168,6050,2000,3900,7800000,2,48406,12103,1,347960000,347960000,18151,6050,12101,6050,0,1,6052,1239082
168,6450,2000,3900,7800000,2,51606,12903,1,366840000,366840000,19351,6450,12901,6450,0,1,6452,14941413
168,6450,2000,3900,7800000,2,51606,12903,1,366840000,366840000,19351,6450,12901,6450,0,1,6452,1274656
168,6450,2000,3900,7800000,2,51606,12903,1,366840000,366840000,19351,6450,12901,6450,0,1,6452,1263693
168,6450,2000,3900,7800000,2,51606,12903,1,366840000,366840000,19351,6450,12901,6450,0,1,6452,1282212
168,6450,2000,3900,7800000,2,51606,12903,1,366840000,366840000,19351,6450,12901,6450,0,1,6452,1292042
168,6450,2000,3900,7800000,2,51606,12903,1,366840000,366840000,19351,6450,12901,6450,0,1,6452,1314354
168,6450,2000,3900,7800000,2,51606,12903,1,366840000,366840000,19351,6450,12901,6450,0,1,6452,1313603
168,6850,2000,3900,7800000,2,54806,13703,1,385720000,385720000,20551,6850,13701,6850,0,1,6852,15874935
168,6850,2000,3900,7800000,2,54806,13703,1,385720000,385720000,20551,6850,13701,6850,0,1,6852,1374064
168,6850,2000,3900,7800000,2,54806,13703,1,385720000,385720000,20551,6850,13701,6850,0,1,6852,1385945
168,6850,2000,3900,7800000,2,54806,13703,1,385720000,385720000,20551,6850,13701,6850,0,1,6852,1384971
168,6850,2000,3900,7800000,2,54806,13703,1,385720000,385720000,20551,6850,13701,6850,0,1,6852,1378807
168,6850,2000,3900,7800000,2,54806,13703,1,385720000,385720000,20551,6850,13701,6850,0,1,6852,1384438
168,6850,2000,3900,7800000,2,54806,13703,1,385720000,385720000,20551,6850,13701,6850,0,1,6852,1382894
168,50,2000,3500,7000000,2,406,103,1,58200000,58200000,151,50,101,50,0,1,52,73261
168,50,2000,3500,7000000,2,406,103,1,58200000,58200000,151,50,101,50,0,1,52,78628
168,50,2000,3500,7000000,2,406,103,1,58200000,58200000,151,50,101,50,0,1,52,74612
168,50,2000,3500,7000000,2,406,103,1,58200000,58200000,151,50,101,50,0,1,52,66464
168,50,2000,3500,7000000,2,406,103,1,58200000,58200000,151,50,101,50,0,1,52,78210
168,50,2000,3500,7000000,2,406,103,1,58200000,58200000,151,50,101,50,0,1,52,93543
168,50,2000,3500,7000000,2,406,103,1,58200000,58200000,151,50,101,50,0,1,52,94581
168,450,2000,3500,7000000,2,3606,903,1,75800000,75800000,1351,450,901,450,0,1,452,708234
168,450,2000,3500,7000000,2,3606,903,1,75800000,75800000,1351,450,901,450,0,1,452,143836
168,450,2000,3500,7000000,2,3606,903,1,75800000,75800000,1351,450,901,450,0,1,452,144041
168,450,2000,3500,7000000,2,3606,903,1,75800000,75800000,1351,450,901,450,0,1,452,142610
168,450,2000,3500,7000000,2,3606,903,1,75800000,75800000,1351,450,901,450,0,1,452,143436
168,450,2000,3500,7000000,2,3606,903,1,75800000,75800000,1351,450,901,450,0,1,452,160856
168,450,2000,3500,7000000,2,3606,903,1,75800000,75800000,1351,450,901,450,0,1,452,161313
168,850,2000,3500,7000000,2,6806,1703,1,93400000,93400000,2551,850,1701,850,0,1,852,1474591
168,850,2000,3500,7000000,2,6806,1703,1,93400000,93400000,2551,850,1701,850,0,1,852,223915
168,850,2000,3500,7000000,2,6806,1703,1,93400000,93400000,2551,850,1701,850,0,1,852,224748
168,850,2000,3500,7000000,2,6806,1703,1,93400000,93400000,2551,850,1701,850,0,1,852,222739
168,850,2000,3500,7000000,2,6806,1703,1,93400000,93400000,2551,850,1701,850,0,1,852,225234
168,850,2000,3500,7000000,2,6806,1703,1,93400000,93400000,2551,850,1701,850,0,1,852,226003
168,850,2000,3500,7000000,2,6806,1703,1,93400000,93400000,2551,850,1701,850,0,1,852,225647
168,1250,2000,3500,7000000,2,10006,2503,1,111000000,111000000,3751,1250,2501,1250,0,1,1252,2264751
168,1250,2000,3500,7000000,2,10006,2503,1,111000000,111000000,3751,1250,2501,1250,0,1,1252,294668
168,1250,2000,3500,7000000,2,10006,2503,1,111000000,111000000,3751,1250,2501,1250,0,1,1252,292511
168,1250,2000,3500,7000000,2,10006,2503,1,111000000,111000000,3751,1250,2501,1250,0,1,1252,295317
168,1250,2000,3500,7000000,2,10006,2503,1,111000000,111000000,3751,1250,2501,1250,0,1,1252,295077
168,1250,2000,3500,7000000,2,10006,2503,1,111000000,111000000,3751,1250,2501,1250,0,1,1252,294174
168,1250,2000,3500,7000000,2,10006,2503,1,111000000,111000000,3751,1250,2501,1250,0,1,1252,293877
168,1650,2000,3500,7000000,2,13206,3303,1,128600000,128600000,4951,1650,3301,1650,0,1,1652,3068932
168,1650,2000,3500,7000000,2,13206,3303,1,128600000,128600000,4951,1650,3301,1650,0,1,1652,363079
168,1650,2000,3500,7000000,2,13206,3303,1,128600000,128600000,4951,1650,3301,1650,0,1,1652,358359
168,1650,2000,3500,7000000,2,13206,3303,1,128600000,128600000,4951,1650,3301,1650,0,1,1652,365994
168,1650,2000,3500,7000000,2,13206,3303,1,128600000,128600000,4951,1650,3301,1650,0,1,1652,359048
168,1650,2000,3500,7000000,2,13206,3303,1,128600000,128600000,4951,1650,3301,1650,0,1,1652,360734
168,1650,2000,3500,7000000,2,13206,3303,1,128600000,128600000,4951,1650,3301,1650,0,1,1652,361171
168,2050,2000,3500,7000000,2,16406,4103,1,146200000,146200000,6151,2050,4101,2050,0,1,2052,3948478
168,2050,2000,3500,7000000,2,16406,4103,1,146200000,146200000,6151,2050,4101,2050,0,1,2052,432559
168,2050,2000,3500,7000000,2,16406,4103,1,146200000,146200000,6151,2050,4101,2050,0,1,2052,431587
168,2050,2000,3500,7000000,2,16406,4103,1,146200000,146200000,6151,2050,4101,2050,0,1,2052,432096
168,2050,2000,3500,7000000,2,16406,4103,1,146200000,146200000,6151,2050,4101,2050,0,1,2052,432856
168,2050,2000,3500,7000000,2,16406,4103,1,146200000,146200000,6151,2050,4101,2050,0,1,2052,428169
168,2050,2000,3500,7000000,2,16406,4103,1,146200000,146200000,6151,2050,4101,2050,0,1,2052,429204
168,2450,2000,3500,7000000,2,19606,4903,1,163800000,163800000,7351,2450,4901,2450,0,1,2452,4717602
168,2450,2000,3500,7000000,2,19606,4903,1,163800000,163800000,7351,2450,4901,2450,0,1,2452,445986
168,2450,2000,3500,7000000,2,19606,4903,1,163800000,163800000,7351,2450,4901,2450,0,1,2452,473572
168,2450,2000,3500,7000000,2,19606,4903,1,163800000,163800000,7351,2450,4901,2450,0,1,2452,478024
168,2450,2000,3500,7000000,2,19606,4903,1,163800000,163800000,7351,2450,4901,2450,0,1,2452,487973
168,2450,2000,3500,7000000,2,19606,4903,1,163800000,163800000,7351,2450,4901,2450,0,1,2452,500881
168,2450,2000,3500,7000000,2,19606,4903,1,163800000,163800000,7351,2450,4901,2450,0,1,2452,499767
168,2850,2000,3500,7000000,2,22806,5703,1,181400000,181400000,8551,2850,5701,2850,0,1,2852,5430589
168,2850,2000,3500,7000000,2,22806,5703,1,181400000,181400000,8551,2850,5701,2850,0,1,2852,568423
168,2850,2000,3500,7000000,2,22806,5703,1,181400000,181400000,8551,2850,5701,2850,0,1,2852,569506
168,2850,2000,3500,7000000,2,22806,5703,1,181400000,181400000,8551,2850,5701,2850,0,1,2852,570011
168,2850,2000,3500,7000000,2,22806,5703,1,181400000,181400000,8551,2850,5701,2850,0,1,2852,570360
168,2850,2000,3500,7000000,2,22806,5703,1,181400000,181400000,8551,2850,5701,2850,0,1,2852,567281
168,2850,2000,3500,7000000,2,22806,5703,1,181400000,181400000,8551,2850,5701,2850,0,1,2852,568959
168,3250,2000,3500,7000000,2,26006,6503,1,199000000,199000000,9751,3250,6501,3250,0,1,3252,6232163
168,3250,2000,3500,7000000,2,26006,6503,1,199000000,199000000,9751,3250,6501,3250,0,1,3252,624696
168,3250,2000,3500,7000000,2,26006,6503,1,199000000,199000000,9751,3250,6501,3250,0,1,3252,627002
168,3250,2000,3500,7000000,2,26006,6503,1,199000000,199000000,9751,3250,6501,3250,0,1,3252,628977
168,3250,2000,3500,7000000,2,26006,6503,1,199000000,199000000,9751,3250,6501,3250,0,1,3252,628029
168,3250,2000,3500,7000000,2,26006,6503,1,199000000,199000000,9751,3250,6501,3250,0,1,3252,631786
168,3250,2000,3500,7000000,2,26006,6503,1,199000000,199000000,9751,3250,6501,3250,0,1,3252,631329
168,3650,2000,3500,7000000,2,29206,7303,1,216600000,216600000,10951,3650,7301,3650,0,1,3652,6828611
168,3650,2000,3500,7000000,2,29206,7303,1,216600000,216600000,10951,3650,7301,3650,0,1,3652,700889
168,3650,2000,3500,7000000,2,29206,7303,1,216600000,216600000,10951,3650,7301,3650,0,1,3652,704208
168,3650,2000,3500,7000000,2,29206,7303,1,216600000,216600000,10951,3650,7301,3650,0,1,3652,699357
168,3650,2000,3500,7000000,2,29206,7303,1,216600000,216600000,10951,3650,7301,3650,0,1,3652,701761
168,3650,2000,3500,7000000,2,29206,7303,1,216600000,216600000,10951,3650,7301,3650,0,1,3652,706335
168,3650,2000,3500,7000000,2,29206,7303,1,216600000,216600000,10951,3650,7301,3650,0,1,3652,705862
168,4050,2000,3500,7000000,2,32406,8103,1,234200000,234200000,12151,4050,8101,4050,0,1,4052,8294277
168,4050,2000,3500,7000000,2,32406,8103,1,234200000,234200000,12151,4050,8101,4050,0,1,4052,748882
168,4050,2000,3500,7000000,2,32406,8103,1,234200000,234200000,12151,4050,8101,4050,0,1,4052,737995
168,4050,2000,3500,7000000,2,32406,8103,1,234200000,234200000,12151,4050,8101,4050,0,1,4052,750132
168,4050,2000,3500,7000000,2,32406,8103,1,234200000,234200000,12151,4050,8101,4050,0,1,4052,751030
168,4050,2000,3500,7000000,2,32406,8103,1,234200000,234200000,12151,4050,8101,4050,0,1,4052,769673
168,4050,2000,3500,7000000,2,32406,8103,1,234200000,234200000,12151,4050,8101,4050,0,1,4052,769185
168,4450,2000,3500,7000000,2,35606,8903,1,251800000,251800000,13351,4450,8901,4450,0,1,4452,8631102
168,4450,2000,3500,7000000,2,35606,8903,1,251800000,251800000,13351,4450,8901,4450,0,1,4452,830680
168,4450,2000,3500,7000000,2,35606,8903,1,251800000,251800000,13351,4450,8901,4450,0,1,4452,792058
168,4450,2000,3500,7000000,2,35606,8903,1,251800000,251800000,13351,4450,8901,4450,0,1,4452,836105
168,4450,2000,3500,7000000,2,35606,8903,1,251800000,251800000,13351,4450,8901,4450,0,1,4452,796927
168,4450,2000,3500,7000000,2,35606,8903,1,251800000,251800000,13351,4450,8901,4450,0,1,4452,850200
168,4450,2000,3500,7000000,2,35606,8903,1,251800000,251800000,13351,4450,8901,4450,0,1,4452,849692
168,4850,2000,3500,7000000,2,38806,9703,1,269400000,269400000,14551,4850,9701,4850,0,1,4852,9665464
168,4850,2000,3500,7000000,2,38806,9703,1,269400000,269400000,14551,4850,9701,4850,0,1,4852,856836
168,4850,2000,3500,7000000,2,38806,9703,1,269400000,269400000,14551,4850,9701,4850,0,1,4852,857492
168,4850,2000,3500,7000000,2,38806,9703,1,269400000,269400000,14551,4850,9701,4850,0,1,4852,857990
168,4850,2000,3500,7000000,2,38806,9703,1,269400000,269400000,14551,4850,9701,4850,0,1,4852,861872
168,4850,2000,3500,7000000,2,38806,9703,1,269400000,269400000,14551,4850,9701,4850,0,1,4852,933322
168,4850,2000,3500,7000000,2,38806,9703,1,269400000,269400000,14551,4850,9701,4850,0,1,4852,930776
168,5250,2000,3500,7000000,2,42006,10503,1,287000000,287000000,15751,5250,10501,5250,0,1,5252,10127756
168,5250,2000,3500,7000000,2,42006,10503,1,287000000,287000000,15751,5250,10501,5250,0,1,5252,948959
168,5250,2000,3500,7000000,2,42006,10503,1,287000000,287000000,15751,5250,10501,5250,0,1,5252,939954
168,5250,2000,3500,7000000,2,42006,10503,1,287000000,287000000,15751,5250,10501,5250,0,1,5252,954625
168,5250,2000,3500,7000000,2,42006,10503,1,287000000,287000000,15751,5250,10501,5250,0,1,5252,952883
168,5250,2000,3500,7000000,2,42006,10503,1,287000000,287000000,15751,5250,10501,5250,0,1,5252,978381
168,5250,2000,3500,7000000,2,42006,10503,1,287000000,287000000,15751,5250,10501,5250,0,1,5252,978922
168,5650,2000,3500,7000000,2,45206,11303,1,304600000,304600000,16951,5650,11301,5650,0,1,5652,11658706
168,5650,2000,3500,7000000,2,45206,11303,1,304600000,304600000,16951,5650,11301,5650,0,1,5652,1021915
168,5650,2000,3500,7000000,2,45206,11303,1,304600000,304600000,16951,5650,11301,5650,0,1,5652,1027674
168,5650,2000,3500,7000000,2,45206,11303,1,304600000,304600000,16951,5650,11301,5650,0,1,5652,1023884
168,5650,2000,3500,7000000,2,45206,11303,1,304600000,304600000,16951,5650,11301,5650,0,1,5652,1013689
168,5650,2000,3500,7000000,2,45206,11303,1,304600000,304600000,16951,5650,11301,5650,0,1,5652,1041623
168,5650,2000,3500,7000000,2,45206,11303,1,304600000,304600000,16951,5650,11301,5650,0,1,5652,1042196
168,6050,2000,3500,7000000,2,48406,12103,1,322200000,322200000,18151,6050,12101,6050,0,1,6052,11894001
168,6050,2000,3500,7000000,2,48406,12103,1,322200000,322200000,18151,6050,12101,6050,0,1,6052,1104165
168,6050,2000,3500,7000000,2,48406,12103,1,322200000,322200000,18151,6050,12101,6050,0,1,6052,1067887
168,6050,2000,3500,7000000,2,48406,12103,1,322200000,322200000,18151,6050,12101,6050,0,1,6052,1115325
168,6050,2000,3500,7000000,2,48406,12103,1,322200000,322200000,18151,6050,12101,6050,0,1,6052,1080483
168,6050,2000,3500,7000000,2,48406,12103,1,322200000,322200000,18151,6050,12101,6050,0,1,6052,1117906
168,6050,2000,3500,7000000,2,48406,12103,1,322200000,322200000,18151,6050,12101,6050,0,1,6052,1117323
168,6450,2000,3500,7000000,2,51606,12903,1,339800000,339800000,19351,6450,12901,6450,0,1,6452,12867159
168,6450,2000,3500,7000000,2,51606,12903,1,339800000,339800000,19351,6450,12901,6450,0,1,6452,1135538
168,6450,2000,3500,7000000,2,51606,12903,1,339800000,339800000,19351,6450,12901,6450,0,1,6452,1145625
168,6450,2000,3500,7000000,2,51606,12903,1,339800000,339800000,19351,6450,12901,6450,0,1,6452,1152890
168,6450,2000,3500,7000000,2,51606,12903,1,339800000,339800000,19351,6450,12901,6450,0,1,6452,1162384
168,6450,2000,3500,7000000,2,51606,12903,1,339800000,339800000,19351,6450,12901,6450,0,1,6452,1188357
168,6450,2000,3500,7000000,2,51606,12903,1,339800000,339800000,19351,6450,12901,6450,0,1,6452,1186806
168,6850,2000,3500,7000000,2,54806,13703,1,357400000,357400000,20551,6850,13701,6850,0,1,6852,13332729
168,6850,2000,3500,7000000,2,54806,13703,1,357400000,357400000,20551,6850,13701,6850,0,1,6852,1244504
168,6850,2000,3500,7000000,2,54806,13703,1,357400000,357400000,20551,6850,13701,6850,0,1,6852,1251577
168,6850,2000,3500,7000000,2,54806,13703,1,357400000,357400000,20551,6850,13701,6850,0,1,6852,1250017
168,6850,2000,3500,7000000,2,54806,13703,1,357400000,357400000,20551,6850,13701,6850,0,1,6852,1247525
168,6850,2000,3500,7000000,2,54806,13703,1,357400000,357400000,20551,6850,13701,6850,0,1,6852,1254025
168,6850,2000,3500,7000000,2,54806,13703,1,357400000,357400000,20551,6850,13701,6850,0,1,6852,1253412
168,50,2000,3100,6200000,2,406,103,1,51640000,51640000,151,50,101,50,0,1,52,63984
168,50,2000,3100,6200000,2,406,103,1,51640000,51640000,151,50,101,50,0,1,52,63360
168,50,2000,3100,6200000,2,406,103,1,51640000,51640000,151,50,101,50,0,1,52,61026
168,50,2000,3100,6200000,2,406,103,1,51640000,51640000,151,50,101,50,0,1,52,50715
168,50,2000,3100,6200000,2,406,103,1,51640000,51640000,151,50,101,50,0,1,52,63777
168,50,2000,3100,6200000,2,406,103,1,51640000,51640000,151,50,101,50,0,1,52,77375
168,50,2000,3100,6200000,2,406,103,1,51640000,51640000,151,50,101,50,0,1,52,76950
168,450,2000,3100,6200000,2,3606,903,1,67960000,67960000,1351,450,901,450,0,1,452,607232
168,450,2000,3100,6200000,2,3606,903,1,67960000,67960000,1351,450,901,450,0,1,452,127226
168,450,2000,3100,6200000,2,3606,903,1,67960000,67960000,1351,450,901,450,0,1,452,127429
168,450,2000,3100,6200000,2,3606,903,1,67960000,67960000,1351,450,901,450,0,1,452,125488
168,450,2000,3100,6200000,2,3606,903,1,67960000,67960000,1351,450,901,450,0,1,452,126802
168,450,2000,3100,6200000,2,3606,903,1,67960000,67960000,1351,450,901,450,0,1,452,143821
168,450,2000,3100,6200000,2,3606,903,1,67960000,67960000,1351,450,901,450,0,1,452,143371
168,850,2000,3100,6200000,2,6806,1703,1,84280000,84280000,2551,850,1701,850,0,1,852,1255628
168,850,2000,3100,6200000,2,6806,1703,1,84280000,84280000,2551,850,1701,850,0,1,852,185101
168,850,2000,3100,6200000,2,6806,1703,1,84280000,84280000,2551,850,1701,850,0,1,852,185560
168,850,2000,3100,6200000,2,6806,1703,1,84280000,84280000,2551,850,1701,850,0,1,852,183698
168,850,2000,3100,6200000,2,6806,1703,1,84280000,84280000,2551,850,1701,850,0,1,852,175493
168,850,2000,3100,6200000,2,6806,1703,1,84280000,84280000,2551,850,1701,850,0,1,852,203136
168,850,2000,3100,6200000,2,6806,1703,1,84280000,84280000,2551,850,1701,850,0,1,852,202783
168,1250,2000,3100,6200000,2,10006,2503,1,100600000,100600000,3751,1250,2501,1250,0,1,1252,1928299
168,1250,2000,3100,6200000,2,10006,2503,1,100600000,100600000,3751,1250,2501,1250,0,1,1252,261764
168,1250,2000,3100,6200000,2,10006,2503,1,100600000,100600000,3751,1250,2501,1250,0,1,1252,259888
168,1250,2000,3100,6200000,2,10006,2503,1,100600000,100600000,3751,1250,2501,1250,0,1,1252,262223
168,1250,2000,3100,6200000,2,10006,2503,1,100600000,100600000,3751,1250,2501,1250,0,1,1252,261985
168,1250,2000,3100,6200000,2,10006,2503,1,100600000,100600000,3751,1250,2501,1250,0,1,1252,261397
168,1250,2000,3100,6200000,2,10006,2503,1,100600000,100600000,3751,1250,2501,1250,0,1,1252,260630
168,1650,2000,3100,6200000,2,13206,3303,1,116920000,116920000,4951,1650,3301,1650,0,1,1652,2680803
168,1650,2000,3100,6200000,2,13206,3303,1,116920000,116920000,4951,1650,3301,1650,0,1,1652,315869
168,1650,2000,3100,6200000,2,13206,3303,1,116920000,116920000,4951,1650,3301,1650,0,1,1652,314119
168,1650,2000,3100,6200000,2,13206,3303,1,116920000,116920000,4951,1650,3301,1650,0,1,1652,315513
168,1650,2000,3100,6200000,2,13206,3303,1,116920000,116920000,4951,1650,3301,1650,0,1,1652,316408
168,1650,2000,3100,6200000,2,13206,3303,1,116920000,116920000,4951,1650,3301,1650,0,1,1652,317513
168,1650,2000,3100,6200000,2,13206,3303,1,116920000,116920000,4951,1650,3301,1650,0,1,1652,317907
168,2050,2000,3100,6200000,2,16406,4103,1,133240000,133240000,6151,2050,4101,2050,0,1,2052,3399921
168,2050,2000,3100,6200000,2,16406,4103,1,133240000,133240000,6151,2050,4101,2050,0,1,2052,387972
168,2050,2000,3100,6200000,2,16406,4103,1,133240000,133240000,6151,2050,4101,2050,0,1,2052,374646
168,2050,2000,3100,6200000,2,16406,4103,1,133240000,133240000,6151,2050,4101,2050,0,1,2052,387472
168,2050,2000,3100,6200000,2,16406,4103,1,133240000,133240000,6151,2050,4101,2050,0,1,2052,376513
168,2050,2000,3100,6200000,2,16406,4103,1,133240000,133240000,6151,2050,4101,2050,0,1,2052,379020
168,2050,2000,3100,6200000,2,16406,4103,1,133240000,133240000,6151,2050,4101,2050,0,1,2052,378481
168,2450,2000,3100,6200000,2,19606,4903,1,149560000,149560000,7351,2450,4901,2450,0,1,2452,4169205
168,2450,2000,3100,6200000,2,19606,4903,1,149560000,149560000,7351,2450,4901,2450,0,1,2452,453629
168,2450,2000,3100,6200000,2,19606,4903,1,149560000,149560000,7351,2450,4901,2450,0,1,2452,451073
168,2450,2000,3100,6200000,2,19606,4903,1,149560000,149560000,7351,2450,4901,2450,0,1,2452,453091
168,2450,2000,3100,6200000,2,19606,4903,1,149560000,149560000,7351,2450,4901,2450,0,1,2452,452494
168,2450,2000,3100,6200000,2,19606,4903,1,149560000,149560000,7351,2450,4901,2450,0,1,2452,447916
168,2450,2000,3100,6200000,2,19606,4903,1,149560000,149560000,7351,2450,4901,2450,0,1,2452,445890
168,2850,2000,3100,6200000,2,22806,5703,1,165880000,165880000,8551,2850,5701,2850,0,1,2852,4794555
168,2850,2000,3100,6200000,2,22806,5703,1,165880000,165880000,8551,2850,5701,2850,0,1,2852,485695
168,2850,2000,3100,6200000,2,22806,5703,1,165880000,165880000,8551,2850,5701,2850,0,1,2852,487689
168,2850,2000,3100,6200000,2,22806,5703,1,165880000,165880000,8551,2850,5701,2850,0,1,2852,494276
168,2850,2000,3100,6200000,2,22806,5703,1,165880000,165880000,8551,2850,5701,2850,0,1,2852,510158
168,2850,2000,3100,6200000,2,22806,5703,1,165880000,165880000,8551,2850,5701,2850,0,1,2852,509328
168,2850,2000,3100,6200000,2,22806,5703,1,165880000,165880000,8551,2850,5701,2850,0,1,2852,511407
168,3250,2000,3100,6200000,2,26006,6503,1,182200000,182200000,9751,3250,6501,3250,0,1,3252,5615655
168,3250,2000,3100,6200000,2,26006,6503,1,182200000,182200000,9751,3250,6501,3250,0,1,3252,567427
168,3250,2000,3100,6200000,2,26006,6503,1,182200000,182200000,9751,3250,6501,3250,0,1,3252,539607
168,3250,2000,3100,6200000,2,26006,6503,1,182200000,182200000,9751,3250,6501,3250,0,1,3252,566210
168,3250,2000,3100,6200000,2,26006,6503,1,182200000,182200000,9751,3250,6501,3250,0,1,3252,568018
168,3250,2000,3100,6200000,2,26006,6503,1,182200000,182200000,9751,3250,6501,3250,0,1,3252,563600
168,3250,2000,3100,6200000,2,26006,6503,1,182200000,182200000,9751,3250,6501,3250,0,1,3252,561851
168,3650,2000,3100,6200000,2,29206,7303,1,198520000,198520000,10951,3650,7301,3650,0,1,3652,6434018
168,3650,2000,3100,6200000,2,29206,7303,1,198520000,198520000,10951,3650,7301,3650,0,1,3652,630735
168,3650,2000,3100,6200000,2,29206,7303,1,198520000,198520000,10951,3650,7301,3650,0,1,3652,626772
168,3650,2000,3100,6200000,2,29206,7303,1,198520000,198520000,10951,3650,7301,3650,0,1,3652,632027
168,3650,2000,3100,6200000,2,29206,7303,1,198520000,198520000,10951,3650,7301,3650,0,1,3652,632596
168,3650,2000,3100,6200000,2,29206,7303,1,198520000,198520000,10951,3650,7301,3650,0,1,3652,635243
168,3650,2000,3100,6200000,2,29206,7303,1,198520000,198520000,10951,3650,7301,3650,0,1,3652,634767
168,4050,2000,3100,6200000,2,32406,8103,1,214840000,214840000,12151,4050,8101,4050,0,1,4052,6916475
168,4050,2000,3100,6200000,2,32406,8103,1,214840000,214840000,12151,4050,8101,4050,0,1,4052,662959
168,4050,2000,3100,6200000,2,32406,8103,1,214840000,214840000,12151,4050,8101,4050,0,1,4052,680755
168,4050,2000,3100,6200000,2,32406,8103,1,214840000,214840000,12151,4050,8101,4050,0,1,4052,667898
168,4050,2000,3100,6200000,2,32406,8103,1,214840000,214840000,12151,4050,8101,4050,0,1,4052,658605
168,4050,2000,3100,6200000,2,32406,8103,1,214840000,214840000,12151,4050,8101,4050,0,1,4052,697412
168,4050,2000,3100,6200000,2,32406,8103,1,214840000,214840000,12151,4050,8101,4050,0,1,4052,696926
168,4450,2000,3100,6200000,2,35606,8903,1,231160000,231160000,13351,4450,8901,4450,0,1,4452,7875028
168,4450,2000,3100,6200000,2,35606,8903,1,231160000,231160000,13351,4450,8901,4450,0,1,4452,725626
168,4450,2000,3100,6200000,2,35606,8903,1,231160000,231160000,13351,4450,8901,4450,0,1,4452,721802
168,4450,2000,3100,6200000,2,35606,8903,1,231160000,231160000,13351,4450,8901,4450,0,1,4452,726045
168,4450,2000,3100,6200000,2,35606,8903,1,231160000,231160000,13351,4450,8901,4450,0,1,4452,725000
168,4450,2000,3100,6200000,2,35606,8903,1,231160000,231160000,13351,4450,8901,4450,0,1,4452,771452
168,4450,2000,3100,6200000,2,35606,8903,1,231160000,231160000,13351,4450,8901,4450,0,1,4452,770948
168,4850,2000,3100,6200000,2,38806,9703,1,247480000,247480000,14551,4850,9701,4850,0,1,4852,8436717
168,4850,2000,3100,6200000,2,38806,9703,1,247480000,247480000,14551,4850,9701,4850,0,1,4852,801400
168,4850,2000,3100,6200000,2,38806,9703,1,247480000,247480000,14551,4850,9701,4850,0,1,4852,763411
168,4850,2000,3100,6200000,2,38806,9703,1,247480000,247480000,14551,4850,9701,4850,0,1,4852,803132
168,4850,2000,3100,6200000,2,38806,9703,1,247480000,247480000,14551,4850,9701,4850,0,1,4852,768510
168,4850,2000,3100,6200000,2,38806,9703,1,247480000,247480000,14551,4850,9701,4850,0,1,4852,825125
168,4850,2000,3100,6200000,2,38806,9703,1,247480000,247480000,14551,4850,9701,4850,0,1,4852,824599
168,5250,2000,3100,6200000,2,42006,10503,1,263800000,263800000,15751,5250,10501,5250,0,1,5252,9038887
168,5250,2000,3100,6200000,2,42006,10503,1,263800000,263800000,15751,5250,10501,5250,0,1,5252,836795
168,5250,2000,3100,6200000,2,42006,10503,1,263800000,263800000,15751,5250,10501,5250,0,1,5252,837894
168,5250,2000,3100,6200000,2,42006,10503,1,263800000,263800000,15751,5250,10501,5250,0,1,5252,838467
168,5250,2000,3100,6200000,2,42006,10503,1,263800000,263800000,15751,5250,10501,5250,0,1,5252,840296
168,5250,2000,3100,6200000,2,42006,10503,1,263800000,263800000,15751,5250,10501,5250,0,1,5252,896670
168,5250,2000,3100,6200000,2,42006,10503,1,263800000,263800000,15751,5250,10501,5250,0,1,5252,890558
168,5650,2000,3100,6200000,2,45206,11303,1,280120000,280120000,16951,5650,11301,5650,0,1,5652,9570462
168,5650,2000,3100,6200000,2,45206,11303,1,280120000,280120000,16951,5650,11301,5650,0,1,5652,905419
168,5650,2000,3100,6200000,2,45206,11303,1,280120000,280120000,16951,5650,11301,5650,0,1,5652,904262
168,5650,2000,3100,6200000,2,45206,11303,1,280120000,280120000,16951,5650,11301,5650,0,1,5652,907733
168,5650,2000,3100,6200000,2,45206,11303,1,280120000,280120000,16951,5650,11301,5650,0,1,5652,901489
168,5650,2000,3100,6200000,2,45206,11303,1,280120000,280120000,16951,5650,11301,5650,0,1,5652,937218
168,5650,2000,3100,6200000,2,45206,11303,1,280120000,280120000,16951,5650,11301,5650,0,1,5652,936660
168,6050,2000,3100,6200000,2,48406,12103,1,296440000,296440000,18151,6050,12101,6050,0,1,6052,10569677
168,6050,2000,3100,6200000,2,48406,12103,1,296440000,296440000,18151,6050,12101,6050,0,1,6052,979769
168,6050,2000,3100,6200000,2,48406,12103,1,296440000,296440000,18151,6050,12101,6050,0,1,6052,985430
168,6050,2000,3100,6200000,2,48406,12103,1,296440000,296440000,18151,6050,12101,6050,0,1,6052,981197
168,6050,2000,3100,6200000,2,48406,12103,1,296440000,296440000,18151,6050,12101,6050,0,1,6052,976974
168,6050,2000,3100,6200000,2,48406,12103,1,296440000,296440000,18151,6050,12101,6050,0,1,6052,1001915
168,6050,2000,3100,6200000,2,48406,12103,1,296440000,296440000,18151,6050,12101,6050,0,1,6052,1001329
168,6450,2000,3100,6200000,2,51606,12903,1,312760000,312760000,19351,6450,12901,6450,0,1,6452,11352982
168,6450,2000,3100,6200000,2,51606,12903,1,312760000,312760000,19351,6450,12901,6450,0,1,6452,1061629
168,6450,2000,3100,6200000,2,51606,12903,1,312760000,312760000,19351,6450,12901,6450,0,1,6452,1010657
168,6450,2000,3100,6200000,2,51606,12903,1,312760000,312760000,19351,6450,12901,6450,0,1,6452,1057284
168,6450,2000,3100,6200000,2,51606,12903,1,312760000,312760000,19351,6450,12901,6450,0,1,6452,1023380
168,6450,2000,3100,6200000,2,51606,12903,1,312760000,312760000,19351,6450,12901,6450,0,1,6452,1068591
168,6450,2000,3100,6200000,2,51606,12903,1,312760000,312760000,19351,6450,12901,6450,0,1,6452,1068008
168,6850,2000,3100,6200000,2,54806,13703,1,329080000,329080000,20551,6850,13701,6850,0,1,6852,11966133
168,6850,2000,3100,6200000,2,54806,13703,1,329080000,329080000,20551,6850,13701,6850,0,1,6852,1092519
168,6850,2000,3100,6200000,2,54806,13703,1,329080000,329080000,20551,6850,13701,6850,0,1,6852,1072359
168,6850,2000,3100,6200000,2,54806,13703,1,329080000,329080000,20551,6850,13701,6850,0,1,6852,1099757
168,6850,2000,3100,6200000,2,54806,13703,1,329080000,329080000,20551,6850,13701,6850,0,1,6852,1113238
168,6850,2000,3100,6200000,2,54806,13703,1,329080000,329080000,20551,6850,13701,6850,0,1,6852,1135801
168,6850,2000,3100,6200000,2,54806,13703,1,329080000,329080000,20551,6850,13701,6850,0,1,6852,1135195
168,50,2000,2700,5400000,2,406,103,1,45080000,45080000,151,50,101,50,0,1,52,56534
168,50,2000,2700,5400000,2,406,103,1,45080000,45080000,151,50,101,50,0,1,52,55301
168,50,2000,2700,5400000,2,406,103,1,45080000,45080000,151,50,101,50,0,1,52,55724
168,50,2000,2700,5400000,2,406,103,1,45080000,45080000,151,50,101,50,0,1,52,44997
168,50,2000,2700,5400000,2,406,103,1,45080000,45080000,151,50,101,50,0,1,52,52663
168,50,2000,2700,5400000,2,406,103,1,45080000,45080000,151,50,101,50,0,1,52,66442
168,50,2000,2700,5400000,2,406,103,1,45080000,45080000,151,50,101,50,0,1,52,68394
168,450,2000,2700,5400000,2,3606,903,1,60120000,60120000,1351,450,901,450,0,1,452,537843
168,450,2000,2700,5400000,2,3606,903,1,60120000,60120000,1351,450,901,450,0,1,452,111320
168,450,2000,2700,5400000,2,3606,903,1,60120000,60120000,1351,450,901,450,0,1,452,103527
168,450,2000,2700,5400000,2,3606,903,1,60120000,60120000,1351,450,901,450,0,1,452,110440
168,450,2000,2700,5400000,2,3606,903,1,60120000,60120000,1351,450,901,450,0,1,452,110040
168,450,2000,2700,5400000,2,3606,903,1,60120000,60120000,1351,450,901,450,0,1,452,124870
168,450,2000,2700,5400000,2,3606,903,1,60120000,60120000,1351,450,901,450,0,1,452,124421
168,850,2000,2700,5400000,2,6806,1703,1,75160000,75160000,2551,850,1701,850,0,1,852,1079118
168,850,2000,2700,5400000,2,6806,1703,1,75160000,75160000,2551,850,1701,850,0,1,852,172596
168,850,2000,2700,5400000,2,6806,1703,1,75160000,75160000,2551,850,1701,850,0,1,852,171902
168,850,2000,2700,5400000,2,6806,1703,1,75160000,75160000,2551,850,1701,850,0,1,852,170620
168,850,2000,2700,5400000,2,6806,1703,1,75160000,75160000,2551,850,1701,850,0,1,852,172355
168,850,2000,2700,5400000,2,6806,1703,1,75160000,75160000,2551,850,1701,850,0,1,852,185668
168,850,2000,2700,5400000,2,6806,1703,1,75160000,75160000,2551,850,1701,850,0,1,852,183664
168,1250,2000,2700,5400000,2,10006,2503,1,90200000,90200000,3751,1250,2501,1250,0,1,1252,1653235
168,1250,2000,2700,5400000,2,10006,2503,1,90200000,90200000,3751,1250,2501,1250,0,1,1252,230269
168,1250,2000,2700,5400000,2,10006,2503,1,90200000,90200000,3751,1250,2501,1250,0,1,1252,231069
168,1250,2000,2700,5400000,2,10006,2503,1,90200000,90200000,3751,1250,2501,1250,0,1,1252,229520
168,1250,2000,2700,5400000,2,10006,2503,1,90200000,90200000,3751,1250,2501,1250,0,1,1252,231657
168,1250,2000,2700,5400000,2,10006,2503,1,90200000,90200000,3751,1250,2501,1250,0,1,1252,231965
168,1250,2000,2700,5400000,2,10006,2503,1,90200000,90200000,3751,1250,2501,1250,0,1,1252,232298
168,1650,2000,2700,5400000,2,13206,3303,1,105240000,105240000,4951,1650,3301,1650,0,1,1652,2329480
168,1650,2000,2700,5400000,2,13206,3303,1,105240000,105240000,4951,1650,3301,1650,0,1,1652,282802
168,1650,2000,2700,5400000,2,13206,3303,1,105240000,105240000,4951,1650,3301,1650,0,1,1652,278630
168,1650,2000,2700,5400000,2,13206,3303,1,105240000,105240000,4951,1650,3301,1650,0,1,1652,283277
168,1650,2000,2700,5400000,2,13206,3303,1,105240000,105240000,4951,1650,3301,1650,0,1,1652,258786
168,1650,2000,2700,5400000,2,13206,3303,1,105240000,105240000,4951,1650,3301,1650,0,1,1652,282248
168,1650,2000,2700,5400000,2,13206,3303,1,105240000,105240000,4951,1650,3301,1650,0,1,1652,281923
168,2050,2000,2700,5400000,2,16406,4103,1,120280000,120280000,6151,2050,4101,2050,0,1,2052,2912651
168,2050,2000,2700,5400000,2,16406,4103,1,120280000,120280000,6151,2050,4101,2050,0,1,2052,344338
168,2050,2000,2700,5400000,2,16406,4103,1,120280000,120280000,6151,2050,4101,2050,0,1,2052,348995
168,2050,2000,2700,5400000,2,16406,4103,1,120280000,120280000,6151,2050,4101,2050,0,1,2052,343581
168,2050,2000,2700,5400000,2,16406,4103,1,120280000,120280000,6151,2050,4101,2050,0,1,2052,343985
168,2050,2000,2700,5400000,2,16406,4103,1,120280000,120280000,6151,2050,4101,2050,0,1,2052,342770
168,2050,2000,2700,5400000,2,16406,4103,1,120280000,120280000,6151,2050,4101,2050,0,1,2052,341440
168,2450,2000,2700,5400000,2,19606,4903,1,135320000,135320000,7351,2450,4901,2450,0,1,2452,3504304
168,2450,2000,2700,5400000,2,19606,4903,1,135320000,135320000,7351,2450,4901,2450,0,1,2452,394892
168,2450,2000,2700,5400000,2,19606,4903,1,135320000,135320000,7351,2450,4901,2450,0,1,2452,395210
168,2450,2000,2700,5400000,2,19606,4903,1,135320000,135320000,7351,2450,4901,2450,0,1,2452,394604
168,2450,2000,2700,5400000,2,19606,4903,1,135320000,135320000,7351,2450,4901,2450,0,1,2452,394189
168,2450,2000,2700,5400000,2,19606,4903,1,135320000,135320000,7351,2450,4901,2450,0,1,2452,388664
168,2450,2000,2700,5400000,2,19606,4903,1,135320000,135320000,7351,2450,4901,2450,0,1,2452,389656
168,2850,2000,2700,5400000,2,22806,5703,1,150360000,150360000,8551,2850,5701,2850,0,1,2852,4134528
168,2850,2000,2700,5400000,2,22806,5703,1,150360000,150360000,8551,2850,5701,2850,0,1,2852,447693
168,2850,2000,2700,5400000,2,22806,5703,1,150360000,150360000,8551,2850,5701,2850,0,1,2852,447137
168,2850,2000,2700,5400000,2,22806,5703,1,150360000,150360000,8551,2850,5701,2850,0,1,2852,427821
168,2850,2000,2700,5400000,2,22806,5703,1,150360000,150360000,8551,2850,5701,2850,0,1,2852,445991
168,2850,2000,2700,5400000,2,22806,5703,1,150360000,150360000,8551,2850,5701,2850,0,1,2852,443440
168,2850,2000,2700,5400000,2,22806,5703,1,150360000,150360000,8551,2850,5701,2850,0,1,2852,444937
168,3250,2000,2700,5400000,2,26006,6503,1,165400000,165400000,9751,3250,6501,3250,0,1,3252,4760665
168,3250,2000,2700,5400000,2,26006,6503,1,165400000,165400000,9751,3250,6501,3250,0,1,3252,510597
168,3250,2000,2700,5400000,2,26006,6503,1,165400000,165400000,9751,3250,6501,3250,0,1,3252,507561
168,3250,2000,2700,5400000,2,26006,6503,1,165400000,165400000,9751,3250,6501,3250,0,1,3252,510969
168,3250,2000,2700,5400000,2,26006,6503,1,165400000,165400000,9751,3250,6501,3250,0,1,3252,509006
168,3250,2000,2700,5400000,2,26006,6503,1,165400000,165400000,9751,3250,6501,3250,0,1,3252,509810
168,3250,2000,2700,5400000,2,26006,6503,1,165400000,165400000,9751,3250,6501,3250,0,1,3252,510262
168,3650,2000,2700,5400000,2,29206,7303,1,180440000,180440000,10951,3650,7301,3650,0,1,3652,5321184
168,3650,2000,2700,5400000,2,29206,7303,1,180440000,180440000,10951,3650,7301,3650,0,1,3652,560156
168,3650,2000,2700,5400000,2,29206,7303,1,180440000,180440000,10951,3650,7301,3650,0,1,3652,537356
168,3650,2000,2700,5400000,2,29206,7303,1,180440000,180440000,10951,3650,7301,3650,0,1,3652,565167
168,3650,2000,2700,5400000,2,29206,7303,1,180440000,180440000,10951,3650,7301,3650,0,1,3652,539939
168,3650,2000,2700,5400000,2,29206,7303,1,180440000,180440000,10951,3650,7301,3650,0,1,3652,560682
168,3650,2000,2700,5400000,2,29206,7303,1,180440000,180440000,10951,3650,7301,3650,0,1,3652,561179
168,4050,2000,2700,5400000,2,32406,8103,1,195480000,195480000,12151,4050,8101,4050,0,1,4052,5777176
168,4050,2000,2700,5400000,2,32406,8103,1,195480000,195480000,12151,4050,8101,4050,0,1,4052,604369
168,4050,2000,2700,5400000,2,32406,8103,1,195480000,195480000,12151,4050,8101,4050,0,1,4052,592558
168,4050,2000,2700,5400000,2,32406,8103,1,195480000,195480000,12151,4050,8101,4050,0,1,4052,605371
168,4050,2000,2700,5400000,2,32406,8103,1,195480000,195480000,12151,4050,8101,4050,0,1,4052,602985
168,4050,2000,2700,5400000,2,32406,8103,1,195480000,195480000,12151,4050,8101,4050,0,1,4052,619756
168,4050,2000,2700,5400000,2,32406,8103,1,195480000,195480000,12151,4050,8101,4050,0,1,4052,619271
168,4450,2000,2700,5400000,2,35606,8903,1,210520000,210520000,13351,4450,8901,4450,0,1,4452,6735352
168,4450,2000,2700,5400000,2,35606,8903,1,210520000,210520000,13351,4450,8901,4450,0,1,4452,676205
168,4450,2000,2700,5400000,2,35606,8903,1,210520000,210520000,13351,4450,8901,4450,0,1,4452,667520
168,4450,2000,2700,5400000,2,35606,8903,1,210520000,210520000,13351,4450,8901,4450,0,1,4452,678139
168,4450,2000,2700,5400000,2,35606,8903,1,210520000,210520000,13351,4450,8901,4450,0,1,4452,688037
168,4450,2000,2700,5400000,2,35606,8903,1,210520000,210520000,13351,4450,8901,4450,0,1,4452,703083
168,4450,2000,2700,5400000,2,35606,8903,1,210520000,210520000,13351,4450,8901,4450,0,1,4452,702574
168,4850,2000,2700,5400000,2,38806,9703,1,225560000,225560000,14551,4850,9701,4850,0,1,4852,7356637
168,4850,2000,2700,5400000,2,38806,9703,1,225560000,225560000,14551,4850,9701,4850,0,1,4852,719618
168,4850,2000,2700,5400000,2,38806,9703,1,225560000,225560000,14551,4850,9701,4850,0,1,4852,720732
168,4850,2000,2700,5400000,2,38806,9703,1,225560000,225560000,14551,4850,9701,4850,0,1,4852,720238
168,4850,2000,2700,5400000,2,38806,9703,1,225560000,225560000,14551,4850,9701,4850,0,1,4852,718708
168,4850,2000,2700,5400000,2,38806,9703,1,225560000,225560000,14551,4850,9701,4850,0,1,4852,715689
168,4850,2000,2700,5400000,2,38806,9703,1,225560000,225560000,14551,4850,9701,4850,0,1,4852,714224
168,5250,2000,2700,5400000,2,42006,10503,1,240600000,240600000,15751,5250,10501,5250,0,1,5252,7908434
168,5250,2000,2700,5400000,2,42006,10503,1,240600000,240600000,15751,5250,10501,5250,0,1,5252,733510
168,5250,2000,2700,5400000,2,42006,10503,1,240600000,240600000,15751,5250,10501,5250,0,1,5252,750844
168,5250,2000,2700,5400000,2,42006,10503,1,240600000,240600000,15751,5250,10501,5250,0,1,5252,739582
168,5250,2000,2700,5400000,2,42006,10503,1,240600000,240600000,15751,5250,10501,5250,0,1,5252,737782
168,5250,2000,2700,5400000,2,42006,10503,1,240600000,240600000,15751,5250,10501,5250,0,1,5252,795211
168,5250,2000,2700,5400000,2,42006,10503,1,240600000,240600000,15751,5250,10501,5250,0,1,5252,795754
168,5650,2000,2700,5400000,2,45206,11303,1,255640000,255640000,16951,5650,11301,5650,0,1,5652,8596541
168,5650,2000,2700,5400000,2,45206,11303,1,255640000,255640000,16951,5650,11301,5650,0,1,5652,791845
168,5650,2000,2700,5400000,2,45206,11303,1,255640000,255640000,16951,5650,11301,5650,0,1,5652,789925
168,5650,2000,2700,5400000,2,45206,11303,1,255640000,255640000,16951,5650,11301,5650,0,1,5652,792725
168,5650,2000,2700,5400000,2,45206,11303,1,255640000,255640000,16951,5650,11301,5650,0,1,5652,790585
168,5650,2000,2700,5400000,2,45206,11303,1,255640000,255640000,16951,5650,11301,5650,0,1,5652,838182
168,5650,2000,2700,5400000,2,45206,11303,1,255640000,255640000,16951,5650,11301,5650,0,1,5652,836835
168,6050,2000,2700,5400000,2,48406,12103,1,270680000,270680000,18151,6050,12101,6050,0,1,6052,9061280
168,6050,2000,2700,5400000,2,48406,12103,1,270680000,270680000,18151,6050,12101,6050,0,1,6052,862136
168,6050,2000,2700,5400000,2,48406,12103,1,270680000,270680000,18151,6050,12101,6050,0,1,6052,835584
168,6050,2000,2700,5400000,2,48406,12103,1,270680000,270680000,18151,6050,12101,6050,0,1,6052,875818
168,6050,2000,2700,5400000,2,48406,12103,1,270680000,270680000,18151,6050,12101,6050,0,1,6052,838692
168,6050,2000,2700,5400000,2,48406,12103,1,270680000,270680000,18151,6050,12101,6050,0,1,6052,896787
168,6050,2000,2700,5400000,2,48406,12103,1,270680000,270680000,18151,6050,12101,6050,0,1,6052,896190
168,6450,2000,2700,5400000,2,51606,12903,1,285720000,285720000,19351,6450,12901,6450,0,1,6452,9521537
168,6450,2000,2700,5400000,2,51606,12903,1,285720000,285720000,19351,6450,12901,6450,0,1,6452,906890
168,6450,2000,2700,5400000,2,51606,12903,1,285720000,285720000,19351,6450,12901,6450,0,1,6452,904638
168,6450,2000,2700,5400000,2,51606,12903,1,285720000,285720000,19351,6450,12901,6450,0,1,6452,907588
168,6450,2000,2700,5400000,2,51606,12903,1,285720000,285720000,19351,6450,12901,6450,0,1,6452,908180
168,6450,2000,2700,5400000,2,51606,12903,1,285720000,285720000,19351,6450,12901,6450,0,1,6452,957130
168,6450,2000,2700,5400000,2,51606,12903,1,285720000,285720000,19351,6450,12901,6450,0,1,6452,956368
168,6850,2000,2700,5400000,2,54806,13703,1,300760000,300760000,20551,6850,13701,6850,0,1,6852,10690977
168,6850,2000,2700,5400000,2,54806,13703,1,300760000,300760000,20551,6850,13701,6850,0,1,6852,967700
168,6850,2000,2700,5400000,2,54806,13703,1,300760000,300760000,20551,6850,13701,6850,0,1,6852,974018
168,6850,2000,2700,5400000,2,54806,13703,1,300760000,300760000,20551,6850,13701,6850,0,1,6852,969345
168,6850,2000,2700,5400000,2,54806,13703,1,300760000,300760000,20551,6850,13701,6850,0,1,6852,959495
168,6850,2000,2700,5400000,2,54806,13703,1,300760000,300760000,20551,6850,13701,6850,0,1,6852,991947
168,6850,2000,2700,5400000,2,54806,13703,1,300760000,300760000,20551,6850,13701,6850,0,1,6852,991324
168,50,2000,2300,4600000,2,406,103,1,38520000,38520000,151,50,101,50,0,1,52,46510
168,50,2000,2300,4600000,2,406,103,1,38520000,38520000,151,50,101,50,0,1,52,49456
168,50,2000,2300,4600000,2,406,103,1,38520000,38520000,151,50,101,50,0,1,52,49868
168,50,2000,2300,4600000,2,406,103,1,38520000,38520000,151,50,101,50,0,1,52,39504
168,50,2000,2300,4600000,2,406,103,1,38520000,38520000,151,50,101,50,0,1,52,46216
168,50,2000,2300,4600000,2,406,103,1,38520000,38520000,151,50,101,50,0,1,52,59929
168,50,2000,2300,4600000,2,406,103,1,38520000,38520000,151,50,101,50,0,1,52,59507
168,450,2000,2300,4600000,2,3606,903,1,52280000,52280000,1351,450,901,450,0,1,452,441809
168,450,2000,2300,4600000,2,3606,903,1,52280000,52280000,1351,450,901,450,0,1,452,94417
168,450,2000,2300,4600000,2,3606,903,1,52280000,52280000,1351,450,901,450,0,1,452,93456
168,450,2000,2300,4600000,2,3606,903,1,52280000,52280000,1351,450,901,450,0,1,452,95830
168,450,2000,2300,4600000,2,3606,903,1,52280000,52280000,1351,450,901,450,0,1,452,96270
168,450,2000,2300,4600000,2,3606,903,1,52280000,52280000,1351,450,901,450,0,1,452,107933
168,450,2000,2300,4600000,2,3606,903,1,52280000,52280000,1351,450,901,450,0,1,452,108390
168,850,2000,2300,4600000,2,6806,1703,1,66040000,66040000,2551,850,1701,850,0,1,852,908192
168,850,2000,2300,4600000,2,6806,1703,1,66040000,66040000,2551,850,1701,850,0,1,852,132330
168,850,2000,2300,4600000,2,6806,1703,1,66040000,66040000,2551,850,1701,850,0,1,852,141398
168,850,2000,2300,4600000,2,6806,1703,1,66040000,66040000,2551,850,1701,850,0,1,852,141863
168,850,2000,2300,4600000,2,6806,1703,1,66040000,66040000,2551,850,1701,850,0,1,852,140027
168,850,2000,2300,4600000,2,6806,1703,1,66040000,66040000,2551,850,1701,850,0,1,852,157202
168,850,2000,2300,4600000,2,6806,1703,1,66040000,66040000,2551,850,1701,850,0,1,852,157690
168,1250,2000,2300,4600000,2,10006,2503,1,79800000,79800000,3751,1250,2501,1250,0,1,1252,1423241
168,1250,2000,2300,4600000,2,10006,2503,1,79800000,79800000,3751,1250,2501,1250,0,1,1252,188795
168,1250,2000,2300,4600000,2,10006,2503,1,79800000,79800000,3751,1250,2501,1250,0,1,1252,186572
168,1250,2000,2300,4600000,2,10006,2503,1,79800000,79800000,3751,1250,2501,1250,0,1,1252,181975
168,1250,2000,2300,4600000,2,10006,2503,1,79800000,79800000,3751,1250,2501,1250,0,1,1252,189299
168,1250,2000,2300,4600000,2,10006,2503,1,79800000,79800000,3751,1250,2501,1250,0,1,1252,203546
168,1250,2000,2300,4600000,2,10006,2503,1,79800000,79800000,3751,1250,2501,1250,0,1,1252,203920
168,1650,2000,2300,4600000,2,13206,3303,1,93560000,93560000,4951,1650,3301,1650,0,1,1652,1913275
168,1650,2000,2300,4600000,2,13206,3303,1,93560000,93560000,4951,1650,3301,1650,0,1,1652,248988
168,1650,2000,2300,4600000,2,13206,3303,1,93560000,93560000,4951,1650,3301,1650,0,1,1652,249256
168,1650,2000,2300,4600000,2,13206,3303,1,93560000,93560000,4951,1650,3301,1650,0,1,1652,248743
168,1650,2000,2300,4600000,2,13206,3303,1,93560000,93560000,4951,1650,3301,1650,0,1,1652,248358
168,1650,2000,2300,4600000,2,13206,3303,1,93560000,93560000,4951,1650,3301,1650,0,1,1652,246717
168,1650,2000,2300,4600000,2,13206,3303,1,93560000,93560000,4951,1650,3301,1650,0,1,1652,247924
168,2050,2000,2300,4600000,2,16406,4103,1,107320000,107320000,6151,2050,4101,2050,0,1,2052,2431103
168,2050,2000,2300,4600000,2,16406,4103,1,107320000,107320000,6151,2050,4101,2050,0,1,2052,295917
168,2050,2000,2300,4600000,2,16406,4103,1,107320000,107320000,6151,2050,4101,2050,0,1,2052,296586
168,2050,2000,2300,4600000,2,16406,4103,1,107320000,107320000,6151,2050,4101,2050,0,1,2052,296321
168,2050,2000,2300,4600000,2,16406,4103,1,107320000,107320000,6151,2050,4101,2050,0,1,2052,296886
168,2050,2000,2300,4600000,2,16406,4103,1,107320000,107320000,6151,2050,4101,2050,0,1,2052,293183
168,2050,2000,2300,4600000,2,16406,4103,1,107320000,107320000,6151,2050,4101,2050,0,1,2052,294476
168,2450,2000,2300,4600000,2,19606,4903,1,121080000,121080000,7351,2450,4901,2450,0,1,2452,2997789
168,2450,2000,2300,4600000,2,19606,4903,1,121080000,121080000,7351,2450,4901,2450,0,1,2452,320397
168,2450,2000,2300,4600000,2,19606,4903,1,121080000,121080000,7351,2450,4901,2450,0,1,2452,337093
168,2450,2000,2300,4600000,2,19606,4903,1,121080000,121080000,7351,2450,4901,2450,0,1,2452,339179
168,2450,2000,2300,4600000,2,19606,4903,1,121080000,121080000,7351,2450,4901,2450,0,1,2452,338650
168,2450,2000,2300,4600000,2,19606,4903,1,121080000,121080000,7351,2450,4901,2450,0,1,2452,336555
168,2450,2000,2300,4600000,2,19606,4903,1,121080000,121080000,7351,2450,4901,2450,0,1,2452,336030
168,2850,2000,2300,4600000,2,22806,5703,1,134840000,134840000,8551,2850,5701,2850,0,1,2852,3603708
168,2850,2000,2300,4600000,2,22806,5703,1,134840000,134840000,8551,2850,5701,2850,0,1,2852,385653
168,2850,2000,2300,4600000,2,22806,5703,1,134840000,134840000,8551,2850,5701,2850,0,1,2852,385099
168,2850,2000,2300,4600000,2,22806,5703,1,134840000,134840000,8551,2850,5701,2850,0,1,2852,381450
168,2850,2000,2300,4600000,2,22806,5703,1,134840000,134840000,8551,2850,5701,2850,0,1,2852,380001
168,2850,2000,2300,4600000,2,22806,5703,1,134840000,134840000,8551,2850,5701,2850,0,1,2852,383623
168,2850,2000,2300,4600000,2,22806,5703,1,134840000,134840000,8551,2850,5701,2850,0,1,2852,383181
168,3250,2000,2300,4600000,2,26006,6503,1,148600000,148600000,9751,3250,6501,3250,0,1,3252,4033626
168,3250,2000,2300,4600000,2,26006,6503,1,148600000,148600000,9751,3250,6501,3250,0,1,3252,441461
168,3250,2000,2300,4600000,2,26006,6503,1,148600000,148600000,9751,3250,6501,3250,0,1,3252,431490
168,3250,2000,2300,4600000,2,26006,6503,1,148600000,148600000,9751,3250,6501,3250,0,1,3252,445941
168,3250,2000,2300,4600000,2,26006,6503,1,148600000,148600000,9751,3250,6501,3250,0,1,3252,433374
168,3250,2000,2300,4600000,2,26006,6503,1,148600000,148600000,9751,3250,6501,3250,0,1,3252,437198
168,3250,2000,2300,4600000,2,26006,6503,1,148600000,148600000,9751,3250,6501,3250,0,1,3252,438087
168,3650,2000,2300,4600000,2,29206,7303,1,162360000,162360000,10951,3650,7301,3650,0,1,3652,4412401
168,3650,2000,2300,4600000,2,29206,7303,1,162360000,162360000,10951,3650,7301,3650,0,1,3652,490192
168,3650,2000,2300,4600000,2,29206,7303,1,162360000,162360000,10951,3650,7301,3650,0,1,3652,487393
168,3650,2000,2300,4600000,2,29206,7303,1,162360000,162360000,10951,3650,7301,3650,0,1,3652,489584
168,3650,2000,2300,4600000,2,29206,7303,1,162360000,162360000,10951,3650,7301,3650,0,1,3652,488922
168,3650,2000,2300,4600000,2,29206,7303,1,162360000,162360000,10951,3650,7301,3650,0,1,3652,484469
168,3650,2000,2300,4600000,2,29206,7303,1,162360000,162360000,10951,3650,7301,3650,0,1,3652,485837
168,4050,2000,2300,4600000,2,32406,8103,1,176120000,176120000,12151,4050,8101,4050,0,1,4052,4906882
168,4050,2000,2300,4600000,2,32406,8103,1,176120000,176120000,12151,4050,8101,4050,0,1,4052,527985
168,4050,2000,2300,4600000,2,32406,8103,1,176120000,176120000,12151,4050,8101,4050,0,1,4052,518914
168,4050,2000,2300,4600000,2,32406,8103,1,176120000,176120000,12151,4050,8101,4050,0,1,4052,532155
168,4050,2000,2300,4600000,2,32406,8103,1,176120000,176120000,12151,4050,8101,4050,0,1,4052,542298
168,4050,2000,2300,4600000,2,32406,8103,1,176120000,176120000,12151,4050,8101,4050,0,1,4052,541513
168,4050,2000,2300,4600000,2,32406,8103,1,176120000,176120000,12151,4050,8101,4050,0,1,4052,540596
168,4450,2000,2300,4600000,2,35606,8903,1,189880000,189880000,13351,4450,8901,4450,0,1,4452,5633126
168,4450,2000,2300,4600000,2,35606,8903,1,189880000,189880000,13351,4450,8901,4450,0,1,4452,562818
168,4450,2000,2300,4600000,2,35606,8903,1,189880000,189880000,13351,4450,8901,4450,0,1,4452,567515
168,4450,2000,2300,4600000,2,35606,8903,1,189880000,189880000,13351,4450,8901,4450,0,1,4452,568365
168,4450,2000,2300,4600000,2,35606,8903,1,189880000,189880000,13351,4450,8901,4450,0,1,4452,566336
168,4450,2000,2300,4600000,2,35606,8903,1,189880000,189880000,13351,4450,8901,4450,0,1,4452,575309
168,4450,2000,2300,4600000,2,35606,8903,1,189880000,189880000,13351,4450,8901,4450,0,1,4452,574799
168,4850,2000,2300,4600000,2,38806,9703,1,203640000,203640000,14551,4850,9701,4850,0,1,4852,6191196
168,4850,2000,2300,4600000,2,38806,9703,1,203640000,203640000,14551,4850,9701,4850,0,1,4852,597565
168,4850,2000,2300,4600000,2,38806,9703,1,203640000,203640000,14551,4850,9701,4850,0,1,4852,599297
168,4850,2000,2300,4600000,2,38806,9703,1,203640000,203640000,14551,4850,9701,4850,0,1,4852,595073
168,4850,2000,2300,4600000,2,38806,9703,1,203640000,203640000,14551,4850,9701,4850,0,1,4852,596646
168,4850,2000,2300,4600000,2,38806,9703,1,203640000,203640000,14551,4850,9701,4850,0,1,4852,645254
168,4850,2000,2300,4600000,2,38806,9703,1,203640000,203640000,14551,4850,9701,4850,0,1,4852,644015
168,5250,2000,2300,4600000,2,42006,10503,1,217400000,217400000,15751,5250,10501,5250,0,1,5252,6269965
168,5250,2000,2300,4600000,2,42006,10503,1,217400000,217400000,15751,5250,10501,5250,0,1,5252,681979
168,5250,2000,2300,4600000,2,42006,10503,1,217400000,217400000,15751,5250,10501,5250,0,1,5252,692145
168,5250,2000,2300,4600000,2,42006,10503,1,217400000,217400000,15751,5250,10501,5250,0,1,5252,690521
168,5250,2000,2300,4600000,2,42006,10503,1,217400000,217400000,15751,5250,10501,5250,0,1,5252,693299
168,5250,2000,2300,4600000,2,42006,10503,1,217400000,217400000,15751,5250,10501,5250,0,1,5252,702444
168,5250,2000,2300,4600000,2,42006,10503,1,217400000,217400000,15751,5250,10501,5250,0,1,5252,702989
168,5650,2000,2300,4600000,2,45206,11303,1,231160000,231160000,16951,5650,11301,5650,0,1,5652,7316842
168,5650,2000,2300,4600000,2,45206,11303,1,231160000,231160000,16951,5650,11301,5650,0,1,5652,686883
168,5650,2000,2300,4600000,2,45206,11303,1,231160000,231160000,16951,5650,11301,5650,0,1,5652,685936
168,5650,2000,2300,4600000,2,45206,11303,1,231160000,231160000,16951,5650,11301,5650,0,1,5652,687552
168,5650,2000,2300,4600000,2,45206,11303,1,231160000,231160000,16951,5650,11301,5650,0,1,5652,688103
168,5650,2000,2300,4600000,2,45206,11303,1,231160000,231160000,16951,5650,11301,5650,0,1,5652,756691
168,5650,2000,2300,4600000,2,45206,11303,1,231160000,231160000,16951,5650,11301,5650,0,1,5652,756122
168,6050,2000,2300,4600000,2,48406,12103,1,244920000,244920000,18151,6050,12101,6050,0,1,6052,7415049
168,6050,2000,2300,4600000,2,48406,12103,1,244920000,244920000,18151,6050,12101,6050,0,1,6052,743673
168,6050,2000,2300,4600000,2,48406,12103,1,244920000,244920000,18151,6050,12101,6050,0,1,6052,734431
168,6050,2000,2300,4600000,2,48406,12103,1,244920000,244920000,18151,6050,12101,6050,0,1,6052,740483
168,6050,2000,2300,4600000,2,48406,12103,1,244920000,244920000,18151,6050,12101,6050,0,1,6052,737424
168,6050,2000,2300,4600000,2,48406,12103,1,244920000,244920000,18151,6050,12101,6050,0,1,6052,776135
168,6050,2000,2300,4600000,2,48406,12103,1,244920000,244920000,18151,6050,12101,6050,0,1,6052,776710
168,6450,2000,2300,4600000,2,51606,12903,1,258680000,258680000,19351,6450,12901,6450,0,1,6452,8258410
168,6450,2000,2300,4600000,2,51606,12903,1,258680000,258680000,19351,6450,12901,6450,0,1,6452,771600
168,6450,2000,2300,4600000,2,51606,12903,1,258680000,258680000,19351,6450,12901,6450,0,1,6452,768492
168,6450,2000,2300,4600000,2,51606,12903,1,258680000,258680000,19351,6450,12901,6450,0,1,6452,772429
168,6450,2000,2300,4600000,2,51606,12903,1,258680000,258680000,19351,6450,12901,6450,0,1,6452,784663
168,6450,2000,2300,4600000,2,51606,12903,1,258680000,258680000,19351,6450,12901,6450,0,1,6452,833834
168,6450,2000,2300,4600000,2,51606,12903,1,258680000,258680000,19351,6450,12901,6450,0,1,6452,835248
168,6850,2000,2300,4600000,2,54806,13703,1,272440000,272440000,20551,6850,13701,6850,0,1,6852,8848890
168,6850,2000,2300,4600000,2,54806,13703,1,272440000,272440000,20551,6850,13701,6850,0,1,6852,836634
168,6850,2000,2300,4600000,2,54806,13703,1,272440000,272440000,20551,6850,13701,6850,0,1,6852,831130
168,6850,2000,2300,4600000,2,54806,13703,1,272440000,272440000,20551,6850,13701,6850,0,1,6852,838443
168,6850,2000,2300,4600000,2,54806,13703,1,272440000,272440000,20551,6850,13701,6850,0,1,6852,839944
168,6850,2000,2300,4600000,2,54806,13703,1,272440000,272440000,20551,6850,13701,6850,0,1,6852,864863
168,6850,2000,2300,4600000,2,54806,13703,1,272440000,272440000,20551,6850,13701,6850,0,1,6852,865488
168,50,2000,1900,3800000,2,406,103,1,31960000,31960000,151,50,101,50,0,1,52,38612
168,50,2000,1900,3800000,2,406,103,1,31960000,31960000,151,50,101,50,0,1,52,46455
168,50,2000,1900,3800000,2,406,103,1,31960000,31960000,151,50,101,50,0,1,52,45795
168,50,2000,1900,3800000,2,406,103,1,31960000,31960000,151,50,101,50,0,1,52,46869
168,50,2000,1900,3800000,2,406,103,1,31960000,31960000,151,50,101,50,0,1,52,44937
168,50,2000,1900,3800000,2,406,103,1,31960000,31960000,151,50,101,50,0,1,52,52416
168,50,2000,1900,3800000,2,406,103,1,31960000,31960000,151,50,101,50,0,1,52,51991
168,450,2000,1900,3800000,2,3606,903,1,44440000,44440000,1351,450,901,450,0,1,452,373470
168,450,2000,1900,3800000,2,3606,903,1,44440000,44440000,1351,450,901,450,0,1,452,76344
168,450,2000,1900,3800000,2,3606,903,1,44440000,44440000,1351,450,901,450,0,1,452,79685
168,450,2000,1900,3800000,2,3606,903,1,44440000,44440000,1351,450,901,450,0,1,452,80118
168,450,2000,1900,3800000,2,3606,903,1,44440000,44440000,1351,450,901,450,0,1,452,72019
168,450,2000,1900,3800000,2,3606,903,1,44440000,44440000,1351,450,901,450,0,1,452,90058
168,450,2000,1900,3800000,2,3606,903,1,44440000,44440000,1351,450,901,450,0,1,452,90520
168,850,2000,1900,3800000,2,6806,1703,1,56920000,56920000,2551,850,1701,850,0,1,852,766128
168,850,2000,1900,3800000,2,6806,1703,1,56920000,56920000,2551,850,1701,850,0,1,852,119473
168,850,2000,1900,3800000,2,6806,1703,1,56920000,56920000,2551,850,1701,850,0,1,852,121714
168,850,2000,1900,3800000,2,6806,1703,1,56920000,56920000,2551,850,1701,850,0,1,852,121232
168,850,2000,1900,3800000,2,6806,1703,1,56920000,56920000,2551,850,1701,850,0,1,852,114052
168,850,2000,1900,3800000,2,6806,1703,1,56920000,56920000,2551,850,1701,850,0,1,852,133247
168,850,2000,1900,3800000,2,6806,1703,1,56920000,56920000,2551,850,1701,850,0,1,852,132094
168,1250,2000,1900,3800000,2,10006,2503,1,69400000,69400000,3751,1250,2501,1250,0,1,1252,1141484
168,1250,2000,1900,3800000,2,10006,2503,1,69400000,69400000,3751,1250,2501,1250,0,1,1252,156006
168,1250,2000,1900,3800000,2,10006,2503,1,69400000,69400000,3751,1250,2501,1250,0,1,1252,151678
168,1250,2000,1900,3800000,2,10006,2503,1,69400000,69400000,3751,1250,2501,1250,0,1,1252,152697
168,1250,2000,1900,3800000,2,10006,2503,1,69400000,69400000,3751,1250,2501,1250,0,1,1252,156511
168,1250,2000,1900,3800000,2,10006,2503,1,69400000,69400000,3751,1250,2501,1250,0,1,1252,172481
168,1250,2000,1900,3800000,2,10006,2503,1,69400000,69400000,3751,1250,2501,1250,0,1,1252,173001
168,1650,2000,1900,3800000,2,13206,3303,1,81880000,81880000,4951,1650,3301,1650,0,1,1652,1530556
168,1650,2000,1900,3800000,2,13206,3303,1,81880000,81880000,4951,1650,3301,1650,0,1,1652,209181
168,1650,2000,1900,3800000,2,13206,3303,1,81880000,81880000,4951,1650,3301,1650,0,1,1652,208727
168,1650,2000,1900,3800000,2,13206,3303,1,81880000,81880000,4951,1650,3301,1650,0,1,1652,206672
168,1650,2000,1900,3800000,2,13206,3303,1,81880000,81880000,4951,1650,3301,1650,0,1,1652,208066
168,1650,2000,1900,3800000,2,13206,3303,1,81880000,81880000,4951,1650,3301,1650,0,1,1652,210965
168,1650,2000,1900,3800000,2,13206,3303,1,81880000,81880000,4951,1650,3301,1650,0,1,1652,210571
168,2050,2000,1900,3800000,2,16406,4103,1,94360000,94360000,6151,2050,4101,2050,0,1,2052,1977875
168,2050,2000,1900,3800000,2,16406,4103,1,94360000,94360000,6151,2050,4101,2050,0,1,2052,251858
168,2050,2000,1900,3800000,2,16406,4103,1,94360000,94360000,6151,2050,4101,2050,0,1,2052,252518
168,2050,2000,1900,3800000,2,16406,4103,1,94360000,94360000,6151,2050,4101,2050,0,1,2052,251460
168,2050,2000,1900,3800000,2,16406,4103,1,94360000,94360000,6151,2050,4101,2050,0,1,2052,252166
168,2050,2000,1900,3800000,2,16406,4103,1,94360000,94360000,6151,2050,4101,2050,0,1,2052,247593
168,2050,2000,1900,3800000,2,16406,4103,1,94360000,94360000,6151,2050,4101,2050,0,1,2052,249005
168,2450,2000,1900,3800000,2,19606,4903,1,106840000,106840000,7351,2450,4901,2450,0,1,2452,2425406
168,2450,2000,1900,3800000,2,19606,4903,1,106840000,106840000,7351,2450,4901,2450,0,1,2452,288690
168,2450,2000,1900,3800000,2,19606,4903,1,106840000,106840000,7351,2450,4901,2450,0,1,2452,289905
168,2450,2000,1900,3800000,2,19606,4903,1,106840000,106840000,7351,2450,4901,2450,0,1,2452,274371
168,2450,2000,1900,3800000,2,19606,4903,1,106840000,106840000,7351,2450,4901,2450,0,1,2452,288281
168,2450,2000,1900,3800000,2,19606,4903,1,106840000,106840000,7351,2450,4901,2450,0,1,2452,287220
168,2450,2000,1900,3800000,2,19606,4903,1,106840000,106840000,7351,2450,4901,2450,0,1,2452,286024
168,2850,2000,1900,3800000,2,22806,5703,1,119320000,119320000,8551,2850,5701,2850,0,1,2852,2966595
168,2850,2000,1900,3800000,2,22806,5703,1,119320000,119320000,8551,2850,5701,2850,0,1,2852,331525
168,2850,2000,1900,3800000,2,22806,5703,1,119320000,119320000,8551,2850,5701,2850,0,1,2852,332024
168,2850,2000,1900,3800000,2,22806,5703,1,119320000,119320000,8551,2850,5701,2850,0,1,2852,332371
168,2850,2000,1900,3800000,2,22806,5703,1,119320000,119320000,8551,2850,5701,2850,0,1,2852,330981
168,2850,2000,1900,3800000,2,22806,5703,1,119320000,119320000,8551,2850,5701,2850,0,1,2852,326301
168,2850,2000,1900,3800000,2,22806,5703,1,119320000,119320000,8551,2850,5701,2850,0,1,2852,327577
168,3250,2000,1900,3800000,2,26006,6503,1,131800000,131800000,9751,3250,6501,3250,0,1,3252,3332625
168,3250,2000,1900,3800000,2,26006,6503,1,131800000,131800000,9751,3250,6501,3250,0,1,3252,392915
168,3250,2000,1900,3800000,2,26006,6503,1,131800000,131800000,9751,3250,6501,3250,0,1,3252,393410
168,3250,2000,1900,3800000,2,26006,6503,1,131800000,131800000,9751,3250,6501,3250,0,1,3252,393944
168,3250,2000,1900,3800000,2,26006,6503,1,131800000,131800000,9751,3250,6501,3250,0,1,3252,392305
168,3250,2000,1900,3800000,2,26006,6503,1,131800000,131800000,9751,3250,6501,3250,0,1,3252,387821
168,3250,2000,1900,3800000,2,26006,6503,1,131800000,131800000,9751,3250,6501,3250,0,1,3252,385835
168,3650,2000,1900,3800000,2,29206,7303,1,144280000,144280000,10951,3650,7301,3650,0,1,3652,3501634
168,3650,2000,1900,3800000,2,29206,7303,1,144280000,144280000,10951,3650,7301,3650,0,1,3652,416132
168,3650,2000,1900,3800000,2,29206,7303,1,144280000,144280000,10951,3650,7301,3650,0,1,3652,414010
168,3650,2000,1900,3800000,2,29206,7303,1,144280000,144280000,10951,3650,7301,3650,0,1,3652,416737
168,3650,2000,1900,3800000,2,29206,7303,1,144280000,144280000,10951,3650,7301,3650,0,1,3652,415466
168,3650,2000,1900,3800000,2,29206,7303,1,144280000,144280000,10951,3650,7301,3650,0,1,3652,407390
168,3650,2000,1900,3800000,2,29206,7303,1,144280000,144280000,10951,3650,7301,3650,0,1,3652,406158
168,4050,2000,1900,3800000,2,32406,8103,1,156760000,156760000,12151,4050,8101,4050,0,1,4052,4025457
168,4050,2000,1900,3800000,2,32406,8103,1,156760000,156760000,12151,4050,8101,4050,0,1,4052,460368
168,4050,2000,1900,3800000,2,32406,8103,1,156760000,156760000,12151,4050,8101,4050,0,1,4052,448979
168,4050,2000,1900,3800000,2,32406,8103,1,156760000,156760000,12151,4050,8101,4050,0,1,4052,458895
168,4050,2000,1900,3800000,2,32406,8103,1,156760000,156760000,12151,4050,8101,4050,0,1,4052,451464
168,4050,2000,1900,3800000,2,32406,8103,1,156760000,156760000,12151,4050,8101,4050,0,1,4052,453087
168,4050,2000,1900,3800000,2,32406,8103,1,156760000,156760000,12151,4050,8101,4050,0,1,4052,452291
168,4450,2000,1900,3800000,2,35606,8903,1,169240000,169240000,13351,4450,8901,4450,0,1,4452,4465614
168,4450,2000,1900,3800000,2,35606,8903,1,169240000,169240000,13351,4450,8901,4450,0,1,4452,456311
168,4450,2000,1900,3800000,2,35606,8903,1,169240000,169240000,13351,4450,8901,4450,0,1,4452,460642
168,4450,2000,1900,3800000,2,35606,8903,1,169240000,169240000,13351,4450,8901,4450,0,1,4452,461188
168,4450,2000,1900,3800000,2,35606,8903,1,169240000,169240000,13351,4450,8901,4450,0,1,4452,460053
168,4450,2000,1900,3800000,2,35606,8903,1,169240000,169240000,13351,4450,8901,4450,0,1,4452,510457
168,4450,2000,1900,3800000,2,35606,8903,1,169240000,169240000,13351,4450,8901,4450,0,1,4452,510987
168,4850,2000,1900,3800000,2,38806,9703,1,181720000,181720000,14551,4850,9701,4850,0,1,4852,4863414
168,4850,2000,1900,3800000,2,38806,9703,1,181720000,181720000,14551,4850,9701,4850,0,1,4852,498199
168,4850,2000,1900,3800000,2,38806,9703,1,181720000,181720000,14551,4850,9701,4850,0,1,4852,499302
168,4850,2000,1900,3800000,2,38806,9703,1,181720000,181720000,14551,4850,9701,4850,0,1,4852,500187
168,4850,2000,1900,3800000,2,38806,9703,1,181720000,181720000,14551,4850,9701,4850,0,1,4852,512539
168,4850,2000,1900,3800000,2,38806,9703,1,181720000,181720000,14551,4850,9701,4850,0,1,4852,579352
168,4850,2000,1900,3800000,2,38806,9703,1,181720000,181720000,14551,4850,9701,4850,0,1,4852,579879
168,5250,2000,1900,3800000,2,42006,10503,1,194200000,194200000,15751,5250,10501,5250,0,1,5252,5384209
168,5250,2000,1900,3800000,2,42006,10503,1,194200000,194200000,15751,5250,10501,5250,0,1,5252,538870
168,5250,2000,1900,3800000,2,42006,10503,1,194200000,194200000,15751,5250,10501,5250,0,1,5252,535957
168,5250,2000,1900,3800000,2,42006,10503,1,194200000,194200000,15751,5250,10501,5250,0,1,5252,539583
168,5250,2000,1900,3800000,2,42006,10503,1,194200000,194200000,15751,5250,10501,5250,0,1,5252,536905
168,5250,2000,1900,3800000,2,42006,10503,1,194200000,194200000,15751,5250,10501,5250,0,1,5252,610090
168,5250,2000,1900,3800000,2,42006,10503,1,194200000,194200000,15751,5250,10501,5250,0,1,5252,609556
168,5650,2000,1900,3800000,2,45206,11303,1,206680000,206680000,16951,5650,11301,5650,0,1,5652,5801938
168,5650,2000,1900,3800000,2,45206,11303,1,206680000,206680000,16951,5650,11301,5650,0,1,5652,583397
168,5650,2000,1900,3800000,2,45206,11303,1,206680000,206680000,16951,5650,11301,5650,0,1,5652,582180
168,5650,2000,1900,3800000,2,45206,11303,1,206680000,206680000,16951,5650,11301,5650,0,1,5652,585510
168,5650,2000,1900,3800000,2,45206,11303,1,206680000,206680000,16951,5650,11301,5650,0,1,5652,584774
168,5650,2000,1900,3800000,2,45206,11303,1,206680000,206680000,16951,5650,11301,5650,0,1,5652,654846
168,5650,2000,1900,3800000,2,45206,11303,1,206680000,206680000,16951,5650,11301,5650,0,1,5652,653557
168,6050,2000,1900,3800000,2,48406,12103,1,219160000,219160000,18151,6050,12101,6050,0,1,6052,6115521
168,6050,2000,1900,3800000,2,48406,12103,1,219160000,219160000,18151,6050,12101,6050,0,1,6052,613525
168,6050,2000,1900,3800000,2,48406,12103,1,219160000,219160000,18151,6050,12101,6050,0,1,6052,627560
168,6050,2000,1900,3800000,2,48406,12103,1,219160000,219160000,18151,6050,12101,6050,0,1,6052,612718
168,6050,2000,1900,3800000,2,48406,12103,1,219160000,219160000,18151,6050,12101,6050,0,1,6052,608728
168,6050,2000,1900,3800000,2,48406,12103,1,219160000,219160000,18151,6050,12101,6050,0,1,6052,684083
168,6050,2000,1900,3800000,2,48406,12103,1,219160000,219160000,18151,6050,12101,6050,0,1,6052,682784
168,6450,2000,1900,3800000,2,51606,12903,1,231640000,231640000,19351,6450,12901,6450,0,1,6452,6483963
168,6450,2000,1900,3800000,2,51606,12903,1,231640000,231640000,19351,6450,12901,6450,0,1,6452,657890
168,6450,2000,1900,3800000,2,51606,12903,1,231640000,231640000,19351,6450,12901,6450,0,1,6452,661283
168,6450,2000,1900,3800000,2,51606,12903,1,231640000,231640000,19351,6450,12901,6450,0,1,6452,661995
168,6450,2000,1900,3800000,2,51606,12903,1,231640000,231640000,19351,6450,12901,6450,0,1,6452,662596
168,6450,2000,1900,3800000,2,51606,12903,1,231640000,231640000,19351,6450,12901,6450,0,1,6452,714298
168,6450,2000,1900,3800000,2,51606,12903,1,231640000,231640000,19351,6450,12901,6450,0,1,6452,713689
168,6850,2000,1900,3800000,2,54806,13703,1,244120000,244120000,20551,6850,13701,6850,0,1,6852,6923151
168,6850,2000,1900,3800000,2,54806,13703,1,244120000,244120000,20551,6850,13701,6850,0,1,6852,706413
168,6850,2000,1900,3800000,2,54806,13703,1,244120000,244120000,20551,6850,13701,6850,0,1,6852,682144
168,6850,2000,1900,3800000,2,54806,13703,1,244120000,244120000,20551,6850,13701,6850,0,1,6852,704707
168,6850,2000,1900,3800000,2,54806,13703,1,244120000,244120000,20551,6850,13701,6850,0,1,6852,678801
168,6850,2000,1900,3800000,2,54806,13703,1,244120000,244120000,20551,6850,13701,6850,0,1,6852,761820
168,6850,2000,1900,3800000,2,54806,13703,1,244120000,244120000,20551,6850,13701,6850,0,1,6852,761053
168,50,2000,1500,3000000,2,406,103,1,25400000,25400000,151,50,101,50,0,1,52,29667
168,50,2000,1500,3000000,2,406,103,1,25400000,25400000,151,50,101,50,0,1,52,30163
168,50,2000,1500,3000000,2,406,103,1,25400000,25400000,151,50,101,50,0,1,52,34535
168,50,2000,1500,3000000,2,406,103,1,25400000,25400000,151,50,101,50,0,1,52,34125
168,50,2000,1500,3000000,2,406,103,1,25400000,25400000,151,50,101,50,0,1,52,27839
168,50,2000,1500,3000000,2,406,103,1,25400000,25400000,151,50,101,50,0,1,52,42036
168,50,2000,1500,3000000,2,406,103,1,25400000,25400000,151,50,101,50,0,1,52,41611
168,450,2000,1500,3000000,2,3606,903,1,36600000,36600000,1351,450,901,450,0,1,452,306765
168,450,2000,1500,3000000,2,3606,903,1,36600000,36600000,1351,450,901,450,0,1,452,58793
168,450,2000,1500,3000000,2,3606,903,1,36600000,36600000,1351,450,901,450,0,1,452,67979
168,450,2000,1500,3000000,2,3606,903,1,36600000,36600000,1351,450,901,450,0,1,452,68447
168,450,2000,1500,3000000,2,3606,903,1,36600000,36600000,1351,450,901,450,0,1,452,66327
168,450,2000,1500,3000000,2,3606,903,1,36600000,36600000,1351,450,901,450,0,1,452,75495
168,450,2000,1500,3000000,2,3606,903,1,36600000,36600000,1351,450,901,450,0,1,452,72452
168,850,2000,1500,3000000,2,6806,1703,1,47800000,47800000,2551,850,1701,850,0,1,852,603501
168,850,2000,1500,3000000,2,6806,1703,1,47800000,47800000,2551,850,1701,850,0,1,852,98374
168,850,2000,1500,3000000,2,6806,1703,1,47800000,47800000,2551,850,1701,850,0,1,852,97118
168,850,2000,1500,3000000,2,6806,1703,1,47800000,47800000,2551,850,1701,850,0,1,852,98019
168,850,2000,1500,3000000,2,6806,1703,1,47800000,47800000,2551,850,1701,850,0,1,852,98854
168,850,2000,1500,3000000,2,6806,1703,1,47800000,47800000,2551,850,1701,850,0,1,852,108838
168,850,2000,1500,3000000,2,6806,1703,1,47800000,47800000,2551,850,1701,850,0,1,852,108357
168,1250,2000,1500,3000000,2,10006,2503,1,59000000,59000000,3751,1250,2501,1250,0,1,1252,894480
168,1250,2000,1500,3000000,2,10006,2503,1,59000000,59000000,3751,1250,2501,1250,0,1,1252,131166
168,1250,2000,1500,3000000,2,10006,2503,1,59000000,59000000,3751,1250,2501,1250,0,1,1252,129348
168,1250,2000,1500,3000000,2,10006,2503,1,59000000,59000000,3751,1250,2501,1250,0,1,1252,124907
168,1250,2000,1500,3000000,2,10006,2503,1,59000000,59000000,3751,1250,2501,1250,0,1,1252,131673
168,1250,2000,1500,3000000,2,10006,2503,1,59000000,59000000,3751,1250,2501,1250,0,1,1252,143927
168,1250,2000,1500,3000000,2,10006,2503,1,59000000,59000000,3751,1250,2501,1250,0,1,1252,143407
168,1650,2000,1500,3000000,2,13206,3303,1,70200000,70200000,4951,1650,3301,1650,0,1,1652,1250776
168,1650,2000,1500,3000000,2,13206,3303,1,70200000,70200000,4951,1650,3301,1650,0,1,1652,166913
168,1650,2000,1500,3000000,2,13206,3303,1,70200000,70200000,4951,1650,3301,1650,0,1,1652,164893
168,1650,2000,1500,3000000,2,13206,3303,1,70200000,70200000,4951,1650,3301,1650,0,1,1652,166133
168,1650,2000,1500,3000000,2,13206,3303,1,70200000,70200000,4951,1650,3301,1650,0,1,1652,166618
168,1650,2000,1500,3000000,2,13206,3303,1,70200000,70200000,4951,1650,3301,1650,0,1,1652,178869
168,1650,2000,1500,3000000,2,13206,3303,1,70200000,70200000,4951,1650,3301,1650,0,1,1652,179421
168,2050,2000,1500,3000000,2,16406,4103,1,81400000,81400000,6151,2050,4101,2050,0,1,2052,1513394
168,2050,2000,1500,3000000,2,16406,4103,1,81400000,81400000,6151,2050,4101,2050,0,1,2052,191775
168,2050,2000,1500,3000000,2,16406,4103,1,81400000,81400000,6151,2050,4101,2050,0,1,2052,194079
168,2050,2000,1500,3000000,2,16406,4103,1,81400000,81400000,6151,2050,4101,2050,0,1,2052,193526
168,2050,2000,1500,3000000,2,16406,4103,1,81400000,81400000,6151,2050,4101,2050,0,1,2052,192734
168,2050,2000,1500,3000000,2,16406,4103,1,81400000,81400000,6151,2050,4101,2050,0,1,2052,205443
168,2050,2000,1500,3000000,2,16406,4103,1,81400000,81400000,6151,2050,4101,2050,0,1,2052,205851
168,2450,2000,1500,3000000,2,19606,4903,1,92600000,92600000,7351,2450,4901,2450,0,1,2452,1863095
168,2450,2000,1500,3000000,2,19606,4903,1,92600000,92600000,7351,2450,4901,2450,0,1,2452,241632
168,2450,2000,1500,3000000,2,19606,4903,1,92600000,92600000,7351,2450,4901,2450,0,1,2452,240493
168,2450,2000,1500,3000000,2,19606,4903,1,92600000,92600000,7351,2450,4901,2450,0,1,2452,241103
168,2450,2000,1500,3000000,2,19606,4903,1,92600000,92600000,7351,2450,4901,2450,0,1,2452,235983
168,2450,2000,1500,3000000,2,19606,4903,1,92600000,92600000,7351,2450,4901,2450,0,1,2452,239228
168,2450,2000,1500,3000000,2,19606,4903,1,92600000,92600000,7351,2450,4901,2450,0,1,2452,238197
168,2850,2000,1500,3000000,2,22806,5703,1,103800000,103800000,8551,2850,5701,2850,0,1,2852,2190658
168,2850,2000,1500,3000000,2,22806,5703,1,103800000,103800000,8551,2850,5701,2850,0,1,2852,270970
168,2850,2000,1500,3000000,2,22806,5703,1,103800000,103800000,8551,2850,5701,2850,0,1,2852,271806
168,2850,2000,1500,3000000,2,22806,5703,1,103800000,103800000,8551,2850,5701,2850,0,1,2852,272311
168,2850,2000,1500,3000000,2,22806,5703,1,103800000,103800000,8551,2850,5701,2850,0,1,2852,272658
168,2850,2000,1500,3000000,2,22806,5703,1,103800000,103800000,8551,2850,5701,2850,0,1,2852,270468
168,2850,2000,1500,3000000,2,22806,5703,1,103800000,103800000,8551,2850,5701,2850,0,1,2852,269147
168,3250,2000,1500,3000000,2,26006,6503,1,115000000,115000000,9751,3250,6501,3250,0,1,3252,2597181
168,3250,2000,1500,3000000,2,26006,6503,1,115000000,115000000,9751,3250,6501,3250,0,1,3252,296619
168,3250,2000,1500,3000000,2,26006,6503,1,115000000,115000000,9751,3250,6501,3250,0,1,3252,311781
168,3250,2000,1500,3000000,2,26006,6503,1,115000000,115000000,9751,3250,6501,3250,0,1,3252,310637
168,3250,2000,1500,3000000,2,26006,6503,1,115000000,115000000,9751,3250,6501,3250,0,1,3252,314679
168,3250,2000,1500,3000000,2,26006,6503,1,115000000,115000000,9751,3250,6501,3250,0,1,3252,315643
168,3250,2000,1500,3000000,2,26006,6503,1,115000000,115000000,9751,3250,6501,3250,0,1,3252,315187
168,3650,2000,1500,3000000,2,29206,7303,1,126200000,126200000,10951,3650,7301,3650,0,1,3652,2792802
168,3650,2000,1500,3000000,2,29206,7303,1,126200000,126200000,10951,3650,7301,3650,0,1,3652,340325
168,3650,2000,1500,3000000,2,29206,7303,1,126200000,126200000,10951,3650,7301,3650,0,1,3652,336436
168,3650,2000,1500,3000000,2,29206,7303,1,126200000,126200000,10951,3650,7301,3650,0,1,3652,340926
168,3650,2000,1500,3000000,2,29206,7303,1,126200000,126200000,10951,3650,7301,3650,0,1,3652,339582
168,3650,2000,1500,3000000,2,29206,7303,1,126200000,126200000,10951,3650,7301,3650,0,1,3652,341526
168,3650,2000,1500,3000000,2,29206,7303,1,126200000,126200000,10951,3650,7301,3650,0,1,3652,341998
168,4050,2000,1500,3000000,2,32406,8103,1,137400000,137400000,12151,4050,8101,4050,0,1,4052,3093632
168,4050,2000,1500,3000000,2,32406,8103,1,137400000,137400000,12151,4050,8101,4050,0,1,4052,366089
168,4050,2000,1500,3000000,2,32406,8103,1,137400000,137400000,12151,4050,8101,4050,0,1,4052,369068
168,4050,2000,1500,3000000,2,32406,8103,1,137400000,137400000,12151,4050,8101,4050,0,1,4052,370323
168,4050,2000,1500,3000000,2,32406,8103,1,137400000,137400000,12151,4050,8101,4050,0,1,4052,371096
168,4050,2000,1500,3000000,2,32406,8103,1,137400000,137400000,12151,4050,8101,4050,0,1,4052,373481
168,4050,2000,1500,3000000,2,32406,8103,1,137400000,137400000,12151,4050,8101,4050,0,1,4052,372992
168,4450,2000,1500,3000000,2,35606,8903,1,148600000,148600000,13351,4450,8901,4450,0,1,4452,3448958
168,4450,2000,1500,3000000,2,35606,8903,1,148600000,148600000,13351,4450,8901,4450,0,1,4452,378809
168,4450,2000,1500,3000000,2,35606,8903,1,148600000,148600000,13351,4450,8901,4450,0,1,4452,377757
168,4450,2000,1500,3000000,2,35606,8903,1,148600000,148600000,13351,4450,8901,4450,0,1,4452,378347
168,4450,2000,1500,3000000,2,35606,8903,1,148600000,148600000,13351,4450,8901,4450,0,1,4452,376187
168,4450,2000,1500,3000000,2,35606,8903,1,148600000,148600000,13351,4450,8901,4450,0,1,4452,408060
168,4450,2000,1500,3000000,2,35606,8903,1,148600000,148600000,13351,4450,8901,4450,0,1,4452,408593
168,4850,2000,1500,3000000,2,38806,9703,1,159800000,159800000,14551,4850,9701,4850,0,1,4852,3852219
168,4850,2000,1500,3000000,2,38806,9703,1,159800000,159800000,14551,4850,9701,4850,0,1,4852,409460
168,4850,2000,1500,3000000,2,38806,9703,1,159800000,159800000,14551,4850,9701,4850,0,1,4852,411204
168,4850,2000,1500,3000000,2,38806,9703,1,159800000,159800000,14551,4850,9701,4850,0,1,4852,410096
168,4850,2000,1500,3000000,2,38806,9703,1,159800000,159800000,14551,4850,9701,4850,0,1,4852,410719
168,4850,2000,1500,3000000,2,38806,9703,1,159800000,159800000,14551,4850,9701,4850,0,1,4852,451670
168,4850,2000,1500,3000000,2,38806,9703,1,159800000,159800000,14551,4850,9701,4850,0,1,4852,451173
168,5250,2000,1500,3000000,2,42006,10503,1,171000000,171000000,15751,5250,10501,5250,0,1,5252,4170892
168,5250,2000,1500,3000000,2,42006,10503,1,171000000,171000000,15751,5250,10501,5250,0,1,5252,435548
168,5250,2000,1500,3000000,2,42006,10503,1,171000000,171000000,15751,5250,10501,5250,0,1,5252,440172
168,5250,2000,1500,3000000,2,42006,10503,1,171000000,171000000,15751,5250,10501,5250,0,1,5252,435000
168,5250,2000,1500,3000000,2,42006,10503,1,171000000,171000000,15751,5250,10501,5250,0,1,5252,434263
168,5250,2000,1500,3000000,2,42006,10503,1,171000000,171000000,15751,5250,10501,5250,0,1,5252,479810
168,5250,2000,1500,3000000,2,42006,10503,1,171000000,171000000,15751,5250,10501,5250,0,1,5252,480351
168,5650,2000,1500,3000000,2,45206,11303,1,182200000,182200000,16951,5650,11301,5650,0,1,5652,4425831
168,5650,2000,1500,3000000,2,45206,11303,1,182200000,182200000,16951,5650,11301,5650,0,1,5652,469507
168,5650,2000,1500,3000000,2,45206,11303,1,182200000,182200000,16951,5650,11301,5650,0,1,5652,470042
168,5650,2000,1500,3000000,2,45206,11303,1,182200000,182200000,16951,5650,11301,5650,0,1,5652,468471
168,5650,2000,1500,3000000,2,45206,11303,1,182200000,182200000,16951,5650,11301,5650,0,1,5652,469016
168,5650,2000,1500,3000000,2,45206,11303,1,182200000,182200000,16951,5650,11301,5650,0,1,5652,517009
168,5650,2000,1500,3000000,2,45206,11303,1,182200000,182200000,16951,5650,11301,5650,0,1,5652,517564
168,6050,2000,1500,3000000,2,48406,12103,1,193400000,193400000,18151,6050,12101,6050,0,1,6052,4758840
168,6050,2000,1500,3000000,2,48406,12103,1,193400000,193400000,18151,6050,12101,6050,0,1,6052,500240
168,6050,2000,1500,3000000,2,48406,12103,1,193400000,193400000,18151,6050,12101,6050,0,1,6052,502684
168,6050,2000,1500,3000000,2,48406,12103,1,193400000,193400000,18151,6050,12101,6050,0,1,6052,501879
168,6050,2000,1500,3000000,2,48406,12103,1,193400000,193400000,18151,6050,12101,6050,0,1,6052,503468
168,6050,2000,1500,3000000,2,48406,12103,1,193400000,193400000,18151,6050,12101,6050,0,1,6052,557484
168,6050,2000,1500,3000000,2,48406,12103,1,193400000,193400000,18151,6050,12101,6050,0,1,6052,558066
168,6450,2000,1500,3000000,2,51606,12903,1,204600000,204600000,19351,6450,12901,6450,0,1,6452,5098781
168,6450,2000,1500,3000000,2,51606,12903,1,204600000,204600000,19351,6450,12901,6450,0,1,6452,540153
168,6450,2000,1500,3000000,2,51606,12903,1,204600000,204600000,19351,6450,12901,6450,0,1,6452,527207
168,6450,2000,1500,3000000,2,51606,12903,1,204600000,204600000,19351,6450,12901,6450,0,1,6452,551118
168,6450,2000,1500,3000000,2,51606,12903,1,204600000,204600000,19351,6450,12901,6450,0,1,6452,535695
168,6450,2000,1500,3000000,2,51606,12903,1,204600000,204600000,19351,6450,12901,6450,0,1,6452,597453
168,6450,2000,1500,3000000,2,51606,12903,1,204600000,204600000,19351,6450,12901,6450,0,1,6452,596860
168,6850,2000,1500,3000000,2,54806,13703,1,215800000,215800000,20551,6850,13701,6850,0,1,6852,5199927
168,6850,2000,1500,3000000,2,54806,13703,1,215800000,215800000,20551,6850,13701,6850,0,1,6852,569834
168,6850,2000,1500,3000000,2,54806,13703,1,215800000,215800000,20551,6850,13701,6850,0,1,6852,572513
168,6850,2000,1500,3000000,2,54806,13703,1,215800000,215800000,20551,6850,13701,6850,0,1,6852,573873
168,6850,2000,1500,3000000,2,54806,13703,1,215800000,215800000,20551,6850,13701,6850,0,1,6852,573251
168,6850,2000,1500,3000000,2,54806,13703,1,215800000,215800000,20551,6850,13701,6850,0,1,6852,632765
168,6850,2000,1500,3000000,2,54806,13703,1,215800000,215800000,20551,6850,13701,6850,0,1,6852,633384
168,50,2000,1100,2200000,2,406,103,1,18840000,18840000,151,50,101,50,0,1,52,22020
168,50,2000,1100,2200000,2,406,103,1,18840000,18840000,151,50,101,50,0,1,52,26782
168,50,2000,1100,2200000,2,406,103,1,18840000,18840000,151,50,101,50,0,1,52,21407
168,50,2000,1100,2200000,2,406,103,1,18840000,18840000,151,50,101,50,0,1,52,28924
168,50,2000,1100,2200000,2,406,103,1,18840000,18840000,151,50,101,50,0,1,52,28515
168,50,2000,1100,2200000,2,406,103,1,18840000,18840000,151,50,101,50,0,1,52,32486
168,50,2000,1100,2200000,2,406,103,1,18840000,18840000,151,50,101,50,0,1,52,32918
168,450,2000,1100,2200000,2,3606,903,1,28760000,28760000,1351,450,901,450,0,1,452,216234
168,450,2000,1100,2200000,2,3606,903,1,28760000,28760000,1351,450,901,450,0,1,452,50077
168,450,2000,1100,2200000,2,3606,903,1,28760000,28760000,1351,450,901,450,0,1,452,50605
168,450,2000,1100,2200000,2,3606,903,1,28760000,28760000,1351,450,901,450,0,1,452,51649
168,450,2000,1100,2200000,2,3606,903,1,28760000,28760000,1351,450,901,450,0,1,452,44655
168,450,2000,1100,2200000,2,3606,903,1,28760000,28760000,1351,450,901,450,0,1,452,60582
168,450,2000,1100,2200000,2,3606,903,1,28760000,28760000,1351,450,901,450,0,1,452,60133
168,850,2000,1100,2200000,2,6806,1703,1,38680000,38680000,2551,850,1701,850,0,1,852,451227
168,850,2000,1100,2200000,2,6806,1703,1,38680000,38680000,2551,850,1701,850,0,1,852,80356
168,850,2000,1100,2200000,2,6806,1703,1,38680000,38680000,2551,850,1701,850,0,1,852,75787
168,850,2000,1100,2200000,2,6806,1703,1,38680000,38680000,2551,850,1701,850,0,1,852,79883
168,850,2000,1100,2200000,2,6806,1703,1,38680000,38680000,2551,850,1701,850,0,1,852,79527
168,850,2000,1100,2200000,2,6806,1703,1,38680000,38680000,2551,850,1701,850,0,1,852,88786
168,850,2000,1100,2200000,2,6806,1703,1,38680000,38680000,2551,850,1701,850,0,1,852,87659
168,1250,2000,1100,2200000,2,10006,2503,1,48600000,48600000,3751,1250,2501,1250,0,1,1252,656585
168,1250,2000,1100,2200000,2,10006,2503,1,48600000,48600000,3751,1250,2501,1250,0,1,1252,103029
168,1250,2000,1100,2200000,2,10006,2503,1,48600000,48600000,3751,1250,2501,1250,0,1,1252,102287
168,1250,2000,1100,2200000,2,10006,2503,1,48600000,48600000,3751,1250,2501,1250,0,1,1252,100874
168,1250,2000,1100,2200000,2,10006,2503,1,48600000,48600000,3751,1250,2501,1250,0,1,1252,102760
168,1250,2000,1100,2200000,2,10006,2503,1,48600000,48600000,3751,1250,2501,1250,0,1,1252,112374
168,1250,2000,1100,2200000,2,10006,2503,1,48600000,48600000,3751,1250,2501,1250,0,1,1252,113554
168,1650,2000,1100,2200000,2,13206,3303,1,58520000,58520000,4951,1650,3301,1650,0,1,1652,888630
168,1650,2000,1100,2200000,2,13206,3303,1,58520000,58520000,4951,1650,3301,1650,0,1,1652,124299
168,1650,2000,1100,2200000,2,13206,3303,1,58520000,58520000,4951,1650,3301,1650,0,1,1652,125835
168,1650,2000,1100,2200000,2,13206,3303,1,58520000,58520000,4951,1650,3301,1650,0,1,1652,121462
168,1650,2000,1100,2200000,2,13206,3303,1,58520000,58520000,4951,1650,3301,1650,0,1,1652,127714
168,1650,2000,1100,2200000,2,13206,3303,1,58520000,58520000,4951,1650,3301,1650,0,1,1652,138273
168,1650,2000,1100,2200000,2,13206,3303,1,58520000,58520000,4951,1650,3301,1650,0,1,1652,138818
168,2050,2000,1100,2200000,2,16406,4103,1,68440000,68440000,6151,2050,4101,2050,0,1,2052,1128946
168,2050,2000,1100,2200000,2,16406,4103,1,68440000,68440000,6151,2050,4101,2050,0,1,2052,156728
168,2050,2000,1100,2200000,2,16406,4103,1,68440000,68440000,6151,2050,4101,2050,0,1,2052,155925
168,2050,2000,1100,2200000,2,16406,4103,1,68440000,68440000,6151,2050,4101,2050,0,1,2052,157297
168,2050,2000,1100,2200000,2,16406,4103,1,68440000,68440000,6151,2050,4101,2050,0,1,2052,155047
168,2050,2000,1100,2200000,2,16406,4103,1,68440000,68440000,6151,2050,4101,2050,0,1,2052,168401
168,2050,2000,1100,2200000,2,16406,4103,1,68440000,68440000,6151,2050,4101,2050,0,1,2052,167120
168,2450,2000,1100,2200000,2,19606,4903,1,78360000,78360000,7351,2450,4901,2450,0,1,2452,1304502
168,2450,2000,1100,2200000,2,19606,4903,1,78360000,78360000,7351,2450,4901,2450,0,1,2452,179045
168,2450,2000,1100,2200000,2,19606,4903,1,78360000,78360000,7351,2450,4901,2450,0,1,2452,179390
168,2450,2000,1100,2200000,2,19606,4903,1,78360000,78360000,7351,2450,4901,2450,0,1,2452,178516
168,2450,2000,1100,2200000,2,19606,4903,1,78360000,78360000,7351,2450,4901,2450,0,1,2452,177604
168,2450,2000,1100,2200000,2,19606,4903,1,78360000,78360000,7351,2450,4901,2450,0,1,2452,194096
168,2450,2000,1100,2200000,2,19606,4903,1,78360000,78360000,7351,2450,4901,2450,0,1,2452,193486
168,2850,2000,1100,2200000,2,22806,5703,1,88280000,88280000,8551,2850,5701,2850,0,1,2852,1588079
168,2850,2000,1100,2200000,2,22806,5703,1,88280000,88280000,8551,2850,5701,2850,0,1,2852,202300
168,2850,2000,1100,2200000,2,22806,5703,1,88280000,88280000,8551,2850,5701,2850,0,1,2852,202791
168,2850,2000,1100,2200000,2,22806,5703,1,88280000,88280000,8551,2850,5701,2850,0,1,2852,201505
168,2850,2000,1100,2200000,2,22806,5703,1,88280000,88280000,8551,2850,5701,2850,0,1,2852,200419
168,2850,2000,1100,2200000,2,22806,5703,1,88280000,88280000,8551,2850,5701,2850,0,1,2852,208273
168,2850,2000,1100,2200000,2,22806,5703,1,88280000,88280000,8551,2850,5701,2850,0,1,2852,207834
168,3250,2000,1100,2200000,2,26006,6503,1,98200000,98200000,9751,3250,6501,3250,0,1,3252,1792928
168,3250,2000,1100,2200000,2,26006,6503,1,98200000,98200000,9751,3250,6501,3250,0,1,3252,233673
168,3250,2000,1100,2200000,2,26006,6503,1,98200000,98200000,9751,3250,6501,3250,0,1,3252,233404
168,3250,2000,1100,2200000,2,26006,6503,1,98200000,98200000,9751,3250,6501,3250,0,1,3252,234705
168,3250,2000,1100,2200000,2,26006,6503,1,98200000,98200000,9751,3250,6501,3250,0,1,3252,234127
168,3250,2000,1100,2200000,2,26006,6503,1,98200000,98200000,9751,3250,6501,3250,0,1,3252,233182
168,3250,2000,1100,2200000,2,26006,6503,1,98200000,98200000,9751,3250,6501,3250,0,1,3252,231807
168,3650,2000,1100,2200000,2,29206,7303,1,108120000,108120000,10951,3650,7301,3650,0,1,3652,2090107
168,3650,2000,1100,2200000,2,29206,7303,1,108120000,108120000,10951,3650,7301,3650,0,1,3652,264596
168,3650,2000,1100,2200000,2,29206,7303,1,108120000,108120000,10951,3650,7301,3650,0,1,3652,264123
168,3650,2000,1100,2200000,2,29206,7303,1,108120000,108120000,10951,3650,7301,3650,0,1,3652,262784
168,3650,2000,1100,2200000,2,29206,7303,1,108120000,108120000,10951,3650,7301,3650,0,1,3652,265551
168,3650,2000,1100,2200000,2,29206,7303,1,108120000,108120000,10951,3650,7301,3650,0,1,3652,266237
168,3650,2000,1100,2200000,2,29206,7303,1,108120000,108120000,10951,3650,7301,3650,0,1,3652,265950
168,4050,2000,1100,2200000,2,32406,8103,1,118040000,118040000,12151,4050,8101,4050,0,1,4052,2259966
168,4050,2000,1100,2200000,2,32406,8103,1,118040000,118040000,12151,4050,8101,4050,0,1,4052,281625
168,4050,2000,1100,2200000,2,32406,8103,1,118040000,118040000,12151,4050,8101,4050,0,1,4052,280379
168,4050,2000,1100,2200000,2,32406,8103,1,118040000,118040000,12151,4050,8101,4050,0,1,4052,283149
168,4050,2000,1100,2200000,2,32406,8103,1,118040000,118040000,12151,4050,8101,4050,0,1,4052,277877
168,4050,2000,1100,2200000,2,32406,8103,1,118040000,118040000,12151,4050,8101,4050,0,1,4052,289480
168,4050,2000,1100,2200000,2,32406,8103,1,118040000,118040000,12151,4050,8101,4050,0,1,4052,289970
168,4450,2000,1100,2200000,2,35606,8903,1,127960000,127960000,13351,4450,8901,4450,0,1,4452,2447030
168,4450,2000,1100,2200000,2,35606,8903,1,127960000,127960000,13351,4450,8901,4450,0,1,4452,303296
168,4450,2000,1100,2200000,2,35606,8903,1,127960000,127960000,13351,4450,8901,4450,0,1,4452,298820
168,4450,2000,1100,2200000,2,35606,8903,1,127960000,127960000,13351,4450,8901,4450,0,1,4452,304911
168,4450,2000,1100,2200000,2,35606,8903,1,127960000,127960000,13351,4450,8901,4450,0,1,4452,297217
168,4450,2000,1100,2200000,2,35606,8903,1,127960000,127960000,13351,4450,8901,4450,0,1,4452,313643
168,4450,2000,1100,2200000,2,35606,8903,1,127960000,127960000,13351,4450,8901,4450,0,1,4452,314151
168,4850,2000,1100,2200000,2,38806,9703,1,137880000,137880000,14551,4850,9701,4850,0,1,4852,2700010
168,4850,2000,1100,2200000,2,38806,9703,1,137880000,137880000,14551,4850,9701,4850,0,1,4852,321266
168,4850,2000,1100,2200000,2,38806,9703,1,137880000,137880000,14551,4850,9701,4850,0,1,4852,320572
168,4850,2000,1100,2200000,2,38806,9703,1,137880000,137880000,14551,4850,9701,4850,0,1,4852,319707
168,4850,2000,1100,2200000,2,38806,9703,1,137880000,137880000,14551,4850,9701,4850,0,1,4852,318663
168,4850,2000,1100,2200000,2,38806,9703,1,137880000,137880000,14551,4850,9701,4850,0,1,4852,371283
168,4850,2000,1100,2200000,2,38806,9703,1,137880000,137880000,14551,4850,9701,4850,0,1,4852,371804
168,5250,2000,1100,2200000,2,42006,10503,1,147800000,147800000,15751,5250,10501,5250,0,1,5252,2983802
168,5250,2000,1100,2200000,2,42006,10503,1,147800000,147800000,15751,5250,10501,5250,0,1,5252,339769
168,5250,2000,1100,2200000,2,42006,10503,1,147800000,147800000,15751,5250,10501,5250,0,1,5252,348488
168,5250,2000,1100,2200000,2,42006,10503,1,147800000,147800000,15751,5250,10501,5250,0,1,5252,339079
168,5250,2000,1100,2200000,2,42006,10503,1,147800000,147800000,15751,5250,10501,5250,0,1,5252,340311
168,5250,2000,1100,2200000,2,42006,10503,1,147800000,147800000,15751,5250,10501,5250,0,1,5252,384620
168,5250,2000,1100,2200000,2,42006,10503,1,147800000,147800000,15751,5250,10501,5250,0,1,5252,385185
168,5650,2000,1100,2200000,2,45206,11303,1,157720000,157720000,16951,5650,11301,5650,0,1,5652,3040156
168,5650,2000,1100,2200000,2,45206,11303,1,157720000,157720000,16951,5650,11301,5650,0,1,5652,373706
168,5650,2000,1100,2200000,2,45206,11303,1,157720000,157720000,16951,5650,11301,5650,0,1,5652,372590
168,5650,2000,1100,2200000,2,45206,11303,1,157720000,157720000,16951,5650,11301,5650,0,1,5652,375691
168,5650,2000,1100,2200000,2,45206,11303,1,157720000,157720000,16951,5650,11301,5650,0,1,5652,374951
168,5650,2000,1100,2200000,2,45206,11303,1,157720000,157720000,16951,5650,11301,5650,0,1,5652,403931
168,5650,2000,1100,2200000,2,45206,11303,1,157720000,157720000,16951,5650,11301,5650,0,1,5652,404490
168,6050,2000,1100,2200000,2,48406,12103,1,167640000,167640000,18151,6050,12101,6050,0,1,6052,3322314
168,6050,2000,1100,2200000,2,48406,12103,1,167640000,167640000,18151,6050,12101,6050,0,1,6052,392386
168,6050,2000,1100,2200000,2,48406,12103,1,167640000,167640000,18151,6050,12101,6050,0,1,6052,393073
168,6050,2000,1100,2200000,2,48406,12103,1,167640000,167640000,18151,6050,12101,6050,0,1,6052,393637
168,6050,2000,1100,2200000,2,48406,12103,1,167640000,167640000,18151,6050,12101,6050,0,1,6052,391024
168,6050,2000,1100,2200000,2,48406,12103,1,167640000,167640000,18151,6050,12101,6050,0,1,6052,438608
168,6050,2000,1100,2200000,2,48406,12103,1,167640000,167640000,18151,6050,12101,6050,0,1,6052,438055
168,6450,2000,1100,2200000,2,51606,12903,1,177560000,177560000,19351,6450,12901,6450,0,1,6452,3614408
168,6450,2000,1100,2200000,2,51606,12903,1,177560000,177560000,19351,6450,12901,6450,0,1,6452,418796
168,6450,2000,1100,2200000,2,51606,12903,1,177560000,177560000,19351,6450,12901,6450,0,1,6452,415339
168,6450,2000,1100,2200000,2,51606,12903,1,177560000,177560000,19351,6450,12901,6450,0,1,6452,418150
168,6450,2000,1100,2200000,2,51606,12903,1,177560000,177560000,19351,6450,12901,6450,0,1,6452,419600
168,6450,2000,1100,2200000,2,51606,12903,1,177560000,177560000,19351,6450,12901,6450,0,1,6452,467852
168,6450,2000,1100,2200000,2,51606,12903,1,177560000,177560000,19351,6450,12901,6450,0,1,6452,467273
168,6850,2000,1100,2200000,2,54806,13703,1,187480000,187480000,20551,6850,13701,6850,0,1,6852,3702692
168,6850,2000,1100,2200000,2,54806,13703,1,187480000,187480000,20551,6850,13701,6850,0,1,6852,447929
168,6850,2000,1100,2200000,2,54806,13703,1,187480000,187480000,20551,6850,13701,6850,0,1,6852,422657
168,6850,2000,1100,2200000,2,54806,13703,1,187480000,187480000,20551,6850,13701,6850,0,1,6852,448731
168,6850,2000,1100,2200000,2,54806,13703,1,187480000,187480000,20551,6850,13701,6850,0,1,6852,424980
168,6850,2000,1100,2200000,2,54806,13703,1,187480000,187480000,20551,6850,13701,6850,0,1,6852,495696
168,6850,2000,1100,2200000,2,54806,13703,1,187480000,187480000,20551,6850,13701,6850,0,1,6852,495074
168,50,2000,700,1400000,2,406,103,1,12280000,12280000,151,50,101,50,0,1,52,14034
168,50,2000,700,1400000,2,406,103,1,12280000,12280000,151,50,101,50,0,1,52,16472
168,50,2000,700,1400000,2,406,103,1,12280000,12280000,151,50,101,50,0,1,52,21738
168,50,2000,700,1400000,2,406,103,1,12280000,12280000,151,50,101,50,0,1,52,19749
168,50,2000,700,1400000,2,406,103,1,12280000,12280000,151,50,101,50,0,1,52,21906
168,50,2000,700,1400000,2,406,103,1,12280000,12280000,151,50,101,50,0,1,52,23802
168,50,2000,700,1400000,2,406,103,1,12280000,12280000,151,50,101,50,0,1,52,24229
168,450,2000,700,1400000,2,3606,903,1,20920000,20920000,1351,450,901,450,0,1,452,130582
168,450,2000,700,1400000,2,3606,903,1,20920000,20920000,1351,450,901,450,0,1,452,36531
168,450,2000,700,1400000,2,3606,903,1,20920000,20920000,1351,450,901,450,0,1,452,42088
168,450,2000,700,1400000,2,3606,903,1,20920000,20920000,1351,450,901,450,0,1,452,41065
168,450,2000,700,1400000,2,3606,903,1,20920000,20920000,1351,450,901,450,0,1,452,42414
168,450,2000,700,1400000,2,3606,903,1,20920000,20920000,1351,450,901,450,0,1,452,44113
168,450,2000,700,1400000,2,3606,903,1,20920000,20920000,1351,450,901,450,0,1,452,45195
168,850,2000,700,1400000,2,6806,1703,1,29560000,29560000,2551,850,1701,850,0,1,852,278890
168,850,2000,700,1400000,2,6806,1703,1,29560000,29560000,2551,850,1701,850,0,1,852,57545
168,850,2000,700,1400000,2,6806,1703,1,29560000,29560000,2551,850,1701,850,0,1,852,55718
168,850,2000,700,1400000,2,6806,1703,1,29560000,29560000,2551,850,1701,850,0,1,852,53255
168,850,2000,700,1400000,2,6806,1703,1,29560000,29560000,2551,850,1701,850,0,1,852,57066
168,850,2000,700,1400000,2,6806,1703,1,29560000,29560000,2551,850,1701,850,0,1,852,62182
168,850,2000,700,1400000,2,6806,1703,1,29560000,29560000,2551,850,1701,850,0,1,852,60391
168,1250,2000,700,1400000,2,10006,2503,1,38200000,38200000,3751,1250,2501,1250,0,1,1252,417440
168,1250,2000,700,1400000,2,10006,2503,1,38200000,38200000,3751,1250,2501,1250,0,1,1252,74871
168,1250,2000,700,1400000,2,10006,2503,1,38200000,38200000,3751,1250,2501,1250,0,1,1252,75585
168,1250,2000,700,1400000,2,10006,2503,1,38200000,38200000,3751,1250,2501,1250,0,1,1252,75322
168,1250,2000,700,1400000,2,10006,2503,1,38200000,38200000,3751,1250,2501,1250,0,1,1252,74323
168,1250,2000,700,1400000,2,10006,2503,1,38200000,38200000,3751,1250,2501,1250,0,1,1252,82587
168,1250,2000,700,1400000,2,10006,2503,1,38200000,38200000,3751,1250,2501,1250,0,1,1252,82072
168,1650,2000,700,1400000,2,13206,3303,1,46840000,46840000,4951,1650,3301,1650,0,1,1652,549040
168,1650,2000,700,1400000,2,13206,3303,1,46840000,46840000,4951,1650,3301,1650,0,1,1652,92590
168,1650,2000,700,1400000,2,13206,3303,1,46840000,46840000,4951,1650,3301,1650,0,1,1652,92885
168,1650,2000,700,1400000,2,13206,3303,1,46840000,46840000,4951,1650,3301,1650,0,1,1652,90013
168,1650,2000,700,1400000,2,13206,3303,1,46840000,46840000,4951,1650,3301,1650,0,1,1652,92108
168,1650,2000,700,1400000,2,13206,3303,1,46840000,46840000,4951,1650,3301,1650,0,1,1652,100844
168,1650,2000,700,1400000,2,13206,3303,1,46840000,46840000,4951,1650,3301,1650,0,1,1652,101403
168,2050,2000,700,1400000,2,16406,4103,1,55480000,55480000,6151,2050,4101,2050,0,1,2052,675283
168,2050,2000,700,1400000,2,16406,4103,1,55480000,55480000,6151,2050,4101,2050,0,1,2052,109167
168,2050,2000,700,1400000,2,16406,4103,1,55480000,55480000,6151,2050,4101,2050,0,1,2052,105835
168,2050,2000,700,1400000,2,16406,4103,1,55480000,55480000,6151,2050,4101,2050,0,1,2052,106671
168,2050,2000,700,1400000,2,16406,4103,1,55480000,55480000,6151,2050,4101,2050,0,1,2052,108612
168,2050,2000,700,1400000,2,16406,4103,1,55480000,55480000,6151,2050,4101,2050,0,1,2052,118839
168,2050,2000,700,1400000,2,16406,4103,1,55480000,55480000,6151,2050,4101,2050,0,1,2052,119425
168,2450,2000,700,1400000,2,19606,4903,1,64120000,64120000,7351,2450,4901,2450,0,1,2452,829923
168,2450,2000,700,1400000,2,19606,4903,1,64120000,64120000,7351,2450,4901,2450,0,1,2452,130624
168,2450,2000,700,1400000,2,19606,4903,1,64120000,64120000,7351,2450,4901,2450,0,1,2452,128606
168,2450,2000,700,1400000,2,19606,4903,1,64120000,64120000,7351,2450,4901,2450,0,1,2452,129587
168,2450,2000,700,1400000,2,19606,4903,1,64120000,64120000,7351,2450,4901,2450,0,1,2452,130041
168,2450,2000,700,1400000,2,19606,4903,1,64120000,64120000,7351,2450,4901,2450,0,1,2452,140637
168,2450,2000,700,1400000,2,19606,4903,1,64120000,64120000,7351,2450,4901,2450,0,1,2452,141251
168,2850,2000,700,1400000,2,22806,5703,1,72760000,72760000,8551,2850,5701,2850,0,1,2852,963791
168,2850,2000,700,1400000,2,22806,5703,1,72760000,72760000,8551,2850,5701,2850,0,1,2852,145957
168,2850,2000,700,1400000,2,22806,5703,1,72760000,72760000,8551,2850,5701,2850,0,1,2852,145285
168,2850,2000,700,1400000,2,22806,5703,1,72760000,72760000,8551,2850,5701,2850,0,1,2852,147620
168,2850,2000,700,1400000,2,22806,5703,1,72760000,72760000,8551,2850,5701,2850,0,1,2852,147017
168,2850,2000,700,1400000,2,22806,5703,1,72760000,72760000,8551,2850,5701,2850,0,1,2852,160833
168,2850,2000,700,1400000,2,22806,5703,1,72760000,72760000,8551,2850,5701,2850,0,1,2852,160204
168,3250,2000,700,1400000,2,26006,6503,1,81400000,81400000,9751,3250,6501,3250,0,1,3252,1152189
168,3250,2000,700,1400000,2,26006,6503,1,81400000,81400000,9751,3250,6501,3250,0,1,3252,163212
168,3250,2000,700,1400000,2,26006,6503,1,81400000,81400000,9751,3250,6501,3250,0,1,3252,165722
168,3250,2000,700,1400000,2,26006,6503,1,81400000,81400000,9751,3250,6501,3250,0,1,3252,164729
168,3250,2000,700,1400000,2,26006,6503,1,81400000,81400000,9751,3250,6501,3250,0,1,3252,165312
168,3250,2000,700,1400000,2,26006,6503,1,81400000,81400000,9751,3250,6501,3250,0,1,3252,180097
168,3250,2000,700,1400000,2,26006,6503,1,81400000,81400000,9751,3250,6501,3250,0,1,3252,179430
168,3650,2000,700,1400000,2,29206,7303,1,90040000,90040000,10951,3650,7301,3650,0,1,3652,1294866
168,3650,2000,700,1400000,2,29206,7303,1,90040000,90040000,10951,3650,7301,3650,0,1,3652,184398
168,3650,2000,700,1400000,2,29206,7303,1,90040000,90040000,10951,3650,7301,3650,0,1,3652,183802
168,3650,2000,700,1400000,2,29206,7303,1,90040000,90040000,10951,3650,7301,3650,0,1,3652,184831
168,3650,2000,700,1400000,2,29206,7303,1,90040000,90040000,10951,3650,7301,3650,0,1,3652,182502
168,3650,2000,700,1400000,2,29206,7303,1,90040000,90040000,10951,3650,7301,3650,0,1,3652,199881
168,3650,2000,700,1400000,2,29206,7303,1,90040000,90040000,10951,3650,7301,3650,0,1,3652,200381
168,4050,2000,700,1400000,2,32406,8103,1,98680000,98680000,12151,4050,8101,4050,0,1,4052,1404161
168,4050,2000,700,1400000,2,32406,8103,1,98680000,98680000,12151,4050,8101,4050,0,1,4052,196045
168,4050,2000,700,1400000,2,32406,8103,1,98680000,98680000,12151,4050,8101,4050,0,1,4052,197934
168,4050,2000,700,1400000,2,32406,8103,1,98680000,98680000,12151,4050,8101,4050,0,1,4052,197013
168,4050,2000,700,1400000,2,32406,8103,1,98680000,98680000,12151,4050,8101,4050,0,1,4052,198641
168,4050,2000,700,1400000,2,32406,8103,1,98680000,98680000,12151,4050,8101,4050,0,1,4052,209147
168,4050,2000,700,1400000,2,32406,8103,1,98680000,98680000,12151,4050,8101,4050,0,1,4052,208658
168,4450,2000,700,1400000,2,35606,8903,1,107320000,107320000,13351,4450,8901,4450,0,1,4452,1563102
168,4450,2000,700,1400000,2,35606,8903,1,107320000,107320000,13351,4450,8901,4450,0,1,4452,228870
168,4450,2000,700,1400000,2,35606,8903,1,107320000,107320000,13351,4450,8901,4450,0,1,4452,222704
168,4450,2000,700,1400000,2,35606,8903,1,107320000,107320000,13351,4450,8901,4450,0,1,4452,227576
168,4450,2000,700,1400000,2,35606,8903,1,107320000,107320000,13351,4450,8901,4450,0,1,4452,225747
168,4450,2000,700,1400000,2,35606,8903,1,107320000,107320000,13351,4450,8901,4450,0,1,4452,230832
168,4450,2000,700,1400000,2,35606,8903,1,107320000,107320000,13351,4450,8901,4450,0,1,4452,231500
168,4850,2000,700,1400000,2,38806,9703,1,115960000,115960000,14551,4850,9701,4850,0,1,4852,1632682
168,4850,2000,700,1400000,2,38806,9703,1,115960000,115960000,14551,4850,9701,4850,0,1,4852,228420
168,4850,2000,700,1400000,2,38806,9703,1,115960000,115960000,14551,4850,9701,4850,0,1,4852,227928
168,4850,2000,700,1400000,2,38806,9703,1,115960000,115960000,14551,4850,9701,4850,0,1,4852,226057
168,4850,2000,700,1400000,2,38806,9703,1,115960000,115960000,14551,4850,9701,4850,0,1,4852,227309
168,4850,2000,700,1400000,2,38806,9703,1,115960000,115960000,14551,4850,9701,4850,0,1,4852,252787
168,4850,2000,700,1400000,2,38806,9703,1,115960000,115960000,14551,4850,9701,4850,0,1,4852,252285
168,5250,2000,700,1400000,2,42006,10503,1,124600000,124600000,15751,5250,10501,5250,0,1,5252,1800900
168,5250,2000,700,1400000,2,42006,10503,1,124600000,124600000,15751,5250,10501,5250,0,1,5252,244520
168,5250,2000,700,1400000,2,42006,10503,1,124600000,124600000,15751,5250,10501,5250,0,1,5252,243791
168,5250,2000,700,1400000,2,42006,10503,1,124600000,124600000,15751,5250,10501,5250,0,1,5252,242077
168,5250,2000,700,1400000,2,42006,10503,1,124600000,124600000,15751,5250,10501,5250,0,1,5252,241083
168,5250,2000,700,1400000,2,42006,10503,1,124600000,124600000,15751,5250,10501,5250,0,1,5252,270035
168,5250,2000,700,1400000,2,42006,10503,1,124600000,124600000,15751,5250,10501,5250,0,1,5252,270576
168,5650,2000,700,1400000,2,45206,11303,1,133240000,133240000,16951,5650,11301,5650,0,1,5652,1977608
168,5650,2000,700,1400000,2,45206,11303,1,133240000,133240000,16951,5650,11301,5650,0,1,5652,262553
168,5650,2000,700,1400000,2,45206,11303,1,133240000,133240000,16951,5650,11301,5650,0,1,5652,261205
168,5650,2000,700,1400000,2,45206,11303,1,133240000,133240000,16951,5650,11301,5650,0,1,5652,260134
168,5650,2000,700,1400000,2,45206,11303,1,133240000,133240000,16951,5650,11301,5650,0,1,5652,261806
168,5650,2000,700,1400000,2,45206,11303,1,133240000,133240000,16951,5650,11301,5650,0,1,5652,297947
168,5650,2000,700,1400000,2,45206,11303,1,133240000,133240000,16951,5650,11301,5650,0,1,5652,297360
168,6050,2000,700,1400000,2,48406,12103,1,141880000,141880000,18151,6050,12101,6050,0,1,6052,2172402
168,6050,2000,700,1400000,2,48406,12103,1,141880000,141880000,18151,6050,12101,6050,0,1,6052,281415
168,6050,2000,700,1400000,2,48406,12103,1,141880000,141880000,18151,6050,12101,6050,0,1,6052,279380
168,6050,2000,700,1400000,2,48406,12103,1,141880000,141880000,18151,6050,12101,6050,0,1,6052,280187
168,6050,2000,700,1400000,2,48406,12103,1,141880000,141880000,18151,6050,12101,6050,0,1,6052,282191
168,6050,2000,700,1400000,2,48406,12103,1,141880000,141880000,18151,6050,12101,6050,0,1,6052,315633
168,6050,2000,700,1400000,2,48406,12103,1,141880000,141880000,18151,6050,12101,6050,0,1,6052,315065
168,6450,2000,700,1400000,2,51606,12903,1,150520000,150520000,19351,6450,12901,6450,0,1,6452,2217021
168,6450,2000,700,1400000,2,51606,12903,1,150520000,150520000,19351,6450,12901,6450,0,1,6452,293259
168,6450,2000,700,1400000,2,51606,12903,1,150520000,150520000,19351,6450,12901,6450,0,1,6452,293964
168,6450,2000,700,1400000,2,51606,12903,1,150520000,150520000,19351,6450,12901,6450,0,1,6452,295262
168,6450,2000,700,1400000,2,51606,12903,1,150520000,150520000,19351,6450,12901,6450,0,1,6452,294673
168,6450,2000,700,1400000,2,51606,12903,1,150520000,150520000,19351,6450,12901,6450,0,1,6452,335114
168,6450,2000,700,1400000,2,51606,12903,1,150520000,150520000,19351,6450,12901,6450,0,1,6452,334524
168,6850,2000,700,1400000,2,54806,13703,1,159160000,159160000,20551,6850,13701,6850,0,1,6852,2322283
168,6850,2000,700,1400000,2,54806,13703,1,159160000,159160000,20551,6850,13701,6850,0,1,6852,313985
168,6850,2000,700,1400000,2,54806,13703,1,159160000,159160000,20551,6850,13701,6850,0,1,6852,314812
168,6850,2000,700,1400000,2,54806,13703,1,159160000,159160000,20551,6850,13701,6850,0,1,6852,313125
168,6850,2000,700,1400000,2,54806,13703,1,159160000,159160000,20551,6850,13701,6850,0,1,6852,311633
168,6850,2000,700,1400000,2,54806,13703,1,159160000,159160000,20551,6850,13701,6850,0,1,6852,362704
168,6850,2000,700,1400000,2,54806,13703,1,159160000,159160000,20551,6850,13701,6850,0,1,6852,363381
168,50,2000,300,600000,2,406,103,1,5720000,5720000,151,50,101,50,0,1,52,5810
168,50,2000,300,600000,2,406,103,1,5720000,5720000,151,50,101,50,0,1,52,16935
168,50,2000,300,600000,2,406,103,1,5720000,5720000,151,50,101,50,0,1,52,14738
168,50,2000,300,600000,2,406,103,1,5720000,5720000,151,50,101,50,0,1,52,17488
168,50,2000,300,600000,2,406,103,1,5720000,5720000,151,50,101,50,0,1,52,11857
168,50,2000,300,600000,2,406,103,1,5720000,5720000,151,50,101,50,0,1,52,17324
168,50,2000,300,600000,2,406,103,1,5720000,5720000,151,50,101,50,0,1,52,17674
168,450,2000,300,600000,2,3606,903,1,13080000,13080000,1351,450,901,450,0,1,452,55165
168,450,2000,300,600000,2,3606,903,1,13080000,13080000,1351,450,901,450,0,1,452,29087
168,450,2000,300,600000,2,3606,903,1,13080000,13080000,1351,450,901,450,0,1,452,30631
168,450,2000,300,600000,2,3606,903,1,13080000,13080000,1351,450,901,450,0,1,452,27181
168,450,2000,300,600000,2,3606,903,1,13080000,13080000,1351,450,901,450,0,1,452,30091
168,450,2000,300,600000,2,3606,903,1,13080000,13080000,1351,450,901,450,0,1,452,32368
168,450,2000,300,600000,2,3606,903,1,13080000,13080000,1351,450,901,450,0,1,452,31916
168,850,2000,300,600000,2,6806,1703,1,20440000,20440000,2551,850,1701,850,0,1,852,117642
168,850,2000,300,600000,2,6806,1703,1,20440000,20440000,2551,850,1701,850,0,1,852,39636
168,850,2000,300,600000,2,6806,1703,1,20440000,20440000,2551,850,1701,850,0,1,852,40281
168,850,2000,300,600000,2,6806,1703,1,20440000,20440000,2551,850,1701,850,0,1,852,39118
168,850,2000,300,600000,2,6806,1703,1,20440000,20440000,2551,850,1701,850,0,1,852,37499
168,850,2000,300,600000,2,6806,1703,1,20440000,20440000,2551,850,1701,850,0,1,852,42299
168,850,2000,300,600000,2,6806,1703,1,20440000,20440000,2551,850,1701,850,0,1,852,42782
168,1250,2000,300,600000,2,10006,2503,1,27800000,27800000,3751,1250,2501,1250,0,1,1252,174578
168,1250,2000,300,600000,2,10006,2503,1,27800000,27800000,3751,1250,2501,1250,0,1,1252,47243
168,1250,2000,300,600000,2,10006,2503,1,27800000,27800000,3751,1250,2501,1250,0,1,1252,48540
168,1250,2000,300,600000,2,10006,2503,1,27800000,27800000,3751,1250,2501,1250,0,1,1252,49035
168,1250,2000,300,600000,2,10006,2503,1,27800000,27800000,3751,1250,2501,1250,0,1,1252,43216
168,1250,2000,300,600000,2,10006,2503,1,27800000,27800000,3751,1250,2501,1250,0,1,1252,53492
168,1250,2000,300,600000,2,10006,2503,1,27800000,27800000,3751,1250,2501,1250,0,1,1252,54014
168,1650,2000,300,600000,2,13206,3303,1,35160000,35160000,4951,1650,3301,1650,0,1,1652,233006
168,1650,2000,300,600000,2,13206,3303,1,35160000,35160000,4951,1650,3301,1650,0,1,1652,57420
168,1650,2000,300,600000,2,13206,3303,1,35160000,35160000,4951,1650,3301,1650,0,1,1652,58870
168,1650,2000,300,600000,2,13206,3303,1,35160000,35160000,4951,1650,3301,1650,0,1,1652,58351
168,1650,2000,300,600000,2,13206,3303,1,35160000,35160000,4951,1650,3301,1650,0,1,1652,56837
168,1650,2000,300,600000,2,13206,3303,1,35160000,35160000,4951,1650,3301,1650,0,1,1652,65761
168,1650,2000,300,600000,2,13206,3303,1,35160000,35160000,4951,1650,3301,1650,0,1,1652,66315
168,2050,2000,300,600000,2,16406,4103,1,42520000,42520000,6151,2050,4101,2050,0,1,2052,289383
168,2050,2000,300,600000,2,16406,4103,1,42520000,42520000,6151,2050,4101,2050,0,1,2052,72470
168,2050,2000,300,600000,2,16406,4103,1,42520000,42520000,6151,2050,4101,2050,0,1,2052,68554
168,2050,2000,300,600000,2,16406,4103,1,42520000,42520000,6151,2050,4101,2050,0,1,2052,71277
168,2050,2000,300,600000,2,16406,4103,1,42520000,42520000,6151,2050,4101,2050,0,1,2052,71917
168,2050,2000,300,600000,2,16406,4103,1,42520000,42520000,6151,2050,4101,2050,0,1,2052,78762
168,2050,2000,300,600000,2,16406,4103,1,42520000,42520000,6151,2050,4101,2050,0,1,2052,78177
168,2450,2000,300,600000,2,19606,4903,1,49880000,49880000,7351,2450,4901,2450,0,1,2452,346454
168,2450,2000,300,600000,2,19606,4903,1,49880000,49880000,7351,2450,4901,2450,0,1,2452,82505
168,2450,2000,300,600000,2,19606,4903,1,49880000,49880000,7351,2450,4901,2450,0,1,2452,80004
168,2450,2000,300,600000,2,19606,4903,1,49880000,49880000,7351,2450,4901,2450,0,1,2452,83766
168,2450,2000,300,600000,2,19606,4903,1,49880000,49880000,7351,2450,4901,2450,0,1,2452,83183
168,2450,2000,300,600000,2,19606,4903,1,49880000,49880000,7351,2450,4901,2450,0,1,2452,90239
168,2450,2000,300,600000,2,19606,4903,1,49880000,49880000,7351,2450,4901,2450,0,1,2452,91481
168,2850,2000,300,600000,2,22806,5703,1,57240000,57240000,8551,2850,5701,2850,0,1,2852,413740
168,2850,2000,300,600000,2,22806,5703,1,57240000,57240000,8551,2850,5701,2850,0,1,2852,93383
168,2850,2000,300,600000,2,22806,5703,1,57240000,57240000,8551,2850,5701,2850,0,1,2852,90650
168,2850,2000,300,600000,2,22806,5703,1,57240000,57240000,8551,2850,5701,2850,0,1,2852,92805
168,2850,2000,300,600000,2,22806,5703,1,57240000,57240000,8551,2850,5701,2850,0,1,2852,93766
168,2850,2000,300,600000,2,22806,5703,1,57240000,57240000,8551,2850,5701,2850,0,1,2852,103628
168,2850,2000,300,600000,2,22806,5703,1,57240000,57240000,8551,2850,5701,2850,0,1,2852,102981
168,3250,2000,300,600000,2,26006,6503,1,64600000,64600000,9751,3250,6501,3250,0,1,3252,458430
168,3250,2000,300,600000,2,26006,6503,1,64600000,64600000,9751,3250,6501,3250,0,1,3252,106843
168,3250,2000,300,600000,2,26006,6503,1,64600000,64600000,9751,3250,6501,3250,0,1,3252,104262
168,3250,2000,300,600000,2,26006,6503,1,64600000,64600000,9751,3250,6501,3250,0,1,3252,107355
168,3250,2000,300,600000,2,26006,6503,1,64600000,64600000,9751,3250,6501,3250,0,1,3252,108018
168,3250,2000,300,600000,2,26006,6503,1,64600000,64600000,9751,3250,6501,3250,0,1,3252,119850
168,3250,2000,300,600000,2,26006,6503,1,64600000,64600000,9751,3250,6501,3250,0,1,3252,122174
168,3650,2000,300,600000,2,29206,7303,1,71960000,71960000,10951,3650,7301,3650,0,1,3652,520808
168,3650,2000,300,600000,2,29206,7303,1,71960000,71960000,10951,3650,7301,3650,0,1,3652,114824
168,3650,2000,300,600000,2,29206,7303,1,71960000,71960000,10951,3650,7301,3650,0,1,3652,116983
168,3650,2000,300,600000,2,29206,7303,1,71960000,71960000,10951,3650,7301,3650,0,1,3652,115873
168,3650,2000,300,600000,2,29206,7303,1,71960000,71960000,10951,3650,7301,3650,0,1,3652,117672
168,3650,2000,300,600000,2,29206,7303,1,71960000,71960000,10951,3650,7301,3650,0,1,3652,133847
168,3650,2000,300,600000,2,29206,7303,1,71960000,71960000,10951,3650,7301,3650,0,1,3652,133001
168,4050,2000,300,600000,2,32406,8103,1,79320000,79320000,12151,4050,8101,4050,0,1,4052,576256
168,4050,2000,300,600000,2,32406,8103,1,79320000,79320000,12151,4050,8101,4050,0,1,4052,124715
168,4050,2000,300,600000,2,32406,8103,1,79320000,79320000,12151,4050,8101,4050,0,1,4052,123961
168,4050,2000,300,600000,2,32406,8103,1,79320000,79320000,12151,4050,8101,4050,0,1,4052,119675
168,4050,2000,300,600000,2,32406,8103,1,79320000,79320000,12151,4050,8101,4050,0,1,4052,126052
168,4050,2000,300,600000,2,32406,8103,1,79320000,79320000,12151,4050,8101,4050,0,1,4052,146169
168,4050,2000,300,600000,2,32406,8103,1,79320000,79320000,12151,4050,8101,4050,0,1,4052,147023
168,4450,2000,300,600000,2,35606,8903,1,86680000,86680000,13351,4450,8901,4450,0,1,4452,610715
168,4450,2000,300,600000,2,35606,8903,1,86680000,86680000,13351,4450,8901,4450,0,1,4452,131483
168,4450,2000,300,600000,2,35606,8903,1,86680000,86680000,13351,4450,8901,4450,0,1,4452,127438
168,4450,2000,300,600000,2,35606,8903,1,86680000,86680000,13351,4450,8901,4450,0,1,4452,130434
168,4450,2000,300,600000,2,35606,8903,1,86680000,86680000,13351,4450,8901,4450,0,1,4452,132400
168,4450,2000,300,600000,2,35606,8903,1,86680000,86680000,13351,4450,8901,4450,0,1,4452,160283
168,4450,2000,300,600000,2,35606,8903,1,86680000,86680000,13351,4450,8901,4450,0,1,4452,161998
168,4850,2000,300,600000,2,38806,9703,1,94040000,94040000,14551,4850,9701,4850,0,1,4852,690425
168,4850,2000,300,600000,2,38806,9703,1,94040000,94040000,14551,4850,9701,4850,0,1,4852,141234
168,4850,2000,300,600000,2,38806,9703,1,94040000,94040000,14551,4850,9701,4850,0,1,4852,144038
168,4850,2000,300,600000,2,38806,9703,1,94040000,94040000,14551,4850,9701,4850,0,1,4852,138562
168,4850,2000,300,600000,2,38806,9703,1,94040000,94040000,14551,4850,9701,4850,0,1,4852,142747
168,4850,2000,300,600000,2,38806,9703,1,94040000,94040000,14551,4850,9701,4850,0,1,4852,181274
168,4850,2000,300,600000,2,38806,9703,1,94040000,94040000,14551,4850,9701,4850,0,1,4852,180349
168,5250,2000,300,600000,2,42006,10503,1,101400000,101400000,15751,5250,10501,5250,0,1,5252,753725
168,5250,2000,300,600000,2,42006,10503,1,101400000,101400000,15751,5250,10501,5250,0,1,5252,150716
168,5250,2000,300,600000,2,42006,10503,1,101400000,101400000,15751,5250,10501,5250,0,1,5252,151249
168,5250,2000,300,600000,2,42006,10503,1,101400000,101400000,15751,5250,10501,5250,0,1,5252,150043
168,5250,2000,300,600000,2,42006,10503,1,101400000,101400000,15751,5250,10501,5250,0,1,5252,148217
168,5250,2000,300,600000,2,42006,10503,1,101400000,101400000,15751,5250,10501,5250,0,1,5252,198831
168,5250,2000,300,600000,2,42006,10503,1,101400000,101400000,15751,5250,10501,5250,0,1,5252,197712
168,5650,2000,300,600000,2,45206,11303,1,108760000,108760000,16951,5650,11301,5650,0,1,5652,819597
168,5650,2000,300,600000,2,45206,11303,1,108760000,108760000,16951,5650,11301,5650,0,1,5652,159579
168,5650,2000,300,600000,2,45206,11303,1,108760000,108760000,16951,5650,11301,5650,0,1,5652,163558
168,5650,2000,300,600000,2,45206,11303,1,108760000,108760000,16951,5650,11301,5650,0,1,5652,162948
168,5650,2000,300,600000,2,45206,11303,1,108760000,108760000,16951,5650,11301,5650,0,1,5652,162203
168,5650,2000,300,600000,2,45206,11303,1,108760000,108760000,16951,5650,11301,5650,0,1,5652,197520
168,5650,2000,300,600000,2,45206,11303,1,108760000,108760000,16951,5650,11301,5650,0,1,5652,195645
168,6050,2000,300,600000,2,48406,12103,1,116120000,116120000,18151,6050,12101,6050,0,1,6052,878147
168,6050,2000,300,600000,2,48406,12103,1,116120000,116120000,18151,6050,12101,6050,0,1,6052,165855
168,6050,2000,300,600000,2,48406,12103,1,116120000,116120000,18151,6050,12101,6050,0,1,6052,167147
168,6050,2000,300,600000,2,48406,12103,1,116120000,116120000,18151,6050,12101,6050,0,1,6052,166563
168,6050,2000,300,600000,2,48406,12103,1,116120000,116120000,18151,6050,12101,6050,0,1,6052,164842
168,6050,2000,300,600000,2,48406,12103,1,116120000,116120000,18151,6050,12101,6050,0,1,6052,215197
168,6050,2000,300,600000,2,48406,12103,1,116120000,116120000,18151,6050,12101,6050,0,1,6052,214028
168,6450,2000,300,600000,2,51606,12903,1,123480000,123480000,19351,6450,12901,6450,0,1,6452,916526
168,6450,2000,300,600000,2,51606,12903,1,123480000,123480000,19351,6450,12901,6450,0,1,6452,177834
168,6450,2000,300,600000,2,51606,12903,1,123480000,123480000,19351,6450,12901,6450,0,1,6452,175490
168,6450,2000,300,600000,2,51606,12903,1,123480000,123480000,19351,6450,12901,6450,0,1,6452,178443
168,6450,2000,300,600000,2,51606,12903,1,123480000,123480000,19351,6450,12901,6450,0,1,6452,177081
168,6450,2000,300,600000,2,51606,12903,1,123480000,123480000,19351,6450,12901,6450,0,1,6452,219360
168,6450,2000,300,600000,2,51606,12903,1,123480000,123480000,19351,6450,12901,6450,0,1,6452,218732
168,6850,2000,300,600000,2,54806,13703,1,130840000,130840000,20551,6850,13701,6850,0,1,6852,958457
168,6850,2000,300,600000,2,54806,13703,1,130840000,130840000,20551,6850,13701,6850,0,1,6852,190723
168,6850,2000,300,600000,2,54806,13703,1,130840000,130840000,20551,6850,13701,6850,0,1,6852,193691
168,6850,2000,300,600000,2,54806,13703,1,130840000,130840000,20551,6850,13701,6850,0,1,6852,192274
168,6850,2000,300,600000,2,54806,13703,1,130840000,130840000,20551,6850,13701,6850,0,1,6852,193057
168,6850,2000,300,600000,2,54806,13703,1,130840000,130840000,20551,6850,13701,6850,0,1,6852,224259
168,6850,2000,300,600000,2,54806,13703,1,130840000,130840000,20551,6850,13701,6850,0,1,6852,224940
168,50,1600,7100,11360000,2,406,103,1,94360000,94360000,151,50,101,50,0,1,52,135124
168,50,1600,7100,11360000,2,406,103,1,94360000,94360000,151,50,101,50,0,1,52,121342
168,50,1600,7100,11360000,2,406,103,1,94360000,94360000,151,50,101,50,0,1,52,120204
168,50,1600,7100,11360000,2,406,103,1,94360000,94360000,151,50,101,50,0,1,52,121747
168,50,1600,7100,11360000,2,406,103,1,94360000,94360000,151,50,101,50,0,1,52,121040
168,50,1600,7100,11360000,2,406,103,1,94360000,94360000,151,50,101,50,0,1,52,146309
168,50,1600,7100,11360000,2,406,103,1,94360000,94360000,151,50,101,50,0,1,52,145892
168,450,1600,7100,11360000,2,3606,903,1,122200000,122200000,1351,450,901,450,0,1,452,1361729
168,450,1600,7100,11360000,2,3606,903,1,122200000,122200000,1351,450,901,450,0,1,452,242794
168,450,1600,7100,11360000,2,3606,903,1,122200000,122200000,1351,450,901,450,0,1,452,242090
168,450,1600,7100,11360000,2,3606,903,1,122200000,122200000,1351,450,901,450,0,1,452,240860
168,450,1600,7100,11360000,2,3606,903,1,122200000,122200000,1351,450,901,450,0,1,452,242971
168,450,1600,7100,11360000,2,3606,903,1,122200000,122200000,1351,450,901,450,0,1,452,243469
168,450,1600,7100,11360000,2,3606,903,1,122200000,122200000,1351,450,901,450,0,1,452,243807
168,850,1600,7100,11360000,2,6806,1703,1,150040000,150040000,2551,850,1701,850,0,1,852,2827013
168,850,1600,7100,11360000,2,6806,1703,1,150040000,150040000,2551,850,1701,850,0,1,852,361863
168,850,1600,7100,11360000,2,6806,1703,1,150040000,150040000,2551,850,1701,850,0,1,852,358536
168,850,1600,7100,11360000,2,6806,1703,1,150040000,150040000,2551,850,1701,850,0,1,852,363378
168,850,1600,7100,11360000,2,6806,1703,1,150040000,150040000,2551,850,1701,850,0,1,852,363021
168,850,1600,7100,11360000,2,6806,1703,1,150040000,150040000,2551,850,1701,850,0,1,852,362356
168,850,1600,7100,11360000,2,6806,1703,1,150040000,150040000,2551,850,1701,850,0,1,852,362678
168,1250,1600,7100,11360000,2,10006,2503,1,177880000,177880000,3751,1250,2501,1250,0,1,1252,4083727
168,1250,1600,7100,11360000,2,10006,2503,1,177880000,177880000,3751,1250,2501,1250,0,1,1252,468389
168,1250,1600,7100,11360000,2,10006,2503,1,177880000,177880000,3751,1250,2501,1250,0,1,1252,457569
168,1250,1600,7100,11360000,2,10006,2503,1,177880000,177880000,3751,1250,2501,1250,0,1,1252,464935
168,1250,1600,7100,11360000,2,10006,2503,1,177880000,177880000,3751,1250,2501,1250,0,1,1252,463631
168,1250,1600,7100,11360000,2,10006,2503,1,177880000,177880000,3751,1250,2501,1250,0,1,1252,466062
168,1250,1600,7100,11360000,2,10006,2503,1,177880000,177880000,3751,1250,2501,1250,0,1,1252,466973
168,1650,1600,7100,11360000,2,13206,3303,1,205720000,205720000,4951,1650,3301,1650,0,1,1652,5667497
168,1650,1600,7100,11360000,2,13206,3303,1,205720000,205720000,4951,1650,3301,1650,0,1,1652,559848
168,1650,1600,7100,11360000,2,13206,3303,1,205720000,205720000,4951,1650,3301,1650,0,1,1652,555748
168,1650,1600,7100,11360000,2,13206,3303,1,205720000,205720000,4951,1650,3301,1650,0,1,1652,560743
168,1650,1600,7100,11360000,2,13206,3303,1,205720000,205720000,4951,1650,3301,1650,0,1,1652,558457
168,1650,1600,7100,11360000,2,13206,3303,1,205720000,205720000,4951,1650,3301,1650,0,1,1652,569618
168,1650,1600,7100,11360000,2,13206,3303,1,205720000,205720000,4951,1650,3301,1650,0,1,1652,569233
168,2050,1600,7100,11360000,2,16406,4103,1,233560000,233560000,6151,2050,4101,2050,0,1,2052,7010401
168,2050,1600,7100,11360000,2,16406,4103,1,233560000,233560000,6151,2050,4101,2050,0,1,2052,659023
168,2050,1600,7100,11360000,2,16406,4103,1,233560000,233560000,6151,2050,4101,2050,0,1,2052,656437
168,2050,1600,7100,11360000,2,16406,4103,1,233560000,233560000,6151,2050,4101,2050,0,1,2052,661033
168,2050,1600,7100,11360000,2,16406,4103,1,233560000,233560000,6151,2050,4101,2050,0,1,2052,659921
168,2050,1600,7100,11360000,2,16406,4103,1,233560000,233560000,6151,2050,4101,2050,0,1,2052,681844
168,2050,1600,7100,11360000,2,16406,4103,1,233560000,233560000,6151,2050,4101,2050,0,1,2052,682232
168,2450,1600,7100,11360000,2,19606,4903,1,261400000,261400000,7351,2450,4901,2450,0,1,2452,8458014
168,2450,1600,7100,11360000,2,19606,4903,1,261400000,261400000,7351,2450,4901,2450,0,1,2452,762716
168,2450,1600,7100,11360000,2,19606,4903,1,261400000,261400000,7351,2450,4901,2450,0,1,2452,761824
168,2450,1600,7100,11360000,2,19606,4903,1,261400000,261400000,7351,2450,4901,2450,0,1,2452,763919
168,2450,1600,7100,11360000,2,19606,4903,1,261400000,261400000,7351,2450,4901,2450,0,1,2452,758770
168,2450,1600,7100,11360000,2,19606,4903,1,261400000,261400000,7351,2450,4901,2450,0,1,2452,790900
168,2450,1600,7100,11360000,2,19606,4903,1,261400000,261400000,7351,2450,4901,2450,0,1,2452,790430
168,2850,1600,7100,11360000,2,22806,5703,1,289240000,289240000,8551,2850,5701,2850,0,1,2852,9992826
168,2850,1600,7100,11360000,2,22806,5703,1,289240000,289240000,8551,2850,5701,2850,0,1,2852,854095
168,2850,1600,7100,11360000,2,22806,5703,1,289240000,289240000,8551,2850,5701,2850,0,1,2852,872467
168,2850,1600,7100,11360000,2,22806,5703,1,289240000,289240000,8551,2850,5701,2850,0,1,2852,854928
168,2850,1600,7100,11360000,2,22806,5703,1,289240000,289240000,8551,2850,5701,2850,0,1,2852,871178
168,2850,1600,7100,11360000,2,22806,5703,1,289240000,289240000,8551,2850,5701,2850,0,1,2852,913650
168,2850,1600,7100,11360000,2,22806,5703,1,289240000,289240000,8551,2850,5701,2850,0,1,2852,914965
168,3250,1600,7100,11360000,2,26006,6503,1,317080000,317080000,9751,3250,6501,3250,0,1,3252,11564238
168,3250,1600,7100,11360000,2,26006,6503,1,317080000,317080000,9751,3250,6501,3250,0,1,3252,1025126
168,3250,1600,7100,11360000,2,26006,6503,1,317080000,317080000,9751,3250,6501,3250,0,1,3252,991087
168,3250,1600,7100,11360000,2,26006,6503,1,317080000,317080000,9751,3250,6501,3250,0,1,3252,1024586
168,3250,1600,7100,11360000,2,26006,6503,1,317080000,317080000,9751,3250,6501,3250,0,1,3252,1002914
168,3250,1600,7100,11360000,2,26006,6503,1,317080000,317080000,9751,3250,6501,3250,0,1,3252,1021893
168,3250,1600,7100,11360000,2,26006,6503,1,317080000,317080000,9751,3250,6501,3250,0,1,3252,1020674
168,3650,1600,7100,11360000,2,29206,7303,1,344920000,344920000,10951,3650,7301,3650,0,1,3652,13148296
168,3650,1600,7100,11360000,2,29206,7303,1,344920000,344920000,10951,3650,7301,3650,0,1,3652,1152271
168,3650,1600,7100,11360000,2,29206,7303,1,344920000,344920000,10951,3650,7301,3650,0,1,3652,1146604
168,3650,1600,7100,11360000,2,29206,7303,1,344920000,344920000,10951,3650,7301,3650,0,1,3652,1152833
168,3650,1600,7100,11360000,2,29206,7303,1,344920000,344920000,10951,3650,7301,3650,0,1,3652,1150619
168,3650,1600,7100,11360000,2,29206,7303,1,344920000,344920000,10951,3650,7301,3650,0,1,3652,1134946
168,3650,1600,7100,11360000,2,29206,7303,1,344920000,344920000,10951,3650,7301,3650,0,1,3652,1136025
168,4050,1600,7100,11360000,2,32406,8103,1,372760000,372760000,12151,4050,8101,4050,0,1,4052,14304091
168,4050,1600,7100,11360000,2,32406,8103,1,372760000,372760000,12151,4050,8101,4050,0,1,4052,1222189
168,4050,1600,7100,11360000,2,32406,8103,1,372760000,372760000,12151,4050,8101,4050,0,1,4052,1237564
168,4050,1600,7100,11360000,2,32406,8103,1,372760000,372760000,12151,4050,8101,4050,0,1,4052,1224189
168,4050,1600,7100,11360000,2,32406,8103,1,372760000,372760000,12151,4050,8101,4050,0,1,4052,1236583
168,4050,1600,7100,11360000,2,32406,8103,1,372760000,372760000,12151,4050,8101,4050,0,1,4052,1240560
168,4050,1600,7100,11360000,2,32406,8103,1,372760000,372760000,12151,4050,8101,4050,0,1,4052,1241119
168,4450,1600,7100,11360000,2,35606,8903,1,400600000,400600000,13351,4450,8901,4450,0,1,4452,14368616
168,4450,1600,7100,11360000,2,35606,8903,1,400600000,400600000,13351,4450,8901,4450,0,1,4452,1353488
168,4450,1600,7100,11360000,2,35606,8903,1,400600000,400600000,13351,4450,8901,4450,0,1,4452,1348466
168,4450,1600,7100,11360000,2,35606,8903,1,400600000,400600000,13351,4450,8901,4450,0,1,4452,1352892
168,4450,1600,7100,11360000,2,35606,8903,1,400600000,400600000,13351,4450,8901,4450,0,1,4452,1347573
168,4450,1600,7100,11360000,2,35606,8903,1,400600000,400600000,13351,4450,8901,4450,0,1,4452,1341044
168,4450,1600,7100,11360000,2,35606,8903,1,400600000,400600000,13351,4450,8901,4450,0,1,4452,1337472
168,4850,1600,7100,11360000,2,38806,9703,1,428440000,428440000,14551,4850,9701,4850,0,1,4852,16410007
168,4850,1600,7100,11360000,2,38806,9703,1,428440000,428440000,14551,4850,9701,4850,0,1,4852,1475433
168,4850,1600,7100,11360000,2,38806,9703,1,428440000,428440000,14551,4850,9701,4850,0,1,4852,1468205
168,4850,1600,7100,11360000,2,38806,9703,1,428440000,428440000,14551,4850,9701,4850,0,1,4852,1477211
168,4850,1600,7100,11360000,2,38806,9703,1,428440000,428440000,14551,4850,9701,4850,0,1,4852,1476424
168,4850,1600,7100,11360000,2,38806,9703,1,428440000,428440000,14551,4850,9701,4850,0,1,4852,1448814
168,4850,1600,7100,11360000,2,38806,9703,1,428440000,428440000,14551,4850,9701,4850,0,1,4852,1447304
168,5250,1600,7100,11360000,2,42006,10503,1,456280000,456280000,15751,5250,10501,5250,0,1,5252,17955068
168,5250,1600,7100,11360000,2,42006,10503,1,456280000,456280000,15751,5250,10501,5250,0,1,5252,1564355
168,5250,1600,7100,11360000,2,42006,10503,1,456280000,456280000,15751,5250,10501,5250,0,1,5252,1587101
168,5250,1600,7100,11360000,2,42006,10503,1,456280000,456280000,15751,5250,10501,5250,0,1,5252,1571419
168,5250,1600,7100,11360000,2,42006,10503,1,456280000,456280000,15751,5250,10501,5250,0,1,5252,1586443
168,5250,1600,7100,11360000,2,42006,10503,1,456280000,456280000,15751,5250,10501,5250,0,1,5252,1572327
168,5250,1600,7100,11360000,2,42006,10503,1,456280000,456280000,15751,5250,10501,5250,0,1,5252,1571937
168,5650,1600,7100,11360000,2,45206,11303,1,484120000,484120000,16951,5650,11301,5650,0,1,5652,20031325
168,5650,1600,7100,11360000,2,45206,11303,1,484120000,484120000,16951,5650,11301,5650,0,1,5652,1704440
168,5650,1600,7100,11360000,2,45206,11303,1,484120000,484120000,16951,5650,11301,5650,0,1,5652,1676882
168,5650,1600,7100,11360000,2,45206,11303,1,484120000,484120000,16951,5650,11301,5650,0,1,5652,1705099
168,5650,1600,7100,11360000,2,45206,11303,1,484120000,484120000,16951,5650,11301,5650,0,1,5652,1681589
168,5650,1600,7100,11360000,2,45206,11303,1,484120000,484120000,16951,5650,11301,5650,0,1,5652,1656701
168,5650,1600,7100,11360000,2,45206,11303,1,484120000,484120000,16951,5650,11301,5650,0,1,5652,1655258
168,6050,1600,7100,11360000,2,48406,12103,1,511960000,511960000,18151,6050,12101,6050,0,1,6052,21072604
168,6050,1600,7100,11360000,2,48406,12103,1,511960000,511960000,18151,6050,12101,6050,0,1,6052,1810792
168,6050,1600,7100,11360000,2,48406,12103,1,511960000,511960000,18151,6050,12101,6050,0,1,6052,1826013
168,6050,1600,7100,11360000,2,48406,12103,1,511960000,511960000,18151,6050,12101,6050,0,1,6052,1816941
168,6050,1600,7100,11360000,2,48406,12103,1,511960000,511960000,18151,6050,12101,6050,0,1,6052,1825334
168,6050,1600,7100,11360000,2,48406,12103,1,511960000,511960000,18151,6050,12101,6050,0,1,6052,1799435
168,6050,1600,7100,11360000,2,48406,12103,1,511960000,511960000,18151,6050,12101,6050,0,1,6052,1797898
168,6450,1600,7100,11360000,2,51606,12903,1,539800000,539800000,19351,6450,12901,6450,0,1,6452,23464525
168,6450,1600,7100,11360000,2,51606,12903,1,539800000,539800000,19351,6450,12901,6450,0,1,6452,1930763
168,6450,1600,7100,11360000,2,51606,12903,1,539800000,539800000,19351,6450,12901,6450,0,1,6452,1914301
168,6450,1600,7100,11360000,2,51606,12903,1,539800000,539800000,19351,6450,12901,6450,0,1,6452,1933561
168,6450,1600,7100,11360000,2,51606,12903,1,539800000,539800000,19351,6450,12901,6450,0,1,6452,1921974
168,6450,1600,7100,11360000,2,51606,12903,1,539800000,539800000,19351,6450,12901,6450,0,1,6452,1874118
168,6450,1600,7100,11360000,2,51606,12903,1,539800000,539800000,19351,6450,12901,6450,0,1,6452,1872493
168,6850,1600,7100,11360000,2,54806,13703,1,567640000,567640000,20551,6850,13701,6850,0,1,6852,25163837
168,6850,1600,7100,11360000,2,54806,13703,1,567640000,567640000,20551,6850,13701,6850,0,1,6852,2076065
168,6850,1600,7100,11360000,2,54806,13703,1,567640000,567640000,20551,6850,13701,6850,0,1,6852,2048723
168,6850,1600,7100,11360000,2,54806,13703,1,567640000,567640000,20551,6850,13701,6850,0,1,6852,2072845
168,6850,1600,7100,11360000,2,54806,13703,1,567640000,567640000,20551,6850,13701,6850,0,1,6852,2075335
168,6850,1600,7100,11360000,2,54806,13703,1,567640000,567640000,20551,6850,13701,6850,0,1,6852,2013262
168,6850,1600,7100,11360000,2,54806,13703,1,567640000,567640000,20551,6850,13701,6850,0,1,6852,2007007
168,50,1600,6700,10720000,2,406,103,1,89080000,89080000,151,50,101,50,0,1,52,126855
168,50,1600,6700,10720000,2,406,103,1,89080000,89080000,151,50,101,50,0,1,52,105748
168,50,1600,6700,10720000,2,406,103,1,89080000,89080000,151,50,101,50,0,1,52,109732
168,50,1600,6700,10720000,2,406,103,1,89080000,89080000,151,50,101,50,0,1,52,74520
168,50,1600,6700,10720000,2,406,103,1,89080000,89080000,151,50,101,50,0,1,52,110791
168,50,1600,6700,10720000,2,406,103,1,89080000,89080000,151,50,101,50,0,1,52,138432
168,50,1600,6700,10720000,2,406,103,1,89080000,89080000,151,50,101,50,0,1,52,140750
168,450,1600,6700,10720000,2,3606,903,1,115640000,115640000,1351,450,901,450,0,1,452,1125912
168,450,1600,6700,10720000,2,3606,903,1,115640000,115640000,1351,450,901,450,0,1,452,229312
168,450,1600,6700,10720000,2,3606,903,1,115640000,115640000,1351,450,901,450,0,1,452,228878
168,450,1600,6700,10720000,2,3606,903,1,115640000,115640000,1351,450,901,450,0,1,452,229651
168,450,1600,6700,10720000,2,3606,903,1,115640000,115640000,1351,450,901,450,0,1,452,227005
168,450,1600,6700,10720000,2,3606,903,1,115640000,115640000,1351,450,901,450,0,1,452,230495
168,450,1600,6700,10720000,2,3606,903,1,115640000,115640000,1351,450,901,450,0,1,452,230832
168,850,1600,6700,10720000,2,6806,1703,1,142200000,142200000,2551,850,1701,850,0,1,852,2447455
168,850,1600,6700,10720000,2,6806,1703,1,142200000,142200000,2551,850,1701,850,0,1,852,342074
168,850,1600,6700,10720000,2,6806,1703,1,142200000,142200000,2551,850,1701,850,0,1,852,338609
168,850,1600,6700,10720000,2,6806,1703,1,142200000,142200000,2551,850,1701,850,0,1,852,340606
168,850,1600,6700,10720000,2,6806,1703,1,142200000,142200000,2551,850,1701,850,0,1,852,341122
168,850,1600,6700,10720000,2,6806,1703,1,142200000,142200000,2551,850,1701,850,0,1,852,341724
168,850,1600,6700,10720000,2,6806,1703,1,142200000,142200000,2551,850,1701,850,0,1,852,341414
168,1250,1600,6700,10720000,2,10006,2503,1,168760000,168760000,3751,1250,2501,1250,0,1,1252,3780234
168,1250,1600,6700,10720000,2,10006,2503,1,168760000,168760000,3751,1250,2501,1250,0,1,1252,434127
168,1250,1600,6700,10720000,2,10006,2503,1,168760000,168760000,3751,1250,2501,1250,0,1,1252,437051
168,1250,1600,6700,10720000,2,10006,2503,1,168760000,168760000,3751,1250,2501,1250,0,1,1252,421179
168,1250,1600,6700,10720000,2,10006,2503,1,168760000,168760000,3751,1250,2501,1250,0,1,1252,437284
168,1250,1600,6700,10720000,2,10006,2503,1,168760000,168760000,3751,1250,2501,1250,0,1,1252,436653
168,1250,1600,6700,10720000,2,10006,2503,1,168760000,168760000,3751,1250,2501,1250,0,1,1252,435872
168,1650,1600,6700,10720000,2,13206,3303,1,195320000,195320000,4951,1650,3301,1650,0,1,1652,5162497
168,1650,1600,6700,10720000,2,13206,3303,1,195320000,195320000,4951,1650,3301,1650,0,1,1652,540813
168,1650,1600,6700,10720000,2,13206,3303,1,195320000,195320000,4951,1650,3301,1650,0,1,1652,536253
168,1650,1600,6700,10720000,2,13206,3303,1,195320000,195320000,4951,1650,3301,1650,0,1,1652,544304
168,1650,1600,6700,10720000,2,13206,3303,1,195320000,195320000,4951,1650,3301,1650,0,1,1652,542972
168,1650,1600,6700,10720000,2,13206,3303,1,195320000,195320000,4951,1650,3301,1650,0,1,1652,548466
168,1650,1600,6700,10720000,2,13206,3303,1,195320000,195320000,4951,1650,3301,1650,0,1,1652,547934
168,2050,1600,6700,10720000,2,16406,4103,1,221880000,221880000,6151,2050,4101,2050,0,1,2052,6534817
168,2050,1600,6700,10720000,2,16406,4103,1,221880000,221880000,6151,2050,4101,2050,0,1,2052,619441
168,2050,1600,6700,10720000,2,16406,4103,1,221880000,221880000,6151,2050,4101,2050,0,1,2052,620482
168,2050,1600,6700,10720000,2,16406,4103,1,221880000,221880000,6151,2050,4101,2050,0,1,2052,621104
168,2050,1600,6700,10720000,2,16406,4103,1,221880000,221880000,6151,2050,4101,2050,0,1,2052,618222
168,2050,1600,6700,10720000,2,16406,4103,1,221880000,221880000,6151,2050,4101,2050,0,1,2052,643650
168,2050,1600,6700,10720000,2,16406,4103,1,221880000,221880000,6151,2050,4101,2050,0,1,2052,643264
168,2450,1600,6700,10720000,2,19606,4903,1,248440000,248440000,7351,2450,4901,2450,0,1,2452,7896421
168,2450,1600,6700,10720000,2,19606,4903,1,248440000,248440000,7351,2450,4901,2450,0,1,2452,708730
168,2450,1600,6700,10720000,2,19606,4903,1,248440000,248440000,7351,2450,4901,2450,0,1,2452,726143
168,2450,1600,6700,10720000,2,19606,4903,1,248440000,248440000,7351,2450,4901,2450,0,1,2452,710601
168,2450,1600,6700,10720000,2,19606,4903,1,248440000,248440000,7351,2450,4901,2450,0,1,2452,725659
168,2450,1600,6700,10720000,2,19606,4903,1,248440000,248440000,7351,2450,4901,2450,0,1,2452,784781
168,2450,1600,6700,10720000,2,19606,4903,1,248440000,248440000,7351,2450,4901,2450,0,1,2452,784382
168,2850,1600,6700,10720000,2,22806,5703,1,275000000,275000000,8551,2850,5701,2850,0,1,2852,8950580
168,2850,1600,6700,10720000,2,22806,5703,1,275000000,275000000,8551,2850,5701,2850,0,1,2852,843782
168,2850,1600,6700,10720000,2,22806,5703,1,275000000,275000000,8551,2850,5701,2850,0,1,2852,840924
168,2850,1600,6700,10720000,2,22806,5703,1,275000000,275000000,8551,2850,5701,2850,0,1,2852,845764
168,2850,1600,6700,10720000,2,22806,5703,1,275000000,275000000,8551,2850,5701,2850,0,1,2852,844671
168,2850,1600,6700,10720000,2,22806,5703,1,275000000,275000000,8551,2850,5701,2850,0,1,2852,856490
168,2850,1600,6700,10720000,2,22806,5703,1,275000000,275000000,8551,2850,5701,2850,0,1,2852,856072
168,3250,1600,6700,10720000,2,26006,6503,1,301560000,301560000,9751,3250,6501,3250,0,1,3252,10852023
168,3250,1600,6700,10720000,2,26006,6503,1,301560000,301560000,9751,3250,6501,3250,0,1,3252,967213
168,3250,1600,6700,10720000,2,26006,6503,1,301560000,301560000,9751,3250,6501,3250,0,1,3252,938652
168,3250,1600,6700,10720000,2,26006,6503,1,301560000,301560000,9751,3250,6501,3250,0,1,3252,968114
168,3250,1600,6700,10720000,2,26006,6503,1,301560000,301560000,9751,3250,6501,3250,0,1,3252,941183
168,3250,1600,6700,10720000,2,26006,6503,1,301560000,301560000,9751,3250,6501,3250,0,1,3252,971380
168,3250,1600,6700,10720000,2,26006,6503,1,301560000,301560000,9751,3250,6501,3250,0,1,3252,970952
168,3650,1600,6700,10720000,2,29206,7303,1,328120000,328120000,10951,3650,7301,3650,0,1,3652,12100282
168,3650,1600,6700,10720000,2,29206,7303,1,328120000,328120000,10951,3650,7301,3650,0,1,3652,1056453
168,3650,1600,6700,10720000,2,29206,7303,1,328120000,328120000,10951,3650,7301,3650,0,1,3652,1053662
168,3650,1600,6700,10720000,2,29206,7303,1,328120000,328120000,10951,3650,7301,3650,0,1,3652,1057592
168,3650,1600,6700,10720000,2,29206,7303,1,328120000,328120000,10951,3650,7301,3650,0,1,3652,1050861
168,3650,1600,6700,10720000,2,29206,7303,1,328120000,328120000,10951,3650,7301,3650,0,1,3652,1059690
168,3650,1600,6700,10720000,2,29206,7303,1,328120000,328120000,10951,3650,7301,3650,0,1,3652,1060137
168,4050,1600,6700,10720000,2,32406,8103,1,354680000,354680000,12151,4050,8101,4050,0,1,4052,13483442
168,4050,1600,6700,10720000,2,32406,8103,1,354680000,354680000,12151,4050,8101,4050,0,1,4052,1135359
168,4050,1600,6700,10720000,2,32406,8103,1,354680000,354680000,12151,4050,8101,4050,0,1,4052,1188395
168,4050,1600,6700,10720000,2,32406,8103,1,354680000,354680000,12151,4050,8101,4050,0,1,4052,1158757
168,4050,1600,6700,10720000,2,32406,8103,1,354680000,354680000,12151,4050,8101,4050,0,1,4052,1183765
168,4050,1600,6700,10720000,2,32406,8103,1,354680000,354680000,12151,4050,8101,4050,0,1,4052,1187546
168,4050,1600,6700,10720000,2,32406,8103,1,354680000,354680000,12151,4050,8101,4050,0,1,4052,1188022
168,4450,1600,6700,10720000,2,35606,8903,1,381240000,381240000,13351,4450,8901,4450,0,1,4452,15163886
168,4450,1600,6700,10720000,2,35606,8903,1,381240000,381240000,13351,4450,8901,4450,0,1,4452,1285297
168,4450,1600,6700,10720000,2,35606,8903,1,381240000,381240000,13351,4450,8901,4450,0,1,4452,1273548
168,4450,1600,6700,10720000,2,35606,8903,1,381240000,381240000,13351,4450,8901,4450,0,1,4452,1287464
168,4450,1600,6700,10720000,2,35606,8903,1,381240000,381240000,13351,4450,8901,4450,0,1,4452,1275810
168,4450,1600,6700,10720000,2,35606,8903,1,381240000,381240000,13351,4450,8901,4450,0,1,4452,1279687
168,4450,1600,6700,10720000,2,35606,8903,1,381240000,381240000,13351,4450,8901,4450,0,1,4452,1278919
168,4850,1600,6700,10720000,2,38806,9703,1,407800000,407800000,14551,4850,9701,4850,0,1,4852,15707244
168,4850,1600,6700,10720000,2,38806,9703,1,407800000,407800000,14551,4850,9701,4850,0,1,4852,1380772
168,4850,1600,6700,10720000,2,38806,9703,1,407800000,407800000,14551,4850,9701,4850,0,1,4852,1381365
168,4850,1600,6700,10720000,2,38806,9703,1,407800000,407800000,14551,4850,9701,4850,0,1,4852,1383790
168,4850,1600,6700,10720000,2,38806,9703,1,407800000,407800000,14551,4850,9701,4850,0,1,4852,1383019
168,4850,1600,6700,10720000,2,38806,9703,1,407800000,407800000,14551,4850,9701,4850,0,1,4852,1374353
168,4850,1600,6700,10720000,2,38806,9703,1,407800000,407800000,14551,4850,9701,4850,0,1,4852,1372293
168,5250,1600,6700,10720000,2,42006,10503,1,434360000,434360000,15751,5250,10501,5250,0,1,5252,17527129
168,5250,1600,6700,10720000,2,42006,10503,1,434360000,434360000,15751,5250,10501,5250,0,1,5252,1493736
168,5250,1600,6700,10720000,2,42006,10503,1,434360000,434360000,15751,5250,10501,5250,0,1,5252,1513554
168,5250,1600,6700,10720000,2,42006,10503,1,434360000,434360000,15751,5250,10501,5250,0,1,5252,1510340
168,5250,1600,6700,10720000,2,42006,10503,1,434360000,434360000,15751,5250,10501,5250,0,1,5252,1516937
168,5250,1600,6700,10720000,2,42006,10503,1,434360000,434360000,15751,5250,10501,5250,0,1,5252,1507180
168,5250,1600,6700,10720000,2,42006,10503,1,434360000,434360000,15751,5250,10501,5250,0,1,5252,1510996
168,5650,1600,6700,10720000,2,45206,11303,1,460920000,460920000,16951,5650,11301,5650,0,1,5652,18558519
168,5650,1600,6700,10720000,2,45206,11303,1,460920000,460920000,16951,5650,11301,5650,0,1,5652,1618687
168,5650,1600,6700,10720000,2,45206,11303,1,460920000,460920000,16951,5650,11301,5650,0,1,5652,1617757
168,5650,1600,6700,10720000,2,45206,11303,1,460920000,460920000,16951,5650,11301,5650,0,1,5652,1619153
168,5650,1600,6700,10720000,2,45206,11303,1,460920000,460920000,16951,5650,11301,5650,0,1,5652,1618277
168,5650,1600,6700,10720000,2,45206,11303,1,460920000,460920000,16951,5650,11301,5650,0,1,5652,1611146
168,5650,1600,6700,10720000,2,45206,11303,1,460920000,460920000,16951,5650,11301,5650,0,1,5652,1612818
168,6050,1600,6700,10720000,2,48406,12103,1,487480000,487480000,18151,6050,12101,6050,0,1,6052,19920709
168,6050,1600,6700,10720000,2,48406,12103,1,487480000,487480000,18151,6050,12101,6050,0,1,6052,1725357
168,6050,1600,6700,10720000,2,48406,12103,1,487480000,487480000,18151,6050,12101,6050,0,1,6052,1741244
168,6050,1600,6700,10720000,2,48406,12103,1,487480000,487480000,18151,6050,12101,6050,0,1,6052,1726288
168,6050,1600,6700,10720000,2,48406,12103,1,487480000,487480000,18151,6050,12101,6050,0,1,6052,1740528
168,6050,1600,6700,10720000,2,48406,12103,1,487480000,487480000,18151,6050,12101,6050,0,1,6052,1696758
168,6050,1600,6700,10720000,2,48406,12103,1,487480000,487480000,18151,6050,12101,6050,0,1,6052,1680824
168,6450,1600,6700,10720000,2,51606,12903,1,514040000,514040000,19351,6450,12901,6450,0,1,6452,21362542
168,6450,1600,6700,10720000,2,51606,12903,1,514040000,514040000,19351,6450,12901,6450,0,1,6452,1821540
168,6450,1600,6700,10720000,2,51606,12903,1,514040000,514040000,19351,6450,12901,6450,0,1,6452,1803677
168,6450,1600,6700,10720000,2,51606,12903,1,514040000,514040000,19351,6450,12901,6450,0,1,6452,1826637
168,6450,1600,6700,10720000,2,51606,12903,1,514040000,514040000,19351,6450,12901,6450,0,1,6452,1811102
168,6450,1600,6700,10720000,2,51606,12903,1,514040000,514040000,19351,6450,12901,6450,0,1,6452,1775959
168,6450,1600,6700,10720000,2,51606,12903,1,514040000,514040000,19351,6450,12901,6450,0,1,6452,1777592
168,6850,1600,6700,10720000,2,54806,13703,1,540600000,540600000,20551,6850,13701,6850,0,1,6852,23002526
168,6850,1600,6700,10720000,2,54806,13703,1,540600000,540600000,20551,6850,13701,6850,0,1,6852,1933218
168,6850,1600,6700,10720000,2,54806,13703,1,540600000,540600000,20551,6850,13701,6850,0,1,6852,1953143
168,6850,1600,6700,10720000,2,54806,13703,1,540600000,540600000,20551,6850,13701,6850,0,1,6852,1938380
168,6850,1600,6700,10720000,2,54806,13703,1,540600000,540600000,20551,6850,13701,6850,0,1,6852,1952410
168,6850,1600,6700,10720000,2,54806,13703,1,540600000,540600000,20551,6850,13701,6850,0,1,6852,1906971
168,6850,1600,6700,10720000,2,54806,13703,1,540600000,540600000,20551,6850,13701,6850,0,1,6852,1912833
168,50,1600,6300,10080000,2,406,103,1,83800000,83800000,151,50,101,50,0,1,52,117146
168,50,1600,6300,10080000,2,406,103,1,83800000,83800000,151,50,101,50,0,1,52,102774
168,50,1600,6300,10080000,2,406,103,1,83800000,83800000,151,50,101,50,0,1,52,88615
168,50,1600,6300,10080000,2,406,103,1,83800000,83800000,151,50,101,50,0,1,52,105105
168,50,1600,6300,10080000,2,406,103,1,83800000,83800000,151,50,101,50,0,1,52,105524
168,50,1600,6300,10080000,2,406,103,1,83800000,83800000,151,50,101,50,0,1,52,125047
168,50,1600,6300,10080000,2,406,103,1,83800000,83800000,151,50,101,50,0,1,52,127190
168,450,1600,6300,10080000,2,3606,903,1,109080000,109080000,1351,450,901,450,0,1,452,1142157
168,450,1600,6300,10080000,2,3606,903,1,109080000,109080000,1351,450,901,450,0,1,452,201542
168,450,1600,6300,10080000,2,3606,903,1,109080000,109080000,1351,450,901,450,0,1,452,200761
168,450,1600,6300,10080000,2,3606,903,1,109080000,109080000,1351,450,901,450,0,1,452,186196
168,450,1600,6300,10080000,2,3606,903,1,109080000,109080000,1351,450,901,450,0,1,452,198684
168,450,1600,6300,10080000,2,3606,903,1,109080000,109080000,1351,450,901,450,0,1,452,211975
168,450,1600,6300,10080000,2,3606,903,1,109080000,109080000,1351,450,901,450,0,1,452,212306
168,850,1600,6300,10080000,2,6806,1703,1,134360000,134360000,2551,850,1701,850,0,1,852,2560047
168,850,1600,6300,10080000,2,6806,1703,1,134360000,134360000,2551,850,1701,850,0,1,852,320677
168,850,1600,6300,10080000,2,6806,1703,1,134360000,134360000,2551,850,1701,850,0,1,852,304210
168,850,1600,6300,10080000,2,6806,1703,1,134360000,134360000,2551,850,1701,850,0,1,852,321082
168,850,1600,6300,10080000,2,6806,1703,1,134360000,134360000,2551,850,1701,850,0,1,852,312211
168,850,1600,6300,10080000,2,6806,1703,1,134360000,134360000,2551,850,1701,850,0,1,852,315138
168,850,1600,6300,10080000,2,6806,1703,1,134360000,134360000,2551,850,1701,850,0,1,852,315616
168,1250,1600,6300,10080000,2,10006,2503,1,159640000,159640000,3751,1250,2501,1250,0,1,1252,3534066
168,1250,1600,6300,10080000,2,10006,2503,1,159640000,159640000,3751,1250,2501,1250,0,1,1252,394566
168,1250,1600,6300,10080000,2,10006,2503,1,159640000,159640000,3751,1250,2501,1250,0,1,1252,375773
168,1250,1600,6300,10080000,2,10006,2503,1,159640000,159640000,3751,1250,2501,1250,0,1,1252,409093
168,1250,1600,6300,10080000,2,10006,2503,1,159640000,159640000,3751,1250,2501,1250,0,1,1252,407794
168,1250,1600,6300,10080000,2,10006,2503,1,159640000,159640000,3751,1250,2501,1250,0,1,1252,409876
168,1250,1600,6300,10080000,2,10006,2503,1,159640000,159640000,3751,1250,2501,1250,0,1,1252,409513
168,1650,1600,6300,10080000,2,13206,3303,1,184920000,184920000,4951,1650,3301,1650,0,1,1652,4843990
168,1650,1600,6300,10080000,2,13206,3303,1,184920000,184920000,4951,1650,3301,1650,0,1,1652,489650
168,1650,1600,6300,10080000,2,13206,3303,1,184920000,184920000,4951,1650,3301,1650,0,1,1652,489195
168,1650,1600,6300,10080000,2,13206,3303,1,184920000,184920000,4951,1650,3301,1650,0,1,1652,490137
168,1650,1600,6300,10080000,2,13206,3303,1,184920000,184920000,4951,1650,3301,1650,0,1,1652,488426
168,1650,1600,6300,10080000,2,13206,3303,1,184920000,184920000,4951,1650,3301,1650,0,1,1652,500368
168,1650,1600,6300,10080000,2,13206,3303,1,184920000,184920000,4951,1650,3301,1650,0,1,1652,500744
168,2050,1600,6300,10080000,2,16406,4103,1,210200000,210200000,6151,2050,4101,2050,0,1,2052,5892758
168,2050,1600,6300,10080000,2,16406,4103,1,210200000,210200000,6151,2050,4101,2050,0,1,2052,610358
168,2050,1600,6300,10080000,2,16406,4103,1,210200000,210200000,6151,2050,4101,2050,0,1,2052,612500
168,2050,1600,6300,10080000,2,16406,4103,1,210200000,210200000,6151,2050,4101,2050,0,1,2052,613563
168,2050,1600,6300,10080000,2,16406,4103,1,210200000,210200000,6151,2050,4101,2050,0,1,2052,613028
168,2050,1600,6300,10080000,2,16406,4103,1,210200000,210200000,6151,2050,4101,2050,0,1,2052,614912
168,2050,1600,6300,10080000,2,16406,4103,1,210200000,210200000,6151,2050,4101,2050,0,1,2052,615306
168,2450,1600,6300,10080000,2,19606,4903,1,235480000,235480000,7351,2450,4901,2450,0,1,2452,7362789
168,2450,1600,6300,10080000,2,19606,4903,1,235480000,235480000,7351,2450,4901,2450,0,1,2452,681753
168,2450,1600,6300,10080000,2,19606,4903,1,235480000,235480000,7351,2450,4901,2450,0,1,2452,685197
168,2450,1600,6300,10080000,2,19606,4903,1,235480000,235480000,7351,2450,4901,2450,0,1,2452,687410
168,2450,1600,6300,10080000,2,19606,4903,1,235480000,235480000,7351,2450,4901,2450,0,1,2452,695551
168,2450,1600,6300,10080000,2,19606,4903,1,235480000,235480000,7351,2450,4901,2450,0,1,2452,716449
168,2450,1600,6300,10080000,2,19606,4903,1,235480000,235480000,7351,2450,4901,2450,0,1,2452,708898
168,2850,1600,6300,10080000,2,22806,5703,1,260760000,260760000,8551,2850,5701,2850,0,1,2852,8372109
168,2850,1600,6300,10080000,2,22806,5703,1,260760000,260760000,8551,2850,5701,2850,0,1,2852,800057
168,2850,1600,6300,10080000,2,22806,5703,1,260760000,260760000,8551,2850,5701,2850,0,1,2852,805598
168,2850,1600,6300,10080000,2,22806,5703,1,260760000,260760000,8551,2850,5701,2850,0,1,2852,801561
168,2850,1600,6300,10080000,2,22806,5703,1,260760000,260760000,8551,2850,5701,2850,0,1,2852,791208
168,2850,1600,6300,10080000,2,22806,5703,1,260760000,260760000,8551,2850,5701,2850,0,1,2852,812667
168,2850,1600,6300,10080000,2,22806,5703,1,260760000,260760000,8551,2850,5701,2850,0,1,2852,825865
168,3250,1600,6300,10080000,2,26006,6503,1,286040000,286040000,9751,3250,6501,3250,0,1,3252,9514228
168,3250,1600,6300,10080000,2,26006,6503,1,286040000,286040000,9751,3250,6501,3250,0,1,3252,893836
168,3250,1600,6300,10080000,2,26006,6503,1,286040000,286040000,9751,3250,6501,3250,0,1,3252,886621
168,3250,1600,6300,10080000,2,26006,6503,1,286040000,286040000,9751,3250,6501,3250,0,1,3252,898160
168,3250,1600,6300,10080000,2,26006,6503,1,286040000,286040000,9751,3250,6501,3250,0,1,3252,897185
168,3250,1600,6300,10080000,2,26006,6503,1,286040000,286040000,9751,3250,6501,3250,0,1,3252,905977
168,3250,1600,6300,10080000,2,26006,6503,1,286040000,286040000,9751,3250,6501,3250,0,1,3252,905552
168,3650,1600,6300,10080000,2,29206,7303,1,311320000,311320000,10951,3650,7301,3650,0,1,3652,11152908
168,3650,1600,6300,10080000,2,29206,7303,1,311320000,311320000,10951,3650,7301,3650,0,1,3652,1002228
168,3650,1600,6300,10080000,2,29206,7303,1,311320000,311320000,10951,3650,7301,3650,0,1,3652,979731
168,3650,1600,6300,10080000,2,29206,7303,1,311320000,311320000,10951,3650,7301,3650,0,1,3652,1006471
168,3650,1600,6300,10080000,2,29206,7303,1,311320000,311320000,10951,3650,7301,3650,0,1,3652,982119
168,3650,1600,6300,10080000,2,29206,7303,1,311320000,311320000,10951,3650,7301,3650,0,1,3652,1006951
168,3650,1600,6300,10080000,2,29206,7303,1,311320000,311320000,10951,3650,7301,3650,0,1,3652,1007403
168,4050,1600,6300,10080000,2,32406,8103,1,336600000,336600000,12151,4050,8101,4050,0,1,4052,12763098
168,4050,1600,6300,10080000,2,32406,8103,1,336600000,336600000,12151,4050,8101,4050,0,1,4052,1101748
168,4050,1600,6300,10080000,2,32406,8103,1,336600000,336600000,12151,4050,8101,4050,0,1,4052,1097878
168,4050,1600,6300,10080000,2,32406,8103,1,336600000,336600000,12151,4050,8101,4050,0,1,4052,1110509
168,4050,1600,6300,10080000,2,32406,8103,1,336600000,336600000,12151,4050,8101,4050,0,1,4052,1115598
168,4050,1600,6300,10080000,2,32406,8103,1,336600000,336600000,12151,4050,8101,4050,0,1,4052,1116201
168,4050,1600,6300,10080000,2,32406,8103,1,336600000,336600000,12151,4050,8101,4050,0,1,4052,1111937
168,4450,1600,6300,10080000,2,35606,8903,1,361880000,361880000,13351,4450,8901,4450,0,1,4452,13565348
168,4450,1600,6300,10080000,2,35606,8903,1,361880000,361880000,13351,4450,8901,4450,0,1,4452,1210296
168,4450,1600,6300,10080000,2,35606,8903,1,361880000,361880000,13351,4450,8901,4450,0,1,4452,1218147
168,4450,1600,6300,10080000,2,35606,8903,1,361880000,361880000,13351,4450,8901,4450,0,1,4452,1213371
168,4450,1600,6300,10080000,2,35606,8903,1,361880000,361880000,13351,4450,8901,4450,0,1,4452,1197258
168,4450,1600,6300,10080000,2,35606,8903,1,361880000,361880000,13351,4450,8901,4450,0,1,4452,1212380
168,4450,1600,6300,10080000,2,35606,8903,1,361880000,361880000,13351,4450,8901,4450,0,1,4452,1216011
168,4850,1600,6300,10080000,2,38806,9703,1,387160000,387160000,14551,4850,9701,4850,0,1,4852,14317713
168,4850,1600,6300,10080000,2,38806,9703,1,387160000,387160000,14551,4850,9701,4850,0,1,4852,1310012
168,4850,1600,6300,10080000,2,38806,9703,1,387160000,387160000,14551,4850,9701,4850,0,1,4852,1296621
168,4850,1600,6300,10080000,2,38806,9703,1,387160000,387160000,14551,4850,9701,4850,0,1,4852,1314363
168,4850,1600,6300,10080000,2,38806,9703,1,387160000,387160000,14551,4850,9701,4850,0,1,4852,1298972
168,4850,1600,6300,10080000,2,38806,9703,1,387160000,387160000,14551,4850,9701,4850,0,1,4852,1302159
168,4850,1600,6300,10080000,2,38806,9703,1,387160000,387160000,14551,4850,9701,4850,0,1,4852,1302943
168,5250,1600,6300,10080000,2,42006,10503,1,412440000,412440000,15751,5250,10501,5250,0,1,5252,15464524
168,5250,1600,6300,10080000,2,42006,10503,1,412440000,412440000,15751,5250,10501,5250,0,1,5252,1409516
168,5250,1600,6300,10080000,2,42006,10503,1,412440000,412440000,15751,5250,10501,5250,0,1,5252,1413807
168,5250,1600,6300,10080000,2,42006,10503,1,412440000,412440000,15751,5250,10501,5250,0,1,5252,1414484
168,5250,1600,6300,10080000,2,42006,10503,1,412440000,412440000,15751,5250,10501,5250,0,1,5252,1420972
168,5250,1600,6300,10080000,2,42006,10503,1,412440000,412440000,15751,5250,10501,5250,0,1,5252,1408033
168,5250,1600,6300,10080000,2,42006,10503,1,412440000,412440000,15751,5250,10501,5250,0,1,5252,1384758
168,5650,1600,6300,10080000,2,45206,11303,1,437720000,437720000,16951,5650,11301,5650,0,1,5652,17032873
168,5650,1600,6300,10080000,2,45206,11303,1,437720000,437720000,16951,5650,11301,5650,0,1,5652,1513038
168,5650,1600,6300,10080000,2,45206,11303,1,437720000,437720000,16951,5650,11301,5650,0,1,5652,1520463
168,5650,1600,6300,10080000,2,45206,11303,1,437720000,437720000,16951,5650,11301,5650,0,1,5652,1517885
168,5650,1600,6300,10080000,2,45206,11303,1,437720000,437720000,16951,5650,11301,5650,0,1,5652,1516835
168,5650,1600,6300,10080000,2,45206,11303,1,437720000,437720000,16951,5650,11301,5650,0,1,5652,1483332
168,5650,1600,6300,10080000,2,45206,11303,1,437720000,437720000,16951,5650,11301,5650,0,1,5652,1497913
168,6050,1600,6300,10080000,2,48406,12103,1,463000000,463000000,18151,6050,12101,6050,0,1,6052,18241255
168,6050,1600,6300,10080000,2,48406,12103,1,463000000,463000000,18151,6050,12101,6050,0,1,6052,1620498
168,6050,1600,6300,10080000,2,48406,12103,1,463000000,463000000,18151,6050,12101,6050,0,1,6052,1606281
168,6050,1600,6300,10080000,2,48406,12103,1,463000000,463000000,18151,6050,12101,6050,0,1,6052,1624723
168,6050,1600,6300,10080000,2,48406,12103,1,463000000,463000000,18151,6050,12101,6050,0,1,6052,1605150
168,6050,1600,6300,10080000,2,48406,12103,1,463000000,463000000,18151,6050,12101,6050,0,1,6052,1590748
168,6050,1600,6300,10080000,2,48406,12103,1,463000000,463000000,18151,6050,12101,6050,0,1,6052,1589136
168,6450,1600,6300,10080000,2,51606,12903,1,488280000,488280000,19351,6450,12901,6450,0,1,6452,19059266
168,6450,1600,6300,10080000,2,51606,12903,1,488280000,488280000,19351,6450,12901,6450,0,1,6452,1718548
168,6450,1600,6300,10080000,2,51606,12903,1,488280000,488280000,19351,6450,12901,6450,0,1,6452,1731805
168,6450,1600,6300,10080000,2,51606,12903,1,488280000,488280000,19351,6450,12901,6450,0,1,6452,1719720
168,6450,1600,6300,10080000,2,51606,12903,1,488280000,488280000,19351,6450,12901,6450,0,1,6452,1734511
168,6450,1600,6300,10080000,2,51606,12903,1,488280000,488280000,19351,6450,12901,6450,0,1,6452,1701455
168,6450,1600,6300,10080000,2,51606,12903,1,488280000,488280000,19351,6450,12901,6450,0,1,6452,1711292
168,6850,1600,6300,10080000,2,54806,13703,1,513560000,513560000,20551,6850,13701,6850,0,1,6852,20728223
168,6850,1600,6300,10080000,2,54806,13703,1,513560000,513560000,20551,6850,13701,6850,0,1,6852,1803221
168,6850,1600,6300,10080000,2,54806,13703,1,513560000,513560000,20551,6850,13701,6850,0,1,6852,1786144
168,6850,1600,6300,10080000,2,54806,13703,1,513560000,513560000,20551,6850,13701,6850,0,1,6852,1797283
168,6850,1600,6300,10080000,2,54806,13703,1,513560000,513560000,20551,6850,13701,6850,0,1,6852,1705918
168,6850,1600,6300,10080000,2,54806,13703,1,513560000,513560000,20551,6850,13701,6850,0,1,6852,1761989
168,6850,1600,6300,10080000,2,54806,13703,1,513560000,513560000,20551,6850,13701,6850,0,1,6852,1760443
168,50,1600,5900,9440000,2,406,103,1,78520000,78520000,151,50,101,50,0,1,52,109087
168,50,1600,5900,9440000,2,406,103,1,78520000,78520000,151,50,101,50,0,1,52,90398
168,50,1600,5900,9440000,2,406,103,1,78520000,78520000,151,50,101,50,0,1,52,105420
168,50,1600,5900,9440000,2,406,103,1,78520000,78520000,151,50,101,50,0,1,52,103156
168,50,1600,5900,9440000,2,406,103,1,78520000,78520000,151,50,101,50,0,1,52,105855
168,50,1600,5900,9440000,2,406,103,1,78520000,78520000,151,50,101,50,0,1,52,125609
168,50,1600,5900,9440000,2,406,103,1,78520000,78520000,151,50,101,50,0,1,52,123532
168,450,1600,5900,9440000,2,3606,903,1,102520000,102520000,1351,450,901,450,0,1,452,1115367
168,450,1600,5900,9440000,2,3606,903,1,102520000,102520000,1351,450,901,450,0,1,452,195045
168,450,1600,5900,9440000,2,3606,903,1,102520000,102520000,1351,450,901,450,0,1,452,193470
168,450,1600,5900,9440000,2,3606,903,1,102520000,102520000,1351,450,901,450,0,1,452,194619
168,450,1600,5900,9440000,2,3606,903,1,102520000,102520000,1351,450,901,450,0,1,452,195246
168,450,1600,5900,9440000,2,3606,903,1,102520000,102520000,1351,450,901,450,0,1,452,208272
168,450,1600,5900,9440000,2,3606,903,1,102520000,102520000,1351,450,901,450,0,1,452,207942
168,850,1600,5900,9440000,2,6806,1703,1,126520000,126520000,2551,850,1701,850,0,1,852,2301467
168,850,1600,5900,9440000,2,6806,1703,1,126520000,126520000,2551,850,1701,850,0,1,852,300956
168,850,1600,5900,9440000,2,6806,1703,1,126520000,126520000,2551,850,1701,850,0,1,852,299041
168,850,1600,5900,9440000,2,6806,1703,1,126520000,126520000,2551,850,1701,850,0,1,852,301330
168,850,1600,5900,9440000,2,6806,1703,1,126520000,126520000,2551,850,1701,850,0,1,852,302577
168,850,1600,5900,9440000,2,6806,1703,1,126520000,126520000,2551,850,1701,850,0,1,852,301481
168,850,1600,5900,9440000,2,6806,1703,1,126520000,126520000,2551,850,1701,850,0,1,852,301650
168,1250,1600,5900,9440000,2,10006,2503,1,150520000,150520000,3751,1250,2501,1250,0,1,1252,3307084
168,1250,1600,5900,9440000,2,10006,2503,1,150520000,150520000,3751,1250,2501,1250,0,1,1252,337505
168,1250,1600,5900,9440000,2,10006,2503,1,150520000,150520000,3751,1250,2501,1250,0,1,1252,363180
168,1250,1600,5900,9440000,2,10006,2503,1,150520000,150520000,3751,1250,2501,1250,0,1,1252,371651
168,1250,1600,5900,9440000,2,10006,2503,1,150520000,150520000,3751,1250,2501,1250,0,1,1252,372261
168,1250,1600,5900,9440000,2,10006,2503,1,150520000,150520000,3751,1250,2501,1250,0,1,1252,401256
168,1250,1600,5900,9440000,2,10006,2503,1,150520000,150520000,3751,1250,2501,1250,0,1,1252,374062
168,1650,1600,5900,9440000,2,13206,3303,1,174520000,174520000,4951,1650,3301,1650,0,1,1652,4515910
168,1650,1600,5900,9440000,2,13206,3303,1,174520000,174520000,4951,1650,3301,1650,0,1,1652,464106
168,1650,1600,5900,9440000,2,13206,3303,1,174520000,174520000,4951,1650,3301,1650,0,1,1652,475911
168,1650,1600,5900,9440000,2,13206,3303,1,174520000,174520000,4951,1650,3301,1650,0,1,1652,458283
168,1650,1600,5900,9440000,2,13206,3303,1,174520000,174520000,4951,1650,3301,1650,0,1,1652,465105
168,1650,1600,5900,9440000,2,13206,3303,1,174520000,174520000,4951,1650,3301,1650,0,1,1652,477961
168,1650,1600,5900,9440000,2,13206,3303,1,174520000,174520000,4951,1650,3301,1650,0,1,1652,485097
168,2050,1600,5900,9440000,2,16406,4103,1,198520000,198520000,6151,2050,4101,2050,0,1,2052,5456395
168,2050,1600,5900,9440000,2,16406,4103,1,198520000,198520000,6151,2050,4101,2050,0,1,2052,542213
168,2050,1600,5900,9440000,2,16406,4103,1,198520000,198520000,6151,2050,4101,2050,0,1,2052,543288
168,2050,1600,5900,9440000,2,16406,4103,1,198520000,198520000,6151,2050,4101,2050,0,1,2052,544117
168,2050,1600,5900,9440000,2,16406,4103,1,198520000,198520000,6151,2050,4101,2050,0,1,2052,543652
168,2050,1600,5900,9440000,2,16406,4103,1,198520000,198520000,6151,2050,4101,2050,0,1,2052,579930
168,2050,1600,5900,9440000,2,16406,4103,1,198520000,198520000,6151,2050,4101,2050,0,1,2052,580319
168,2450,1600,5900,9440000,2,19606,4903,1,222520000,222520000,7351,2450,4901,2450,0,1,2452,6666939
168,2450,1600,5900,9440000,2,19606,4903,1,222520000,222520000,7351,2450,4901,2450,0,1,2452,643281
168,2450,1600,5900,9440000,2,19606,4903,1,222520000,222520000,7351,2450,4901,2450,0,1,2452,635180
168,2450,1600,5900,9440000,2,19606,4903,1,222520000,222520000,7351,2450,4901,2450,0,1,2452,643937
168,2450,1600,5900,9440000,2,19606,4903,1,222520000,222520000,7351,2450,4901,2450,0,1,2452,642181
168,2450,1600,5900,9440000,2,19606,4903,1,222520000,222520000,7351,2450,4901,2450,0,1,2452,667782
168,2450,1600,5900,9440000,2,19606,4903,1,222520000,222520000,7351,2450,4901,2450,0,1,2452,667384
168,2850,1600,5900,9440000,2,22806,5703,1,246520000,246520000,8551,2850,5701,2850,0,1,2852,8039176
168,2850,1600,5900,9440000,2,22806,5703,1,246520000,246520000,8551,2850,5701,2850,0,1,2852,762764
168,2850,1600,5900,9440000,2,22806,5703,1,246520000,246520000,8551,2850,5701,2850,0,1,2852,725686
168,2850,1600,5900,9440000,2,22806,5703,1,246520000,246520000,8551,2850,5701,2850,0,1,2852,757595
168,2850,1600,5900,9440000,2,22806,5703,1,246520000,246520000,8551,2850,5701,2850,0,1,2852,723582
168,2850,1600,5900,9440000,2,22806,5703,1,246520000,246520000,8551,2850,5701,2850,0,1,2852,764924
168,2850,1600,5900,9440000,2,22806,5703,1,246520000,246520000,8551,2850,5701,2850,0,1,2852,764506
168,3250,1600,5900,9440000,2,26006,6503,1,270520000,270520000,9751,3250,6501,3250,0,1,3252,9348248
168,3250,1600,5900,9440000,2,26006,6503,1,270520000,270520000,9751,3250,6501,3250,0,1,3252,844959
168,3250,1600,5900,9440000,2,26006,6503,1,270520000,270520000,9751,3250,6501,3250,0,1,3252,838373
168,3250,1600,5900,9440000,2,26006,6503,1,270520000,270520000,9751,3250,6501,3250,0,1,3252,846018
168,3250,1600,5900,9440000,2,26006,6503,1,270520000,270520000,9751,3250,6501,3250,0,1,3252,840263
168,3250,1600,5900,9440000,2,26006,6503,1,270520000,270520000,9751,3250,6501,3250,0,1,3252,851094
168,3250,1600,5900,9440000,2,26006,6503,1,270520000,270520000,9751,3250,6501,3250,0,1,3252,850666
168,3650,1600,5900,9440000,2,29206,7303,1,294520000,294520000,10951,3650,7301,3650,0,1,3652,10407934
168,3650,1600,5900,9440000,2,29206,7303,1,294520000,294520000,10951,3650,7301,3650,0,1,3652,889358
168,3650,1600,5900,9440000,2,29206,7303,1,294520000,294520000,10951,3650,7301,3650,0,1,3652,943097
168,3650,1600,5900,9440000,2,29206,7303,1,294520000,294520000,10951,3650,7301,3650,0,1,3652,900551
168,3650,1600,5900,9440000,2,29206,7303,1,294520000,294520000,10951,3650,7301,3650,0,1,3652,947627
168,3650,1600,5900,9440000,2,29206,7303,1,294520000,294520000,10951,3650,7301,3650,0,1,3652,955525
168,3650,1600,5900,9440000,2,29206,7303,1,294520000,294520000,10951,3650,7301,3650,0,1,3652,960080
168,4050,1600,5900,9440000,2,32406,8103,1,318520000,318520000,12151,4050,8101,4050,0,1,4052,11714413
168,4050,1600,5900,9440000,2,32406,8103,1,318520000,318520000,12151,4050,8101,4050,0,1,4052,1039087
168,4050,1600,5900,9440000,2,32406,8103,1,318520000,318520000,12151,4050,8101,4050,0,1,4052,1031137
168,4050,1600,5900,9440000,2,32406,8103,1,318520000,318520000,12151,4050,8101,4050,0,1,4052,1039612
168,4050,1600,5900,9440000,2,32406,8103,1,318520000,318520000,12151,4050,8101,4050,0,1,4052,1040542
168,4050,1600,5900,9440000,2,32406,8103,1,318520000,318520000,12151,4050,8101,4050,0,1,4052,1042625
168,4050,1600,5900,9440000,2,32406,8103,1,318520000,318520000,12151,4050,8101,4050,0,1,4052,1043083
168,4450,1600,5900,9440000,2,35606,8903,1,342520000,342520000,13351,4450,8901,4450,0,1,4452,12543008
168,4450,1600,5900,9440000,2,35606,8903,1,342520000,342520000,13351,4450,8901,4450,0,1,4452,1131243
168,4450,1600,5900,9440000,2,35606,8903,1,342520000,342520000,13351,4450,8901,4450,0,1,4452,1124992
168,4450,1600,5900,9440000,2,35606,8903,1,342520000,342520000,13351,4450,8901,4450,0,1,4452,1134877
168,4450,1600,5900,9440000,2,35606,8903,1,342520000,342520000,13351,4450,8901,4450,0,1,4452,1122982
168,4450,1600,5900,9440000,2,35606,8903,1,342520000,342520000,13351,4450,8901,4450,0,1,4452,1132395
168,4450,1600,5900,9440000,2,35606,8903,1,342520000,342520000,13351,4450,8901,4450,0,1,4452,1132816
168,4850,1600,5900,9440000,2,38806,9703,1,366520000,366520000,14551,4850,9701,4850,0,1,4852,13355768
168,4850,1600,5900,9440000,2,38806,9703,1,366520000,366520000,14551,4850,9701,4850,0,1,4852,1230948
168,4850,1600,5900,9440000,2,38806,9703,1,366520000,366520000,14551,4850,9701,4850,0,1,4852,1226996
168,4850,1600,5900,9440000,2,38806,9703,1,366520000,366520000,14551,4850,9701,4850,0,1,4852,1231624
168,4850,1600,5900,9440000,2,38806,9703,1,366520000,366520000,14551,4850,9701,4850,0,1,4852,1235086
168,4850,1600,5900,9440000,2,38806,9703,1,366520000,366520000,14551,4850,9701,4850,0,1,4852,1234444
168,4850,1600,5900,9440000,2,38806,9703,1,366520000,366520000,14551,4850,9701,4850,0,1,4852,1225548
168,5250,1600,5900,9440000,2,42006,10503,1,390520000,390520000,15751,5250,10501,5250,0,1,5252,15113048
168,5250,1600,5900,9440000,2,42006,10503,1,390520000,390520000,15751,5250,10501,5250,0,1,5252,1325699
168,5250,1600,5900,9440000,2,42006,10503,1,390520000,390520000,15751,5250,10501,5250,0,1,5252,1329424
168,5250,1600,5900,9440000,2,42006,10503,1,390520000,390520000,15751,5250,10501,5250,0,1,5252,1327029
168,5250,1600,5900,9440000,2,42006,10503,1,390520000,390520000,15751,5250,10501,5250,0,1,5252,1320097
168,5250,1600,5900,9440000,2,42006,10503,1,390520000,390520000,15751,5250,10501,5250,0,1,5252,1301764
168,5250,1600,5900,9440000,2,42006,10503,1,390520000,390520000,15751,5250,10501,5250,0,1,5252,1326634
168,5650,1600,5900,9440000,2,45206,11303,1,414520000,414520000,16951,5650,11301,5650,0,1,5652,16065077
168,5650,1600,5900,9440000,2,45206,11303,1,414520000,414520000,16951,5650,11301,5650,0,1,5652,1421885
168,5650,1600,5900,9440000,2,45206,11303,1,414520000,414520000,16951,5650,11301,5650,0,1,5652,1411172
168,5650,1600,5900,9440000,2,45206,11303,1,414520000,414520000,16951,5650,11301,5650,0,1,5652,1418197
168,5650,1600,5900,9440000,2,45206,11303,1,414520000,414520000,16951,5650,11301,5650,0,1,5652,1412316
168,5650,1600,5900,9440000,2,45206,11303,1,414520000,414520000,16951,5650,11301,5650,0,1,5652,1402288
168,5650,1600,5900,9440000,2,45206,11303,1,414520000,414520000,16951,5650,11301,5650,0,1,5652,1405024
168,6050,1600,5900,9440000,2,48406,12103,1,438520000,438520000,18151,6050,12101,6050,0,1,6052,18031034
168,6050,1600,5900,9440000,2,48406,12103,1,438520000,438520000,18151,6050,12101,6050,0,1,6052,1506491
168,6050,1600,5900,9440000,2,48406,12103,1,438520000,438520000,18151,6050,12101,6050,0,1,6052,1526388
168,6050,1600,5900,9440000,2,48406,12103,1,438520000,438520000,18151,6050,12101,6050,0,1,6052,1521008
168,6050,1600,5900,9440000,2,48406,12103,1,438520000,438520000,18151,6050,12101,6050,0,1,6052,1529788
168,6050,1600,5900,9440000,2,48406,12103,1,438520000,438520000,18151,6050,12101,6050,0,1,6052,1512058
168,6050,1600,5900,9440000,2,48406,12103,1,438520000,438520000,18151,6050,12101,6050,0,1,6052,1519600
168,6450,1600,5900,9440000,2,51606,12903,1,462520000,462520000,19351,6450,12901,6450,0,1,6452,18854910
168,6450,1600,5900,9440000,2,51606,12903,1,462520000,462520000,19351,6450,12901,6450,0,1,6452,1591950
168,6450,1600,5900,9440000,2,51606,12903,1,462520000,462520000,19351,6450,12901,6450,0,1,6452,1486641
168,6450,1600,5900,9440000,2,51606,12903,1,462520000,462520000,19351,6450,12901,6450,0,1,6452,1587473
168,6450,1600,5900,9440000,2,51606,12903,1,462520000,462520000,19351,6450,12901,6450,0,1,6452,1581265
168,6450,1600,5900,9440000,2,51606,12903,1,462520000,462520000,19351,6450,12901,6450,0,1,6452,1568057
168,6450,1600,5900,9440000,2,51606,12903,1,462520000,462520000,19351,6450,12901,6450,0,1,6452,1569454
168,6850,1600,5900,9440000,2,54806,13703,1,486520000,486520000,20551,6850,13701,6850,0,1,6852,20540995
168,6850,1600,5900,9440000,2,54806,13703,1,486520000,486520000,20551,6850,13701,6850,0,1,6852,1707280
168,6850,1600,5900,9440000,2,54806,13703,1,486520000,486520000,20551,6850,13701,6850,0,1,6852,1655358
168,6850,1600,5900,9440000,2,54806,13703,1,486520000,486520000,20551,6850,13701,6850,0,1,6852,1710431
168,6850,1600,5900,9440000,2,54806,13703,1,486520000,486520000,20551,6850,13701,6850,0,1,6852,1713141
168,6850,1600,5900,9440000,2,54806,13703,1,486520000,486520000,20551,6850,13701,6850,0,1,6852,1693732
168,6850,1600,5900,9440000,2,54806,13703,1,486520000,486520000,20551,6850,13701,6850,0,1,6852,1688875
168,50,1600,5500,8800000,2,406,103,1,73240000,73240000,151,50,101,50,0,1,52,100478
168,50,1600,5500,8800000,2,406,103,1,73240000,73240000,151,50,101,50,0,1,52,99668
168,50,1600,5500,8800000,2,406,103,1,73240000,73240000,151,50,101,50,0,1,52,101529
168,50,1600,5500,8800000,2,406,103,1,73240000,73240000,151,50,101,50,0,1,52,100391
168,50,1600,5500,8800000,2,406,103,1,73240000,73240000,151,50,101,50,0,1,52,101105
168,50,1600,5500,8800000,2,406,103,1,73240000,73240000,151,50,101,50,0,1,52,114712
168,50,1600,5500,8800000,2,406,103,1,73240000,73240000,151,50,101,50,0,1,52,113663
168,450,1600,5500,8800000,2,3606,903,1,95960000,95960000,1351,450,901,450,0,1,452,1041948
168,450,1600,5500,8800000,2,3606,903,1,95960000,95960000,1351,450,901,450,0,1,452,182635
168,450,1600,5500,8800000,2,3606,903,1,95960000,95960000,1351,450,901,450,0,1,452,183039
168,450,1600,5500,8800000,2,3606,903,1,95960000,95960000,1351,450,901,450,0,1,452,182145
168,450,1600,5500,8800000,2,3606,903,1,95960000,95960000,1351,450,901,450,0,1,452,183240
168,450,1600,5500,8800000,2,3606,903,1,95960000,95960000,1351,450,901,450,0,1,452,202974
168,450,1600,5500,8800000,2,3606,903,1,95960000,95960000,1351,450,901,450,0,1,452,202646
168,850,1600,5500,8800000,2,6806,1703,1,118680000,118680000,2551,850,1701,850,0,1,852,2089468
168,850,1600,5500,8800000,2,6806,1703,1,118680000,118680000,2551,850,1701,850,0,1,852,277705
168,850,1600,5500,8800000,2,6806,1703,1,118680000,118680000,2551,850,1701,850,0,1,852,277903
168,850,1600,5500,8800000,2,6806,1703,1,118680000,118680000,2551,850,1701,850,0,1,852,276379
168,850,1600,5500,8800000,2,6806,1703,1,118680000,118680000,2551,850,1701,850,0,1,852,277353
168,850,1600,5500,8800000,2,6806,1703,1,118680000,118680000,2551,850,1701,850,0,1,852,278053
168,850,1600,5500,8800000,2,6806,1703,1,118680000,118680000,2551,850,1701,850,0,1,852,278217
168,1250,1600,5500,8800000,2,10006,2503,1,141400000,141400000,3751,1250,2501,1250,0,1,1252,3145777
168,1250,1600,5500,8800000,2,10006,2503,1,141400000,141400000,3751,1250,2501,1250,0,1,1252,364924
168,1250,1600,5500,8800000,2,10006,2503,1,141400000,141400000,3751,1250,2501,1250,0,1,1252,364173
168,1250,1600,5500,8800000,2,10006,2503,1,141400000,141400000,3751,1250,2501,1250,0,1,1252,361679
168,1250,1600,5500,8800000,2,10006,2503,1,141400000,141400000,3751,1250,2501,1250,0,1,1252,346567
168,1250,1600,5500,8800000,2,10006,2503,1,141400000,141400000,3751,1250,2501,1250,0,1,1252,364525
168,1250,1600,5500,8800000,2,10006,2503,1,141400000,141400000,3751,1250,2501,1250,0,1,1252,364702
168,1650,1600,5500,8800000,2,13206,3303,1,164120000,164120000,4951,1650,3301,1650,0,1,1652,4065701
168,1650,1600,5500,8800000,2,13206,3303,1,164120000,164120000,4951,1650,3301,1650,0,1,1652,454012
168,1650,1600,5500,8800000,2,13206,3303,1,164120000,164120000,4951,1650,3301,1650,0,1,1652,453554
168,1650,1600,5500,8800000,2,13206,3303,1,164120000,164120000,4951,1650,3301,1650,0,1,1652,444171
168,1650,1600,5500,8800000,2,13206,3303,1,164120000,164120000,4951,1650,3301,1650,0,1,1652,452058
168,1650,1600,5500,8800000,2,13206,3303,1,164120000,164120000,4951,1650,3301,1650,0,1,1652,451681
168,1650,1600,5500,8800000,2,13206,3303,1,164120000,164120000,4951,1650,3301,1650,0,1,1652,450607
168,2050,1600,5500,8800000,2,16406,4103,1,186840000,186840000,6151,2050,4101,2050,0,1,2052,5098276
168,2050,1600,5500,8800000,2,16406,4103,1,186840000,186840000,6151,2050,4101,2050,0,1,2052,535991
168,2050,1600,5500,8800000,2,16406,4103,1,186840000,186840000,6151,2050,4101,2050,0,1,2052,494673
168,2050,1600,5500,8800000,2,16406,4103,1,186840000,186840000,6151,2050,4101,2050,0,1,2052,537014
168,2050,1600,5500,8800000,2,16406,4103,1,186840000,186840000,6151,2050,4101,2050,0,1,2052,495515
168,2050,1600,5500,8800000,2,16406,4103,1,186840000,186840000,6151,2050,4101,2050,0,1,2052,540891
168,2050,1600,5500,8800000,2,16406,4103,1,186840000,186840000,6151,2050,4101,2050,0,1,2052,540503
168,2450,1600,5500,8800000,2,19606,4903,1,209560000,209560000,7351,2450,4901,2450,0,1,2452,6095661
168,2450,1600,5500,8800000,2,19606,4903,1,209560000,209560000,7351,2450,4901,2450,0,1,2452,608431
168,2450,1600,5500,8800000,2,19606,4903,1,209560000,209560000,7351,2450,4901,2450,0,1,2452,610709
168,2450,1600,5500,8800000,2,19606,4903,1,209560000,209560000,7351,2450,4901,2450,0,1,2452,612432
168,2450,1600,5500,8800000,2,19606,4903,1,209560000,209560000,7351,2450,4901,2450,0,1,2452,611464
168,2450,1600,5500,8800000,2,19606,4903,1,209560000,209560000,7351,2450,4901,2450,0,1,2452,620524
168,2450,1600,5500,8800000,2,19606,4903,1,209560000,209560000,7351,2450,4901,2450,0,1,2452,620926
168,2850,1600,5500,8800000,2,22806,5703,1,232280000,232280000,8551,2850,5701,2850,0,1,2852,7374802
168,2850,1600,5500,8800000,2,22806,5703,1,232280000,232280000,8551,2850,5701,2850,0,1,2852,684464
168,2850,1600,5500,8800000,2,22806,5703,1,232280000,232280000,8551,2850,5701,2850,0,1,2852,682772
168,2850,1600,5500,8800000,2,22806,5703,1,232280000,232280000,8551,2850,5701,2850,0,1,2852,686020
168,2850,1600,5500,8800000,2,22806,5703,1,232280000,232280000,8551,2850,5701,2850,0,1,2852,685411
168,2850,1600,5500,8800000,2,22806,5703,1,232280000,232280000,8551,2850,5701,2850,0,1,2852,702871
168,2850,1600,5500,8800000,2,22806,5703,1,232280000,232280000,8551,2850,5701,2850,0,1,2852,703284
168,3250,1600,5500,8800000,2,26006,6503,1,255000000,255000000,9751,3250,6501,3250,0,1,3252,7877536
168,3250,1600,5500,8800000,2,26006,6503,1,255000000,255000000,9751,3250,6501,3250,0,1,3252,755775
168,3250,1600,5500,8800000,2,26006,6503,1,255000000,255000000,9751,3250,6501,3250,0,1,3252,775193
168,3250,1600,5500,8800000,2,26006,6503,1,255000000,255000000,9751,3250,6501,3250,0,1,3252,758879
168,3250,1600,5500,8800000,2,26006,6503,1,255000000,255000000,9751,3250,6501,3250,0,1,3252,776237
168,3250,1600,5500,8800000,2,26006,6503,1,255000000,255000000,9751,3250,6501,3250,0,1,3252,811699
168,3250,1600,5500,8800000,2,26006,6503,1,255000000,255000000,9751,3250,6501,3250,0,1,3252,806535
168,3650,1600,5500,8800000,2,29206,7303,1,277720000,277720000,10951,3650,7301,3650,0,1,3652,9482479
168,3650,1600,5500,8800000,2,29206,7303,1,277720000,277720000,10951,3650,7301,3650,0,1,3652,876964
168,3650,1600,5500,8800000,2,29206,7303,1,277720000,277720000,10951,3650,7301,3650,0,1,3652,870335
168,3650,1600,5500,8800000,2,29206,7303,1,277720000,277720000,10951,3650,7301,3650,0,1,3652,878601
168,3650,1600,5500,8800000,2,29206,7303,1,277720000,277720000,10951,3650,7301,3650,0,1,3652,874126
168,3650,1600,5500,8800000,2,29206,7303,1,277720000,277720000,10951,3650,7301,3650,0,1,3652,894648
168,3650,1600,5500,8800000,2,29206,7303,1,277720000,277720000,10951,3650,7301,3650,0,1,3652,894207
168,4050,1600,5500,8800000,2,32406,8103,1,300440000,300440000,12151,4050,8101,4050,0,1,4052,10723153
168,4050,1600,5500,8800000,2,32406,8103,1,300440000,300440000,12151,4050,8101,4050,0,1,4052,982471
168,4050,1600,5500,8800000,2,32406,8103,1,300440000,300440000,12151,4050,8101,4050,0,1,4052,945610
168,4050,1600,5500,8800000,2,32406,8103,1,300440000,300440000,12151,4050,8101,4050,0,1,4052,969664
168,4050,1600,5500,8800000,2,32406,8103,1,300440000,300440000,12151,4050,8101,4050,0,1,4052,954718
168,4050,1600,5500,8800000,2,32406,8103,1,300440000,300440000,12151,4050,8101,4050,0,1,4052,979497
168,4050,1600,5500,8800000,2,32406,8103,1,300440000,300440000,12151,4050,8101,4050,0,1,4052,981726
168,4450,1600,5500,8800000,2,35606,8903,1,323160000,323160000,13351,4450,8901,4450,0,1,4452,11987752
168,4450,1600,5500,8800000,2,35606,8903,1,323160000,323160000,13351,4450,8901,4450,0,1,4452,1049410
168,4450,1600,5500,8800000,2,35606,8903,1,323160000,323160000,13351,4450,8901,4450,0,1,4452,1046671
168,4450,1600,5500,8800000,2,35606,8903,1,323160000,323160000,13351,4450,8901,4450,0,1,4452,1051962
168,4450,1600,5500,8800000,2,35606,8903,1,323160000,323160000,13351,4450,8901,4450,0,1,4452,1051463
168,4450,1600,5500,8800000,2,35606,8903,1,323160000,323160000,13351,4450,8901,4450,0,1,4452,1053976
168,4450,1600,5500,8800000,2,35606,8903,1,323160000,323160000,13351,4450,8901,4450,0,1,4452,1054450
168,4850,1600,5500,8800000,2,38806,9703,1,345880000,345880000,14551,4850,9701,4850,0,1,4852,12896227
168,4850,1600,5500,8800000,2,38806,9703,1,345880000,345880000,14551,4850,9701,4850,0,1,4852,1112137
168,4850,1600,5500,8800000,2,38806,9703,1,345880000,345880000,14551,4850,9701,4850,0,1,4852,1163525
168,4850,1600,5500,8800000,2,38806,9703,1,345880000,345880000,14551,4850,9701,4850,0,1,4852,1121600
168,4850,1600,5500,8800000,2,38806,9703,1,345880000,345880000,14551,4850,9701,4850,0,1,4852,1160697
168,4850,1600,5500,8800000,2,38806,9703,1,345880000,345880000,14551,4850,9701,4850,0,1,4852,1164987
168,4850,1600,5500,8800000,2,38806,9703,1,345880000,345880000,14551,4850,9701,4850,0,1,4852,1164349
168,5250,1600,5500,8800000,2,42006,10503,1,368600000,368600000,15751,5250,10501,5250,0,1,5252,14065581
168,5250,1600,5500,8800000,2,42006,10503,1,368600000,368600000,15751,5250,10501,5250,0,1,5252,1233931
168,5250,1600,5500,8800000,2,42006,10503,1,368600000,368600000,15751,5250,10501,5250,0,1,5252,1225907
168,5250,1600,5500,8800000,2,42006,10503,1,368600000,368600000,15751,5250,10501,5250,0,1,5252,1234378
168,5250,1600,5500,8800000,2,42006,10503,1,368600000,368600000,15751,5250,10501,5250,0,1,5252,1233346
168,5250,1600,5500,8800000,2,42006,10503,1,368600000,368600000,15751,5250,10501,5250,0,1,5252,1232308
168,5250,1600,5500,8800000,2,42006,10503,1,368600000,368600000,15751,5250,10501,5250,0,1,5252,1232734
168,5650,1600,5500,8800000,2,45206,11303,1,391320000,391320000,16951,5650,11301,5650,0,1,5652,14953250
168,5650,1600,5500,8800000,2,45206,11303,1,391320000,391320000,16951,5650,11301,5650,0,1,5652,1326857
168,5650,1600,5500,8800000,2,45206,11303,1,391320000,391320000,16951,5650,11301,5650,0,1,5652,1309561
168,5650,1600,5500,8800000,2,45206,11303,1,391320000,391320000,16951,5650,11301,5650,0,1,5652,1330324
168,5650,1600,5500,8800000,2,45206,11303,1,391320000,391320000,16951,5650,11301,5650,0,1,5652,1316985
168,5650,1600,5500,8800000,2,45206,11303,1,391320000,391320000,16951,5650,11301,5650,0,1,5652,1318682
168,5650,1600,5500,8800000,2,45206,11303,1,391320000,391320000,16951,5650,11301,5650,0,1,5652,1317852
168,6050,1600,5500,8800000,2,48406,12103,1,414040000,414040000,18151,6050,12101,6050,0,1,6052,16079633
168,6050,1600,5500,8800000,2,48406,12103,1,414040000,414040000,18151,6050,12101,6050,0,1,6052,1407469
168,6050,1600,5500,8800000,2,48406,12103,1,414040000,414040000,18151,6050,12101,6050,0,1,6052,1426803
168,6050,1600,5500,8800000,2,48406,12103,1,414040000,414040000,18151,6050,12101,6050,0,1,6052,1423168
168,6050,1600,5500,8800000,2,48406,12103,1,414040000,414040000,18151,6050,12101,6050,0,1,6052,1430102
168,6050,1600,5500,8800000,2,48406,12103,1,414040000,414040000,18151,6050,12101,6050,0,1,6052,1415782
168,6050,1600,5500,8800000,2,48406,12103,1,414040000,414040000,18151,6050,12101,6050,0,1,6052,1424188
168,6450,1600,5500,8800000,2,51606,12903,1,436760000,436760000,19351,6450,12901,6450,0,1,6452,16992080
168,6450,1600,5500,8800000,2,51606,12903,1,436760000,436760000,19351,6450,12901,6450,0,1,6452,1496548
168,6450,1600,5500,8800000,2,51606,12903,1,436760000,436760000,19351,6450,12901,6450,0,1,6452,1456495
168,6450,1600,5500,8800000,2,51606,12903,1,436760000,436760000,19351,6450,12901,6450,0,1,6452,1491578
168,6450,1600,5500,8800000,2,51606,12903,1,436760000,436760000,19351,6450,12901,6450,0,1,6452,1470419
168,6450,1600,5500,8800000,2,51606,12903,1,436760000,436760000,19351,6450,12901,6450,0,1,6452,1475703
168,6450,1600,5500,8800000,2,51606,12903,1,436760000,436760000,19351,6450,12901,6450,0,1,6452,1474674
168,6850,1600,5500,8800000,2,54806,13703,1,459480000,459480000,20551,6850,13701,6850,0,1,6852,18116987
168,6850,1600,5500,8800000,2,54806,13703,1,459480000,459480000,20551,6850,13701,6850,0,1,6852,1513715
168,6850,1600,5500,8800000,2,54806,13703,1,459480000,459480000,20551,6850,13701,6850,0,1,6852,1573326
168,6850,1600,5500,8800000,2,54806,13703,1,459480000,459480000,20551,6850,13701,6850,0,1,6852,1526095
168,6850,1600,5500,8800000,2,54806,13703,1,459480000,459480000,20551,6850,13701,6850,0,1,6852,1572578
168,6850,1600,5500,8800000,2,54806,13703,1,459480000,459480000,20551,6850,13701,6850,0,1,6852,1546784
168,6850,1600,5500,8800000,2,54806,13703,1,459480000,459480000,20551,6850,13701,6850,0,1,6852,1546095
168,50,1600,5100,8160000,2,406,103,1,67960000,67960000,151,50,101,50,0,1,52,92160
168,50,1600,5100,8160000,2,406,103,1,67960000,67960000,151,50,101,50,0,1,52,86127
168,50,1600,5100,8160000,2,406,103,1,67960000,67960000,151,50,101,50,0,1,52,74675
168,50,1600,5100,8160000,2,406,103,1,67960000,67960000,151,50,101,50,0,1,52,86526
168,50,1600,5100,8160000,2,406,103,1,67960000,67960000,151,50,101,50,0,1,52,84933
168,50,1600,5100,8160000,2,406,103,1,67960000,67960000,151,50,101,50,0,1,52,105769
168,50,1600,5100,8160000,2,406,103,1,67960000,67960000,151,50,101,50,0,1,52,105344
168,450,1600,5100,8160000,2,3606,903,1,89400000,89400000,1351,450,901,450,0,1,452,842143
168,450,1600,5100,8160000,2,3606,903,1,89400000,89400000,1351,450,901,450,0,1,452,167376
168,450,1600,5100,8160000,2,3606,903,1,89400000,89400000,1351,450,901,450,0,1,452,166799
168,450,1600,5100,8160000,2,3606,903,1,89400000,89400000,1351,450,901,450,0,1,452,152950
168,450,1600,5100,8160000,2,3606,903,1,89400000,89400000,1351,450,901,450,0,1,452,164186
168,450,1600,5100,8160000,2,3606,903,1,89400000,89400000,1351,450,901,450,0,1,452,189120
168,450,1600,5100,8160000,2,3606,903,1,89400000,89400000,1351,450,901,450,0,1,452,189714
168,850,1600,5100,8160000,2,6806,1703,1,110840000,110840000,2551,850,1701,850,0,1,852,1816745
168,850,1600,5100,8160000,2,6806,1703,1,110840000,110840000,2551,850,1701,850,0,1,852,258447
168,850,1600,5100,8160000,2,6806,1703,1,110840000,110840000,2551,850,1701,850,0,1,852,255353
168,850,1600,5100,8160000,2,6806,1703,1,110840000,110840000,2551,850,1701,850,0,1,852,258650
168,850,1600,5100,8160000,2,6806,1703,1,110840000,110840000,2551,850,1701,850,0,1,852,256909
168,850,1600,5100,8160000,2,6806,1703,1,110840000,110840000,2551,850,1701,850,0,1,852,257907
168,850,1600,5100,8160000,2,6806,1703,1,110840000,110840000,2551,850,1701,850,0,1,852,258258
168,1250,1600,5100,8160000,2,10006,2503,1,132280000,132280000,3751,1250,2501,1250,0,1,1252,2853513
168,1250,1600,5100,8160000,2,10006,2503,1,132280000,132280000,3751,1250,2501,1250,0,1,1252,312645
168,1250,1600,5100,8160000,2,10006,2503,1,132280000,132280000,3751,1250,2501,1250,0,1,1252,315897
168,1250,1600,5100,8160000,2,10006,2503,1,132280000,132280000,3751,1250,2501,1250,0,1,1252,301866
168,1250,1600,5100,8160000,2,10006,2503,1,132280000,132280000,3751,1250,2501,1250,0,1,1252,316419
168,1250,1600,5100,8160000,2,10006,2503,1,132280000,132280000,3751,1250,2501,1250,0,1,1252,339394
168,1250,1600,5100,8160000,2,10006,2503,1,132280000,132280000,3751,1250,2501,1250,0,1,1252,339038
168,1650,1600,5100,8160000,2,13206,3303,1,153720000,153720000,4951,1650,3301,1650,0,1,1652,3805618
168,1650,1600,5100,8160000,2,13206,3303,1,153720000,153720000,4951,1650,3301,1650,0,1,1652,415411
168,1650,1600,5100,8160000,2,13206,3303,1,153720000,153720000,4951,1650,3301,1650,0,1,1652,408150
168,1650,1600,5100,8160000,2,13206,3303,1,153720000,153720000,4951,1650,3301,1650,0,1,1652,384067
168,1650,1600,5100,8160000,2,13206,3303,1,153720000,153720000,4951,1650,3301,1650,0,1,1652,416391
168,1650,1600,5100,8160000,2,13206,3303,1,153720000,153720000,4951,1650,3301,1650,0,1,1652,417313
168,1650,1600,5100,8160000,2,13206,3303,1,153720000,153720000,4951,1650,3301,1650,0,1,1652,416933
168,2050,1600,5100,8160000,2,16406,4103,1,175160000,175160000,6151,2050,4101,2050,0,1,2052,4799971
168,2050,1600,5100,8160000,2,16406,4103,1,175160000,175160000,6151,2050,4101,2050,0,1,2052,483994
168,2050,1600,5100,8160000,2,16406,4103,1,175160000,175160000,6151,2050,4101,2050,0,1,2052,482989
168,2050,1600,5100,8160000,2,16406,4103,1,175160000,175160000,6151,2050,4101,2050,0,1,2052,483464
168,2050,1600,5100,8160000,2,16406,4103,1,175160000,175160000,6151,2050,4101,2050,0,1,2052,482207
168,2050,1600,5100,8160000,2,16406,4103,1,175160000,175160000,6151,2050,4101,2050,0,1,2052,492829
168,2050,1600,5100,8160000,2,16406,4103,1,175160000,175160000,6151,2050,4101,2050,0,1,2052,493224
168,2450,1600,5100,8160000,2,19606,4903,1,196600000,196600000,7351,2450,4901,2450,0,1,2452,5715924
168,2450,1600,5100,8160000,2,19606,4903,1,196600000,196600000,7351,2450,4901,2450,0,1,2452,582187
168,2450,1600,5100,8160000,2,19606,4903,1,196600000,196600000,7351,2450,4901,2450,0,1,2452,539123
168,2450,1600,5100,8160000,2,19606,4903,1,196600000,196600000,7351,2450,4901,2450,0,1,2452,583209
168,2450,1600,5100,8160000,2,19606,4903,1,196600000,196600000,7351,2450,4901,2450,0,1,2452,540106
168,2450,1600,5100,8160000,2,19606,4903,1,196600000,196600000,7351,2450,4901,2450,0,1,2452,590177
168,2450,1600,5100,8160000,2,19606,4903,1,196600000,196600000,7351,2450,4901,2450,0,1,2452,590576
168,2850,1600,5100,8160000,2,22806,5703,1,218040000,218040000,8551,2850,5701,2850,0,1,2852,6748590
168,2850,1600,5100,8160000,2,22806,5703,1,218040000,218040000,8551,2850,5701,2850,0,1,2852,639565
168,2850,1600,5100,8160000,2,22806,5703,1,218040000,218040000,8551,2850,5701,2850,0,1,2852,637840
168,2850,1600,5100,8160000,2,22806,5703,1,218040000,218040000,8551,2850,5701,2850,0,1,2852,644754
168,2850,1600,5100,8160000,2,22806,5703,1,218040000,218040000,8551,2850,5701,2850,0,1,2852,643718
168,2850,1600,5100,8160000,2,22806,5703,1,218040000,218040000,8551,2850,5701,2850,0,1,2852,656146
168,2850,1600,5100,8160000,2,22806,5703,1,218040000,218040000,8551,2850,5701,2850,0,1,2852,656568
168,3250,1600,5100,8160000,2,26006,6503,1,239480000,239480000,9751,3250,6501,3250,0,1,3252,7820423
168,3250,1600,5100,8160000,2,26006,6503,1,239480000,239480000,9751,3250,6501,3250,0,1,3252,692562
168,3250,1600,5100,8160000,2,26006,6503,1,239480000,239480000,9751,3250,6501,3250,0,1,3252,694117
168,3250,1600,5100,8160000,2,26006,6503,1,239480000,239480000,9751,3250,6501,3250,0,1,3252,695599
168,3250,1600,5100,8160000,2,26006,6503,1,239480000,239480000,9751,3250,6501,3250,0,1,3252,696972
168,3250,1600,5100,8160000,2,26006,6503,1,239480000,239480000,9751,3250,6501,3250,0,1,3252,733328
168,3250,1600,5100,8160000,2,26006,6503,1,239480000,239480000,9751,3250,6501,3250,0,1,3252,732903
168,3650,1600,5100,8160000,2,29206,7303,1,260920000,260920000,10951,3650,7301,3650,0,1,3652,8735563
168,3650,1600,5100,8160000,2,29206,7303,1,260920000,260920000,10951,3650,7301,3650,0,1,3652,776074
168,3650,1600,5100,8160000,2,29206,7303,1,260920000,260920000,10951,3650,7301,3650,0,1,3652,812365
168,3650,1600,5100,8160000,2,29206,7303,1,260920000,260920000,10951,3650,7301,3650,0,1,3652,773693
168,3650,1600,5100,8160000,2,29206,7303,1,260920000,260920000,10951,3650,7301,3650,0,1,3652,811348
168,3650,1600,5100,8160000,2,29206,7303,1,260920000,260920000,10951,3650,7301,3650,0,1,3652,821178
168,3650,1600,5100,8160000,2,29206,7303,1,260920000,260920000,10951,3650,7301,3650,0,1,3652,821624
168,4050,1600,5100,8160000,2,32406,8103,1,282360000,282360000,12151,4050,8101,4050,0,1,4052,9709678
168,4050,1600,5100,8160000,2,32406,8103,1,282360000,282360000,12151,4050,8101,4050,0,1,4052,888153
168,4050,1600,5100,8160000,2,32406,8103,1,282360000,282360000,12151,4050,8101,4050,0,1,4052,867925
168,4050,1600,5100,8160000,2,32406,8103,1,282360000,282360000,12151,4050,8101,4050,0,1,4052,890794
168,4050,1600,5100,8160000,2,32406,8103,1,282360000,282360000,12151,4050,8101,4050,0,1,4052,889357
168,4050,1600,5100,8160000,2,32406,8103,1,282360000,282360000,12151,4050,8101,4050,0,1,4052,899536
168,4050,1600,5100,8160000,2,32406,8103,1,282360000,282360000,12151,4050,8101,4050,0,1,4052,903843
168,4450,1600,5100,8160000,2,35606,8903,1,303800000,303800000,13351,4450,8901,4450,0,1,4452,10991426
168,4450,1600,5100,8160000,2,35606,8903,1,303800000,303800000,13351,4450,8901,4450,0,1,4452,987948
168,4450,1600,5100,8160000,2,35606,8903,1,303800000,303800000,13351,4450,8901,4450,0,1,4452,967628
168,4450,1600,5100,8160000,2,35606,8903,1,303800000,303800000,13351,4450,8901,4450,0,1,4452,993503
168,4450,1600,5100,8160000,2,35606,8903,1,303800000,303800000,13351,4450,8901,4450,0,1,4452,970033
168,4450,1600,5100,8160000,2,35606,8903,1,303800000,303800000,13351,4450,8901,4450,0,1,4452,995683
168,4450,1600,5100,8160000,2,35606,8903,1,303800000,303800000,13351,4450,8901,4450,0,1,4452,995212
168,4850,1600,5100,8160000,2,38806,9703,1,325240000,325240000,14551,4850,9701,4850,0,1,4852,12106120
168,4850,1600,5100,8160000,2,38806,9703,1,325240000,325240000,14551,4850,9701,4850,0,1,4852,1067083
168,4850,1600,5100,8160000,2,38806,9703,1,325240000,325240000,14551,4850,9701,4850,0,1,4852,1060504
168,4850,1600,5100,8160000,2,38806,9703,1,325240000,325240000,14551,4850,9701,4850,0,1,4852,1068424
168,4850,1600,5100,8160000,2,38806,9703,1,325240000,325240000,14551,4850,9701,4850,0,1,4852,1067744
168,4850,1600,5100,8160000,2,38806,9703,1,325240000,325240000,14551,4850,9701,4850,0,1,4852,1070770
168,4850,1600,5100,8160000,2,38806,9703,1,325240000,325240000,14551,4850,9701,4850,0,1,4852,1070287
168,5250,1600,5100,8160000,2,42006,10503,1,346680000,346680000,15751,5250,10501,5250,0,1,5252,13269475
168,5250,1600,5100,8160000,2,42006,10503,1,346680000,346680000,15751,5250,10501,5250,0,1,5252,1121769
168,5250,1600,5100,8160000,2,42006,10503,1,346680000,346680000,15751,5250,10501,5250,0,1,5252,1152453
168,5250,1600,5100,8160000,2,42006,10503,1,346680000,346680000,15751,5250,10501,5250,0,1,5252,1134245
168,5250,1600,5100,8160000,2,42006,10503,1,346680000,346680000,15751,5250,10501,5250,0,1,5252,1153690
168,5250,1600,5100,8160000,2,42006,10503,1,346680000,346680000,15751,5250,10501,5250,0,1,5252,1157473
168,5250,1600,5100,8160000,2,42006,10503,1,346680000,346680000,15751,5250,10501,5250,0,1,5252,1156972
168,5650,1600,5100,8160000,2,45206,11303,1,368120000,368120000,16951,5650,11301,5650,0,1,5652,14082017
168,5650,1600,5100,8160000,2,45206,11303,1,368120000,368120000,16951,5650,11301,5650,0,1,5652,1238372
168,5650,1600,5100,8160000,2,45206,11303,1,368120000,368120000,16951,5650,11301,5650,0,1,5652,1207482
168,5650,1600,5100,8160000,2,45206,11303,1,368120000,368120000,16951,5650,11301,5650,0,1,5652,1246318
168,5650,1600,5100,8160000,2,45206,11303,1,368120000,368120000,16951,5650,11301,5650,0,1,5652,1218207
168,5650,1600,5100,8160000,2,45206,11303,1,368120000,368120000,16951,5650,11301,5650,0,1,5652,1233232
168,5650,1600,5100,8160000,2,45206,11303,1,368120000,368120000,16951,5650,11301,5650,0,1,5652,1232388
168,6050,1600,5100,8160000,2,48406,12103,1,389560000,389560000,18151,6050,12101,6050,0,1,6052,15469865
168,6050,1600,5100,8160000,2,48406,12103,1,389560000,389560000,18151,6050,12101,6050,0,1,6052,1303036
168,6050,1600,5100,8160000,2,48406,12103,1,389560000,389560000,18151,6050,12101,6050,0,1,6052,1302102
168,6050,1600,5100,8160000,2,48406,12103,1,389560000,389560000,18151,6050,12101,6050,0,1,6052,1304153
168,6050,1600,5100,8160000,2,48406,12103,1,389560000,389560000,18151,6050,12101,6050,0,1,6052,1303658
168,6050,1600,5100,8160000,2,48406,12103,1,389560000,389560000,18151,6050,12101,6050,0,1,6052,1296813
168,6050,1600,5100,8160000,2,48406,12103,1,389560000,389560000,18151,6050,12101,6050,0,1,6052,1298351
168,6450,1600,5100,8160000,2,51606,12903,1,411000000,411000000,19351,6450,12901,6450,0,1,6452,15949483
168,6450,1600,5100,8160000,2,51606,12903,1,411000000,411000000,19351,6450,12901,6450,0,1,6452,1388964
168,6450,1600,5100,8160000,2,51606,12903,1,411000000,411000000,19351,6450,12901,6450,0,1,6452,1392704
168,6450,1600,5100,8160000,2,51606,12903,1,411000000,411000000,19351,6450,12901,6450,0,1,6452,1387786
168,6450,1600,5100,8160000,2,51606,12903,1,411000000,411000000,19351,6450,12901,6450,0,1,6452,1393426
168,6450,1600,5100,8160000,2,51606,12903,1,411000000,411000000,19351,6450,12901,6450,0,1,6452,1377684
168,6450,1600,5100,8160000,2,51606,12903,1,411000000,411000000,19351,6450,12901,6450,0,1,6452,1376215
168,6850,1600,5100,8160000,2,54806,13703,1,432440000,432440000,20551,6850,13701,6850,0,1,6852,16824680
168,6850,1600,5100,8160000,2,54806,13703,1,432440000,432440000,20551,6850,13701,6850,0,1,6852,1469290
168,6850,1600,5100,8160000,2,54806,13703,1,432440000,432440000,20551,6850,13701,6850,0,1,6852,1452660
168,6850,1600,5100,8160000,2,54806,13703,1,432440000,432440000,20551,6850,13701,6850,0,1,6852,1471778
168,6850,1600,5100,8160000,2,54806,13703,1,432440000,432440000,20551,6850,13701,6850,0,1,6852,1460674
168,6850,1600,5100,8160000,2,54806,13703,1,432440000,432440000,20551,6850,13701,6850,0,1,6852,1461263
168,6850,1600,5100,8160000,2,54806,13703,1,432440000,432440000,20551,6850,13701,6850,0,1,6852,1459516
168,50,1600,4700,7520000,2,406,103,1,62680000,62680000,151,50,101,50,0,1,52,84263
168,50,1600,4700,7520000,2,406,103,1,62680000,62680000,151,50,101,50,0,1,52,82427
168,50,1600,4700,7520000,2,406,103,1,62680000,62680000,151,50,101,50,0,1,52,80000
168,50,1600,4700,7520000,2,406,103,1,62680000,62680000,151,50,101,50,0,1,52,82008
168,50,1600,4700,7520000,2,406,103,1,62680000,62680000,151,50,101,50,0,1,52,73058
168,50,1600,4700,7520000,2,406,103,1,62680000,62680000,151,50,101,50,0,1,52,97886
168,50,1600,4700,7520000,2,406,103,1,62680000,62680000,151,50,101,50,0,1,52,98313
168,450,1600,4700,7520000,2,3606,903,1,82840000,82840000,1351,450,901,450,0,1,452,789190
168,450,1600,4700,7520000,2,3606,903,1,82840000,82840000,1351,450,901,450,0,1,452,150425
168,450,1600,4700,7520000,2,3606,903,1,82840000,82840000,1351,450,901,450,0,1,452,141008
168,450,1600,4700,7520000,2,3606,903,1,82840000,82840000,1351,450,901,450,0,1,452,152134
168,450,1600,4700,7520000,2,3606,903,1,82840000,82840000,1351,450,901,450,0,1,452,152569
168,450,1600,4700,7520000,2,3606,903,1,82840000,82840000,1351,450,901,450,0,1,452,173319
168,450,1600,4700,7520000,2,3606,903,1,82840000,82840000,1351,450,901,450,0,1,452,173762
168,850,1600,4700,7520000,2,6806,1703,1,103000000,103000000,2551,850,1701,850,0,1,852,1700293
168,850,1600,4700,7520000,2,6806,1703,1,103000000,103000000,2551,850,1701,850,0,1,852,238717
168,850,1600,4700,7520000,2,6806,1703,1,103000000,103000000,2551,850,1701,850,0,1,852,236053
168,850,1600,4700,7520000,2,6806,1703,1,103000000,103000000,2551,850,1701,850,0,1,852,237936
168,850,1600,4700,7520000,2,6806,1703,1,103000000,103000000,2551,850,1701,850,0,1,852,239188
168,850,1600,4700,7520000,2,6806,1703,1,103000000,103000000,2551,850,1701,850,0,1,852,239666
168,850,1600,4700,7520000,2,6806,1703,1,103000000,103000000,2551,850,1701,850,0,1,852,239502
168,1250,1600,4700,7520000,2,10006,2503,1,123160000,123160000,3751,1250,2501,1250,0,1,1252,2540004
168,1250,1600,4700,7520000,2,10006,2503,1,123160000,123160000,3751,1250,2501,1250,0,1,1252,314979
168,1250,1600,4700,7520000,2,10006,2503,1,123160000,123160000,3751,1250,2501,1250,0,1,1252,314554
168,1250,1600,4700,7520000,2,10006,2503,1,123160000,123160000,3751,1250,2501,1250,0,1,1252,314757
168,1250,1600,4700,7520000,2,10006,2503,1,123160000,123160000,3751,1250,2501,1250,0,1,1252,313026
168,1250,1600,4700,7520000,2,10006,2503,1,123160000,123160000,3751,1250,2501,1250,0,1,1252,314201
168,1250,1600,4700,7520000,2,10006,2503,1,123160000,123160000,3751,1250,2501,1250,0,1,1252,313450
168,1650,1600,4700,7520000,2,13206,3303,1,143320000,143320000,4951,1650,3301,1650,0,1,1652,3551958
168,1650,1600,4700,7520000,2,13206,3303,1,143320000,143320000,4951,1650,3301,1650,0,1,1652,379162
168,1650,1600,4700,7520000,2,13206,3303,1,143320000,143320000,4951,1650,3301,1650,0,1,1652,378344
168,1650,1600,4700,7520000,2,13206,3303,1,143320000,143320000,4951,1650,3301,1650,0,1,1652,379994
168,1650,1600,4700,7520000,2,13206,3303,1,143320000,143320000,4951,1650,3301,1650,0,1,1652,376149
168,1650,1600,4700,7520000,2,13206,3303,1,143320000,143320000,4951,1650,3301,1650,0,1,1652,382467
168,1650,1600,4700,7520000,2,13206,3303,1,143320000,143320000,4951,1650,3301,1650,0,1,1652,382847
168,2050,1600,4700,7520000,2,16406,4103,1,163480000,163480000,6151,2050,4101,2050,0,1,2052,4428574
168,2050,1600,4700,7520000,2,16406,4103,1,163480000,163480000,6151,2050,4101,2050,0,1,2052,454874
168,2050,1600,4700,7520000,2,16406,4103,1,163480000,163480000,6151,2050,4101,2050,0,1,2052,458926
168,2050,1600,4700,7520000,2,16406,4103,1,163480000,163480000,6151,2050,4101,2050,0,1,2052,459837
168,2050,1600,4700,7520000,2,16406,4103,1,163480000,163480000,6151,2050,4101,2050,0,1,2052,457813
168,2050,1600,4700,7520000,2,16406,4103,1,163480000,163480000,6151,2050,4101,2050,0,1,2052,462495
168,2050,1600,4700,7520000,2,16406,4103,1,163480000,163480000,6151,2050,4101,2050,0,1,2052,462106
168,2450,1600,4700,7520000,2,19606,4903,1,183640000,183640000,7351,2450,4901,2450,0,1,2452,5271553
168,2450,1600,4700,7520000,2,19606,4903,1,183640000,183640000,7351,2450,4901,2450,0,1,2452,495980
168,2450,1600,4700,7520000,2,19606,4903,1,183640000,183640000,7351,2450,4901,2450,0,1,2452,542318
168,2450,1600,4700,7520000,2,19606,4903,1,183640000,183640000,7351,2450,4901,2450,0,1,2452,499742
168,2450,1600,4700,7520000,2,19606,4903,1,183640000,183640000,7351,2450,4901,2450,0,1,2452,546973
168,2450,1600,4700,7520000,2,19606,4903,1,183640000,183640000,7351,2450,4901,2450,0,1,2452,548551
168,2450,1600,4700,7520000,2,19606,4903,1,183640000,183640000,7351,2450,4901,2450,0,1,2452,548958
168,2850,1600,4700,7520000,2,22806,5703,1,203800000,203800000,8551,2850,5701,2850,0,1,2852,6232735
168,2850,1600,4700,7520000,2,22806,5703,1,203800000,203800000,8551,2850,5701,2850,0,1,2852,588705
168,2850,1600,4700,7520000,2,22806,5703,1,203800000,203800000,8551,2850,5701,2850,0,1,2852,590481
168,2850,1600,4700,7520000,2,22806,5703,1,203800000,203800000,8551,2850,5701,2850,0,1,2852,591265
168,2850,1600,4700,7520000,2,22806,5703,1,203800000,203800000,8551,2850,5701,2850,0,1,2852,590947
168,2850,1600,4700,7520000,2,22806,5703,1,203800000,203800000,8551,2850,5701,2850,0,1,2852,638011
168,2850,1600,4700,7520000,2,22806,5703,1,203800000,203800000,8551,2850,5701,2850,0,1,2852,639192
168,3250,1600,4700,7520000,2,26006,6503,1,223960000,223960000,9751,3250,6501,3250,0,1,3252,7285412
168,3250,1600,4700,7520000,2,26006,6503,1,223960000,223960000,9751,3250,6501,3250,0,1,3252,687562
168,3250,1600,4700,7520000,2,26006,6503,1,223960000,223960000,9751,3250,6501,3250,0,1,3252,648818
168,3250,1600,4700,7520000,2,26006,6503,1,223960000,223960000,9751,3250,6501,3250,0,1,3252,678584
168,3250,1600,4700,7520000,2,26006,6503,1,223960000,223960000,9751,3250,6501,3250,0,1,3252,650858
168,3250,1600,4700,7520000,2,26006,6503,1,223960000,223960000,9751,3250,6501,3250,0,1,3252,695824
168,3250,1600,4700,7520000,2,26006,6503,1,223960000,223960000,9751,3250,6501,3250,0,1,3252,695386
168,3650,1600,4700,7520000,2,29206,7303,1,244120000,244120000,10951,3650,7301,3650,0,1,3652,8159309
168,3650,1600,4700,7520000,2,29206,7303,1,244120000,244120000,10951,3650,7301,3650,0,1,3652,735620
168,3650,1600,4700,7520000,2,29206,7303,1,244120000,244120000,10951,3650,7301,3650,0,1,3652,728602
168,3650,1600,4700,7520000,2,29206,7303,1,244120000,244120000,10951,3650,7301,3650,0,1,3652,737758
168,3650,1600,4700,7520000,2,29206,7303,1,244120000,244120000,10951,3650,7301,3650,0,1,3652,736865
168,3650,1600,4700,7520000,2,29206,7303,1,244120000,244120000,10951,3650,7301,3650,0,1,3652,770011
168,3650,1600,4700,7520000,2,29206,7303,1,244120000,244120000,10951,3650,7301,3650,0,1,3652,770450
