168,50,7000,7100,49700000,2,406,103,1,403240000,403240000,151,50,101,50,0,1,52,549840
168,50,7000,7100,49700000,2,406,103,1,403240000,403240000,151,50,101,50,0,1,52,543100
168,50,7000,7100,49700000,2,406,103,1,403240000,403240000,151,50,101,50,0,1,52,543265
168,50,7000,7100,49700000,2,406,103,1,403240000,403240000,151,50,101,50,0,1,52,543440
168,50,7000,7100,49700000,2,406,103,1,403240000,403240000,151,50,101,50,0,1,52,543634
168,50,7000,7100,49700000,2,406,103,1,403240000,403240000,151,50,101,50,0,1,52,542805
168,50,7000,7100,49700000,2,406,103,1,403240000,403240000,151,50,101,50,0,1,52,542125

168,450,7000,7100,49700000,2,3606,903,1,448360000,448360000,1351,450,901,450,0,1,452,5447299
168,450,7000,7100,49700000,2,3606,903,1,448360000,448360000,1351,450,901,450,0,1,452,952560
168,450,7000,7100,49700000,2,3606,903,1,448360000,448360000,1351,450,901,450,0,1,452,954635
168,450,7000,7100,49700000,2,3606,903,1,448360000,448360000,1351,450,901,450,0,1,452,956211
168,450,7000,7100,49700000,2,3606,903,1,448360000,448360000,1351,450,901,450,0,1,452,955531
168,450,7000,7100,49700000,2,3606,903,1,448360000,448360000,1351,450,901,450,0,1,452,918183
168,450,7000,7100,49700000,2,3606,903,1,448360000,448360000,1351,450,901,450,0,1,452,912034

168,850,7000,7100,49700000,2,6806,1703,1,493480000,493480000,2551,850,1701,850,0,1,852,10976487
168,850,7000,7100,49700000,2,6806,1703,1,493480000,493480000,2551,850,1701,850,0,1,852,1328896
168,850,7000,7100,49700000,2,6806,1703,1,493480000,493480000,2551,850,1701,850,0,1,852,1327345
168,850,7000,7100,49700000,2,6806,1703,1,493480000,493480000,2551,850,1701,850,0,1,852,1328325
168,850,7000,7100,49700000,2,6806,1703,1,493480000,493480000,2551,850,1701,850,0,1,852,1329282
168,850,7000,7100,49700000,2,6806,1703,1,493480000,493480000,2551,850,1701,850,0,1,852,1293893
168,850,7000,7100,49700000,2,6806,1703,1,493480000,493480000,2551,850,1701,850,0,1,852,1294820

168,1250,7000,7100,49700000,2,10006,2503,1,538600000,538600000,3751,1250,2501,1250,0,1,1252,16865645
168,1250,7000,7100,49700000,2,10006,2503,1,538600000,538600000,3751,1250,2501,1250,0,1,1252,1741204
168,1250,7000,7100,49700000,2,10006,2503,1,538600000,538600000,3751,1250,2501,1250,0,1,1252,1740532
168,1250,7000,7100,49700000,2,10006,2503,1,538600000,538600000,3751,1250,2501,1250,0,1,1252,1739488
168,1250,7000,7100,49700000,2,10006,2503,1,538600000,538600000,3751,1250,2501,1250,0,1,1252,1741678
168,1250,7000,7100,49700000,2,10006,2503,1,538600000,538600000,3751,1250,2501,1250,0,1,1252,1706202
168,1250,7000,7100,49700000,2,10006,2503,1,538600000,538600000,3751,1250,2501,1250,0,1,1252,1707294

168,1650,7000,7100,49700000,2,13206,3303,1,583720000,583720000,4951,1650,3301,1650,0,1,1652,23323957
168,1650,7000,7100,49700000,2,13206,3303,1,583720000,583720000,4951,1650,3301,1650,0,1,1652,2196239
168,1650,7000,7100,49700000,2,13206,3303,1,583720000,583720000,4951,1650,3301,1650,0,1,1652,2196893
168,1650,7000,7100,49700000,2,13206,3303,1,583720000,583720000,4951,1650,3301,1650,0,1,1652,2194850
168,1650,7000,7100,49700000,2,13206,3303,1,583720000,583720000,4951,1650,3301,1650,0,1,1652,2197762
168,1650,7000,7100,49700000,2,13206,3303,1,583720000,583720000,4951,1650,3301,1650,0,1,1652,2155260
168,1650,7000,7100,49700000,2,13206,3303,1,583720000,583720000,4951,1650,3301,1650,0,1,1652,2156676

168,2050,7000,7100,49700000,2,16406,4103,1,628840000,628840000,6151,2050,4101,2050,0,1,2052,29575096
168,2050,7000,7100,49700000,2,16406,4103,1,628840000,628840000,6151,2050,4101,2050,0,1,2052,2616048
168,2050,7000,7100,49700000,2,16406,4103,1,628840000,628840000,6151,2050,4101,2050,0,1,2052,2616961
168,2050,7000,7100,49700000,2,16406,4103,1,628840000,628840000,6151,2050,4101,2050,0,1,2052,2614932
168,2050,7000,7100,49700000,2,16406,4103,1,628840000,628840000,6151,2050,4101,2050,0,1,2052,2613250
168,2050,7000,7100,49700000,2,16406,4103,1,628840000,628840000,6151,2050,4101,2050,0,1,2052,2558279
168,2050,7000,7100,49700000,2,16406,4103,1,628840000,628840000,6151,2050,4101,2050,0,1,2052,2559917

168,2450,7000,7100,49700000,2,19606,4903,1,673960000,673960000,7351,2450,4901,2450,0,1,2452,34737156
168,2450,7000,7100,49700000,2,19606,4903,1,673960000,673960000,7351,2450,4901,2450,0,1,2452,3003272
168,2450,7000,7100,49700000,2,19606,4903,1,673960000,673960000,7351,2450,4901,2450,0,1,2452,3001152
168,2450,7000,7100,49700000,2,19606,4903,1,673960000,673960000,7351,2450,4901,2450,0,1,2452,3002366
168,2450,7000,7100,49700000,2,19606,4903,1,673960000,673960000,7351,2450,4901,2450,0,1,2452,3004061
168,2450,7000,7100,49700000,2,19606,4903,1,673960000,673960000,7351,2450,4901,2450,0,1,2452,2921242
168,2450,7000,7100,49700000,2,19606,4903,1,673960000,673960000,7351,2450,4901,2450,0,1,2452,2919744

168,2850,7000,7100,49700000,2,22806,5703,1,719080000,719080000,8551,2850,5701,2850,0,1,2852,42311039
168,2850,7000,7100,49700000,2,22806,5703,1,719080000,719080000,8551,2850,5701,2850,0,1,2852,3484210
168,2850,7000,7100,49700000,2,22806,5703,1,719080000,719080000,8551,2850,5701,2850,0,1,2852,3482180
168,2850,7000,7100,49700000,2,22806,5703,1,719080000,719080000,8551,2850,5701,2850,0,1,2852,3480068
168,2850,7000,7100,49700000,2,22806,5703,1,719080000,719080000,8551,2850,5701,2850,0,1,2852,3485323
168,2850,7000,7100,49700000,2,22806,5703,1,719080000,719080000,8551,2850,5701,2850,0,1,2852,3393888
168,2850,7000,7100,49700000,2,22806,5703,1,719080000,719080000,8551,2850,5701,2850,0,1,2852,3395794

168,3250,7000,7100,49700000,2,26006,6503,1,764200000,764200000,9751,3250,6501,3250,0,1,3252,49096283
168,3250,7000,7100,49700000,2,26006,6503,1,764200000,764200000,9751,3250,6501,3250,0,1,3252,3869405
168,3250,7000,7100,49700000,2,26006,6503,1,764200000,764200000,9751,3250,6501,3250,0,1,3252,3870619
168,3250,7000,7100,49700000,2,26006,6503,1,764200000,764200000,9751,3250,6501,3250,0,1,3252,3868219
168,3250,7000,7100,49700000,2,26006,6503,1,764200000,764200000,9751,3250,6501,3250,0,1,3252,3865357
168,3250,7000,7100,49700000,2,26006,6503,1,764200000,764200000,9751,3250,6501,3250,0,1,3252,3765968
168,3250,7000,7100,49700000,2,26006,6503,1,764200000,764200000,9751,3250,6501,3250,0,1,3252,3767764

168,3650,7000,7100,49700000,2,29206,7303,1,809320000,809320000,10951,3650,7301,3650,0,1,3652,54677202
168,3650,7000,7100,49700000,2,29206,7303,1,809320000,809320000,10951,3650,7301,3650,0,1,3652,4303044
168,3650,7000,7100,49700000,2,29206,7303,1,809320000,809320000,10951,3650,7301,3650,0,1,3652,4305247
168,3650,7000,7100,49700000,2,29206,7303,1,809320000,809320000,10951,3650,7301,3650,0,1,3652,4301607
168,3650,7000,7100,49700000,2,29206,7303,1,809320000,809320000,10951,3650,7301,3650,0,1,3652,4304184
168,3650,7000,7100,49700000,2,29206,7303,1,809320000,809320000,10951,3650,7301,3650,0,1,3652,4191535
168,3650,7000,7100,49700000,2,29206,7303,1,809320000,809320000,10951,3650,7301,3650,0,1,3652,4195831

168,4050,7000,7100,49700000,2,32406,8103,1,854440000,854440000,12151,4050,8101,4050,0,1,4052,61834410
168,4050,7000,7100,49700000,2,32406,8103,1,854440000,854440000,12151,4050,8101,4050,0,1,4052,4715787
168,4050,7000,7100,49700000,2,32406,8103,1,854440000,854440000,12151,4050,8101,4050,0,1,4052,4710992
168,4050,7000,7100,49700000,2,32406,8103,1,854440000,854440000,12151,4050,8101,4050,0,1,4052,4714597
168,4050,7000,7100,49700000,2,32406,8103,1,854440000,854440000,12151,4050,8101,4050,0,1,4052,4713391
168,4050,7000,7100,49700000,2,32406,8103,1,854440000,854440000,12151,4050,8101,4050,0,1,4052,4620037
168,4050,7000,7100,49700000,2,32406,8103,1,854440000,854440000,12151,4050,8101,4050,0,1,4052,4622001

168,4450,7000,7100,49700000,2,35606,8903,1,899560000,899560000,13351,4450,8901,4450,0,1,4452,65022868
168,4450,7000,7100,49700000,2,35606,8903,1,899560000,899560000,13351,4450,8901,4450,0,1,4452,5158114
168,4450,7000,7100,49700000,2,35606,8903,1,899560000,899560000,13351,4450,8901,4450,0,1,4452,5160358
168,4450,7000,7100,49700000,2,35606,8903,1,899560000,899560000,13351,4450,8901,4450,0,1,4452,5163055
168,4450,7000,7100,49700000,2,35606,8903,1,899560000,899560000,13351,4450,8901,4450,0,1,4452,5164599
168,4450,7000,7100,49700000,2,35606,8903,1,899560000,899560000,13351,4450,8901,4450,0,1,4452,4932722
168,4450,7000,7100,49700000,2,35606,8903,1,899560000,899560000,13351,4450,8901,4450,0,1,4452,5013716

168,4850,7000,7100,49700000,2,38806,9703,1,944680000,944680000,14551,4850,9701,4850,0,1,4852,72369244
168,4850,7000,7100,49700000,2,38806,9703,1,944680000,944680000,14551,4850,9701,4850,0,1,4852,5535607
168,4850,7000,7100,49700000,2,38806,9703,1,944680000,944680000,14551,4850,9701,4850,0,1,4852,5537968
168,4850,7000,7100,49700000,2,38806,9703,1,944680000,944680000,14551,4850,9701,4850,0,1,4852,5539262
168,4850,7000,7100,49700000,2,38806,9703,1,944680000,944680000,14551,4850,9701,4850,0,1,4852,5540912
168,4850,7000,7100,49700000,2,38806,9703,1,944680000,944680000,14551,4850,9701,4850,0,1,4852,5355943
168,4850,7000,7100,49700000,2,38806,9703,1,944680000,944680000,14551,4850,9701,4850,0,1,4852,5383420

168,5250,7000,7100,49700000,2,42006,10503,1,989800000,989800000,15751,5250,10501,5250,0,1,5252,78245646
168,5250,7000,7100,49700000,2,42006,10503,1,989800000,989800000,15751,5250,10501,5250,0,1,5252,5938112
168,5250,7000,7100,49700000,2,42006,10503,1,989800000,989800000,15751,5250,10501,5250,0,1,5252,5936465
168,5250,7000,7100,49700000,2,42006,10503,1,989800000,989800000,15751,5250,10501,5250,0,1,5252,5939595
168,5250,7000,7100,49700000,2,42006,10503,1,989800000,989800000,15751,5250,10501,5250,0,1,5252,5941206
168,5250,7000,7100,49700000,2,42006,10503,1,989800000,989800000,15751,5250,10501,5250,0,1,5252,5828941
168,5250,7000,7100,49700000,2,42006,10503,1,989800000,989800000,15751,5250,10501,5250,0,1,5252,5831035

168,5650,7000,7100,49700000,2,45206,11303,1,1034920000,1034920000,16951,5650,11301,5650,0,1,5652,87150686
168,5650,7000,7100,49700000,2,45206,11303,1,1034920000,1034920000,16951,5650,11301,5650,0,1,5652,6354886
168,5650,7000,7100,49700000,2,45206,11303,1,1034920000,1034920000,16951,5650,11301,5650,0,1,5652,6353424
168,5650,7000,7100,49700000,2,45206,11303,1,1034920000,1034920000,16951,5650,11301,5650,0,1,5652,6350819
168,5650,7000,7100,49700000,2,45206,11303,1,1034920000,1034920000,16951,5650,11301,5650,0,1,5652,6356743
168,5650,7000,7100,49700000,2,45206,11303,1,1034920000,1034920000,16951,5650,11301,5650,0,1,5652,6179673
168,5650,7000,7100,49700000,2,45206,11303,1,1034920000,1034920000,16951,5650,11301,5650,0,1,5652,6182696

168,6050,7000,7100,49700000,2,48406,12103,1,1080040000,1080040000,18151,6050,12101,6050,0,1,6052,96350980
168,6050,7000,7100,49700000,2,48406,12103,1,1080040000,1080040000,18151,6050,12101,6050,0,1,6052,6826123
168,6050,7000,7100,49700000,2,48406,12103,1,1080040000,1080040000,18151,6050,12101,6050,0,1,6052,6815446
168,6050,7000,7100,49700000,2,48406,12103,1,1080040000,1080040000,18151,6050,12101,6050,0,1,6052,6822649
168,6050,7000,7100,49700000,2,48406,12103,1,1080040000,1080040000,18151,6050,12101,6050,0,1,6052,6824212
168,6050,7000,7100,49700000,2,48406,12103,1,1080040000,1080040000,18151,6050,12101,6050,0,1,6052,6660124
168,6050,7000,7100,49700000,2,48406,12103,1,1080040000,1080040000,18151,6050,12101,6050,0,1,6052,6653075

168,6450,7000,7100,49700000,2,51606,12903,1,1125160000,1125160000,19351,6450,12901,6450,0,1,6452,101896123
168,6450,7000,7100,49700000,2,51606,12903,1,1125160000,1125160000,19351,6450,12901,6450,0,1,6452,7197216
168,6450,7000,7100,49700000,2,51606,12903,1,1125160000,1125160000,19351,6450,12901,6450,0,1,6452,7198860
168,6450,7000,7100,49700000,2,51606,12903,1,1125160000,1125160000,19351,6450,12901,6450,0,1,6452,7194198
168,6450,7000,7100,49700000,2,51606,12903,1,1125160000,1125160000,19351,6450,12901,6450,0,1,6452,7200884
168,6450,7000,7100,49700000,2,51606,12903,1,1125160000,1125160000,19351,6450,12901,6450,0,1,6452,7010250
168,6450,7000,7100,49700000,2,51606,12903,1,1125160000,1125160000,19351,6450,12901,6450,0,1,6452,7013265

168,6850,7000,7100,49700000,2,54806,13703,1,1170280000,1170280000,20551,6850,13701,6850,0,1,6852,107485848
168,6850,7000,7100,49700000,2,54806,13703,1,1170280000,1170280000,20551,6850,13701,6850,0,1,6852,7593395
168,6850,7000,7100,49700000,2,54806,13703,1,1170280000,1170280000,20551,6850,13701,6850,0,1,6852,7587855
168,6850,7000,7100,49700000,2,54806,13703,1,1170280000,1170280000,20551,6850,13701,6850,0,1,6852,7589767
168,6850,7000,7100,49700000,2,54806,13703,1,1170280000,1170280000,20551,6850,13701,6850,0,1,6852,7591557
168,6850,7000,7100,49700000,2,54806,13703,1,1170280000,1170280000,20551,6850,13701,6850,0,1,6852,7365294
168,6850,7000,7100,49700000,2,54806,13703,1,1170280000,1170280000,20551,6850,13701,6850,0,1,6852,7355707

168,50,7000,6700,46900000,2,406,103,1,380680000,380680000,151,50,101,50,0,1,52,533118
168,50,7000,6700,46900000,2,406,103,1,380680000,380680000,151,50,101,50,0,1,52,449015
168,50,7000,6700,46900000,2,406,103,1,380680000,380680000,151,50,101,50,0,1,52,497768
168,50,7000,6700,46900000,2,406,103,1,380680000,380680000,151,50,101,50,0,1,52,497338
168,50,7000,6700,46900000,2,406,103,1,380680000,380680000,151,50,101,50,0,1,52,487943
168,50,7000,6700,46900000,2,406,103,1,380680000,380680000,151,50,101,50,0,1,52,486160
168,50,7000,6700,46900000,2,406,103,1,380680000,380680000,151,50,101,50,0,1,52,486959

168,450,7000,6700,46900000,2,3606,903,1,424520000,424520000,1351,450,901,450,0,1,452,4846580
168,450,7000,6700,46900000,2,3606,903,1,424520000,424520000,1351,450,901,450,0,1,452,904874
168,450,7000,6700,46900000,2,3606,903,1,424520000,424520000,1351,450,901,450,0,1,452,900764
168,450,7000,6700,46900000,2,3606,903,1,424520000,424520000,1351,450,901,450,0,1,452,898790
168,450,7000,6700,46900000,2,3606,903,1,424520000,424520000,1351,450,901,450,0,1,452,904336
168,450,7000,6700,46900000,2,3606,903,1,424520000,424520000,1351,450,901,450,0,1,452,884211
168,450,7000,6700,46900000,2,3606,903,1,424520000,424520000,1351,450,901,450,0,1,452,885180

168,850,7000,6700,46900000,2,6806,1703,1,468360000,468360000,2551,850,1701,850,0,1,852,10317556
168,850,7000,6700,46900000,2,6806,1703,1,468360000,468360000,2551,850,1701,850,0,1,852,1263794
168,850,7000,6700,46900000,2,6806,1703,1,468360000,468360000,2551,850,1701,850,0,1,852,1262240
168,850,7000,6700,46900000,2,6806,1703,1,468360000,468360000,2551,850,1701,850,0,1,852,1264184
168,850,7000,6700,46900000,2,6806,1703,1,468360000,468360000,2551,850,1701,850,0,1,852,1263232
168,850,7000,6700,46900000,2,6806,1703,1,468360000,468360000,2551,850,1701,850,0,1,852,1224578
168,850,7000,6700,46900000,2,6806,1703,1,468360000,468360000,2551,850,1701,850,0,1,852,1225504

168,1250,7000,6700,46900000,2,10006,2503,1,512200000,512200000,3751,1250,2501,1250,0,1,1252,15866850
168,1250,7000,6700,46900000,2,10006,2503,1,512200000,512200000,3751,1250,2501,1250,0,1,1252,1660559
168,1250,7000,6700,46900000,2,10006,2503,1,512200000,512200000,3751,1250,2501,1250,0,1,1252,1662238
168,1250,7000,6700,46900000,2,10006,2503,1,512200000,512200000,3751,1250,2501,1250,0,1,1252,1661587
168,1250,7000,6700,46900000,2,10006,2503,1,512200000,512200000,3751,1250,2501,1250,0,1,1252,1662736
168,1250,7000,6700,46900000,2,10006,2503,1,512200000,512200000,3751,1250,2501,1250,0,1,1252,1610174
168,1250,7000,6700,46900000,2,10006,2503,1,512200000,512200000,3751,1250,2501,1250,0,1,1252,1611200

168,1650,7000,6700,46900000,2,13206,3303,1,556040000,556040000,4951,1650,3301,1650,0,1,1652,21528140
168,1650,7000,6700,46900000,2,13206,3303,1,556040000,556040000,4951,1650,3301,1650,0,1,1652,2066687
168,1650,7000,6700,46900000,2,13206,3303,1,556040000,556040000,4951,1650,3301,1650,0,1,1652,2065308
168,1650,7000,6700,46900000,2,13206,3303,1,556040000,556040000,4951,1650,3301,1650,0,1,1652,2067337
168,1650,7000,6700,46900000,2,13206,3303,1,556040000,556040000,4951,1650,3301,1650,0,1,1652,2068182
168,1650,7000,6700,46900000,2,13206,3303,1,556040000,556040000,4951,1650,3301,1650,0,1,1652,2024274
168,1650,7000,6700,46900000,2,13206,3303,1,556040000,556040000,4951,1650,3301,1650,0,1,1652,2025561

168,2050,7000,6700,46900000,2,16406,4103,1,599880000,599880000,6151,2050,4101,2050,0,1,2052,27855337
168,2050,7000,6700,46900000,2,16406,4103,1,599880000,599880000,6151,2050,4101,2050,0,1,2052,2400829
168,2050,7000,6700,46900000,2,16406,4103,1,599880000,599880000,6151,2050,4101,2050,0,1,2052,2398267
168,2050,7000,6700,46900000,2,16406,4103,1,599880000,599880000,6151,2050,4101,2050,0,1,2052,2401527
168,2050,7000,6700,46900000,2,16406,4103,1,599880000,599880000,6151,2050,4101,2050,0,1,2052,2400024
168,2050,7000,6700,46900000,2,16406,4103,1,599880000,599880000,6151,2050,4101,2050,0,1,2052,2380028
168,2050,7000,6700,46900000,2,16406,4103,1,599880000,599880000,6151,2050,4101,2050,0,1,2052,2381367

168,2450,7000,6700,46900000,2,19606,4903,1,643720000,643720000,7351,2450,4901,2450,0,1,2452,32053655
168,2450,7000,6700,46900000,2,19606,4903,1,643720000,643720000,7351,2450,4901,2450,0,1,2452,2916831
168,2450,7000,6700,46900000,2,19606,4903,1,643720000,643720000,7351,2450,4901,2450,0,1,2452,2915777
168,2450,7000,6700,46900000,2,19606,4903,1,643720000,643720000,7351,2450,4901,2450,0,1,2452,2909443
168,2450,7000,6700,46900000,2,19606,4903,1,643720000,643720000,7351,2450,4901,2450,0,1,2452,2912554
168,2450,7000,6700,46900000,2,19606,4903,1,643720000,643720000,7351,2450,4901,2450,0,1,2452,2836065
168,2450,7000,6700,46900000,2,19606,4903,1,643720000,643720000,7351,2450,4901,2450,0,1,2452,2837836

168,2850,7000,6700,46900000,2,22806,5703,1,687560000,687560000,8551,2850,5701,2850,0,1,2852,38580426
168,2850,7000,6700,46900000,2,22806,5703,1,687560000,687560000,8551,2850,5701,2850,0,1,2852,3302083
168,2850,7000,6700,46900000,2,22806,5703,1,687560000,687560000,8551,2850,5701,2850,0,1,2852,3304035
168,2850,7000,6700,46900000,2,22806,5703,1,687560000,687560000,8551,2850,5701,2850,0,1,2852,3305161
168,2850,7000,6700,46900000,2,22806,5703,1,687560000,687560000,8551,2850,5701,2850,0,1,2852,3300353
168,2850,7000,6700,46900000,2,22806,5703,1,687560000,687560000,8551,2850,5701,2850,0,1,2852,3213338
168,2850,7000,6700,46900000,2,22806,5703,1,687560000,687560000,8551,2850,5701,2850,0,1,2852,3217046

168,3250,7000,6700,46900000,2,26006,6503,1,731400000,731400000,9751,3250,6501,3250,0,1,3252,44385009
168,3250,7000,6700,46900000,2,26006,6503,1,731400000,731400000,9751,3250,6501,3250,0,1,3252,3673090
168,3250,7000,6700,46900000,2,26006,6503,1,731400000,731400000,9751,3250,6501,3250,0,1,3252,3671247
168,3250,7000,6700,46900000,2,26006,6503,1,731400000,731400000,9751,3250,6501,3250,0,1,3252,3674078
168,3250,7000,6700,46900000,2,26006,6503,1,731400000,731400000,9751,3250,6501,3250,0,1,3252,3675324
168,3250,7000,6700,46900000,2,26006,6503,1,731400000,731400000,9751,3250,6501,3250,0,1,3252,3558336
168,3250,7000,6700,46900000,2,26006,6503,1,731400000,731400000,9751,3250,6501,3250,0,1,3252,3565655

168,3650,7000,6700,46900000,2,29206,7303,1,775240000,775240000,10951,3650,7301,3650,0,1,3652,52023008
168,3650,7000,6700,46900000,2,29206,7303,1,775240000,775240000,10951,3650,7301,3650,0,1,3652,4064761
168,3650,7000,6700,46900000,2,29206,7303,1,775240000,775240000,10951,3650,7301,3650,0,1,3652,4067218
168,3650,7000,6700,46900000,2,29206,7303,1,775240000,775240000,10951,3650,7301,3650,0,1,3652,4070807
168,3650,7000,6700,46900000,2,29206,7303,1,775240000,775240000,10951,3650,7301,3650,0,1,3652,4072116
168,3650,7000,6700,46900000,2,29206,7303,1,775240000,775240000,10951,3650,7301,3650,0,1,3652,3933825
168,3650,7000,6700,46900000,2,29206,7303,1,775240000,775240000,10951,3650,7301,3650,0,1,3652,3944867

168,4050,7000,6700,46900000,2,32406,8103,1,819080000,819080000,12151,4050,8101,4050,0,1,4052,57173425
168,4050,7000,6700,46900000,2,32406,8103,1,819080000,819080000,12151,4050,8101,4050,0,1,4052,4443109
168,4050,7000,6700,46900000,2,32406,8103,1,819080000,819080000,12151,4050,8101,4050,0,1,4052,4444718
168,4050,7000,6700,46900000,2,32406,8103,1,819080000,819080000,12151,4050,8101,4050,0,1,4052,4441548
168,4050,7000,6700,46900000,2,32406,8103,1,819080000,819080000,12151,4050,8101,4050,0,1,4052,4421415
168,4050,7000,6700,46900000,2,32406,8103,1,819080000,819080000,12151,4050,8101,4050,0,1,4052,4302769
168,4050,7000,6700,46900000,2,32406,8103,1,819080000,819080000,12151,4050,8101,4050,0,1,4052,4282413

168,4450,7000,6700,46900000,2,35606,8903,1,862920000,862920000,13351,4450,8901,4450,0,1,4452,62103386
168,4450,7000,6700,46900000,2,35606,8903,1,862920000,862920000,13351,4450,8901,4450,0,1,4452,4819538
168,4450,7000,6700,46900000,2,35606,8903,1,862920000,862920000,13351,4450,8901,4450,0,1,4452,4818036
168,4450,7000,6700,46900000,2,35606,8903,1,862920000,862920000,13351,4450,8901,4450,0,1,4452,4814616
168,4450,7000,6700,46900000,2,35606,8903,1,862920000,862920000,13351,4450,8901,4450,0,1,4452,4816810
168,4450,7000,6700,46900000,2,35606,8903,1,862920000,862920000,13351,4450,8901,4450,0,1,4452,4682408
168,4450,7000,6700,46900000,2,35606,8903,1,862920000,862920000,13351,4450,8901,4450,0,1,4452,4664619

168,4850,7000,6700,46900000,2,38806,9703,1,906760000,906760000,14551,4850,9701,4850,0,1,4852,67742008
168,4850,7000,6700,46900000,2,38806,9703,1,906760000,906760000,14551,4850,9701,4850,0,1,4852,5224630
168,4850,7000,6700,46900000,2,38806,9703,1,906760000,906760000,14551,4850,9701,4850,0,1,4852,5192491
168,4850,7000,6700,46900000,2,38806,9703,1,906760000,906760000,14551,4850,9701,4850,0,1,4852,5218519
168,4850,7000,6700,46900000,2,38806,9703,1,906760000,906760000,14551,4850,9701,4850,0,1,4852,5223024
168,4850,7000,6700,46900000,2,38806,9703,1,906760000,906760000,14551,4850,9701,4850,0,1,4852,5076688
168,4850,7000,6700,46900000,2,38806,9703,1,906760000,906760000,14551,4850,9701,4850,0,1,4852,5055747

168,5250,7000,6700,46900000,2,42006,10503,1,950600000,950600000,15751,5250,10501,5250,0,1,5252,73791948
168,5250,7000,6700,46900000,2,42006,10503,1,950600000,950600000,15751,5250,10501,5250,0,1,5252,5613730
168,5250,7000,6700,46900000,2,42006,10503,1,950600000,950600000,15751,5250,10501,5250,0,1,5252,5638677
168,5250,7000,6700,46900000,2,42006,10503,1,950600000,950600000,15751,5250,10501,5250,0,1,5252,5636013
168,5250,7000,6700,46900000,2,42006,10503,1,950600000,950600000,15751,5250,10501,5250,0,1,5252,5640585
168,5250,7000,6700,46900000,2,42006,10503,1,950600000,950600000,15751,5250,10501,5250,0,1,5252,5474848
168,5250,7000,6700,46900000,2,42006,10503,1,950600000,950600000,15751,5250,10501,5250,0,1,5252,5481304

168,5650,7000,6700,46900000,2,45206,11303,1,994440000,994440000,16951,5650,11301,5650,0,1,5652,81363449
168,5650,7000,6700,46900000,2,45206,11303,1,994440000,994440000,16951,5650,11301,5650,0,1,5652,5926249
168,5650,7000,6700,46900000,2,45206,11303,1,994440000,994440000,16951,5650,11301,5650,0,1,5652,5976566
168,5650,7000,6700,46900000,2,45206,11303,1,994440000,994440000,16951,5650,11301,5650,0,1,5652,5974761
168,5650,7000,6700,46900000,2,45206,11303,1,994440000,994440000,16951,5650,11301,5650,0,1,5652,5966290
168,5650,7000,6700,46900000,2,45206,11303,1,994440000,994440000,16951,5650,11301,5650,0,1,5652,5820074
168,5650,7000,6700,46900000,2,45206,11303,1,994440000,994440000,16951,5650,11301,5650,0,1,5652,5823061

168,6050,7000,6700,46900000,2,48406,12103,1,1038280000,1038280000,18151,6050,12101,6050,0,1,6052,85611910
168,6050,7000,6700,46900000,2,48406,12103,1,1038280000,1038280000,18151,6050,12101,6050,0,1,6052,6418961
168,6050,7000,6700,46900000,2,48406,12103,1,1038280000,1038280000,18151,6050,12101,6050,0,1,6052,6417204
168,6050,7000,6700,46900000,2,48406,12103,1,1038280000,1038280000,18151,6050,12101,6050,0,1,6052,6422242
168,6050,7000,6700,46900000,2,48406,12103,1,1038280000,1038280000,18151,6050,12101,6050,0,1,6052,6420580
168,6050,7000,6700,46900000,2,48406,12103,1,1038280000,1038280000,18151,6050,12101,6050,0,1,6052,6254513
168,6050,7000,6700,46900000,2,48406,12103,1,1038280000,1038280000,18151,6050,12101,6050,0,1,6052,6259437

168,6450,7000,6700,46900000,2,51606,12903,1,1082120000,1082120000,19351,6450,12901,6450,0,1,6452,94182929
168,6450,7000,6700,46900000,2,51606,12903,1,1082120000,1082120000,19351,6450,12901,6450,0,1,6452,6823149
168,6450,7000,6700,46900000,2,51606,12903,1,1082120000,1082120000,19351,6450,12901,6450,0,1,6452,6817605
168,6450,7000,6700,46900000,2,51606,12903,1,1082120000,1082120000,19351,6450,12901,6450,0,1,6452,6821151
168,6450,7000,6700,46900000,2,51606,12903,1,1082120000,1082120000,19351,6450,12901,6450,0,1,6452,6825181
168,6450,7000,6700,46900000,2,51606,12903,1,1082120000,1082120000,19351,6450,12901,6450,0,1,6452,6612151
168,6450,7000,6700,46900000,2,51606,12903,1,1082120000,1082120000,19351,6450,12901,6450,0,1,6452,6622784

168,6850,7000,6700,46900000,2,54806,13703,1,1125960000,1125960000,20551,6850,13701,6850,0,1,6852,101296234
168,6850,7000,6700,46900000,2,54806,13703,1,1125960000,1125960000,20551,6850,13701,6850,0,1,6852,7175737
168,6850,7000,6700,46900000,2,54806,13703,1,1125960000,1125960000,20551,6850,13701,6850,0,1,6852,7173859
168,6850,7000,6700,46900000,2,54806,13703,1,1125960000,1125960000,20551,6850,13701,6850,0,1,6852,7179365
168,6850,7000,6700,46900000,2,54806,13703,1,1125960000,1125960000,20551,6850,13701,6850,0,1,6852,7177511
168,6850,7000,6700,46900000,2,54806,13703,1,1125960000,1125960000,20551,6850,13701,6850,0,1,6852,6984559
168,6850,7000,6700,46900000,2,54806,13703,1,1125960000,1125960000,20551,6850,13701,6850,0,1,6852,6990411

168,50,7000,6300,44100000,2,406,103,1,358120000,358120000,151,50,101,50,0,1,52,496599
168,50,7000,6300,44100000,2,406,103,1,358120000,358120000,151,50,101,50,0,1,52,462581
168,50,7000,6300,44100000,2,406,103,1,358120000,358120000,151,50,101,50,0,1,52,419929
168,50,7000,6300,44100000,2,406,103,1,358120000,358120000,151,50,101,50,0,1,52,456908
168,50,7000,6300,44100000,2,406,103,1,358120000,358120000,151,50,101,50,0,1,52,463030
168,50,7000,6300,44100000,2,406,103,1,358120000,358120000,151,50,101,50,0,1,52,455610
168,50,7000,6300,44100000,2,406,103,1,358120000,358120000,151,50,101,50,0,1,52,456245

168,450,7000,6300,44100000,2,3606,903,1,400680000,400680000,1351,450,901,450,0,1,452,4545272
168,450,7000,6300,44100000,2,3606,903,1,400680000,400680000,1351,450,901,450,0,1,452,846961
168,450,7000,6300,44100000,2,3606,903,1,400680000,400680000,1351,450,901,450,0,1,452,849237
168,450,7000,6300,44100000,2,3606,903,1,400680000,400680000,1351,450,901,450,0,1,452,850480
168,450,7000,6300,44100000,2,3606,903,1,400680000,400680000,1351,450,901,450,0,1,452,851029
168,450,7000,6300,44100000,2,3606,903,1,400680000,400680000,1351,450,901,450,0,1,452,827394
168,450,7000,6300,44100000,2,3606,903,1,400680000,400680000,1351,450,901,450,0,1,452,817415

168,850,7000,6300,44100000,2,6806,1703,1,443240000,443240000,2551,850,1701,850,0,1,852,9792554
168,850,7000,6300,44100000,2,6806,1703,1,443240000,443240000,2551,850,1701,850,0,1,852,1196764
168,850,7000,6300,44100000,2,6806,1703,1,443240000,443240000,2551,850,1701,850,0,1,852,1195811
168,850,7000,6300,44100000,2,6806,1703,1,443240000,443240000,2551,850,1701,850,0,1,852,1194829
168,850,7000,6300,44100000,2,6806,1703,1,443240000,443240000,2551,850,1701,850,0,1,852,1196372
168,850,7000,6300,44100000,2,6806,1703,1,443240000,443240000,2551,850,1701,850,0,1,852,1162505
168,850,7000,6300,44100000,2,6806,1703,1,443240000,443240000,2551,850,1701,850,0,1,852,1163437

168,1250,7000,6300,44100000,2,10006,2503,1,485800000,485800000,3751,1250,2501,1250,0,1,1252,14643717
168,1250,7000,6300,44100000,2,10006,2503,1,485800000,485800000,3751,1250,2501,1250,0,1,1252,1575610
168,1250,7000,6300,44100000,2,10006,2503,1,485800000,485800000,3751,1250,2501,1250,0,1,1252,1572940
168,1250,7000,6300,44100000,2,10006,2503,1,485800000,485800000,3751,1250,2501,1250,0,1,1252,1574463
168,1250,7000,6300,44100000,2,10006,2503,1,485800000,485800000,3751,1250,2501,1250,0,1,1252,1575120
168,1250,7000,6300,44100000,2,10006,2503,1,485800000,485800000,3751,1250,2501,1250,0,1,1252,1526965
168,1250,7000,6300,44100000,2,10006,2503,1,485800000,485800000,3751,1250,2501,1250,0,1,1252,1528016

168,1650,7000,6300,44100000,2,13206,3303,1,528360000,528360000,4951,1650,3301,1650,0,1,1652,18963817
168,1650,7000,6300,44100000,2,13206,3303,1,528360000,528360000,4951,1650,3301,1650,0,1,1652,1964807
168,1650,7000,6300,44100000,2,13206,3303,1,528360000,528360000,4951,1650,3301,1650,0,1,1652,1965784
168,1650,7000,6300,44100000,2,13206,3303,1,528360000,528360000,4951,1650,3301,1650,0,1,1652,1957030
168,1650,7000,6300,44100000,2,13206,3303,1,528360000,528360000,4951,1650,3301,1650,0,1,1652,1963699
168,1650,7000,6300,44100000,2,13206,3303,1,528360000,528360000,4951,1650,3301,1650,0,1,1652,1923700
168,1650,7000,6300,44100000,2,13206,3303,1,528360000,528360000,4951,1650,3301,1650,0,1,1652,1925072

168,2050,7000,6300,44100000,2,16406,4103,1,570920000,570920000,6151,2050,4101,2050,0,1,2052,23571801
168,2050,7000,6300,44100000,2,16406,4103,1,570920000,570920000,6151,2050,4101,2050,0,1,2052,2284257
168,2050,7000,6300,44100000,2,16406,4103,1,570920000,570920000,6151,2050,4101,2050,0,1,2052,2285064
168,2050,7000,6300,44100000,2,16406,4103,1,570920000,570920000,6151,2050,4101,2050,0,1,2052,2283103
168,2050,7000,6300,44100000,2,16406,4103,1,570920000,570920000,6151,2050,4101,2050,0,1,2052,2285773
168,2050,7000,6300,44100000,2,16406,4103,1,570920000,570920000,6151,2050,4101,2050,0,1,2052,2247172
168,2050,7000,6300,44100000,2,16406,4103,1,570920000,570920000,6151,2050,4101,2050,0,1,2052,2248491

168,2450,7000,6300,44100000,2,19606,4903,1,613480000,613480000,7351,2450,4901,2450,0,1,2452,30239086
168,2450,7000,6300,44100000,2,19606,4903,1,613480000,613480000,7351,2450,4901,2450,0,1,2452,2717492
168,2450,7000,6300,44100000,2,19606,4903,1,613480000,613480000,7351,2450,4901,2450,0,1,2452,2700050
168,2450,7000,6300,44100000,2,19606,4903,1,613480000,613480000,7351,2450,4901,2450,0,1,2452,2716272
168,2450,7000,6300,44100000,2,19606,4903,1,613480000,613480000,7351,2450,4901,2450,0,1,2452,2714746
168,2450,7000,6300,44100000,2,19606,4903,1,613480000,613480000,7351,2450,4901,2450,0,1,2452,2663945
168,2450,7000,6300,44100000,2,19606,4903,1,613480000,613480000,7351,2450,4901,2450,0,1,2452,2665656

168,2850,7000,6300,44100000,2,22806,5703,1,656040000,656040000,8551,2850,5701,2850,0,1,2852,35748735
168,2850,7000,6300,44100000,2,22806,5703,1,656040000,656040000,8551,2850,5701,2850,0,1,2852,3096307
168,2850,7000,6300,44100000,2,22806,5703,1,656040000,656040000,8551,2850,5701,2850,0,1,2852,3105185
168,2850,7000,6300,44100000,2,22806,5703,1,656040000,656040000,8551,2850,5701,2850,0,1,2852,3106282
168,2850,7000,6300,44100000,2,22806,5703,1,656040000,656040000,8551,2850,5701,2850,0,1,2852,3107400
168,2850,7000,6300,44100000,2,22806,5703,1,656040000,656040000,8551,2850,5701,2850,0,1,2852,3016036
168,2850,7000,6300,44100000,2,22806,5703,1,656040000,656040000,8551,2850,5701,2850,0,1,2852,3019993

168,3250,7000,6300,44100000,2,26006,6503,1,698600000,698600000,9751,3250,6501,3250,0,1,3252,40811634
168,3250,7000,6300,44100000,2,26006,6503,1,698600000,698600000,9751,3250,6501,3250,0,1,3252,3470397
168,3250,7000,6300,44100000,2,26006,6503,1,698600000,698600000,9751,3250,6501,3250,0,1,3252,3469352
168,3250,7000,6300,44100000,2,26006,6503,1,698600000,698600000,9751,3250,6501,3250,0,1,3252,3465156
168,3250,7000,6300,44100000,2,26006,6503,1,698600000,698600000,9751,3250,6501,3250,0,1,3252,3471390
168,3250,7000,6300,44100000,2,26006,6503,1,698600000,698600000,9751,3250,6501,3250,0,1,3252,3384959
168,3250,7000,6300,44100000,2,26006,6503,1,698600000,698600000,9751,3250,6501,3250,0,1,3252,3388419

168,3650,7000,6300,44100000,2,29206,7303,1,741160000,741160000,10951,3650,7301,3650,0,1,3652,47586248
168,3650,7000,6300,44100000,2,29206,7303,1,741160000,741160000,10951,3650,7301,3650,0,1,3652,3842982
168,3650,7000,6300,44100000,2,29206,7303,1,741160000,741160000,10951,3650,7301,3650,0,1,3652,3844046
168,3650,7000,6300,44100000,2,29206,7303,1,741160000,741160000,10951,3650,7301,3650,0,1,3652,3840443
168,3650,7000,6300,44100000,2,29206,7303,1,741160000,741160000,10951,3650,7301,3650,0,1,3652,3841836
168,3650,7000,6300,44100000,2,29206,7303,1,741160000,741160000,10951,3650,7301,3650,0,1,3652,3740208
168,3650,7000,6300,44100000,2,29206,7303,1,741160000,741160000,10951,3650,7301,3650,0,1,3652,3744171

168,4050,7000,6300,44100000,2,32406,8103,1,783720000,783720000,12151,4050,8101,4050,0,1,4052,54961568
168,4050,7000,6300,44100000,2,32406,8103,1,783720000,783720000,12151,4050,8101,4050,0,1,4052,4206446
168,4050,7000,6300,44100000,2,32406,8103,1,783720000,783720000,12151,4050,8101,4050,0,1,4052,4209922
168,4050,7000,6300,44100000,2,32406,8103,1,783720000,783720000,12151,4050,8101,4050,0,1,4052,4208481
168,4050,7000,6300,44100000,2,32406,8103,1,783720000,783720000,12151,4050,8101,4050,0,1,4052,4211095
168,4050,7000,6300,44100000,2,32406,8103,1,783720000,783720000,12151,4050,8101,4050,0,1,4052,4084471
168,4050,7000,6300,44100000,2,32406,8103,1,783720000,783720000,12151,4050,8101,4050,0,1,4052,4089145

168,4450,7000,6300,44100000,2,35606,8903,1,826280000,826280000,13351,4450,8901,4450,0,1,4452,59297887
168,4450,7000,6300,44100000,2,35606,8903,1,826280000,826280000,13351,4450,8901,4450,0,1,4452,4582336
168,4450,7000,6300,44100000,2,35606,8903,1,826280000,826280000,13351,4450,8901,4450,0,1,4452,4578139
168,4450,7000,6300,44100000,2,35606,8903,1,826280000,826280000,13351,4450,8901,4450,0,1,4452,4583846
168,4450,7000,6300,44100000,2,35606,8903,1,826280000,826280000,13351,4450,8901,4450,0,1,4452,4580743
168,4450,7000,6300,44100000,2,35606,8903,1,826280000,826280000,13351,4450,8901,4450,0,1,4452,4455603
168,4450,7000,6300,44100000,2,35606,8903,1,826280000,826280000,13351,4450,8901,4450,0,1,4452,4442510

168,4850,7000,6300,44100000,2,38806,9703,1,868840000,868840000,14551,4850,9701,4850,0,1,4852,64113116
168,4850,7000,6300,44100000,2,38806,9703,1,868840000,868840000,14551,4850,9701,4850,0,1,4852,4932642
168,4850,7000,6300,44100000,2,38806,9703,1,868840000,868840000,14551,4850,9701,4850,0,1,4852,4930365
168,4850,7000,6300,44100000,2,38806,9703,1,868840000,868840000,14551,4850,9701,4850,0,1,4852,4935357
168,4850,7000,6300,44100000,2,38806,9703,1,868840000,868840000,14551,4850,9701,4850,0,1,4852,4936975
168,4850,7000,6300,44100000,2,38806,9703,1,868840000,868840000,14551,4850,9701,4850,0,1,4852,4796469
168,4850,7000,6300,44100000,2,38806,9703,1,868840000,868840000,14551,4850,9701,4850,0,1,4852,4801429

168,5250,7000,6300,44100000,2,42006,10503,1,911400000,911400000,15751,5250,10501,5250,0,1,5252,69809518
168,5250,7000,6300,44100000,2,42006,10503,1,911400000,911400000,15751,5250,10501,5250,0,1,5252,5270512
168,5250,7000,6300,44100000,2,42006,10503,1,911400000,911400000,15751,5250,10501,5250,0,1,5252,5290432
168,5250,7000,6300,44100000,2,42006,10503,1,911400000,911400000,15751,5250,10501,5250,0,1,5252,5288799
168,5250,7000,6300,44100000,2,42006,10503,1,911400000,911400000,15751,5250,10501,5250,0,1,5252,5292157
168,5250,7000,6300,44100000,2,42006,10503,1,911400000,911400000,15751,5250,10501,5250,0,1,5252,5155573
168,5250,7000,6300,44100000,2,42006,10503,1,911400000,911400000,15751,5250,10501,5250,0,1,5252,5158293

168,5650,7000,6300,44100000,2,45206,11303,1,953960000,953960000,16951,5650,11301,5650,0,1,5652,76493423
168,5650,7000,6300,44100000,2,45206,11303,1,953960000,953960000,16951,5650,11301,5650,0,1,5652,5698093
168,5650,7000,6300,44100000,2,45206,11303,1,953960000,953960000,16951,5650,11301,5650,0,1,5652,5699919
168,5650,7000,6300,44100000,2,45206,11303,1,953960000,953960000,16951,5650,11301,5650,0,1,5652,5691729
168,5650,7000,6300,44100000,2,45206,11303,1,953960000,953960000,16951,5650,11301,5650,0,1,5652,5683179
168,5650,7000,6300,44100000,2,45206,11303,1,953960000,953960000,16951,5650,11301,5650,0,1,5652,5523846
168,5650,7000,6300,44100000,2,45206,11303,1,953960000,953960000,16951,5650,11301,5650,0,1,5652,5498378

168,6050,7000,6300,44100000,2,48406,12103,1,996520000,996520000,18151,6050,12101,6050,0,1,6052,83500716
168,6050,7000,6300,44100000,2,48406,12103,1,996520000,996520000,18151,6050,12101,6050,0,1,6052,6044213
168,6050,7000,6300,44100000,2,48406,12103,1,996520000,996520000,18151,6050,12101,6050,0,1,6052,6042547
168,6050,7000,6300,44100000,2,48406,12103,1,996520000,996520000,18151,6050,12101,6050,0,1,6052,6037961
168,6050,7000,6300,44100000,2,48406,12103,1,996520000,996520000,18151,6050,12101,6050,0,1,6052,6040906
168,6050,7000,6300,44100000,2,48406,12103,1,996520000,996520000,18151,6050,12101,6050,0,1,6052,5870413
168,6050,7000,6300,44100000,2,48406,12103,1,996520000,996520000,18151,6050,12101,6050,0,1,6052,5873263

168,6450,7000,6300,44100000,2,51606,12903,1,1039080000,1039080000,19351,6450,12901,6450,0,1,6452,85391355
168,6450,7000,6300,44100000,2,51606,12903,1,1039080000,1039080000,19351,6450,12901,6450,0,1,6452,6391724
168,6450,7000,6300,44100000,2,51606,12903,1,1039080000,1039080000,19351,6450,12901,6450,0,1,6452,6389899
168,6450,7000,6300,44100000,2,51606,12903,1,1039080000,1039080000,19351,6450,12901,6450,0,1,6452,6396694
168,6450,7000,6300,44100000,2,51606,12903,1,1039080000,1039080000,19351,6450,12901,6450,0,1,6452,6398706
168,6450,7000,6300,44100000,2,51606,12903,1,1039080000,1039080000,19351,6450,12901,6450,0,1,6452,6204609
168,6450,7000,6300,44100000,2,51606,12903,1,1039080000,1039080000,19351,6450,12901,6450,0,1,6452,6201938

168,6850,7000,6300,44100000,2,54806,13703,1,1081640000,1081640000,20551,6850,13701,6850,0,1,6852,91602826
168,6850,7000,6300,44100000,2,54806,13703,1,1081640000,1081640000,20551,6850,13701,6850,0,1,6852,6781356
168,6850,7000,6300,44100000,2,54806,13703,1,1081640000,1081640000,20551,6850,13701,6850,0,1,6852,6779420
168,6850,7000,6300,44100000,2,54806,13703,1,1081640000,1081640000,20551,6850,13701,6850,0,1,6852,6777530
168,6850,7000,6300,44100000,2,54806,13703,1,1081640000,1081640000,20551,6850,13701,6850,0,1,6852,6783226
168,6850,7000,6300,44100000,2,54806,13703,1,1081640000,1081640000,20551,6850,13701,6850,0,1,6852,6593046
168,6850,7000,6300,44100000,2,54806,13703,1,1081640000,1081640000,20551,6850,13701,6850,0,1,6852,6595874

168,50,7000,5900,41300000,2,406,103,1,335560000,335560000,151,50,101,50,0,1,52,452267
168,50,7000,5900,41300000,2,406,103,1,335560000,335560000,151,50,101,50,0,1,52,431513
168,50,7000,5900,41300000,2,406,103,1,335560000,335560000,151,50,101,50,0,1,52,438459
168,50,7000,5900,41300000,2,406,103,1,335560000,335560000,151,50,101,50,0,1,52,385139
168,50,7000,5900,41300000,2,406,103,1,335560000,335560000,151,50,101,50,0,1,52,438908
168,50,7000,5900,41300000,2,406,103,1,335560000,335560000,151,50,101,50,0,1,52,433046
168,50,7000,5900,41300000,2,406,103,1,335560000,335560000,151,50,101,50,0,1,52,436830

168,450,7000,5900,41300000,2,3606,903,1,376840000,376840000,1351,450,901,450,0,1,452,4239733
168,450,7000,5900,41300000,2,3606,903,1,376840000,376840000,1351,450,901,450,0,1,452,789900
168,450,7000,5900,41300000,2,3606,903,1,376840000,376840000,1351,450,901,450,0,1,452,790839
168,450,7000,5900,41300000,2,3606,903,1,376840000,376840000,1351,450,901,450,0,1,452,790300
168,450,7000,5900,41300000,2,3606,903,1,376840000,376840000,1351,450,901,450,0,1,452,782414
168,450,7000,5900,41300000,2,3606,903,1,376840000,376840000,1351,450,901,450,0,1,452,782918
168,450,7000,5900,41300000,2,3606,903,1,376840000,376840000,1351,450,901,450,0,1,452,783534

168,850,7000,5900,41300000,2,6806,1703,1,418120000,418120000,2551,850,1701,850,0,1,852,8910705
168,850,7000,5900,41300000,2,6806,1703,1,418120000,418120000,2551,850,1701,850,0,1,852,1111669
168,850,7000,5900,41300000,2,6806,1703,1,418120000,418120000,2551,850,1701,850,0,1,852,1113043
168,850,7000,5900,41300000,2,6806,1703,1,418120000,418120000,2551,850,1701,850,0,1,852,1113603
168,850,7000,5900,41300000,2,6806,1703,1,418120000,418120000,2551,850,1701,850,0,1,852,1113996
168,850,7000,5900,41300000,2,6806,1703,1,418120000,418120000,2551,850,1701,850,0,1,852,1089322
168,850,7000,5900,41300000,2,6806,1703,1,418120000,418120000,2551,850,1701,850,0,1,852,1090272

168,1250,7000,5900,41300000,2,10006,2503,1,459400000,459400000,3751,1250,2501,1250,0,1,1252,13703605
168,1250,7000,5900,41300000,2,10006,2503,1,459400000,459400000,3751,1250,2501,1250,0,1,1252,1470669
168,1250,7000,5900,41300000,2,10006,2503,1,459400000,459400000,3751,1250,2501,1250,0,1,1252,1470188
168,1250,7000,5900,41300000,2,10006,2503,1,459400000,459400000,3751,1250,2501,1250,0,1,1252,1468012
168,1250,7000,5900,41300000,2,10006,2503,1,459400000,459400000,3751,1250,2501,1250,0,1,1252,1469522
168,1250,7000,5900,41300000,2,10006,2503,1,459400000,459400000,3751,1250,2501,1250,0,1,1252,1430286
168,1250,7000,5900,41300000,2,10006,2503,1,459400000,459400000,3751,1250,2501,1250,0,1,1252,1431508

168,1650,7000,5900,41300000,2,13206,3303,1,500680000,500680000,4951,1650,3301,1650,0,1,1652,18650742
168,1650,7000,5900,41300000,2,13206,3303,1,500680000,500680000,4951,1650,3301,1650,0,1,1652,1842735
168,1650,7000,5900,41300000,2,13206,3303,1,500680000,500680000,4951,1650,3301,1650,0,1,1652,1844430
168,1650,7000,5900,41300000,2,13206,3303,1,500680000,500680000,4951,1650,3301,1650,0,1,1652,1764418
168,1650,7000,5900,41300000,2,13206,3303,1,500680000,500680000,4951,1650,3301,1650,0,1,1652,1843587
168,1650,7000,5900,41300000,2,13206,3303,1,500680000,500680000,4951,1650,3301,1650,0,1,1652,1799722
168,1650,7000,5900,41300000,2,13206,3303,1,500680000,500680000,4951,1650,3301,1650,0,1,1652,1800833

168,2050,7000,5900,41300000,2,16406,4103,1,541960000,541960000,6151,2050,4101,2050,0,1,2052,23486920
168,2050,7000,5900,41300000,2,16406,4103,1,541960000,541960000,6151,2050,4101,2050,0,1,2052,2145944
168,2050,7000,5900,41300000,2,16406,4103,1,541960000,541960000,6151,2050,4101,2050,0,1,2052,2146677
168,2050,7000,5900,41300000,2,16406,4103,1,541960000,541960000,6151,2050,4101,2050,0,1,2052,2144493
168,2050,7000,5900,41300000,2,16406,4103,1,541960000,541960000,6151,2050,4101,2050,0,1,2052,2147639
168,2050,7000,5900,41300000,2,16406,4103,1,541960000,541960000,6151,2050,4101,2050,0,1,2052,2114525
168,2050,7000,5900,41300000,2,16406,4103,1,541960000,541960000,6151,2050,4101,2050,0,1,2052,2115843

168,2450,7000,5900,41300000,2,19606,4903,1,583240000,583240000,7351,2450,4901,2450,0,1,2452,28829315
168,2450,7000,5900,41300000,2,19606,4903,1,583240000,583240000,7351,2450,4901,2450,0,1,2452,2551187
168,2450,7000,5900,41300000,2,19606,4903,1,583240000,583240000,7351,2450,4901,2450,0,1,2452,2542713
168,2450,7000,5900,41300000,2,19606,4903,1,583240000,583240000,7351,2450,4901,2450,0,1,2452,2549955
168,2450,7000,5900,41300000,2,19606,4903,1,583240000,583240000,7351,2450,4901,2450,0,1,2452,2548451
168,2450,7000,5900,41300000,2,19606,4903,1,583240000,583240000,7351,2450,4901,2450,0,1,2452,2496724
168,2450,7000,5900,41300000,2,19606,4903,1,583240000,583240000,7351,2450,4901,2450,0,1,2452,2498621

168,2850,7000,5900,41300000,2,22806,5703,1,624520000,624520000,8551,2850,5701,2850,0,1,2852,33149767
168,2850,7000,5900,41300000,2,22806,5703,1,624520000,624520000,8551,2850,5701,2850,0,1,2852,2926340
168,2850,7000,5900,41300000,2,22806,5703,1,624520000,624520000,8551,2850,5701,2850,0,1,2852,2917986
168,2850,7000,5900,41300000,2,22806,5703,1,624520000,624520000,8551,2850,5701,2850,0,1,2852,2920654
168,2850,7000,5900,41300000,2,22806,5703,1,624520000,624520000,8551,2850,5701,2850,0,1,2852,2925207
168,2850,7000,5900,41300000,2,22806,5703,1,624520000,624520000,8551,2850,5701,2850,0,1,2852,2859393
168,2850,7000,5900,41300000,2,22806,5703,1,624520000,624520000,8551,2850,5701,2850,0,1,2852,2861458

168,3250,7000,5900,41300000,2,26006,6503,1,665800000,665800000,9751,3250,6501,3250,0,1,3252,38372172
168,3250,7000,5900,41300000,2,26006,6503,1,665800000,665800000,9751,3250,6501,3250,0,1,3252,3269898
168,3250,7000,5900,41300000,2,26006,6503,1,665800000,665800000,9751,3250,6501,3250,0,1,3252,3272333
168,3250,7000,5900,41300000,2,26006,6503,1,665800000,665800000,9751,3250,6501,3250,0,1,3252,3271110
168,3250,7000,5900,41300000,2,26006,6503,1,665800000,665800000,9751,3250,6501,3250,0,1,3252,3267408
168,3250,7000,5900,41300000,2,26006,6503,1,665800000,665800000,9751,3250,6501,3250,0,1,3252,3173627
168,3250,7000,5900,41300000,2,26006,6503,1,665800000,665800000,9751,3250,6501,3250,0,1,3252,3175347

168,3650,7000,5900,41300000,2,29206,7303,1,707080000,707080000,10951,3650,7301,3650,0,1,3652,45064920
168,3650,7000,5900,41300000,2,29206,7303,1,707080000,707080000,10951,3650,7301,3650,0,1,3652,3625798
168,3650,7000,5900,41300000,2,29206,7303,1,707080000,707080000,10951,3650,7301,3650,0,1,3652,3627502
168,3650,7000,5900,41300000,2,29206,7303,1,707080000,707080000,10951,3650,7301,3650,0,1,3652,3632559
168,3650,7000,5900,41300000,2,29206,7303,1,707080000,707080000,10951,3650,7301,3650,0,1,3652,3633909
168,3650,7000,5900,41300000,2,29206,7303,1,707080000,707080000,10951,3650,7301,3650,0,1,3652,3501512
168,3650,7000,5900,41300000,2,29206,7303,1,707080000,707080000,10951,3650,7301,3650,0,1,3652,3503686

168,4050,7000,5900,41300000,2,32406,8103,1,748360000,748360000,12151,4050,8101,4050,0,1,4052,50709717
168,4050,7000,5900,41300000,2,32406,8103,1,748360000,748360000,12151,4050,8101,4050,0,1,4052,3916746
168,4050,7000,5900,41300000,2,32406,8103,1,748360000,748360000,12151,4050,8101,4050,0,1,4052,3919087
168,4050,7000,5900,41300000,2,32406,8103,1,748360000,748360000,12151,4050,8101,4050,0,1,4052,3917850
168,4050,7000,5900,41300000,2,32406,8103,1,748360000,748360000,12151,4050,8101,4050,0,1,4052,3920272
168,4050,7000,5900,41300000,2,32406,8103,1,748360000,748360000,12151,4050,8101,4050,0,1,4052,3810150
168,4050,7000,5900,41300000,2,32406,8103,1,748360000,748360000,12151,4050,8101,4050,0,1,4052,3808244

168,4450,7000,5900,41300000,2,35606,8903,1,789640000,789640000,13351,4450,8901,4450,0,1,4452,54640596
168,4450,7000,5900,41300000,2,35606,8903,1,789640000,789640000,13351,4450,8901,4450,0,1,4452,4346455
168,4450,7000,5900,41300000,2,35606,8903,1,789640000,789640000,13351,4450,8901,4450,0,1,4452,4344186
168,4450,7000,5900,41300000,2,35606,8903,1,789640000,789640000,13351,4450,8901,4450,0,1,4452,4327848
168,4450,7000,5900,41300000,2,35606,8903,1,789640000,789640000,13351,4450,8901,4450,0,1,4452,4348178
168,4450,7000,5900,41300000,2,35606,8903,1,789640000,789640000,13351,4450,8901,4450,0,1,4452,4210397
168,4450,7000,5900,41300000,2,35606,8903,1,789640000,789640000,13351,4450,8901,4450,0,1,4452,4213059

168,4850,7000,5900,41300000,2,38806,9703,1,830920000,830920000,14551,4850,9701,4850,0,1,4852,59657809
168,4850,7000,5900,41300000,2,38806,9703,1,830920000,830920000,14551,4850,9701,4850,0,1,4852,4635818
168,4850,7000,5900,41300000,2,38806,9703,1,830920000,830920000,14551,4850,9701,4850,0,1,4852,4633123
168,4850,7000,5900,41300000,2,38806,9703,1,830920000,830920000,14551,4850,9701,4850,0,1,4852,4637497
168,4850,7000,5900,41300000,2,38806,9703,1,830920000,830920000,14551,4850,9701,4850,0,1,4852,4639134
168,4850,7000,5900,41300000,2,38806,9703,1,830920000,830920000,14551,4850,9701,4850,0,1,4852,4501721
168,4850,7000,5900,41300000,2,38806,9703,1,830920000,830920000,14551,4850,9701,4850,0,1,4852,4509779

168,5250,7000,5900,41300000,2,42006,10503,1,872200000,872200000,15751,5250,10501,5250,0,1,5252,64356433
168,5250,7000,5900,41300000,2,42006,10503,1,872200000,872200000,15751,5250,10501,5250,0,1,5252,5030122
168,5250,7000,5900,41300000,2,42006,10503,1,872200000,872200000,15751,5250,10501,5250,0,1,5252,5023189
168,5250,7000,5900,41300000,2,42006,10503,1,872200000,872200000,15751,5250,10501,5250,0,1,5252,5025548
168,5250,7000,5900,41300000,2,42006,10503,1,872200000,872200000,15751,5250,10501,5250,0,1,5252,5028400
168,5250,7000,5900,41300000,2,42006,10503,1,872200000,872200000,15751,5250,10501,5250,0,1,5252,4848751
168,5250,7000,5900,41300000,2,42006,10503,1,872200000,872200000,15751,5250,10501,5250,0,1,5252,4851255

168,5650,7000,5900,41300000,2,45206,11303,1,913480000,913480000,16951,5650,11301,5650,0,1,5652,70023799
168,5650,7000,5900,41300000,2,45206,11303,1,913480000,913480000,16951,5650,11301,5650,0,1,5652,5351611
168,5650,7000,5900,41300000,2,45206,11303,1,913480000,913480000,16951,5650,11301,5650,0,1,5652,5346482
168,5650,7000,5900,41300000,2,45206,11303,1,913480000,913480000,16951,5650,11301,5650,0,1,5652,5321667
168,5650,7000,5900,41300000,2,45206,11303,1,913480000,913480000,16951,5650,11301,5650,0,1,5652,5355281
168,5650,7000,5900,41300000,2,45206,11303,1,913480000,913480000,16951,5650,11301,5650,0,1,5652,5190781
168,5650,7000,5900,41300000,2,45206,11303,1,913480000,913480000,16951,5650,11301,5650,0,1,5652,5194155

168,6050,7000,5900,41300000,2,48406,12103,1,954760000,954760000,18151,6050,12101,6050,0,1,6052,74385022
168,6050,7000,5900,41300000,2,48406,12103,1,954760000,954760000,18151,6050,12101,6050,0,1,6052,5687794
168,6050,7000,5900,41300000,2,48406,12103,1,954760000,954760000,18151,6050,12101,6050,0,1,6052,5674426
168,6050,7000,5900,41300000,2,48406,12103,1,954760000,954760000,18151,6050,12101,6050,0,1,6052,5684498
168,6050,7000,5900,41300000,2,48406,12103,1,954760000,954760000,18151,6050,12101,6050,0,1,6052,5686135
168,6050,7000,5900,41300000,2,48406,12103,1,954760000,954760000,18151,6050,12101,6050,0,1,6052,5526591
168,6050,7000,5900,41300000,2,48406,12103,1,954760000,954760000,18151,6050,12101,6050,0,1,6052,5517898

168,6450,7000,5900,41300000,2,51606,12903,1,996040000,996040000,19351,6450,12901,6450,0,1,6452,80927157
168,6450,7000,5900,41300000,2,51606,12903,1,996040000,996040000,19351,6450,12901,6450,0,1,6452,6005267
168,6450,7000,5900,41300000,2,51606,12903,1,996040000,996040000,19351,6450,12901,6450,0,1,6452,6008748
168,6450,7000,5900,41300000,2,51606,12903,1,996040000,996040000,19351,6450,12901,6450,0,1,6452,6006971
168,6450,7000,5900,41300000,2,51606,12903,1,996040000,996040000,19351,6450,12901,6450,0,1,6452,6003791
168,6450,7000,5900,41300000,2,51606,12903,1,996040000,996040000,19351,6450,12901,6450,0,1,6452,5843007
168,6450,7000,5900,41300000,2,51606,12903,1,996040000,996040000,19351,6450,12901,6450,0,1,6452,5847744

168,6850,7000,5900,41300000,2,54806,13703,1,1037320000,1037320000,20551,6850,13701,6850,0,1,6852,85155303
168,6850,7000,5900,41300000,2,54806,13703,1,1037320000,1037320000,20551,6850,13701,6850,0,1,6852,6423797
168,6850,7000,5900,41300000,2,54806,13703,1,1037320000,1037320000,20551,6850,13701,6850,0,1,6852,6415394
168,6850,7000,5900,41300000,2,54806,13703,1,1037320000,1037320000,20551,6850,13701,6850,0,1,6852,6418212
168,6850,7000,5900,41300000,2,54806,13703,1,1037320000,1037320000,20551,6850,13701,6850,0,1,6852,6421678
168,6850,7000,5900,41300000,2,54806,13703,1,1037320000,1037320000,20551,6850,13701,6850,0,1,6852,6222170
168,6850,7000,5900,41300000,2,54806,13703,1,1037320000,1037320000,20551,6850,13701,6850,0,1,6852,6225285

168,50,7000,5500,38500000,2,406,103,1,313000000,313000000,151,50,101,50,0,1,52,423589
168,50,7000,5500,38500000,2,406,103,1,313000000,313000000,151,50,101,50,0,1,52,391106
168,50,7000,5500,38500000,2,406,103,1,313000000,313000000,151,50,101,50,0,1,52,391772
168,50,7000,5500,38500000,2,406,103,1,313000000,313000000,151,50,101,50,0,1,52,335014
168,50,7000,5500,38500000,2,406,103,1,313000000,313000000,151,50,101,50,0,1,52,275716
168,50,7000,5500,38500000,2,406,103,1,313000000,313000000,151,50,101,50,0,1,52,396883
168,50,7000,5500,38500000,2,406,103,1,313000000,313000000,151,50,101,50,0,1,52,396504

168,450,7000,5500,38500000,2,3606,903,1,353000000,353000000,1351,450,901,450,0,1,452,3943411
168,450,7000,5500,38500000,2,3606,903,1,353000000,353000000,1351,450,901,450,0,1,452,738293
168,450,7000,5500,38500000,2,3606,903,1,353000000,353000000,1351,450,901,450,0,1,452,745946
168,450,7000,5500,38500000,2,3606,903,1,353000000,353000000,1351,450,901,450,0,1,452,747127
168,450,7000,5500,38500000,2,3606,903,1,353000000,353000000,1351,450,901,450,0,1,452,747530
168,450,7000,5500,38500000,2,3606,903,1,353000000,353000000,1351,450,901,450,0,1,452,747979
168,450,7000,5500,38500000,2,3606,903,1,353000000,353000000,1351,450,901,450,0,1,452,748427

168,850,7000,5500,38500000,2,6806,1703,1,393000000,393000000,2551,850,1701,850,0,1,852,8402606
168,850,7000,5500,38500000,2,6806,1703,1,393000000,393000000,2551,850,1701,850,0,1,852,1035379
168,850,7000,5500,38500000,2,6806,1703,1,393000000,393000000,2551,850,1701,850,0,1,852,1036313
168,850,7000,5500,38500000,2,6806,1703,1,393000000,393000000,2551,850,1701,850,0,1,852,1034407
168,850,7000,5500,38500000,2,6806,1703,1,393000000,393000000,2551,850,1701,850,0,1,852,1035930
168,850,7000,5500,38500000,2,6806,1703,1,393000000,393000000,2551,850,1701,850,0,1,852,1020792
168,850,7000,5500,38500000,2,6806,1703,1,393000000,393000000,2551,850,1701,850,0,1,852,1021708

168,1250,7000,5500,38500000,2,10006,2503,1,433000000,433000000,3751,1250,2501,1250,0,1,1252,12656230
168,1250,7000,5500,38500000,2,10006,2503,1,433000000,433000000,3751,1250,2501,1250,0,1,1252,1374337
168,1250,7000,5500,38500000,2,10006,2503,1,433000000,433000000,3751,1250,2501,1250,0,1,1252,1373613
168,1250,7000,5500,38500000,2,10006,2503,1,433000000,433000000,3751,1250,2501,1250,0,1,1252,1371138
168,1250,7000,5500,38500000,2,10006,2503,1,433000000,433000000,3751,1250,2501,1250,0,1,1252,1372808
168,1250,7000,5500,38500000,2,10006,2503,1,433000000,433000000,3751,1250,2501,1250,0,1,1252,1341117
168,1250,7000,5500,38500000,2,10006,2503,1,433000000,433000000,3751,1250,2501,1250,0,1,1252,1342185

168,1650,7000,5500,38500000,2,13206,3303,1,473000000,473000000,4951,1650,3301,1650,0,1,1652,17006747
168,1650,7000,5500,38500000,2,13206,3303,1,473000000,473000000,4951,1650,3301,1650,0,1,1652,1667353
168,1650,7000,5500,38500000,2,13206,3303,1,473000000,473000000,4951,1650,3301,1650,0,1,1652,1664949
168,1650,7000,5500,38500000,2,13206,3303,1,473000000,473000000,4951,1650,3301,1650,0,1,1652,1666764
168,1650,7000,5500,38500000,2,13206,3303,1,473000000,473000000,4951,1650,3301,1650,0,1,1652,1666051
168,1650,7000,5500,38500000,2,13206,3303,1,473000000,473000000,4951,1650,3301,1650,0,1,1652,1652379
168,1650,7000,5500,38500000,2,13206,3303,1,473000000,473000000,4951,1650,3301,1650,0,1,1652,1653590

168,2050,7000,5500,38500000,2,16406,4103,1,513000000,513000000,6151,2050,4101,2050,0,1,2052,21172417
168,2050,7000,5500,38500000,2,16406,4103,1,513000000,513000000,6151,2050,4101,2050,0,1,2052,2045987
168,2050,7000,5500,38500000,2,16406,4103,1,513000000,513000000,6151,2050,4101,2050,0,1,2052,2040930
168,2050,7000,5500,38500000,2,16406,4103,1,513000000,513000000,6151,2050,4101,2050,0,1,2052,2038538
168,2050,7000,5500,38500000,2,16406,4103,1,513000000,513000000,6151,2050,4101,2050,0,1,2052,2045054
168,2050,7000,5500,38500000,2,16406,4103,1,513000000,513000000,6151,2050,4101,2050,0,1,2052,2011489
168,2050,7000,5500,38500000,2,16406,4103,1,513000000,513000000,6151,2050,4101,2050,0,1,2052,2013153

168,2450,7000,5500,38500000,2,19606,4903,1,553000000,553000000,7351,2450,4901,2450,0,1,2452,25545879
168,2450,7000,5500,38500000,2,19606,4903,1,553000000,553000000,7351,2450,4901,2450,0,1,2452,2371875
168,2450,7000,5500,38500000,2,19606,4903,1,553000000,553000000,7351,2450,4901,2450,0,1,2452,2369178
168,2450,7000,5500,38500000,2,19606,4903,1,553000000,553000000,7351,2450,4901,2450,0,1,2452,2366283
168,2450,7000,5500,38500000,2,19606,4903,1,553000000,553000000,7351,2450,4901,2450,0,1,2452,2370682
168,2450,7000,5500,38500000,2,19606,4903,1,553000000,553000000,7351,2450,4901,2450,0,1,2452,2330052
168,2450,7000,5500,38500000,2,19606,4903,1,553000000,553000000,7351,2450,4901,2450,0,1,2452,2331754

168,2850,7000,5500,38500000,2,22806,5703,1,593000000,593000000,8551,2850,5701,2850,0,1,2852,31187691
168,2850,7000,5500,38500000,2,22806,5703,1,593000000,593000000,8551,2850,5701,2850,0,1,2852,2707686
168,2850,7000,5500,38500000,2,22806,5703,1,593000000,593000000,8551,2850,5701,2850,0,1,2852,2704653
168,2850,7000,5500,38500000,2,22806,5703,1,593000000,593000000,8551,2850,5701,2850,0,1,2852,2703025
168,2850,7000,5500,38500000,2,22806,5703,1,593000000,593000000,8551,2850,5701,2850,0,1,2852,2706578
168,2850,7000,5500,38500000,2,22806,5703,1,593000000,593000000,8551,2850,5701,2850,0,1,2852,2641425
168,2850,7000,5500,38500000,2,22806,5703,1,593000000,593000000,8551,2850,5701,2850,0,1,2852,2643138

168,3250,7000,5500,38500000,2,26006,6503,1,633000000,633000000,9751,3250,6501,3250,0,1,3252,35324846
168,3250,7000,5500,38500000,2,26006,6503,1,633000000,633000000,9751,3250,6501,3250,0,1,3252,3080781
168,3250,7000,5500,38500000,2,26006,6503,1,633000000,633000000,9751,3250,6501,3250,0,1,3252,3078788
168,3250,7000,5500,38500000,2,26006,6503,1,633000000,633000000,9751,3250,6501,3250,0,1,3252,3082096
168,3250,7000,5500,38500000,2,26006,6503,1,633000000,633000000,9751,3250,6501,3250,0,1,3252,3083348
168,3250,7000,5500,38500000,2,26006,6503,1,633000000,633000000,9751,3250,6501,3250,0,1,3252,2988235
168,3250,7000,5500,38500000,2,26006,6503,1,633000000,633000000,9751,3250,6501,3250,0,1,3252,2990042

168,3650,7000,5500,38500000,2,29206,7303,1,673000000,673000000,10951,3650,7301,3650,0,1,3652,40983072
168,3650,7000,5500,38500000,2,29206,7303,1,673000000,673000000,10951,3650,7301,3650,0,1,3652,3382679
168,3650,7000,5500,38500000,2,29206,7303,1,673000000,673000000,10951,3650,7301,3650,0,1,3652,3392289
168,3650,7000,5500,38500000,2,29206,7303,1,673000000,673000000,10951,3650,7301,3650,0,1,3652,3394202
168,3650,7000,5500,38500000,2,29206,7303,1,673000000,673000000,10951,3650,7301,3650,0,1,3652,3395724
168,3650,7000,5500,38500000,2,29206,7303,1,673000000,673000000,10951,3650,7301,3650,0,1,3652,3310263
168,3650,7000,5500,38500000,2,29206,7303,1,673000000,673000000,10951,3650,7301,3650,0,1,3652,3318307

168,4050,7000,5500,38500000,2,32406,8103,1,713000000,713000000,12151,4050,8101,4050,0,1,4052,45295122
168,4050,7000,5500,38500000,2,32406,8103,1,713000000,713000000,12151,4050,8101,4050,0,1,4052,3702737
168,4050,7000,5500,38500000,2,32406,8103,1,713000000,713000000,12151,4050,8101,4050,0,1,4052,3704162
168,4050,7000,5500,38500000,2,32406,8103,1,713000000,713000000,12151,4050,8101,4050,0,1,4052,3698923
168,4050,7000,5500,38500000,2,32406,8103,1,713000000,713000000,12151,4050,8101,4050,0,1,4052,3701232
168,4050,7000,5500,38500000,2,32406,8103,1,713000000,713000000,12151,4050,8101,4050,0,1,4052,3608345
168,4050,7000,5500,38500000,2,32406,8103,1,713000000,713000000,12151,4050,8101,4050,0,1,4052,3606305

168,4450,7000,5500,38500000,2,35606,8903,1,753000000,753000000,13351,4450,8901,4450,0,1,4452,50313726
168,4450,7000,5500,38500000,2,35606,8903,1,753000000,753000000,13351,4450,8901,4450,0,1,4452,4021818
168,4450,7000,5500,38500000,2,35606,8903,1,753000000,753000000,13351,4450,8901,4450,0,1,4452,4023339
168,4450,7000,5500,38500000,2,35606,8903,1,753000000,753000000,13351,4450,8901,4450,0,1,4452,4017800
168,4450,7000,5500,38500000,2,35606,8903,1,753000000,753000000,13351,4450,8901,4450,0,1,4452,4020234
168,4450,7000,5500,38500000,2,35606,8903,1,753000000,753000000,13351,4450,8901,4450,0,1,4452,3910771
168,4450,7000,5500,38500000,2,35606,8903,1,753000000,753000000,13351,4450,8901,4450,0,1,4452,3908614

168,4850,7000,5500,38500000,2,38806,9703,1,793000000,793000000,14551,4850,9701,4850,0,1,4852,53754646
168,4850,7000,5500,38500000,2,38806,9703,1,793000000,793000000,14551,4850,9701,4850,0,1,4852,4351590
168,4850,7000,5500,38500000,2,38806,9703,1,793000000,793000000,14551,4850,9701,4850,0,1,4852,4350063
168,4850,7000,5500,38500000,2,38806,9703,1,793000000,793000000,14551,4850,9701,4850,0,1,4852,4340877
168,4850,7000,5500,38500000,2,38806,9703,1,793000000,793000000,14551,4850,9701,4850,0,1,4852,4353222
168,4850,7000,5500,38500000,2,38806,9703,1,793000000,793000000,14551,4850,9701,4850,0,1,4852,4225520
168,4850,7000,5500,38500000,2,38806,9703,1,793000000,793000000,14551,4850,9701,4850,0,1,4852,4228234

168,5250,7000,5500,38500000,2,42006,10503,1,833000000,833000000,15751,5250,10501,5250,0,1,5252,60605704
168,5250,7000,5500,38500000,2,42006,10503,1,833000000,833000000,15751,5250,10501,5250,0,1,5252,4636411
168,5250,7000,5500,38500000,2,42006,10503,1,833000000,833000000,15751,5250,10501,5250,0,1,5252,4650869
168,5250,7000,5500,38500000,2,42006,10503,1,833000000,833000000,15751,5250,10501,5250,0,1,5252,4660358
168,5250,7000,5500,38500000,2,42006,10503,1,833000000,833000000,15751,5250,10501,5250,0,1,5252,4658637
168,5250,7000,5500,38500000,2,42006,10503,1,833000000,833000000,15751,5250,10501,5250,0,1,5252,4512544
168,5250,7000,5500,38500000,2,42006,10503,1,833000000,833000000,15751,5250,10501,5250,0,1,5252,4509414

168,5650,7000,5500,38500000,2,45206,11303,1,873000000,873000000,16951,5650,11301,5650,0,1,5652,64135124
168,5650,7000,5500,38500000,2,45206,11303,1,873000000,873000000,16951,5650,11301,5650,0,1,5652,4984119
168,5650,7000,5500,38500000,2,45206,11303,1,873000000,873000000,16951,5650,11301,5650,0,1,5652,4988848
168,5650,7000,5500,38500000,2,45206,11303,1,873000000,873000000,16951,5650,11301,5650,0,1,5652,4987036
168,5650,7000,5500,38500000,2,45206,11303,1,873000000,873000000,16951,5650,11301,5650,0,1,5652,4959723
168,5650,7000,5500,38500000,2,45206,11303,1,873000000,873000000,16951,5650,11301,5650,0,1,5652,4852885
168,5650,7000,5500,38500000,2,45206,11303,1,873000000,873000000,16951,5650,11301,5650,0,1,5652,4855801

168,6050,7000,5500,38500000,2,48406,12103,1,913000000,913000000,18151,6050,12101,6050,0,1,6052,70302348
168,6050,7000,5500,38500000,2,48406,12103,1,913000000,913000000,18151,6050,12101,6050,0,1,6052,5334968
168,6050,7000,5500,38500000,2,48406,12103,1,913000000,913000000,18151,6050,12101,6050,0,1,6052,5336510
168,6050,7000,5500,38500000,2,48406,12103,1,913000000,913000000,18151,6050,12101,6050,0,1,6052,5332440
168,6050,7000,5500,38500000,2,48406,12103,1,913000000,913000000,18151,6050,12101,6050,0,1,6052,5338438
168,6050,7000,5500,38500000,2,48406,12103,1,913000000,913000000,18151,6050,12101,6050,0,1,6052,5167254
168,6050,7000,5500,38500000,2,48406,12103,1,913000000,913000000,18151,6050,12101,6050,0,1,6052,5170191

168,6450,7000,5500,38500000,2,51606,12903,1,953000000,953000000,19351,6450,12901,6450,0,1,6452,72627770
168,6450,7000,5500,38500000,2,51606,12903,1,953000000,953000000,19351,6450,12901,6450,0,1,6452,5688755
168,6450,7000,5500,38500000,2,51606,12903,1,953000000,953000000,19351,6450,12901,6450,0,1,6452,5687270
168,6450,7000,5500,38500000,2,51606,12903,1,953000000,953000000,19351,6450,12901,6450,0,1,6452,5685004
168,6450,7000,5500,38500000,2,51606,12903,1,953000000,953000000,19351,6450,12901,6450,0,1,6452,5690923
168,6450,7000,5500,38500000,2,51606,12903,1,953000000,953000000,19351,6450,12901,6450,0,1,6452,5522942
168,6450,7000,5500,38500000,2,51606,12903,1,953000000,953000000,19351,6450,12901,6450,0,1,6452,5528277

168,6850,7000,5500,38500000,2,54806,13703,1,993000000,993000000,20551,6850,13701,6850,0,1,6852,78863988
168,6850,7000,5500,38500000,2,54806,13703,1,993000000,993000000,20551,6850,13701,6850,0,1,6852,5981879
168,6850,7000,5500,38500000,2,54806,13703,1,993000000,993000000,20551,6850,13701,6850,0,1,6852,5980050
168,6850,7000,5500,38500000,2,54806,13703,1,993000000,993000000,20551,6850,13701,6850,0,1,6852,5976367
168,6850,7000,5500,38500000,2,54806,13703,1,993000000,993000000,20551,6850,13701,6850,0,1,6852,5978260
168,6850,7000,5500,38500000,2,54806,13703,1,993000000,993000000,20551,6850,13701,6850,0,1,6852,5816716
168,6850,7000,5500,38500000,2,54806,13703,1,993000000,993000000,20551,6850,13701,6850,0,1,6852,5822376

168,50,7000,5100,35700000,2,406,103,1,290440000,290440000,151,50,101,50,0,1,52,389518
168,50,7000,5100,35700000,2,406,103,1,290440000,290440000,151,50,101,50,0,1,52,362277
168,50,7000,5100,35700000,2,406,103,1,290440000,290440000,151,50,101,50,0,1,52,368080
168,50,7000,5100,35700000,2,406,103,1,290440000,290440000,151,50,101,50,0,1,52,320642
168,50,7000,5100,35700000,2,406,103,1,290440000,290440000,151,50,101,50,0,1,52,368935
168,50,7000,5100,35700000,2,406,103,1,290440000,290440000,151,50,101,50,0,1,52,376057
168,50,7000,5100,35700000,2,406,103,1,290440000,290440000,151,50,101,50,0,1,52,376435

168,450,7000,5100,35700000,2,3606,903,1,329160000,329160000,1351,450,901,450,0,1,452,3640137
168,450,7000,5100,35700000,2,3606,903,1,329160000,329160000,1351,450,901,450,0,1,452,696524
168,450,7000,5100,35700000,2,3606,903,1,329160000,329160000,1351,450,901,450,0,1,452,691889
168,450,7000,5100,35700000,2,3606,903,1,329160000,329160000,1351,450,901,450,0,1,452,693412
168,450,7000,5100,35700000,2,3606,903,1,329160000,329160000,1351,450,901,450,0,1,452,694076
168,450,7000,5100,35700000,2,3606,903,1,329160000,329160000,1351,450,901,450,0,1,452,697576
168,450,7000,5100,35700000,2,3606,903,1,329160000,329160000,1351,450,901,450,0,1,452,698020

168,850,7000,5100,35700000,2,6806,1703,1,367880000,367880000,2551,850,1701,850,0,1,852,7424827
168,850,7000,5100,35700000,2,6806,1703,1,367880000,367880000,2551,850,1701,850,0,1,852,970592
168,850,7000,5100,35700000,2,6806,1703,1,367880000,367880000,2551,850,1701,850,0,1,852,971322
168,850,7000,5100,35700000,2,6806,1703,1,367880000,367880000,2551,850,1701,850,0,1,852,970933
168,850,7000,5100,35700000,2,6806,1703,1,367880000,367880000,2551,850,1701,850,0,1,852,970098
168,850,7000,5100,35700000,2,6806,1703,1,367880000,367880000,2551,850,1701,850,0,1,852,964434
168,850,7000,5100,35700000,2,6806,1703,1,367880000,367880000,2551,850,1701,850,0,1,852,967489

168,1250,7000,5100,35700000,2,10006,2503,1,406600000,406600000,3751,1250,2501,1250,0,1,1252,11480549
168,1250,7000,5100,35700000,2,10006,2503,1,406600000,406600000,3751,1250,2501,1250,0,1,1252,1253693
168,1250,7000,5100,35700000,2,10006,2503,1,406600000,406600000,3751,1250,2501,1250,0,1,1252,1252431
168,1250,7000,5100,35700000,2,10006,2503,1,406600000,406600000,3751,1250,2501,1250,0,1,1252,1254817
168,1250,7000,5100,35700000,2,10006,2503,1,406600000,406600000,3751,1250,2501,1250,0,1,1252,1254332
168,1250,7000,5100,35700000,2,10006,2503,1,406600000,406600000,3751,1250,2501,1250,0,1,1252,1244826
168,1250,7000,5100,35700000,2,10006,2503,1,406600000,406600000,3751,1250,2501,1250,0,1,1252,1245682

168,1650,7000,5100,35700000,2,13206,3303,1,445320000,445320000,4951,1650,3301,1650,0,1,1652,16097878
168,1650,7000,5100,35700000,2,13206,3303,1,445320000,445320000,4951,1650,3301,1650,0,1,1652,1579489
168,1650,7000,5100,35700000,2,13206,3303,1,445320000,445320000,4951,1650,3301,1650,0,1,1652,1577066
168,1650,7000,5100,35700000,2,13206,3303,1,445320000,445320000,4951,1650,3301,1650,0,1,1652,1578915
168,1650,7000,5100,35700000,2,13206,3303,1,445320000,445320000,4951,1650,3301,1650,0,1,1652,1578168
168,1650,7000,5100,35700000,2,13206,3303,1,445320000,445320000,4951,1650,3301,1650,0,1,1652,1539480
168,1650,7000,5100,35700000,2,13206,3303,1,445320000,445320000,4951,1650,3301,1650,0,1,1652,1540694

168,2050,7000,5100,35700000,2,16406,4103,1,484040000,484040000,6151,2050,4101,2050,0,1,2052,19917122
168,2050,7000,5100,35700000,2,16406,4103,1,484040000,484040000,6151,2050,4101,2050,0,1,2052,1894069
168,2050,7000,5100,35700000,2,16406,4103,1,484040000,484040000,6151,2050,4101,2050,0,1,2052,1886352
168,2050,7000,5100,35700000,2,16406,4103,1,484040000,484040000,6151,2050,4101,2050,0,1,2052,1892186
168,2050,7000,5100,35700000,2,16406,4103,1,484040000,484040000,6151,2050,4101,2050,0,1,2052,1893128
168,2050,7000,5100,35700000,2,16406,4103,1,484040000,484040000,6151,2050,4101,2050,0,1,2052,1884550
168,2050,7000,5100,35700000,2,16406,4103,1,484040000,484040000,6151,2050,4101,2050,0,1,2052,1886821

168,2450,7000,5100,35700000,2,19606,4903,1,522760000,522760000,7351,2450,4901,2450,0,1,2452,23864759
168,2450,7000,5100,35700000,2,19606,4903,1,522760000,522760000,7351,2450,4901,2450,0,1,2452,2168651
168,2450,7000,5100,35700000,2,19606,4903,1,522760000,522760000,7351,2450,4901,2450,0,1,2452,2162912
168,2450,7000,5100,35700000,2,19606,4903,1,522760000,522760000,7351,2450,4901,2450,0,1,2452,2167750
168,2450,7000,5100,35700000,2,19606,4903,1,522760000,522760000,7351,2450,4901,2450,0,1,2452,2169464
168,2450,7000,5100,35700000,2,19606,4903,1,522760000,522760000,7351,2450,4901,2450,0,1,2452,2139947
168,2450,7000,5100,35700000,2,19606,4903,1,522760000,522760000,7351,2450,4901,2450,0,1,2452,2141451

168,2850,7000,5100,35700000,2,22806,5703,1,561480000,561480000,8551,2850,5701,2850,0,1,2852,28004150
168,2850,7000,5100,35700000,2,22806,5703,1,561480000,561480000,8551,2850,5701,2850,0,1,2852,2526828
168,2850,7000,5100,35700000,2,22806,5703,1,561480000,561480000,8551,2850,5701,2850,0,1,2852,2508985
168,2850,7000,5100,35700000,2,22806,5703,1,561480000,561480000,8551,2850,5701,2850,0,1,2852,2524499
168,2850,7000,5100,35700000,2,22806,5703,1,561480000,561480000,8551,2850,5701,2850,0,1,2852,2521908
168,2850,7000,5100,35700000,2,22806,5703,1,561480000,561480000,8551,2850,5701,2850,0,1,2852,2488440
168,2850,7000,5100,35700000,2,22806,5703,1,561480000,561480000,8551,2850,5701,2850,0,1,2852,2486460

168,3250,7000,5100,35700000,2,26006,6503,1,600200000,600200000,9751,3250,6501,3250,0,1,3252,32539410
168,3250,7000,5100,35700000,2,26006,6503,1,600200000,600200000,9751,3250,6501,3250,0,1,3252,2849470
168,3250,7000,5100,35700000,2,26006,6503,1,600200000,600200000,9751,3250,6501,3250,0,1,3252,2853294
168,3250,7000,5100,35700000,2,26006,6503,1,600200000,600200000,9751,3250,6501,3250,0,1,3252,2842421
168,3250,7000,5100,35700000,2,26006,6503,1,600200000,600200000,9751,3250,6501,3250,0,1,3252,2855723
168,3250,7000,5100,35700000,2,26006,6503,1,600200000,600200000,9751,3250,6501,3250,0,1,3252,2781781
168,3250,7000,5100,35700000,2,26006,6503,1,600200000,600200000,9751,3250,6501,3250,0,1,3252,2784012

168,3650,7000,5100,35700000,2,29206,7303,1,638920000,638920000,10951,3650,7301,3650,0,1,3652,37325209
168,3650,7000,5100,35700000,2,29206,7303,1,638920000,638920000,10951,3650,7301,3650,0,1,3652,3144183
168,3650,7000,5100,35700000,2,29206,7303,1,638920000,638920000,10951,3650,7301,3650,0,1,3652,3132378
168,3650,7000,5100,35700000,2,29206,7303,1,638920000,638920000,10951,3650,7301,3650,0,1,3652,3140239
168,3650,7000,5100,35700000,2,29206,7303,1,638920000,638920000,10951,3650,7301,3650,0,1,3652,3141557
168,3650,7000,5100,35700000,2,29206,7303,1,638920000,638920000,10951,3650,7301,3650,0,1,3652,3062612
168,3650,7000,5100,35700000,2,29206,7303,1,638920000,638920000,10951,3650,7301,3650,0,1,3652,3065057

168,4050,7000,5100,35700000,2,32406,8103,1,677640000,677640000,12151,4050,8101,4050,0,1,4052,42156186
168,4050,7000,5100,35700000,2,32406,8103,1,677640000,677640000,12151,4050,8101,4050,0,1,4052,3485275
168,4050,7000,5100,35700000,2,32406,8103,1,677640000,677640000,12151,4050,8101,4050,0,1,4052,3476425
168,4050,7000,5100,35700000,2,32406,8103,1,677640000,677640000,12151,4050,8101,4050,0,1,4052,3469245
168,4050,7000,5100,35700000,2,32406,8103,1,677640000,677640000,12151,4050,8101,4050,0,1,4052,3482523
168,4050,7000,5100,35700000,2,32406,8103,1,677640000,677640000,12151,4050,8101,4050,0,1,4052,3354134
168,4050,7000,5100,35700000,2,32406,8103,1,677640000,677640000,12151,4050,8101,4050,0,1,4052,3351447

168,4450,7000,5100,35700000,2,35606,8903,1,716360000,716360000,13351,4450,8901,4450,0,1,4452,44352683
168,4450,7000,5100,35700000,2,35606,8903,1,716360000,716360000,13351,4450,8901,4450,0,1,4452,3781636
168,4450,7000,5100,35700000,2,35606,8903,1,716360000,716360000,13351,4450,8901,4450,0,1,4452,3780044
168,4450,7000,5100,35700000,2,35606,8903,1,716360000,716360000,13351,4450,8901,4450,0,1,4452,3777599
168,4450,7000,5100,35700000,2,35606,8903,1,716360000,716360000,13351,4450,8901,4450,0,1,4452,3783180
168,4450,7000,5100,35700000,2,35606,8903,1,716360000,716360000,13351,4450,8901,4450,0,1,4452,3658747
168,4450,7000,5100,35700000,2,35606,8903,1,716360000,716360000,13351,4450,8901,4450,0,1,4452,3660886

168,4850,7000,5100,35700000,2,38806,9703,1,755080000,755080000,14551,4850,9701,4850,0,1,4852,51011902
168,4850,7000,5100,35700000,2,38806,9703,1,755080000,755080000,14551,4850,9701,4850,0,1,4852,4059893
168,4850,7000,5100,35700000,2,38806,9703,1,755080000,755080000,14551,4850,9701,4850,0,1,4852,4065330
168,4850,7000,5100,35700000,2,38806,9703,1,755080000,755080000,14551,4850,9701,4850,0,1,4852,4057301
168,4850,7000,5100,35700000,2,38806,9703,1,755080000,755080000,14551,4850,9701,4850,0,1,4852,4063713
168,4850,7000,5100,35700000,2,38806,9703,1,755080000,755080000,14551,4850,9701,4850,0,1,4852,3945408
168,4850,7000,5100,35700000,2,38806,9703,1,755080000,755080000,14551,4850,9701,4850,0,1,4852,3942846

168,5250,7000,5100,35700000,2,42006,10503,1,793800000,793800000,15751,5250,10501,5250,0,1,5252,54598501
168,5250,7000,5100,35700000,2,42006,10503,1,793800000,793800000,15751,5250,10501,5250,0,1,5252,4376491
168,5250,7000,5100,35700000,2,42006,10503,1,793800000,793800000,15751,5250,10501,5250,0,1,5252,4370709
168,5250,7000,5100,35700000,2,42006,10503,1,793800000,793800000,15751,5250,10501,5250,0,1,5252,4374594
168,5250,7000,5100,35700000,2,42006,10503,1,793800000,793800000,15751,5250,10501,5250,0,1,5252,4372013
168,5250,7000,5100,35700000,2,42006,10503,1,793800000,793800000,15751,5250,10501,5250,0,1,5252,4206907
168,5250,7000,5100,35700000,2,42006,10503,1,793800000,793800000,15751,5250,10501,5250,0,1,5252,4246282

168,5650,7000,5100,35700000,2,45206,11303,1,832520000,832520000,16951,5650,11301,5650,0,1,5652,59268184
168,5650,7000,5100,35700000,2,45206,11303,1,832520000,832520000,16951,5650,11301,5650,0,1,5652,4635111
168,5650,7000,5100,35700000,2,45206,11303,1,832520000,832520000,16951,5650,11301,5650,0,1,5652,4655394
168,5650,7000,5100,35700000,2,45206,11303,1,832520000,832520000,16951,5650,11301,5650,0,1,5652,4653413
168,5650,7000,5100,35700000,2,45206,11303,1,832520000,832520000,16951,5650,11301,5650,0,1,5652,4650855
168,5650,7000,5100,35700000,2,45206,11303,1,832520000,832520000,16951,5650,11301,5650,0,1,5652,4480882
168,5650,7000,5100,35700000,2,45206,11303,1,832520000,832520000,16951,5650,11301,5650,0,1,5652,4521146

168,6050,7000,5100,35700000,2,48406,12103,1,871240000,871240000,18151,6050,12101,6050,0,1,6052,64076721
168,6050,7000,5100,35700000,2,48406,12103,1,871240000,871240000,18151,6050,12101,6050,0,1,6052,4948102
168,6050,7000,5100,35700000,2,48406,12103,1,871240000,871240000,18151,6050,12101,6050,0,1,6052,4951772
168,6050,7000,5100,35700000,2,48406,12103,1,871240000,871240000,18151,6050,12101,6050,0,1,6052,4949853
168,6050,7000,5100,35700000,2,48406,12103,1,871240000,871240000,18151,6050,12101,6050,0,1,6052,4938428
168,6050,7000,5100,35700000,2,48406,12103,1,871240000,871240000,18151,6050,12101,6050,0,1,6052,4813084
168,6050,7000,5100,35700000,2,48406,12103,1,871240000,871240000,18151,6050,12101,6050,0,1,6052,4810017

168,6450,7000,5100,35700000,2,51606,12903,1,909960000,909960000,19351,6450,12901,6450,0,1,6452,67743199
168,6450,7000,5100,35700000,2,51606,12903,1,909960000,909960000,19351,6450,12901,6450,0,1,6452,5292710
168,6450,7000,5100,35700000,2,51606,12903,1,909960000,909960000,19351,6450,12901,6450,0,1,6452,5283417
168,6450,7000,5100,35700000,2,51606,12903,1,909960000,909960000,19351,6450,12901,6450,0,1,6452,5286062
168,6450,7000,5100,35700000,2,51606,12903,1,909960000,909960000,19351,6450,12901,6450,0,1,6452,5290695
168,6450,7000,5100,35700000,2,51606,12903,1,909960000,909960000,19351,6450,12901,6450,0,1,6452,5111595
168,6450,7000,5100,35700000,2,51606,12903,1,909960000,909960000,19351,6450,12901,6450,0,1,6452,5115275

168,6850,7000,5100,35700000,2,54806,13703,1,948680000,948680000,20551,6850,13701,6850,0,1,6852,72409291
168,6850,7000,5100,35700000,2,54806,13703,1,948680000,948680000,20551,6850,13701,6850,0,1,6852,5609071
168,6850,7000,5100,35700000,2,54806,13703,1,948680000,948680000,20551,6850,13701,6850,0,1,6852,5605312
168,6850,7000,5100,35700000,2,54806,13703,1,948680000,948680000,20551,6850,13701,6850,0,1,6852,5610984
168,6850,7000,5100,35700000,2,54806,13703,1,948680000,948680000,20551,6850,13701,6850,0,1,6852,5613109
168,6850,7000,5100,35700000,2,54806,13703,1,948680000,948680000,20551,6850,13701,6850,0,1,6852,5445703
168,6850,7000,5100,35700000,2,54806,13703,1,948680000,948680000,20551,6850,13701,6850,0,1,6852,5448732

168,50,7000,4700,32900000,2,406,103,1,267880000,267880000,151,50,101,50,0,1,52,356838
168,50,7000,4700,32900000,2,406,103,1,267880000,267880000,151,50,101,50,0,1,52,404979
168,50,7000,4700,32900000,2,406,103,1,267880000,267880000,151,50,101,50,0,1,52,405409
168,50,7000,4700,32900000,2,406,103,1,267880000,267880000,151,50,101,50,0,1,52,398672
168,50,7000,4700,32900000,2,406,103,1,267880000,267880000,151,50,101,50,0,1,52,380479
168,50,7000,4700,32900000,2,406,103,1,267880000,267880000,151,50,101,50,0,1,52,394452
168,50,7000,4700,32900000,2,406,103,1,267880000,267880000,151,50,101,50,0,1,52,395092

168,450,7000,4700,32900000,2,3606,903,1,305320000,305320000,1351,450,901,450,0,1,452,3275926
168,450,7000,4700,32900000,2,3606,903,1,305320000,305320000,1351,450,901,450,0,1,452,624184
168,450,7000,4700,32900000,2,3606,903,1,305320000,305320000,1351,450,901,450,0,1,452,626146
168,450,7000,4700,32900000,2,3606,903,1,305320000,305320000,1351,450,901,450,0,1,452,626949
168,450,7000,4700,32900000,2,3606,903,1,305320000,305320000,1351,450,901,450,0,1,452,627976
168,450,7000,4700,32900000,2,3606,903,1,305320000,305320000,1351,450,901,450,0,1,452,640732
168,450,7000,4700,32900000,2,3606,903,1,305320000,305320000,1351,450,901,450,0,1,452,640293

168,850,7000,4700,32900000,2,6806,1703,1,342760000,342760000,2551,850,1701,850,0,1,852,6805120
168,850,7000,4700,32900000,2,6806,1703,1,342760000,342760000,2551,850,1701,850,0,1,852,897718
168,850,7000,4700,32900000,2,6806,1703,1,342760000,342760000,2551,850,1701,850,0,1,852,896406
168,850,7000,4700,32900000,2,6806,1703,1,342760000,342760000,2551,850,1701,850,0,1,852,894932
168,850,7000,4700,32900000,2,6806,1703,1,342760000,342760000,2551,850,1701,850,0,1,852,897336
168,850,7000,4700,32900000,2,6806,1703,1,342760000,342760000,2551,850,1701,850,0,1,852,898311
168,850,7000,4700,32900000,2,6806,1703,1,342760000,342760000,2551,850,1701,850,0,1,852,898818

168,1250,7000,4700,32900000,2,10006,2503,1,380200000,380200000,3751,1250,2501,1250,0,1,1252,10799212
168,1250,7000,4700,32900000,2,10006,2503,1,380200000,380200000,3751,1250,2501,1250,0,1,1252,1177735
168,1250,7000,4700,32900000,2,10006,2503,1,380200000,380200000,3751,1250,2501,1250,0,1,1252,1175562
168,1250,7000,4700,32900000,2,10006,2503,1,380200000,380200000,3751,1250,2501,1250,0,1,1252,1176613
168,1250,7000,4700,32900000,2,10006,2503,1,380200000,380200000,3751,1250,2501,1250,0,1,1252,1177246
168,1250,7000,4700,32900000,2,10006,2503,1,380200000,380200000,3751,1250,2501,1250,0,1,1252,1161742
168,1250,7000,4700,32900000,2,10006,2503,1,380200000,380200000,3751,1250,2501,1250,0,1,1252,1162788

168,1650,7000,4700,32900000,2,13206,3303,1,417640000,417640000,4951,1650,3301,1650,0,1,1652,14577622
168,1650,7000,4700,32900000,2,13206,3303,1,417640000,417640000,4951,1650,3301,1650,0,1,1652,1464354
168,1650,7000,4700,32900000,2,13206,3303,1,417640000,417640000,4951,1650,3301,1650,0,1,1652,1462497
168,1650,7000,4700,32900000,2,13206,3303,1,417640000,417640000,4951,1650,3301,1650,0,1,1652,1463591
168,1650,7000,4700,32900000,2,13206,3303,1,417640000,417640000,4951,1650,3301,1650,0,1,1652,1464969
168,1650,7000,4700,32900000,2,13206,3303,1,417640000,417640000,4951,1650,3301,1650,0,1,1652,1429858
168,1650,7000,4700,32900000,2,13206,3303,1,417640000,417640000,4951,1650,3301,1650,0,1,1652,1431016

168,2050,7000,4700,32900000,2,16406,4103,1,455080000,455080000,6151,2050,4101,2050,0,1,2052,18801091
168,2050,7000,4700,32900000,2,16406,4103,1,455080000,455080000,6151,2050,4101,2050,0,1,2052,1766427
168,2050,7000,4700,32900000,2,16406,4103,1,455080000,455080000,6151,2050,4101,2050,0,1,2052,1768720
168,2050,7000,4700,32900000,2,16406,4103,1,455080000,455080000,6151,2050,4101,2050,0,1,2052,1769682
168,2050,7000,4700,32900000,2,16406,4103,1,455080000,455080000,6151,2050,4101,2050,0,1,2052,1770606
168,2050,7000,4700,32900000,2,16406,4103,1,455080000,455080000,6151,2050,4101,2050,0,1,2052,1750262
168,2050,7000,4700,32900000,2,16406,4103,1,455080000,455080000,6151,2050,4101,2050,0,1,2052,1761865

168,2450,7000,4700,32900000,2,19606,4903,1,492520000,492520000,7351,2450,4901,2450,0,1,2452,21880778
168,2450,7000,4700,32900000,2,19606,4903,1,492520000,492520000,7351,2450,4901,2450,0,1,2452,2026792
168,2450,7000,4700,32900000,2,19606,4903,1,492520000,492520000,7351,2450,4901,2450,0,1,2452,2029104
168,2450,7000,4700,32900000,2,19606,4903,1,492520000,492520000,7351,2450,4901,2450,0,1,2452,2028293
168,2450,7000,4700,32900000,2,19606,4903,1,492520000,492520000,7351,2450,4901,2450,0,1,2452,2030140
168,2450,7000,4700,32900000,2,19606,4903,1,492520000,492520000,7351,2450,4901,2450,0,1,2452,1996098
168,2450,7000,4700,32900000,2,19606,4903,1,492520000,492520000,7351,2450,4901,2450,0,1,2452,1997535

168,2850,7000,4700,32900000,2,22806,5703,1,529960000,529960000,8551,2850,5701,2850,0,1,2852,25734866
168,2850,7000,4700,32900000,2,22806,5703,1,529960000,529960000,8551,2850,5701,2850,0,1,2852,2356375
168,2850,7000,4700,32900000,2,22806,5703,1,529960000,529960000,8551,2850,5701,2850,0,1,2852,2348793
168,2850,7000,4700,32900000,2,22806,5703,1,529960000,529960000,8551,2850,5701,2850,0,1,2852,2350660
168,2850,7000,4700,32900000,2,22806,5703,1,529960000,529960000,8551,2850,5701,2850,0,1,2852,2355274
168,2850,7000,4700,32900000,2,22806,5703,1,529960000,529960000,8551,2850,5701,2850,0,1,2852,2308941
168,2850,7000,4700,32900000,2,22806,5703,1,529960000,529960000,8551,2850,5701,2850,0,1,2852,2313248

168,3250,7000,4700,32900000,2,26006,6503,1,567400000,567400000,9751,3250,6501,3250,0,1,3252,30021872
168,3250,7000,4700,32900000,2,26006,6503,1,567400000,567400000,9751,3250,6501,3250,0,1,3252,2659812
168,3250,7000,4700,32900000,2,26006,6503,1,567400000,567400000,9751,3250,6501,3250,0,1,3252,2653969
168,3250,7000,4700,32900000,2,26006,6503,1,567400000,567400000,9751,3250,6501,3250,0,1,3252,2656192
168,3250,7000,4700,32900000,2,26006,6503,1,567400000,567400000,9751,3250,6501,3250,0,1,3252,2658607
168,3250,7000,4700,32900000,2,26006,6503,1,567400000,567400000,9751,3250,6501,3250,0,1,3252,2602452
168,3250,7000,4700,32900000,2,26006,6503,1,567400000,567400000,9751,3250,6501,3250,0,1,3252,2604507

168,3650,7000,4700,32900000,2,29206,7303,1,604840000,604840000,10951,3650,7301,3650,0,1,3652,34461025
168,3650,7000,4700,32900000,2,29206,7303,1,604840000,604840000,10951,3650,7301,3650,0,1,3652,2936172
168,3650,7000,4700,32900000,2,29206,7303,1,604840000,604840000,10951,3650,7301,3650,0,1,3652,2938168
168,3650,7000,4700,32900000,2,29206,7303,1,604840000,604840000,10951,3650,7301,3650,0,1,3652,2939587
168,3650,7000,4700,32900000,2,29206,7303,1,604840000,604840000,10951,3650,7301,3650,0,1,3652,2940937
168,3650,7000,4700,32900000,2,29206,7303,1,604840000,604840000,10951,3650,7301,3650,0,1,3652,2859881
168,3650,7000,4700,32900000,2,29206,7303,1,604840000,604840000,10951,3650,7301,3650,0,1,3652,2857944

168,4050,7000,4700,32900000,2,32406,8103,1,642280000,642280000,12151,4050,8101,4050,0,1,4052,37498594
168,4050,7000,4700,32900000,2,32406,8103,1,642280000,642280000,12151,4050,8101,4050,0,1,4052,3181076
168,4050,7000,4700,32900000,2,32406,8103,1,642280000,642280000,12151,4050,8101,4050,0,1,4052,3177100
168,4050,7000,4700,32900000,2,32406,8103,1,642280000,642280000,12151,4050,8101,4050,0,1,4052,3179847
168,4050,7000,4700,32900000,2,32406,8103,1,642280000,642280000,12151,4050,8101,4050,0,1,4052,3182297
168,4050,7000,4700,32900000,2,32406,8103,1,642280000,642280000,12151,4050,8101,4050,0,1,4052,3092190
168,4050,7000,4700,32900000,2,32406,8103,1,642280000,642280000,12151,4050,8101,4050,0,1,4052,3094198

168,4450,7000,4700,32900000,2,35606,8903,1,679720000,679720000,13351,4450,8901,4450,0,1,4452,42642869
168,4450,7000,4700,32900000,2,35606,8903,1,679720000,679720000,13351,4450,8901,4450,0,1,4452,3489819
168,4450,7000,4700,32900000,2,35606,8903,1,679720000,679720000,13351,4450,8901,4450,0,1,4452,3495111
168,4450,7000,4700,32900000,2,35606,8903,1,679720000,679720000,13351,4450,8901,4450,0,1,4452,3497504
168,4450,7000,4700,32900000,2,35606,8903,1,679720000,679720000,13351,4450,8901,4450,0,1,4452,3499043
168,4450,7000,4700,32900000,2,35606,8903,1,679720000,679720000,13351,4450,8901,4450,0,1,4452,3373859
168,4450,7000,4700,32900000,2,35606,8903,1,679720000,679720000,13351,4450,8901,4450,0,1,4452,3376146

168,4850,7000,4700,32900000,2,38806,9703,1,717160000,717160000,14551,4850,9701,4850,0,1,4852,46483349
168,4850,7000,4700,32900000,2,38806,9703,1,717160000,717160000,14551,4850,9701,4850,0,1,4852,3730079
168,4850,7000,4700,32900000,2,38806,9703,1,717160000,717160000,14551,4850,9701,4850,0,1,4852,3727510
168,4850,7000,4700,32900000,2,38806,9703,1,717160000,717160000,14551,4850,9701,4850,0,1,4852,3731761
168,4850,7000,4700,32900000,2,38806,9703,1,717160000,717160000,14551,4850,9701,4850,0,1,4852,3733411
168,4850,7000,4700,32900000,2,38806,9703,1,717160000,717160000,14551,4850,9701,4850,0,1,4852,3633530
168,4850,7000,4700,32900000,2,38806,9703,1,717160000,717160000,14551,4850,9701,4850,0,1,4852,3635491

168,5250,7000,4700,32900000,2,42006,10503,1,754600000,754600000,15751,5250,10501,5250,0,1,5252,51856029
168,5250,7000,4700,32900000,2,42006,10503,1,754600000,754600000,15751,5250,10501,5250,0,1,5252,4043410
168,5250,7000,4700,32900000,2,42006,10503,1,754600000,754600000,15751,5250,10501,5250,0,1,5252,4041944
168,5250,7000,4700,32900000,2,42006,10503,1,754600000,754600000,15751,5250,10501,5250,0,1,5252,4037138
168,5250,7000,4700,32900000,2,42006,10503,1,754600000,754600000,15751,5250,10501,5250,0,1,5252,4040484
168,5250,7000,4700,32900000,2,42006,10503,1,754600000,754600000,15751,5250,10501,5250,0,1,5252,3943460
168,5250,7000,4700,32900000,2,42006,10503,1,754600000,754600000,15751,5250,10501,5250,0,1,5252,3945753

168,5650,7000,4700,32900000,2,45206,11303,1,792040000,792040000,16951,5650,11301,5650,0,1,5652,54665200
168,5650,7000,4700,32900000,2,45206,11303,1,792040000,792040000,16951,5650,11301,5650,0,1,5652,4353270
168,5650,7000,4700,32900000,2,45206,11303,1,792040000,792040000,16951,5650,11301,5650,0,1,5652,4350078
168,5650,7000,4700,32900000,2,45206,11303,1,792040000,792040000,16951,5650,11301,5650,0,1,5652,4354948
168,5650,7000,4700,32900000,2,45206,11303,1,792040000,792040000,16951,5650,11301,5650,0,1,5652,4356780
168,5650,7000,4700,32900000,2,45206,11303,1,792040000,792040000,16951,5650,11301,5650,0,1,5652,4212941
168,5650,7000,4700,32900000,2,45206,11303,1,792040000,792040000,16951,5650,11301,5650,0,1,5652,4210458

168,6050,7000,4700,32900000,2,48406,12103,1,829480000,829480000,18151,6050,12101,6050,0,1,6052,57715328
168,6050,7000,4700,32900000,2,48406,12103,1,829480000,829480000,18151,6050,12101,6050,0,1,6052,4651323
168,6050,7000,4700,32900000,2,48406,12103,1,829480000,829480000,18151,6050,12101,6050,0,1,6052,4653213
168,6050,7000,4700,32900000,2,48406,12103,1,829480000,829480000,18151,6050,12101,6050,0,1,6052,4649398
168,6050,7000,4700,32900000,2,48406,12103,1,829480000,829480000,18151,6050,12101,6050,0,1,6052,4646553
168,6050,7000,4700,32900000,2,48406,12103,1,829480000,829480000,18151,6050,12101,6050,0,1,6052,4521361
168,6050,7000,4700,32900000,2,48406,12103,1,829480000,829480000,18151,6050,12101,6050,0,1,6052,4518654

168,6450,7000,4700,32900000,2,51606,12903,1,866920000,866920000,19351,6450,12901,6450,0,1,6452,61307339
168,6450,7000,4700,32900000,2,51606,12903,1,866920000,866920000,19351,6450,12901,6450,0,1,6452,4892990
168,6450,7000,4700,32900000,2,51606,12903,1,866920000,866920000,19351,6450,12901,6450,0,1,6452,4891160
168,6450,7000,4700,32900000,2,51606,12903,1,866920000,866920000,19351,6450,12901,6450,0,1,6452,4899391
168,6450,7000,4700,32900000,2,51606,12903,1,866920000,866920000,19351,6450,12901,6450,0,1,6452,4897375
168,6450,7000,4700,32900000,2,51606,12903,1,866920000,866920000,19351,6450,12901,6450,0,1,6452,4736808
168,6450,7000,4700,32900000,2,51606,12903,1,866920000,866920000,19351,6450,12901,6450,0,1,6452,4740081

168,6850,7000,4700,32900000,2,54806,13703,1,904360000,904360000,20551,6850,13701,6850,0,1,6852,66705496
168,6850,7000,4700,32900000,2,54806,13703,1,904360000,904360000,20551,6850,13701,6850,0,1,6852,5181089
168,6850,7000,4700,32900000,2,54806,13703,1,904360000,904360000,20551,6850,13701,6850,0,1,6852,5184980
168,6850,7000,4700,32900000,2,54806,13703,1,904360000,904360000,20551,6850,13701,6850,0,1,6852,5183005
168,6850,7000,4700,32900000,2,54806,13703,1,904360000,904360000,20551,6850,13701,6850,0,1,6852,5169720
168,6850,7000,4700,32900000,2,54806,13703,1,904360000,904360000,20551,6850,13701,6850,0,1,6852,5038057
168,6850,7000,4700,32900000,2,54806,13703,1,904360000,904360000,20551,6850,13701,6850,0,1,6852,5044148

168,50,7000,4300,30100000,2,406,103,1,245320000,245320000,151,50,101,50,0,1,52,322265
168,50,7000,4300,30100000,2,406,103,1,245320000,245320000,151,50,101,50,0,1,52,280172
168,50,7000,4300,30100000,2,406,103,1,245320000,245320000,151,50,101,50,0,1,52,279359
168,50,7000,4300,30100000,2,406,103,1,245320000,245320000,151,50,101,50,0,1,52,276963
168,50,7000,4300,30100000,2,406,103,1,245320000,245320000,151,50,101,50,0,1,52,260560
168,50,7000,4300,30100000,2,406,103,1,245320000,245320000,151,50,101,50,0,1,52,310176
168,50,7000,4300,30100000,2,406,103,1,245320000,245320000,151,50,101,50,0,1,52,310553

168,450,7000,4300,30100000,2,3606,903,1,281480000,281480000,1351,450,901,450,0,1,452,2944046
168,450,7000,4300,30100000,2,3606,903,1,281480000,281480000,1351,450,901,450,0,1,452,576111
168,450,7000,4300,30100000,2,3606,903,1,281480000,281480000,1351,450,901,450,0,1,452,579937
168,450,7000,4300,30100000,2,3606,903,1,281480000,281480000,1351,450,901,450,0,1,452,576906
168,450,7000,4300,30100000,2,3606,903,1,281480000,281480000,1351,450,901,450,0,1,452,579016
168,450,7000,4300,30100000,2,3606,903,1,281480000,281480000,1351,450,901,450,0,1,452,589797
168,450,7000,4300,30100000,2,3606,903,1,281480000,281480000,1351,450,901,450,0,1,452,590241

168,850,7000,4300,30100000,2,6806,1703,1,317640000,317640000,2551,850,1701,850,0,1,852,6109616
168,850,7000,4300,30100000,2,6806,1703,1,317640000,317640000,2551,850,1701,850,0,1,852,815312
168,850,7000,4300,30100000,2,6806,1703,1,317640000,317640000,2551,850,1701,850,0,1,852,813890
168,850,7000,4300,30100000,2,6806,1703,1,317640000,317640000,2551,850,1701,850,0,1,852,814892
168,850,7000,4300,30100000,2,6806,1703,1,317640000,317640000,2551,850,1701,850,0,1,852,811873
168,850,7000,4300,30100000,2,6806,1703,1,317640000,317640000,2551,850,1701,850,0,1,852,818765
168,850,7000,4300,30100000,2,6806,1703,1,317640000,317640000,2551,850,1701,850,0,1,852,819266

168,1250,7000,4300,30100000,2,10006,2503,1,353800000,353800000,3751,1250,2501,1250,0,1,1252,9746346
168,1250,7000,4300,30100000,2,10006,2503,1,353800000,353800000,3751,1250,2501,1250,0,1,1252,1058281
168,1250,7000,4300,30100000,2,10006,2503,1,353800000,353800000,3751,1250,2501,1250,0,1,1252,1059573
168,1250,7000,4300,30100000,2,10006,2503,1,353800000,353800000,3751,1250,2501,1250,0,1,1252,1060582
168,1250,7000,4300,30100000,2,10006,2503,1,353800000,353800000,3751,1250,2501,1250,0,1,1252,1056811
168,1250,7000,4300,30100000,2,10006,2503,1,353800000,353800000,3751,1250,2501,1250,0,1,1252,1064834
168,1250,7000,4300,30100000,2,10006,2503,1,353800000,353800000,3751,1250,2501,1250,0,1,1252,1065409

168,1650,7000,4300,30100000,2,13206,3303,1,389960000,389960000,4951,1650,3301,1650,0,1,1652,13174581
168,1650,7000,4300,30100000,2,13206,3303,1,389960000,389960000,4951,1650,3301,1650,0,1,1652,1312970
168,1650,7000,4300,30100000,2,13206,3303,1,389960000,389960000,4951,1650,3301,1650,0,1,1652,1312132
168,1650,7000,4300,30100000,2,13206,3303,1,389960000,389960000,4951,1650,3301,1650,0,1,1652,1310545
168,1650,7000,4300,30100000,2,13206,3303,1,389960000,389960000,4951,1650,3301,1650,0,1,1652,1313830
168,1650,7000,4300,30100000,2,13206,3303,1,389960000,389960000,4951,1650,3301,1650,0,1,1652,1316940
168,1650,7000,4300,30100000,2,13206,3303,1,389960000,389960000,4951,1650,3301,1650,0,1,1652,1317585

168,2050,7000,4300,30100000,2,16406,4103,1,426120000,426120000,6151,2050,4101,2050,0,1,2052,16562410
168,2050,7000,4300,30100000,2,16406,4103,1,426120000,426120000,6151,2050,4101,2050,0,1,2052,1611528
168,2050,7000,4300,30100000,2,16406,4103,1,426120000,426120000,6151,2050,4101,2050,0,1,2052,1614011
168,2050,7000,4300,30100000,2,16406,4103,1,426120000,426120000,6151,2050,4101,2050,0,1,2052,1612927
168,2050,7000,4300,30100000,2,16406,4103,1,426120000,426120000,6151,2050,4101,2050,0,1,2052,1614936
168,2050,7000,4300,30100000,2,16406,4103,1,426120000,426120000,6151,2050,4101,2050,0,1,2052,1605844
168,2050,7000,4300,30100000,2,16406,4103,1,426120000,426120000,6151,2050,4101,2050,0,1,2052,1607803

168,2450,7000,4300,30100000,2,19606,4903,1,462280000,462280000,7351,2450,4901,2450,0,1,2452,21002332
168,2450,7000,4300,30100000,2,19606,4903,1,462280000,462280000,7351,2450,4901,2450,0,1,2452,1837388
168,2450,7000,4300,30100000,2,19606,4903,1,462280000,462280000,7351,2450,4901,2450,0,1,2452,1834486
168,2450,7000,4300,30100000,2,19606,4903,1,462280000,462280000,7351,2450,4901,2450,0,1,2452,1836611
168,2450,7000,4300,30100000,2,19606,4903,1,462280000,462280000,7351,2450,4901,2450,0,1,2452,1835709
168,2450,7000,4300,30100000,2,19606,4903,1,462280000,462280000,7351,2450,4901,2450,0,1,2452,1824056
168,2450,7000,4300,30100000,2,19606,4903,1,462280000,462280000,7351,2450,4901,2450,0,1,2452,1825414

168,2850,7000,4300,30100000,2,22806,5703,1,498440000,498440000,8551,2850,5701,2850,0,1,2852,24068590
168,2850,7000,4300,30100000,2,22806,5703,1,498440000,498440000,8551,2850,5701,2850,0,1,2852,2178985
168,2850,7000,4300,30100000,2,22806,5703,1,498440000,498440000,8551,2850,5701,2850,0,1,2852,2183237
168,2850,7000,4300,30100000,2,22806,5703,1,498440000,498440000,8551,2850,5701,2850,0,1,2852,2181044
168,2850,7000,4300,30100000,2,22806,5703,1,498440000,498440000,8551,2850,5701,2850,0,1,2852,2184363
168,2850,7000,4300,30100000,2,22806,5703,1,498440000,498440000,8551,2850,5701,2850,0,1,2852,2132456
168,2850,7000,4300,30100000,2,22806,5703,1,498440000,498440000,8551,2850,5701,2850,0,1,2852,2125147

168,3250,7000,4300,30100000,2,26006,6503,1,534600000,534600000,9751,3250,6501,3250,0,1,3252,26847273
168,3250,7000,4300,30100000,2,26006,6503,1,534600000,534600000,9751,3250,6501,3250,0,1,3252,2400758
168,3250,7000,4300,30100000,2,26006,6503,1,534600000,534600000,9751,3250,6501,3250,0,1,3252,2399069
168,3250,7000,4300,30100000,2,26006,6503,1,534600000,534600000,9751,3250,6501,3250,0,1,3252,2401714
168,3250,7000,4300,30100000,2,26006,6503,1,534600000,534600000,9751,3250,6501,3250,0,1,3252,2402965
168,3250,7000,4300,30100000,2,26006,6503,1,534600000,534600000,9751,3250,6501,3250,0,1,3252,2349864
168,3250,7000,4300,30100000,2,26006,6503,1,534600000,534600000,9751,3250,6501,3250,0,1,3252,2351613

168,3650,7000,4300,30100000,2,29206,7303,1,570760000,570760000,10951,3650,7301,3650,0,1,3652,30821550
168,3650,7000,4300,30100000,2,29206,7303,1,570760000,570760000,10951,3650,7301,3650,0,1,3652,2695027
168,3650,7000,4300,30100000,2,29206,7303,1,570760000,570760000,10951,3650,7301,3650,0,1,3652,2687056
168,3650,7000,4300,30100000,2,29206,7303,1,570760000,570760000,10951,3650,7301,3650,0,1,3652,2681290
168,3650,7000,4300,30100000,2,29206,7303,1,570760000,570760000,10951,3650,7301,3650,0,1,3652,2693703
168,3650,7000,4300,30100000,2,29206,7303,1,570760000,570760000,10951,3650,7301,3650,0,1,3652,2641557
168,3650,7000,4300,30100000,2,29206,7303,1,570760000,570760000,10951,3650,7301,3650,0,1,3652,2644196

168,4050,7000,4300,30100000,2,32406,8103,1,606920000,606920000,12151,4050,8101,4050,0,1,4052,34153355
168,4050,7000,4300,30100000,2,32406,8103,1,606920000,606920000,12151,4050,8101,4050,0,1,4052,2959650
168,4050,7000,4300,30100000,2,32406,8103,1,606920000,606920000,12151,4050,8101,4050,0,1,4052,2962416
168,4050,7000,4300,30100000,2,32406,8103,1,606920000,606920000,12151,4050,8101,4050,0,1,4052,2961000
168,4050,7000,4300,30100000,2,32406,8103,1,606920000,606920000,12151,4050,8101,4050,0,1,4052,2957060
168,4050,7000,4300,30100000,2,32406,8103,1,606920000,606920000,12151,4050,8101,4050,0,1,4052,2884018
168,4050,7000,4300,30100000,2,32406,8103,1,606920000,606920000,12151,4050,8101,4050,0,1,4052,2882046

168,4450,7000,4300,30100000,2,35606,8903,1,643080000,643080000,13351,4450,8901,4450,0,1,4452,38835264
168,4450,7000,4300,30100000,2,35606,8903,1,643080000,643080000,13351,4450,8901,4450,0,1,4452,3237287
168,4450,7000,4300,30100000,2,35606,8903,1,643080000,643080000,13351,4450,8901,4450,0,1,4452,3229365
168,4450,7000,4300,30100000,2,35606,8903,1,643080000,643080000,13351,4450,8901,4450,0,1,4452,3235783
168,4450,7000,4300,30100000,2,35606,8903,1,643080000,643080000,13351,4450,8901,4450,0,1,4452,3224590
168,4450,7000,4300,30100000,2,35606,8903,1,643080000,643080000,13351,4450,8901,4450,0,1,4452,3135968
168,4450,7000,4300,30100000,2,35606,8903,1,643080000,643080000,13351,4450,8901,4450,0,1,4452,3138609

168,4850,7000,4300,30100000,2,38806,9703,1,679240000,679240000,14551,4850,9701,4850,0,1,4852,42483628
168,4850,7000,4300,30100000,2,38806,9703,1,679240000,679240000,14551,4850,9701,4850,0,1,4852,3475605
168,4850,7000,4300,30100000,2,38806,9703,1,679240000,679240000,14551,4850,9701,4850,0,1,4852,3474002
168,4850,7000,4300,30100000,2,38806,9703,1,679240000,679240000,14551,4850,9701,4850,0,1,4852,3472472
168,4850,7000,4300,30100000,2,38806,9703,1,679240000,679240000,14551,4850,9701,4850,0,1,4852,3455300
168,4850,7000,4300,30100000,2,38806,9703,1,679240000,679240000,14551,4850,9701,4850,0,1,4852,3400481
168,4850,7000,4300,30100000,2,38806,9703,1,679240000,679240000,14551,4850,9701,4850,0,1,4852,3405352

168,5250,7000,4300,30100000,2,42006,10503,1,715400000,715400000,15751,5250,10501,5250,0,1,5252,44441798
168,5250,7000,4300,30100000,2,42006,10503,1,715400000,715400000,15751,5250,10501,5250,0,1,5252,3719931
168,5250,7000,4300,30100000,2,42006,10503,1,715400000,715400000,15751,5250,10501,5250,0,1,5252,3721569
168,5250,7000,4300,30100000,2,42006,10503,1,715400000,715400000,15751,5250,10501,5250,0,1,5252,3723032
168,5250,7000,4300,30100000,2,42006,10503,1,715400000,715400000,15751,5250,10501,5250,0,1,5252,3724491
168,5250,7000,4300,30100000,2,42006,10503,1,715400000,715400000,15751,5250,10501,5250,0,1,5252,3617698
168,5250,7000,4300,30100000,2,42006,10503,1,715400000,715400000,15751,5250,10501,5250,0,1,5252,3622097

168,5650,7000,4300,30100000,2,45206,11303,1,751560000,751560000,16951,5650,11301,5650,0,1,5652,49331261
168,5650,7000,4300,30100000,2,45206,11303,1,751560000,751560000,16951,5650,11301,5650,0,1,5652,4032076
168,5650,7000,4300,30100000,2,45206,11303,1,751560000,751560000,16951,5650,11301,5650,0,1,5652,4022944
168,5650,7000,4300,30100000,2,45206,11303,1,751560000,751560000,16951,5650,11301,5650,0,1,5652,4027534
168,5650,7000,4300,30100000,2,45206,11303,1,751560000,751560000,16951,5650,11301,5650,0,1,5652,4030095
168,5650,7000,4300,30100000,2,45206,11303,1,751560000,751560000,16951,5650,11301,5650,0,1,5652,3927040
168,5650,7000,4300,30100000,2,45206,11303,1,751560000,751560000,16951,5650,11301,5650,0,1,5652,3921191

168,6050,7000,4300,30100000,2,48406,12103,1,787720000,787720000,18151,6050,12101,6050,0,1,6052,53786180
168,6050,7000,4300,30100000,2,48406,12103,1,787720000,787720000,18151,6050,12101,6050,0,1,6052,4279790
168,6050,7000,4300,30100000,2,48406,12103,1,787720000,787720000,18151,6050,12101,6050,0,1,6052,4277190
168,6050,7000,4300,30100000,2,48406,12103,1,787720000,787720000,18151,6050,12101,6050,0,1,6052,4281865
168,6050,7000,4300,30100000,2,48406,12103,1,787720000,787720000,18151,6050,12101,6050,0,1,6052,4268884
168,6050,7000,4300,30100000,2,48406,12103,1,787720000,787720000,18151,6050,12101,6050,0,1,6052,4152912
168,6050,7000,4300,30100000,2,48406,12103,1,787720000,787720000,18151,6050,12101,6050,0,1,6052,4156101

168,6450,7000,4300,30100000,2,51606,12903,1,823880000,823880000,19351,6450,12901,6450,0,1,6452,56783713
168,6450,7000,4300,30100000,2,51606,12903,1,823880000,823880000,19351,6450,12901,6450,0,1,6452,4546997
168,6450,7000,4300,30100000,2,51606,12903,1,823880000,823880000,19351,6450,12901,6450,0,1,6452,4549443
168,6450,7000,4300,30100000,2,51606,12903,1,823880000,823880000,19351,6450,12901,6450,0,1,6452,4552448
168,6450,7000,4300,30100000,2,51606,12903,1,823880000,823880000,19351,6450,12901,6450,0,1,6452,4554470
168,6450,7000,4300,30100000,2,51606,12903,1,823880000,823880000,19351,6450,12901,6450,0,1,6452,4441596
168,6450,7000,4300,30100000,2,51606,12903,1,823880000,823880000,19351,6450,12901,6450,0,1,6452,4446672

168,6850,7000,4300,30100000,2,54806,13703,1,860040000,860040000,20551,6850,13701,6850,0,1,6852,61485192
168,6850,7000,4300,30100000,2,54806,13703,1,860040000,860040000,20551,6850,13701,6850,0,1,6852,4767946
168,6850,7000,4300,30100000,2,54806,13703,1,860040000,860040000,20551,6850,13701,6850,0,1,6852,4770041
168,6850,7000,4300,30100000,2,54806,13703,1,860040000,860040000,20551,6850,13701,6850,0,1,6852,4761440
168,6850,7000,4300,30100000,2,54806,13703,1,860040000,860040000,20551,6850,13701,6850,0,1,6852,4764467
168,6850,7000,4300,30100000,2,54806,13703,1,860040000,860040000,20551,6850,13701,6850,0,1,6852,4630554
168,6850,7000,4300,30100000,2,54806,13703,1,860040000,860040000,20551,6850,13701,6850,0,1,6852,4634247

168,50,7000,3900,27300000,2,406,103,1,222760000,222760000,151,50,101,50,0,1,52,280530
168,50,7000,3900,27300000,2,406,103,1,222760000,222760000,151,50,101,50,0,1,52,242271
168,50,7000,3900,27300000,2,406,103,1,222760000,222760000,151,50,101,50,0,1,52,211840
168,50,7000,3900,27300000,2,406,103,1,222760000,222760000,151,50,101,50,0,1,52,249117
168,50,7000,3900,27300000,2,406,103,1,222760000,222760000,151,50,101,50,0,1,52,249559
168,50,7000,3900,27300000,2,406,103,1,222760000,222760000,151,50,101,50,0,1,52,283085
168,50,7000,3900,27300000,2,406,103,1,222760000,222760000,151,50,101,50,0,1,52,283463

168,450,7000,3900,27300000,2,3606,903,1,257640000,257640000,1351,450,901,450,0,1,452,2595892
168,450,7000,3900,27300000,2,3606,903,1,257640000,257640000,1351,450,901,450,0,1,452,543341
168,450,7000,3900,27300000,2,3606,903,1,257640000,257640000,1351,450,901,450,0,1,452,516130
168,450,7000,3900,27300000,2,3606,903,1,257640000,257640000,1351,450,901,450,0,1,452,541393
168,450,7000,3900,27300000,2,3606,903,1,257640000,257640000,1351,450,901,450,0,1,452,540176
168,450,7000,3900,27300000,2,3606,903,1,257640000,257640000,1351,450,901,450,0,1,452,544490
168,450,7000,3900,27300000,2,3606,903,1,257640000,257640000,1351,450,901,450,0,1,452,544046

168,850,7000,3900,27300000,2,6806,1703,1,292520000,292520000,2551,850,1701,850,0,1,852,5510162
168,850,7000,3900,27300000,2,6806,1703,1,292520000,292520000,2551,850,1701,850,0,1,852,724318
168,850,7000,3900,27300000,2,6806,1703,1,292520000,292520000,2551,850,1701,850,0,1,852,726169
168,850,7000,3900,27300000,2,6806,1703,1,292520000,292520000,2551,850,1701,850,0,1,852,722350
168,850,7000,3900,27300000,2,6806,1703,1,292520000,292520000,2551,850,1701,850,0,1,852,725418
168,850,7000,3900,27300000,2,6806,1703,1,292520000,292520000,2551,850,1701,850,0,1,852,743460
168,850,7000,3900,27300000,2,6806,1703,1,292520000,292520000,2551,850,1701,850,0,1,852,743956

168,1250,7000,3900,27300000,2,10006,2503,1,327400000,327400000,3751,1250,2501,1250,0,1,1252,8820935
168,1250,7000,3900,27300000,2,10006,2503,1,327400000,327400000,3751,1250,2501,1250,0,1,1252,993863
168,1250,7000,3900,27300000,2,10006,2503,1,327400000,327400000,3751,1250,2501,1250,0,1,1252,993177
168,1250,7000,3900,27300000,2,10006,2503,1,327400000,327400000,3751,1250,2501,1250,0,1,1252,992345
168,1250,7000,3900,27300000,2,10006,2503,1,327400000,327400000,3751,1250,2501,1250,0,1,1252,990797
168,1250,7000,3900,27300000,2,10006,2503,1,327400000,327400000,3751,1250,2501,1250,0,1,1252,994512
168,1250,7000,3900,27300000,2,10006,2503,1,327400000,327400000,3751,1250,2501,1250,0,1,1252,995079

168,1650,7000,3900,27300000,2,13206,3303,1,362280000,362280000,4951,1650,3301,1650,0,1,1652,11437693
168,1650,7000,3900,27300000,2,13206,3303,1,362280000,362280000,4951,1650,3301,1650,0,1,1652,1190152
168,1650,7000,3900,27300000,2,13206,3303,1,362280000,362280000,4951,1650,3301,1650,0,1,1652,1192855
168,1650,7000,3900,27300000,2,13206,3303,1,362280000,362280000,4951,1650,3301,1650,0,1,1652,1187796
168,1650,7000,3900,27300000,2,13206,3303,1,362280000,362280000,4951,1650,3301,1650,0,1,1652,1191653
168,1650,7000,3900,27300000,2,13206,3303,1,362280000,362280000,4951,1650,3301,1650,0,1,1652,1201528
168,1650,7000,3900,27300000,2,13206,3303,1,362280000,362280000,4951,1650,3301,1650,0,1,1652,1202174

168,2050,7000,3900,27300000,2,16406,4103,1,397160000,397160000,6151,2050,4101,2050,0,1,2052,14858084
168,2050,7000,3900,27300000,2,16406,4103,1,397160000,397160000,6151,2050,4101,2050,0,1,2052,1494953
168,2050,7000,3900,27300000,2,16406,4103,1,397160000,397160000,6151,2050,4101,2050,0,1,2052,1495849
168,2050,7000,3900,27300000,2,16406,4103,1,397160000,397160000,6151,2050,4101,2050,0,1,2052,1491417
168,2050,7000,3900,27300000,2,16406,4103,1,397160000,397160000,6151,2050,4101,2050,0,1,2052,1484669
168,2050,7000,3900,27300000,2,16406,4103,1,397160000,397160000,6151,2050,4101,2050,0,1,2052,1492971
168,2050,7000,3900,27300000,2,16406,4103,1,397160000,397160000,6151,2050,4101,2050,0,1,2052,1493444

168,2450,7000,3900,27300000,2,19606,4903,1,432040000,432040000,7351,2450,4901,2450,0,1,2452,18434798
168,2450,7000,3900,27300000,2,19606,4903,1,432040000,432040000,7351,2450,4901,2450,0,1,2452,1682727
168,2450,7000,3900,27300000,2,19606,4903,1,432040000,432040000,7351,2450,4901,2450,0,1,2452,1680126
168,2450,7000,3900,27300000,2,19606,4903,1,432040000,432040000,7351,2450,4901,2450,0,1,2452,1683612
168,2450,7000,3900,27300000,2,19606,4903,1,432040000,432040000,7351,2450,4901,2450,0,1,2452,1682066
168,2450,7000,3900,27300000,2,19606,4903,1,432040000,432040000,7351,2450,4901,2450,0,1,2452,1684264
168,2450,7000,3900,27300000,2,19606,4903,1,432040000,432040000,7351,2450,4901,2450,0,1,2452,1685027

168,2850,7000,3900,27300000,2,22806,5703,1,466920000,466920000,8551,2850,5701,2850,0,1,2852,20884096
168,2850,7000,3900,27300000,2,22806,5703,1,466920000,466920000,8551,2850,5701,2850,0,1,2852,1958501
168,2850,7000,3900,27300000,2,22806,5703,1,466920000,466920000,8551,2850,5701,2850,0,1,2852,1957033
168,2850,7000,3900,27300000,2,22806,5703,1,466920000,466920000,8551,2850,5701,2850,0,1,2852,1952227
168,2850,7000,3900,27300000,2,22806,5703,1,466920000,466920000,8551,2850,5701,2850,0,1,2852,1959830
168,2850,7000,3900,27300000,2,22806,5703,1,466920000,466920000,8551,2850,5701,2850,0,1,2852,1944353
168,2850,7000,3900,27300000,2,22806,5703,1,466920000,466920000,8551,2850,5701,2850,0,1,2852,1942523

168,3250,7000,3900,27300000,2,26006,6503,1,501800000,501800000,9751,3250,6501,3250,0,1,3252,24021244
168,3250,7000,3900,27300000,2,26006,6503,1,501800000,501800000,9751,3250,6501,3250,0,1,3252,2156795
168,3250,7000,3900,27300000,2,26006,6503,1,501800000,501800000,9751,3250,6501,3250,0,1,3252,2154427
168,3250,7000,3900,27300000,2,26006,6503,1,501800000,501800000,9751,3250,6501,3250,0,1,3252,2157779
168,3250,7000,3900,27300000,2,26006,6503,1,501800000,501800000,9751,3250,6501,3250,0,1,3252,2155759
168,3250,7000,3900,27300000,2,26006,6503,1,501800000,501800000,9751,3250,6501,3250,0,1,3252,2139254
168,3250,7000,3900,27300000,2,26006,6503,1,501800000,501800000,9751,3250,6501,3250,0,1,3252,2140906

168,3650,7000,3900,27300000,2,29206,7303,1,536680000,536680000,10951,3650,7301,3650,0,1,3652,28281480
168,3650,7000,3900,27300000,2,29206,7303,1,536680000,536680000,10951,3650,7301,3650,0,1,3652,2488919
168,3650,7000,3900,27300000,2,29206,7303,1,536680000,536680000,10951,3650,7301,3650,0,1,3652,2487607
168,3650,7000,3900,27300000,2,29206,7303,1,536680000,536680000,10951,3650,7301,3650,0,1,3652,2480336
168,3650,7000,3900,27300000,2,29206,7303,1,536680000,536680000,10951,3650,7301,3650,0,1,3652,2490245
168,3650,7000,3900,27300000,2,29206,7303,1,536680000,536680000,10951,3650,7301,3650,0,1,3652,2418703
168,3650,7000,3900,27300000,2,29206,7303,1,536680000,536680000,10951,3650,7301,3650,0,1,3652,2420886

168,4050,7000,3900,27300000,2,32406,8103,1,571560000,571560000,12151,4050,8101,4050,0,1,4052,31006720
168,4050,7000,3900,27300000,2,32406,8103,1,571560000,571560000,12151,4050,8101,4050,0,1,4052,2715079
168,4050,7000,3900,27300000,2,32406,8103,1,571560000,571560000,12151,4050,8101,4050,0,1,4052,2716233
168,4050,7000,3900,27300000,2,32406,8103,1,571560000,571560000,12151,4050,8101,4050,0,1,4052,2713245
168,4050,7000,3900,27300000,2,32406,8103,1,571560000,571560000,12151,4050,8101,4050,0,1,4052,2717673
168,4050,7000,3900,27300000,2,32406,8103,1,571560000,571560000,12151,4050,8101,4050,0,1,4052,2600440
168,4050,7000,3900,27300000,2,32406,8103,1,571560000,571560000,12151,4050,8101,4050,0,1,4052,2634835

168,4450,7000,3900,27300000,2,35606,8903,1,606440000,606440000,13351,4450,8901,4450,0,1,4452,34368715
168,4450,7000,3900,27300000,2,35606,8903,1,606440000,606440000,13351,4450,8901,4450,0,1,4452,2942211
168,4450,7000,3900,27300000,2,35606,8903,1,606440000,606440000,13351,4450,8901,4450,0,1,4452,2939027
168,4450,7000,3900,27300000,2,35606,8903,1,606440000,606440000,13351,4450,8901,4450,0,1,4452,2937859
168,4450,7000,3900,27300000,2,35606,8903,1,606440000,606440000,13351,4450,8901,4450,0,1,4452,2943743
168,4450,7000,3900,27300000,2,35606,8903,1,606440000,606440000,13351,4450,8901,4450,0,1,4452,2895199
168,4450,7000,3900,27300000,2,35606,8903,1,606440000,606440000,13351,4450,8901,4450,0,1,4452,2873103

168,4850,7000,3900,27300000,2,38806,9703,1,641320000,641320000,14551,4850,9701,4850,0,1,4852,38446604
168,4850,7000,3900,27300000,2,38806,9703,1,641320000,641320000,14551,4850,9701,4850,0,1,4852,3201034
168,4850,7000,3900,27300000,2,38806,9703,1,641320000,641320000,14551,4850,9701,4850,0,1,4852,3197929
168,4850,7000,3900,27300000,2,38806,9703,1,641320000,641320000,14551,4850,9701,4850,0,1,4852,3203144
168,4850,7000,3900,27300000,2,38806,9703,1,641320000,641320000,14551,4850,9701,4850,0,1,4852,3204934
168,4850,7000,3900,27300000,2,38806,9703,1,641320000,641320000,14551,4850,9701,4850,0,1,4852,3130083
168,4850,7000,3900,27300000,2,38806,9703,1,641320000,641320000,14551,4850,9701,4850,0,1,4852,3122476

168,5250,7000,3900,27300000,2,42006,10503,1,676200000,676200000,15751,5250,10501,5250,0,1,5252,41272370
168,5250,7000,3900,27300000,2,42006,10503,1,676200000,676200000,15751,5250,10501,5250,0,1,5252,3424142
168,5250,7000,3900,27300000,2,42006,10503,1,676200000,676200000,15751,5250,10501,5250,0,1,5252,3422449
168,5250,7000,3900,27300000,2,42006,10503,1,676200000,676200000,15751,5250,10501,5250,0,1,5252,3418587
168,5250,7000,3900,27300000,2,42006,10503,1,676200000,676200000,15751,5250,10501,5250,0,1,5252,3415315
168,5250,7000,3900,27300000,2,42006,10503,1,676200000,676200000,15751,5250,10501,5250,0,1,5252,3345502
168,5250,7000,3900,27300000,2,42006,10503,1,676200000,676200000,15751,5250,10501,5250,0,1,5252,3348356

168,5650,7000,3900,27300000,2,45206,11303,1,711080000,711080000,16951,5650,11301,5650,0,1,5652,43015135
168,5650,7000,3900,27300000,2,45206,11303,1,711080000,711080000,16951,5650,11301,5650,0,1,5652,3653869
168,5650,7000,3900,27300000,2,45206,11303,1,711080000,711080000,16951,5650,11301,5650,0,1,5652,3652408
168,5650,7000,3900,27300000,2,45206,11303,1,711080000,711080000,16951,5650,11301,5650,0,1,5652,3650215
168,5650,7000,3900,27300000,2,45206,11303,1,711080000,711080000,16951,5650,11301,5650,0,1,5652,3655669
168,5650,7000,3900,27300000,2,45206,11303,1,711080000,711080000,16951,5650,11301,5650,0,1,5652,3559429
168,5650,7000,3900,27300000,2,45206,11303,1,711080000,711080000,16951,5650,11301,5650,0,1,5652,3563506

168,6050,7000,3900,27300000,2,48406,12103,1,745960000,745960000,18151,6050,12101,6050,0,1,6052,47109886
168,6050,7000,3900,27300000,2,48406,12103,1,745960000,745960000,18151,6050,12101,6050,0,1,6052,3883353
168,6050,7000,3900,27300000,2,48406,12103,1,745960000,745960000,18151,6050,12101,6050,0,1,6052,3881051
168,6050,7000,3900,27300000,2,48406,12103,1,745960000,745960000,18151,6050,12101,6050,0,1,6052,3884905
168,6050,7000,3900,27300000,2,48406,12103,1,745960000,745960000,18151,6050,12101,6050,0,1,6052,3886839
168,6050,7000,3900,27300000,2,48406,12103,1,745960000,745960000,18151,6050,12101,6050,0,1,6052,3768818
168,6050,7000,3900,27300000,2,48406,12103,1,745960000,745960000,18151,6050,12101,6050,0,1,6052,3778643

168,6450,7000,3900,27300000,2,51606,12903,1,780840000,780840000,19351,6450,12901,6450,0,1,6452,51174974
168,6450,7000,3900,27300000,2,51606,12903,1,780840000,780840000,19351,6450,12901,6450,0,1,6452,4156676
168,6450,7000,3900,27300000,2,51606,12903,1,780840000,780840000,19351,6450,12901,6450,0,1,6452,4153876
168,6450,7000,3900,27300000,2,51606,12903,1,780840000,780840000,19351,6450,12901,6450,0,1,6452,4141142
168,6450,7000,3900,27300000,2,51606,12903,1,780840000,780840000,19351,6450,12901,6450,0,1,6452,4160385
168,6450,7000,3900,27300000,2,51606,12903,1,780840000,780840000,19351,6450,12901,6450,0,1,6452,4029959
168,6450,7000,3900,27300000,2,51606,12903,1,780840000,780840000,19351,6450,12901,6450,0,1,6452,4026426

168,6850,7000,3900,27300000,2,54806,13703,1,815720000,815720000,20551,6850,13701,6850,0,1,6852,54307812
168,6850,7000,3900,27300000,2,54806,13703,1,815720000,815720000,20551,6850,13701,6850,0,1,6852,4364304
168,6850,7000,3900,27300000,2,54806,13703,1,815720000,815720000,20551,6850,13701,6850,0,1,6852,4365868
168,6850,7000,3900,27300000,2,54806,13703,1,815720000,815720000,20551,6850,13701,6850,0,1,6852,4362172
168,6850,7000,3900,27300000,2,54806,13703,1,815720000,815720000,20551,6850,13701,6850,0,1,6852,4368125
168,6850,7000,3900,27300000,2,54806,13703,1,815720000,815720000,20551,6850,13701,6850,0,1,6852,4244864
168,6850,7000,3900,27300000,2,54806,13703,1,815720000,815720000,20551,6850,13701,6850,0,1,6852,4250302

168,50,7000,3500,24500000,2,406,103,1,200200000,200200000,151,50,101,50,0,1,52,247597
168,50,7000,3500,24500000,2,406,103,1,200200000,200200000,151,50,101,50,0,1,52,259001
168,50,7000,3500,24500000,2,406,103,1,200200000,200200000,151,50,101,50,0,1,52,255692
168,50,7000,3500,24500000,2,406,103,1,200200000,200200000,151,50,101,50,0,1,52,259738
168,50,7000,3500,24500000,2,406,103,1,200200000,200200000,151,50,101,50,0,1,52,257935
168,50,7000,3500,24500000,2,406,103,1,200200000,200200000,151,50,101,50,0,1,52,262877
168,50,7000,3500,24500000,2,406,103,1,200200000,200200000,151,50,101,50,0,1,52,267102

168,450,7000,3500,24500000,2,3606,903,1,233800000,233800000,1351,450,901,450,0,1,452,2382675
168,450,7000,3500,24500000,2,3606,903,1,233800000,233800000,1351,450,901,450,0,1,452,464223
168,450,7000,3500,24500000,2,3606,903,1,233800000,233800000,1351,450,901,450,0,1,452,462832
168,450,7000,3500,24500000,2,3606,903,1,233800000,233800000,1351,450,901,450,0,1,452,461051
168,450,7000,3500,24500000,2,3606,903,1,233800000,233800000,1351,450,901,450,0,1,452,462316
168,450,7000,3500,24500000,2,3606,903,1,233800000,233800000,1351,450,901,450,0,1,452,476982
168,450,7000,3500,24500000,2,3606,903,1,233800000,233800000,1351,450,901,450,0,1,452,479097

168,850,7000,3500,24500000,2,6806,1703,1,267400000,267400000,2551,850,1701,850,0,1,852,4870265
168,850,7000,3500,24500000,2,6806,1703,1,267400000,267400000,2551,850,1701,850,0,1,852,663055
168,850,7000,3500,24500000,2,6806,1703,1,267400000,267400000,2551,850,1701,850,0,1,852,664156
168,850,7000,3500,24500000,2,6806,1703,1,267400000,267400000,2551,850,1701,850,0,1,852,661204
168,850,7000,3500,24500000,2,6806,1703,1,267400000,267400000,2551,850,1701,850,0,1,852,664953
168,850,7000,3500,24500000,2,6806,1703,1,267400000,267400000,2551,850,1701,850,0,1,852,676370
168,850,7000,3500,24500000,2,6806,1703,1,267400000,267400000,2551,850,1701,850,0,1,852,676867

168,1250,7000,3500,24500000,2,10006,2503,1,301000000,301000000,3751,1250,2501,1250,0,1,1252,7518701
168,1250,7000,3500,24500000,2,10006,2503,1,301000000,301000000,3751,1250,2501,1250,0,1,1252,889767
168,1250,7000,3500,24500000,2,10006,2503,1,301000000,301000000,3751,1250,2501,1250,0,1,1252,892075
168,1250,7000,3500,24500000,2,10006,2503,1,301000000,301000000,3751,1250,2501,1250,0,1,1252,887595
168,1250,7000,3500,24500000,2,10006,2503,1,301000000,301000000,3751,1250,2501,1250,0,1,1252,891086
168,1250,7000,3500,24500000,2,10006,2503,1,301000000,301000000,3751,1250,2501,1250,0,1,1252,895761
168,1250,7000,3500,24500000,2,10006,2503,1,301000000,301000000,3751,1250,2501,1250,0,1,1252,896327

168,1650,7000,3500,24500000,2,13206,3303,1,334600000,334600000,4951,1650,3301,1650,0,1,1652,10588176
168,1650,7000,3500,24500000,2,13206,3303,1,334600000,334600000,4951,1650,3301,1650,0,1,1652,1077224
168,1650,7000,3500,24500000,2,13206,3303,1,334600000,334600000,4951,1650,3301,1650,0,1,1652,1079500
168,1650,7000,3500,24500000,2,13206,3303,1,334600000,334600000,4951,1650,3301,1650,0,1,1652,1081010
168,1650,7000,3500,24500000,2,13206,3303,1,334600000,334600000,4951,1650,3301,1650,0,1,1652,1082243
168,1650,7000,3500,24500000,2,13206,3303,1,334600000,334600000,4951,1650,3301,1650,0,1,1652,1093860
168,1650,7000,3500,24500000,2,13206,3303,1,334600000,334600000,4951,1650,3301,1650,0,1,1652,1094508

168,2050,7000,3500,24500000,2,16406,4103,1,368200000,368200000,6151,2050,4101,2050,0,1,2052,13109163
168,2050,7000,3500,24500000,2,16406,4103,1,368200000,368200000,6151,2050,4101,2050,0,1,2052,1310841
168,2050,7000,3500,24500000,2,16406,4103,1,368200000,368200000,6151,2050,4101,2050,0,1,2052,1307571
168,2050,7000,3500,24500000,2,16406,4103,1,368200000,368200000,6151,2050,4101,2050,0,1,2052,1309735
168,2050,7000,3500,24500000,2,16406,4103,1,368200000,368200000,6151,2050,4101,2050,0,1,2052,1311616
168,2050,7000,3500,24500000,2,16406,4103,1,368200000,368200000,6151,2050,4101,2050,0,1,2052,1313262
168,2050,7000,3500,24500000,2,16406,4103,1,368200000,368200000,6151,2050,4101,2050,0,1,2052,1313960

168,2450,7000,3500,24500000,2,19606,4903,1,401800000,401800000,7351,2450,4901,2450,0,1,2452,15616609
168,2450,7000,3500,24500000,2,19606,4903,1,401800000,401800000,7351,2450,4901,2450,0,1,2452,1548356
168,2450,7000,3500,24500000,2,19606,4903,1,401800000,401800000,7351,2450,4901,2450,0,1,2452,1550849
168,2450,7000,3500,24500000,2,19606,4903,1,401800000,401800000,7351,2450,4901,2450,0,1,2452,1552492
168,2450,7000,3500,24500000,2,19606,4903,1,401800000,401800000,7351,2450,4901,2450,0,1,2452,1553532
168,2450,7000,3500,24500000,2,19606,4903,1,401800000,401800000,7351,2450,4901,2450,0,1,2452,1555038
168,2450,7000,3500,24500000,2,19606,4903,1,401800000,401800000,7351,2450,4901,2450,0,1,2452,1555781

168,2850,7000,3500,24500000,2,22806,5703,1,435400000,435400000,8551,2850,5701,2850,0,1,2852,19165025
168,2850,7000,3500,24500000,2,22806,5703,1,435400000,435400000,8551,2850,5701,2850,0,1,2852,1739626
168,2850,7000,3500,24500000,2,22806,5703,1,435400000,435400000,8551,2850,5701,2850,0,1,2852,1734764
168,2850,7000,3500,24500000,2,22806,5703,1,435400000,435400000,8551,2850,5701,2850,0,1,2852,1737459
168,2850,7000,3500,24500000,2,22806,5703,1,435400000,435400000,8551,2850,5701,2850,0,1,2852,1736416
168,2850,7000,3500,24500000,2,22806,5703,1,435400000,435400000,8551,2850,5701,2850,0,1,2852,1738128
168,2850,7000,3500,24500000,2,22806,5703,1,435400000,435400000,8551,2850,5701,2850,0,1,2852,1738727

168,3250,7000,3500,24500000,2,26006,6503,1,469000000,469000000,9751,3250,6501,3250,0,1,3252,21441333
168,3250,7000,3500,24500000,2,26006,6503,1,469000000,469000000,9751,3250,6501,3250,0,1,3252,1974771
168,3250,7000,3500,24500000,2,26006,6503,1,469000000,469000000,9751,3250,6501,3250,0,1,3252,1976393
168,3250,7000,3500,24500000,2,26006,6503,1,469000000,469000000,9751,3250,6501,3250,0,1,3252,1979472
168,3250,7000,3500,24500000,2,26006,6503,1,469000000,469000000,9751,3250,6501,3250,0,1,3252,1978242
168,3250,7000,3500,24500000,2,26006,6503,1,469000000,469000000,9751,3250,6501,3250,0,1,3252,1957709
168,3250,7000,3500,24500000,2,26006,6503,1,469000000,469000000,9751,3250,6501,3250,0,1,3252,1959228

168,3650,7000,3500,24500000,2,29206,7303,1,502600000,502600000,10951,3650,7301,3650,0,1,3652,24551977
168,3650,7000,3500,24500000,2,29206,7303,1,502600000,502600000,10951,3650,7301,3650,0,1,3652,2201036
168,3650,7000,3500,24500000,2,29206,7303,1,502600000,502600000,10951,3650,7301,3650,0,1,3652,2202154
168,3650,7000,3500,24500000,2,29206,7303,1,502600000,502600000,10951,3650,7301,3650,0,1,3652,2199975
168,3650,7000,3500,24500000,2,29206,7303,1,502600000,502600000,10951,3650,7301,3650,0,1,3652,2203256
168,3650,7000,3500,24500000,2,29206,7303,1,502600000,502600000,10951,3650,7301,3650,0,1,3652,2164327
168,3650,7000,3500,24500000,2,29206,7303,1,502600000,502600000,10951,3650,7301,3650,0,1,3652,2166096

168,4050,7000,3500,24500000,2,32406,8103,1,536200000,536200000,12151,4050,8101,4050,0,1,4052,27451730
168,4050,7000,3500,24500000,2,32406,8103,1,536200000,536200000,12151,4050,8101,4050,0,1,4052,2474867
168,4050,7000,3500,24500000,2,32406,8103,1,536200000,536200000,12151,4050,8101,4050,0,1,4052,2479295
168,4050,7000,3500,24500000,2,32406,8103,1,536200000,536200000,12151,4050,8101,4050,0,1,4052,2482225
168,4050,7000,3500,24500000,2,32406,8103,1,536200000,536200000,12151,4050,8101,4050,0,1,4052,2483658
168,4050,7000,3500,24500000,2,32406,8103,1,536200000,536200000,12151,4050,8101,4050,0,1,4052,2410376
168,4050,7000,3500,24500000,2,32406,8103,1,536200000,536200000,12151,4050,8101,4050,0,1,4052,2400825

168,4450,7000,3500,24500000,2,35606,8903,1,569800000,569800000,13351,4450,8901,4450,0,1,4452,29132697
168,4450,7000,3500,24500000,2,35606,8903,1,569800000,569800000,13351,4450,8901,4450,0,1,4452,2650263
168,4450,7000,3500,24500000,2,35606,8903,1,569800000,569800000,13351,4450,8901,4450,0,1,4452,2656088
168,4450,7000,3500,24500000,2,35606,8903,1,569800000,569800000,13351,4450,8901,4450,0,1,4452,2654881
168,4450,7000,3500,24500000,2,35606,8903,1,569800000,569800000,13351,4450,8901,4450,0,1,4452,2657646
168,4450,7000,3500,24500000,2,35606,8903,1,569800000,569800000,13351,4450,8901,4450,0,1,4452,2613676
168,4450,7000,3500,24500000,2,35606,8903,1,569800000,569800000,13351,4450,8901,4450,0,1,4452,2611498

168,4850,7000,3500,24500000,2,38806,9703,1,603400000,603400000,14551,4850,9701,4850,0,1,4852,32511855
168,4850,7000,3500,24500000,2,38806,9703,1,603400000,603400000,14551,4850,9701,4850,0,1,4852,2852030
168,4850,7000,3500,24500000,2,38806,9703,1,603400000,603400000,14551,4850,9701,4850,0,1,4852,2870231
168,4850,7000,3500,24500000,2,38806,9703,1,603400000,603400000,14551,4850,9701,4850,0,1,4852,2864397
168,4850,7000,3500,24500000,2,38806,9703,1,603400000,603400000,14551,4850,9701,4850,0,1,4852,2873088
168,4850,7000,3500,24500000,2,38806,9703,1,603400000,603400000,14551,4850,9701,4850,0,1,4852,2813526
168,4850,7000,3500,24500000,2,38806,9703,1,603400000,603400000,14551,4850,9701,4850,0,1,4852,2816523

168,5250,7000,3500,24500000,2,42006,10503,1,637000000,637000000,15751,5250,10501,5250,0,1,5252,36862437
168,5250,7000,3500,24500000,2,42006,10503,1,637000000,637000000,15751,5250,10501,5250,0,1,5252,3128090
168,5250,7000,3500,24500000,2,42006,10503,1,637000000,637000000,15751,5250,10501,5250,0,1,5252,3126362
168,5250,7000,3500,24500000,2,42006,10503,1,637000000,637000000,15751,5250,10501,5250,0,1,5252,3123810
168,5250,7000,3500,24500000,2,42006,10503,1,637000000,637000000,15751,5250,10501,5250,0,1,5252,3121740
168,5250,7000,3500,24500000,2,42006,10503,1,637000000,637000000,15751,5250,10501,5250,0,1,5252,3044903
168,5250,7000,3500,24500000,2,42006,10503,1,637000000,637000000,15751,5250,10501,5250,0,1,5252,3047302

168,5650,7000,3500,24500000,2,45206,11303,1,670600000,670600000,16951,5650,11301,5650,0,1,5652,38865092
168,5650,7000,3500,24500000,2,45206,11303,1,670600000,670600000,16951,5650,11301,5650,0,1,5652,3334265
168,5650,7000,3500,24500000,2,45206,11303,1,670600000,670600000,16951,5650,11301,5650,0,1,5652,3340716
168,5650,7000,3500,24500000,2,45206,11303,1,670600000,670600000,16951,5650,11301,5650,0,1,5652,3328683
168,5650,7000,3500,24500000,2,45206,11303,1,670600000,670600000,16951,5650,11301,5650,0,1,5652,3342533
168,5650,7000,3500,24500000,2,45206,11303,1,670600000,670600000,16951,5650,11301,5650,0,1,5652,3258070
168,5650,7000,3500,24500000,2,45206,11303,1,670600000,670600000,16951,5650,11301,5650,0,1,5652,3261256

168,6050,7000,3500,24500000,2,48406,12103,1,704200000,704200000,18151,6050,12101,6050,0,1,6052,41708588
168,6050,7000,3500,24500000,2,48406,12103,1,704200000,704200000,18151,6050,12101,6050,0,1,6052,3553764
168,6050,7000,3500,24500000,2,48406,12103,1,704200000,704200000,18151,6050,12101,6050,0,1,6052,3555682
168,6050,7000,3500,24500000,2,48406,12103,1,704200000,704200000,18151,6050,12101,6050,0,1,6052,3551064
168,6050,7000,3500,24500000,2,48406,12103,1,704200000,704200000,18151,6050,12101,6050,0,1,6052,3548822
168,6050,7000,3500,24500000,2,48406,12103,1,704200000,704200000,18151,6050,12101,6050,0,1,6052,3454328
168,6050,7000,3500,24500000,2,48406,12103,1,704200000,704200000,18151,6050,12101,6050,0,1,6052,3456943

168,6450,7000,3500,24500000,2,51606,12903,1,737800000,737800000,19351,6450,12901,6450,0,1,6452,44963489
168,6450,7000,3500,24500000,2,51606,12903,1,737800000,737800000,19351,6450,12901,6450,0,1,6452,3764463
168,6450,7000,3500,24500000,2,51606,12903,1,737800000,737800000,19351,6450,12901,6450,0,1,6452,3769400
168,6450,7000,3500,24500000,2,51606,12903,1,737800000,737800000,19351,6450,12901,6450,0,1,6452,3766182
168,6450,7000,3500,24500000,2,51606,12903,1,737800000,737800000,19351,6450,12901,6450,0,1,6452,3755142
168,6450,7000,3500,24500000,2,51606,12903,1,737800000,737800000,19351,6450,12901,6450,0,1,6452,3664883
168,6450,7000,3500,24500000,2,51606,12903,1,737800000,737800000,19351,6450,12901,6450,0,1,6452,3668039

