168,50,5400,7100,38340000,2,406,103,1,311720000,311720000,151,50,101,50,0,1,52,439047
168,50,5400,7100,38340000,2,406,103,1,311720000,311720000,151,50,101,50,0,1,52,429112
168,50,5400,7100,38340000,2,406,103,1,311720000,311720000,151,50,101,50,0,1,52,429304
168,50,5400,7100,38340000,2,406,103,1,311720000,311720000,151,50,101,50,0,1,52,428948
168,50,5400,7100,38340000,2,406,103,1,311720000,311720000,151,50,101,50,0,1,52,429500
168,50,5400,7100,38340000,2,406,103,1,311720000,311720000,151,50,101,50,0,1,52,428224
168,50,5400,7100,38340000,2,406,103,1,311720000,311720000,151,50,101,50,0,1,52,428650

168,450,5400,7100,38340000,2,3606,903,1,351720000,351720000,1351,450,901,450,0,1,452,4341512
168,450,5400,7100,38340000,2,3606,903,1,351720000,351720000,1351,450,901,450,0,1,452,747613
168,450,5400,7100,38340000,2,3606,903,1,351720000,351720000,1351,450,901,450,0,1,452,746297
168,450,5400,7100,38340000,2,3606,903,1,351720000,351720000,1351,450,901,450,0,1,452,746896
168,450,5400,7100,38340000,2,3606,903,1,351720000,351720000,1351,450,901,450,0,1,452,738020
168,450,5400,7100,38340000,2,3606,903,1,351720000,351720000,1351,450,901,450,0,1,452,744796
168,450,5400,7100,38340000,2,3606,903,1,351720000,351720000,1351,450,901,450,0,1,452,747342

168,850,5400,7100,38340000,2,6806,1703,1,391720000,391720000,2551,850,1701,850,0,1,852,8633524
168,850,5400,7100,38340000,2,6806,1703,1,391720000,391720000,2551,850,1701,850,0,1,852,936543
168,850,5400,7100,38340000,2,6806,1703,1,391720000,391720000,2551,850,1701,850,0,1,852,1022217
168,850,5400,7100,38340000,2,6806,1703,1,391720000,391720000,2551,850,1701,850,0,1,852,1010707
168,850,5400,7100,38340000,2,6806,1703,1,391720000,391720000,2551,850,1701,850,0,1,852,1022563
168,850,5400,7100,38340000,2,6806,1703,1,391720000,391720000,2551,850,1701,850,0,1,852,1021073
168,850,5400,7100,38340000,2,6806,1703,1,391720000,391720000,2551,850,1701,850,0,1,852,1021688

168,1250,5400,7100,38340000,2,10006,2503,1,431720000,431720000,3751,1250,2501,1250,0,1,1252,13365609
168,1250,5400,7100,38340000,2,10006,2503,1,431720000,431720000,3751,1250,2501,1250,0,1,1252,1341144
168,1250,5400,7100,38340000,2,10006,2503,1,431720000,431720000,3751,1250,2501,1250,0,1,1252,1342014
168,1250,5400,7100,38340000,2,10006,2503,1,431720000,431720000,3751,1250,2501,1250,0,1,1252,1342424
168,1250,5400,7100,38340000,2,10006,2503,1,431720000,431720000,3751,1250,2501,1250,0,1,1252,1341652
168,1250,5400,7100,38340000,2,10006,2503,1,431720000,431720000,3751,1250,2501,1250,0,1,1252,1340352
168,1250,5400,7100,38340000,2,10006,2503,1,431720000,431720000,3751,1250,2501,1250,0,1,1252,1340806

168,1650,5400,7100,38340000,2,13206,3303,1,471720000,471720000,4951,1650,3301,1650,0,1,1652,18358703
168,1650,5400,7100,38340000,2,13206,3303,1,471720000,471720000,4951,1650,3301,1650,0,1,1652,1711427
168,1650,5400,7100,38340000,2,13206,3303,1,471720000,471720000,4951,1650,3301,1650,0,1,1652,1710144
168,1650,5400,7100,38340000,2,13206,3303,1,471720000,471720000,4951,1650,3301,1650,0,1,1652,1712151
168,1650,5400,7100,38340000,2,13206,3303,1,471720000,471720000,4951,1650,3301,1650,0,1,1652,1708551
168,1650,5400,7100,38340000,2,13206,3303,1,471720000,471720000,4951,1650,3301,1650,0,1,1652,1708967
168,1650,5400,7100,38340000,2,13206,3303,1,471720000,471720000,4951,1650,3301,1650,0,1,1652,1710494

168,2050,5400,7100,38340000,2,16406,4103,1,511720000,511720000,6151,2050,4101,2050,0,1,2052,22509775
168,2050,5400,7100,38340000,2,16406,4103,1,511720000,511720000,6151,2050,4101,2050,0,1,2052,2016131
168,2050,5400,7100,38340000,2,16406,4103,1,511720000,511720000,6151,2050,4101,2050,0,1,2052,2014054
168,2050,5400,7100,38340000,2,16406,4103,1,511720000,511720000,6151,2050,4101,2050,0,1,2052,2016978
168,2050,5400,7100,38340000,2,16406,4103,1,511720000,511720000,6151,2050,4101,2050,0,1,2052,2015495
168,2050,5400,7100,38340000,2,16406,4103,1,511720000,511720000,6151,2050,4101,2050,0,1,2052,1970426
168,2050,5400,7100,38340000,2,16406,4103,1,511720000,511720000,6151,2050,4101,2050,0,1,2052,1971643

168,2450,5400,7100,38340000,2,19606,4903,1,551720000,551720000,7351,2450,4901,2450,0,1,2452,27236153
168,2450,5400,7100,38340000,2,19606,4903,1,551720000,551720000,7351,2450,4901,2450,0,1,2452,2375011
168,2450,5400,7100,38340000,2,19606,4903,1,551720000,551720000,7351,2450,4901,2450,0,1,2452,2369960
168,2450,5400,7100,38340000,2,19606,4903,1,551720000,551720000,7351,2450,4901,2450,0,1,2452,2375888
168,2450,5400,7100,38340000,2,19606,4903,1,551720000,551720000,7351,2450,4901,2450,0,1,2452,2356584
168,2450,5400,7100,38340000,2,19606,4903,1,551720000,551720000,7351,2450,4901,2450,0,1,2452,2351057
168,2450,5400,7100,38340000,2,19606,4903,1,551720000,551720000,7351,2450,4901,2450,0,1,2452,2345934

168,2850,5400,7100,38340000,2,22806,5703,1,591720000,591720000,8551,2850,5701,2850,0,1,2852,32122127
168,2850,5400,7100,38340000,2,22806,5703,1,591720000,591720000,8551,2850,5701,2850,0,1,2852,2717047
168,2850,5400,7100,38340000,2,22806,5703,1,591720000,591720000,8551,2850,5701,2850,0,1,2852,2707170
168,2850,5400,7100,38340000,2,22806,5703,1,591720000,591720000,8551,2850,5701,2850,0,1,2852,2715144
168,2850,5400,7100,38340000,2,22806,5703,1,591720000,591720000,8551,2850,5701,2850,0,1,2852,2718066
168,2850,5400,7100,38340000,2,22806,5703,1,591720000,591720000,8551,2850,5701,2850,0,1,2852,2651994
168,2850,5400,7100,38340000,2,22806,5703,1,591720000,591720000,8551,2850,5701,2850,0,1,2852,2656150

168,3250,5400,7100,38340000,2,26006,6503,1,631720000,631720000,9751,3250,6501,3250,0,1,3252,36264100
168,3250,5400,7100,38340000,2,26006,6503,1,631720000,631720000,9751,3250,6501,3250,0,1,3252,2986783
168,3250,5400,7100,38340000,2,26006,6503,1,631720000,631720000,9751,3250,6501,3250,0,1,3252,2985031
168,3250,5400,7100,38340000,2,26006,6503,1,631720000,631720000,9751,3250,6501,3250,0,1,3252,2988663
168,3250,5400,7100,38340000,2,26006,6503,1,631720000,631720000,9751,3250,6501,3250,0,1,3252,2987603
168,3250,5400,7100,38340000,2,26006,6503,1,631720000,631720000,9751,3250,6501,3250,0,1,3252,2954521
168,3250,5400,7100,38340000,2,26006,6503,1,631720000,631720000,9751,3250,6501,3250,0,1,3252,2952511

168,3650,5400,7100,38340000,2,29206,7303,1,671720000,671720000,10951,3650,7301,3650,0,1,3652,43497488
168,3650,5400,7100,38340000,2,29206,7303,1,671720000,671720000,10951,3650,7301,3650,0,1,3652,3378935
168,3650,5400,7100,38340000,2,29206,7303,1,671720000,671720000,10951,3650,7301,3650,0,1,3652,3364885
168,3650,5400,7100,38340000,2,29206,7303,1,671720000,671720000,10951,3650,7301,3650,0,1,3652,3382161
168,3650,5400,7100,38340000,2,29206,7303,1,671720000,671720000,10951,3650,7301,3650,0,1,3652,3380884
168,3650,5400,7100,38340000,2,29206,7303,1,671720000,671720000,10951,3650,7301,3650,0,1,3652,3288185
168,3650,5400,7100,38340000,2,29206,7303,1,671720000,671720000,10951,3650,7301,3650,0,1,3652,3299635

168,4050,5400,7100,38340000,2,32406,8103,1,711720000,711720000,12151,4050,8101,4050,0,1,4052,45180099
168,4050,5400,7100,38340000,2,32406,8103,1,711720000,711720000,12151,4050,8101,4050,0,1,4052,3742395
168,4050,5400,7100,38340000,2,32406,8103,1,711720000,711720000,12151,4050,8101,4050,0,1,4052,3739803
168,4050,5400,7100,38340000,2,32406,8103,1,711720000,711720000,12151,4050,8101,4050,0,1,4052,3743664
168,4050,5400,7100,38340000,2,32406,8103,1,711720000,711720000,12151,4050,8101,4050,0,1,4052,3733237
168,4050,5400,7100,38340000,2,32406,8103,1,711720000,711720000,12151,4050,8101,4050,0,1,4052,3635685
168,4050,5400,7100,38340000,2,32406,8103,1,711720000,711720000,12151,4050,8101,4050,0,1,4052,3638151

168,4450,5400,7100,38340000,2,35606,8903,1,751720000,751720000,13351,4450,8901,4450,0,1,4452,49629879
168,4450,5400,7100,38340000,2,35606,8903,1,751720000,751720000,13351,4450,8901,4450,0,1,4452,4024308
168,4450,5400,7100,38340000,2,35606,8903,1,751720000,751720000,13351,4450,8901,4450,0,1,4452,4016406
168,4450,5400,7100,38340000,2,35606,8903,1,751720000,751720000,13351,4450,8901,4450,0,1,4452,4029778
168,4450,5400,7100,38340000,2,35606,8903,1,751720000,751720000,13351,4450,8901,4450,0,1,4452,4028483
168,4450,5400,7100,38340000,2,35606,8903,1,751720000,751720000,13351,4450,8901,4450,0,1,4452,3929618
168,4450,5400,7100,38340000,2,35606,8903,1,751720000,751720000,13351,4450,8901,4450,0,1,4452,3931768

168,4850,5400,7100,38340000,2,38806,9703,1,791720000,791720000,14551,4850,9701,4850,0,1,4852,57254304
168,4850,5400,7100,38340000,2,38806,9703,1,791720000,791720000,14551,4850,9701,4850,0,1,4852,4424062
168,4850,5400,7100,38340000,2,38806,9703,1,791720000,791720000,14551,4850,9701,4850,0,1,4852,4421210
168,4850,5400,7100,38340000,2,38806,9703,1,791720000,791720000,14551,4850,9701,4850,0,1,4852,4425432
168,4850,5400,7100,38340000,2,38806,9703,1,791720000,791720000,14551,4850,9701,4850,0,1,4852,4415140
168,4850,5400,7100,38340000,2,38806,9703,1,791720000,791720000,14551,4850,9701,4850,0,1,4852,4267742
168,4850,5400,7100,38340000,2,38806,9703,1,791720000,791720000,14551,4850,9701,4850,0,1,4852,4265055

168,5250,5400,7100,38340000,2,42006,10503,1,831720000,831720000,15751,5250,10501,5250,0,1,5252,59720730
168,5250,5400,7100,38340000,2,42006,10503,1,831720000,831720000,15751,5250,10501,5250,0,1,5252,4691809
168,5250,5400,7100,38340000,2,42006,10503,1,831720000,831720000,15751,5250,10501,5250,0,1,5252,4682790
168,5250,5400,7100,38340000,2,42006,10503,1,831720000,831720000,15751,5250,10501,5250,0,1,5252,4696442
168,5250,5400,7100,38340000,2,42006,10503,1,831720000,831720000,15751,5250,10501,5250,0,1,5252,4697942
168,5250,5400,7100,38340000,2,42006,10503,1,831720000,831720000,15751,5250,10501,5250,0,1,5252,4582608
168,5250,5400,7100,38340000,2,42006,10503,1,831720000,831720000,15751,5250,10501,5250,0,1,5252,4585032

168,5650,5400,7100,38340000,2,45206,11303,1,871720000,871720000,16951,5650,11301,5650,0,1,5652,65517245
168,5650,5400,7100,38340000,2,45206,11303,1,871720000,871720000,16951,5650,11301,5650,0,1,5652,5005523
168,5650,5400,7100,38340000,2,45206,11303,1,871720000,871720000,16951,5650,11301,5650,0,1,5652,5000778
168,5650,5400,7100,38340000,2,45206,11303,1,871720000,871720000,16951,5650,11301,5650,0,1,5652,5007003
168,5650,5400,7100,38340000,2,45206,11303,1,871720000,871720000,16951,5650,11301,5650,0,1,5652,4999291
168,5650,5400,7100,38340000,2,45206,11303,1,871720000,871720000,16951,5650,11301,5650,0,1,5652,4892426
168,5650,5400,7100,38340000,2,45206,11303,1,871720000,871720000,16951,5650,11301,5650,0,1,5652,4889689

168,6050,5400,7100,38340000,2,48406,12103,1,911720000,911720000,18151,6050,12101,6050,0,1,6052,72579778
168,6050,5400,7100,38340000,2,48406,12103,1,911720000,911720000,18151,6050,12101,6050,0,1,6052,5314508
168,6050,5400,7100,38340000,2,48406,12103,1,911720000,911720000,18151,6050,12101,6050,0,1,6052,5307230
168,6050,5400,7100,38340000,2,48406,12103,1,911720000,911720000,18151,6050,12101,6050,0,1,6052,5316083
168,6050,5400,7100,38340000,2,48406,12103,1,911720000,911720000,18151,6050,12101,6050,0,1,6052,5309650
168,6050,5400,7100,38340000,2,48406,12103,1,911720000,911720000,18151,6050,12101,6050,0,1,6052,5204322
168,6050,5400,7100,38340000,2,48406,12103,1,911720000,911720000,18151,6050,12101,6050,0,1,6052,5201385

168,6450,5400,7100,38340000,2,51606,12903,1,951720000,951720000,19351,6450,12901,6450,0,1,6452,75797425
168,6450,5400,7100,38340000,2,51606,12903,1,951720000,951720000,19351,6450,12901,6450,0,1,6452,5689597
168,6450,5400,7100,38340000,2,51606,12903,1,951720000,951720000,19351,6450,12901,6450,0,1,6452,5684837
168,6450,5400,7100,38340000,2,51606,12903,1,951720000,951720000,19351,6450,12901,6450,0,1,6452,5687760
168,6450,5400,7100,38340000,2,51606,12903,1,951720000,951720000,19351,6450,12901,6450,0,1,6452,5669955
168,6450,5400,7100,38340000,2,51606,12903,1,951720000,951720000,19351,6450,12901,6450,0,1,6452,5540686
168,6450,5400,7100,38340000,2,51606,12903,1,951720000,951720000,19351,6450,12901,6450,0,1,6452,5537319

168,6850,5400,7100,38340000,2,54806,13703,1,991720000,991720000,20551,6850,13701,6850,0,1,6852,83269994
168,6850,5400,7100,38340000,2,54806,13703,1,991720000,991720000,20551,6850,13701,6850,0,1,6852,5951359
168,6850,5400,7100,38340000,2,54806,13703,1,991720000,991720000,20551,6850,13701,6850,0,1,6852,5944978
168,6850,5400,7100,38340000,2,54806,13703,1,991720000,991720000,20551,6850,13701,6850,0,1,6852,5952840
168,6850,5400,7100,38340000,2,54806,13703,1,991720000,991720000,20551,6850,13701,6850,0,1,6852,5954328
168,6850,5400,7100,38340000,2,54806,13703,1,991720000,991720000,20551,6850,13701,6850,0,1,6852,5720229
168,6850,5400,7100,38340000,2,54806,13703,1,991720000,991720000,20551,6850,13701,6850,0,1,6852,5732102

168,50,5400,6700,36180000,2,406,103,1,294280000,294280000,151,50,101,50,0,1,52,424816
168,50,5400,6700,36180000,2,406,103,1,294280000,294280000,151,50,101,50,0,1,52,369393
168,50,5400,6700,36180000,2,406,103,1,294280000,294280000,151,50,101,50,0,1,52,358174
168,50,5400,6700,36180000,2,406,103,1,294280000,294280000,151,50,101,50,0,1,52,325082
168,50,5400,6700,36180000,2,406,103,1,294280000,294280000,151,50,101,50,0,1,52,370041
168,50,5400,6700,36180000,2,406,103,1,294280000,294280000,151,50,101,50,0,1,52,377273
168,50,5400,6700,36180000,2,406,103,1,294280000,294280000,151,50,101,50,0,1,52,377662

168,450,5400,6700,36180000,2,3606,903,1,333000000,333000000,1351,450,901,450,0,1,452,3764460
168,450,5400,6700,36180000,2,3606,903,1,333000000,333000000,1351,450,901,450,0,1,452,711597
168,450,5400,6700,36180000,2,3606,903,1,333000000,333000000,1351,450,901,450,0,1,452,721368
168,450,5400,6700,36180000,2,3606,903,1,333000000,333000000,1351,450,901,450,0,1,452,698280
168,450,5400,6700,36180000,2,3606,903,1,333000000,333000000,1351,450,901,450,0,1,452,719698
168,450,5400,6700,36180000,2,3606,903,1,333000000,333000000,1351,450,901,450,0,1,452,720860
168,450,5400,6700,36180000,2,3606,903,1,333000000,333000000,1351,450,901,450,0,1,452,719870

168,850,5400,6700,36180000,2,6806,1703,1,371720000,371720000,2551,850,1701,850,0,1,852,8402571
168,850,5400,6700,36180000,2,6806,1703,1,371720000,371720000,2551,850,1701,850,0,1,852,983033
168,850,5400,6700,36180000,2,6806,1703,1,371720000,371720000,2551,850,1701,850,0,1,852,984138
168,850,5400,6700,36180000,2,6806,1703,1,371720000,371720000,2551,850,1701,850,0,1,852,983797
168,850,5400,6700,36180000,2,6806,1703,1,371720000,371720000,2551,850,1701,850,0,1,852,983500
168,850,5400,6700,36180000,2,6806,1703,1,371720000,371720000,2551,850,1701,850,0,1,852,979057
168,850,5400,6700,36180000,2,6806,1703,1,371720000,371720000,2551,850,1701,850,0,1,852,980639

168,1250,5400,6700,36180000,2,10006,2503,1,410440000,410440000,3751,1250,2501,1250,0,1,1252,12137455
168,1250,5400,6700,36180000,2,10006,2503,1,410440000,410440000,3751,1250,2501,1250,0,1,1252,1281247
168,1250,5400,6700,36180000,2,10006,2503,1,410440000,410440000,3751,1250,2501,1250,0,1,1252,1280673
168,1250,5400,6700,36180000,2,10006,2503,1,410440000,410440000,3751,1250,2501,1250,0,1,1252,1281656
168,1250,5400,6700,36180000,2,10006,2503,1,410440000,410440000,3751,1250,2501,1250,0,1,1252,1280036
168,1250,5400,6700,36180000,2,10006,2503,1,410440000,410440000,3751,1250,2501,1250,0,1,1252,1276097
168,1250,5400,6700,36180000,2,10006,2503,1,410440000,410440000,3751,1250,2501,1250,0,1,1252,1276560

168,1650,5400,6700,36180000,2,13206,3303,1,449160000,449160000,4951,1650,3301,1650,0,1,1652,16422259
168,1650,5400,6700,36180000,2,13206,3303,1,449160000,449160000,4951,1650,3301,1650,0,1,1652,1583572
168,1650,5400,6700,36180000,2,13206,3303,1,449160000,449160000,4951,1650,3301,1650,0,1,1652,1582779
168,1650,5400,6700,36180000,2,13206,3303,1,449160000,449160000,4951,1650,3301,1650,0,1,1652,1584216
168,1650,5400,6700,36180000,2,13206,3303,1,449160000,449160000,4951,1650,3301,1650,0,1,1652,1581288
168,1650,5400,6700,36180000,2,13206,3303,1,449160000,449160000,4951,1650,3301,1650,0,1,1652,1569787
168,1650,5400,6700,36180000,2,13206,3303,1,449160000,449160000,4951,1650,3301,1650,0,1,1652,1571152

168,2050,5400,6700,36180000,2,16406,4103,1,487880000,487880000,6151,2050,4101,2050,0,1,2052,20267619
168,2050,5400,6700,36180000,2,16406,4103,1,487880000,487880000,6151,2050,4101,2050,0,1,2052,1940568
168,2050,5400,6700,36180000,2,16406,4103,1,487880000,487880000,6151,2050,4101,2050,0,1,2052,1936705
168,2050,5400,6700,36180000,2,16406,4103,1,487880000,487880000,6151,2050,4101,2050,0,1,2052,1939732
168,2050,5400,6700,36180000,2,16406,4103,1,487880000,487880000,6151,2050,4101,2050,0,1,2052,1938154
168,2050,5400,6700,36180000,2,16406,4103,1,487880000,487880000,6151,2050,4101,2050,0,1,2052,1883294
168,2050,5400,6700,36180000,2,16406,4103,1,487880000,487880000,6151,2050,4101,2050,0,1,2052,1919746

168,2450,5400,6700,36180000,2,19606,4903,1,526600000,526600000,7351,2450,4901,2450,0,1,2452,24244508
168,2450,5400,6700,36180000,2,19606,4903,1,526600000,526600000,7351,2450,4901,2450,0,1,2452,2211487
168,2450,5400,6700,36180000,2,19606,4903,1,526600000,526600000,7351,2450,4901,2450,0,1,2452,2203415
168,2450,5400,6700,36180000,2,19606,4903,1,526600000,526600000,7351,2450,4901,2450,0,1,2452,2210595
168,2450,5400,6700,36180000,2,19606,4903,1,526600000,526600000,7351,2450,4901,2450,0,1,2452,2209693
168,2450,5400,6700,36180000,2,19606,4903,1,526600000,526600000,7351,2450,4901,2450,0,1,2452,2181357
168,2450,5400,6700,36180000,2,19606,4903,1,526600000,526600000,7351,2450,4901,2450,0,1,2452,2182872

168,2850,5400,6700,36180000,2,22806,5703,1,565320000,565320000,8551,2850,5701,2850,0,1,2852,31160401
168,2850,5400,6700,36180000,2,22806,5703,1,565320000,565320000,8551,2850,5701,2850,0,1,2852,2568466
168,2850,5400,6700,36180000,2,22806,5703,1,565320000,565320000,8551,2850,5701,2850,0,1,2852,2562988
168,2850,5400,6700,36180000,2,22806,5703,1,565320000,565320000,8551,2850,5701,2850,0,1,2852,2567500
168,2850,5400,6700,36180000,2,22806,5703,1,565320000,565320000,8551,2850,5701,2850,0,1,2852,2556703
168,2850,5400,6700,36180000,2,22806,5703,1,565320000,565320000,8551,2850,5701,2850,0,1,2852,2524850
168,2850,5400,6700,36180000,2,22806,5703,1,565320000,565320000,8551,2850,5701,2850,0,1,2852,2523214

168,3250,5400,6700,36180000,2,26006,6503,1,604040000,604040000,9751,3250,6501,3250,0,1,3252,32405293
168,3250,5400,6700,36180000,2,26006,6503,1,604040000,604040000,9751,3250,6501,3250,0,1,3252,2879400
168,3250,5400,6700,36180000,2,26006,6503,1,604040000,604040000,9751,3250,6501,3250,0,1,3252,2884142
168,3250,5400,6700,36180000,2,26006,6503,1,604040000,604040000,9751,3250,6501,3250,0,1,3252,2885185
168,3250,5400,6700,36180000,2,26006,6503,1,604040000,604040000,9751,3250,6501,3250,0,1,3252,2881746
168,3250,5400,6700,36180000,2,26006,6503,1,604040000,604040000,9751,3250,6501,3250,0,1,3252,2832898
168,3250,5400,6700,36180000,2,26006,6503,1,604040000,604040000,9751,3250,6501,3250,0,1,3252,2830930

168,3650,5400,6700,36180000,2,29206,7303,1,642760000,642760000,10951,3650,7301,3650,0,1,3652,38824162
168,3650,5400,6700,36180000,2,29206,7303,1,642760000,642760000,10951,3650,7301,3650,0,1,3652,3206672
168,3650,5400,6700,36180000,2,29206,7303,1,642760000,642760000,10951,3650,7301,3650,0,1,3652,3198198
168,3650,5400,6700,36180000,2,29206,7303,1,642760000,642760000,10951,3650,7301,3650,0,1,3652,3205552
168,3650,5400,6700,36180000,2,29206,7303,1,642760000,642760000,10951,3650,7301,3650,0,1,3652,3191497
168,3650,5400,6700,36180000,2,29206,7303,1,642760000,642760000,10951,3650,7301,3650,0,1,3652,3138865
168,3650,5400,6700,36180000,2,29206,7303,1,642760000,642760000,10951,3650,7301,3650,0,1,3652,3136752

168,4050,5400,6700,36180000,2,32406,8103,1,681480000,681480000,12151,4050,8101,4050,0,1,4052,44618579
168,4050,5400,6700,36180000,2,32406,8103,1,681480000,681480000,12151,4050,8101,4050,0,1,4052,3500673
168,4050,5400,6700,36180000,2,32406,8103,1,681480000,681480000,12151,4050,8101,4050,0,1,4052,3504101
168,4050,5400,6700,36180000,2,32406,8103,1,681480000,681480000,12151,4050,8101,4050,0,1,4052,3505456
168,4050,5400,6700,36180000,2,32406,8103,1,681480000,681480000,12151,4050,8101,4050,0,1,4052,3502008
168,4050,5400,6700,36180000,2,32406,8103,1,681480000,681480000,12151,4050,8101,4050,0,1,4052,3377698
168,4050,5400,6700,36180000,2,32406,8103,1,681480000,681480000,12151,4050,8101,4050,0,1,4052,3406186

168,4450,5400,6700,36180000,2,35606,8903,1,720200000,720200000,13351,4450,8901,4450,0,1,4452,47600148
168,4450,5400,6700,36180000,2,35606,8903,1,720200000,720200000,13351,4450,8901,4450,0,1,4452,3817221
168,4450,5400,6700,36180000,2,35606,8903,1,720200000,720200000,13351,4450,8901,4450,0,1,4452,3809795
168,4450,5400,6700,36180000,2,35606,8903,1,720200000,720200000,13351,4450,8901,4450,0,1,4452,3818471
168,4450,5400,6700,36180000,2,35606,8903,1,720200000,720200000,13351,4450,8901,4450,0,1,4452,3801368
168,4450,5400,6700,36180000,2,35606,8903,1,720200000,720200000,13351,4450,8901,4450,0,1,4452,3722903
168,4450,5400,6700,36180000,2,35606,8903,1,720200000,720200000,13351,4450,8901,4450,0,1,4452,3725154

168,4850,5400,6700,36180000,2,38806,9703,1,758920000,758920000,14551,4850,9701,4850,0,1,4852,52676079
168,4850,5400,6700,36180000,2,38806,9703,1,758920000,758920000,14551,4850,9701,4850,0,1,4852,4135394
168,4850,5400,6700,36180000,2,38806,9703,1,758920000,758920000,14551,4850,9701,4850,0,1,4852,4140143
168,4850,5400,6700,36180000,2,38806,9703,1,758920000,758920000,14551,4850,9701,4850,0,1,4852,4141655
168,4850,5400,6700,36180000,2,38806,9703,1,758920000,758920000,14551,4850,9701,4850,0,1,4852,4137825
168,4850,5400,6700,36180000,2,38806,9703,1,758920000,758920000,14551,4850,9701,4850,0,1,4852,3977093
168,4850,5400,6700,36180000,2,38806,9703,1,758920000,758920000,14551,4850,9701,4850,0,1,4852,4010626

168,5250,5400,6700,36180000,2,42006,10503,1,797640000,797640000,15751,5250,10501,5250,0,1,5252,57912723
168,5250,5400,6700,36180000,2,42006,10503,1,797640000,797640000,15751,5250,10501,5250,0,1,5252,4423083
168,5250,5400,6700,36180000,2,42006,10503,1,797640000,797640000,15751,5250,10501,5250,0,1,5252,4424532
168,5250,5400,6700,36180000,2,42006,10503,1,797640000,797640000,15751,5250,10501,5250,0,1,5252,4428734
168,5250,5400,6700,36180000,2,42006,10503,1,797640000,797640000,15751,5250,10501,5250,0,1,5252,4430192
168,5250,5400,6700,36180000,2,42006,10503,1,797640000,797640000,15751,5250,10501,5250,0,1,5252,4312680
168,5250,5400,6700,36180000,2,42006,10503,1,797640000,797640000,15751,5250,10501,5250,0,1,5252,4310418

168,5650,5400,6700,36180000,2,45206,11303,1,836360000,836360000,16951,5650,11301,5650,0,1,5652,61701007
168,5650,5400,6700,36180000,2,45206,11303,1,836360000,836360000,16951,5650,11301,5650,0,1,5652,4769969
168,5650,5400,6700,36180000,2,45206,11303,1,836360000,836360000,16951,5650,11301,5650,0,1,5652,4772558
168,5650,5400,6700,36180000,2,45206,11303,1,836360000,836360000,16951,5650,11301,5650,0,1,5652,4774250
168,5650,5400,6700,36180000,2,45206,11303,1,836360000,836360000,16951,5650,11301,5650,0,1,5652,4745547
168,5650,5400,6700,36180000,2,45206,11303,1,836360000,836360000,16951,5650,11301,5650,0,1,5652,4612353
168,5650,5400,6700,36180000,2,45206,11303,1,836360000,836360000,16951,5650,11301,5650,0,1,5652,4642431

168,6050,5400,6700,36180000,2,48406,12103,1,875080000,875080000,18151,6050,12101,6050,0,1,6052,66708161
168,6050,5400,6700,36180000,2,48406,12103,1,875080000,875080000,18151,6050,12101,6050,0,1,6052,5054423
168,6050,5400,6700,36180000,2,48406,12103,1,875080000,875080000,18151,6050,12101,6050,0,1,6052,5004033
168,6050,5400,6700,36180000,2,48406,12103,1,875080000,875080000,18151,6050,12101,6050,0,1,6052,5065113
168,6050,5400,6700,36180000,2,48406,12103,1,875080000,875080000,18151,6050,12101,6050,0,1,6052,5063515
168,6050,5400,6700,36180000,2,48406,12103,1,875080000,875080000,18151,6050,12101,6050,0,1,6052,4949805
168,6050,5400,6700,36180000,2,48406,12103,1,875080000,875080000,18151,6050,12101,6050,0,1,6052,4946235

168,6450,5400,6700,36180000,2,51606,12903,1,913800000,913800000,19351,6450,12901,6450,0,1,6452,69882514
168,6450,5400,6700,36180000,2,51606,12903,1,913800000,913800000,19351,6450,12901,6450,0,1,6452,5368585
168,6450,5400,6700,36180000,2,51606,12903,1,913800000,913800000,19351,6450,12901,6450,0,1,6452,5377300
168,6450,5400,6700,36180000,2,51606,12903,1,913800000,913800000,19351,6450,12901,6450,0,1,6452,5354400
168,6450,5400,6700,36180000,2,51606,12903,1,913800000,913800000,19351,6450,12901,6450,0,1,6452,5375663
168,6450,5400,6700,36180000,2,51606,12903,1,913800000,913800000,19351,6450,12901,6450,0,1,6452,5252823
168,6450,5400,6700,36180000,2,51606,12903,1,913800000,913800000,19351,6450,12901,6450,0,1,6452,5249473

168,6850,5400,6700,36180000,2,54806,13703,1,952520000,952520000,20551,6850,13701,6850,0,1,6852,77488795
168,6850,5400,6700,36180000,2,54806,13703,1,952520000,952520000,20551,6850,13701,6850,0,1,6852,5704491
168,6850,5400,6700,36180000,2,54806,13703,1,952520000,952520000,20551,6850,13701,6850,0,1,6852,5699455
168,6850,5400,6700,36180000,2,54806,13703,1,952520000,952520000,20551,6850,13701,6850,0,1,6852,5706218
168,6850,5400,6700,36180000,2,54806,13703,1,952520000,952520000,20551,6850,13701,6850,0,1,6852,5697797
168,6850,5400,6700,36180000,2,54806,13703,1,952520000,952520000,20551,6850,13701,6850,0,1,6852,5543687
168,6850,5400,6700,36180000,2,54806,13703,1,952520000,952520000,20551,6850,13701,6850,0,1,6852,5540608

168,50,5400,6300,34020000,2,406,103,1,276840000,276840000,151,50,101,50,0,1,52,394110
168,50,5400,6300,34020000,2,406,103,1,276840000,276840000,151,50,101,50,0,1,52,318357
168,50,5400,6300,34020000,2,406,103,1,276840000,276840000,151,50,101,50,0,1,52,316258
168,50,5400,6300,34020000,2,406,103,1,276840000,276840000,151,50,101,50,0,1,52,319248
168,50,5400,6300,34020000,2,406,103,1,276840000,276840000,151,50,101,50,0,1,52,287317
168,50,5400,6300,34020000,2,406,103,1,276840000,276840000,151,50,101,50,0,1,52,342272
168,50,5400,6300,34020000,2,406,103,1,276840000,276840000,151,50,101,50,0,1,52,342650

168,450,5400,6300,34020000,2,3606,903,1,314280000,314280000,1351,450,901,450,0,1,452,3640649
168,450,5400,6300,34020000,2,3606,903,1,314280000,314280000,1351,450,901,450,0,1,452,679912
168,450,5400,6300,34020000,2,3606,903,1,314280000,314280000,1351,450,901,450,0,1,452,677711
168,450,5400,6300,34020000,2,3606,903,1,314280000,314280000,1351,450,901,450,0,1,452,679194
168,450,5400,6300,34020000,2,3606,903,1,314280000,314280000,1351,450,901,450,0,1,452,680548
168,450,5400,6300,34020000,2,3606,903,1,314280000,314280000,1351,450,901,450,0,1,452,679532
168,450,5400,6300,34020000,2,3606,903,1,314280000,314280000,1351,450,901,450,0,1,452,680974

168,850,5400,6300,34020000,2,6806,1703,1,351720000,351720000,2551,850,1701,850,0,1,852,7312081
168,850,5400,6300,34020000,2,6806,1703,1,351720000,351720000,2551,850,1701,850,0,1,852,934974
168,850,5400,6300,34020000,2,6806,1703,1,351720000,351720000,2551,850,1701,850,0,1,852,936429
168,850,5400,6300,34020000,2,6806,1703,1,351720000,351720000,2551,850,1701,850,0,1,852,936767
168,850,5400,6300,34020000,2,6806,1703,1,351720000,351720000,2551,850,1701,850,0,1,852,935917
168,850,5400,6300,34020000,2,6806,1703,1,351720000,351720000,2551,850,1701,850,0,1,852,933315
168,850,5400,6300,34020000,2,6806,1703,1,351720000,351720000,2551,850,1701,850,0,1,852,934667

168,1250,5400,6300,34020000,2,10006,2503,1,389160000,389160000,3751,1250,2501,1250,0,1,1252,11668719
168,1250,5400,6300,34020000,2,10006,2503,1,389160000,389160000,3751,1250,2501,1250,0,1,1252,1228435
168,1250,5400,6300,34020000,2,10006,2503,1,389160000,389160000,3751,1250,2501,1250,0,1,1252,1227933
168,1250,5400,6300,34020000,2,10006,2503,1,389160000,389160000,3751,1250,2501,1250,0,1,1252,1229092
168,1250,5400,6300,34020000,2,10006,2503,1,389160000,389160000,3751,1250,2501,1250,0,1,1252,1226744
168,1250,5400,6300,34020000,2,10006,2503,1,389160000,389160000,3751,1250,2501,1250,0,1,1252,1205512
168,1250,5400,6300,34020000,2,10006,2503,1,389160000,389160000,3751,1250,2501,1250,0,1,1252,1206500

168,1650,5400,6300,34020000,2,13206,3303,1,426600000,426600000,4951,1650,3301,1650,0,1,1652,14333697
168,1650,5400,6300,34020000,2,13206,3303,1,426600000,426600000,4951,1650,3301,1650,0,1,1652,1502493
168,1650,5400,6300,34020000,2,13206,3303,1,426600000,426600000,4951,1650,3301,1650,0,1,1652,1500677
168,1650,5400,6300,34020000,2,13206,3303,1,426600000,426600000,4951,1650,3301,1650,0,1,1652,1504035
168,1650,5400,6300,34020000,2,13206,3303,1,426600000,426600000,4951,1650,3301,1650,0,1,1652,1503312
168,1650,5400,6300,34020000,2,13206,3303,1,426600000,426600000,4951,1650,3301,1650,0,1,1652,1483223
168,1650,5400,6300,34020000,2,13206,3303,1,426600000,426600000,4951,1650,3301,1650,0,1,1652,1484562

168,2050,5400,6300,34020000,2,16406,4103,1,464040000,464040000,6151,2050,4101,2050,0,1,2052,18819411
168,2050,5400,6300,34020000,2,16406,4103,1,464040000,464040000,6151,2050,4101,2050,0,1,2052,1846778
168,2050,5400,6300,34020000,2,16406,4103,1,464040000,464040000,6151,2050,4101,2050,0,1,2052,1844500
168,2050,5400,6300,34020000,2,16406,4103,1,464040000,464040000,6151,2050,4101,2050,0,1,2052,1845802
168,2050,5400,6300,34020000,2,16406,4103,1,464040000,464040000,6151,2050,4101,2050,0,1,2052,1840545
168,2050,5400,6300,34020000,2,16406,4103,1,464040000,464040000,6151,2050,4101,2050,0,1,2052,1813273
168,2050,5400,6300,34020000,2,16406,4103,1,464040000,464040000,6151,2050,4101,2050,0,1,2052,1811775

168,2450,5400,6300,34020000,2,19606,4903,1,501480000,501480000,7351,2450,4901,2450,0,1,2452,23366486
168,2450,5400,6300,34020000,2,19606,4903,1,501480000,501480000,7351,2450,4901,2450,0,1,2452,2073989
168,2450,5400,6300,34020000,2,19606,4903,1,501480000,501480000,7351,2450,4901,2450,0,1,2452,2073196
168,2450,5400,6300,34020000,2,19606,4903,1,501480000,501480000,7351,2450,4901,2450,0,1,2452,2075430
168,2450,5400,6300,34020000,2,19606,4903,1,501480000,501480000,7351,2450,4901,2450,0,1,2452,2074765
168,2450,5400,6300,34020000,2,19606,4903,1,501480000,501480000,7351,2450,4901,2450,0,1,2452,2046400
168,2450,5400,6300,34020000,2,19606,4903,1,501480000,501480000,7351,2450,4901,2450,0,1,2452,2047685

168,2850,5400,6300,34020000,2,22806,5703,1,538920000,538920000,8551,2850,5701,2850,0,1,2852,27144061
168,2850,5400,6300,34020000,2,22806,5703,1,538920000,538920000,8551,2850,5701,2850,0,1,2852,2416143
168,2850,5400,6300,34020000,2,22806,5703,1,538920000,538920000,8551,2850,5701,2850,0,1,2852,2414537
168,2850,5400,6300,34020000,2,22806,5703,1,538920000,538920000,8551,2850,5701,2850,0,1,2852,2416928
168,2850,5400,6300,34020000,2,22806,5703,1,538920000,538920000,8551,2850,5701,2850,0,1,2852,2417891
168,2850,5400,6300,34020000,2,22806,5703,1,538920000,538920000,8551,2850,5701,2850,0,1,2852,2355742
168,2850,5400,6300,34020000,2,22806,5703,1,538920000,538920000,8551,2850,5701,2850,0,1,2852,2373207

168,3250,5400,6300,34020000,2,26006,6503,1,576360000,576360000,9751,3250,6501,3250,0,1,3252,33307621
168,3250,5400,6300,34020000,2,26006,6503,1,576360000,576360000,9751,3250,6501,3250,0,1,3252,2754769
168,3250,5400,6300,34020000,2,26006,6503,1,576360000,576360000,9751,3250,6501,3250,0,1,3252,2755812
168,3250,5400,6300,34020000,2,26006,6503,1,576360000,576360000,9751,3250,6501,3250,0,1,3252,2758279
168,3250,5400,6300,34020000,2,26006,6503,1,576360000,576360000,9751,3250,6501,3250,0,1,3252,2733498
168,3250,5400,6300,34020000,2,26006,6503,1,576360000,576360000,9751,3250,6501,3250,0,1,3252,2649450
168,3250,5400,6300,34020000,2,26006,6503,1,576360000,576360000,9751,3250,6501,3250,0,1,3252,2669780

168,3650,5400,6300,34020000,2,29206,7303,1,613800000,613800000,10951,3650,7301,3650,0,1,3652,37672921
168,3650,5400,6300,34020000,2,29206,7303,1,613800000,613800000,10951,3650,7301,3650,0,1,3652,3018998
168,3650,5400,6300,34020000,2,29206,7303,1,613800000,613800000,10951,3650,7301,3650,0,1,3652,3026665
168,3650,5400,6300,34020000,2,29206,7303,1,613800000,613800000,10951,3650,7301,3650,0,1,3652,3027814
168,3650,5400,6300,34020000,2,29206,7303,1,613800000,613800000,10951,3650,7301,3650,0,1,3652,3024349
168,3650,5400,6300,34020000,2,29206,7303,1,613800000,613800000,10951,3650,7301,3650,0,1,3652,2969240
168,3650,5400,6300,34020000,2,29206,7303,1,613800000,613800000,10951,3650,7301,3650,0,1,3652,2967608

168,4050,5400,6300,34020000,2,32406,8103,1,651240000,651240000,12151,4050,8101,4050,0,1,4052,41713466
168,4050,5400,6300,34020000,2,32406,8103,1,651240000,651240000,12151,4050,8101,4050,0,1,4052,3329457
168,4050,5400,6300,34020000,2,32406,8103,1,651240000,651240000,12151,4050,8101,4050,0,1,4052,3339051
168,4050,5400,6300,34020000,2,32406,8103,1,651240000,651240000,12151,4050,8101,4050,0,1,4052,3341834
168,4050,5400,6300,34020000,2,32406,8103,1,651240000,651240000,12151,4050,8101,4050,0,1,4052,3337871
168,4050,5400,6300,34020000,2,32406,8103,1,651240000,651240000,12151,4050,8101,4050,0,1,4052,3262281
168,4050,5400,6300,34020000,2,32406,8103,1,651240000,651240000,12151,4050,8101,4050,0,1,4052,3264530

168,4450,5400,6300,34020000,2,35606,8903,1,688680000,688680000,13351,4450,8901,4450,0,1,4452,47480868
168,4450,5400,6300,34020000,2,35606,8903,1,688680000,688680000,13351,4450,8901,4450,0,1,4452,3589959
168,4450,5400,6300,34020000,2,35606,8903,1,688680000,688680000,13351,4450,8901,4450,0,1,4452,3610399
168,4450,5400,6300,34020000,2,35606,8903,1,688680000,688680000,13351,4450,8901,4450,0,1,4452,3609119
168,4450,5400,6300,34020000,2,35606,8903,1,688680000,688680000,13351,4450,8901,4450,0,1,4452,3601964
168,4450,5400,6300,34020000,2,35606,8903,1,688680000,688680000,13351,4450,8901,4450,0,1,4452,3542584
168,4450,5400,6300,34020000,2,35606,8903,1,688680000,688680000,13351,4450,8901,4450,0,1,4452,3540264

168,4850,5400,6300,34020000,2,38806,9703,1,726120000,726120000,14551,4850,9701,4850,0,1,4852,49260334
168,4850,5400,6300,34020000,2,38806,9703,1,726120000,726120000,14551,4850,9701,4850,0,1,4852,3906526
168,4850,5400,6300,34020000,2,38806,9703,1,726120000,726120000,14551,4850,9701,4850,0,1,4852,3911149
168,4850,5400,6300,34020000,2,38806,9703,1,726120000,726120000,14551,4850,9701,4850,0,1,4852,3912509
168,4850,5400,6300,34020000,2,38806,9703,1,726120000,726120000,14551,4850,9701,4850,0,1,4852,3908628
168,4850,5400,6300,34020000,2,38806,9703,1,726120000,726120000,14551,4850,9701,4850,0,1,4852,3796694
168,4850,5400,6300,34020000,2,38806,9703,1,726120000,726120000,14551,4850,9701,4850,0,1,4852,3805165

168,5250,5400,6300,34020000,2,42006,10503,1,763560000,763560000,15751,5250,10501,5250,0,1,5252,53385793
168,5250,5400,6300,34020000,2,42006,10503,1,763560000,763560000,15751,5250,10501,5250,0,1,5252,4176884
168,5250,5400,6300,34020000,2,42006,10503,1,763560000,763560000,15751,5250,10501,5250,0,1,5252,4174675
168,5250,5400,6300,34020000,2,42006,10503,1,763560000,763560000,15751,5250,10501,5250,0,1,5252,4179474
168,5250,5400,6300,34020000,2,42006,10503,1,763560000,763560000,15751,5250,10501,5250,0,1,5252,4178055
168,5250,5400,6300,34020000,2,42006,10503,1,763560000,763560000,15751,5250,10501,5250,0,1,5252,4038196
168,5250,5400,6300,34020000,2,42006,10503,1,763560000,763560000,15751,5250,10501,5250,0,1,5252,4067034

168,5650,5400,6300,34020000,2,45206,11303,1,801000000,801000000,16951,5650,11301,5650,0,1,5652,54939090
168,5650,5400,6300,34020000,2,45206,11303,1,801000000,801000000,16951,5650,11301,5650,0,1,5652,4523982
168,5650,5400,6300,34020000,2,45206,11303,1,801000000,801000000,16951,5650,11301,5650,0,1,5652,4517885
168,5650,5400,6300,34020000,2,45206,11303,1,801000000,801000000,16951,5650,11301,5650,0,1,5652,4529045
168,5650,5400,6300,34020000,2,45206,11303,1,801000000,801000000,16951,5650,11301,5650,0,1,5652,4527519
168,5650,5400,6300,34020000,2,45206,11303,1,801000000,801000000,16951,5650,11301,5650,0,1,5652,4375861
168,5650,5400,6300,34020000,2,45206,11303,1,801000000,801000000,16951,5650,11301,5650,0,1,5652,4400623

168,6050,5400,6300,34020000,2,48406,12103,1,838440000,838440000,18151,6050,12101,6050,0,1,6052,64136340
168,6050,5400,6300,34020000,2,48406,12103,1,838440000,838440000,18151,6050,12101,6050,0,1,6052,4787054
168,6050,5400,6300,34020000,2,48406,12103,1,838440000,838440000,18151,6050,12101,6050,0,1,6052,4778053
168,6050,5400,6300,34020000,2,48406,12103,1,838440000,838440000,18151,6050,12101,6050,0,1,6052,4792092
168,6050,5400,6300,34020000,2,48406,12103,1,838440000,838440000,18151,6050,12101,6050,0,1,6052,4788554
168,6050,5400,6300,34020000,2,48406,12103,1,838440000,838440000,18151,6050,12101,6050,0,1,6052,4646064
168,6050,5400,6300,34020000,2,48406,12103,1,838440000,838440000,18151,6050,12101,6050,0,1,6052,4652915

168,6450,5400,6300,34020000,2,51606,12903,1,875880000,875880000,19351,6450,12901,6450,0,1,6452,66862946
168,6450,5400,6300,34020000,2,51606,12903,1,875880000,875880000,19351,6450,12901,6450,0,1,6452,5041513
168,6450,5400,6300,34020000,2,51606,12903,1,875880000,875880000,19351,6450,12901,6450,0,1,6452,5056926
168,6450,5400,6300,34020000,2,51606,12903,1,875880000,875880000,19351,6450,12901,6450,0,1,6452,5064783
168,6450,5400,6300,34020000,2,51606,12903,1,875880000,875880000,19351,6450,12901,6450,0,1,6452,5063133
168,6450,5400,6300,34020000,2,51606,12903,1,875880000,875880000,19351,6450,12901,6450,0,1,6452,4929940
168,6450,5400,6300,34020000,2,51606,12903,1,875880000,875880000,19351,6450,12901,6450,0,1,6452,4926765

168,6850,5400,6300,34020000,2,54806,13703,1,913320000,913320000,20551,6850,13701,6850,0,1,6852,70635151
168,6850,5400,6300,34020000,2,54806,13703,1,913320000,913320000,20551,6850,13701,6850,0,1,6852,5356575
168,6850,5400,6300,34020000,2,54806,13703,1,913320000,913320000,20551,6850,13701,6850,0,1,6852,5359025
168,6850,5400,6300,34020000,2,54806,13703,1,913320000,913320000,20551,6850,13701,6850,0,1,6852,5360504
168,6850,5400,6300,34020000,2,54806,13703,1,913320000,913320000,20551,6850,13701,6850,0,1,6852,5357753
168,6850,5400,6300,34020000,2,54806,13703,1,913320000,913320000,20551,6850,13701,6850,0,1,6852,5211434
168,6850,5400,6300,34020000,2,54806,13703,1,913320000,913320000,20551,6850,13701,6850,0,1,6852,5208443

168,50,5400,5900,31860000,2,406,103,1,259400000,259400000,151,50,101,50,0,1,52,364577
168,50,5400,5900,31860000,2,406,103,1,259400000,259400000,151,50,101,50,0,1,52,332364
168,50,5400,5900,31860000,2,406,103,1,259400000,259400000,151,50,101,50,0,1,52,291504
168,50,5400,5900,31860000,2,406,103,1,259400000,259400000,151,50,101,50,0,1,52,320573
168,50,5400,5900,31860000,2,406,103,1,259400000,259400000,151,50,101,50,0,1,52,331594
168,50,5400,5900,31860000,2,406,103,1,259400000,259400000,151,50,101,50,0,1,52,346246
168,50,5400,5900,31860000,2,406,103,1,259400000,259400000,151,50,101,50,0,1,52,346628

168,450,5400,5900,31860000,2,3606,903,1,295560000,295560000,1351,450,901,450,0,1,452,3321314
168,450,5400,5900,31860000,2,3606,903,1,295560000,295560000,1351,450,901,450,0,1,452,627112
168,450,5400,5900,31860000,2,3606,903,1,295560000,295560000,1351,450,901,450,0,1,452,625868
168,450,5400,5900,31860000,2,3606,903,1,295560000,295560000,1351,450,901,450,0,1,452,623293
168,450,5400,5900,31860000,2,3606,903,1,295560000,295560000,1351,450,901,450,0,1,452,628151
168,450,5400,5900,31860000,2,3606,903,1,295560000,295560000,1351,450,901,450,0,1,452,635246
168,450,5400,5900,31860000,2,3606,903,1,295560000,295560000,1351,450,901,450,0,1,452,634816

168,850,5400,5900,31860000,2,6806,1703,1,331720000,331720000,2551,850,1701,850,0,1,852,7062748
168,850,5400,5900,31860000,2,6806,1703,1,331720000,331720000,2551,850,1701,850,0,1,852,878057
168,850,5400,5900,31860000,2,6806,1703,1,331720000,331720000,2551,850,1701,850,0,1,852,879228
168,850,5400,5900,31860000,2,6806,1703,1,331720000,331720000,2551,850,1701,850,0,1,852,880493
168,850,5400,5900,31860000,2,6806,1703,1,331720000,331720000,2551,850,1701,850,0,1,852,880154
168,850,5400,5900,31860000,2,6806,1703,1,331720000,331720000,2551,850,1701,850,0,1,852,881190
168,850,5400,5900,31860000,2,6806,1703,1,331720000,331720000,2551,850,1701,850,0,1,852,881664

168,1250,5400,5900,31860000,2,10006,2503,1,367880000,367880000,3751,1250,2501,1250,0,1,1252,10655899
168,1250,5400,5900,31860000,2,10006,2503,1,367880000,367880000,3751,1250,2501,1250,0,1,1252,1146201
168,1250,5400,5900,31860000,2,10006,2503,1,367880000,367880000,3751,1250,2501,1250,0,1,1252,1146706
168,1250,5400,5900,31860000,2,10006,2503,1,367880000,367880000,3751,1250,2501,1250,0,1,1252,1147353
168,1250,5400,5900,31860000,2,10006,2503,1,367880000,367880000,3751,1250,2501,1250,0,1,1252,1145026
168,1250,5400,5900,31860000,2,10006,2503,1,367880000,367880000,3751,1250,2501,1250,0,1,1252,1137206
168,1250,5400,5900,31860000,2,10006,2503,1,367880000,367880000,3751,1250,2501,1250,0,1,1252,1138208

168,1650,5400,5900,31860000,2,13206,3303,1,404040000,404040000,4951,1650,3301,1650,0,1,1652,14228758
168,1650,5400,5900,31860000,2,13206,3303,1,404040000,404040000,4951,1650,3301,1650,0,1,1652,1405947
168,1650,5400,5900,31860000,2,13206,3303,1,404040000,404040000,4951,1650,3301,1650,0,1,1652,1408724
168,1650,5400,5900,31860000,2,13206,3303,1,404040000,404040000,4951,1650,3301,1650,0,1,1652,1409151
168,1650,5400,5900,31860000,2,13206,3303,1,404040000,404040000,4951,1650,3301,1650,0,1,1652,1409639
168,1650,5400,5900,31860000,2,13206,3303,1,404040000,404040000,4951,1650,3301,1650,0,1,1652,1407474
168,1650,5400,5900,31860000,2,13206,3303,1,404040000,404040000,4951,1650,3301,1650,0,1,1652,1408159

168,2050,5400,5900,31860000,2,16406,4103,1,440200000,440200000,6151,2050,4101,2050,0,1,2052,18438215
168,2050,5400,5900,31860000,2,16406,4103,1,440200000,440200000,6151,2050,4101,2050,0,1,2052,1701553
168,2050,5400,5900,31860000,2,16406,4103,1,440200000,440200000,6151,2050,4101,2050,0,1,2052,1717313
168,2050,5400,5900,31860000,2,16406,4103,1,440200000,440200000,6151,2050,4101,2050,0,1,2052,1718139
168,2050,5400,5900,31860000,2,16406,4103,1,440200000,440200000,6151,2050,4101,2050,0,1,2052,1708932
168,2050,5400,5900,31860000,2,16406,4103,1,440200000,440200000,6151,2050,4101,2050,0,1,2052,1693241
168,2050,5400,5900,31860000,2,16406,4103,1,440200000,440200000,6151,2050,4101,2050,0,1,2052,1691955

168,2450,5400,5900,31860000,2,19606,4903,1,476360000,476360000,7351,2450,4901,2450,0,1,2452,20511466
168,2450,5400,5900,31860000,2,19606,4903,1,476360000,476360000,7351,2450,4901,2450,0,1,2452,1954880
168,2450,5400,5900,31860000,2,19606,4903,1,476360000,476360000,7351,2450,4901,2450,0,1,2452,1950755
168,2450,5400,5900,31860000,2,19606,4903,1,476360000,476360000,7351,2450,4901,2450,0,1,2452,1955553
168,2450,5400,5900,31860000,2,19606,4903,1,476360000,476360000,7351,2450,4901,2450,0,1,2452,1954015
168,2450,5400,5900,31860000,2,19606,4903,1,476360000,476360000,7351,2450,4901,2450,0,1,2452,1936499
168,2450,5400,5900,31860000,2,19606,4903,1,476360000,476360000,7351,2450,4901,2450,0,1,2452,1937789

168,2850,5400,5900,31860000,2,22806,5703,1,512520000,512520000,8551,2850,5701,2850,0,1,2852,26126083
168,2850,5400,5900,31860000,2,22806,5703,1,512520000,512520000,8551,2850,5701,2850,0,1,2852,2280853
168,2850,5400,5900,31860000,2,22806,5703,1,512520000,512520000,8551,2850,5701,2850,0,1,2852,2272886
168,2850,5400,5900,31860000,2,22806,5703,1,512520000,512520000,8551,2850,5701,2850,0,1,2852,2279723
168,2850,5400,5900,31860000,2,22806,5703,1,512520000,512520000,8551,2850,5701,2850,0,1,2852,2261739
168,2850,5400,5900,31860000,2,22806,5703,1,512520000,512520000,8551,2850,5701,2850,0,1,2852,2238703
168,2850,5400,5900,31860000,2,22806,5703,1,512520000,512520000,8551,2850,5701,2850,0,1,2852,2234542

168,3250,5400,5900,31860000,2,26006,6503,1,548680000,548680000,9751,3250,6501,3250,0,1,3252,29506154
168,3250,5400,5900,31860000,2,26006,6503,1,548680000,548680000,9751,3250,6501,3250,0,1,3252,2554216
168,3250,5400,5900,31860000,2,26006,6503,1,548680000,548680000,9751,3250,6501,3250,0,1,3252,2550496
168,3250,5400,5900,31860000,2,26006,6503,1,548680000,548680000,9751,3250,6501,3250,0,1,3252,2552291
168,3250,5400,5900,31860000,2,26006,6503,1,548680000,548680000,9751,3250,6501,3250,0,1,3252,2555264
168,3250,5400,5900,31860000,2,26006,6503,1,548680000,548680000,9751,3250,6501,3250,0,1,3252,2521672
168,3250,5400,5900,31860000,2,26006,6503,1,548680000,548680000,9751,3250,6501,3250,0,1,3252,2519820

168,3650,5400,5900,31860000,2,29206,7303,1,584840000,584840000,10951,3650,7301,3650,0,1,3652,34413344
168,3650,5400,5900,31860000,2,29206,7303,1,584840000,584840000,10951,3650,7301,3650,0,1,3652,2792840
168,3650,5400,5900,31860000,2,29206,7303,1,584840000,584840000,10951,3650,7301,3650,0,1,3652,2791944
168,3650,5400,5900,31860000,2,29206,7303,1,584840000,584840000,10951,3650,7301,3650,0,1,3652,2793978
168,3650,5400,5900,31860000,2,29206,7303,1,584840000,584840000,10951,3650,7301,3650,0,1,3652,2790179
168,3650,5400,5900,31860000,2,29206,7303,1,584840000,584840000,10951,3650,7301,3650,0,1,3652,2742364
168,3650,5400,5900,31860000,2,29206,7303,1,584840000,584840000,10951,3650,7301,3650,0,1,3652,2743978

168,4050,5400,5900,31860000,2,32406,8103,1,621000000,621000000,12151,4050,8101,4050,0,1,4052,38807306
168,4050,5400,5900,31860000,2,32406,8103,1,621000000,621000000,12151,4050,8101,4050,0,1,4052,3110881
168,4050,5400,5900,31860000,2,32406,8103,1,621000000,621000000,12151,4050,8101,4050,0,1,4052,3114673
168,4050,5400,5900,31860000,2,32406,8103,1,621000000,621000000,12151,4050,8101,4050,0,1,4052,3117370
168,4050,5400,5900,31860000,2,32406,8103,1,621000000,621000000,12151,4050,8101,4050,0,1,4052,3113315
168,4050,5400,5900,31860000,2,32406,8103,1,621000000,621000000,12151,4050,8101,4050,0,1,4052,3059644
168,4050,5400,5900,31860000,2,32406,8103,1,621000000,621000000,12151,4050,8101,4050,0,1,4052,3057621

168,4450,5400,5900,31860000,2,35606,8903,1,657160000,657160000,13351,4450,8901,4450,0,1,4452,42300678
168,4450,5400,5900,31860000,2,35606,8903,1,657160000,657160000,13351,4450,8901,4450,0,1,4452,3415903
168,4450,5400,5900,31860000,2,35606,8903,1,657160000,657160000,13351,4450,8901,4450,0,1,4452,3408842
168,4450,5400,5900,31860000,2,35606,8903,1,657160000,657160000,13351,4450,8901,4450,0,1,4452,3418800
168,4450,5400,5900,31860000,2,35606,8903,1,657160000,657160000,13351,4450,8901,4450,0,1,4452,3414680
168,4450,5400,5900,31860000,2,35606,8903,1,657160000,657160000,13351,4450,8901,4450,0,1,4452,3295265
168,4450,5400,5900,31860000,2,35606,8903,1,657160000,657160000,13351,4450,8901,4450,0,1,4452,3320720

168,4850,5400,5900,31860000,2,38806,9703,1,693320000,693320000,14551,4850,9701,4850,0,1,4852,45807916
168,4850,5400,5900,31860000,2,38806,9703,1,693320000,693320000,14551,4850,9701,4850,0,1,4852,3656116
168,4850,5400,5900,31860000,2,38806,9703,1,693320000,693320000,14551,4850,9701,4850,0,1,4852,3661031
168,4850,5400,5900,31860000,2,38806,9703,1,693320000,693320000,14551,4850,9701,4850,0,1,4852,3662367
168,4850,5400,5900,31860000,2,38806,9703,1,693320000,693320000,14551,4850,9701,4850,0,1,4852,3658540
168,4850,5400,5900,31860000,2,38806,9703,1,693320000,693320000,14551,4850,9701,4850,0,1,4852,3577232
168,4850,5400,5900,31860000,2,38806,9703,1,693320000,693320000,14551,4850,9701,4850,0,1,4852,3579238

168,5250,5400,5900,31860000,2,42006,10503,1,729480000,729480000,15751,5250,10501,5250,0,1,5252,49273092
168,5250,5400,5900,31860000,2,42006,10503,1,729480000,729480000,15751,5250,10501,5250,0,1,5252,3969894
168,5250,5400,5900,31860000,2,42006,10503,1,729480000,729480000,15751,5250,10501,5250,0,1,5252,3958542
168,5250,5400,5900,31860000,2,42006,10503,1,729480000,729480000,15751,5250,10501,5250,0,1,5252,3973274
168,5250,5400,5900,31860000,2,42006,10503,1,729480000,729480000,15751,5250,10501,5250,0,1,5252,3967567
168,5250,5400,5900,31860000,2,42006,10503,1,729480000,729480000,15751,5250,10501,5250,0,1,5252,3816205
168,5250,5400,5900,31860000,2,42006,10503,1,729480000,729480000,15751,5250,10501,5250,0,1,5252,3854276

168,5650,5400,5900,31860000,2,45206,11303,1,765640000,765640000,16951,5650,11301,5650,0,1,5652,52553507
168,5650,5400,5900,31860000,2,45206,11303,1,765640000,765640000,16951,5650,11301,5650,0,1,5652,4240496
168,5650,5400,5900,31860000,2,45206,11303,1,765640000,765640000,16951,5650,11301,5650,0,1,5652,4224833
168,5650,5400,5900,31860000,2,45206,11303,1,765640000,765640000,16951,5650,11301,5650,0,1,5652,4244029
168,5650,5400,5900,31860000,2,45206,11303,1,765640000,765640000,16951,5650,11301,5650,0,1,5652,4238110
168,5650,5400,5900,31860000,2,45206,11303,1,765640000,765640000,16951,5650,11301,5650,0,1,5652,4137953
168,5650,5400,5900,31860000,2,45206,11303,1,765640000,765640000,16951,5650,11301,5650,0,1,5652,4141072

168,6050,5400,5900,31860000,2,48406,12103,1,801800000,801800000,18151,6050,12101,6050,0,1,6052,58265362
168,6050,5400,5900,31860000,2,48406,12103,1,801800000,801800000,18151,6050,12101,6050,0,1,6052,4493601
168,6050,5400,5900,31860000,2,48406,12103,1,801800000,801800000,18151,6050,12101,6050,0,1,6052,4485923
168,6050,5400,5900,31860000,2,48406,12103,1,801800000,801800000,18151,6050,12101,6050,0,1,6052,4495363
168,6050,5400,5900,31860000,2,48406,12103,1,801800000,801800000,18151,6050,12101,6050,0,1,6052,4491026
168,6050,5400,5900,31860000,2,48406,12103,1,801800000,801800000,18151,6050,12101,6050,0,1,6052,4334230
168,6050,5400,5900,31860000,2,48406,12103,1,801800000,801800000,18151,6050,12101,6050,0,1,6052,4373212

168,6450,5400,5900,31860000,2,51606,12903,1,837960000,837960000,19351,6450,12901,6450,0,1,6452,61580063
168,6450,5400,5900,31860000,2,51606,12903,1,837960000,837960000,19351,6450,12901,6450,0,1,6452,4777869
168,6450,5400,5900,31860000,2,51606,12903,1,837960000,837960000,19351,6450,12901,6450,0,1,6452,4762914
168,6450,5400,5900,31860000,2,51606,12903,1,837960000,837960000,19351,6450,12901,6450,0,1,6452,4784897
168,6450,5400,5900,31860000,2,51606,12903,1,837960000,837960000,19351,6450,12901,6450,0,1,6452,4779438
168,6450,5400,5900,31860000,2,51606,12903,1,837960000,837960000,19351,6450,12901,6450,0,1,6452,4668671
168,6450,5400,5900,31860000,2,51606,12903,1,837960000,837960000,19351,6450,12901,6450,0,1,6452,4674979

168,6850,5400,5900,31860000,2,54806,13703,1,874120000,874120000,20551,6850,13701,6850,0,1,6852,67030115
168,6850,5400,5900,31860000,2,54806,13703,1,874120000,874120000,20551,6850,13701,6850,0,1,6852,5038473
168,6850,5400,5900,31860000,2,54806,13703,1,874120000,874120000,20551,6850,13701,6850,0,1,6852,5035126
168,6850,5400,5900,31860000,2,54806,13703,1,874120000,874120000,20551,6850,13701,6850,0,1,6852,5036749
168,6850,5400,5900,31860000,2,54806,13703,1,874120000,874120000,20551,6850,13701,6850,0,1,6852,5025494
168,6850,5400,5900,31860000,2,54806,13703,1,874120000,874120000,20551,6850,13701,6850,0,1,6852,4950275
168,6850,5400,5900,31860000,2,54806,13703,1,874120000,874120000,20551,6850,13701,6850,0,1,6852,4947305

168,50,5400,5500,29700000,2,406,103,1,241960000,241960000,151,50,101,50,0,1,52,328058
168,50,5400,5500,29700000,2,406,103,1,241960000,241960000,151,50,101,50,0,1,52,273405
168,50,5400,5500,29700000,2,406,103,1,241960000,241960000,151,50,101,50,0,1,52,255587
168,50,5400,5500,29700000,2,406,103,1,241960000,241960000,151,50,101,50,0,1,52,275659
168,50,5400,5500,29700000,2,406,103,1,241960000,241960000,151,50,101,50,0,1,52,276437
168,50,5400,5500,29700000,2,406,103,1,241960000,241960000,151,50,101,50,0,1,52,305663
168,50,5400,5500,29700000,2,406,103,1,241960000,241960000,151,50,101,50,0,1,52,306042

168,450,5400,5500,29700000,2,3606,903,1,276840000,276840000,1351,450,901,450,0,1,452,3054463
168,450,5400,5500,29700000,2,3606,903,1,276840000,276840000,1351,450,901,450,0,1,452,579709
168,450,5400,5500,29700000,2,3606,903,1,276840000,276840000,1351,450,901,450,0,1,452,578724
168,450,5400,5500,29700000,2,3606,903,1,276840000,276840000,1351,450,901,450,0,1,452,575834
168,450,5400,5500,29700000,2,3606,903,1,276840000,276840000,1351,450,901,450,0,1,452,580220
168,450,5400,5500,29700000,2,3606,903,1,276840000,276840000,1351,450,901,450,0,1,452,592624
168,450,5400,5500,29700000,2,3606,903,1,276840000,276840000,1351,450,901,450,0,1,452,592200

168,850,5400,5500,29700000,2,6806,1703,1,311720000,311720000,2551,850,1701,850,0,1,852,6413511
168,850,5400,5500,29700000,2,6806,1703,1,311720000,311720000,2551,850,1701,850,0,1,852,817709
168,850,5400,5500,29700000,2,6806,1703,1,311720000,311720000,2551,850,1701,850,0,1,852,816683
168,850,5400,5500,29700000,2,6806,1703,1,311720000,311720000,2551,850,1701,850,0,1,852,817091
168,850,5400,5500,29700000,2,6806,1703,1,311720000,311720000,2551,850,1701,850,0,1,852,816181
168,850,5400,5500,29700000,2,6806,1703,1,311720000,311720000,2551,850,1701,850,0,1,852,820630
168,850,5400,5500,29700000,2,6806,1703,1,311720000,311720000,2551,850,1701,850,0,1,852,821101

168,1250,5400,5500,29700000,2,10006,2503,1,346600000,346600000,3751,1250,2501,1250,0,1,1252,10019576
168,1250,5400,5500,29700000,2,10006,2503,1,346600000,346600000,3751,1250,2501,1250,0,1,1252,1055649
168,1250,5400,5500,29700000,2,10006,2503,1,346600000,346600000,3751,1250,2501,1250,0,1,1252,987192
168,1250,5400,5500,29700000,2,10006,2503,1,346600000,346600000,3751,1250,2501,1250,0,1,1252,1067578
168,1250,5400,5500,29700000,2,10006,2503,1,346600000,346600000,3751,1250,2501,1250,0,1,1252,1066451
168,1250,5400,5500,29700000,2,10006,2503,1,346600000,346600000,3751,1250,2501,1250,0,1,1252,1068192
168,1250,5400,5500,29700000,2,10006,2503,1,346600000,346600000,3751,1250,2501,1250,0,1,1252,1068717

168,1650,5400,5500,29700000,2,13206,3303,1,381480000,381480000,4951,1650,3301,1650,0,1,1652,13357397
168,1650,5400,5500,29700000,2,13206,3303,1,381480000,381480000,4951,1650,3301,1650,0,1,1652,1323128
168,1650,5400,5500,29700000,2,13206,3303,1,381480000,381480000,4951,1650,3301,1650,0,1,1652,1261762
168,1650,5400,5500,29700000,2,13206,3303,1,381480000,381480000,4951,1650,3301,1650,0,1,1652,1316703
168,1650,5400,5500,29700000,2,13206,3303,1,381480000,381480000,4951,1650,3301,1650,0,1,1652,1322385
168,1650,5400,5500,29700000,2,13206,3303,1,381480000,381480000,4951,1650,3301,1650,0,1,1652,1311684
168,1650,5400,5500,29700000,2,13206,3303,1,381480000,381480000,4951,1650,3301,1650,0,1,1652,1312686

168,2050,5400,5500,29700000,2,16406,4103,1,416360000,416360000,6151,2050,4101,2050,0,1,2052,16884511
168,2050,5400,5500,29700000,2,16406,4103,1,416360000,416360000,6151,2050,4101,2050,0,1,2052,1600141
168,2050,5400,5500,29700000,2,16406,4103,1,416360000,416360000,6151,2050,4101,2050,0,1,2052,1581786
168,2050,5400,5500,29700000,2,16406,4103,1,416360000,416360000,6151,2050,4101,2050,0,1,2052,1602896
168,2050,5400,5500,29700000,2,16406,4103,1,416360000,416360000,6151,2050,4101,2050,0,1,2052,1601078
168,2050,5400,5500,29700000,2,16406,4103,1,416360000,416360000,6151,2050,4101,2050,0,1,2052,1593327
168,2050,5400,5500,29700000,2,16406,4103,1,416360000,416360000,6151,2050,4101,2050,0,1,2052,1592422

168,2450,5400,5500,29700000,2,19606,4903,1,451240000,451240000,7351,2450,4901,2450,0,1,2452,20587484
168,2450,5400,5500,29700000,2,19606,4903,1,451240000,451240000,7351,2450,4901,2450,0,1,2452,1824345
168,2450,5400,5500,29700000,2,19606,4903,1,451240000,451240000,7351,2450,4901,2450,0,1,2452,1825109
168,2450,5400,5500,29700000,2,19606,4903,1,451240000,451240000,7351,2450,4901,2450,0,1,2452,1825769
168,2450,5400,5500,29700000,2,19606,4903,1,451240000,451240000,7351,2450,4901,2450,0,1,2452,1823558
168,2450,5400,5500,29700000,2,19606,4903,1,451240000,451240000,7351,2450,4901,2450,0,1,2452,1816463
168,2450,5400,5500,29700000,2,19606,4903,1,451240000,451240000,7351,2450,4901,2450,0,1,2452,1817161

168,2850,5400,5500,29700000,2,22806,5703,1,486120000,486120000,8551,2850,5701,2850,0,1,2852,24687542
168,2850,5400,5500,29700000,2,22806,5703,1,486120000,486120000,8551,2850,5701,2850,0,1,2852,2114539
168,2850,5400,5500,29700000,2,22806,5703,1,486120000,486120000,8551,2850,5701,2850,0,1,2852,2120164
168,2850,5400,5500,29700000,2,22806,5703,1,486120000,486120000,8551,2850,5701,2850,0,1,2852,2121137
168,2850,5400,5500,29700000,2,22806,5703,1,486120000,486120000,8551,2850,5701,2850,0,1,2852,2113344
168,2850,5400,5500,29700000,2,22806,5703,1,486120000,486120000,8551,2850,5701,2850,0,1,2852,2089916
168,2850,5400,5500,29700000,2,22806,5703,1,486120000,486120000,8551,2850,5701,2850,0,1,2852,2091534

168,3250,5400,5500,29700000,2,26006,6503,1,521000000,521000000,9751,3250,6501,3250,0,1,3252,28909220
168,3250,5400,5500,29700000,2,26006,6503,1,521000000,521000000,9751,3250,6501,3250,0,1,3252,2348692
168,3250,5400,5500,29700000,2,26006,6503,1,521000000,521000000,9751,3250,6501,3250,0,1,3252,2349730
168,3250,5400,5500,29700000,2,26006,6503,1,521000000,521000000,9751,3250,6501,3250,0,1,3252,2350776
168,3250,5400,5500,29700000,2,26006,6503,1,521000000,521000000,9751,3250,6501,3250,0,1,3252,2346356
168,3250,5400,5500,29700000,2,26006,6503,1,521000000,521000000,9751,3250,6501,3250,0,1,3252,2316506
168,3250,5400,5500,29700000,2,26006,6503,1,521000000,521000000,9751,3250,6501,3250,0,1,3252,2318072

168,3650,5400,5500,29700000,2,29206,7303,1,555880000,555880000,10951,3650,7301,3650,0,1,3652,31204052
168,3650,5400,5500,29700000,2,29206,7303,1,555880000,555880000,10951,3650,7301,3650,0,1,3652,2636128
168,3650,5400,5500,29700000,2,29206,7303,1,555880000,555880000,10951,3650,7301,3650,0,1,3652,2647183
168,3650,5400,5500,29700000,2,29206,7303,1,555880000,555880000,10951,3650,7301,3650,0,1,3652,2646062
168,3650,5400,5500,29700000,2,29206,7303,1,555880000,555880000,10951,3650,7301,3650,0,1,3652,2642604
168,3650,5400,5500,29700000,2,29206,7303,1,555880000,555880000,10951,3650,7301,3650,0,1,3652,2585429
168,3650,5400,5500,29700000,2,29206,7303,1,555880000,555880000,10951,3650,7301,3650,0,1,3652,2608005

168,4050,5400,5500,29700000,2,32406,8103,1,590760000,590760000,12151,4050,8101,4050,0,1,4052,36814642
168,4050,5400,5500,29700000,2,32406,8103,1,590760000,590760000,12151,4050,8101,4050,0,1,4052,2917688
168,4050,5400,5500,29700000,2,32406,8103,1,590760000,590760000,12151,4050,8101,4050,0,1,4052,2919029
168,4050,5400,5500,29700000,2,32406,8103,1,590760000,590760000,12151,4050,8101,4050,0,1,4052,2921651
168,4050,5400,5500,29700000,2,32406,8103,1,590760000,590760000,12151,4050,8101,4050,0,1,4052,2915397
168,4050,5400,5500,29700000,2,32406,8103,1,590760000,590760000,12151,4050,8101,4050,0,1,4052,2868495
168,4050,5400,5500,29700000,2,32406,8103,1,590760000,590760000,12151,4050,8101,4050,0,1,4052,2866330

168,4450,5400,5500,29700000,2,35606,8903,1,625640000,625640000,13351,4450,8901,4450,0,1,4452,38714203
168,4450,5400,5500,29700000,2,35606,8903,1,625640000,625640000,13351,4450,8901,4450,0,1,4452,3184129
168,4450,5400,5500,29700000,2,35606,8903,1,625640000,625640000,13351,4450,8901,4450,0,1,4452,3174054
168,4450,5400,5500,29700000,2,35606,8903,1,625640000,625640000,13351,4450,8901,4450,0,1,4452,3190211
168,4450,5400,5500,29700000,2,35606,8903,1,625640000,625640000,13351,4450,8901,4450,0,1,4452,3188943
168,4450,5400,5500,29700000,2,35606,8903,1,625640000,625640000,13351,4450,8901,4450,0,1,4452,3130840
168,4450,5400,5500,29700000,2,35606,8903,1,625640000,625640000,13351,4450,8901,4450,0,1,4452,3128433

168,4850,5400,5500,29700000,2,38806,9703,1,660520000,660520000,14551,4850,9701,4850,0,1,4852,42364797
168,4850,5400,5500,29700000,2,38806,9703,1,660520000,660520000,14551,4850,9701,4850,0,1,4852,3446621
168,4850,5400,5500,29700000,2,38806,9703,1,660520000,660520000,14551,4850,9701,4850,0,1,4852,3458610
168,4850,5400,5500,29700000,2,38806,9703,1,660520000,660520000,14551,4850,9701,4850,0,1,4852,3461494
168,4850,5400,5500,29700000,2,38806,9703,1,660520000,660520000,14551,4850,9701,4850,0,1,4852,3454273
168,4850,5400,5500,29700000,2,38806,9703,1,660520000,660520000,14551,4850,9701,4850,0,1,4852,3379456
168,4850,5400,5500,29700000,2,38806,9703,1,660520000,660520000,14551,4850,9701,4850,0,1,4852,3382249

168,5250,5400,5500,29700000,2,42006,10503,1,695400000,695400000,15751,5250,10501,5250,0,1,5252,45781466
168,5250,5400,5500,29700000,2,42006,10503,1,695400000,695400000,15751,5250,10501,5250,0,1,5252,3679786
168,5250,5400,5500,29700000,2,42006,10503,1,695400000,695400000,15751,5250,10501,5250,0,1,5252,3674252
168,5250,5400,5500,29700000,2,42006,10503,1,695400000,695400000,15751,5250,10501,5250,0,1,5252,3678370
168,5250,5400,5500,29700000,2,42006,10503,1,695400000,695400000,15751,5250,10501,5250,0,1,5252,3676875
168,5250,5400,5500,29700000,2,42006,10503,1,695400000,695400000,15751,5250,10501,5250,0,1,5252,3574684
168,5250,5400,5500,29700000,2,42006,10503,1,695400000,695400000,15751,5250,10501,5250,0,1,5252,3570275

168,5650,5400,5500,29700000,2,45206,11303,1,730280000,730280000,16951,5650,11301,5650,0,1,5652,48635696
168,5650,5400,5500,29700000,2,45206,11303,1,730280000,730280000,16951,5650,11301,5650,0,1,5652,3953518
168,5650,5400,5500,29700000,2,45206,11303,1,730280000,730280000,16951,5650,11301,5650,0,1,5652,3949120
168,5650,5400,5500,29700000,2,45206,11303,1,730280000,730280000,16951,5650,11301,5650,0,1,5652,3955007
168,5650,5400,5500,29700000,2,45206,11303,1,730280000,730280000,16951,5650,11301,5650,0,1,5652,3944327
168,5650,5400,5500,29700000,2,45206,11303,1,730280000,730280000,16951,5650,11301,5650,0,1,5652,3854007
168,5650,5400,5500,29700000,2,45206,11303,1,730280000,730280000,16951,5650,11301,5650,0,1,5652,3851378

168,6050,5400,5500,29700000,2,48406,12103,1,765160000,765160000,18151,6050,12101,6050,0,1,6052,52758382
168,6050,5400,5500,29700000,2,48406,12103,1,765160000,765160000,18151,6050,12101,6050,0,1,6052,4209582
168,6050,5400,5500,29700000,2,48406,12103,1,765160000,765160000,18151,6050,12101,6050,0,1,6052,4203903
168,6050,5400,5500,29700000,2,48406,12103,1,765160000,765160000,18151,6050,12101,6050,0,1,6052,4208012
168,6050,5400,5500,29700000,2,48406,12103,1,765160000,765160000,18151,6050,12101,6050,0,1,6052,4202173
168,6050,5400,5500,29700000,2,48406,12103,1,765160000,765160000,18151,6050,12101,6050,0,1,6052,4105227
168,6050,5400,5500,29700000,2,48406,12103,1,765160000,765160000,18151,6050,12101,6050,0,1,6052,4108034

168,6450,5400,5500,29700000,2,51606,12903,1,800040000,800040000,19351,6450,12901,6450,0,1,6452,56922564
168,6450,5400,5500,29700000,2,51606,12903,1,800040000,800040000,19351,6450,12901,6450,0,1,6452,4501597
168,6450,5400,5500,29700000,2,51606,12903,1,800040000,800040000,19351,6450,12901,6450,0,1,6452,4496264
168,6450,5400,5500,29700000,2,51606,12903,1,800040000,800040000,19351,6450,12901,6450,0,1,6452,4506074
168,6450,5400,5500,29700000,2,51606,12903,1,800040000,800040000,19351,6450,12901,6450,0,1,6452,4504237
168,6450,5400,5500,29700000,2,51606,12903,1,800040000,800040000,19351,6450,12901,6450,0,1,6452,4332554
168,6450,5400,5500,29700000,2,51606,12903,1,800040000,800040000,19351,6450,12901,6450,0,1,6452,4368638

168,6850,5400,5500,29700000,2,54806,13703,1,834920000,834920000,20551,6850,13701,6850,0,1,6852,62092776
168,6850,5400,5500,29700000,2,54806,13703,1,834920000,834920000,20551,6850,13701,6850,0,1,6852,4715691
168,6850,5400,5500,29700000,2,54806,13703,1,834920000,834920000,20551,6850,13701,6850,0,1,6852,4723484
168,6850,5400,5500,29700000,2,54806,13703,1,834920000,834920000,20551,6850,13701,6850,0,1,6852,4725212
168,6850,5400,5500,29700000,2,54806,13703,1,834920000,834920000,20551,6850,13701,6850,0,1,6852,4722069
168,6850,5400,5500,29700000,2,54806,13703,1,834920000,834920000,20551,6850,13701,6850,0,1,6852,4594845
168,6850,5400,5500,29700000,2,54806,13703,1,834920000,834920000,20551,6850,13701,6850,0,1,6852,4586416

168,50,5400,5100,27540000,2,406,103,1,224520000,224520000,151,50,101,50,0,1,52,311246
168,50,5400,5100,27540000,2,406,103,1,224520000,224520000,151,50,101,50,0,1,52,280784
168,50,5400,5100,27540000,2,406,103,1,224520000,224520000,151,50,101,50,0,1,52,254995
168,50,5400,5100,27540000,2,406,103,1,224520000,224520000,151,50,101,50,0,1,52,270564
168,50,5400,5100,27540000,2,406,103,1,224520000,224520000,151,50,101,50,0,1,52,279996
168,50,5400,5100,27540000,2,406,103,1,224520000,224520000,151,50,101,50,0,1,52,302133
168,50,5400,5100,27540000,2,406,103,1,224520000,224520000,151,50,101,50,0,1,52,302514

168,450,5400,5100,27540000,2,3606,903,1,258120000,258120000,1351,450,901,450,0,1,452,2852930
168,450,5400,5100,27540000,2,3606,903,1,258120000,258120000,1351,450,901,450,0,1,452,539366
168,450,5400,5100,27540000,2,3606,903,1,258120000,258120000,1351,450,901,450,0,1,452,550995
168,450,5400,5100,27540000,2,3606,903,1,258120000,258120000,1351,450,901,450,0,1,452,549936
168,450,5400,5100,27540000,2,3606,903,1,258120000,258120000,1351,450,901,450,0,1,452,547760
168,450,5400,5100,27540000,2,3606,903,1,258120000,258120000,1351,450,901,450,0,1,452,558764
168,450,5400,5100,27540000,2,3606,903,1,258120000,258120000,1351,450,901,450,0,1,452,556035

168,850,5400,5100,27540000,2,6806,1703,1,291720000,291720000,2551,850,1701,850,0,1,852,5770997
168,850,5400,5100,27540000,2,6806,1703,1,291720000,291720000,2551,850,1701,850,0,1,852,747574
168,850,5400,5100,27540000,2,6806,1703,1,291720000,291720000,2551,850,1701,850,0,1,852,745761
168,850,5400,5100,27540000,2,6806,1703,1,291720000,291720000,2551,850,1701,850,0,1,852,749290
168,850,5400,5100,27540000,2,6806,1703,1,291720000,291720000,2551,850,1701,850,0,1,852,748626
168,850,5400,5100,27540000,2,6806,1703,1,291720000,291720000,2551,850,1701,850,0,1,852,759580
168,850,5400,5100,27540000,2,6806,1703,1,291720000,291720000,2551,850,1701,850,0,1,852,760052

168,1250,5400,5100,27540000,2,10006,2503,1,325320000,325320000,3751,1250,2501,1250,0,1,1252,8877233
168,1250,5400,5100,27540000,2,10006,2503,1,325320000,325320000,3751,1250,2501,1250,0,1,1252,1009705
168,1250,5400,5100,27540000,2,10006,2503,1,325320000,325320000,3751,1250,2501,1250,0,1,1252,1007614
168,1250,5400,5100,27540000,2,10006,2503,1,325320000,325320000,3751,1250,2501,1250,0,1,1252,1010383
168,1250,5400,5100,27540000,2,10006,2503,1,325320000,325320000,3751,1250,2501,1250,0,1,1252,1009248
168,1250,5400,5100,27540000,2,10006,2503,1,325320000,325320000,3751,1250,2501,1250,0,1,1252,1010783
168,1250,5400,5100,27540000,2,10006,2503,1,325320000,325320000,3751,1250,2501,1250,0,1,1252,1011086

168,1650,5400,5100,27540000,2,13206,3303,1,358920000,358920000,4951,1650,3301,1650,0,1,1652,12055796
168,1650,5400,5100,27540000,2,13206,3303,1,358920000,358920000,4951,1650,3301,1650,0,1,1652,1230542
168,1650,5400,5100,27540000,2,13206,3303,1,358920000,358920000,4951,1650,3301,1650,0,1,1652,1228099
168,1650,5400,5100,27540000,2,13206,3303,1,358920000,358920000,4951,1650,3301,1650,0,1,1652,1229641
168,1650,5400,5100,27540000,2,13206,3303,1,358920000,358920000,4951,1650,3301,1650,0,1,1652,1231294
168,1650,5400,5100,27540000,2,13206,3303,1,358920000,358920000,4951,1650,3301,1650,0,1,1652,1231949
168,1650,5400,5100,27540000,2,13206,3303,1,358920000,358920000,4951,1650,3301,1650,0,1,1652,1232505

168,2050,5400,5100,27540000,2,16406,4103,1,392520000,392520000,6151,2050,4101,2050,0,1,2052,15111484
168,2050,5400,5100,27540000,2,16406,4103,1,392520000,392520000,6151,2050,4101,2050,0,1,2052,1506890
168,2050,5400,5100,27540000,2,16406,4103,1,392520000,392520000,6151,2050,4101,2050,0,1,2052,1504567
168,2050,5400,5100,27540000,2,16406,4103,1,392520000,392520000,6151,2050,4101,2050,0,1,2052,1509951
168,2050,5400,5100,27540000,2,16406,4103,1,392520000,392520000,6151,2050,4101,2050,0,1,2052,1509000
168,2050,5400,5100,27540000,2,16406,4103,1,392520000,392520000,6151,2050,4101,2050,0,1,2052,1497917
168,2050,5400,5100,27540000,2,16406,4103,1,392520000,392520000,6151,2050,4101,2050,0,1,2052,1500674

168,2450,5400,5100,27540000,2,19606,4903,1,426120000,426120000,7351,2450,4901,2450,0,1,2452,18935601
168,2450,5400,5100,27540000,2,19606,4903,1,426120000,426120000,7351,2450,4901,2450,0,1,2452,1724515
168,2450,5400,5100,27540000,2,19606,4903,1,426120000,426120000,7351,2450,4901,2450,0,1,2452,1725954
168,2450,5400,5100,27540000,2,19606,4903,1,426120000,426120000,7351,2450,4901,2450,0,1,2452,1727558
168,2450,5400,5100,27540000,2,19606,4903,1,426120000,426120000,7351,2450,4901,2450,0,1,2452,1726683
168,2450,5400,5100,27540000,2,19606,4903,1,426120000,426120000,7351,2450,4901,2450,0,1,2452,1686038
168,2450,5400,5100,27540000,2,19606,4903,1,426120000,426120000,7351,2450,4901,2450,0,1,2452,1687342

168,2850,5400,5100,27540000,2,22806,5703,1,459720000,459720000,8551,2850,5701,2850,0,1,2852,21950084
168,2850,5400,5100,27540000,2,22806,5703,1,459720000,459720000,8551,2850,5701,2850,0,1,2852,1974048
168,2850,5400,5100,27540000,2,22806,5703,1,459720000,459720000,8551,2850,5701,2850,0,1,2852,1966821
168,2850,5400,5100,27540000,2,22806,5703,1,459720000,459720000,8551,2850,5701,2850,0,1,2852,1978920
168,2850,5400,5100,27540000,2,22806,5703,1,459720000,459720000,8551,2850,5701,2850,0,1,2852,1977970
168,2850,5400,5100,27540000,2,22806,5703,1,459720000,459720000,8551,2850,5701,2850,0,1,2852,1959260
168,2850,5400,5100,27540000,2,22806,5703,1,459720000,459720000,8551,2850,5701,2850,0,1,2852,1957572

168,3250,5400,5100,27540000,2,26006,6503,1,493320000,493320000,9751,3250,6501,3250,0,1,3252,25398519
168,3250,5400,5100,27540000,2,26006,6503,1,493320000,493320000,9751,3250,6501,3250,0,1,3252,2173963
168,3250,5400,5100,27540000,2,26006,6503,1,493320000,493320000,9751,3250,6501,3250,0,1,3252,2172350
168,3250,5400,5100,27540000,2,26006,6503,1,493320000,493320000,9751,3250,6501,3250,0,1,3252,2175824
168,3250,5400,5100,27540000,2,26006,6503,1,493320000,493320000,9751,3250,6501,3250,0,1,3252,2174802
168,3250,5400,5100,27540000,2,26006,6503,1,493320000,493320000,9751,3250,6501,3250,0,1,3252,2156722
168,3250,5400,5100,27540000,2,26006,6503,1,493320000,493320000,9751,3250,6501,3250,0,1,3252,2158234

168,3650,5400,5100,27540000,2,29206,7303,1,526920000,526920000,10951,3650,7301,3650,0,1,3652,28668652
168,3650,5400,5100,27540000,2,29206,7303,1,526920000,526920000,10951,3650,7301,3650,0,1,3652,2459015
168,3650,5400,5100,27540000,2,29206,7303,1,526920000,526920000,10951,3650,7301,3650,0,1,3652,2462119
168,3650,5400,5100,27540000,2,29206,7303,1,526920000,526920000,10951,3650,7301,3650,0,1,3652,2461004
168,3650,5400,5100,27540000,2,29206,7303,1,526920000,526920000,10951,3650,7301,3650,0,1,3652,2457301
168,3650,5400,5100,27540000,2,29206,7303,1,526920000,526920000,10951,3650,7301,3650,0,1,3652,2423282
168,3650,5400,5100,27540000,2,29206,7303,1,526920000,526920000,10951,3650,7301,3650,0,1,3652,2421533

168,4050,5400,5100,27540000,2,32406,8103,1,560520000,560520000,12151,4050,8101,4050,0,1,4052,32427841
168,4050,5400,5100,27540000,2,32406,8103,1,560520000,560520000,12151,4050,8101,4050,0,1,4052,2714217
168,4050,5400,5100,27540000,2,32406,8103,1,560520000,560520000,12151,4050,8101,4050,0,1,4052,2709871
168,4050,5400,5100,27540000,2,32406,8103,1,560520000,560520000,12151,4050,8101,4050,0,1,4052,2705321
168,4050,5400,5100,27540000,2,32406,8103,1,560520000,560520000,12151,4050,8101,4050,0,1,4052,2712999
168,4050,5400,5100,27540000,2,32406,8103,1,560520000,560520000,12151,4050,8101,4050,0,1,4052,2653064
168,4050,5400,5100,27540000,2,32406,8103,1,560520000,560520000,12151,4050,8101,4050,0,1,4052,2665576

168,4450,5400,5100,27540000,2,35606,8903,1,594120000,594120000,13351,4450,8901,4450,0,1,4452,36282014
168,4450,5400,5100,27540000,2,35606,8903,1,594120000,594120000,13351,4450,8901,4450,0,1,4452,2954029
168,4450,5400,5100,27540000,2,35606,8903,1,594120000,594120000,13351,4450,8901,4450,0,1,4452,2937838
168,4450,5400,5100,27540000,2,35606,8903,1,594120000,594120000,13351,4450,8901,4450,0,1,4452,2949508
168,4450,5400,5100,27540000,2,35606,8903,1,594120000,594120000,13351,4450,8901,4450,0,1,4452,2946789
168,4450,5400,5100,27540000,2,35606,8903,1,594120000,594120000,13351,4450,8901,4450,0,1,4452,2882480
168,4450,5400,5100,27540000,2,35606,8903,1,594120000,594120000,13351,4450,8901,4450,0,1,4452,2885011

168,4850,5400,5100,27540000,2,38806,9703,1,627720000,627720000,14551,4850,9701,4850,0,1,4852,39224358
168,4850,5400,5100,27540000,2,38806,9703,1,627720000,627720000,14551,4850,9701,4850,0,1,4852,3174754
168,4850,5400,5100,27540000,2,38806,9703,1,627720000,627720000,14551,4850,9701,4850,0,1,4852,3207400
168,4850,5400,5100,27540000,2,38806,9703,1,627720000,627720000,14551,4850,9701,4850,0,1,4852,3204507
168,4850,5400,5100,27540000,2,38806,9703,1,627720000,627720000,14551,4850,9701,4850,0,1,4852,3200240
168,4850,5400,5100,27540000,2,38806,9703,1,627720000,627720000,14551,4850,9701,4850,0,1,4852,3142831
168,4850,5400,5100,27540000,2,38806,9703,1,627720000,627720000,14551,4850,9701,4850,0,1,4852,3140212

168,5250,5400,5100,27540000,2,42006,10503,1,661320000,661320000,15751,5250,10501,5250,0,1,5252,42607188
168,5250,5400,5100,27540000,2,42006,10503,1,661320000,661320000,15751,5250,10501,5250,0,1,5252,3467176
168,5250,5400,5100,27540000,2,42006,10503,1,661320000,661320000,15751,5250,10501,5250,0,1,5252,3461723
168,5250,5400,5100,27540000,2,42006,10503,1,661320000,661320000,15751,5250,10501,5250,0,1,5252,3471289
168,5250,5400,5100,27540000,2,42006,10503,1,661320000,661320000,15751,5250,10501,5250,0,1,5252,3469854
168,5250,5400,5100,27540000,2,42006,10503,1,661320000,661320000,15751,5250,10501,5250,0,1,5252,3336050
168,5250,5400,5100,27540000,2,42006,10503,1,661320000,661320000,15751,5250,10501,5250,0,1,5252,3375465

168,5650,5400,5100,27540000,2,45206,11303,1,694920000,694920000,16951,5650,11301,5650,0,1,5652,46104852
168,5650,5400,5100,27540000,2,45206,11303,1,694920000,694920000,16951,5650,11301,5650,0,1,5652,3690120
168,5650,5400,5100,27540000,2,45206,11303,1,694920000,694920000,16951,5650,11301,5650,0,1,5652,3686918
168,5650,5400,5100,27540000,2,45206,11303,1,694920000,694920000,16951,5650,11301,5650,0,1,5652,3694121
168,5650,5400,5100,27540000,2,45206,11303,1,694920000,694920000,16951,5650,11301,5650,0,1,5652,3692460
168,5650,5400,5100,27540000,2,45206,11303,1,694920000,694920000,16951,5650,11301,5650,0,1,5652,3550961
168,5650,5400,5100,27540000,2,45206,11303,1,694920000,694920000,16951,5650,11301,5650,0,1,5652,3591455

168,6050,5400,5100,27540000,2,48406,12103,1,728520000,728520000,18151,6050,12101,6050,0,1,6052,49829386
168,6050,5400,5100,27540000,2,48406,12103,1,728520000,728520000,18151,6050,12101,6050,0,1,6052,3939000
168,6050,5400,5100,27540000,2,48406,12103,1,728520000,728520000,18151,6050,12101,6050,0,1,6052,3937536
168,6050,5400,5100,27540000,2,48406,12103,1,728520000,728520000,18151,6050,12101,6050,0,1,6052,3940567
168,6050,5400,5100,27540000,2,48406,12103,1,728520000,728520000,18151,6050,12101,6050,0,1,6052,3931251
168,6050,5400,5100,27540000,2,48406,12103,1,728520000,728520000,18151,6050,12101,6050,0,1,6052,3833061
168,6050,5400,5100,27540000,2,48406,12103,1,728520000,728520000,18151,6050,12101,6050,0,1,6052,3838908

168,6450,5400,5100,27540000,2,51606,12903,1,762120000,762120000,19351,6450,12901,6450,0,1,6452,51148116
168,6450,5400,5100,27540000,2,51606,12903,1,762120000,762120000,19351,6450,12901,6450,0,1,6452,4163624
168,6450,5400,5100,27540000,2,51606,12903,1,762120000,762120000,19351,6450,12901,6450,0,1,6452,4159019
168,6450,5400,5100,27540000,2,51606,12903,1,762120000,762120000,19351,6450,12901,6450,0,1,6452,4160433
168,6450,5400,5100,27540000,2,51606,12903,1,762120000,762120000,19351,6450,12901,6450,0,1,6452,4147697
168,6450,5400,5100,27540000,2,51606,12903,1,762120000,762120000,19351,6450,12901,6450,0,1,6452,4057549
168,6450,5400,5100,27540000,2,51606,12903,1,762120000,762120000,19351,6450,12901,6450,0,1,6452,4060490

168,6850,5400,5100,27540000,2,54806,13703,1,795720000,795720000,20551,6850,13701,6850,0,1,6852,55584483
168,6850,5400,5100,27540000,2,54806,13703,1,795720000,795720000,20551,6850,13701,6850,0,1,6852,4390052
168,6850,5400,5100,27540000,2,54806,13703,1,795720000,795720000,20551,6850,13701,6850,0,1,6852,4397004
168,6850,5400,5100,27540000,2,54806,13703,1,795720000,795720000,20551,6850,13701,6850,0,1,6852,4398489
168,6850,5400,5100,27540000,2,54806,13703,1,795720000,795720000,20551,6850,13701,6850,0,1,6852,4395525
168,6850,5400,5100,27540000,2,54806,13703,1,795720000,795720000,20551,6850,13701,6850,0,1,6852,4294062
168,6850,5400,5100,27540000,2,54806,13703,1,795720000,795720000,20551,6850,13701,6850,0,1,6852,4291496

168,50,5400,4700,25380000,2,406,103,1,207080000,207080000,151,50,101,50,0,1,52,281864
168,50,5400,4700,25380000,2,406,103,1,207080000,207080000,151,50,101,50,0,1,52,237308
168,50,5400,4700,25380000,2,406,103,1,207080000,207080000,151,50,101,50,0,1,52,217829
168,50,5400,4700,25380000,2,406,103,1,207080000,207080000,151,50,101,50,0,1,52,238045
168,50,5400,4700,25380000,2,406,103,1,207080000,207080000,151,50,101,50,0,1,52,232623
168,50,5400,4700,25380000,2,406,103,1,207080000,207080000,151,50,101,50,0,1,52,261506
168,50,5400,4700,25380000,2,406,103,1,207080000,207080000,151,50,101,50,0,1,52,261884

168,450,5400,4700,25380000,2,3606,903,1,239400000,239400000,1351,450,901,450,0,1,452,2557687
168,450,5400,4700,25380000,2,3606,903,1,239400000,239400000,1351,450,901,450,0,1,452,500326
168,450,5400,4700,25380000,2,3606,903,1,239400000,239400000,1351,450,901,450,0,1,452,499920
168,450,5400,4700,25380000,2,3606,903,1,239400000,239400000,1351,450,901,450,0,1,452,501653
168,450,5400,4700,25380000,2,3606,903,1,239400000,239400000,1351,450,901,450,0,1,452,500678
168,450,5400,4700,25380000,2,3606,903,1,239400000,239400000,1351,450,901,450,0,1,452,504055
168,450,5400,4700,25380000,2,3606,903,1,239400000,239400000,1351,450,901,450,0,1,452,503629

168,850,5400,4700,25380000,2,6806,1703,1,271720000,271720000,2551,850,1701,850,0,1,852,5318700
168,850,5400,4700,25380000,2,6806,1703,1,271720000,271720000,2551,850,1701,850,0,1,852,690796
168,850,5400,4700,25380000,2,6806,1703,1,271720000,271720000,2551,850,1701,850,0,1,852,687506
168,850,5400,4700,25380000,2,6806,1703,1,271720000,271720000,2551,850,1701,850,0,1,852,689248
168,850,5400,4700,25380000,2,6806,1703,1,271720000,271720000,2551,850,1701,850,0,1,852,690196
168,850,5400,4700,25380000,2,6806,1703,1,271720000,271720000,2551,850,1701,850,0,1,852,704730
168,850,5400,4700,25380000,2,6806,1703,1,271720000,271720000,2551,850,1701,850,0,1,852,705201

168,1250,5400,4700,25380000,2,10006,2503,1,304040000,304040000,3751,1250,2501,1250,0,1,1252,8320300
168,1250,5400,4700,25380000,2,10006,2503,1,304040000,304040000,3751,1250,2501,1250,0,1,1252,910421
168,1250,5400,4700,25380000,2,10006,2503,1,304040000,304040000,3751,1250,2501,1250,0,1,1252,907263
168,1250,5400,4700,25380000,2,10006,2503,1,304040000,304040000,3751,1250,2501,1250,0,1,1252,909206
168,1250,5400,4700,25380000,2,10006,2503,1,304040000,304040000,3751,1250,2501,1250,0,1,1252,911296
168,1250,5400,4700,25380000,2,10006,2503,1,304040000,304040000,3751,1250,2501,1250,0,1,1252,918554
168,1250,5400,4700,25380000,2,10006,2503,1,304040000,304040000,3751,1250,2501,1250,0,1,1252,919071

168,1650,5400,4700,25380000,2,13206,3303,1,336360000,336360000,4951,1650,3301,1650,0,1,1652,11195554
168,1650,5400,4700,25380000,2,13206,3303,1,336360000,336360000,4951,1650,3301,1650,0,1,1652,1135738
168,1650,5400,4700,25380000,2,13206,3303,1,336360000,336360000,4951,1650,3301,1650,0,1,1652,1138971
168,1650,5400,4700,25380000,2,13206,3303,1,336360000,336360000,4951,1650,3301,1650,0,1,1652,1139626
168,1650,5400,4700,25380000,2,13206,3303,1,336360000,336360000,4951,1650,3301,1650,0,1,1652,1137939
168,1650,5400,4700,25380000,2,13206,3303,1,336360000,336360000,4951,1650,3301,1650,0,1,1652,1142407
168,1650,5400,4700,25380000,2,13206,3303,1,336360000,336360000,4951,1650,3301,1650,0,1,1652,1142973

168,2050,5400,4700,25380000,2,16406,4103,1,368680000,368680000,6151,2050,4101,2050,0,1,2052,13663941
168,2050,5400,4700,25380000,2,16406,4103,1,368680000,368680000,6151,2050,4101,2050,0,1,2052,1376831
168,2050,5400,4700,25380000,2,16406,4103,1,368680000,368680000,6151,2050,4101,2050,0,1,2052,1370914
168,2050,5400,4700,25380000,2,16406,4103,1,368680000,368680000,6151,2050,4101,2050,0,1,2052,1378803
168,2050,5400,4700,25380000,2,16406,4103,1,368680000,368680000,6151,2050,4101,2050,0,1,2052,1375496
168,2050,5400,4700,25380000,2,16406,4103,1,368680000,368680000,6151,2050,4101,2050,0,1,2052,1376115
168,2050,5400,4700,25380000,2,16406,4103,1,368680000,368680000,6151,2050,4101,2050,0,1,2052,1377240

168,2450,5400,4700,25380000,2,19606,4903,1,401000000,401000000,7351,2450,4901,2450,0,1,2452,17753476
168,2450,5400,4700,25380000,2,19606,4903,1,401000000,401000000,7351,2450,4901,2450,0,1,2452,1610518
168,2450,5400,4700,25380000,2,19606,4903,1,401000000,401000000,7351,2450,4901,2450,0,1,2452,1604627
168,2450,5400,4700,25380000,2,19606,4903,1,401000000,401000000,7351,2450,4901,2450,0,1,2452,1572742
168,2450,5400,4700,25380000,2,19606,4903,1,401000000,401000000,7351,2450,4901,2450,0,1,2452,1612080
168,2450,5400,4700,25380000,2,19606,4903,1,401000000,401000000,7351,2450,4901,2450,0,1,2452,1612515
168,2450,5400,4700,25380000,2,19606,4903,1,401000000,401000000,7351,2450,4901,2450,0,1,2452,1611203

168,2850,5400,4700,25380000,2,22806,5703,1,433320000,433320000,8551,2850,5701,2850,0,1,2852,19991267
168,2850,5400,4700,25380000,2,22806,5703,1,433320000,433320000,8551,2850,5701,2850,0,1,2852,1795270
168,2850,5400,4700,25380000,2,22806,5703,1,433320000,433320000,8551,2850,5701,2850,0,1,2852,1793230
168,2850,5400,4700,25380000,2,22806,5703,1,433320000,433320000,8551,2850,5701,2850,0,1,2852,1795997
168,2850,5400,4700,25380000,2,22806,5703,1,433320000,433320000,8551,2850,5701,2850,0,1,2852,1794439
168,2850,5400,4700,25380000,2,22806,5703,1,433320000,433320000,8551,2850,5701,2850,0,1,2852,1785695
168,2850,5400,4700,25380000,2,22806,5703,1,433320000,433320000,8551,2850,5701,2850,0,1,2852,1787885

168,3250,5400,4700,25380000,2,26006,6503,1,465640000,465640000,9751,3250,6501,3250,0,1,3252,23068805
168,3250,5400,4700,25380000,2,26006,6503,1,465640000,465640000,9751,3250,6501,3250,0,1,3252,2042575
168,3250,5400,4700,25380000,2,26006,6503,1,465640000,465640000,9751,3250,6501,3250,0,1,3252,2049087
168,3250,5400,4700,25380000,2,26006,6503,1,465640000,465640000,9751,3250,6501,3250,0,1,3252,2050106
168,3250,5400,4700,25380000,2,26006,6503,1,465640000,465640000,9751,3250,6501,3250,0,1,3252,2047053
168,3250,5400,4700,25380000,2,26006,6503,1,465640000,465640000,9751,3250,6501,3250,0,1,3252,2028119
168,3250,5400,4700,25380000,2,26006,6503,1,465640000,465640000,9751,3250,6501,3250,0,1,3252,2029716

168,3650,5400,4700,25380000,2,29206,7303,1,497960000,497960000,10951,3650,7301,3650,0,1,3652,26461356
168,3650,5400,4700,25380000,2,29206,7303,1,497960000,497960000,10951,3650,7301,3650,0,1,3652,2274061
168,3650,5400,4700,25380000,2,29206,7303,1,497960000,497960000,10951,3650,7301,3650,0,1,3652,2265811
168,3650,5400,4700,25380000,2,29206,7303,1,497960000,497960000,10951,3650,7301,3650,0,1,3652,2279094
168,3650,5400,4700,25380000,2,29206,7303,1,497960000,497960000,10951,3650,7301,3650,0,1,3652,2275195
168,3650,5400,4700,25380000,2,29206,7303,1,497960000,497960000,10951,3650,7301,3650,0,1,3652,2261014
168,3650,5400,4700,25380000,2,29206,7303,1,497960000,497960000,10951,3650,7301,3650,0,1,3652,2259125

168,4050,5400,4700,25380000,2,32406,8103,1,530280000,530280000,12151,4050,8101,4050,0,1,4052,30017283
168,4050,5400,4700,25380000,2,32406,8103,1,530280000,530280000,12151,4050,8101,4050,0,1,4052,2481468
168,4050,5400,4700,25380000,2,32406,8103,1,530280000,530280000,12151,4050,8101,4050,0,1,4052,2474192
168,4050,5400,4700,25380000,2,32406,8103,1,530280000,530280000,12151,4050,8101,4050,0,1,4052,2483877
168,4050,5400,4700,25380000,2,32406,8103,1,530280000,530280000,12151,4050,8101,4050,0,1,4052,2482685
168,4050,5400,4700,25380000,2,32406,8103,1,530280000,530280000,12151,4050,8101,4050,0,1,4052,2441645
168,4050,5400,4700,25380000,2,32406,8103,1,530280000,530280000,12151,4050,8101,4050,0,1,4052,2443593

168,4450,5400,4700,25380000,2,35606,8903,1,562600000,562600000,13351,4450,8901,4450,0,1,4452,33359822
168,4450,5400,4700,25380000,2,35606,8903,1,562600000,562600000,13351,4450,8901,4450,0,1,4452,2729323
168,4450,5400,4700,25380000,2,35606,8903,1,562600000,562600000,13351,4450,8901,4450,0,1,4452,2740711
168,4450,5400,4700,25380000,2,35606,8903,1,562600000,562600000,13351,4450,8901,4450,0,1,4452,2741963
168,4450,5400,4700,25380000,2,35606,8903,1,562600000,562600000,13351,4450,8901,4450,0,1,4452,2734473
168,4450,5400,4700,25380000,2,35606,8903,1,562600000,562600000,13351,4450,8901,4450,0,1,4452,2686854
168,4450,5400,4700,25380000,2,35606,8903,1,562600000,562600000,13351,4450,8901,4450,0,1,4452,2689173

168,4850,5400,4700,25380000,2,38806,9703,1,594920000,594920000,14551,4850,9701,4850,0,1,4852,35529028
168,4850,5400,4700,25380000,2,38806,9703,1,594920000,594920000,14551,4850,9701,4850,0,1,4852,2986772
168,4850,5400,4700,25380000,2,38806,9703,1,594920000,594920000,14551,4850,9701,4850,0,1,4852,2980224
168,4850,5400,4700,25380000,2,38806,9703,1,594920000,594920000,14551,4850,9701,4850,0,1,4852,2988294
168,4850,5400,4700,25380000,2,38806,9703,1,594920000,594920000,14551,4850,9701,4850,0,1,4852,2984739
168,4850,5400,4700,25380000,2,38806,9703,1,594920000,594920000,14551,4850,9701,4850,0,1,4852,2892489
168,4850,5400,4700,25380000,2,38806,9703,1,594920000,594920000,14551,4850,9701,4850,0,1,4852,2894790

168,5250,5400,4700,25380000,2,42006,10503,1,627240000,627240000,15751,5250,10501,5250,0,1,5252,38810866
168,5250,5400,4700,25380000,2,42006,10503,1,627240000,627240000,15751,5250,10501,5250,0,1,5252,3200263
168,5250,5400,4700,25380000,2,42006,10503,1,627240000,627240000,15751,5250,10501,5250,0,1,5252,3195138
168,5250,5400,4700,25380000,2,42006,10503,1,627240000,627240000,15751,5250,10501,5250,0,1,5252,3196601
168,5250,5400,4700,25380000,2,42006,10503,1,627240000,627240000,15751,5250,10501,5250,0,1,5252,3201709
168,5250,5400,4700,25380000,2,42006,10503,1,627240000,627240000,15751,5250,10501,5250,0,1,5252,3105401
168,5250,5400,4700,25380000,2,42006,10503,1,627240000,627240000,15751,5250,10501,5250,0,1,5252,3124993

168,5650,5400,4700,25380000,2,45206,11303,1,659560000,659560000,16951,5650,11301,5650,0,1,5652,42556790
168,5650,5400,4700,25380000,2,45206,11303,1,659560000,659560000,16951,5650,11301,5650,0,1,5652,3423198
168,5650,5400,4700,25380000,2,45206,11303,1,659560000,659560000,16951,5650,11301,5650,0,1,5652,3417969
168,5650,5400,4700,25380000,2,45206,11303,1,659560000,659560000,16951,5650,11301,5650,0,1,5652,3416431
168,5650,5400,4700,25380000,2,45206,11303,1,659560000,659560000,16951,5650,11301,5650,0,1,5652,3421684
168,5650,5400,4700,25380000,2,45206,11303,1,659560000,659560000,16951,5650,11301,5650,0,1,5652,3330285
168,5650,5400,4700,25380000,2,45206,11303,1,659560000,659560000,16951,5650,11301,5650,0,1,5652,3322611

168,6050,5400,4700,25380000,2,48406,12103,1,691880000,691880000,18151,6050,12101,6050,0,1,6052,44220234
168,6050,5400,4700,25380000,2,48406,12103,1,691880000,691880000,18151,6050,12101,6050,0,1,6052,3663078
168,6050,5400,4700,25380000,2,48406,12103,1,691880000,691880000,18151,6050,12101,6050,0,1,6052,3655110
168,6050,5400,4700,25380000,2,48406,12103,1,691880000,691880000,18151,6050,12101,6050,0,1,6052,3667800
168,6050,5400,4700,25380000,2,48406,12103,1,691880000,691880000,18151,6050,12101,6050,0,1,6052,3664569
168,6050,5400,4700,25380000,2,48406,12103,1,691880000,691880000,18151,6050,12101,6050,0,1,6052,3545988
168,6050,5400,4700,25380000,2,48406,12103,1,691880000,691880000,18151,6050,12101,6050,0,1,6052,3567696

168,6450,5400,4700,25380000,2,51606,12903,1,724200000,724200000,19351,6450,12901,6450,0,1,6452,48593845
168,6450,5400,4700,25380000,2,51606,12903,1,724200000,724200000,19351,6450,12901,6450,0,1,6452,3887757
168,6450,5400,4700,25380000,2,51606,12903,1,724200000,724200000,19351,6450,12901,6450,0,1,6452,3881649
168,6450,5400,4700,25380000,2,51606,12903,1,724200000,724200000,19351,6450,12901,6450,0,1,6452,3890546
168,6450,5400,4700,25380000,2,51606,12903,1,724200000,724200000,19351,6450,12901,6450,0,1,6452,3889154
168,6450,5400,4700,25380000,2,51606,12903,1,724200000,724200000,19351,6450,12901,6450,0,1,6452,3764573
168,6450,5400,4700,25380000,2,51606,12903,1,724200000,724200000,19351,6450,12901,6450,0,1,6452,3769458

168,6850,5400,4700,25380000,2,54806,13703,1,756520000,756520000,20551,6850,13701,6850,0,1,6852,51173764
168,6850,5400,4700,25380000,2,54806,13703,1,756520000,756520000,20551,6850,13701,6850,0,1,6852,4108027
168,6850,5400,4700,25380000,2,54806,13703,1,756520000,756520000,20551,6850,13701,6850,0,1,6852,4096082
168,6850,5400,4700,25380000,2,54806,13703,1,756520000,756520000,20551,6850,13701,6850,0,1,6852,4111703
168,6850,5400,4700,25380000,2,54806,13703,1,756520000,756520000,20551,6850,13701,6850,0,1,6852,4105599
168,6850,5400,4700,25380000,2,54806,13703,1,756520000,756520000,20551,6850,13701,6850,0,1,6852,4006599
168,6850,5400,4700,25380000,2,54806,13703,1,756520000,756520000,20551,6850,13701,6850,0,1,6852,4013099

168,50,5400,4300,23220000,2,406,103,1,189640000,189640000,151,50,101,50,0,1,52,255162
168,50,5400,4300,23220000,2,406,103,1,189640000,189640000,151,50,101,50,0,1,52,231316
168,50,5400,4300,23220000,2,406,103,1,189640000,189640000,151,50,101,50,0,1,52,222981
168,50,5400,4300,23220000,2,406,103,1,189640000,189640000,151,50,101,50,0,1,52,232085
168,50,5400,4300,23220000,2,406,103,1,189640000,189640000,151,50,101,50,0,1,52,210460
168,50,5400,4300,23220000,2,406,103,1,189640000,189640000,151,50,101,50,0,1,52,249709
168,50,5400,4300,23220000,2,406,103,1,189640000,189640000,151,50,101,50,0,1,52,250090

168,450,5400,4300,23220000,2,3606,903,1,220680000,220680000,1351,450,901,450,0,1,452,2373467
168,450,5400,4300,23220000,2,3606,903,1,220680000,220680000,1351,450,901,450,0,1,452,425773
168,450,5400,4300,23220000,2,3606,903,1,220680000,220680000,1351,450,901,450,0,1,452,424924
168,450,5400,4300,23220000,2,3606,903,1,220680000,220680000,1351,450,901,450,0,1,452,426257
168,450,5400,4300,23220000,2,3606,903,1,220680000,220680000,1351,450,901,450,0,1,452,423229
168,450,5400,4300,23220000,2,3606,903,1,220680000,220680000,1351,450,901,450,0,1,452,442266
168,450,5400,4300,23220000,2,3606,903,1,220680000,220680000,1351,450,901,450,0,1,452,441843

168,850,5400,4300,23220000,2,6806,1703,1,251720000,251720000,2551,850,1701,850,0,1,852,4764484
168,850,5400,4300,23220000,2,6806,1703,1,251720000,251720000,2551,850,1701,850,0,1,852,679738
168,850,5400,4300,23220000,2,6806,1703,1,251720000,251720000,2551,850,1701,850,0,1,852,678452
168,850,5400,4300,23220000,2,6806,1703,1,251720000,251720000,2551,850,1701,850,0,1,852,656290
168,850,5400,4300,23220000,2,6806,1703,1,251720000,251720000,2551,850,1701,850,0,1,852,680726
168,850,5400,4300,23220000,2,6806,1703,1,251720000,251720000,2551,850,1701,850,0,1,852,693864
168,850,5400,4300,23220000,2,6806,1703,1,251720000,251720000,2551,850,1701,850,0,1,852,693392

168,1250,5400,4300,23220000,2,10006,2503,1,282760000,282760000,3751,1250,2501,1250,0,1,1252,7498621
168,1250,5400,4300,23220000,2,10006,2503,1,282760000,282760000,3751,1250,2501,1250,0,1,1252,845302
168,1250,5400,4300,23220000,2,10006,2503,1,282760000,282760000,3751,1250,2501,1250,0,1,1252,843449
168,1250,5400,4300,23220000,2,10006,2503,1,282760000,282760000,3751,1250,2501,1250,0,1,1252,847224
168,1250,5400,4300,23220000,2,10006,2503,1,282760000,282760000,3751,1250,2501,1250,0,1,1252,846383
168,1250,5400,4300,23220000,2,10006,2503,1,282760000,282760000,3751,1250,2501,1250,0,1,1252,854065
168,1250,5400,4300,23220000,2,10006,2503,1,282760000,282760000,3751,1250,2501,1250,0,1,1252,854582

168,1650,5400,4300,23220000,2,13206,3303,1,313800000,313800000,4951,1650,3301,1650,0,1,1652,10401082
168,1650,5400,4300,23220000,2,13206,3303,1,313800000,313800000,4951,1650,3301,1650,0,1,1652,1037902
168,1650,5400,4300,23220000,2,13206,3303,1,313800000,313800000,4951,1650,3301,1650,0,1,1652,1030261
168,1650,5400,4300,23220000,2,13206,3303,1,313800000,313800000,4951,1650,3301,1650,0,1,1652,1036563
168,1650,5400,4300,23220000,2,13206,3303,1,313800000,313800000,4951,1650,3301,1650,0,1,1652,1038946
168,1650,5400,4300,23220000,2,13206,3303,1,313800000,313800000,4951,1650,3301,1650,0,1,1652,1045829
168,1650,5400,4300,23220000,2,13206,3303,1,313800000,313800000,4951,1650,3301,1650,0,1,1652,1046398

168,2050,5400,4300,23220000,2,16406,4103,1,344840000,344840000,6151,2050,4101,2050,0,1,2052,12479205
168,2050,5400,4300,23220000,2,16406,4103,1,344840000,344840000,6151,2050,4101,2050,0,1,2052,1245880
168,2050,5400,4300,23220000,2,16406,4103,1,344840000,344840000,6151,2050,4101,2050,0,1,2052,1244045
168,2050,5400,4300,23220000,2,16406,4103,1,344840000,344840000,6151,2050,4101,2050,0,1,2052,1248608
168,2050,5400,4300,23220000,2,16406,4103,1,344840000,344840000,6151,2050,4101,2050,0,1,2052,1247436
168,2050,5400,4300,23220000,2,16406,4103,1,344840000,344840000,6151,2050,4101,2050,0,1,2052,1250261
168,2050,5400,4300,23220000,2,16406,4103,1,344840000,344840000,6151,2050,4101,2050,0,1,2052,1250896

168,2450,5400,4300,23220000,2,19606,4903,1,375880000,375880000,7351,2450,4901,2450,0,1,2452,15256758
168,2450,5400,4300,23220000,2,19606,4903,1,375880000,375880000,7351,2450,4901,2450,0,1,2452,1477758
168,2450,5400,4300,23220000,2,19606,4903,1,375880000,375880000,7351,2450,4901,2450,0,1,2452,1487960
168,2450,5400,4300,23220000,2,19606,4903,1,375880000,375880000,7351,2450,4901,2450,0,1,2452,1486923
168,2450,5400,4300,23220000,2,19606,4903,1,375880000,375880000,7351,2450,4901,2450,0,1,2452,1485648
168,2450,5400,4300,23220000,2,19606,4903,1,375880000,375880000,7351,2450,4901,2450,0,1,2452,1482313
168,2450,5400,4300,23220000,2,19606,4903,1,375880000,375880000,7351,2450,4901,2450,0,1,2452,1480496

168,2850,5400,4300,23220000,2,22806,5703,1,406920000,406920000,8551,2850,5701,2850,0,1,2852,18150805
168,2850,5400,4300,23220000,2,22806,5703,1,406920000,406920000,8551,2850,5701,2850,0,1,2852,1675013
168,2850,5400,4300,23220000,2,22806,5703,1,406920000,406920000,8551,2850,5701,2850,0,1,2852,1672311
168,2850,5400,4300,23220000,2,22806,5703,1,406920000,406920000,8551,2850,5701,2850,0,1,2852,1675988
168,2850,5400,4300,23220000,2,22806,5703,1,406920000,406920000,8551,2850,5701,2850,0,1,2852,1673905
168,2850,5400,4300,23220000,2,22806,5703,1,406920000,406920000,8551,2850,5701,2850,0,1,2852,1655874
168,2850,5400,4300,23220000,2,22806,5703,1,406920000,406920000,8551,2850,5701,2850,0,1,2852,1657262

168,3250,5400,4300,23220000,2,26006,6503,1,437960000,437960000,9751,3250,6501,3250,0,1,3252,22599825
168,3250,5400,4300,23220000,2,26006,6503,1,437960000,437960000,9751,3250,6501,3250,0,1,3252,1890662
168,3250,5400,4300,23220000,2,26006,6503,1,437960000,437960000,9751,3250,6501,3250,0,1,3252,1877387
168,3250,5400,4300,23220000,2,26006,6503,1,437960000,437960000,9751,3250,6501,3250,0,1,3252,1891679
168,3250,5400,4300,23220000,2,26006,6503,1,437960000,437960000,9751,3250,6501,3250,0,1,3252,1888663
168,3250,5400,4300,23220000,2,26006,6503,1,437960000,437960000,9751,3250,6501,3250,0,1,3252,1884235
168,3250,5400,4300,23220000,2,26006,6503,1,437960000,437960000,9751,3250,6501,3250,0,1,3252,1882910

168,3650,5400,4300,23220000,2,29206,7303,1,469000000,469000000,10951,3650,7301,3650,0,1,3652,24095344
168,3650,5400,4300,23220000,2,29206,7303,1,469000000,469000000,10951,3650,7301,3650,0,1,3652,2069242
168,3650,5400,4300,23220000,2,29206,7303,1,469000000,469000000,10951,3650,7301,3650,0,1,3652,2067338
168,3650,5400,4300,23220000,2,29206,7303,1,469000000,469000000,10951,3650,7301,3650,0,1,3652,2070347
168,3650,5400,4300,23220000,2,29206,7303,1,469000000,469000000,10951,3650,7301,3650,0,1,3652,2065708
168,3650,5400,4300,23220000,2,29206,7303,1,469000000,469000000,10951,3650,7301,3650,0,1,3652,2053545
168,3650,5400,4300,23220000,2,29206,7303,1,469000000,469000000,10951,3650,7301,3650,0,1,3652,2055305

168,4050,5400,4300,23220000,2,32406,8103,1,500040000,500040000,12151,4050,8101,4050,0,1,4052,26886243
168,4050,5400,4300,23220000,2,32406,8103,1,500040000,500040000,12151,4050,8101,4050,0,1,4052,2315619
168,4050,5400,4300,23220000,2,32406,8103,1,500040000,500040000,12151,4050,8101,4050,0,1,4052,2307045
168,4050,5400,4300,23220000,2,32406,8103,1,500040000,500040000,12151,4050,8101,4050,0,1,4052,2318036
168,4050,5400,4300,23220000,2,32406,8103,1,500040000,500040000,12151,4050,8101,4050,0,1,4052,2314436
168,4050,5400,4300,23220000,2,32406,8103,1,500040000,500040000,12151,4050,8101,4050,0,1,4052,2285652
168,4050,5400,4300,23220000,2,32406,8103,1,500040000,500040000,12151,4050,8101,4050,0,1,4052,2287761

168,4450,5400,4300,23220000,2,35606,8903,1,531080000,531080000,13351,4450,8901,4450,0,1,4452,29963886
168,4450,5400,4300,23220000,2,35606,8903,1,531080000,531080000,13351,4450,8901,4450,0,1,4452,2528335
168,4450,5400,4300,23220000,2,35606,8903,1,531080000,531080000,13351,4450,8901,4450,0,1,4452,2524124
168,4450,5400,4300,23220000,2,35606,8903,1,531080000,531080000,13351,4450,8901,4450,0,1,4452,2533005
168,4450,5400,4300,23220000,2,35606,8903,1,531080000,531080000,13351,4450,8901,4450,0,1,4452,2531740
168,4450,5400,4300,23220000,2,35606,8903,1,531080000,531080000,13351,4450,8901,4450,0,1,4452,2488067
168,4450,5400,4300,23220000,2,35606,8903,1,531080000,531080000,13351,4450,8901,4450,0,1,4452,2490273

168,4850,5400,4300,23220000,2,38806,9703,1,562120000,562120000,14551,4850,9701,4850,0,1,4852,31675398
168,4850,5400,4300,23220000,2,38806,9703,1,562120000,562120000,14551,4850,9701,4850,0,1,4852,2685900
168,4850,5400,4300,23220000,2,38806,9703,1,562120000,562120000,14551,4850,9701,4850,0,1,4852,2682335
168,4850,5400,4300,23220000,2,38806,9703,1,562120000,562120000,14551,4850,9701,4850,0,1,4852,2684576
168,4850,5400,4300,23220000,2,38806,9703,1,562120000,562120000,14551,4850,9701,4850,0,1,4852,2680767
168,4850,5400,4300,23220000,2,38806,9703,1,562120000,562120000,14551,4850,9701,4850,0,1,4852,2635976
168,4850,5400,4300,23220000,2,38806,9703,1,562120000,562120000,14551,4850,9701,4850,0,1,4852,2637927

168,5250,5400,4300,23220000,2,42006,10503,1,593160000,593160000,15751,5250,10501,5250,0,1,5252,35140840
168,5250,5400,4300,23220000,2,42006,10503,1,593160000,593160000,15751,5250,10501,5250,0,1,5252,2953061
168,5250,5400,4300,23220000,2,42006,10503,1,593160000,593160000,15751,5250,10501,5250,0,1,5252,2949615
168,5250,5400,4300,23220000,2,42006,10503,1,593160000,593160000,15751,5250,10501,5250,0,1,5252,2945091
168,5250,5400,4300,23220000,2,42006,10503,1,593160000,593160000,15751,5250,10501,5250,0,1,5252,2954516
168,5250,5400,4300,23220000,2,42006,10503,1,593160000,593160000,15751,5250,10501,5250,0,1,5252,2894824
168,5250,5400,4300,23220000,2,42006,10503,1,593160000,593160000,15751,5250,10501,5250,0,1,5252,2899741

168,5650,5400,4300,23220000,2,45206,11303,1,624200000,624200000,16951,5650,11301,5650,0,1,5652,39302482
168,5650,5400,4300,23220000,2,45206,11303,1,624200000,624200000,16951,5650,11301,5650,0,1,5652,3128804
168,5650,5400,4300,23220000,2,45206,11303,1,624200000,624200000,16951,5650,11301,5650,0,1,5652,3134684
168,5650,5400,4300,23220000,2,45206,11303,1,624200000,624200000,16951,5650,11301,5650,0,1,5652,3136180
168,5650,5400,4300,23220000,2,45206,11303,1,624200000,624200000,16951,5650,11301,5650,0,1,5652,3131137
168,5650,5400,4300,23220000,2,45206,11303,1,624200000,624200000,16951,5650,11301,5650,0,1,5652,3079417
168,5650,5400,4300,23220000,2,45206,11303,1,624200000,624200000,16951,5650,11301,5650,0,1,5652,3084435

168,6050,5400,4300,23220000,2,48406,12103,1,655240000,655240000,18151,6050,12101,6050,0,1,6052,41814535
168,6050,5400,4300,23220000,2,48406,12103,1,655240000,655240000,18151,6050,12101,6050,0,1,6052,3351085
168,6050,5400,4300,23220000,2,48406,12103,1,655240000,655240000,18151,6050,12101,6050,0,1,6052,3356519
168,6050,5400,4300,23220000,2,48406,12103,1,655240000,655240000,18151,6050,12101,6050,0,1,6052,3354923
168,6050,5400,4300,23220000,2,48406,12103,1,655240000,655240000,18151,6050,12101,6050,0,1,6052,3348952
168,6050,5400,4300,23220000,2,48406,12103,1,655240000,655240000,18151,6050,12101,6050,0,1,6052,3286266
168,6050,5400,4300,23220000,2,48406,12103,1,655240000,655240000,18151,6050,12101,6050,0,1,6052,3288840

168,6450,5400,4300,23220000,2,51606,12903,1,686280000,686280000,19351,6450,12901,6450,0,1,6452,44390002
168,6450,5400,4300,23220000,2,51606,12903,1,686280000,686280000,19351,6450,12901,6450,0,1,6452,3559962
168,6450,5400,4300,23220000,2,51606,12903,1,686280000,686280000,19351,6450,12901,6450,0,1,6452,3558391
168,6450,5400,4300,23220000,2,51606,12903,1,686280000,686280000,19351,6450,12901,6450,0,1,6452,3566747
168,6450,5400,4300,23220000,2,51606,12903,1,686280000,686280000,19351,6450,12901,6450,0,1,6452,3565123
168,6450,5400,4300,23220000,2,51606,12903,1,686280000,686280000,19351,6450,12901,6450,0,1,6452,3484141
168,6450,5400,4300,23220000,2,51606,12903,1,686280000,686280000,19351,6450,12901,6450,0,1,6452,3481213

168,6850,5400,4300,23220000,2,54806,13703,1,717320000,717320000,20551,6850,13701,6850,0,1,6852,47543669
168,6850,5400,4300,23220000,2,54806,13703,1,717320000,717320000,20551,6850,13701,6850,0,1,6852,3785282
168,6850,5400,4300,23220000,2,54806,13703,1,717320000,717320000,20551,6850,13701,6850,0,1,6852,3782904
168,6850,5400,4300,23220000,2,54806,13703,1,717320000,717320000,20551,6850,13701,6850,0,1,6852,3780051
168,6850,5400,4300,23220000,2,54806,13703,1,717320000,717320000,20551,6850,13701,6850,0,1,6852,3772010
168,6850,5400,4300,23220000,2,54806,13703,1,717320000,717320000,20551,6850,13701,6850,0,1,6852,3688319
168,6850,5400,4300,23220000,2,54806,13703,1,717320000,717320000,20551,6850,13701,6850,0,1,6852,3691058

168,50,5400,3900,21060000,2,406,103,1,172200000,172200000,151,50,101,50,0,1,52,227406
168,50,5400,3900,21060000,2,406,103,1,172200000,172200000,151,50,101,50,0,1,52,207521
168,50,5400,3900,21060000,2,406,103,1,172200000,172200000,151,50,101,50,0,1,52,190825
168,50,5400,3900,21060000,2,406,103,1,172200000,172200000,151,50,101,50,0,1,52,209797
168,50,5400,3900,21060000,2,406,103,1,172200000,172200000,151,50,101,50,0,1,52,209046
168,50,5400,3900,21060000,2,406,103,1,172200000,172200000,151,50,101,50,0,1,52,227060
168,50,5400,3900,21060000,2,406,103,1,172200000,172200000,151,50,101,50,0,1,52,227438

168,450,5400,3900,21060000,2,3606,903,1,201960000,201960000,1351,450,901,450,0,1,452,2149688
168,450,5400,3900,21060000,2,3606,903,1,201960000,201960000,1351,450,901,450,0,1,452,390987
168,450,5400,3900,21060000,2,3606,903,1,201960000,201960000,1351,450,901,450,0,1,452,391849
168,450,5400,3900,21060000,2,3606,903,1,201960000,201960000,1351,450,901,450,0,1,452,392336
168,450,5400,3900,21060000,2,3606,903,1,201960000,201960000,1351,450,901,450,0,1,452,389334
168,450,5400,3900,21060000,2,3606,903,1,201960000,201960000,1351,450,901,450,0,1,452,405517
168,450,5400,3900,21060000,2,3606,903,1,201960000,201960000,1351,450,901,450,0,1,452,405941

168,850,5400,3900,21060000,2,6806,1703,1,231720000,231720000,2551,850,1701,850,0,1,852,4344640
168,850,5400,3900,21060000,2,6806,1703,1,231720000,231720000,2551,850,1701,850,0,1,852,582040
168,850,5400,3900,21060000,2,6806,1703,1,231720000,231720000,2551,850,1701,850,0,1,852,574666
168,850,5400,3900,21060000,2,6806,1703,1,231720000,231720000,2551,850,1701,850,0,1,852,594347
168,850,5400,3900,21060000,2,6806,1703,1,231720000,231720000,2551,850,1701,850,0,1,852,580520
168,850,5400,3900,21060000,2,6806,1703,1,231720000,231720000,2551,850,1701,850,0,1,852,600900
168,850,5400,3900,21060000,2,6806,1703,1,231720000,231720000,2551,850,1701,850,0,1,852,601374

168,1250,5400,3900,21060000,2,10006,2503,1,261480000,261480000,3751,1250,2501,1250,0,1,1252,6769367
168,1250,5400,3900,21060000,2,10006,2503,1,261480000,261480000,3751,1250,2501,1250,0,1,1252,796447
168,1250,5400,3900,21060000,2,10006,2503,1,261480000,261480000,3751,1250,2501,1250,0,1,1252,798334
168,1250,5400,3900,21060000,2,10006,2503,1,261480000,261480000,3751,1250,2501,1250,0,1,1252,748592
168,1250,5400,3900,21060000,2,10006,2503,1,261480000,261480000,3751,1250,2501,1250,0,1,1252,799877
168,1250,5400,3900,21060000,2,10006,2503,1,261480000,261480000,3751,1250,2501,1250,0,1,1252,810000
168,1250,5400,3900,21060000,2,10006,2503,1,261480000,261480000,3751,1250,2501,1250,0,1,1252,810517

168,1650,5400,3900,21060000,2,13206,3303,1,291240000,291240000,4951,1650,3301,1650,0,1,1652,8931176
168,1650,5400,3900,21060000,2,13206,3303,1,291240000,291240000,4951,1650,3301,1650,0,1,1652,962426
168,1650,5400,3900,21060000,2,13206,3303,1,291240000,291240000,4951,1650,3301,1650,0,1,1652,960136
168,1650,5400,3900,21060000,2,13206,3303,1,291240000,291240000,4951,1650,3301,1650,0,1,1652,961468
168,1650,5400,3900,21060000,2,13206,3303,1,291240000,291240000,4951,1650,3301,1650,0,1,1652,958584
168,1650,5400,3900,21060000,2,13206,3303,1,291240000,291240000,4951,1650,3301,1650,0,1,1652,965921
168,1650,5400,3900,21060000,2,13206,3303,1,291240000,291240000,4951,1650,3301,1650,0,1,1652,966491

168,2050,5400,3900,21060000,2,16406,4103,1,321000000,321000000,6151,2050,4101,2050,0,1,2052,11867256
168,2050,5400,3900,21060000,2,16406,4103,1,321000000,321000000,6151,2050,4101,2050,0,1,2052,1107377
168,2050,5400,3900,21060000,2,16406,4103,1,321000000,321000000,6151,2050,4101,2050,0,1,2052,1106184
168,2050,5400,3900,21060000,2,16406,4103,1,321000000,321000000,6151,2050,4101,2050,0,1,2052,1104587
168,2050,5400,3900,21060000,2,16406,4103,1,321000000,321000000,6151,2050,4101,2050,0,1,2052,1098009
168,2050,5400,3900,21060000,2,16406,4103,1,321000000,321000000,6151,2050,4101,2050,0,1,2052,1126302
168,2050,5400,3900,21060000,2,16406,4103,1,321000000,321000000,6151,2050,4101,2050,0,1,2052,1126902

168,2450,5400,3900,21060000,2,19606,4903,1,350760000,350760000,7351,2450,4901,2450,0,1,2452,14214925
168,2450,5400,3900,21060000,2,19606,4903,1,350760000,350760000,7351,2450,4901,2450,0,1,2452,1329996
168,2450,5400,3900,21060000,2,19606,4903,1,350760000,350760000,7351,2450,4901,2450,0,1,2452,1316932
168,2450,5400,3900,21060000,2,19606,4903,1,350760000,350760000,7351,2450,4901,2450,0,1,2452,1336568
168,2450,5400,3900,21060000,2,19606,4903,1,350760000,350760000,7351,2450,4901,2450,0,1,2452,1332736
168,2450,5400,3900,21060000,2,19606,4903,1,350760000,350760000,7351,2450,4901,2450,0,1,2452,1338035
168,2450,5400,3900,21060000,2,19606,4903,1,350760000,350760000,7351,2450,4901,2450,0,1,2452,1338714

168,2850,5400,3900,21060000,2,22806,5703,1,380520000,380520000,8551,2850,5701,2850,0,1,2852,16993336
168,2850,5400,3900,21060000,2,22806,5703,1,380520000,380520000,8551,2850,5701,2850,0,1,2852,1541437
168,2850,5400,3900,21060000,2,22806,5703,1,380520000,380520000,8551,2850,5701,2850,0,1,2852,1539384
168,2850,5400,3900,21060000,2,22806,5703,1,380520000,380520000,8551,2850,5701,2850,0,1,2852,1497823
168,2850,5400,3900,21060000,2,22806,5703,1,380520000,380520000,8551,2850,5701,2850,0,1,2852,1543595
168,2850,5400,3900,21060000,2,22806,5703,1,380520000,380520000,8551,2850,5701,2850,0,1,2852,1545985
168,2850,5400,3900,21060000,2,22806,5703,1,380520000,380520000,8551,2850,5701,2850,0,1,2852,1546706

168,3250,5400,3900,21060000,2,26006,6503,1,410280000,410280000,9751,3250,6501,3250,0,1,3252,18590583
168,3250,5400,3900,21060000,2,26006,6503,1,410280000,410280000,9751,3250,6501,3250,0,1,3252,1702346
168,3250,5400,3900,21060000,2,26006,6503,1,410280000,410280000,9751,3250,6501,3250,0,1,3252,1695537
168,3250,5400,3900,21060000,2,26006,6503,1,410280000,410280000,9751,3250,6501,3250,0,1,3252,1701535
168,3250,5400,3900,21060000,2,26006,6503,1,410280000,410280000,9751,3250,6501,3250,0,1,3252,1700723
168,3250,5400,3900,21060000,2,26006,6503,1,410280000,410280000,9751,3250,6501,3250,0,1,3252,1698756
168,3250,5400,3900,21060000,2,26006,6503,1,410280000,410280000,9751,3250,6501,3250,0,1,3252,1699985

168,3650,5400,3900,21060000,2,29206,7303,1,440040000,440040000,10951,3650,7301,3650,0,1,3652,21638906
168,3650,5400,3900,21060000,2,29206,7303,1,440040000,440040000,10951,3650,7301,3650,0,1,3652,1930039
168,3650,5400,3900,21060000,2,29206,7303,1,440040000,440040000,10951,3650,7301,3650,0,1,3652,1928910
168,3650,5400,3900,21060000,2,29206,7303,1,440040000,440040000,10951,3650,7301,3650,0,1,3652,1925093
168,3650,5400,3900,21060000,2,29206,7303,1,440040000,440040000,10951,3650,7301,3650,0,1,3652,1920021
168,3650,5400,3900,21060000,2,29206,7303,1,440040000,440040000,10951,3650,7301,3650,0,1,3652,1906665
168,3650,5400,3900,21060000,2,29206,7303,1,440040000,440040000,10951,3650,7301,3650,0,1,3652,1908769

168,4050,5400,3900,21060000,2,32406,8103,1,469800000,469800000,12151,4050,8101,4050,0,1,4052,24104928
168,4050,5400,3900,21060000,2,32406,8103,1,469800000,469800000,12151,4050,8101,4050,0,1,4052,2070144
168,4050,5400,3900,21060000,2,32406,8103,1,469800000,469800000,12151,4050,8101,4050,0,1,4052,2072273
168,4050,5400,3900,21060000,2,32406,8103,1,469800000,469800000,12151,4050,8101,4050,0,1,4052,2079244
168,4050,5400,3900,21060000,2,32406,8103,1,469800000,469800000,12151,4050,8101,4050,0,1,4052,2071290
168,4050,5400,3900,21060000,2,32406,8103,1,469800000,469800000,12151,4050,8101,4050,0,1,4052,2054953
168,4050,5400,3900,21060000,2,32406,8103,1,469800000,469800000,12151,4050,8101,4050,0,1,4052,2056659

168,4450,5400,3900,21060000,2,35606,8903,1,499560000,499560000,13351,4450,8901,4450,0,1,4452,26562452
168,4450,5400,3900,21060000,2,35606,8903,1,499560000,499560000,13351,4450,8901,4450,0,1,4452,2296025
168,4450,5400,3900,21060000,2,35606,8903,1,499560000,499560000,13351,4450,8901,4450,0,1,4452,2287873
168,4450,5400,3900,21060000,2,35606,8903,1,499560000,499560000,13351,4450,8901,4450,0,1,4452,2281599
168,4450,5400,3900,21060000,2,35606,8903,1,499560000,499560000,13351,4450,8901,4450,0,1,4452,2297293
168,4450,5400,3900,21060000,2,35606,8903,1,499560000,499560000,13351,4450,8901,4450,0,1,4452,2270106
168,4450,5400,3900,21060000,2,35606,8903,1,499560000,499560000,13351,4450,8901,4450,0,1,4452,2272562

168,4850,5400,3900,21060000,2,38806,9703,1,529320000,529320000,14551,4850,9701,4850,0,1,4852,29138941
168,4850,5400,3900,21060000,2,38806,9703,1,529320000,529320000,14551,4850,9701,4850,0,1,4852,2501597
168,4850,5400,3900,21060000,2,38806,9703,1,529320000,529320000,14551,4850,9701,4850,0,1,4852,2498946
168,4850,5400,3900,21060000,2,38806,9703,1,529320000,529320000,14551,4850,9701,4850,0,1,4852,2497477
168,4850,5400,3900,21060000,2,38806,9703,1,529320000,529320000,14551,4850,9701,4850,0,1,4852,2495314
168,4850,5400,3900,21060000,2,38806,9703,1,529320000,529320000,14551,4850,9701,4850,0,1,4852,2442389
168,4850,5400,3900,21060000,2,38806,9703,1,529320000,529320000,14551,4850,9701,4850,0,1,4852,2456128

168,5250,5400,3900,21060000,2,42006,10503,1,559080000,559080000,15751,5250,10501,5250,0,1,5252,33037174
168,5250,5400,3900,21060000,2,42006,10503,1,559080000,559080000,15751,5250,10501,5250,0,1,5252,2687048
168,5250,5400,3900,21060000,2,42006,10503,1,559080000,559080000,15751,5250,10501,5250,0,1,5252,2683961
168,5250,5400,3900,21060000,2,42006,10503,1,559080000,559080000,15751,5250,10501,5250,0,1,5252,2694442
168,5250,5400,3900,21060000,2,42006,10503,1,559080000,559080000,15751,5250,10501,5250,0,1,5252,2693010
168,5250,5400,3900,21060000,2,42006,10503,1,559080000,559080000,15751,5250,10501,5250,0,1,5252,2651569
168,5250,5400,3900,21060000,2,42006,10503,1,559080000,559080000,15751,5250,10501,5250,0,1,5252,2648878

168,5650,5400,3900,21060000,2,45206,11303,1,588840000,588840000,16951,5650,11301,5650,0,1,5652,36226026
168,5650,5400,3900,21060000,2,45206,11303,1,588840000,588840000,16951,5650,11301,5650,0,1,5652,2886587
168,5650,5400,3900,21060000,2,45206,11303,1,588840000,588840000,16951,5650,11301,5650,0,1,5652,2879152
168,5650,5400,3900,21060000,2,45206,11303,1,588840000,588840000,16951,5650,11301,5650,0,1,5652,2888097
168,5650,5400,3900,21060000,2,45206,11303,1,588840000,588840000,16951,5650,11301,5650,0,1,5652,2883963
168,5650,5400,3900,21060000,2,45206,11303,1,588840000,588840000,16951,5650,11301,5650,0,1,5652,2815637
168,5650,5400,3900,21060000,2,45206,11303,1,588840000,588840000,16951,5650,11301,5650,0,1,5652,2827206

168,6050,5400,3900,21060000,2,48406,12103,1,618600000,618600000,18151,6050,12101,6050,0,1,6052,36426414
168,6050,5400,3900,21060000,2,48406,12103,1,618600000,618600000,18151,6050,12101,6050,0,1,6052,3075673
168,6050,5400,3900,21060000,2,48406,12103,1,618600000,618600000,18151,6050,12101,6050,0,1,6052,3078910
168,6050,5400,3900,21060000,2,48406,12103,1,618600000,618600000,18151,6050,12101,6050,0,1,6052,3077327
168,6050,5400,3900,21060000,2,48406,12103,1,618600000,618600000,18151,6050,12101,6050,0,1,6052,3073236
168,6050,5400,3900,21060000,2,48406,12103,1,618600000,618600000,18151,6050,12101,6050,0,1,6052,3014791
168,6050,5400,3900,21060000,2,48406,12103,1,618600000,618600000,18151,6050,12101,6050,0,1,6052,3007655

168,6450,5400,3900,21060000,2,51606,12903,1,648360000,648360000,19351,6450,12901,6450,0,1,6452,39505798
168,6450,5400,3900,21060000,2,51606,12903,1,648360000,648360000,19351,6450,12901,6450,0,1,6452,3265965
168,6450,5400,3900,21060000,2,51606,12903,1,648360000,648360000,19351,6450,12901,6450,0,1,6452,3261202
168,6450,5400,3900,21060000,2,51606,12903,1,648360000,648360000,19351,6450,12901,6450,0,1,6452,3267596
168,6450,5400,3900,21060000,2,51606,12903,1,648360000,648360000,19351,6450,12901,6450,0,1,6452,3263374
168,6450,5400,3900,21060000,2,51606,12903,1,648360000,648360000,19351,6450,12901,6450,0,1,6452,3179547
168,6450,5400,3900,21060000,2,51606,12903,1,648360000,648360000,19351,6450,12901,6450,0,1,6452,3184444

168,6850,5400,3900,21060000,2,54806,13703,1,678120000,678120000,20551,6850,13701,6850,0,1,6852,42450613
168,6850,5400,3900,21060000,2,54806,13703,1,678120000,678120000,20551,6850,13701,6850,0,1,6852,3460272
168,6850,5400,3900,21060000,2,54806,13703,1,678120000,678120000,20551,6850,13701,6850,0,1,6852,3453003
168,6850,5400,3900,21060000,2,54806,13703,1,678120000,678120000,20551,6850,13701,6850,0,1,6852,3462197
168,6850,5400,3900,21060000,2,54806,13703,1,678120000,678120000,20551,6850,13701,6850,0,1,6852,3457847
168,6850,5400,3900,21060000,2,54806,13703,1,678120000,678120000,20551,6850,13701,6850,0,1,6852,3341045
168,6850,5400,3900,21060000,2,54806,13703,1,678120000,678120000,20551,6850,13701,6850,0,1,6852,3366888

168,50,5400,3500,18900000,2,406,103,1,154760000,154760000,151,50,101,50,0,1,52,200943
168,50,5400,3500,18900000,2,406,103,1,154760000,154760000,151,50,101,50,0,1,52,190993
168,50,5400,3500,18900000,2,406,103,1,154760000,154760000,151,50,101,50,0,1,52,191640
168,50,5400,3500,18900000,2,406,103,1,154760000,154760000,151,50,101,50,0,1,52,176942
168,50,5400,3500,18900000,2,406,103,1,154760000,154760000,151,50,101,50,0,1,52,190377
168,50,5400,3500,18900000,2,406,103,1,154760000,154760000,151,50,101,50,0,1,52,217661
168,50,5400,3500,18900000,2,406,103,1,154760000,154760000,151,50,101,50,0,1,52,218040

168,450,5400,3500,18900000,2,3606,903,1,183240000,183240000,1351,450,901,450,0,1,452,1886064
168,450,5400,3500,18900000,2,3606,903,1,183240000,183240000,1351,450,901,450,0,1,452,359577
168,450,5400,3500,18900000,2,3606,903,1,183240000,183240000,1351,450,901,450,0,1,452,358279
168,450,5400,3500,18900000,2,3606,903,1,183240000,183240000,1351,450,901,450,0,1,452,356604
168,450,5400,3500,18900000,2,3606,903,1,183240000,183240000,1351,450,901,450,0,1,452,359074
168,450,5400,3500,18900000,2,3606,903,1,183240000,183240000,1351,450,901,450,0,1,452,366307
168,450,5400,3500,18900000,2,3606,903,1,183240000,183240000,1351,450,901,450,0,1,452,366745

168,850,5400,3500,18900000,2,6806,1703,1,211720000,211720000,2551,850,1701,850,0,1,852,3724161
168,850,5400,3500,18900000,2,6806,1703,1,211720000,211720000,2551,850,1701,850,0,1,852,522810
168,850,5400,3500,18900000,2,6806,1703,1,211720000,211720000,2551,850,1701,850,0,1,852,525756
168,850,5400,3500,18900000,2,6806,1703,1,211720000,211720000,2551,850,1701,850,0,1,852,526397
168,850,5400,3500,18900000,2,6806,1703,1,211720000,211720000,2551,850,1701,850,0,1,852,524805
168,850,5400,3500,18900000,2,6806,1703,1,211720000,211720000,2551,850,1701,850,0,1,852,533951
168,850,5400,3500,18900000,2,6806,1703,1,211720000,211720000,2551,850,1701,850,0,1,852,534420

168,1250,5400,3500,18900000,2,10006,2503,1,240200000,240200000,3751,1250,2501,1250,0,1,1252,6004771
168,1250,5400,3500,18900000,2,10006,2503,1,240200000,240200000,3751,1250,2501,1250,0,1,1252,718464
168,1250,5400,3500,18900000,2,10006,2503,1,240200000,240200000,3751,1250,2501,1250,0,1,1252,731091
168,1250,5400,3500,18900000,2,10006,2503,1,240200000,240200000,3751,1250,2501,1250,0,1,1252,729554
168,1250,5400,3500,18900000,2,10006,2503,1,240200000,240200000,3751,1250,2501,1250,0,1,1252,730517
168,1250,5400,3500,18900000,2,10006,2503,1,240200000,240200000,3751,1250,2501,1250,0,1,1252,734049
168,1250,5400,3500,18900000,2,10006,2503,1,240200000,240200000,3751,1250,2501,1250,0,1,1252,733529

168,1650,5400,3500,18900000,2,13206,3303,1,268680000,268680000,4951,1650,3301,1650,0,1,1652,8107926
168,1650,5400,3500,18900000,2,13206,3303,1,268680000,268680000,4951,1650,3301,1650,0,1,1652,836440
168,1650,5400,3500,18900000,2,13206,3303,1,268680000,268680000,4951,1650,3301,1650,0,1,1652,837299
168,1650,5400,3500,18900000,2,13206,3303,1,268680000,268680000,4951,1650,3301,1650,0,1,1652,835274
168,1650,5400,3500,18900000,2,13206,3303,1,268680000,268680000,4951,1650,3301,1650,0,1,1652,831906
168,1650,5400,3500,18900000,2,13206,3303,1,268680000,268680000,4951,1650,3301,1650,0,1,1652,859603
168,1650,5400,3500,18900000,2,13206,3303,1,268680000,268680000,4951,1650,3301,1650,0,1,1652,860188

168,2050,5400,3500,18900000,2,16406,4103,1,297160000,297160000,6151,2050,4101,2050,0,1,2052,10207173
168,2050,5400,3500,18900000,2,16406,4103,1,297160000,297160000,6151,2050,4101,2050,0,1,2052,1029547
168,2050,5400,3500,18900000,2,16406,4103,1,297160000,297160000,6151,2050,4101,2050,0,1,2052,1033861
168,2050,5400,3500,18900000,2,16406,4103,1,297160000,297160000,6151,2050,4101,2050,0,1,2052,1032632
168,2050,5400,3500,18900000,2,16406,4103,1,297160000,297160000,6151,2050,4101,2050,0,1,2052,1031146
168,2050,5400,3500,18900000,2,16406,4103,1,297160000,297160000,6151,2050,4101,2050,0,1,2052,1038695
168,2050,5400,3500,18900000,2,16406,4103,1,297160000,297160000,6151,2050,4101,2050,0,1,2052,1039311

168,2450,5400,3500,18900000,2,19606,4903,1,325640000,325640000,7351,2450,4901,2450,0,1,2452,12409905
168,2450,5400,3500,18900000,2,19606,4903,1,325640000,325640000,7351,2450,4901,2450,0,1,2452,1185897
168,2450,5400,3500,18900000,2,19606,4903,1,325640000,325640000,7351,2450,4901,2450,0,1,2452,1181515
168,2450,5400,3500,18900000,2,19606,4903,1,325640000,325640000,7351,2450,4901,2450,0,1,2452,1187749
168,2450,5400,3500,18900000,2,19606,4903,1,325640000,325640000,7351,2450,4901,2450,0,1,2452,1184457
168,2450,5400,3500,18900000,2,19606,4903,1,325640000,325640000,7351,2450,4901,2450,0,1,2452,1199182
168,2450,5400,3500,18900000,2,19606,4903,1,325640000,325640000,7351,2450,4901,2450,0,1,2452,1200028

168,2850,5400,3500,18900000,2,22806,5703,1,354120000,354120000,8551,2850,5701,2850,0,1,2852,14966610
168,2850,5400,3500,18900000,2,22806,5703,1,354120000,354120000,8551,2850,5701,2850,0,1,2852,1401208
168,2850,5400,3500,18900000,2,22806,5703,1,354120000,354120000,8551,2850,5701,2850,0,1,2852,1389060
168,2850,5400,3500,18900000,2,22806,5703,1,354120000,354120000,8551,2850,5701,2850,0,1,2852,1405175
168,2850,5400,3500,18900000,2,22806,5703,1,354120000,354120000,8551,2850,5701,2850,0,1,2852,1404180
168,2850,5400,3500,18900000,2,22806,5703,1,354120000,354120000,8551,2850,5701,2850,0,1,2852,1406712
168,2850,5400,3500,18900000,2,22806,5703,1,354120000,354120000,8551,2850,5701,2850,0,1,2852,1407415

168,3250,5400,3500,18900000,2,26006,6503,1,382600000,382600000,9751,3250,6501,3250,0,1,3252,16868132
168,3250,5400,3500,18900000,2,26006,6503,1,382600000,382600000,9751,3250,6501,3250,0,1,3252,1538876
168,3250,5400,3500,18900000,2,26006,6503,1,382600000,382600000,9751,3250,6501,3250,0,1,3252,1535401
168,3250,5400,3500,18900000,2,26006,6503,1,382600000,382600000,9751,3250,6501,3250,0,1,3252,1540226
168,3250,5400,3500,18900000,2,26006,6503,1,382600000,382600000,9751,3250,6501,3250,0,1,3252,1537600
168,3250,5400,3500,18900000,2,26006,6503,1,382600000,382600000,9751,3250,6501,3250,0,1,3252,1541820
168,3250,5400,3500,18900000,2,26006,6503,1,382600000,382600000,9751,3250,6501,3250,0,1,3252,1542581

168,3650,5400,3500,18900000,2,29206,7303,1,411080000,411080000,10951,3650,7301,3650,0,1,3652,19880836
168,3650,5400,3500,18900000,2,29206,7303,1,411080000,411080000,10951,3650,7301,3650,0,1,3652,1746760
168,3650,5400,3500,18900000,2,29206,7303,1,411080000,411080000,10951,3650,7301,3650,0,1,3652,1751447
168,3650,5400,3500,18900000,2,29206,7303,1,411080000,411080000,10951,3650,7301,3650,0,1,3652,1750137
168,3650,5400,3500,18900000,2,29206,7303,1,411080000,411080000,10951,3650,7301,3650,0,1,3652,1748620
168,3650,5400,3500,18900000,2,29206,7303,1,411080000,411080000,10951,3650,7301,3650,0,1,3652,1738723
168,3650,5400,3500,18900000,2,29206,7303,1,411080000,411080000,10951,3650,7301,3650,0,1,3652,1743711

168,4050,5400,3500,18900000,2,32406,8103,1,439560000,439560000,12151,4050,8101,4050,0,1,4052,21261385
168,4050,5400,3500,18900000,2,32406,8103,1,439560000,439560000,12151,4050,8101,4050,0,1,4052,1878039
168,4050,5400,3500,18900000,2,32406,8103,1,439560000,439560000,12151,4050,8101,4050,0,1,4052,1877068
168,4050,5400,3500,18900000,2,32406,8103,1,439560000,439560000,12151,4050,8101,4050,0,1,4052,1879220
168,4050,5400,3500,18900000,2,32406,8103,1,439560000,439560000,12151,4050,8101,4050,0,1,4052,1875412
168,4050,5400,3500,18900000,2,32406,8103,1,439560000,439560000,12151,4050,8101,4050,0,1,4052,1862934
168,4050,5400,3500,18900000,2,32406,8103,1,439560000,439560000,12151,4050,8101,4050,0,1,4052,1864870

168,4450,5400,3500,18900000,2,35606,8903,1,468040000,468040000,13351,4450,8901,4450,0,1,4452,23252689
168,4450,5400,3500,18900000,2,35606,8903,1,468040000,468040000,13351,4450,8901,4450,0,1,4452,2083756
168,4450,5400,3500,18900000,2,35606,8903,1,468040000,468040000,13351,4450,8901,4450,0,1,4452,2093017
168,4450,5400,3500,18900000,2,35606,8903,1,468040000,468040000,13351,4450,8901,4450,0,1,4452,2091719
168,4450,5400,3500,18900000,2,35606,8903,1,468040000,468040000,13351,4450,8901,4450,0,1,4452,2090503
168,4450,5400,3500,18900000,2,35606,8903,1,468040000,468040000,13351,4450,8901,4450,0,1,4452,2061909
168,4450,5400,3500,18900000,2,35606,8903,1,468040000,468040000,13351,4450,8901,4450,0,1,4452,2064105

168,4850,5400,3500,18900000,2,38806,9703,1,496520000,496520000,14551,4850,9701,4850,0,1,4852,27040374
168,4850,5400,3500,18900000,2,38806,9703,1,496520000,496520000,14551,4850,9701,4850,0,1,4852,2219991
168,4850,5400,3500,18900000,2,38806,9703,1,496520000,496520000,14551,4850,9701,4850,0,1,4852,2216236
168,4850,5400,3500,18900000,2,38806,9703,1,496520000,496520000,14551,4850,9701,4850,0,1,4852,2221098
168,4850,5400,3500,18900000,2,38806,9703,1,496520000,496520000,14551,4850,9701,4850,0,1,4852,2218862
168,4850,5400,3500,18900000,2,38806,9703,1,496520000,496520000,14551,4850,9701,4850,0,1,4852,2191518
168,4850,5400,3500,18900000,2,38806,9703,1,496520000,496520000,14551,4850,9701,4850,0,1,4852,2193544

168,5250,5400,3500,18900000,2,42006,10503,1,525000000,525000000,15751,5250,10501,5250,0,1,5252,28290288
168,5250,5400,3500,18900000,2,42006,10503,1,525000000,525000000,15751,5250,10501,5250,0,1,5252,2429124
168,5250,5400,3500,18900000,2,42006,10503,1,525000000,525000000,15751,5250,10501,5250,0,1,5252,2424861
168,5250,5400,3500,18900000,2,42006,10503,1,525000000,525000000,15751,5250,10501,5250,0,1,5252,2432278
168,5250,5400,3500,18900000,2,42006,10503,1,525000000,525000000,15751,5250,10501,5250,0,1,5252,2433744
168,5250,5400,3500,18900000,2,42006,10503,1,525000000,525000000,15751,5250,10501,5250,0,1,5252,2393802
168,5250,5400,3500,18900000,2,42006,10503,1,525000000,525000000,15751,5250,10501,5250,0,1,5252,2395853

168,5650,5400,3500,18900000,2,45206,11303,1,553480000,553480000,16951,5650,11301,5650,0,1,5652,30333814
168,5650,5400,3500,18900000,2,45206,11303,1,553480000,553480000,16951,5650,11301,5650,0,1,5652,2603864
168,5650,5400,3500,18900000,2,45206,11303,1,553480000,553480000,16951,5650,11301,5650,0,1,5652,2611624
168,5650,5400,3500,18900000,2,45206,11303,1,553480000,553480000,16951,5650,11301,5650,0,1,5652,2610079
168,5650,5400,3500,18900000,2,45206,11303,1,553480000,553480000,16951,5650,11301,5650,0,1,5652,2608681
168,5650,5400,3500,18900000,2,45206,11303,1,553480000,553480000,16951,5650,11301,5650,0,1,5652,2564181
168,5650,5400,3500,18900000,2,45206,11303,1,553480000,553480000,16951,5650,11301,5650,0,1,5652,2566637

168,6050,5400,3500,18900000,2,48406,12103,1,581960000,581960000,18151,6050,12101,6050,0,1,6052,33418964
168,6050,5400,3500,18900000,2,48406,12103,1,581960000,581960000,18151,6050,12101,6050,0,1,6052,2732008
168,6050,5400,3500,18900000,2,48406,12103,1,581960000,581960000,18151,6050,12101,6050,0,1,6052,2727403
168,6050,5400,3500,18900000,2,48406,12103,1,581960000,581960000,18151,6050,12101,6050,0,1,6052,2733557
168,6050,5400,3500,18900000,2,48406,12103,1,581960000,581960000,18151,6050,12101,6050,0,1,6052,2729597
168,6050,5400,3500,18900000,2,48406,12103,1,581960000,581960000,18151,6050,12101,6050,0,1,6052,2686054
168,6050,5400,3500,18900000,2,48406,12103,1,581960000,581960000,18151,6050,12101,6050,0,1,6052,2688402

168,6450,5400,3500,18900000,2,51606,12903,1,610440000,610440000,19351,6450,12901,6450,0,1,6452,33905839
168,6450,5400,3500,18900000,2,51606,12903,1,610440000,610440000,19351,6450,12901,6450,0,1,6452,2990389
168,6450,5400,3500,18900000,2,51606,12903,1,610440000,610440000,19351,6450,12901,6450,0,1,6452,2991724
168,6450,5400,3500,18900000,2,51606,12903,1,610440000,610440000,19351,6450,12901,6450,0,1,6452,2993365
168,6450,5400,3500,18900000,2,51606,12903,1,610440000,610440000,19351,6450,12901,6450,0,1,6452,2988269
168,6450,5400,3500,18900000,2,51606,12903,1,610440000,610440000,19351,6450,12901,6450,0,1,6452,2908356
168,6450,5400,3500,18900000,2,51606,12903,1,610440000,610440000,19351,6450,12901,6450,0,1,6452,2912714

168,6850,5400,3500,18900000,2,54806,13703,1,638920000,638920000,20551,6850,13701,6850,0,1,6852,37329602
168,6850,5400,3500,18900000,2,54806,13703,1,638920000,638920000,20551,6850,13701,6850,0,1,6852,3106217
168,6850,5400,3500,18900000,2,54806,13703,1,638920000,638920000,20551,6850,13701,6850,0,1,6852,3114807
168,6850,5400,3500,18900000,2,54806,13703,1,638920000,638920000,20551,6850,13701,6850,0,1,6852,3112890
168,6850,5400,3500,18900000,2,54806,13703,1,638920000,638920000,20551,6850,13701,6850,0,1,6852,3110532
168,6850,5400,3500,18900000,2,54806,13703,1,638920000,638920000,20551,6850,13701,6850,0,1,6852,3046345
168,6850,5400,3500,18900000,2,54806,13703,1,638920000,638920000,20551,6850,13701,6850,0,1,6852,3049202

168,50,5400,3100,16740000,2,406,103,1,137320000,137320000,151,50,101,50,0,1,52,180218
168,50,5400,3100,16740000,2,406,103,1,137320000,137320000,151,50,101,50,0,1,52,158342
168,50,5400,3100,16740000,2,406,103,1,137320000,137320000,151,50,101,50,0,1,52,162851
168,50,5400,3100,16740000,2,406,103,1,137320000,137320000,151,50,101,50,0,1,52,148426
168,50,5400,3100,16740000,2,406,103,1,137320000,137320000,151,50,101,50,0,1,52,162386
168,50,5400,3100,16740000,2,406,103,1,137320000,137320000,151,50,101,50,0,1,52,204105
168,50,5400,3100,16740000,2,406,103,1,137320000,137320000,151,50,101,50,0,1,52,204486

168,450,5400,3100,16740000,2,3606,903,1,164520000,164520000,1351,450,901,450,0,1,452,1763295
168,450,5400,3100,16740000,2,3606,903,1,164520000,164520000,1351,450,901,450,0,1,452,312690
168,450,5400,3100,16740000,2,3606,903,1,164520000,164520000,1351,450,901,450,0,1,452,311668
168,450,5400,3100,16740000,2,3606,903,1,164520000,164520000,1351,450,901,450,0,1,452,314019
168,450,5400,3100,16740000,2,3606,903,1,164520000,164520000,1351,450,901,450,0,1,452,313541
168,450,5400,3100,16740000,2,3606,903,1,164520000,164520000,1351,450,901,450,0,1,452,322908
168,450,5400,3100,16740000,2,3606,903,1,164520000,164520000,1351,450,901,450,0,1,452,323335

168,850,5400,3100,16740000,2,6806,1703,1,191720000,191720000,2551,850,1701,850,0,1,852,3446709
168,850,5400,3100,16740000,2,6806,1703,1,191720000,191720000,2551,850,1701,850,0,1,852,471634
168,850,5400,3100,16740000,2,6806,1703,1,191720000,191720000,2551,850,1701,850,0,1,852,468007
168,850,5400,3100,16740000,2,6806,1703,1,191720000,191720000,2551,850,1701,850,0,1,852,472257
168,850,5400,3100,16740000,2,6806,1703,1,191720000,191720000,2551,850,1701,850,0,1,852,470662
168,850,5400,3100,16740000,2,6806,1703,1,191720000,191720000,2551,850,1701,850,0,1,852,479468
168,850,5400,3100,16740000,2,6806,1703,1,191720000,191720000,2551,850,1701,850,0,1,852,479941

168,1250,5400,3100,16740000,2,10006,2503,1,218920000,218920000,3751,1250,2501,1250,0,1,1252,5088865
168,1250,5400,3100,16740000,2,10006,2503,1,218920000,218920000,3751,1250,2501,1250,0,1,1252,621685
168,1250,5400,3100,16740000,2,10006,2503,1,218920000,218920000,3751,1250,2501,1250,0,1,1252,622575
168,1250,5400,3100,16740000,2,10006,2503,1,218920000,218920000,3751,1250,2501,1250,0,1,1252,619078
168,1250,5400,3100,16740000,2,10006,2503,1,218920000,218920000,3751,1250,2501,1250,0,1,1252,620466
168,1250,5400,3100,16740000,2,10006,2503,1,218920000,218920000,3751,1250,2501,1250,0,1,1252,626283
168,1250,5400,3100,16740000,2,10006,2503,1,218920000,218920000,3751,1250,2501,1250,0,1,1252,626803

168,1650,5400,3100,16740000,2,13206,3303,1,246120000,246120000,4951,1650,3301,1650,0,1,1652,7145099
168,1650,5400,3100,16740000,2,13206,3303,1,246120000,246120000,4951,1650,3301,1650,0,1,1652,795321
168,1650,5400,3100,16740000,2,13206,3303,1,246120000,246120000,4951,1650,3301,1650,0,1,1652,782157
168,1650,5400,3100,16740000,2,13206,3303,1,246120000,246120000,4951,1650,3301,1650,0,1,1652,796600
168,1650,5400,3100,16740000,2,13206,3303,1,246120000,246120000,4951,1650,3301,1650,0,1,1652,767762
168,1650,5400,3100,16740000,2,13206,3303,1,246120000,246120000,4951,1650,3301,1650,0,1,1652,809223
168,1650,5400,3100,16740000,2,13206,3303,1,246120000,246120000,4951,1650,3301,1650,0,1,1652,808658

168,2050,5400,3100,16740000,2,16406,4103,1,273320000,273320000,6151,2050,4101,2050,0,1,2052,9059417
168,2050,5400,3100,16740000,2,16406,4103,1,273320000,273320000,6151,2050,4101,2050,0,1,2052,887570
168,2050,5400,3100,16740000,2,16406,4103,1,273320000,273320000,6151,2050,4101,2050,0,1,2052,892814
168,2050,5400,3100,16740000,2,16406,4103,1,273320000,273320000,6151,2050,4101,2050,0,1,2052,894566
168,2050,5400,3100,16740000,2,16406,4103,1,273320000,273320000,6151,2050,4101,2050,0,1,2052,891067
168,2050,5400,3100,16740000,2,16406,4103,1,273320000,273320000,6151,2050,4101,2050,0,1,2052,922890
168,2050,5400,3100,16740000,2,16406,4103,1,273320000,273320000,6151,2050,4101,2050,0,1,2052,923507

168,2450,5400,3100,16740000,2,19606,4903,1,300520000,300520000,7351,2450,4901,2450,0,1,2452,11081977
168,2450,5400,3100,16740000,2,19606,4903,1,300520000,300520000,7351,2450,4901,2450,0,1,2452,1054515
168,2450,5400,3100,16740000,2,19606,4903,1,300520000,300520000,7351,2450,4901,2450,0,1,2452,1051663
168,2450,5400,3100,16740000,2,19606,4903,1,300520000,300520000,7351,2450,4901,2450,0,1,2452,1053091
168,2450,5400,3100,16740000,2,19606,4903,1,300520000,300520000,7351,2450,4901,2450,0,1,2452,1049198
168,2450,5400,3100,16740000,2,19606,4903,1,300520000,300520000,7351,2450,4901,2450,0,1,2452,1070912
168,2450,5400,3100,16740000,2,19606,4903,1,300520000,300520000,7351,2450,4901,2450,0,1,2452,1071575

168,2850,5400,3100,16740000,2,22806,5703,1,327720000,327720000,8551,2850,5701,2850,0,1,2852,13150866
168,2850,5400,3100,16740000,2,22806,5703,1,327720000,327720000,8551,2850,5701,2850,0,1,2852,1204054
168,2850,5400,3100,16740000,2,22806,5703,1,327720000,327720000,8551,2850,5701,2850,0,1,2852,1208436
168,2850,5400,3100,16740000,2,22806,5703,1,327720000,327720000,8551,2850,5701,2850,0,1,2852,1209981
168,2850,5400,3100,16740000,2,22806,5703,1,327720000,327720000,8551,2850,5701,2850,0,1,2852,1206631
168,2850,5400,3100,16740000,2,22806,5703,1,327720000,327720000,8551,2850,5701,2850,0,1,2852,1219392
168,2850,5400,3100,16740000,2,22806,5703,1,327720000,327720000,8551,2850,5701,2850,0,1,2852,1220103

168,3250,5400,3100,16740000,2,26006,6503,1,354920000,354920000,9751,3250,6501,3250,0,1,3252,14889137
168,3250,5400,3100,16740000,2,26006,6503,1,354920000,354920000,9751,3250,6501,3250,0,1,3252,1403898
168,3250,5400,3100,16740000,2,26006,6503,1,354920000,354920000,9751,3250,6501,3250,0,1,3252,1411769
168,3250,5400,3100,16740000,2,26006,6503,1,354920000,354920000,9751,3250,6501,3250,0,1,3252,1409625
168,3250,5400,3100,16740000,2,26006,6503,1,354920000,354920000,9751,3250,6501,3250,0,1,3252,1408689
168,3250,5400,3100,16740000,2,26006,6503,1,354920000,354920000,9751,3250,6501,3250,0,1,3252,1410347
168,3250,5400,3100,16740000,2,26006,6503,1,354920000,354920000,9751,3250,6501,3250,0,1,3252,1412704

168,3650,5400,3100,16740000,2,29206,7303,1,382120000,382120000,10951,3650,7301,3650,0,1,3652,17228976
168,3650,5400,3100,16740000,2,29206,7303,1,382120000,382120000,10951,3650,7301,3650,0,1,3652,1526019
168,3650,5400,3100,16740000,2,29206,7303,1,382120000,382120000,10951,3650,7301,3650,0,1,3652,1525137
168,3650,5400,3100,16740000,2,29206,7303,1,382120000,382120000,10951,3650,7301,3650,0,1,3652,1528440
168,3650,5400,3100,16740000,2,29206,7303,1,382120000,382120000,10951,3650,7301,3650,0,1,3652,1527086
168,3650,5400,3100,16740000,2,29206,7303,1,382120000,382120000,10951,3650,7301,3650,0,1,3652,1529560
168,3650,5400,3100,16740000,2,29206,7303,1,382120000,382120000,10951,3650,7301,3650,0,1,3652,1530378

168,4050,5400,3100,16740000,2,32406,8103,1,409320000,409320000,12151,4050,8101,4050,0,1,4052,18518167
168,4050,5400,3100,16740000,2,32406,8103,1,409320000,409320000,12151,4050,8101,4050,0,1,4052,1706968
168,4050,5400,3100,16740000,2,32406,8103,1,409320000,409320000,12151,4050,8101,4050,0,1,4052,1710771
168,4050,5400,3100,16740000,2,32406,8103,1,409320000,409320000,12151,4050,8101,4050,0,1,4052,1708589
168,4050,5400,3100,16740000,2,32406,8103,1,409320000,409320000,12151,4050,8101,4050,0,1,4052,1709553
168,4050,5400,3100,16740000,2,32406,8103,1,409320000,409320000,12151,4050,8101,4050,0,1,4052,1699292
168,4050,5400,3100,16740000,2,32406,8103,1,409320000,409320000,12151,4050,8101,4050,0,1,4052,1700750

168,4450,5400,3100,16740000,2,35606,8903,1,436520000,436520000,13351,4450,8901,4450,0,1,4452,20899335
168,4450,5400,3100,16740000,2,35606,8903,1,436520000,436520000,13351,4450,8901,4450,0,1,4452,1843222
168,4450,5400,3100,16740000,2,35606,8903,1,436520000,436520000,13351,4450,8901,4450,0,1,4452,1842212
168,4450,5400,3100,16740000,2,35606,8903,1,436520000,436520000,13351,4450,8901,4450,0,1,4452,1847245
168,4450,5400,3100,16740000,2,35606,8903,1,436520000,436520000,13351,4450,8901,4450,0,1,4452,1845966
168,4450,5400,3100,16740000,2,35606,8903,1,436520000,436520000,13351,4450,8901,4450,0,1,4452,1826226
168,4450,5400,3100,16740000,2,35606,8903,1,436520000,436520000,13351,4450,8901,4450,0,1,4452,1824325

168,4850,5400,3100,16740000,2,38806,9703,1,463720000,463720000,14551,4850,9701,4850,0,1,4852,22649551
168,4850,5400,3100,16740000,2,38806,9703,1,463720000,463720000,14551,4850,9701,4850,0,1,4852,2026742
168,4850,5400,3100,16740000,2,38806,9703,1,463720000,463720000,14551,4850,9701,4850,0,1,4852,2029643
168,4850,5400,3100,16740000,2,38806,9703,1,463720000,463720000,14551,4850,9701,4850,0,1,4852,2024495
168,4850,5400,3100,16740000,2,38806,9703,1,463720000,463720000,14551,4850,9701,4850,0,1,4852,2028165
168,4850,5400,3100,16740000,2,38806,9703,1,463720000,463720000,14551,4850,9701,4850,0,1,4852,1988271
168,4850,5400,3100,16740000,2,38806,9703,1,463720000,463720000,14551,4850,9701,4850,0,1,4852,1986239

168,5250,5400,3100,16740000,2,42006,10503,1,490920000,490920000,15751,5250,10501,5250,0,1,5252,24376139
168,5250,5400,3100,16740000,2,42006,10503,1,490920000,490920000,15751,5250,10501,5250,0,1,5252,2146971
168,5250,5400,3100,16740000,2,42006,10503,1,490920000,490920000,15751,5250,10501,5250,0,1,5252,2148147
168,5250,5400,3100,16740000,2,42006,10503,1,490920000,490920000,15751,5250,10501,5250,0,1,5252,2149561
168,5250,5400,3100,16740000,2,42006,10503,1,490920000,490920000,15751,5250,10501,5250,0,1,5252,2142555
168,5250,5400,3100,16740000,2,42006,10503,1,490920000,490920000,15751,5250,10501,5250,0,1,5252,2110678
168,5250,5400,3100,16740000,2,42006,10503,1,490920000,490920000,15751,5250,10501,5250,0,1,5252,2112919

168,5650,5400,3100,16740000,2,45206,11303,1,518120000,518120000,16951,5650,11301,5650,0,1,5652,27513683
168,5650,5400,3100,16740000,2,45206,11303,1,518120000,518120000,16951,5650,11301,5650,0,1,5652,2339053
168,5650,5400,3100,16740000,2,45206,11303,1,518120000,518120000,16951,5650,11301,5650,0,1,5652,2343774
168,5650,5400,3100,16740000,2,45206,11303,1,518120000,518120000,16951,5650,11301,5650,0,1,5652,2340977
168,5650,5400,3100,16740000,2,45206,11303,1,518120000,518120000,16951,5650,11301,5650,0,1,5652,2342296
168,5650,5400,3100,16740000,2,45206,11303,1,518120000,518120000,16951,5650,11301,5650,0,1,5652,2301144
168,5650,5400,3100,16740000,2,45206,11303,1,518120000,518120000,16951,5650,11301,5650,0,1,5652,2305689

168,6050,5400,3100,16740000,2,48406,12103,1,545320000,545320000,18151,6050,12101,6050,0,1,6052,29725704
168,6050,5400,3100,16740000,2,48406,12103,1,545320000,545320000,18151,6050,12101,6050,0,1,6052,2457417
168,6050,5400,3100,16740000,2,48406,12103,1,545320000,545320000,18151,6050,12101,6050,0,1,6052,2488875
168,6050,5400,3100,16740000,2,48406,12103,1,545320000,545320000,18151,6050,12101,6050,0,1,6052,2480898
168,6050,5400,3100,16740000,2,48406,12103,1,545320000,545320000,18151,6050,12101,6050,0,1,6052,2485996
168,6050,5400,3100,16740000,2,48406,12103,1,545320000,545320000,18151,6050,12101,6050,0,1,6052,2459525
168,6050,5400,3100,16740000,2,48406,12103,1,545320000,545320000,18151,6050,12101,6050,0,1,6052,2454309

168,6450,5400,3100,16740000,2,51606,12903,1,572520000,572520000,19351,6450,12901,6450,0,1,6452,30039528
168,6450,5400,3100,16740000,2,51606,12903,1,572520000,572520000,19351,6450,12901,6450,0,1,6452,2594751
168,6450,5400,3100,16740000,2,51606,12903,1,572520000,572520000,19351,6450,12901,6450,0,1,6452,2592604
168,6450,5400,3100,16740000,2,51606,12903,1,572520000,572520000,19351,6450,12901,6450,0,1,6452,2597734
168,6450,5400,3100,16740000,2,51606,12903,1,572520000,572520000,19351,6450,12901,6450,0,1,6452,2596079
168,6450,5400,3100,16740000,2,51606,12903,1,572520000,572520000,19351,6450,12901,6450,0,1,6452,2556404
168,6450,5400,3100,16740000,2,51606,12903,1,572520000,572520000,19351,6450,12901,6450,0,1,6452,2558890

168,6850,5400,3100,16740000,2,54806,13703,1,599720000,599720000,20551,6850,13701,6850,0,1,6852,32911295
168,6850,5400,3100,16740000,2,54806,13703,1,599720000,599720000,20551,6850,13701,6850,0,1,6852,2765439
168,6850,5400,3100,16740000,2,54806,13703,1,599720000,599720000,20551,6850,13701,6850,0,1,6852,2771723
168,6850,5400,3100,16740000,2,54806,13703,1,599720000,599720000,20551,6850,13701,6850,0,1,6852,2769986
168,6850,5400,3100,16740000,2,54806,13703,1,599720000,599720000,20551,6850,13701,6850,0,1,6852,2768376
168,6850,5400,3100,16740000,2,54806,13703,1,599720000,599720000,20551,6850,13701,6850,0,1,6852,2719794
168,6850,5400,3100,16740000,2,54806,13703,1,599720000,599720000,20551,6850,13701,6850,0,1,6852,2722487

168,50,5400,2700,14580000,2,406,103,1,119880000,119880000,151,50,101,50,0,1,52,159083
168,50,5400,2700,14580000,2,406,103,1,119880000,119880000,151,50,101,50,0,1,52,137203
168,50,5400,2700,14580000,2,406,103,1,119880000,119880000,151,50,101,50,0,1,52,150526
168,50,5400,2700,14580000,2,406,103,1,119880000,119880000,151,50,101,50,0,1,52,150063
168,50,5400,2700,14580000,2,406,103,1,119880000,119880000,151,50,101,50,0,1,52,148334
168,50,5400,2700,14580000,2,406,103,1,119880000,119880000,151,50,101,50,0,1,52,192068
168,50,5400,2700,14580000,2,406,103,1,119880000,119880000,151,50,101,50,0,1,52,192553

168,450,5400,2700,14580000,2,3606,903,1,145800000,145800000,1351,450,901,450,0,1,452,1503551
168,450,5400,2700,14580000,2,3606,903,1,145800000,145800000,1351,450,901,450,0,1,452,276553
168,450,5400,2700,14580000,2,3606,903,1,145800000,145800000,1351,450,901,450,0,1,452,274123
168,450,5400,2700,14580000,2,3606,903,1,145800000,145800000,1351,450,901,450,0,1,452,277055
168,450,5400,2700,14580000,2,3606,903,1,145800000,145800000,1351,450,901,450,0,1,452,275776
168,450,5400,2700,14580000,2,3606,903,1,145800000,145800000,1351,450,901,450,0,1,452,283148
168,450,5400,2700,14580000,2,3606,903,1,145800000,145800000,1351,450,901,450,0,1,452,283574

168,850,5400,2700,14580000,2,6806,1703,1,171720000,171720000,2551,850,1701,850,0,1,852,3005110
168,850,5400,2700,14580000,2,6806,1703,1,171720000,171720000,2551,850,1701,850,0,1,852,422094
168,850,5400,2700,14580000,2,6806,1703,1,171720000,171720000,2551,850,1701,850,0,1,852,421200
168,850,5400,2700,14580000,2,6806,1703,1,171720000,171720000,2551,850,1701,850,0,1,852,422445
168,850,5400,2700,14580000,2,6806,1703,1,171720000,171720000,2551,850,1701,850,0,1,852,419248
168,850,5400,2700,14580000,2,6806,1703,1,171720000,171720000,2551,850,1701,850,0,1,852,425195
168,850,5400,2700,14580000,2,6806,1703,1,171720000,171720000,2551,850,1701,850,0,1,852,425724

168,1250,5400,2700,14580000,2,10006,2503,1,197640000,197640000,3751,1250,2501,1250,0,1,1252,4550812
168,1250,5400,2700,14580000,2,10006,2503,1,197640000,197640000,3751,1250,2501,1250,0,1,1252,552645
168,1250,5400,2700,14580000,2,10006,2503,1,197640000,197640000,3751,1250,2501,1250,0,1,1252,555187
168,1250,5400,2700,14580000,2,10006,2503,1,197640000,197640000,3751,1250,2501,1250,0,1,1252,554781
168,1250,5400,2700,14580000,2,10006,2503,1,197640000,197640000,3751,1250,2501,1250,0,1,1252,554250
168,1250,5400,2700,14580000,2,10006,2503,1,197640000,197640000,3751,1250,2501,1250,0,1,1252,557607
168,1250,5400,2700,14580000,2,10006,2503,1,197640000,197640000,3751,1250,2501,1250,0,1,1252,558127

168,1650,5400,2700,14580000,2,13206,3303,1,223560000,223560000,4951,1650,3301,1650,0,1,1652,6178566
168,1650,5400,2700,14580000,2,13206,3303,1,223560000,223560000,4951,1650,3301,1650,0,1,1652,689919
168,1650,5400,2700,14580000,2,13206,3303,1,223560000,223560000,4951,1650,3301,1650,0,1,1652,663288
168,1650,5400,2700,14580000,2,13206,3303,1,223560000,223560000,4951,1650,3301,1650,0,1,1652,692995
168,1650,5400,2700,14580000,2,13206,3303,1,223560000,223560000,4951,1650,3301,1650,0,1,1652,638270
168,1650,5400,2700,14580000,2,13206,3303,1,223560000,223560000,4951,1650,3301,1650,0,1,1652,703884
168,1650,5400,2700,14580000,2,13206,3303,1,223560000,223560000,4951,1650,3301,1650,0,1,1652,703319

168,2050,5400,2700,14580000,2,16406,4103,1,249480000,249480000,6151,2050,4101,2050,0,1,2052,7756254
168,2050,5400,2700,14580000,2,16406,4103,1,249480000,249480000,6151,2050,4101,2050,0,1,2052,787216
168,2050,5400,2700,14580000,2,16406,4103,1,249480000,249480000,6151,2050,4101,2050,0,1,2052,808147
168,2050,5400,2700,14580000,2,16406,4103,1,249480000,249480000,6151,2050,4101,2050,0,1,2052,799118
168,2050,5400,2700,14580000,2,16406,4103,1,249480000,249480000,6151,2050,4101,2050,0,1,2052,796993
168,2050,5400,2700,14580000,2,16406,4103,1,249480000,249480000,6151,2050,4101,2050,0,1,2052,828513
168,2050,5400,2700,14580000,2,16406,4103,1,249480000,249480000,6151,2050,4101,2050,0,1,2052,829151

168,2450,5400,2700,14580000,2,19606,4903,1,275400000,275400000,7351,2450,4901,2450,0,1,2452,9784602
168,2450,5400,2700,14580000,2,19606,4903,1,275400000,275400000,7351,2450,4901,2450,0,1,2452,931014
168,2450,5400,2700,14580000,2,19606,4903,1,275400000,275400000,7351,2450,4901,2450,0,1,2452,923554
168,2450,5400,2700,14580000,2,19606,4903,1,275400000,275400000,7351,2450,4901,2450,0,1,2452,929130
168,2450,5400,2700,14580000,2,19606,4903,1,275400000,275400000,7351,2450,4901,2450,0,1,2452,927171
168,2450,5400,2700,14580000,2,19606,4903,1,275400000,275400000,7351,2450,4901,2450,0,1,2452,952826
168,2450,5400,2700,14580000,2,19606,4903,1,275400000,275400000,7351,2450,4901,2450,0,1,2452,953514

168,2850,5400,2700,14580000,2,22806,5703,1,301320000,301320000,8551,2850,5701,2850,0,1,2852,11225562
168,2850,5400,2700,14580000,2,22806,5703,1,301320000,301320000,8551,2850,5701,2850,0,1,2852,1068904
168,2850,5400,2700,14580000,2,22806,5703,1,301320000,301320000,8551,2850,5701,2850,0,1,2852,1064349
168,2850,5400,2700,14580000,2,22806,5703,1,301320000,301320000,8551,2850,5701,2850,0,1,2852,1070894
168,2850,5400,2700,14580000,2,22806,5703,1,301320000,301320000,8551,2850,5701,2850,0,1,2852,1067284
168,2850,5400,2700,14580000,2,22806,5703,1,301320000,301320000,8551,2850,5701,2850,0,1,2852,1085362
168,2850,5400,2700,14580000,2,22806,5703,1,301320000,301320000,8551,2850,5701,2850,0,1,2852,1086064

168,3250,5400,2700,14580000,2,26006,6503,1,327240000,327240000,9751,3250,6501,3250,0,1,3252,12967103
168,3250,5400,2700,14580000,2,26006,6503,1,327240000,327240000,9751,3250,6501,3250,0,1,3252,1246797
168,3250,5400,2700,14580000,2,26006,6503,1,327240000,327240000,9751,3250,6501,3250,0,1,3252,1197187
168,3250,5400,2700,14580000,2,26006,6503,1,327240000,327240000,9751,3250,6501,3250,0,1,3252,1240683
168,3250,5400,2700,14580000,2,26006,6503,1,327240000,327240000,9751,3250,6501,3250,0,1,3252,1248303
168,3250,5400,2700,14580000,2,26006,6503,1,327240000,327240000,9751,3250,6501,3250,0,1,3252,1251476
168,3250,5400,2700,14580000,2,26006,6503,1,327240000,327240000,9751,3250,6501,3250,0,1,3252,1250706

168,3650,5400,2700,14580000,2,29206,7303,1,353160000,353160000,10951,3650,7301,3650,0,1,3652,14758855
168,3650,5400,2700,14580000,2,29206,7303,1,353160000,353160000,10951,3650,7301,3650,0,1,3652,1364692
168,3650,5400,2700,14580000,2,29206,7303,1,353160000,353160000,10951,3650,7301,3650,0,1,3652,1372234
168,3650,5400,2700,14580000,2,29206,7303,1,353160000,353160000,10951,3650,7301,3650,0,1,3652,1367453
168,3650,5400,2700,14580000,2,29206,7303,1,353160000,353160000,10951,3650,7301,3650,0,1,3652,1358234
168,3650,5400,2700,14580000,2,29206,7303,1,353160000,353160000,10951,3650,7301,3650,0,1,3652,1370518
168,3650,5400,2700,14580000,2,29206,7303,1,353160000,353160000,10951,3650,7301,3650,0,1,3652,1371344

168,4050,5400,2700,14580000,2,32406,8103,1,379080000,379080000,12151,4050,8101,4050,0,1,4052,16298507
168,4050,5400,2700,14580000,2,32406,8103,1,379080000,379080000,12151,4050,8101,4050,0,1,4052,1499391
168,4050,5400,2700,14580000,2,32406,8103,1,379080000,379080000,12151,4050,8101,4050,0,1,4052,1494659
168,4050,5400,2700,14580000,2,32406,8103,1,379080000,379080000,12151,4050,8101,4050,0,1,4052,1498453
168,4050,5400,2700,14580000,2,32406,8103,1,379080000,379080000,12151,4050,8101,4050,0,1,4052,1491854
168,4050,5400,2700,14580000,2,32406,8103,1,379080000,379080000,12151,4050,8101,4050,0,1,4052,1496728
168,4050,5400,2700,14580000,2,32406,8103,1,379080000,379080000,12151,4050,8101,4050,0,1,4052,1497573

168,4450,5400,2700,14580000,2,35606,8903,1,405000000,405000000,13351,4450,8901,4450,0,1,4452,17556800
168,4450,5400,2700,14580000,2,35606,8903,1,405000000,405000000,13351,4450,8901,4450,0,1,4452,1656337
168,4450,5400,2700,14580000,2,35606,8903,1,405000000,405000000,13351,4450,8901,4450,0,1,4452,1661819
168,4450,5400,2700,14580000,2,35606,8903,1,405000000,405000000,13351,4450,8901,4450,0,1,4452,1660384
168,4450,5400,2700,14580000,2,35606,8903,1,405000000,405000000,13351,4450,8901,4450,0,1,4452,1658750
168,4450,5400,2700,14580000,2,35606,8903,1,405000000,405000000,13351,4450,8901,4450,0,1,4452,1640017
168,4450,5400,2700,14580000,2,35606,8903,1,405000000,405000000,13351,4450,8901,4450,0,1,4452,1636061

168,4850,5400,2700,14580000,2,38806,9703,1,430920000,430920000,14551,4850,9701,4850,0,1,4852,19913559
168,4850,5400,2700,14580000,2,38806,9703,1,430920000,430920000,14551,4850,9701,4850,0,1,4852,1763682
168,4850,5400,2700,14580000,2,38806,9703,1,430920000,430920000,14551,4850,9701,4850,0,1,4852,1759516
168,4850,5400,2700,14580000,2,38806,9703,1,430920000,430920000,14551,4850,9701,4850,0,1,4852,1766085
168,4850,5400,2700,14580000,2,38806,9703,1,430920000,430920000,14551,4850,9701,4850,0,1,4852,1764733
168,4850,5400,2700,14580000,2,38806,9703,1,430920000,430920000,14551,4850,9701,4850,0,1,4852,1745155
168,4850,5400,2700,14580000,2,38806,9703,1,430920000,430920000,14551,4850,9701,4850,0,1,4852,1747015

168,5250,5400,2700,14580000,2,42006,10503,1,456840000,456840000,15751,5250,10501,5250,0,1,5252,21257804
168,5250,5400,2700,14580000,2,42006,10503,1,456840000,456840000,15751,5250,10501,5250,0,1,5252,1939411
168,5250,5400,2700,14580000,2,42006,10503,1,456840000,456840000,15751,5250,10501,5250,0,1,5252,1927975
168,5250,5400,2700,14580000,2,42006,10503,1,456840000,456840000,15751,5250,10501,5250,0,1,5252,1944843
168,5250,5400,2700,14580000,2,42006,10503,1,456840000,456840000,15751,5250,10501,5250,0,1,5252,1946295
168,5250,5400,2700,14580000,2,42006,10503,1,456840000,456840000,15751,5250,10501,5250,0,1,5252,1915131
168,5250,5400,2700,14580000,2,42006,10503,1,456840000,456840000,15751,5250,10501,5250,0,1,5252,1919671

168,5650,5400,2700,14580000,2,45206,11303,1,482760000,482760000,16951,5650,11301,5650,0,1,5652,22904965
168,5650,5400,2700,14580000,2,45206,11303,1,482760000,482760000,16951,5650,11301,5650,0,1,5652,2027617
168,5650,5400,2700,14580000,2,45206,11303,1,482760000,482760000,16951,5650,11301,5650,0,1,5652,2023466
168,5650,5400,2700,14580000,2,45206,11303,1,482760000,482760000,16951,5650,11301,5650,0,1,5652,2031506
168,5650,5400,2700,14580000,2,45206,11303,1,482760000,482760000,16951,5650,11301,5650,0,1,5652,2030032
168,5650,5400,2700,14580000,2,45206,11303,1,482760000,482760000,16951,5650,11301,5650,0,1,5652,2005931
168,5650,5400,2700,14580000,2,45206,11303,1,482760000,482760000,16951,5650,11301,5650,0,1,5652,2008269

168,6050,5400,2700,14580000,2,48406,12103,1,508680000,508680000,18151,6050,12101,6050,0,1,6052,25226646
168,6050,5400,2700,14580000,2,48406,12103,1,508680000,508680000,18151,6050,12101,6050,0,1,6052,2199752
168,6050,5400,2700,14580000,2,48406,12103,1,508680000,508680000,18151,6050,12101,6050,0,1,6052,2203615
168,6050,5400,2700,14580000,2,48406,12103,1,508680000,508680000,18151,6050,12101,6050,0,1,6052,2197787
168,6050,5400,2700,14580000,2,48406,12103,1,508680000,508680000,18151,6050,12101,6050,0,1,6052,2202056
168,6050,5400,2700,14580000,2,48406,12103,1,508680000,508680000,18151,6050,12101,6050,0,1,6052,2166883
168,6050,5400,2700,14580000,2,48406,12103,1,508680000,508680000,18151,6050,12101,6050,0,1,6052,2162503

168,6450,5400,2700,14580000,2,51606,12903,1,534600000,534600000,19351,6450,12901,6450,0,1,6452,26541119
168,6450,5400,2700,14580000,2,51606,12903,1,534600000,534600000,19351,6450,12901,6450,0,1,6452,2328012
168,6450,5400,2700,14580000,2,51606,12903,1,534600000,534600000,19351,6450,12901,6450,0,1,6452,2326311
168,6450,5400,2700,14580000,2,51606,12903,1,534600000,534600000,19351,6450,12901,6450,0,1,6452,2332343
168,6450,5400,2700,14580000,2,51606,12903,1,534600000,534600000,19351,6450,12901,6450,0,1,6452,2321635
168,6450,5400,2700,14580000,2,51606,12903,1,534600000,534600000,19351,6450,12901,6450,0,1,6452,2285657
168,6450,5400,2700,14580000,2,51606,12903,1,534600000,534600000,19351,6450,12901,6450,0,1,6452,2291519

168,6850,5400,2700,14580000,2,54806,13703,1,560520000,560520000,20551,6850,13701,6850,0,1,6852,28468319
168,6850,5400,2700,14580000,2,54806,13703,1,560520000,560520000,20551,6850,13701,6850,0,1,6852,2470451
168,6850,5400,2700,14580000,2,54806,13703,1,560520000,560520000,20551,6850,13701,6850,0,1,6852,2477287
168,6850,5400,2700,14580000,2,54806,13703,1,560520000,560520000,20551,6850,13701,6850,0,1,6852,2456760
168,6850,5400,2700,14580000,2,54806,13703,1,560520000,560520000,20551,6850,13701,6850,0,1,6852,2474236
168,6850,5400,2700,14580000,2,54806,13703,1,560520000,560520000,20551,6850,13701,6850,0,1,6852,2442121
168,6850,5400,2700,14580000,2,54806,13703,1,560520000,560520000,20551,6850,13701,6850,0,1,6852,2439013

168,50,5400,2300,12420000,2,406,103,1,102440000,102440000,151,50,101,50,0,1,52,130596
168,50,5400,2300,12420000,2,406,103,1,102440000,102440000,151,50,101,50,0,1,52,120007
168,50,5400,2300,12420000,2,406,103,1,102440000,102440000,151,50,101,50,0,1,52,109337
168,50,5400,2300,12420000,2,406,103,1,102440000,102440000,151,50,101,50,0,1,52,122223
168,50,5400,2300,12420000,2,406,103,1,102440000,102440000,151,50,101,50,0,1,52,121757
168,50,5400,2300,12420000,2,406,103,1,102440000,102440000,151,50,101,50,0,1,52,157003
168,50,5400,2300,12420000,2,406,103,1,102440000,102440000,151,50,101,50,0,1,52,157501

168,450,5400,2300,12420000,2,3606,903,1,127080000,127080000,1351,450,901,450,0,1,452,1296233
168,450,5400,2300,12420000,2,3606,903,1,127080000,127080000,1351,450,901,450,0,1,452,234272
168,450,5400,2300,12420000,2,3606,903,1,127080000,127080000,1351,450,901,450,0,1,452,234738
168,450,5400,2300,12420000,2,3606,903,1,127080000,127080000,1351,450,901,450,0,1,452,232464
168,450,5400,2300,12420000,2,3606,903,1,127080000,127080000,1351,450,901,450,0,1,452,233452
168,450,5400,2300,12420000,2,3606,903,1,127080000,127080000,1351,450,901,450,0,1,452,242377
168,450,5400,2300,12420000,2,3606,903,1,127080000,127080000,1351,450,901,450,0,1,452,242801

168,850,5400,2300,12420000,2,6806,1703,1,151720000,151720000,2551,850,1701,850,0,1,852,2556935
168,850,5400,2300,12420000,2,6806,1703,1,151720000,151720000,2551,850,1701,850,0,1,852,360911
168,850,5400,2300,12420000,2,6806,1703,1,151720000,151720000,2551,850,1701,850,0,1,852,356554
168,850,5400,2300,12420000,2,6806,1703,1,151720000,151720000,2551,850,1701,850,0,1,852,359206
168,850,5400,2300,12420000,2,6806,1703,1,151720000,151720000,2551,850,1701,850,0,1,852,360267
168,850,5400,2300,12420000,2,6806,1703,1,151720000,151720000,2551,850,1701,850,0,1,852,363694
168,850,5400,2300,12420000,2,6806,1703,1,151720000,151720000,2551,850,1701,850,0,1,852,364168

168,1250,5400,2300,12420000,2,10006,2503,1,176360000,176360000,3751,1250,2501,1250,0,1,1252,3710252
168,1250,5400,2300,12420000,2,10006,2503,1,176360000,176360000,3751,1250,2501,1250,0,1,1252,484046
168,1250,5400,2300,12420000,2,10006,2503,1,176360000,176360000,3751,1250,2501,1250,0,1,1252,483272
168,1250,5400,2300,12420000,2,10006,2503,1,176360000,176360000,3751,1250,2501,1250,0,1,1252,481400
168,1250,5400,2300,12420000,2,10006,2503,1,176360000,176360000,3751,1250,2501,1250,0,1,1252,482231
168,1250,5400,2300,12420000,2,10006,2503,1,176360000,176360000,3751,1250,2501,1250,0,1,1252,485167
168,1250,5400,2300,12420000,2,10006,2503,1,176360000,176360000,3751,1250,2501,1250,0,1,1252,485686

168,1650,5400,2300,12420000,2,13206,3303,1,201000000,201000000,4951,1650,3301,1650,0,1,1652,5052929
168,1650,5400,2300,12420000,2,13206,3303,1,201000000,201000000,4951,1650,3301,1650,0,1,1652,599927
168,1650,5400,2300,12420000,2,13206,3303,1,201000000,201000000,4951,1650,3301,1650,0,1,1652,601346
168,1650,5400,2300,12420000,2,13206,3303,1,201000000,201000000,4951,1650,3301,1650,0,1,1652,609621
168,1650,5400,2300,12420000,2,13206,3303,1,201000000,201000000,4951,1650,3301,1650,0,1,1652,591703
168,1650,5400,2300,12420000,2,13206,3303,1,201000000,201000000,4951,1650,3301,1650,0,1,1652,604301
168,1650,5400,2300,12420000,2,13206,3303,1,201000000,201000000,4951,1650,3301,1650,0,1,1652,604887

168,2050,5400,2300,12420000,2,16406,4103,1,225640000,225640000,6151,2050,4101,2050,0,1,2052,6607776
168,2050,5400,2300,12420000,2,16406,4103,1,225640000,225640000,6151,2050,4101,2050,0,1,2052,696855
168,2050,5400,2300,12420000,2,16406,4103,1,225640000,225640000,6151,2050,4101,2050,0,1,2052,699896
168,2050,5400,2300,12420000,2,16406,4103,1,225640000,225640000,6151,2050,4101,2050,0,1,2052,676960
168,2050,5400,2300,12420000,2,16406,4103,1,225640000,225640000,6151,2050,4101,2050,0,1,2052,698132
168,2050,5400,2300,12420000,2,16406,4103,1,225640000,225640000,6151,2050,4101,2050,0,1,2052,739744
168,2050,5400,2300,12420000,2,16406,4103,1,225640000,225640000,6151,2050,4101,2050,0,1,2052,738463

168,2450,5400,2300,12420000,2,19606,4903,1,250280000,250280000,7351,2450,4901,2450,0,1,2452,7929027
168,2450,5400,2300,12420000,2,19606,4903,1,250280000,250280000,7351,2450,4901,2450,0,1,2452,784912
168,2450,5400,2300,12420000,2,19606,4903,1,250280000,250280000,7351,2450,4901,2450,0,1,2452,786622
168,2450,5400,2300,12420000,2,19606,4903,1,250280000,250280000,7351,2450,4901,2450,0,1,2452,788632
168,2450,5400,2300,12420000,2,19606,4903,1,250280000,250280000,7351,2450,4901,2450,0,1,2452,787559
168,2450,5400,2300,12420000,2,19606,4903,1,250280000,250280000,7351,2450,4901,2450,0,1,2452,826847
168,2450,5400,2300,12420000,2,19606,4903,1,250280000,250280000,7351,2450,4901,2450,0,1,2452,827495

168,2850,5400,2300,12420000,2,22806,5703,1,274920000,274920000,8551,2850,5701,2850,0,1,2852,9552322
168,2850,5400,2300,12420000,2,22806,5703,1,274920000,274920000,8551,2850,5701,2850,0,1,2852,919586
168,2850,5400,2300,12420000,2,22806,5703,1,274920000,274920000,8551,2850,5701,2850,0,1,2852,914328
168,2850,5400,2300,12420000,2,22806,5703,1,274920000,274920000,8551,2850,5701,2850,0,1,2852,917887
168,2850,5400,2300,12420000,2,22806,5703,1,274920000,274920000,8551,2850,5701,2850,0,1,2852,916143
168,2850,5400,2300,12420000,2,22806,5703,1,274920000,274920000,8551,2850,5701,2850,0,1,2852,943398
168,2850,5400,2300,12420000,2,22806,5703,1,274920000,274920000,8551,2850,5701,2850,0,1,2852,944105

168,3250,5400,2300,12420000,2,26006,6503,1,299560000,299560000,9751,3250,6501,3250,0,1,3252,10420180
168,3250,5400,2300,12420000,2,26006,6503,1,299560000,299560000,9751,3250,6501,3250,0,1,3252,1040584
168,3250,5400,2300,12420000,2,26006,6503,1,299560000,299560000,9751,3250,6501,3250,0,1,3252,1043669
168,3250,5400,2300,12420000,2,26006,6503,1,299560000,299560000,9751,3250,6501,3250,0,1,3252,1047544
168,3250,5400,2300,12420000,2,26006,6503,1,299560000,299560000,9751,3250,6501,3250,0,1,3252,1045540
168,3250,5400,2300,12420000,2,26006,6503,1,299560000,299560000,9751,3250,6501,3250,0,1,3252,1061530
168,3250,5400,2300,12420000,2,26006,6503,1,299560000,299560000,9751,3250,6501,3250,0,1,3252,1062285

168,3650,5400,2300,12420000,2,29206,7303,1,324200000,324200000,10951,3650,7301,3650,0,1,3652,12295842
168,3650,5400,2300,12420000,2,29206,7303,1,324200000,324200000,10951,3650,7301,3650,0,1,3652,1205739
168,3650,5400,2300,12420000,2,29206,7303,1,324200000,324200000,10951,3650,7301,3650,0,1,3652,1163028
168,3650,5400,2300,12420000,2,29206,7303,1,324200000,324200000,10951,3650,7301,3650,0,1,3652,1203500
168,3650,5400,2300,12420000,2,29206,7303,1,324200000,324200000,10951,3650,7301,3650,0,1,3652,1206591
168,3650,5400,2300,12420000,2,29206,7303,1,324200000,324200000,10951,3650,7301,3650,0,1,3652,1204322
168,3650,5400,2300,12420000,2,29206,7303,1,324200000,324200000,10951,3650,7301,3650,0,1,3652,1208317

168,4050,5400,2300,12420000,2,32406,8103,1,348840000,348840000,12151,4050,8101,4050,0,1,4052,13502994
168,4050,5400,2300,12420000,2,32406,8103,1,348840000,348840000,12151,4050,8101,4050,0,1,4052,1310119
168,4050,5400,2300,12420000,2,32406,8103,1,348840000,348840000,12151,4050,8101,4050,0,1,4052,1311897
168,4050,5400,2300,12420000,2,32406,8103,1,348840000,348840000,12151,4050,8101,4050,0,1,4052,1268748
168,4050,5400,2300,12420000,2,32406,8103,1,348840000,348840000,12151,4050,8101,4050,0,1,4052,1306243
168,4050,5400,2300,12420000,2,32406,8103,1,348840000,348840000,12151,4050,8101,4050,0,1,4052,1315487
168,4050,5400,2300,12420000,2,32406,8103,1,348840000,348840000,12151,4050,8101,4050,0,1,4052,1313857

168,4450,5400,2300,12420000,2,35606,8903,1,373480000,373480000,13351,4450,8901,4450,0,1,4452,15336937
168,4450,5400,2300,12420000,2,35606,8903,1,373480000,373480000,13351,4450,8901,4450,0,1,4452,1416204
168,4450,5400,2300,12420000,2,35606,8903,1,373480000,373480000,13351,4450,8901,4450,0,1,4452,1413314
168,4450,5400,2300,12420000,2,35606,8903,1,373480000,373480000,13351,4450,8901,4450,0,1,4452,1417890
168,4450,5400,2300,12420000,2,35606,8903,1,373480000,373480000,13351,4450,8901,4450,0,1,4452,1414736
168,4450,5400,2300,12420000,2,35606,8903,1,373480000,373480000,13351,4450,8901,4450,0,1,4452,1416876
168,4450,5400,2300,12420000,2,35606,8903,1,373480000,373480000,13351,4450,8901,4450,0,1,4452,1418560

168,4850,5400,2300,12420000,2,38806,9703,1,398120000,398120000,14551,4850,9701,4850,0,1,4852,15801453
168,4850,5400,2300,12420000,2,38806,9703,1,398120000,398120000,14551,4850,9701,4850,0,1,4852,1561910
168,4850,5400,2300,12420000,2,38806,9703,1,398120000,398120000,14551,4850,9701,4850,0,1,4852,1559040
168,4850,5400,2300,12420000,2,38806,9703,1,398120000,398120000,14551,4850,9701,4850,0,1,4852,1554453
168,4850,5400,2300,12420000,2,38806,9703,1,398120000,398120000,14551,4850,9701,4850,0,1,4852,1553436
168,4850,5400,2300,12420000,2,38806,9703,1,398120000,398120000,14551,4850,9701,4850,0,1,4852,1560376
168,4850,5400,2300,12420000,2,38806,9703,1,398120000,398120000,14551,4850,9701,4850,0,1,4852,1557901

168,5250,5400,2300,12420000,2,42006,10503,1,422760000,422760000,15751,5250,10501,5250,0,1,5252,17902747
168,5250,5400,2300,12420000,2,42006,10503,1,422760000,422760000,15751,5250,10501,5250,0,1,5252,1633572
168,5250,5400,2300,12420000,2,42006,10503,1,422760000,422760000,15751,5250,10501,5250,0,1,5252,1640312
168,5250,5400,2300,12420000,2,42006,10503,1,422760000,422760000,15751,5250,10501,5250,0,1,5252,1639130
168,5250,5400,2300,12420000,2,42006,10503,1,422760000,422760000,15751,5250,10501,5250,0,1,5252,1637905
168,5250,5400,2300,12420000,2,42006,10503,1,422760000,422760000,15751,5250,10501,5250,0,1,5252,1625299
168,5250,5400,2300,12420000,2,42006,10503,1,422760000,422760000,15751,5250,10501,5250,0,1,5252,1627378

168,5650,5400,2300,12420000,2,45206,11303,1,447400000,447400000,16951,5650,11301,5650,0,1,5652,19126599
168,5650,5400,2300,12420000,2,45206,11303,1,447400000,447400000,16951,5650,11301,5650,0,1,5652,1799947
168,5650,5400,2300,12420000,2,45206,11303,1,447400000,447400000,16951,5650,11301,5650,0,1,5652,1790106
168,5650,5400,2300,12420000,2,45206,11303,1,447400000,447400000,16951,5650,11301,5650,0,1,5652,1808488
168,5650,5400,2300,12420000,2,45206,11303,1,447400000,447400000,16951,5650,11301,5650,0,1,5652,1805884
168,5650,5400,2300,12420000,2,45206,11303,1,447400000,447400000,16951,5650,11301,5650,0,1,5652,1757381
168,5650,5400,2300,12420000,2,45206,11303,1,447400000,447400000,16951,5650,11301,5650,0,1,5652,1792524

168,6050,5400,2300,12420000,2,48406,12103,1,472040000,472040000,18151,6050,12101,6050,0,1,6052,20555841
168,6050,5400,2300,12420000,2,48406,12103,1,472040000,472040000,18151,6050,12101,6050,0,1,6052,1882637
168,6050,5400,2300,12420000,2,48406,12103,1,472040000,472040000,18151,6050,12101,6050,0,1,6052,1886495
168,6050,5400,2300,12420000,2,48406,12103,1,472040000,472040000,18151,6050,12101,6050,0,1,6052,1884011
168,6050,5400,2300,12420000,2,48406,12103,1,472040000,472040000,18151,6050,12101,6050,0,1,6052,1881078
168,6050,5400,2300,12420000,2,48406,12103,1,472040000,472040000,18151,6050,12101,6050,0,1,6052,1871028
168,6050,5400,2300,12420000,2,48406,12103,1,472040000,472040000,18151,6050,12101,6050,0,1,6052,1855941

168,6450,5400,2300,12420000,2,51606,12903,1,496680000,496680000,19351,6450,12901,6450,0,1,6452,22577615
168,6450,5400,2300,12420000,2,51606,12903,1,496680000,496680000,19351,6450,12901,6450,0,1,6452,2038482
168,6450,5400,2300,12420000,2,51606,12903,1,496680000,496680000,19351,6450,12901,6450,0,1,6452,2016389
168,6450,5400,2300,12420000,2,51606,12903,1,496680000,496680000,19351,6450,12901,6450,0,1,6452,2034524
168,6450,5400,2300,12420000,2,51606,12903,1,496680000,496680000,19351,6450,12901,6450,0,1,6452,2020195
168,6450,5400,2300,12420000,2,51606,12903,1,496680000,496680000,19351,6450,12901,6450,0,1,6452,1985547
168,6450,5400,2300,12420000,2,51606,12903,1,496680000,496680000,19351,6450,12901,6450,0,1,6452,2004716

168,6850,5400,2300,12420000,2,54806,13703,1,521320000,521320000,20551,6850,13701,6850,0,1,6852,22982473
168,6850,5400,2300,12420000,2,54806,13703,1,521320000,521320000,20551,6850,13701,6850,0,1,6852,2141249
168,6850,5400,2300,12420000,2,54806,13703,1,521320000,521320000,20551,6850,13701,6850,0,1,6852,2151813
168,6850,5400,2300,12420000,2,54806,13703,1,521320000,521320000,20551,6850,13701,6850,0,1,6852,2148877
168,6850,5400,2300,12420000,2,54806,13703,1,521320000,521320000,20551,6850,13701,6850,0,1,6852,2145078
168,6850,5400,2300,12420000,2,54806,13703,1,521320000,521320000,20551,6850,13701,6850,0,1,6852,2114099
168,6850,5400,2300,12420000,2,54806,13703,1,521320000,521320000,20551,6850,13701,6850,0,1,6852,2104475

168,50,5400,1900,10260000,2,406,103,1,85000000,85000000,151,50,101,50,0,1,52,108496
168,50,5400,1900,10260000,2,406,103,1,85000000,85000000,151,50,101,50,0,1,52,101337
168,50,5400,1900,10260000,2,406,103,1,85000000,85000000,151,50,101,50,0,1,52,93524
168,50,5400,1900,10260000,2,406,103,1,85000000,85000000,151,50,101,50,0,1,52,102217
168,50,5400,1900,10260000,2,406,103,1,85000000,85000000,151,50,101,50,0,1,52,102675
168,50,5400,1900,10260000,2,406,103,1,85000000,85000000,151,50,101,50,0,1,52,136010
168,50,5400,1900,10260000,2,406,103,1,85000000,85000000,151,50,101,50,0,1,52,136498

168,450,5400,1900,10260000,2,3606,903,1,108360000,108360000,1351,450,901,450,0,1,452,1051038
168,450,5400,1900,10260000,2,3606,903,1,108360000,108360000,1351,450,901,450,0,1,452,192523
168,450,5400,1900,10260000,2,3606,903,1,108360000,108360000,1351,450,901,450,0,1,452,188851
168,450,5400,1900,10260000,2,3606,903,1,108360000,108360000,1351,450,901,450,0,1,452,190677
168,450,5400,1900,10260000,2,3606,903,1,108360000,108360000,1351,450,901,450,0,1,452,193080
168,450,5400,1900,10260000,2,3606,903,1,108360000,108360000,1351,450,901,450,0,1,452,210294
168,450,5400,1900,10260000,2,3606,903,1,108360000,108360000,1351,450,901,450,0,1,452,210719

168,850,5400,1900,10260000,2,6806,1703,1,131720000,131720000,2551,850,1701,850,0,1,852,2102383
168,850,5400,1900,10260000,2,6806,1703,1,131720000,131720000,2551,850,1701,850,0,1,852,299131
168,850,5400,1900,10260000,2,6806,1703,1,131720000,131720000,2551,850,1701,850,0,1,852,296323
168,850,5400,1900,10260000,2,6806,1703,1,131720000,131720000,2551,850,1701,850,0,1,852,297509
168,850,5400,1900,10260000,2,6806,1703,1,131720000,131720000,2551,850,1701,850,0,1,852,298501
168,850,5400,1900,10260000,2,6806,1703,1,131720000,131720000,2551,850,1701,850,0,1,852,302303
168,850,5400,1900,10260000,2,6806,1703,1,131720000,131720000,2551,850,1701,850,0,1,852,301828

168,1250,5400,1900,10260000,2,10006,2503,1,155080000,155080000,3751,1250,2501,1250,0,1,1252,3187121
168,1250,5400,1900,10260000,2,10006,2503,1,155080000,155080000,3751,1250,2501,1250,0,1,1252,406992
168,1250,5400,1900,10260000,2,10006,2503,1,155080000,155080000,3751,1250,2501,1250,0,1,1252,408166
168,1250,5400,1900,10260000,2,10006,2503,1,155080000,155080000,3751,1250,2501,1250,0,1,1252,408574
168,1250,5400,1900,10260000,2,10006,2503,1,155080000,155080000,3751,1250,2501,1250,0,1,1252,405453
168,1250,5400,1900,10260000,2,10006,2503,1,155080000,155080000,3751,1250,2501,1250,0,1,1252,410049
168,1250,5400,1900,10260000,2,10006,2503,1,155080000,155080000,3751,1250,2501,1250,0,1,1252,410569

168,1650,5400,1900,10260000,2,13206,3303,1,178440000,178440000,4951,1650,3301,1650,0,1,1652,4225064
168,1650,5400,1900,10260000,2,13206,3303,1,178440000,178440000,4951,1650,3301,1650,0,1,1652,475883
168,1650,5400,1900,10260000,2,13206,3303,1,178440000,178440000,4951,1650,3301,1650,0,1,1652,477471
168,1650,5400,1900,10260000,2,13206,3303,1,178440000,178440000,4951,1650,3301,1650,0,1,1652,501135
168,1650,5400,1900,10260000,2,13206,3303,1,178440000,178440000,4951,1650,3301,1650,0,1,1652,469759
168,1650,5400,1900,10260000,2,13206,3303,1,178440000,178440000,4951,1650,3301,1650,0,1,1652,515663
168,1650,5400,1900,10260000,2,13206,3303,1,178440000,178440000,4951,1650,3301,1650,0,1,1652,509067

168,2050,5400,1900,10260000,2,16406,4103,1,201800000,201800000,6151,2050,4101,2050,0,1,2052,5273402
168,2050,5400,1900,10260000,2,16406,4103,1,201800000,201800000,6151,2050,4101,2050,0,1,2052,591461
168,2050,5400,1900,10260000,2,16406,4103,1,201800000,201800000,6151,2050,4101,2050,0,1,2052,585681
168,2050,5400,1900,10260000,2,16406,4103,1,201800000,201800000,6151,2050,4101,2050,0,1,2052,583428
168,2050,5400,1900,10260000,2,16406,4103,1,201800000,201800000,6151,2050,4101,2050,0,1,2052,596086
168,2050,5400,1900,10260000,2,16406,4103,1,201800000,201800000,6151,2050,4101,2050,0,1,2052,608175
168,2050,5400,1900,10260000,2,16406,4103,1,201800000,201800000,6151,2050,4101,2050,0,1,2052,624332

168,2450,5400,1900,10260000,2,19606,4903,1,225160000,225160000,7351,2450,4901,2450,0,1,2452,6375036
168,2450,5400,1900,10260000,2,19606,4903,1,225160000,225160000,7351,2450,4901,2450,0,1,2452,679052
168,2450,5400,1900,10260000,2,19606,4903,1,225160000,225160000,7351,2450,4901,2450,0,1,2452,687613
168,2450,5400,1900,10260000,2,19606,4903,1,225160000,225160000,7351,2450,4901,2450,0,1,2452,681004
168,2450,5400,1900,10260000,2,19606,4903,1,225160000,225160000,7351,2450,4901,2450,0,1,2452,668715
168,2450,5400,1900,10260000,2,19606,4903,1,225160000,225160000,7351,2450,4901,2450,0,1,2452,723859
168,2450,5400,1900,10260000,2,19606,4903,1,225160000,225160000,7351,2450,4901,2450,0,1,2452,704809

168,2850,5400,1900,10260000,2,22806,5703,1,248520000,248520000,8551,2850,5701,2850,0,1,2852,7684021
168,2850,5400,1900,10260000,2,22806,5703,1,248520000,248520000,8551,2850,5701,2850,0,1,2852,767514
168,2850,5400,1900,10260000,2,22806,5703,1,248520000,248520000,8551,2850,5701,2850,0,1,2852,765817
168,2850,5400,1900,10260000,2,22806,5703,1,248520000,248520000,8551,2850,5701,2850,0,1,2852,766660
168,2850,5400,1900,10260000,2,22806,5703,1,248520000,248520000,8551,2850,5701,2850,0,1,2852,768233
168,2850,5400,1900,10260000,2,22806,5703,1,248520000,248520000,8551,2850,5701,2850,0,1,2852,811307
168,2850,5400,1900,10260000,2,22806,5703,1,248520000,248520000,8551,2850,5701,2850,0,1,2852,812002

168,3250,5400,1900,10260000,2,26006,6503,1,271880000,271880000,9751,3250,6501,3250,0,1,3252,8832169
168,3250,5400,1900,10260000,2,26006,6503,1,271880000,271880000,9751,3250,6501,3250,0,1,3252,867085
168,3250,5400,1900,10260000,2,26006,6503,1,271880000,271880000,9751,3250,6501,3250,0,1,3252,871606
168,3250,5400,1900,10260000,2,26006,6503,1,271880000,271880000,9751,3250,6501,3250,0,1,3252,873264
168,3250,5400,1900,10260000,2,26006,6503,1,271880000,271880000,9751,3250,6501,3250,0,1,3252,869699
168,3250,5400,1900,10260000,2,26006,6503,1,271880000,271880000,9751,3250,6501,3250,0,1,3252,898509
168,3250,5400,1900,10260000,2,26006,6503,1,271880000,271880000,9751,3250,6501,3250,0,1,3252,899286

168,3650,5400,1900,10260000,2,29206,7303,1,295240000,295240000,10951,3650,7301,3650,0,1,3652,9946755
168,3650,5400,1900,10260000,2,29206,7303,1,295240000,295240000,10951,3650,7301,3650,0,1,3652,981795
168,3650,5400,1900,10260000,2,29206,7303,1,295240000,295240000,10951,3650,7301,3650,0,1,3652,978024
168,3650,5400,1900,10260000,2,29206,7303,1,295240000,295240000,10951,3650,7301,3650,0,1,3652,979976
168,3650,5400,1900,10260000,2,29206,7303,1,295240000,295240000,10951,3650,7301,3650,0,1,3652,975167
168,3650,5400,1900,10260000,2,29206,7303,1,295240000,295240000,10951,3650,7301,3650,0,1,3652,1000512
168,3650,5400,1900,10260000,2,29206,7303,1,295240000,295240000,10951,3650,7301,3650,0,1,3652,1001339

168,4050,5400,1900,10260000,2,32406,8103,1,318600000,318600000,12151,4050,8101,4050,0,1,4052,11183458
168,4050,5400,1900,10260000,2,32406,8103,1,318600000,318600000,12151,4050,8101,4050,0,1,4052,1112341
168,4050,5400,1900,10260000,2,32406,8103,1,318600000,318600000,12151,4050,8101,4050,0,1,4052,1139748
168,4050,5400,1900,10260000,2,32406,8103,1,318600000,318600000,12151,4050,8101,4050,0,1,4052,1128465
168,4050,5400,1900,10260000,2,32406,8103,1,318600000,318600000,12151,4050,8101,4050,0,1,4052,1141651
168,4050,5400,1900,10260000,2,32406,8103,1,318600000,318600000,12151,4050,8101,4050,0,1,4052,1144648
168,4050,5400,1900,10260000,2,32406,8103,1,318600000,318600000,12151,4050,8101,4050,0,1,4052,1145514

168,4450,5400,1900,10260000,2,35606,8903,1,341960000,341960000,13351,4450,8901,4450,0,1,4452,12369386
168,4450,5400,1900,10260000,2,35606,8903,1,341960000,341960000,13351,4450,8901,4450,0,1,4452,1201076
168,4450,5400,1900,10260000,2,35606,8903,1,341960000,341960000,13351,4450,8901,4450,0,1,4452,1204044
168,4450,5400,1900,10260000,2,35606,8903,1,341960000,341960000,13351,4450,8901,4450,0,1,4452,1207668
168,4450,5400,1900,10260000,2,35606,8903,1,341960000,341960000,13351,4450,8901,4450,0,1,4452,1187469
168,4450,5400,1900,10260000,2,35606,8903,1,341960000,341960000,13351,4450,8901,4450,0,1,4452,1209293
168,4450,5400,1900,10260000,2,35606,8903,1,341960000,341960000,13351,4450,8901,4450,0,1,4452,1210202

168,4850,5400,1900,10260000,2,38806,9703,1,365320000,365320000,14551,4850,9701,4850,0,1,4852,13277729
168,4850,5400,1900,10260000,2,38806,9703,1,365320000,365320000,14551,4850,9701,4850,0,1,4852,1290304
168,4850,5400,1900,10260000,2,38806,9703,1,365320000,365320000,14551,4850,9701,4850,0,1,4852,1296760
168,4850,5400,1900,10260000,2,38806,9703,1,365320000,365320000,14551,4850,9701,4850,0,1,4852,1294562
168,4850,5400,1900,10260000,2,38806,9703,1,365320000,365320000,14551,4850,9701,4850,0,1,4852,1293224
168,4850,5400,1900,10260000,2,38806,9703,1,365320000,365320000,14551,4850,9701,4850,0,1,4852,1299199
168,4850,5400,1900,10260000,2,38806,9703,1,365320000,365320000,14551,4850,9701,4850,0,1,4852,1300287

168,5250,5400,1900,10260000,2,42006,10503,1,388680000,388680000,15751,5250,10501,5250,0,1,5252,14434524
168,5250,5400,1900,10260000,2,42006,10503,1,388680000,388680000,15751,5250,10501,5250,0,1,5252,1428107
168,5250,5400,1900,10260000,2,42006,10503,1,388680000,388680000,15751,5250,10501,5250,0,1,5252,1407806
168,5250,5400,1900,10260000,2,42006,10503,1,388680000,388680000,15751,5250,10501,5250,0,1,5252,1429524
168,5250,5400,1900,10260000,2,42006,10503,1,388680000,388680000,15751,5250,10501,5250,0,1,5252,1416151
168,5250,5400,1900,10260000,2,42006,10503,1,388680000,388680000,15751,5250,10501,5250,0,1,5252,1409690
168,5250,5400,1900,10260000,2,42006,10503,1,388680000,388680000,15751,5250,10501,5250,0,1,5252,1417461

168,5650,5400,1900,10260000,2,45206,11303,1,412040000,412040000,16951,5650,11301,5650,0,1,5652,15380284
168,5650,5400,1900,10260000,2,45206,11303,1,412040000,412040000,16951,5650,11301,5650,0,1,5652,1514066
168,5650,5400,1900,10260000,2,45206,11303,1,412040000,412040000,16951,5650,11301,5650,0,1,5652,1523608
168,5650,5400,1900,10260000,2,45206,11303,1,412040000,412040000,16951,5650,11301,5650,0,1,5652,1521258
168,5650,5400,1900,10260000,2,45206,11303,1,412040000,412040000,16951,5650,11301,5650,0,1,5652,1516356
168,5650,5400,1900,10260000,2,45206,11303,1,412040000,412040000,16951,5650,11301,5650,0,1,5652,1519995
168,5650,5400,1900,10260000,2,45206,11303,1,412040000,412040000,16951,5650,11301,5650,0,1,5652,1499998

168,6050,5400,1900,10260000,2,48406,12103,1,435400000,435400000,18151,6050,12101,6050,0,1,6052,16970148
168,6050,5400,1900,10260000,2,48406,12103,1,435400000,435400000,18151,6050,12101,6050,0,1,6052,1591484
168,6050,5400,1900,10260000,2,48406,12103,1,435400000,435400000,18151,6050,12101,6050,0,1,6052,1590135
168,6050,5400,1900,10260000,2,48406,12103,1,435400000,435400000,18151,6050,12101,6050,0,1,6052,1592872
168,6050,5400,1900,10260000,2,48406,12103,1,435400000,435400000,18151,6050,12101,6050,0,1,6052,1586331
168,6050,5400,1900,10260000,2,48406,12103,1,435400000,435400000,18151,6050,12101,6050,0,1,6052,1578121
168,6050,5400,1900,10260000,2,48406,12103,1,435400000,435400000,18151,6050,12101,6050,0,1,6052,1580487

168,6450,5400,1900,10260000,2,51606,12903,1,458760000,458760000,19351,6450,12901,6450,0,1,6452,18118426
168,6450,5400,1900,10260000,2,51606,12903,1,458760000,458760000,19351,6450,12901,6450,0,1,6452,1719985
168,6450,5400,1900,10260000,2,51606,12903,1,458760000,458760000,19351,6450,12901,6450,0,1,6452,1703653
168,6450,5400,1900,10260000,2,51606,12903,1,458760000,458760000,19351,6450,12901,6450,0,1,6452,1723063
168,6450,5400,1900,10260000,2,51606,12903,1,458760000,458760000,19351,6450,12901,6450,0,1,6452,1725811
168,6450,5400,1900,10260000,2,51606,12903,1,458760000,458760000,19351,6450,12901,6450,0,1,6452,1711280
168,6450,5400,1900,10260000,2,51606,12903,1,458760000,458760000,19351,6450,12901,6450,0,1,6452,1708772

168,6850,5400,1900,10260000,2,54806,13703,1,482120000,482120000,20551,6850,13701,6850,0,1,6852,18681386
168,6850,5400,1900,10260000,2,54806,13703,1,482120000,482120000,20551,6850,13701,6850,0,1,6852,1800171
168,6850,5400,1900,10260000,2,54806,13703,1,482120000,482120000,20551,6850,13701,6850,0,1,6852,1798133
168,6850,5400,1900,10260000,2,54806,13703,1,482120000,482120000,20551,6850,13701,6850,0,1,6852,1802052
168,6850,5400,1900,10260000,2,54806,13703,1,482120000,482120000,20551,6850,13701,6850,0,1,6852,1796510
168,6850,5400,1900,10260000,2,54806,13703,1,482120000,482120000,20551,6850,13701,6850,0,1,6852,1773999
168,6850,5400,1900,10260000,2,54806,13703,1,482120000,482120000,20551,6850,13701,6850,0,1,6852,1779125

168,50,5400,1500,8100000,2,406,103,1,67560000,67560000,151,50,101,50,0,1,52,82367
168,50,5400,1500,8100000,2,406,103,1,67560000,67560000,151,50,101,50,0,1,52,85195
168,50,5400,1500,8100000,2,406,103,1,67560000,67560000,151,50,101,50,0,1,52,77865
168,50,5400,1500,8100000,2,406,103,1,67560000,67560000,151,50,101,50,0,1,52,86132
168,50,5400,1500,8100000,2,406,103,1,67560000,67560000,151,50,101,50,0,1,52,86616
168,50,5400,1500,8100000,2,406,103,1,67560000,67560000,151,50,101,50,0,1,52,107755
168,50,5400,1500,8100000,2,406,103,1,67560000,67560000,151,50,101,50,0,1,52,104458

168,450,5400,1500,8100000,2,3606,903,1,89640000,89640000,1351,450,901,450,0,1,452,890214
168,450,5400,1500,8100000,2,3606,903,1,89640000,89640000,1351,450,901,450,0,1,452,150619
168,450,5400,1500,8100000,2,3606,903,1,89640000,89640000,1351,450,901,450,0,1,452,149623
168,450,5400,1500,8100000,2,3606,903,1,89640000,89640000,1351,450,901,450,0,1,452,149884
168,450,5400,1500,8100000,2,3606,903,1,89640000,89640000,1351,450,901,450,0,1,452,148984
168,450,5400,1500,8100000,2,3606,903,1,89640000,89640000,1351,450,901,450,0,1,452,182028
168,450,5400,1500,8100000,2,3606,903,1,89640000,89640000,1351,450,901,450,0,1,452,182604

168,850,5400,1500,8100000,2,6806,1703,1,111720000,111720000,2551,850,1701,850,0,1,852,1671964
168,850,5400,1500,8100000,2,6806,1703,1,111720000,111720000,2551,850,1701,850,0,1,852,241940
168,850,5400,1500,8100000,2,6806,1703,1,111720000,111720000,2551,850,1701,850,0,1,852,244576
168,850,5400,1500,8100000,2,6806,1703,1,111720000,111720000,2551,850,1701,850,0,1,852,243488
168,850,5400,1500,8100000,2,6806,1703,1,111720000,111720000,2551,850,1701,850,0,1,852,228128
168,850,5400,1500,8100000,2,6806,1703,1,111720000,111720000,2551,850,1701,850,0,1,852,245975
168,850,5400,1500,8100000,2,6806,1703,1,111720000,111720000,2551,850,1701,850,0,1,852,246451

168,1250,5400,1500,8100000,2,10006,2503,1,133800000,133800000,3751,1250,2501,1250,0,1,1252,2494388
168,1250,5400,1500,8100000,2,10006,2503,1,133800000,133800000,3751,1250,2501,1250,0,1,1252,304556
168,1250,5400,1500,8100000,2,10006,2503,1,133800000,133800000,3751,1250,2501,1250,0,1,1252,312570
168,1250,5400,1500,8100000,2,10006,2503,1,133800000,133800000,3751,1250,2501,1250,0,1,1252,327685
168,1250,5400,1500,8100000,2,10006,2503,1,133800000,133800000,3751,1250,2501,1250,0,1,1252,306534
168,1250,5400,1500,8100000,2,10006,2503,1,133800000,133800000,3751,1250,2501,1250,0,1,1252,328083
168,1250,5400,1500,8100000,2,10006,2503,1,133800000,133800000,3751,1250,2501,1250,0,1,1252,328386

168,1650,5400,1500,8100000,2,13206,3303,1,155880000,155880000,4951,1650,3301,1650,0,1,1652,3345600
168,1650,5400,1500,8100000,2,13206,3303,1,155880000,155880000,4951,1650,3301,1650,0,1,1652,419701
168,1650,5400,1500,8100000,2,13206,3303,1,155880000,155880000,4951,1650,3301,1650,0,1,1652,397041
168,1650,5400,1500,8100000,2,13206,3303,1,155880000,155880000,4951,1650,3301,1650,0,1,1652,405423
168,1650,5400,1500,8100000,2,13206,3303,1,155880000,155880000,4951,1650,3301,1650,0,1,1652,373798
168,1650,5400,1500,8100000,2,13206,3303,1,155880000,155880000,4951,1650,3301,1650,0,1,1652,411492
168,1650,5400,1500,8100000,2,13206,3303,1,155880000,155880000,4951,1650,3301,1650,0,1,1652,420280

168,2050,5400,1500,8100000,2,16406,4103,1,177960000,177960000,6151,2050,4101,2050,0,1,2052,4098335
168,2050,5400,1500,8100000,2,16406,4103,1,177960000,177960000,6151,2050,4101,2050,0,1,2052,471693
168,2050,5400,1500,8100000,2,16406,4103,1,177960000,177960000,6151,2050,4101,2050,0,1,2052,466614
168,2050,5400,1500,8100000,2,16406,4103,1,177960000,177960000,6151,2050,4101,2050,0,1,2052,472582
168,2050,5400,1500,8100000,2,16406,4103,1,177960000,177960000,6151,2050,4101,2050,0,1,2052,488583
168,2050,5400,1500,8100000,2,16406,4103,1,177960000,177960000,6151,2050,4101,2050,0,1,2052,505329
168,2050,5400,1500,8100000,2,16406,4103,1,177960000,177960000,6151,2050,4101,2050,0,1,2052,505964

168,2450,5400,1500,8100000,2,19606,4903,1,200040000,200040000,7351,2450,4901,2450,0,1,2452,4934094
168,2450,5400,1500,8100000,2,19606,4903,1,200040000,200040000,7351,2450,4901,2450,0,1,2452,553155
168,2450,5400,1500,8100000,2,19606,4903,1,200040000,200040000,7351,2450,4901,2450,0,1,2452,556503
168,2450,5400,1500,8100000,2,19606,4903,1,200040000,200040000,7351,2450,4901,2450,0,1,2452,552052
168,2450,5400,1500,8100000,2,19606,4903,1,200040000,200040000,7351,2450,4901,2450,0,1,2452,548562
168,2450,5400,1500,8100000,2,19606,4903,1,200040000,200040000,7351,2450,4901,2450,0,1,2452,594820
168,2450,5400,1500,8100000,2,19606,4903,1,200040000,200040000,7351,2450,4901,2450,0,1,2452,575655

168,2850,5400,1500,8100000,2,22806,5703,1,222120000,222120000,8551,2850,5701,2850,0,1,2852,6035862
168,2850,5400,1500,8100000,2,22806,5703,1,222120000,222120000,8551,2850,5701,2850,0,1,2852,627010
168,2850,5400,1500,8100000,2,22806,5703,1,222120000,222120000,8551,2850,5701,2850,0,1,2852,621346
168,2850,5400,1500,8100000,2,22806,5703,1,222120000,222120000,8551,2850,5701,2850,0,1,2852,624790
168,2850,5400,1500,8100000,2,22806,5703,1,222120000,222120000,8551,2850,5701,2850,0,1,2852,622726
168,2850,5400,1500,8100000,2,22806,5703,1,222120000,222120000,8551,2850,5701,2850,0,1,2852,657361
168,2850,5400,1500,8100000,2,22806,5703,1,222120000,222120000,8551,2850,5701,2850,0,1,2852,658082

168,3250,5400,1500,8100000,2,26006,6503,1,244200000,244200000,9751,3250,6501,3250,0,1,3252,6644052
168,3250,5400,1500,8100000,2,26006,6503,1,244200000,244200000,9751,3250,6501,3250,0,1,3252,706974
168,3250,5400,1500,8100000,2,26006,6503,1,244200000,244200000,9751,3250,6501,3250,0,1,3252,712485
168,3250,5400,1500,8100000,2,26006,6503,1,244200000,244200000,9751,3250,6501,3250,0,1,3252,714635
168,3250,5400,1500,8100000,2,26006,6503,1,244200000,244200000,9751,3250,6501,3250,0,1,3252,695725
168,3250,5400,1500,8100000,2,26006,6503,1,244200000,244200000,9751,3250,6501,3250,0,1,3252,740746
168,3250,5400,1500,8100000,2,26006,6503,1,244200000,244200000,9751,3250,6501,3250,0,1,3252,741486

168,3650,5400,1500,8100000,2,29206,7303,1,266280000,266280000,10951,3650,7301,3650,0,1,3652,7631164
168,3650,5400,1500,8100000,2,29206,7303,1,266280000,266280000,10951,3650,7301,3650,0,1,3652,793271
168,3650,5400,1500,8100000,2,29206,7303,1,266280000,266280000,10951,3650,7301,3650,0,1,3652,791371
168,3650,5400,1500,8100000,2,29206,7303,1,266280000,266280000,10951,3650,7301,3650,0,1,3652,795342
168,3650,5400,1500,8100000,2,29206,7303,1,266280000,266280000,10951,3650,7301,3650,0,1,3652,788171
168,3650,5400,1500,8100000,2,29206,7303,1,266280000,266280000,10951,3650,7301,3650,0,1,3652,819686
168,3650,5400,1500,8100000,2,29206,7303,1,266280000,266280000,10951,3650,7301,3650,0,1,3652,820504

168,4050,5400,1500,8100000,2,32406,8103,1,288360000,288360000,12151,4050,8101,4050,0,1,4052,8415318
168,4050,5400,1500,8100000,2,32406,8103,1,288360000,288360000,12151,4050,8101,4050,0,1,4052,897804
168,4050,5400,1500,8100000,2,32406,8103,1,288360000,288360000,12151,4050,8101,4050,0,1,4052,887960
168,4050,5400,1500,8100000,2,32406,8103,1,288360000,288360000,12151,4050,8101,4050,0,1,4052,900650
168,4050,5400,1500,8100000,2,32406,8103,1,288360000,288360000,12151,4050,8101,4050,0,1,4052,894971
168,4050,5400,1500,8100000,2,32406,8103,1,288360000,288360000,12151,4050,8101,4050,0,1,4052,909814
168,4050,5400,1500,8100000,2,32406,8103,1,288360000,288360000,12151,4050,8101,4050,0,1,4052,910653

168,4450,5400,1500,8100000,2,35606,8903,1,310440000,310440000,13351,4450,8901,4450,0,1,4452,9436531
168,4450,5400,1500,8100000,2,35606,8903,1,310440000,310440000,13351,4450,8901,4450,0,1,4452,1000302
168,4450,5400,1500,8100000,2,35606,8903,1,310440000,310440000,13351,4450,8901,4450,0,1,4452,966037
168,4450,5400,1500,8100000,2,35606,8903,1,310440000,310440000,13351,4450,8901,4450,0,1,4452,975543
168,4450,5400,1500,8100000,2,35606,8903,1,310440000,310440000,13351,4450,8901,4450,0,1,4452,1006202
168,4450,5400,1500,8100000,2,35606,8903,1,310440000,310440000,13351,4450,8901,4450,0,1,4452,1009304
168,4450,5400,1500,8100000,2,35606,8903,1,310440000,310440000,13351,4450,8901,4450,0,1,4452,1013320

168,4850,5400,1500,8100000,2,38806,9703,1,332520000,332520000,14551,4850,9701,4850,0,1,4852,10136017
168,4850,5400,1500,8100000,2,38806,9703,1,332520000,332520000,14551,4850,9701,4850,0,1,4852,1082382
168,4850,5400,1500,8100000,2,38806,9703,1,332520000,332520000,14551,4850,9701,4850,0,1,4852,1092040
168,4850,5400,1500,8100000,2,38806,9703,1,332520000,332520000,14551,4850,9701,4850,0,1,4852,1087488
168,4850,5400,1500,8100000,2,38806,9703,1,332520000,332520000,14551,4850,9701,4850,0,1,4852,1073237
168,4850,5400,1500,8100000,2,38806,9703,1,332520000,332520000,14551,4850,9701,4850,0,1,4852,1094801
168,4850,5400,1500,8100000,2,38806,9703,1,332520000,332520000,14551,4850,9701,4850,0,1,4852,1093003

168,5250,5400,1500,8100000,2,42006,10503,1,354600000,354600000,15751,5250,10501,5250,0,1,5252,11134856
168,5250,5400,1500,8100000,2,42006,10503,1,354600000,354600000,15751,5250,10501,5250,0,1,5252,1140100
168,5250,5400,1500,8100000,2,42006,10503,1,354600000,354600000,15751,5250,10501,5250,0,1,5252,1141429
168,5250,5400,1500,8100000,2,42006,10503,1,354600000,354600000,15751,5250,10501,5250,0,1,5252,1142731
168,5250,5400,1500,8100000,2,42006,10503,1,354600000,354600000,15751,5250,10501,5250,0,1,5252,1134092
168,5250,5400,1500,8100000,2,42006,10503,1,354600000,354600000,15751,5250,10501,5250,0,1,5252,1145386
168,5250,5400,1500,8100000,2,42006,10503,1,354600000,354600000,15751,5250,10501,5250,0,1,5252,1146394

168,5650,5400,1500,8100000,2,45206,11303,1,376680000,376680000,16951,5650,11301,5650,0,1,5652,11652494
168,5650,5400,1500,8100000,2,45206,11303,1,376680000,376680000,16951,5650,11301,5650,0,1,5652,1239897
168,5650,5400,1500,8100000,2,45206,11303,1,376680000,376680000,16951,5650,11301,5650,0,1,5652,1237452
168,5650,5400,1500,8100000,2,45206,11303,1,376680000,376680000,16951,5650,11301,5650,0,1,5652,1246528
168,5650,5400,1500,8100000,2,45206,11303,1,376680000,376680000,16951,5650,11301,5650,0,1,5652,1225914
168,5650,5400,1500,8100000,2,45206,11303,1,376680000,376680000,16951,5650,11301,5650,0,1,5652,1242432
168,5650,5400,1500,8100000,2,45206,11303,1,376680000,376680000,16951,5650,11301,5650,0,1,5652,1243944

168,6050,5400,1500,8100000,2,48406,12103,1,398760000,398760000,18151,6050,12101,6050,0,1,6052,12509763
168,6050,5400,1500,8100000,2,48406,12103,1,398760000,398760000,18151,6050,12101,6050,0,1,6052,1342054
168,6050,5400,1500,8100000,2,48406,12103,1,398760000,398760000,18151,6050,12101,6050,0,1,6052,1348842
168,6050,5400,1500,8100000,2,48406,12103,1,398760000,398760000,18151,6050,12101,6050,0,1,6052,1309783
168,6050,5400,1500,8100000,2,48406,12103,1,398760000,398760000,18151,6050,12101,6050,0,1,6052,1346324
168,6050,5400,1500,8100000,2,48406,12103,1,398760000,398760000,18151,6050,12101,6050,0,1,6052,1336872
168,6050,5400,1500,8100000,2,48406,12103,1,398760000,398760000,18151,6050,12101,6050,0,1,6052,1330841

168,6450,5400,1500,8100000,2,51606,12903,1,420840000,420840000,19351,6450,12901,6450,0,1,6452,13669071
168,6450,5400,1500,8100000,2,51606,12903,1,420840000,420840000,19351,6450,12901,6450,0,1,6452,1386110
168,6450,5400,1500,8100000,2,51606,12903,1,420840000,420840000,19351,6450,12901,6450,0,1,6452,1387512
168,6450,5400,1500,8100000,2,51606,12903,1,420840000,420840000,19351,6450,12901,6450,0,1,6452,1388917
168,6450,5400,1500,8100000,2,51606,12903,1,420840000,420840000,19351,6450,12901,6450,0,1,6452,1384862
168,6450,5400,1500,8100000,2,51606,12903,1,420840000,420840000,19351,6450,12901,6450,0,1,6452,1380815
168,6450,5400,1500,8100000,2,51606,12903,1,420840000,420840000,19351,6450,12901,6450,0,1,6452,1382993

168,6850,5400,1500,8100000,2,54806,13703,1,442920000,442920000,20551,6850,13701,6850,0,1,6852,14900687
168,6850,5400,1500,8100000,2,54806,13703,1,442920000,442920000,20551,6850,13701,6850,0,1,6852,1478053
168,6850,5400,1500,8100000,2,54806,13703,1,442920000,442920000,20551,6850,13701,6850,0,1,6852,1479302
168,6850,5400,1500,8100000,2,54806,13703,1,442920000,442920000,20551,6850,13701,6850,0,1,6852,1482727
168,6850,5400,1500,8100000,2,54806,13703,1,442920000,442920000,20551,6850,13701,6850,0,1,6852,1476825
168,6850,5400,1500,8100000,2,54806,13703,1,442920000,442920000,20551,6850,13701,6850,0,1,6852,1471705
168,6850,5400,1500,8100000,2,54806,13703,1,442920000,442920000,20551,6850,13701,6850,0,1,6852,1475831

168,50,5400,1100,5940000,2,406,103,1,50120000,50120000,151,50,101,50,0,1,52,59952
168,50,5400,1100,5940000,2,406,103,1,50120000,50120000,151,50,101,50,0,1,52,64020
168,50,5400,1100,5940000,2,406,103,1,50120000,50120000,151,50,101,50,0,1,52,57901
168,50,5400,1100,5940000,2,406,103,1,50120000,50120000,151,50,101,50,0,1,52,63438
168,50,5400,1100,5940000,2,406,103,1,50120000,50120000,151,50,101,50,0,1,52,65216
168,50,5400,1100,5940000,2,406,103,1,50120000,50120000,151,50,101,50,0,1,52,80561
168,50,5400,1100,5940000,2,406,103,1,50120000,50120000,151,50,101,50,0,1,52,79378

168,450,5400,1100,5940000,2,3606,903,1,70920000,70920000,1351,450,901,450,0,1,452,594925
168,450,5400,1100,5940000,2,3606,903,1,70920000,70920000,1351,450,901,450,0,1,452,111793
168,450,5400,1100,5940000,2,3606,903,1,70920000,70920000,1351,450,901,450,0,1,452,112396
168,450,5400,1100,5940000,2,3606,903,1,70920000,70920000,1351,450,901,450,0,1,452,113363
168,450,5400,1100,5940000,2,3606,903,1,70920000,70920000,1351,450,901,450,0,1,452,112650
168,450,5400,1100,5940000,2,3606,903,1,70920000,70920000,1351,450,901,450,0,1,452,141920
168,450,5400,1100,5940000,2,3606,903,1,70920000,70920000,1351,450,901,450,0,1,452,142494

168,850,5400,1100,5940000,2,6806,1703,1,91720000,91720000,2551,850,1701,850,0,1,852,1290079
168,850,5400,1100,5940000,2,6806,1703,1,91720000,91720000,2551,850,1701,850,0,1,852,175957
168,850,5400,1100,5940000,2,6806,1703,1,91720000,91720000,2551,850,1701,850,0,1,852,174594
168,850,5400,1100,5940000,2,6806,1703,1,91720000,91720000,2551,850,1701,850,0,1,852,176911
168,850,5400,1100,5940000,2,6806,1703,1,91720000,91720000,2551,850,1701,850,0,1,852,176549
168,850,5400,1100,5940000,2,6806,1703,1,91720000,91720000,2551,850,1701,850,0,1,852,200708
168,850,5400,1100,5940000,2,6806,1703,1,91720000,91720000,2551,850,1701,850,0,1,852,204747

168,1250,5400,1100,5940000,2,10006,2503,1,112520000,112520000,3751,1250,2501,1250,0,1,1252,1840090
168,1250,5400,1100,5940000,2,10006,2503,1,112520000,112520000,3751,1250,2501,1250,0,1,1252,252109
168,1250,5400,1100,5940000,2,10006,2503,1,112520000,112520000,3751,1250,2501,1250,0,1,1252,250317
168,1250,5400,1100,5940000,2,10006,2503,1,112520000,112520000,3751,1250,2501,1250,0,1,1252,237715
168,1250,5400,1100,5940000,2,10006,2503,1,112520000,112520000,3751,1250,2501,1250,0,1,1252,255996
168,1250,5400,1100,5940000,2,10006,2503,1,112520000,112520000,3751,1250,2501,1250,0,1,1252,254417
168,1250,5400,1100,5940000,2,10006,2503,1,112520000,112520000,3751,1250,2501,1250,0,1,1252,256518

168,1650,5400,1100,5940000,2,13206,3303,1,133320000,133320000,4951,1650,3301,1650,0,1,1652,2316170
168,1650,5400,1100,5940000,2,13206,3303,1,133320000,133320000,4951,1650,3301,1650,0,1,1652,296121
168,1650,5400,1100,5940000,2,13206,3303,1,133320000,133320000,4951,1650,3301,1650,0,1,1652,313159
168,1650,5400,1100,5940000,2,13206,3303,1,133320000,133320000,4951,1650,3301,1650,0,1,1652,318322
168,1650,5400,1100,5940000,2,13206,3303,1,133320000,133320000,4951,1650,3301,1650,0,1,1652,319699
168,1650,5400,1100,5940000,2,13206,3303,1,133320000,133320000,4951,1650,3301,1650,0,1,1652,318843
168,1650,5400,1100,5940000,2,13206,3303,1,133320000,133320000,4951,1650,3301,1650,0,1,1652,319198

168,2050,5400,1100,5940000,2,16406,4103,1,154120000,154120000,6151,2050,4101,2050,0,1,2052,3004043
168,2050,5400,1100,5940000,2,16406,4103,1,154120000,154120000,6151,2050,4101,2050,0,1,2052,387739
168,2050,5400,1100,5940000,2,16406,4103,1,154120000,154120000,6151,2050,4101,2050,0,1,2052,383884
168,2050,5400,1100,5940000,2,16406,4103,1,154120000,154120000,6151,2050,4101,2050,0,1,2052,363011
168,2050,5400,1100,5940000,2,16406,4103,1,154120000,154120000,6151,2050,4101,2050,0,1,2052,361717
168,2050,5400,1100,5940000,2,16406,4103,1,154120000,154120000,6151,2050,4101,2050,0,1,2052,409502
168,2050,5400,1100,5940000,2,16406,4103,1,154120000,154120000,6151,2050,4101,2050,0,1,2052,392464

168,2450,5400,1100,5940000,2,19606,4903,1,174920000,174920000,7351,2450,4901,2450,0,1,2452,3485638
168,2450,5400,1100,5940000,2,19606,4903,1,174920000,174920000,7351,2450,4901,2450,0,1,2452,442754
168,2450,5400,1100,5940000,2,19606,4903,1,174920000,174920000,7351,2450,4901,2450,0,1,2452,432926
168,2450,5400,1100,5940000,2,19606,4903,1,174920000,174920000,7351,2450,4901,2450,0,1,2452,440093
168,2450,5400,1100,5940000,2,19606,4903,1,174920000,174920000,7351,2450,4901,2450,0,1,2452,438597
168,2450,5400,1100,5940000,2,19606,4903,1,174920000,174920000,7351,2450,4901,2450,0,1,2452,453780
168,2450,5400,1100,5940000,2,19606,4903,1,174920000,174920000,7351,2450,4901,2450,0,1,2452,454444

168,2850,5400,1100,5940000,2,22806,5703,1,195720000,195720000,8551,2850,5701,2850,0,1,2852,4085948
168,2850,5400,1100,5940000,2,22806,5703,1,195720000,195720000,8551,2850,5701,2850,0,1,2852,479562
168,2850,5400,1100,5940000,2,22806,5703,1,195720000,195720000,8551,2850,5701,2850,0,1,2852,482127
168,2850,5400,1100,5940000,2,22806,5703,1,195720000,195720000,8551,2850,5701,2850,0,1,2852,480973
168,2850,5400,1100,5940000,2,22806,5703,1,195720000,195720000,8551,2850,5701,2850,0,1,2852,484929
168,2850,5400,1100,5940000,2,22806,5703,1,195720000,195720000,8551,2850,5701,2850,0,1,2852,509588
168,2850,5400,1100,5940000,2,22806,5703,1,195720000,195720000,8551,2850,5701,2850,0,1,2852,510299

168,3250,5400,1100,5940000,2,26006,6503,1,216520000,216520000,9751,3250,6501,3250,0,1,3252,4872783
168,3250,5400,1100,5940000,2,26006,6503,1,216520000,216520000,9751,3250,6501,3250,0,1,3252,544307
168,3250,5400,1100,5940000,2,26006,6503,1,216520000,216520000,9751,3250,6501,3250,0,1,3252,545218
168,3250,5400,1100,5940000,2,26006,6503,1,216520000,216520000,9751,3250,6501,3250,0,1,3252,543394
168,3250,5400,1100,5940000,2,26006,6503,1,216520000,216520000,9751,3250,6501,3250,0,1,3252,546016
168,3250,5400,1100,5940000,2,26006,6503,1,216520000,216520000,9751,3250,6501,3250,0,1,3252,584156
168,3250,5400,1100,5940000,2,26006,6503,1,216520000,216520000,9751,3250,6501,3250,0,1,3252,585520

168,3650,5400,1100,5940000,2,29206,7303,1,237320000,237320000,10951,3650,7301,3650,0,1,3652,5564052
168,3650,5400,1100,5940000,2,29206,7303,1,237320000,237320000,10951,3650,7301,3650,0,1,3652,601192
168,3650,5400,1100,5940000,2,29206,7303,1,237320000,237320000,10951,3650,7301,3650,0,1,3652,600218
168,3650,5400,1100,5940000,2,29206,7303,1,237320000,237320000,10951,3650,7301,3650,0,1,3652,602070
168,3650,5400,1100,5940000,2,29206,7303,1,237320000,237320000,10951,3650,7301,3650,0,1,3652,597143
168,3650,5400,1100,5940000,2,29206,7303,1,237320000,237320000,10951,3650,7301,3650,0,1,3652,653182
168,3650,5400,1100,5940000,2,29206,7303,1,237320000,237320000,10951,3650,7301,3650,0,1,3652,652379

168,4050,5400,1100,5940000,2,32406,8103,1,258120000,258120000,12151,4050,8101,4050,0,1,4052,6110081
168,4050,5400,1100,5940000,2,32406,8103,1,258120000,258120000,12151,4050,8101,4050,0,1,4052,666623
168,4050,5400,1100,5940000,2,32406,8103,1,258120000,258120000,12151,4050,8101,4050,0,1,4052,662849
168,4050,5400,1100,5940000,2,32406,8103,1,258120000,258120000,12151,4050,8101,4050,0,1,4052,668551
168,4050,5400,1100,5940000,2,32406,8103,1,258120000,258120000,12151,4050,8101,4050,0,1,4052,670203
168,4050,5400,1100,5940000,2,32406,8103,1,258120000,258120000,12151,4050,8101,4050,0,1,4052,704422
168,4050,5400,1100,5940000,2,32406,8103,1,258120000,258120000,12151,4050,8101,4050,0,1,4052,703579

168,4450,5400,1100,5940000,2,35606,8903,1,278920000,278920000,13351,4450,8901,4450,0,1,4452,6743396
168,4450,5400,1100,5940000,2,35606,8903,1,278920000,278920000,13351,4450,8901,4450,0,1,4452,764416
168,4450,5400,1100,5940000,2,35606,8903,1,278920000,278920000,13351,4450,8901,4450,0,1,4452,757325
168,4450,5400,1100,5940000,2,35606,8903,1,278920000,278920000,13351,4450,8901,4450,0,1,4452,770605
168,4450,5400,1100,5940000,2,35606,8903,1,278920000,278920000,13351,4450,8901,4450,0,1,4452,761832
168,4450,5400,1100,5940000,2,35606,8903,1,278920000,278920000,13351,4450,8901,4450,0,1,4452,780307
168,4450,5400,1100,5940000,2,35606,8903,1,278920000,278920000,13351,4450,8901,4450,0,1,4452,781844

168,4850,5400,1100,5940000,2,38806,9703,1,299720000,299720000,14551,4850,9701,4850,0,1,4852,7318475
168,4850,5400,1100,5940000,2,38806,9703,1,299720000,299720000,14551,4850,9701,4850,0,1,4852,833502
168,4850,5400,1100,5940000,2,38806,9703,1,299720000,299720000,14551,4850,9701,4850,0,1,4852,812199
168,4850,5400,1100,5940000,2,38806,9703,1,299720000,299720000,14551,4850,9701,4850,0,1,4852,828966
168,4850,5400,1100,5940000,2,38806,9703,1,299720000,299720000,14551,4850,9701,4850,0,1,4852,843315
168,4850,5400,1100,5940000,2,38806,9703,1,299720000,299720000,14551,4850,9701,4850,0,1,4852,850837
168,4850,5400,1100,5940000,2,38806,9703,1,299720000,299720000,14551,4850,9701,4850,0,1,4852,862316

168,5250,5400,1100,5940000,2,42006,10503,1,320520000,320520000,15751,5250,10501,5250,0,1,5252,7975677
168,5250,5400,1100,5940000,2,42006,10503,1,320520000,320520000,15751,5250,10501,5250,0,1,5252,934232
168,5250,5400,1100,5940000,2,42006,10503,1,320520000,320520000,15751,5250,10501,5250,0,1,5252,928986
168,5250,5400,1100,5940000,2,42006,10503,1,320520000,320520000,15751,5250,10501,5250,0,1,5252,906454
168,5250,5400,1100,5940000,2,42006,10503,1,320520000,320520000,15751,5250,10501,5250,0,1,5252,896194
168,5250,5400,1100,5940000,2,42006,10503,1,320520000,320520000,15751,5250,10501,5250,0,1,5252,935235
168,5250,5400,1100,5940000,2,42006,10503,1,320520000,320520000,15751,5250,10501,5250,0,1,5252,930239

168,5650,5400,1100,5940000,2,45206,11303,1,341320000,341320000,16951,5650,11301,5650,0,1,5652,8451648
168,5650,5400,1100,5940000,2,45206,11303,1,341320000,341320000,16951,5650,11301,5650,0,1,5652,946425
168,5650,5400,1100,5940000,2,45206,11303,1,341320000,341320000,16951,5650,11301,5650,0,1,5652,943401
168,5650,5400,1100,5940000,2,45206,11303,1,341320000,341320000,16951,5650,11301,5650,0,1,5652,953879
168,5650,5400,1100,5940000,2,45206,11303,1,341320000,341320000,16951,5650,11301,5650,0,1,5652,950796
168,5650,5400,1100,5940000,2,45206,11303,1,341320000,341320000,16951,5650,11301,5650,0,1,5652,956981
168,5650,5400,1100,5940000,2,45206,11303,1,341320000,341320000,16951,5650,11301,5650,0,1,5652,958026

168,6050,5400,1100,5940000,2,48406,12103,1,362120000,362120000,18151,6050,12101,6050,0,1,6052,9372381
168,6050,5400,1100,5940000,2,48406,12103,1,362120000,362120000,18151,6050,12101,6050,0,1,6052,1017458
168,6050,5400,1100,5940000,2,48406,12103,1,362120000,362120000,18151,6050,12101,6050,0,1,6052,1015672
168,6050,5400,1100,5940000,2,48406,12103,1,362120000,362120000,18151,6050,12101,6050,0,1,6052,1019374
168,6050,5400,1100,5940000,2,48406,12103,1,362120000,362120000,18151,6050,12101,6050,0,1,6052,1010839
168,6050,5400,1100,5940000,2,48406,12103,1,362120000,362120000,18151,6050,12101,6050,0,1,6052,1023127
168,6050,5400,1100,5940000,2,48406,12103,1,362120000,362120000,18151,6050,12101,6050,0,1,6052,1022046

168,6450,5400,1100,5940000,2,51606,12903,1,382920000,382920000,19351,6450,12901,6450,0,1,6452,9716871
168,6450,5400,1100,5940000,2,51606,12903,1,382920000,382920000,19351,6450,12901,6450,0,1,6452,1093287
168,6450,5400,1100,5940000,2,51606,12903,1,382920000,382920000,19351,6450,12901,6450,0,1,6452,1091402
168,6450,5400,1100,5940000,2,51606,12903,1,382920000,382920000,19351,6450,12901,6450,0,1,6452,1099846
168,6450,5400,1100,5940000,2,51606,12903,1,382920000,382920000,19351,6450,12901,6450,0,1,6452,1088291
168,6450,5400,1100,5940000,2,51606,12903,1,382920000,382920000,19351,6450,12901,6450,0,1,6452,1097122
168,6450,5400,1100,5940000,2,51606,12903,1,382920000,382920000,19351,6450,12901,6450,0,1,6452,1098191

168,6850,5400,1100,5940000,2,54806,13703,1,403720000,403720000,20551,6850,13701,6850,0,1,6852,10578638
168,6850,5400,1100,5940000,2,54806,13703,1,403720000,403720000,20551,6850,13701,6850,0,1,6852,1181758
168,6850,5400,1100,5940000,2,54806,13703,1,403720000,403720000,20551,6850,13701,6850,0,1,6852,1185893
168,6850,5400,1100,5940000,2,54806,13703,1,403720000,403720000,20551,6850,13701,6850,0,1,6852,1142344
168,6850,5400,1100,5940000,2,54806,13703,1,403720000,403720000,20551,6850,13701,6850,0,1,6852,1184173
168,6850,5400,1100,5940000,2,54806,13703,1,403720000,403720000,20551,6850,13701,6850,0,1,6852,1177193
168,6850,5400,1100,5940000,2,54806,13703,1,403720000,403720000,20551,6850,13701,6850,0,1,6852,1179111

168,50,5400,700,3780000,2,406,103,1,32680000,32680000,151,50,101,50,0,1,52,39093
168,50,5400,700,3780000,2,406,103,1,32680000,32680000,151,50,101,50,0,1,52,45203
168,50,5400,700,3780000,2,406,103,1,32680000,32680000,151,50,101,50,0,1,52,47856
168,50,5400,700,3780000,2,406,103,1,32680000,32680000,151,50,101,50,0,1,52,38871
168,50,5400,700,3780000,2,406,103,1,32680000,32680000,151,50,101,50,0,1,52,47397
168,50,5400,700,3780000,2,406,103,1,32680000,32680000,151,50,101,50,0,1,52,56358
168,50,5400,700,3780000,2,406,103,1,32680000,32680000,151,50,101,50,0,1,52,55874

168,450,5400,700,3780000,2,3606,903,1,52200000,52200000,1351,450,901,450,0,1,452,367463
168,450,5400,700,3780000,2,3606,903,1,52200000,52200000,1351,450,901,450,0,1,452,79614
168,450,5400,700,3780000,2,3606,903,1,52200000,52200000,1351,450,901,450,0,1,452,83577
168,450,5400,700,3780000,2,3606,903,1,52200000,52200000,1351,450,901,450,0,1,452,83040
168,450,5400,700,3780000,2,3606,903,1,52200000,52200000,1351,450,901,450,0,1,452,76380
168,450,5400,700,3780000,2,3606,903,1,52200000,52200000,1351,450,901,450,0,1,452,98403
168,450,5400,700,3780000,2,3606,903,1,52200000,52200000,1351,450,901,450,0,1,452,98988

168,850,5400,700,3780000,2,6806,1703,1,71720000,71720000,2551,850,1701,850,0,1,852,790485
168,850,5400,700,3780000,2,6806,1703,1,71720000,71720000,2551,850,1701,850,0,1,852,126498
168,850,5400,700,3780000,2,6806,1703,1,71720000,71720000,2551,850,1701,850,0,1,852,125864
168,850,5400,700,3780000,2,6806,1703,1,71720000,71720000,2551,850,1701,850,0,1,852,121134
168,850,5400,700,3780000,2,6806,1703,1,71720000,71720000,2551,850,1701,850,0,1,852,123929
168,850,5400,700,3780000,2,6806,1703,1,71720000,71720000,2551,850,1701,850,0,1,852,139881
168,850,5400,700,3780000,2,6806,1703,1,71720000,71720000,2551,850,1701,850,0,1,852,141261

168,1250,5400,700,3780000,2,10006,2503,1,91240000,91240000,3751,1250,2501,1250,0,1,1252,1145583
168,1250,5400,700,3780000,2,10006,2503,1,91240000,91240000,3751,1250,2501,1250,0,1,1252,166653
168,1250,5400,700,3780000,2,10006,2503,1,91240000,91240000,3751,1250,2501,1250,0,1,1252,167713
168,1250,5400,700,3780000,2,10006,2503,1,91240000,91240000,3751,1250,2501,1250,0,1,1252,168357
168,1250,5400,700,3780000,2,10006,2503,1,91240000,91240000,3751,1250,2501,1250,0,1,1252,168806
168,1250,5400,700,3780000,2,10006,2503,1,91240000,91240000,3751,1250,2501,1250,0,1,1252,196809
168,1250,5400,700,3780000,2,10006,2503,1,91240000,91240000,3751,1250,2501,1250,0,1,1252,197552

168,1650,5400,700,3780000,2,13206,3303,1,110760000,110760000,4951,1650,3301,1650,0,1,1652,1550702
168,1650,5400,700,3780000,2,13206,3303,1,110760000,110760000,4951,1650,3301,1650,0,1,1652,208716
168,1650,5400,700,3780000,2,13206,3303,1,110760000,110760000,4951,1650,3301,1650,0,1,1652,209883
168,1650,5400,700,3780000,2,13206,3303,1,110760000,110760000,4951,1650,3301,1650,0,1,1652,212333
168,1650,5400,700,3780000,2,13206,3303,1,110760000,110760000,4951,1650,3301,1650,0,1,1652,210944
168,1650,5400,700,3780000,2,13206,3303,1,110760000,110760000,4951,1650,3301,1650,0,1,1652,227919
168,1650,5400,700,3780000,2,13206,3303,1,110760000,110760000,4951,1650,3301,1650,0,1,1652,228569

168,2050,5400,700,3780000,2,16406,4103,1,130280000,130280000,6151,2050,4101,2050,0,1,2052,1867546
168,2050,5400,700,3780000,2,16406,4103,1,130280000,130280000,6151,2050,4101,2050,0,1,2052,256486
168,2050,5400,700,3780000,2,16406,4103,1,130280000,130280000,6151,2050,4101,2050,0,1,2052,253935
168,2050,5400,700,3780000,2,16406,4103,1,130280000,130280000,6151,2050,4101,2050,0,1,2052,255053
168,2050,5400,700,3780000,2,16406,4103,1,130280000,130280000,6151,2050,4101,2050,0,1,2052,252475
168,2050,5400,700,3780000,2,16406,4103,1,130280000,130280000,6151,2050,4101,2050,0,1,2052,274338
168,2050,5400,700,3780000,2,16406,4103,1,130280000,130280000,6151,2050,4101,2050,0,1,2052,273721

168,2450,5400,700,3780000,2,19606,4903,1,149800000,149800000,7351,2450,4901,2450,0,1,2452,2202791
168,2450,5400,700,3780000,2,19606,4903,1,149800000,149800000,7351,2450,4901,2450,0,1,2452,298023
168,2450,5400,700,3780000,2,19606,4903,1,149800000,149800000,7351,2450,4901,2450,0,1,2452,296804
168,2450,5400,700,3780000,2,19606,4903,1,149800000,149800000,7351,2450,4901,2450,0,1,2452,294533
168,2450,5400,700,3780000,2,19606,4903,1,149800000,149800000,7351,2450,4901,2450,0,1,2452,295375
168,2450,5400,700,3780000,2,19606,4903,1,149800000,149800000,7351,2450,4901,2450,0,1,2452,319458
168,2450,5400,700,3780000,2,19606,4903,1,149800000,149800000,7351,2450,4901,2450,0,1,2452,318794

168,2850,5400,700,3780000,2,22806,5703,1,169320000,169320000,8551,2850,5701,2850,0,1,2852,2612261
168,2850,5400,700,3780000,2,22806,5703,1,169320000,169320000,8551,2850,5701,2850,0,1,2852,340663
168,2850,5400,700,3780000,2,22806,5703,1,169320000,169320000,8551,2850,5701,2850,0,1,2852,339119
168,2850,5400,700,3780000,2,22806,5703,1,169320000,169320000,8551,2850,5701,2850,0,1,2852,342536
168,2850,5400,700,3780000,2,22806,5703,1,169320000,169320000,8551,2850,5701,2850,0,1,2852,341436
168,2850,5400,700,3780000,2,22806,5703,1,169320000,169320000,8551,2850,5701,2850,0,1,2852,369171
168,2850,5400,700,3780000,2,22806,5703,1,169320000,169320000,8551,2850,5701,2850,0,1,2852,369880

168,3250,5400,700,3780000,2,26006,6503,1,188840000,188840000,9751,3250,6501,3250,0,1,3252,2924135
168,3250,5400,700,3780000,2,26006,6503,1,188840000,188840000,9751,3250,6501,3250,0,1,3252,384294
168,3250,5400,700,3780000,2,26006,6503,1,188840000,188840000,9751,3250,6501,3250,0,1,3252,385209
168,3250,5400,700,3780000,2,26006,6503,1,188840000,188840000,9751,3250,6501,3250,0,1,3252,383407
168,3250,5400,700,3780000,2,26006,6503,1,188840000,188840000,9751,3250,6501,3250,0,1,3252,385998
168,3250,5400,700,3780000,2,26006,6503,1,188840000,188840000,9751,3250,6501,3250,0,1,3252,416134
168,3250,5400,700,3780000,2,26006,6503,1,188840000,188840000,9751,3250,6501,3250,0,1,3252,416902

168,3650,5400,700,3780000,2,29206,7303,1,208360000,208360000,10951,3650,7301,3650,0,1,3652,3391316
168,3650,5400,700,3780000,2,29206,7303,1,208360000,208360000,10951,3650,7301,3650,0,1,3652,428248
168,3650,5400,700,3780000,2,29206,7303,1,208360000,208360000,10951,3650,7301,3650,0,1,3652,427346
168,3650,5400,700,3780000,2,29206,7303,1,208360000,208360000,10951,3650,7301,3650,0,1,3652,429395
168,3650,5400,700,3780000,2,29206,7303,1,208360000,208360000,10951,3650,7301,3650,0,1,3652,425986
168,3650,5400,700,3780000,2,29206,7303,1,208360000,208360000,10951,3650,7301,3650,0,1,3652,468501
168,3650,5400,700,3780000,2,29206,7303,1,208360000,208360000,10951,3650,7301,3650,0,1,3652,469286

168,4050,5400,700,3780000,2,32406,8103,1,227880000,227880000,12151,4050,8101,4050,0,1,4052,3686961
168,4050,5400,700,3780000,2,32406,8103,1,227880000,227880000,12151,4050,8101,4050,0,1,4052,475435
168,4050,5400,700,3780000,2,32406,8103,1,227880000,227880000,12151,4050,8101,4050,0,1,4052,479484
168,4050,5400,700,3780000,2,32406,8103,1,227880000,227880000,12151,4050,8101,4050,0,1,4052,476427
168,4050,5400,700,3780000,2,32406,8103,1,227880000,227880000,12151,4050,8101,4050,0,1,4052,477654
168,4050,5400,700,3780000,2,32406,8103,1,227880000,227880000,12151,4050,8101,4050,0,1,4052,512840
168,4050,5400,700,3780000,2,32406,8103,1,227880000,227880000,12151,4050,8101,4050,0,1,4052,514317

168,4450,5400,700,3780000,2,35606,8903,1,247400000,247400000,13351,4450,8901,4450,0,1,4452,4109259
168,4450,5400,700,3780000,2,35606,8903,1,247400000,247400000,13351,4450,8901,4450,0,1,4452,531074
168,4450,5400,700,3780000,2,35606,8903,1,247400000,247400000,13351,4450,8901,4450,0,1,4452,518002
168,4450,5400,700,3780000,2,35606,8903,1,247400000,247400000,13351,4450,8901,4450,0,1,4452,540098
168,4450,5400,700,3780000,2,35606,8903,1,247400000,247400000,13351,4450,8901,4450,0,1,4452,527254
168,4450,5400,700,3780000,2,35606,8903,1,247400000,247400000,13351,4450,8901,4450,0,1,4452,564086
168,4450,5400,700,3780000,2,35606,8903,1,247400000,247400000,13351,4450,8901,4450,0,1,4452,565053

168,4850,5400,700,3780000,2,38806,9703,1,266920000,266920000,14551,4850,9701,4850,0,1,4852,4447740
168,4850,5400,700,3780000,2,38806,9703,1,266920000,266920000,14551,4850,9701,4850,0,1,4852,568151
168,4850,5400,700,3780000,2,38806,9703,1,266920000,266920000,14551,4850,9701,4850,0,1,4852,558428
168,4850,5400,700,3780000,2,38806,9703,1,266920000,266920000,14551,4850,9701,4850,0,1,4852,570868
168,4850,5400,700,3780000,2,38806,9703,1,266920000,266920000,14551,4850,9701,4850,0,1,4852,565383
168,4850,5400,700,3780000,2,38806,9703,1,266920000,266920000,14551,4850,9701,4850,0,1,4852,595729
168,4850,5400,700,3780000,2,38806,9703,1,266920000,266920000,14551,4850,9701,4850,0,1,4852,596691

168,5250,5400,700,3780000,2,42006,10503,1,286440000,286440000,15751,5250,10501,5250,0,1,5252,4948741
168,5250,5400,700,3780000,2,42006,10503,1,286440000,286440000,15751,5250,10501,5250,0,1,5252,641547
168,5250,5400,700,3780000,2,42006,10503,1,286440000,286440000,15751,5250,10501,5250,0,1,5252,646569
168,5250,5400,700,3780000,2,42006,10503,1,286440000,286440000,15751,5250,10501,5250,0,1,5252,629350
168,5250,5400,700,3780000,2,42006,10503,1,286440000,286440000,15751,5250,10501,5250,0,1,5252,655022
168,5250,5400,700,3780000,2,42006,10503,1,286440000,286440000,15751,5250,10501,5250,0,1,5252,665699
168,5250,5400,700,3780000,2,42006,10503,1,286440000,286440000,15751,5250,10501,5250,0,1,5252,668236

168,5650,5400,700,3780000,2,45206,11303,1,305960000,305960000,16951,5650,11301,5650,0,1,5652,5299922
168,5650,5400,700,3780000,2,45206,11303,1,305960000,305960000,16951,5650,11301,5650,0,1,5652,708265
168,5650,5400,700,3780000,2,45206,11303,1,305960000,305960000,16951,5650,11301,5650,0,1,5652,713726
168,5650,5400,700,3780000,2,45206,11303,1,305960000,305960000,16951,5650,11301,5650,0,1,5652,676522
168,5650,5400,700,3780000,2,45206,11303,1,305960000,305960000,16951,5650,11301,5650,0,1,5652,670185
168,5650,5400,700,3780000,2,45206,11303,1,305960000,305960000,16951,5650,11301,5650,0,1,5652,719406
168,5650,5400,700,3780000,2,45206,11303,1,305960000,305960000,16951,5650,11301,5650,0,1,5652,716856

168,6050,5400,700,3780000,2,48406,12103,1,325480000,325480000,18151,6050,12101,6050,0,1,6052,5599002
168,6050,5400,700,3780000,2,48406,12103,1,325480000,325480000,18151,6050,12101,6050,0,1,6052,711674
168,6050,5400,700,3780000,2,48406,12103,1,325480000,325480000,18151,6050,12101,6050,0,1,6052,705173
168,6050,5400,700,3780000,2,48406,12103,1,325480000,325480000,18151,6050,12101,6050,0,1,6052,708747
168,6050,5400,700,3780000,2,48406,12103,1,325480000,325480000,18151,6050,12101,6050,0,1,6052,714480
168,6050,5400,700,3780000,2,48406,12103,1,325480000,325480000,18151,6050,12101,6050,0,1,6052,728219
168,6050,5400,700,3780000,2,48406,12103,1,325480000,325480000,18151,6050,12101,6050,0,1,6052,729336

168,6450,5400,700,3780000,2,51606,12903,1,345000000,345000000,19351,6450,12901,6450,0,1,6452,6220093
168,6450,5400,700,3780000,2,51606,12903,1,345000000,345000000,19351,6450,12901,6450,0,1,6452,756786
168,6450,5400,700,3780000,2,51606,12903,1,345000000,345000000,19351,6450,12901,6450,0,1,6452,753942
168,6450,5400,700,3780000,2,51606,12903,1,345000000,345000000,19351,6450,12901,6450,0,1,6452,759474
168,6450,5400,700,3780000,2,51606,12903,1,345000000,345000000,19351,6450,12901,6450,0,1,6452,762752
168,6450,5400,700,3780000,2,51606,12903,1,345000000,345000000,19351,6450,12901,6450,0,1,6452,771182
168,6450,5400,700,3780000,2,51606,12903,1,345000000,345000000,19351,6450,12901,6450,0,1,6452,770050

168,6850,5400,700,3780000,2,54806,13703,1,364520000,364520000,20551,6850,13701,6850,0,1,6852,6425686
168,6850,5400,700,3780000,2,54806,13703,1,364520000,364520000,20551,6850,13701,6850,0,1,6852,807691
168,6850,5400,700,3780000,2,54806,13703,1,364520000,364520000,20551,6850,13701,6850,0,1,6852,804395
168,6850,5400,700,3780000,2,54806,13703,1,364520000,364520000,20551,6850,13701,6850,0,1,6852,810871
168,6850,5400,700,3780000,2,54806,13703,1,364520000,364520000,20551,6850,13701,6850,0,1,6852,813649
168,6850,5400,700,3780000,2,54806,13703,1,364520000,364520000,20551,6850,13701,6850,0,1,6852,817885
168,6850,5400,700,3780000,2,54806,13703,1,364520000,364520000,20551,6850,13701,6850,0,1,6852,816690

168,50,5400,300,1620000,2,406,103,1,15240000,15240000,151,50,101,50,0,1,52,16866
168,50,5400,300,1620000,2,406,103,1,15240000,15240000,151,50,101,50,0,1,52,29750
168,50,5400,300,1620000,2,406,103,1,15240000,15240000,151,50,101,50,0,1,52,32515
168,50,5400,300,1620000,2,406,103,1,15240000,15240000,151,50,101,50,0,1,52,25154
168,50,5400,300,1620000,2,406,103,1,15240000,15240000,151,50,101,50,0,1,52,31029
168,50,5400,300,1620000,2,406,103,1,15240000,15240000,151,50,101,50,0,1,52,34823
168,50,5400,300,1620000,2,406,103,1,15240000,15240000,151,50,101,50,0,1,52,34338

168,450,5400,300,1620000,2,3606,903,1,33480000,33480000,1351,450,901,450,0,1,452,155162
168,450,5400,300,1620000,2,3606,903,1,33480000,33480000,1351,450,901,450,0,1,452,51227
168,450,5400,300,1620000,2,3606,903,1,33480000,33480000,1351,450,901,450,0,1,452,52172
168,450,5400,300,1620000,2,3606,903,1,33480000,33480000,1351,450,901,450,0,1,452,51632
168,450,5400,300,1620000,2,3606,903,1,33480000,33480000,1351,450,901,450,0,1,452,48588
168,450,5400,300,1620000,2,3606,903,1,33480000,33480000,1351,450,901,450,0,1,452,60181
168,450,5400,300,1620000,2,3606,903,1,33480000,33480000,1351,450,901,450,0,1,452,59609

168,850,5400,300,1620000,2,6806,1703,1,51720000,51720000,2551,850,1701,850,0,1,852,320961
168,850,5400,300,1620000,2,6806,1703,1,51720000,51720000,2551,850,1701,850,0,1,852,76204
168,850,5400,300,1620000,2,6806,1703,1,51720000,51720000,2551,850,1701,850,0,1,852,77163
168,850,5400,300,1620000,2,6806,1703,1,51720000,51720000,2551,850,1701,850,0,1,852,76778
168,850,5400,300,1620000,2,6806,1703,1,51720000,51720000,2551,850,1701,850,0,1,852,72940
168,850,5400,300,1620000,2,6806,1703,1,51720000,51720000,2551,850,1701,850,0,1,852,91020
168,850,5400,300,1620000,2,6806,1703,1,51720000,51720000,2551,850,1701,850,0,1,852,89115

168,1250,5400,300,1620000,2,10006,2503,1,69960000,69960000,3751,1250,2501,1250,0,1,1252,492048
168,1250,5400,300,1620000,2,10006,2503,1,69960000,69960000,3751,1250,2501,1250,0,1,1252,104235
168,1250,5400,300,1620000,2,10006,2503,1,69960000,69960000,3751,1250,2501,1250,0,1,1252,103369
168,1250,5400,300,1620000,2,10006,2503,1,69960000,69960000,3751,1250,2501,1250,0,1,1252,98326
168,1250,5400,300,1620000,2,10006,2503,1,69960000,69960000,3751,1250,2501,1250,0,1,1252,102502
168,1250,5400,300,1620000,2,10006,2503,1,69960000,69960000,3751,1250,2501,1250,0,1,1252,120200
168,1250,5400,300,1620000,2,10006,2503,1,69960000,69960000,3751,1250,2501,1250,0,1,1252,121087

168,1650,5400,300,1620000,2,13206,3303,1,88200000,88200000,4951,1650,3301,1650,0,1,1652,638351
168,1650,5400,300,1620000,2,13206,3303,1,88200000,88200000,4951,1650,3301,1650,0,1,1652,123762
168,1650,5400,300,1620000,2,13206,3303,1,88200000,88200000,4951,1650,3301,1650,0,1,1652,122382
168,1650,5400,300,1620000,2,13206,3303,1,88200000,88200000,4951,1650,3301,1650,0,1,1652,124927
168,1650,5400,300,1620000,2,13206,3303,1,88200000,88200000,4951,1650,3301,1650,0,1,1652,124433
168,1650,5400,300,1620000,2,13206,3303,1,88200000,88200000,4951,1650,3301,1650,0,1,1652,176948
168,1650,5400,300,1620000,2,13206,3303,1,88200000,88200000,4951,1650,3301,1650,0,1,1652,177919

168,2050,5400,300,1620000,2,16406,4103,1,106440000,106440000,6151,2050,4101,2050,0,1,2052,835626
168,2050,5400,300,1620000,2,16406,4103,1,106440000,106440000,6151,2050,4101,2050,0,1,2052,150555
168,2050,5400,300,1620000,2,16406,4103,1,106440000,106440000,6151,2050,4101,2050,0,1,2052,149828
168,2050,5400,300,1620000,2,16406,4103,1,106440000,106440000,6151,2050,4101,2050,0,1,2052,151135
168,2050,5400,300,1620000,2,16406,4103,1,106440000,106440000,6151,2050,4101,2050,0,1,2052,149065
168,2050,5400,300,1620000,2,16406,4103,1,106440000,106440000,6151,2050,4101,2050,0,1,2052,208568
168,2050,5400,300,1620000,2,16406,4103,1,106440000,106440000,6151,2050,4101,2050,0,1,2052,207889

168,2450,5400,300,1620000,2,19606,4903,1,124680000,124680000,7351,2450,4901,2450,0,1,2452,956782
168,2450,5400,300,1620000,2,19606,4903,1,124680000,124680000,7351,2450,4901,2450,0,1,2452,173279
168,2450,5400,300,1620000,2,19606,4903,1,124680000,124680000,7351,2450,4901,2450,0,1,2452,174803
168,2450,5400,300,1620000,2,19606,4903,1,124680000,124680000,7351,2450,4901,2450,0,1,2452,175602
168,2450,5400,300,1620000,2,19606,4903,1,124680000,124680000,7351,2450,4901,2450,0,1,2452,176256
168,2450,5400,300,1620000,2,19606,4903,1,124680000,124680000,7351,2450,4901,2450,0,1,2452,218065
168,2450,5400,300,1620000,2,19606,4903,1,124680000,124680000,7351,2450,4901,2450,0,1,2452,217335

168,2850,5400,300,1620000,2,22806,5703,1,142920000,142920000,8551,2850,5701,2850,0,1,2852,1179519
168,2850,5400,300,1620000,2,22806,5703,1,142920000,142920000,8551,2850,5701,2850,0,1,2852,203885
168,2850,5400,300,1620000,2,22806,5703,1,142920000,142920000,8551,2850,5701,2850,0,1,2852,204740
168,2850,5400,300,1620000,2,22806,5703,1,142920000,142920000,8551,2850,5701,2850,0,1,2852,206761
168,2850,5400,300,1620000,2,22806,5703,1,142920000,142920000,8551,2850,5701,2850,0,1,2852,201256
168,2850,5400,300,1620000,2,22806,5703,1,142920000,142920000,8551,2850,5701,2850,0,1,2852,245488
168,2850,5400,300,1620000,2,22806,5703,1,142920000,142920000,8551,2850,5701,2850,0,1,2852,244708

168,3250,5400,300,1620000,2,26006,6503,1,161160000,161160000,9751,3250,6501,3250,0,1,3252,1331302
168,3250,5400,300,1620000,2,26006,6503,1,161160000,161160000,9751,3250,6501,3250,0,1,3252,231367
168,3250,5400,300,1620000,2,26006,6503,1,161160000,161160000,9751,3250,6501,3250,0,1,3252,229627
168,3250,5400,300,1620000,2,26006,6503,1,161160000,161160000,9751,3250,6501,3250,0,1,3252,232385
168,3250,5400,300,1620000,2,26006,6503,1,161160000,161160000,9751,3250,6501,3250,0,1,3252,228494
168,3250,5400,300,1620000,2,26006,6503,1,161160000,161160000,9751,3250,6501,3250,0,1,3252,272018
168,3250,5400,300,1620000,2,26006,6503,1,161160000,161160000,9751,3250,6501,3250,0,1,3252,271246

168,3650,5400,300,1620000,2,29206,7303,1,179400000,179400000,10951,3650,7301,3650,0,1,3652,1461843
168,3650,5400,300,1620000,2,29206,7303,1,179400000,179400000,10951,3650,7301,3650,0,1,3652,253281
168,3650,5400,300,1620000,2,29206,7303,1,179400000,179400000,10951,3650,7301,3650,0,1,3652,251034
168,3650,5400,300,1620000,2,29206,7303,1,179400000,179400000,10951,3650,7301,3650,0,1,3652,254378
168,3650,5400,300,1620000,2,29206,7303,1,179400000,179400000,10951,3650,7301,3650,0,1,3652,252382
168,3650,5400,300,1620000,2,29206,7303,1,179400000,179400000,10951,3650,7301,3650,0,1,3652,290825
168,3650,5400,300,1620000,2,29206,7303,1,179400000,179400000,10951,3650,7301,3650,0,1,3652,291619

168,4050,5400,300,1620000,2,32406,8103,1,197640000,197640000,12151,4050,8101,4050,0,1,4052,1567351
168,4050,5400,300,1620000,2,32406,8103,1,197640000,197640000,12151,4050,8101,4050,0,1,4052,280523
168,4050,5400,300,1620000,2,32406,8103,1,197640000,197640000,12151,4050,8101,4050,0,1,4052,281508
168,4050,5400,300,1620000,2,32406,8103,1,197640000,197640000,12151,4050,8101,4050,0,1,4052,278496
168,4050,5400,300,1620000,2,32406,8103,1,197640000,197640000,12151,4050,8101,4050,0,1,4052,279488
168,4050,5400,300,1620000,2,32406,8103,1,197640000,197640000,12151,4050,8101,4050,0,1,4052,313130
168,4050,5400,300,1620000,2,32406,8103,1,197640000,197640000,12151,4050,8101,4050,0,1,4052,313963

168,4450,5400,300,1620000,2,35606,8903,1,215880000,215880000,13351,4450,8901,4450,0,1,4452,1725360
168,4450,5400,300,1620000,2,35606,8903,1,215880000,215880000,13351,4450,8901,4450,0,1,4452,307710
168,4450,5400,300,1620000,2,35606,8903,1,215880000,215880000,13351,4450,8901,4450,0,1,4452,305527
168,4450,5400,300,1620000,2,35606,8903,1,215880000,215880000,13351,4450,8901,4450,0,1,4452,310208
168,4450,5400,300,1620000,2,35606,8903,1,215880000,215880000,13351,4450,8901,4450,0,1,4452,312587
168,4450,5400,300,1620000,2,35606,8903,1,215880000,215880000,13351,4450,8901,4450,0,1,4452,338509
168,4450,5400,300,1620000,2,35606,8903,1,215880000,215880000,13351,4450,8901,4450,0,1,4452,339410

168,4850,5400,300,1620000,2,38806,9703,1,234120000,234120000,14551,4850,9701,4850,0,1,4852,1917831
168,4850,5400,300,1620000,2,38806,9703,1,234120000,234120000,14551,4850,9701,4850,0,1,4852,344499
168,4850,5400,300,1620000,2,38806,9703,1,234120000,234120000,14551,4850,9701,4850,0,1,4852,336010
168,4850,5400,300,1620000,2,38806,9703,1,234120000,234120000,14551,4850,9701,4850,0,1,4852,341824
168,4850,5400,300,1620000,2,38806,9703,1,234120000,234120000,14551,4850,9701,4850,0,1,4852,338435
168,4850,5400,300,1620000,2,38806,9703,1,234120000,234120000,14551,4850,9701,4850,0,1,4852,367280
168,4850,5400,300,1620000,2,38806,9703,1,234120000,234120000,14551,4850,9701,4850,0,1,4852,366362

168,5250,5400,300,1620000,2,42006,10503,1,252360000,252360000,15751,5250,10501,5250,0,1,5252,2064242
168,5250,5400,300,1620000,2,42006,10503,1,252360000,252360000,15751,5250,10501,5250,0,1,5252,354107
168,5250,5400,300,1620000,2,42006,10503,1,252360000,252360000,15751,5250,10501,5250,0,1,5252,350534
168,5250,5400,300,1620000,2,42006,10503,1,252360000,252360000,15751,5250,10501,5250,0,1,5252,351674
168,5250,5400,300,1620000,2,42006,10503,1,252360000,252360000,15751,5250,10501,5250,0,1,5252,352902
168,5250,5400,300,1620000,2,42006,10503,1,252360000,252360000,15751,5250,10501,5250,0,1,5252,398187
168,5250,5400,300,1620000,2,42006,10503,1,252360000,252360000,15751,5250,10501,5250,0,1,5252,397173

168,5650,5400,300,1620000,2,45206,11303,1,270600000,270600000,16951,5650,11301,5650,0,1,5652,2265945
168,5650,5400,300,1620000,2,45206,11303,1,270600000,270600000,16951,5650,11301,5650,0,1,5652,397786
168,5650,5400,300,1620000,2,45206,11303,1,270600000,270600000,16951,5650,11301,5650,0,1,5652,392336
168,5650,5400,300,1620000,2,45206,11303,1,270600000,270600000,16951,5650,11301,5650,0,1,5652,387805
168,5650,5400,300,1620000,2,45206,11303,1,270600000,270600000,16951,5650,11301,5650,0,1,5652,395065
168,5650,5400,300,1620000,2,45206,11303,1,270600000,270600000,16951,5650,11301,5650,0,1,5652,420792
168,5650,5400,300,1620000,2,45206,11303,1,270600000,270600000,16951,5650,11301,5650,0,1,5652,422389

168,6050,5400,300,1620000,2,48406,12103,1,288840000,288840000,18151,6050,12101,6050,0,1,6052,2375185
168,6050,5400,300,1620000,2,48406,12103,1,288840000,288840000,18151,6050,12101,6050,0,1,6052,428741
168,6050,5400,300,1620000,2,48406,12103,1,288840000,288840000,18151,6050,12101,6050,0,1,6052,425825
168,6050,5400,300,1620000,2,48406,12103,1,288840000,288840000,18151,6050,12101,6050,0,1,6052,420898
168,6050,5400,300,1620000,2,48406,12103,1,288840000,288840000,18151,6050,12101,6050,0,1,6052,434549
168,6050,5400,300,1620000,2,48406,12103,1,288840000,288840000,18151,6050,12101,6050,0,1,6052,452846
168,6050,5400,300,1620000,2,48406,12103,1,288840000,288840000,18151,6050,12101,6050,0,1,6052,451722

168,6450,5400,300,1620000,2,51606,12903,1,307080000,307080000,19351,6450,12901,6450,0,1,6452,2529058
168,6450,5400,300,1620000,2,51606,12903,1,307080000,307080000,19351,6450,12901,6450,0,1,6452,501957
168,6450,5400,300,1620000,2,51606,12903,1,307080000,307080000,19351,6450,12901,6450,0,1,6452,509140
168,6450,5400,300,1620000,2,51606,12903,1,307080000,307080000,19351,6450,12901,6450,0,1,6452,471591
168,6450,5400,300,1620000,2,51606,12903,1,307080000,307080000,19351,6450,12901,6450,0,1,6452,488962
168,6450,5400,300,1620000,2,51606,12903,1,307080000,307080000,19351,6450,12901,6450,0,1,6452,516972
168,6450,5400,300,1620000,2,51606,12903,1,307080000,307080000,19351,6450,12901,6450,0,1,6452,515243

168,6850,5400,300,1620000,2,54806,13703,1,325320000,325320000,20551,6850,13701,6850,0,1,6852,2761066
168,6850,5400,300,1620000,2,54806,13703,1,325320000,325320000,20551,6850,13701,6850,0,1,6852,472105
168,6850,5400,300,1620000,2,54806,13703,1,325320000,325320000,20551,6850,13701,6850,0,1,6852,484222
168,6850,5400,300,1620000,2,54806,13703,1,325320000,325320000,20551,6850,13701,6850,0,1,6852,477742
168,6850,5400,300,1620000,2,54806,13703,1,325320000,325320000,20551,6850,13701,6850,0,1,6852,480999
168,6850,5400,300,1620000,2,54806,13703,1,325320000,325320000,20551,6850,13701,6850,0,1,6852,496396
168,6850,5400,300,1620000,2,54806,13703,1,325320000,325320000,20551,6850,13701,6850,0,1,6852,497566

168,50,5000,7100,35500000,2,406,103,1,288840000,288840000,151,50,101,50,0,1,52,412957
168,50,5000,7100,35500000,2,406,103,1,288840000,288840000,151,50,101,50,0,1,52,354170
168,50,5000,7100,35500000,2,406,103,1,288840000,288840000,151,50,101,50,0,1,52,352906
168,50,5000,7100,35500000,2,406,103,1,288840000,288840000,151,50,101,50,0,1,52,324041
168,50,5000,7100,35500000,2,406,103,1,288840000,288840000,151,50,101,50,0,1,52,355605
168,50,5000,7100,35500000,2,406,103,1,288840000,288840000,151,50,101,50,0,1,52,367291
168,50,5000,7100,35500000,2,406,103,1,288840000,288840000,151,50,101,50,0,1,52,367697

168,450,5000,7100,35500000,2,3606,903,1,327560000,327560000,1351,450,901,450,0,1,452,3855268
168,450,5000,7100,35500000,2,3606,903,1,327560000,327560000,1351,450,901,450,0,1,452,658248
168,450,5000,7100,35500000,2,3606,903,1,327560000,327560000,1351,450,901,450,0,1,452,656092
168,450,5000,7100,35500000,2,3606,903,1,327560000,327560000,1351,450,901,450,0,1,452,657642
168,450,5000,7100,35500000,2,3606,903,1,327560000,327560000,1351,450,901,450,0,1,452,657997
168,450,5000,7100,35500000,2,3606,903,1,327560000,327560000,1351,450,901,450,0,1,452,661082
168,450,5000,7100,35500000,2,3606,903,1,327560000,327560000,1351,450,901,450,0,1,452,661504

168,850,5000,7100,35500000,2,6806,1703,1,366280000,366280000,2551,850,1701,850,0,1,852,8168028
168,850,5000,7100,35500000,2,6806,1703,1,366280000,366280000,2551,850,1701,850,0,1,852,975063
168,850,5000,7100,35500000,2,6806,1703,1,366280000,366280000,2551,850,1701,850,0,1,852,974125
168,850,5000,7100,35500000,2,6806,1703,1,366280000,366280000,2551,850,1701,850,0,1,852,975911
168,850,5000,7100,35500000,2,6806,1703,1,366280000,366280000,2551,850,1701,850,0,1,852,975569
168,850,5000,7100,35500000,2,6806,1703,1,366280000,366280000,2551,850,1701,850,0,1,852,964876
168,850,5000,7100,35500000,2,6806,1703,1,366280000,366280000,2551,850,1701,850,0,1,852,965774

168,1250,5000,7100,35500000,2,10006,2503,1,405000000,405000000,3751,1250,2501,1250,0,1,1252,12559905
168,1250,5000,7100,35500000,2,10006,2503,1,405000000,405000000,3751,1250,2501,1250,0,1,1252,1268712
168,1250,5000,7100,35500000,2,10006,2503,1,405000000,405000000,3751,1250,2501,1250,0,1,1252,1275332
168,1250,5000,7100,35500000,2,10006,2503,1,405000000,405000000,3751,1250,2501,1250,0,1,1252,1258318
168,1250,5000,7100,35500000,2,10006,2503,1,405000000,405000000,3751,1250,2501,1250,0,1,1252,1274689
168,1250,5000,7100,35500000,2,10006,2503,1,405000000,405000000,3751,1250,2501,1250,0,1,1252,1259254
168,1250,5000,7100,35500000,2,10006,2503,1,405000000,405000000,3751,1250,2501,1250,0,1,1252,1260183

168,1650,5000,7100,35500000,2,13206,3303,1,443720000,443720000,4951,1650,3301,1650,0,1,1652,15010219
168,1650,5000,7100,35500000,2,13206,3303,1,443720000,443720000,4951,1650,3301,1650,0,1,1652,1599820
168,1650,5000,7100,35500000,2,13206,3303,1,443720000,443720000,4951,1650,3301,1650,0,1,1652,1603567
168,1650,5000,7100,35500000,2,13206,3303,1,443720000,443720000,4951,1650,3301,1650,0,1,1652,1590508
168,1650,5000,7100,35500000,2,13206,3303,1,443720000,443720000,4951,1650,3301,1650,0,1,1652,1599050
168,1650,5000,7100,35500000,2,13206,3303,1,443720000,443720000,4951,1650,3301,1650,0,1,1652,1576431
168,1650,5000,7100,35500000,2,13206,3303,1,443720000,443720000,4951,1650,3301,1650,0,1,1652,1591750

168,2050,5000,7100,35500000,2,16406,4103,1,482440000,482440000,6151,2050,4101,2050,0,1,2052,20009942
168,2050,5000,7100,35500000,2,16406,4103,1,482440000,482440000,6151,2050,4101,2050,0,1,2052,1886982
168,2050,5000,7100,35500000,2,16406,4103,1,482440000,482440000,6151,2050,4101,2050,0,1,2052,1890315
168,2050,5000,7100,35500000,2,16406,4103,1,482440000,482440000,6151,2050,4101,2050,0,1,2052,1892285
168,2050,5000,7100,35500000,2,16406,4103,1,482440000,482440000,6151,2050,4101,2050,0,1,2052,1889483
168,2050,5000,7100,35500000,2,16406,4103,1,482440000,482440000,6151,2050,4101,2050,0,1,2052,1853511
168,2050,5000,7100,35500000,2,16406,4103,1,482440000,482440000,6151,2050,4101,2050,0,1,2052,1855044

168,2450,5000,7100,35500000,2,19606,4903,1,521160000,521160000,7351,2450,4901,2450,0,1,2452,25404623
168,2450,5000,7100,35500000,2,19606,4903,1,521160000,521160000,7351,2450,4901,2450,0,1,2452,2210088
168,2450,5000,7100,35500000,2,19606,4903,1,521160000,521160000,7351,2450,4901,2450,0,1,2452,2211116
168,2450,5000,7100,35500000,2,19606,4903,1,521160000,521160000,7351,2450,4901,2450,0,1,2452,2190012
168,2450,5000,7100,35500000,2,19606,4903,1,521160000,521160000,7351,2450,4901,2450,0,1,2452,2208657
168,2450,5000,7100,35500000,2,19606,4903,1,521160000,521160000,7351,2450,4901,2450,0,1,2452,2177492
168,2450,5000,7100,35500000,2,19606,4903,1,521160000,521160000,7351,2450,4901,2450,0,1,2452,2176002

168,2850,5000,7100,35500000,2,22806,5703,1,559880000,559880000,8551,2850,5701,2850,0,1,2852,29659949
168,2850,5000,7100,35500000,2,22806,5703,1,559880000,559880000,8551,2850,5701,2850,0,1,2852,2498369
168,2850,5000,7100,35500000,2,22806,5703,1,559880000,559880000,8551,2850,5701,2850,0,1,2852,2496787
168,2850,5000,7100,35500000,2,22806,5703,1,559880000,559880000,8551,2850,5701,2850,0,1,2852,2511747
168,2850,5000,7100,35500000,2,22806,5703,1,559880000,559880000,8551,2850,5701,2850,0,1,2852,2507410
168,2850,5000,7100,35500000,2,22806,5703,1,559880000,559880000,8551,2850,5701,2850,0,1,2852,2453939
168,2850,5000,7100,35500000,2,22806,5703,1,559880000,559880000,8551,2850,5701,2850,0,1,2852,2455670

168,3250,5000,7100,35500000,2,26006,6503,1,598600000,598600000,9751,3250,6501,3250,0,1,3252,33469536
168,3250,5000,7100,35500000,2,26006,6503,1,598600000,598600000,9751,3250,6501,3250,0,1,3252,2840466
168,3250,5000,7100,35500000,2,26006,6503,1,598600000,598600000,9751,3250,6501,3250,0,1,3252,2842546
168,3250,5000,7100,35500000,2,26006,6503,1,598600000,598600000,9751,3250,6501,3250,0,1,3252,2845209
168,3250,5000,7100,35500000,2,26006,6503,1,598600000,598600000,9751,3250,6501,3250,0,1,3252,2818164
168,3250,5000,7100,35500000,2,26006,6503,1,598600000,598600000,9751,3250,6501,3250,0,1,3252,2773149
168,3250,5000,7100,35500000,2,26006,6503,1,598600000,598600000,9751,3250,6501,3250,0,1,3252,2775069

