168,50,3600,5100,18360000,2,406,103,1,150360000,150360000,151,50,101,50,0,1,52,211928
168,50,3600,5100,18360000,2,406,103,1,150360000,150360000,151,50,101,50,0,1,52,226935
168,50,3600,5100,18360000,2,406,103,1,150360000,150360000,151,50,101,50,0,1,52,226611
168,50,3600,5100,18360000,2,406,103,1,150360000,150360000,151,50,101,50,0,1,52,227102
168,50,3600,5100,18360000,2,406,103,1,150360000,150360000,151,50,101,50,0,1,52,227286
168,50,3600,5100,18360000,2,406,103,1,150360000,150360000,151,50,101,50,0,1,52,226333
168,50,3600,5100,18360000,2,406,103,1,150360000,150360000,151,50,101,50,0,1,52,226773

168,450,3600,5100,18360000,2,3606,903,1,178200000,178200000,1351,450,901,450,0,1,452,2044049
168,450,3600,5100,18360000,2,3606,903,1,178200000,178200000,1351,450,901,450,0,1,452,379033
168,450,3600,5100,18360000,2,3606,903,1,178200000,178200000,1351,450,901,450,0,1,452,380514
168,450,3600,5100,18360000,2,3606,903,1,178200000,178200000,1351,450,901,450,0,1,452,374233
168,450,3600,5100,18360000,2,3606,903,1,178200000,178200000,1351,450,901,450,0,1,452,340815
168,450,3600,5100,18360000,2,3606,903,1,178200000,178200000,1351,450,901,450,0,1,452,379820
168,450,3600,5100,18360000,2,3606,903,1,178200000,178200000,1351,450,901,450,0,1,452,381435

168,850,3600,5100,18360000,2,6806,1703,1,206040000,206040000,2551,850,1701,850,0,1,852,4047650
168,850,3600,5100,18360000,2,6806,1703,1,206040000,206040000,2551,850,1701,850,0,1,852,548977
168,850,3600,5100,18360000,2,6806,1703,1,206040000,206040000,2551,850,1701,850,0,1,852,546963
168,850,3600,5100,18360000,2,6806,1703,1,206040000,206040000,2551,850,1701,850,0,1,852,552627
168,850,3600,5100,18360000,2,6806,1703,1,206040000,206040000,2551,850,1701,850,0,1,852,553036
168,850,3600,5100,18360000,2,6806,1703,1,206040000,206040000,2551,850,1701,850,0,1,852,553476
168,850,3600,5100,18360000,2,6806,1703,1,206040000,206040000,2551,850,1701,850,0,1,852,551524

168,1250,3600,5100,18360000,2,10006,2503,1,233880000,233880000,3751,1250,2501,1250,0,1,1252,6460586
168,1250,3600,5100,18360000,2,10006,2503,1,233880000,233880000,3751,1250,2501,1250,0,1,1252,638555
168,1250,3600,5100,18360000,2,10006,2503,1,233880000,233880000,3751,1250,2501,1250,0,1,1252,641265
168,1250,3600,5100,18360000,2,10006,2503,1,233880000,233880000,3751,1250,2501,1250,0,1,1252,640648
168,1250,3600,5100,18360000,2,10006,2503,1,233880000,233880000,3751,1250,2501,1250,0,1,1252,639683
168,1250,3600,5100,18360000,2,10006,2503,1,233880000,233880000,3751,1250,2501,1250,0,1,1252,669118
168,1250,3600,5100,18360000,2,10006,2503,1,233880000,233880000,3751,1250,2501,1250,0,1,1252,669584

168,1650,3600,5100,18360000,2,13206,3303,1,261720000,261720000,4951,1650,3301,1650,0,1,1652,8672832
168,1650,3600,5100,18360000,2,13206,3303,1,261720000,261720000,4951,1650,3301,1650,0,1,1652,789283
168,1650,3600,5100,18360000,2,13206,3303,1,261720000,261720000,4951,1650,3301,1650,0,1,1652,790488
168,1650,3600,5100,18360000,2,13206,3303,1,261720000,261720000,4951,1650,3301,1650,0,1,1652,790117
168,1650,3600,5100,18360000,2,13206,3303,1,261720000,261720000,4951,1650,3301,1650,0,1,1652,789777
168,1650,3600,5100,18360000,2,13206,3303,1,261720000,261720000,4951,1650,3301,1650,0,1,1652,846731
168,1650,3600,5100,18360000,2,13206,3303,1,261720000,261720000,4951,1650,3301,1650,0,1,1652,847229

168,2050,3600,5100,18360000,2,16406,4103,1,289560000,289560000,6151,2050,4101,2050,0,1,2052,11075719
168,2050,3600,5100,18360000,2,16406,4103,1,289560000,289560000,6151,2050,4101,2050,0,1,2052,954770
168,2050,3600,5100,18360000,2,16406,4103,1,289560000,289560000,6151,2050,4101,2050,0,1,2052,955160
168,2050,3600,5100,18360000,2,16406,4103,1,289560000,289560000,6151,2050,4101,2050,0,1,2052,955583
168,2050,3600,5100,18360000,2,16406,4103,1,289560000,289560000,6151,2050,4101,2050,0,1,2052,954249
168,2050,3600,5100,18360000,2,16406,4103,1,289560000,289560000,6151,2050,4101,2050,0,1,2052,1005721
168,2050,3600,5100,18360000,2,16406,4103,1,289560000,289560000,6151,2050,4101,2050,0,1,2052,1005192

168,2450,3600,5100,18360000,2,19606,4903,1,317400000,317400000,7351,2450,4901,2450,0,1,2452,13175284
168,2450,3600,5100,18360000,2,19606,4903,1,317400000,317400000,7351,2450,4901,2450,0,1,2452,1166263
168,2450,3600,5100,18360000,2,19606,4903,1,317400000,317400000,7351,2450,4901,2450,0,1,2452,1168675
168,2450,3600,5100,18360000,2,19606,4903,1,317400000,317400000,7351,2450,4901,2450,0,1,2452,1170456
168,2450,3600,5100,18360000,2,19606,4903,1,317400000,317400000,7351,2450,4901,2450,0,1,2452,1162307
168,2450,3600,5100,18360000,2,19606,4903,1,317400000,317400000,7351,2450,4901,2450,0,1,2452,1202291
168,2450,3600,5100,18360000,2,19606,4903,1,317400000,317400000,7351,2450,4901,2450,0,1,2452,1198028

168,2850,3600,5100,18360000,2,22806,5703,1,345240000,345240000,8551,2850,5701,2850,0,1,2852,15609395
168,2850,3600,5100,18360000,2,22806,5703,1,345240000,345240000,8551,2850,5701,2850,0,1,2852,1322851
168,2850,3600,5100,18360000,2,22806,5703,1,345240000,345240000,8551,2850,5701,2850,0,1,2852,1321239
168,2850,3600,5100,18360000,2,22806,5703,1,345240000,345240000,8551,2850,5701,2850,0,1,2852,1324474
168,2850,3600,5100,18360000,2,22806,5703,1,345240000,345240000,8551,2850,5701,2850,0,1,2852,1323566
168,2850,3600,5100,18360000,2,22806,5703,1,345240000,345240000,8551,2850,5701,2850,0,1,2852,1328060
168,2850,3600,5100,18360000,2,22806,5703,1,345240000,345240000,8551,2850,5701,2850,0,1,2852,1327461

168,3250,3600,5100,18360000,2,26006,6503,1,373080000,373080000,9751,3250,6501,3250,0,1,3252,17633659
168,3250,3600,5100,18360000,2,26006,6503,1,373080000,373080000,9751,3250,6501,3250,0,1,3252,1497741
168,3250,3600,5100,18360000,2,26006,6503,1,373080000,373080000,9751,3250,6501,3250,0,1,3252,1496008
168,3250,3600,5100,18360000,2,26006,6503,1,373080000,373080000,9751,3250,6501,3250,0,1,3252,1500413
168,3250,3600,5100,18360000,2,26006,6503,1,373080000,373080000,9751,3250,6501,3250,0,1,3252,1499241
168,3250,3600,5100,18360000,2,26006,6503,1,373080000,373080000,9751,3250,6501,3250,0,1,3252,1506375
168,3250,3600,5100,18360000,2,26006,6503,1,373080000,373080000,9751,3250,6501,3250,0,1,3252,1505758

168,3650,3600,5100,18360000,2,29206,7303,1,400920000,400920000,10951,3650,7301,3650,0,1,3652,20411951
168,3650,3600,5100,18360000,2,29206,7303,1,400920000,400920000,10951,3650,7301,3650,0,1,3652,1689376
168,3650,3600,5100,18360000,2,29206,7303,1,400920000,400920000,10951,3650,7301,3650,0,1,3652,1674235
168,3650,3600,5100,18360000,2,29206,7303,1,400920000,400920000,10951,3650,7301,3650,0,1,3652,1659475
168,3650,3600,5100,18360000,2,29206,7303,1,400920000,400920000,10951,3650,7301,3650,0,1,3652,1691044
168,3650,3600,5100,18360000,2,29206,7303,1,400920000,400920000,10951,3650,7301,3650,0,1,3652,1694402
168,3650,3600,5100,18360000,2,29206,7303,1,400920000,400920000,10951,3650,7301,3650,0,1,3652,1696037

168,4050,3600,5100,18360000,2,32406,8103,1,428760000,428760000,12151,4050,8101,4050,0,1,4052,22713534
168,4050,3600,5100,18360000,2,32406,8103,1,428760000,428760000,12151,4050,8101,4050,0,1,4052,1814195
168,4050,3600,5100,18360000,2,32406,8103,1,428760000,428760000,12151,4050,8101,4050,0,1,4052,1816497
168,4050,3600,5100,18360000,2,32406,8103,1,428760000,428760000,12151,4050,8101,4050,0,1,4052,1818930
168,4050,3600,5100,18360000,2,32406,8103,1,428760000,428760000,12151,4050,8101,4050,0,1,4052,1817922
168,4050,3600,5100,18360000,2,32406,8103,1,428760000,428760000,12151,4050,8101,4050,0,1,4052,1821452
168,4050,3600,5100,18360000,2,32406,8103,1,428760000,428760000,12151,4050,8101,4050,0,1,4052,1820757

168,4450,3600,5100,18360000,2,35606,8903,1,456600000,456600000,13351,4450,8901,4450,0,1,4452,24892147
168,4450,3600,5100,18360000,2,35606,8903,1,456600000,456600000,13351,4450,8901,4450,0,1,4452,2065974
168,4450,3600,5100,18360000,2,35606,8903,1,456600000,456600000,13351,4450,8901,4450,0,1,4452,2069138
168,4450,3600,5100,18360000,2,35606,8903,1,456600000,456600000,13351,4450,8901,4450,0,1,4452,2070105
168,4450,3600,5100,18360000,2,35606,8903,1,456600000,456600000,13351,4450,8901,4450,0,1,4452,2064368
168,4450,3600,5100,18360000,2,35606,8903,1,456600000,456600000,13351,4450,8901,4450,0,1,4452,2014584
168,4450,3600,5100,18360000,2,35606,8903,1,456600000,456600000,13351,4450,8901,4450,0,1,4452,2018799

168,4850,3600,5100,18360000,2,38806,9703,1,484440000,484440000,14551,4850,9701,4850,0,1,4852,26737814
168,4850,3600,5100,18360000,2,38806,9703,1,484440000,484440000,14551,4850,9701,4850,0,1,4852,2211861
168,4850,3600,5100,18360000,2,38806,9703,1,484440000,484440000,14551,4850,9701,4850,0,1,4852,2226954
168,4850,3600,5100,18360000,2,38806,9703,1,484440000,484440000,14551,4850,9701,4850,0,1,4852,2227986
168,4850,3600,5100,18360000,2,38806,9703,1,484440000,484440000,14551,4850,9701,4850,0,1,4852,2223352
168,4850,3600,5100,18360000,2,38806,9703,1,484440000,484440000,14551,4850,9701,4850,0,1,4852,2196941
168,4850,3600,5100,18360000,2,38806,9703,1,484440000,484440000,14551,4850,9701,4850,0,1,4852,2191897

168,5250,3600,5100,18360000,2,42006,10503,1,512280000,512280000,15751,5250,10501,5250,0,1,5252,30000059
168,5250,3600,5100,18360000,2,42006,10503,1,512280000,512280000,15751,5250,10501,5250,0,1,5252,2309153
168,5250,3600,5100,18360000,2,42006,10503,1,512280000,512280000,15751,5250,10501,5250,0,1,5252,2309872
168,5250,3600,5100,18360000,2,42006,10503,1,512280000,512280000,15751,5250,10501,5250,0,1,5252,2311093
168,5250,3600,5100,18360000,2,42006,10503,1,512280000,512280000,15751,5250,10501,5250,0,1,5252,2307631
168,5250,3600,5100,18360000,2,42006,10503,1,512280000,512280000,15751,5250,10501,5250,0,1,5252,2298108
168,5250,3600,5100,18360000,2,42006,10503,1,512280000,512280000,15751,5250,10501,5250,0,1,5252,2299660

168,5650,3600,5100,18360000,2,45206,11303,1,540120000,540120000,16951,5650,11301,5650,0,1,5652,31255502
168,5650,3600,5100,18360000,2,45206,11303,1,540120000,540120000,16951,5650,11301,5650,0,1,5652,2525923
168,5650,3600,5100,18360000,2,45206,11303,1,540120000,540120000,16951,5650,11301,5650,0,1,5652,2529708
168,5650,3600,5100,18360000,2,45206,11303,1,540120000,540120000,16951,5650,11301,5650,0,1,5652,2530808
168,5650,3600,5100,18360000,2,45206,11303,1,540120000,540120000,16951,5650,11301,5650,0,1,5652,2524223
168,5650,3600,5100,18360000,2,45206,11303,1,540120000,540120000,16951,5650,11301,5650,0,1,5652,2486457
168,5650,3600,5100,18360000,2,45206,11303,1,540120000,540120000,16951,5650,11301,5650,0,1,5652,2488251

168,6050,3600,5100,18360000,2,48406,12103,1,567960000,567960000,18151,6050,12101,6050,0,1,6052,35030215
168,6050,3600,5100,18360000,2,48406,12103,1,567960000,567960000,18151,6050,12101,6050,0,1,6052,2736714
168,6050,3600,5100,18360000,2,48406,12103,1,567960000,567960000,18151,6050,12101,6050,0,1,6052,2738042
168,6050,3600,5100,18360000,2,48406,12103,1,567960000,567960000,18151,6050,12101,6050,0,1,6052,2740919
168,6050,3600,5100,18360000,2,48406,12103,1,567960000,567960000,18151,6050,12101,6050,0,1,6052,2715941
168,6050,3600,5100,18360000,2,48406,12103,1,567960000,567960000,18151,6050,12101,6050,0,1,6052,2650427
168,6050,3600,5100,18360000,2,48406,12103,1,567960000,567960000,18151,6050,12101,6050,0,1,6052,2661745

168,6450,3600,5100,18360000,2,51606,12903,1,595800000,595800000,19351,6450,12901,6450,0,1,6452,37258673
168,6450,3600,5100,18360000,2,51606,12903,1,595800000,595800000,19351,6450,12901,6450,0,1,6452,2892351
168,6450,3600,5100,18360000,2,51606,12903,1,595800000,595800000,19351,6450,12901,6450,0,1,6452,2901316
168,6450,3600,5100,18360000,2,51606,12903,1,595800000,595800000,19351,6450,12901,6450,0,1,6452,2899490
168,6450,3600,5100,18360000,2,51606,12903,1,595800000,595800000,19351,6450,12901,6450,0,1,6452,2904428
168,6450,3600,5100,18360000,2,51606,12903,1,595800000,595800000,19351,6450,12901,6450,0,1,6452,2829696
168,6450,3600,5100,18360000,2,51606,12903,1,595800000,595800000,19351,6450,12901,6450,0,1,6452,2823024

168,6850,3600,5100,18360000,2,54806,13703,1,623640000,623640000,20551,6850,13701,6850,0,1,6852,39769810
168,6850,3600,5100,18360000,2,54806,13703,1,623640000,623640000,20551,6850,13701,6850,0,1,6852,3038893
168,6850,3600,5100,18360000,2,54806,13703,1,623640000,623640000,20551,6850,13701,6850,0,1,6852,3030623
168,6850,3600,5100,18360000,2,54806,13703,1,623640000,623640000,20551,6850,13701,6850,0,1,6852,3043941
168,6850,3600,5100,18360000,2,54806,13703,1,623640000,623640000,20551,6850,13701,6850,0,1,6852,3040696
168,6850,3600,5100,18360000,2,54806,13703,1,623640000,623640000,20551,6850,13701,6850,0,1,6852,2961441
168,6850,3600,5100,18360000,2,54806,13703,1,623640000,623640000,20551,6850,13701,6850,0,1,6852,2963915

168,50,3600,4700,16920000,2,406,103,1,138680000,138680000,151,50,101,50,0,1,52,195242
168,50,3600,4700,16920000,2,406,103,1,138680000,138680000,151,50,101,50,0,1,52,160182
168,50,3600,4700,16920000,2,406,103,1,138680000,138680000,151,50,101,50,0,1,52,176866
168,50,3600,4700,16920000,2,406,103,1,138680000,138680000,151,50,101,50,0,1,52,177318
168,50,3600,4700,16920000,2,406,103,1,138680000,138680000,151,50,101,50,0,1,52,176300
168,50,3600,4700,16920000,2,406,103,1,138680000,138680000,151,50,101,50,0,1,52,206825
168,50,3600,4700,16920000,2,406,103,1,138680000,138680000,151,50,101,50,0,1,52,207194

168,450,3600,4700,16920000,2,3606,903,1,165240000,165240000,1351,450,901,450,0,1,452,1798598
168,450,3600,4700,16920000,2,3606,903,1,165240000,165240000,1351,450,901,450,0,1,452,316848
168,450,3600,4700,16920000,2,3606,903,1,165240000,165240000,1351,450,901,450,0,1,452,316415
168,450,3600,4700,16920000,2,3606,903,1,165240000,165240000,1351,450,901,450,0,1,452,315611
168,450,3600,4700,16920000,2,3606,903,1,165240000,165240000,1351,450,901,450,0,1,452,314582
168,450,3600,4700,16920000,2,3606,903,1,165240000,165240000,1351,450,901,450,0,1,452,325130
168,450,3600,4700,16920000,2,3606,903,1,165240000,165240000,1351,450,901,450,0,1,452,324726

168,850,3600,4700,16920000,2,6806,1703,1,191800000,191800000,2551,850,1701,850,0,1,852,3797522
168,850,3600,4700,16920000,2,6806,1703,1,191800000,191800000,2551,850,1701,850,0,1,852,469220
168,850,3600,4700,16920000,2,6806,1703,1,191800000,191800000,2551,850,1701,850,0,1,852,467332
168,850,3600,4700,16920000,2,6806,1703,1,191800000,191800000,2551,850,1701,850,0,1,852,468674
168,850,3600,4700,16920000,2,6806,1703,1,191800000,191800000,2551,850,1701,850,0,1,852,468185
168,850,3600,4700,16920000,2,6806,1703,1,191800000,191800000,2551,850,1701,850,0,1,852,477471
168,850,3600,4700,16920000,2,6806,1703,1,191800000,191800000,2551,850,1701,850,0,1,852,477038

168,1250,3600,4700,16920000,2,10006,2503,1,218360000,218360000,3751,1250,2501,1250,0,1,1252,5773295
168,1250,3600,4700,16920000,2,10006,2503,1,218360000,218360000,3751,1250,2501,1250,0,1,1252,627137
168,1250,3600,4700,16920000,2,10006,2503,1,218360000,218360000,3751,1250,2501,1250,0,1,1252,629175
168,1250,3600,4700,16920000,2,10006,2503,1,218360000,218360000,3751,1250,2501,1250,0,1,1252,630283
168,1250,3600,4700,16920000,2,10006,2503,1,218360000,218360000,3751,1250,2501,1250,0,1,1252,627903
168,1250,3600,4700,16920000,2,10006,2503,1,218360000,218360000,3751,1250,2501,1250,0,1,1252,647433
168,1250,3600,4700,16920000,2,10006,2503,1,218360000,218360000,3751,1250,2501,1250,0,1,1252,647900

168,1650,3600,4700,16920000,2,13206,3303,1,244920000,244920000,4951,1650,3301,1650,0,1,1652,6880718
168,1650,3600,4700,16920000,2,13206,3303,1,244920000,244920000,4951,1650,3301,1650,0,1,1652,741578
168,1650,3600,4700,16920000,2,13206,3303,1,244920000,244920000,4951,1650,3301,1650,0,1,1652,739329
168,1650,3600,4700,16920000,2,13206,3303,1,244920000,244920000,4951,1650,3301,1650,0,1,1652,743076
168,1650,3600,4700,16920000,2,13206,3303,1,244920000,244920000,4951,1650,3301,1650,0,1,1652,740915
168,1650,3600,4700,16920000,2,13206,3303,1,244920000,244920000,4951,1650,3301,1650,0,1,1652,772052
168,1650,3600,4700,16920000,2,13206,3303,1,244920000,244920000,4951,1650,3301,1650,0,1,1652,771559

168,2050,3600,4700,16920000,2,16406,4103,1,271480000,271480000,6151,2050,4101,2050,0,1,2052,9100291
168,2050,3600,4700,16920000,2,16406,4103,1,271480000,271480000,6151,2050,4101,2050,0,1,2052,877918
168,2050,3600,4700,16920000,2,16406,4103,1,271480000,271480000,6151,2050,4101,2050,0,1,2052,880034
168,2050,3600,4700,16920000,2,16406,4103,1,271480000,271480000,6151,2050,4101,2050,0,1,2052,880458
168,2050,3600,4700,16920000,2,16406,4103,1,271480000,271480000,6151,2050,4101,2050,0,1,2052,879436
168,2050,3600,4700,16920000,2,16406,4103,1,271480000,271480000,6151,2050,4101,2050,0,1,2052,933264
168,2050,3600,4700,16920000,2,16406,4103,1,271480000,271480000,6151,2050,4101,2050,0,1,2052,933797

168,2450,3600,4700,16920000,2,19606,4903,1,298040000,298040000,7351,2450,4901,2450,0,1,2452,11636731
168,2450,3600,4700,16920000,2,19606,4903,1,298040000,298040000,7351,2450,4901,2450,0,1,2452,1116405
168,2450,3600,4700,16920000,2,19606,4903,1,298040000,298040000,7351,2450,4901,2450,0,1,2452,1067492
168,2450,3600,4700,16920000,2,19606,4903,1,298040000,298040000,7351,2450,4901,2450,0,1,2452,1117997
168,2450,3600,4700,16920000,2,19606,4903,1,298040000,298040000,7351,2450,4901,2450,0,1,2452,1103928
168,2450,3600,4700,16920000,2,19606,4903,1,298040000,298040000,7351,2450,4901,2450,0,1,2452,1123352
168,2450,3600,4700,16920000,2,19606,4903,1,298040000,298040000,7351,2450,4901,2450,0,1,2452,1125670

168,2850,3600,4700,16920000,2,22806,5703,1,324600000,324600000,8551,2850,5701,2850,0,1,2852,13825094
168,2850,3600,4700,16920000,2,22806,5703,1,324600000,324600000,8551,2850,5701,2850,0,1,2852,1206171
168,2850,3600,4700,16920000,2,22806,5703,1,324600000,324600000,8551,2850,5701,2850,0,1,2852,1209892
168,2850,3600,4700,16920000,2,22806,5703,1,324600000,324600000,8551,2850,5701,2850,0,1,2852,1212332
168,2850,3600,4700,16920000,2,22806,5703,1,324600000,324600000,8551,2850,5701,2850,0,1,2852,1211225
168,2850,3600,4700,16920000,2,22806,5703,1,324600000,324600000,8551,2850,5701,2850,0,1,2852,1225516
168,2850,3600,4700,16920000,2,22806,5703,1,324600000,324600000,8551,2850,5701,2850,0,1,2852,1226113

168,3250,3600,4700,16920000,2,26006,6503,1,351160000,351160000,9751,3250,6501,3250,0,1,3252,15954320
168,3250,3600,4700,16920000,2,26006,6503,1,351160000,351160000,9751,3250,6501,3250,0,1,3252,1405796
168,3250,3600,4700,16920000,2,26006,6503,1,351160000,351160000,9751,3250,6501,3250,0,1,3252,1405076
168,3250,3600,4700,16920000,2,26006,6503,1,351160000,351160000,9751,3250,6501,3250,0,1,3252,1407079
168,3250,3600,4700,16920000,2,26006,6503,1,351160000,351160000,9751,3250,6501,3250,0,1,3252,1404377
168,3250,3600,4700,16920000,2,26006,6503,1,351160000,351160000,9751,3250,6501,3250,0,1,3252,1406100
168,3250,3600,4700,16920000,2,26006,6503,1,351160000,351160000,9751,3250,6501,3250,0,1,3252,1406512

168,3650,3600,4700,16920000,2,29206,7303,1,377720000,377720000,10951,3650,7301,3650,0,1,3652,17831712
168,3650,3600,4700,16920000,2,29206,7303,1,377720000,377720000,10951,3650,7301,3650,0,1,3652,1565540
168,3650,3600,4700,16920000,2,29206,7303,1,377720000,377720000,10951,3650,7301,3650,0,1,3652,1538981
168,3650,3600,4700,16920000,2,29206,7303,1,377720000,377720000,10951,3650,7301,3650,0,1,3652,1567900
168,3650,3600,4700,16920000,2,29206,7303,1,377720000,377720000,10951,3650,7301,3650,0,1,3652,1563749
168,3650,3600,4700,16920000,2,29206,7303,1,377720000,377720000,10951,3650,7301,3650,0,1,3652,1569046
168,3650,3600,4700,16920000,2,29206,7303,1,377720000,377720000,10951,3650,7301,3650,0,1,3652,1569701

168,4050,3600,4700,16920000,2,32406,8103,1,404280000,404280000,12151,4050,8101,4050,0,1,4052,19962149
168,4050,3600,4700,16920000,2,32406,8103,1,404280000,404280000,12151,4050,8101,4050,0,1,4052,1670449
168,4050,3600,4700,16920000,2,32406,8103,1,404280000,404280000,12151,4050,8101,4050,0,1,4052,1661767
168,4050,3600,4700,16920000,2,32406,8103,1,404280000,404280000,12151,4050,8101,4050,0,1,4052,1671911
168,4050,3600,4700,16920000,2,32406,8103,1,404280000,404280000,12151,4050,8101,4050,0,1,4052,1669656
168,4050,3600,4700,16920000,2,32406,8103,1,404280000,404280000,12151,4050,8101,4050,0,1,4052,1674774
168,4050,3600,4700,16920000,2,32406,8103,1,404280000,404280000,12151,4050,8101,4050,0,1,4052,1674070

168,4450,3600,4700,16920000,2,35606,8903,1,430840000,430840000,13351,4450,8901,4450,0,1,4452,22423080
168,4450,3600,4700,16920000,2,35606,8903,1,430840000,430840000,13351,4450,8901,4450,0,1,4452,1877148
168,4450,3600,4700,16920000,2,35606,8903,1,430840000,430840000,13351,4450,8901,4450,0,1,4452,1861070
168,4450,3600,4700,16920000,2,35606,8903,1,430840000,430840000,13351,4450,8901,4450,0,1,4452,1878112
168,4450,3600,4700,16920000,2,35606,8903,1,430840000,430840000,13351,4450,8901,4450,0,1,4452,1876378
168,4450,3600,4700,16920000,2,35606,8903,1,430840000,430840000,13351,4450,8901,4450,0,1,4452,1867774
168,4450,3600,4700,16920000,2,35606,8903,1,430840000,430840000,13351,4450,8901,4450,0,1,4452,1871876

168,4850,3600,4700,16920000,2,38806,9703,1,457400000,457400000,14551,4850,9701,4850,0,1,4852,24575090
168,4850,3600,4700,16920000,2,38806,9703,1,457400000,457400000,14551,4850,9701,4850,0,1,4852,1986130
168,4850,3600,4700,16920000,2,38806,9703,1,457400000,457400000,14551,4850,9701,4850,0,1,4852,1980459
168,4850,3600,4700,16920000,2,38806,9703,1,457400000,457400000,14551,4850,9701,4850,0,1,4852,1987151
168,4850,3600,4700,16920000,2,38806,9703,1,457400000,457400000,14551,4850,9701,4850,0,1,4852,1985307
168,4850,3600,4700,16920000,2,38806,9703,1,457400000,457400000,14551,4850,9701,4850,0,1,4852,1983567
168,4850,3600,4700,16920000,2,38806,9703,1,457400000,457400000,14551,4850,9701,4850,0,1,4852,1982902

168,5250,3600,4700,16920000,2,42006,10503,1,483960000,483960000,15751,5250,10501,5250,0,1,5252,27363365
168,5250,3600,4700,16920000,2,42006,10503,1,483960000,483960000,15751,5250,10501,5250,0,1,5252,2148363
168,5250,3600,4700,16920000,2,42006,10503,1,483960000,483960000,15751,5250,10501,5250,0,1,5252,2157441
168,5250,3600,4700,16920000,2,42006,10503,1,483960000,483960000,15751,5250,10501,5250,0,1,5252,2156365
168,5250,3600,4700,16920000,2,42006,10503,1,483960000,483960000,15751,5250,10501,5250,0,1,5252,2149578
168,5250,3600,4700,16920000,2,42006,10503,1,483960000,483960000,15751,5250,10501,5250,0,1,5252,2140835
168,5250,3600,4700,16920000,2,42006,10503,1,483960000,483960000,15751,5250,10501,5250,0,1,5252,2135590

168,5650,3600,4700,16920000,2,45206,11303,1,510520000,510520000,16951,5650,11301,5650,0,1,5652,28858424
168,5650,3600,4700,16920000,2,45206,11303,1,510520000,510520000,16951,5650,11301,5650,0,1,5652,2333242
168,5650,3600,4700,16920000,2,45206,11303,1,510520000,510520000,16951,5650,11301,5650,0,1,5652,2322488
168,5650,3600,4700,16920000,2,45206,11303,1,510520000,510520000,16951,5650,11301,5650,0,1,5652,2337057
168,5650,3600,4700,16920000,2,45206,11303,1,510520000,510520000,16951,5650,11301,5650,0,1,5652,2332120
168,5650,3600,4700,16920000,2,45206,11303,1,510520000,510520000,16951,5650,11301,5650,0,1,5652,2300962
168,5650,3600,4700,16920000,2,45206,11303,1,510520000,510520000,16951,5650,11301,5650,0,1,5652,2306078

168,6050,3600,4700,16920000,2,48406,12103,1,537080000,537080000,18151,6050,12101,6050,0,1,6052,32004960
168,6050,3600,4700,16920000,2,48406,12103,1,537080000,537080000,18151,6050,12101,6050,0,1,6052,2464510
168,6050,3600,4700,16920000,2,48406,12103,1,537080000,537080000,18151,6050,12101,6050,0,1,6052,2468999
168,6050,3600,4700,16920000,2,48406,12103,1,537080000,537080000,18151,6050,12101,6050,0,1,6052,2472591
168,6050,3600,4700,16920000,2,48406,12103,1,537080000,537080000,18151,6050,12101,6050,0,1,6052,2470074
168,6050,3600,4700,16920000,2,48406,12103,1,537080000,537080000,18151,6050,12101,6050,0,1,6052,2435841
168,6050,3600,4700,16920000,2,48406,12103,1,537080000,537080000,18151,6050,12101,6050,0,1,6052,2447608

168,6450,3600,4700,16920000,2,51606,12903,1,563640000,563640000,19351,6450,12901,6450,0,1,6452,31719130
168,6450,3600,4700,16920000,2,51606,12903,1,563640000,563640000,19351,6450,12901,6450,0,1,6452,2667887
168,6450,3600,4700,16920000,2,51606,12903,1,563640000,563640000,19351,6450,12901,6450,0,1,6452,2671605
168,6450,3600,4700,16920000,2,51606,12903,1,563640000,563640000,19351,6450,12901,6450,0,1,6452,2672812
168,6450,3600,4700,16920000,2,51606,12903,1,563640000,563640000,19351,6450,12901,6450,0,1,6452,2666906
168,6450,3600,4700,16920000,2,51606,12903,1,563640000,563640000,19351,6450,12901,6450,0,1,6452,2590088
168,6450,3600,4700,16920000,2,51606,12903,1,563640000,563640000,19351,6450,12901,6450,0,1,6452,2561032

168,6850,3600,4700,16920000,2,54806,13703,1,590200000,590200000,20551,6850,13701,6850,0,1,6852,36159013
168,6850,3600,4700,16920000,2,54806,13703,1,590200000,590200000,20551,6850,13701,6850,0,1,6852,2802169
168,6850,3600,4700,16920000,2,54806,13703,1,590200000,590200000,20551,6850,13701,6850,0,1,6852,2797998
168,6850,3600,4700,16920000,2,54806,13703,1,590200000,590200000,20551,6850,13701,6850,0,1,6852,2805098
168,6850,3600,4700,16920000,2,54806,13703,1,590200000,590200000,20551,6850,13701,6850,0,1,6852,2800919
168,6850,3600,4700,16920000,2,54806,13703,1,590200000,590200000,20551,6850,13701,6850,0,1,6852,2749470
168,6850,3600,4700,16920000,2,54806,13703,1,590200000,590200000,20551,6850,13701,6850,0,1,6852,2751600

168,50,3600,4300,15480000,2,406,103,1,127000000,127000000,151,50,101,50,0,1,52,174323
168,50,3600,4300,15480000,2,406,103,1,127000000,127000000,151,50,101,50,0,1,52,150677
168,50,3600,4300,15480000,2,406,103,1,127000000,127000000,151,50,101,50,0,1,52,152414
168,50,3600,4300,15480000,2,406,103,1,127000000,127000000,151,50,101,50,0,1,52,145509
168,50,3600,4300,15480000,2,406,103,1,127000000,127000000,151,50,101,50,0,1,52,152873
168,50,3600,4300,15480000,2,406,103,1,127000000,127000000,151,50,101,50,0,1,52,190801
168,50,3600,4300,15480000,2,406,103,1,127000000,127000000,151,50,101,50,0,1,52,191276

168,450,3600,4300,15480000,2,3606,903,1,152280000,152280000,1351,450,901,450,0,1,452,1632792
168,450,3600,4300,15480000,2,3606,903,1,152280000,152280000,1351,450,901,450,0,1,452,294385
168,450,3600,4300,15480000,2,3606,903,1,152280000,152280000,1351,450,901,450,0,1,452,295178
168,450,3600,4300,15480000,2,3606,903,1,152280000,152280000,1351,450,901,450,0,1,452,295554
168,450,3600,4300,15480000,2,3606,903,1,152280000,152280000,1351,450,901,450,0,1,452,293383
168,450,3600,4300,15480000,2,3606,903,1,152280000,152280000,1351,450,901,450,0,1,452,300211
168,450,3600,4300,15480000,2,3606,903,1,152280000,152280000,1351,450,901,450,0,1,452,299806

168,850,3600,4300,15480000,2,6806,1703,1,177560000,177560000,2551,850,1701,850,0,1,852,3491017
168,850,3600,4300,15480000,2,6806,1703,1,177560000,177560000,2551,850,1701,850,0,1,852,439298
168,850,3600,4300,15480000,2,6806,1703,1,177560000,177560000,2551,850,1701,850,0,1,852,440279
168,850,3600,4300,15480000,2,6806,1703,1,177560000,177560000,2551,850,1701,850,0,1,852,437925
168,850,3600,4300,15480000,2,6806,1703,1,177560000,177560000,2551,850,1701,850,0,1,852,439833
168,850,3600,4300,15480000,2,6806,1703,1,177560000,177560000,2551,850,1701,850,0,1,852,442522
168,850,3600,4300,15480000,2,6806,1703,1,177560000,177560000,2551,850,1701,850,0,1,852,442956

168,1250,3600,4300,15480000,2,10006,2503,1,202840000,202840000,3751,1250,2501,1250,0,1,1252,5454379
168,1250,3600,4300,15480000,2,10006,2503,1,202840000,202840000,3751,1250,2501,1250,0,1,1252,570509
168,1250,3600,4300,15480000,2,10006,2503,1,202840000,202840000,3751,1250,2501,1250,0,1,1252,524147
168,1250,3600,4300,15480000,2,10006,2503,1,202840000,202840000,3751,1250,2501,1250,0,1,1252,571629
168,1250,3600,4300,15480000,2,10006,2503,1,202840000,202840000,3751,1250,2501,1250,0,1,1252,565298
168,1250,3600,4300,15480000,2,10006,2503,1,202840000,202840000,3751,1250,2501,1250,0,1,1252,578199
168,1250,3600,4300,15480000,2,10006,2503,1,202840000,202840000,3751,1250,2501,1250,0,1,1252,577730

168,1650,3600,4300,15480000,2,13206,3303,1,228120000,228120000,4951,1650,3301,1650,0,1,1652,6981776
168,1650,3600,4300,15480000,2,13206,3303,1,228120000,228120000,4951,1650,3301,1650,0,1,1652,758970
168,1650,3600,4300,15480000,2,13206,3303,1,228120000,228120000,4951,1650,3301,1650,0,1,1652,745366
168,1650,3600,4300,15480000,2,13206,3303,1,228120000,228120000,4951,1650,3301,1650,0,1,1652,760782
168,1650,3600,4300,15480000,2,13206,3303,1,228120000,228120000,4951,1650,3301,1650,0,1,1652,757516
168,1650,3600,4300,15480000,2,13206,3303,1,228120000,228120000,4951,1650,3301,1650,0,1,1652,760200
168,1650,3600,4300,15480000,2,13206,3303,1,228120000,228120000,4951,1650,3301,1650,0,1,1652,761069

168,2050,3600,4300,15480000,2,16406,4103,1,253400000,253400000,6151,2050,4101,2050,0,1,2052,9268683
168,2050,3600,4300,15480000,2,16406,4103,1,253400000,253400000,6151,2050,4101,2050,0,1,2052,862168
168,2050,3600,4300,15480000,2,16406,4103,1,253400000,253400000,6151,2050,4101,2050,0,1,2052,862813
168,2050,3600,4300,15480000,2,16406,4103,1,253400000,253400000,6151,2050,4101,2050,0,1,2052,863339
168,2050,3600,4300,15480000,2,16406,4103,1,253400000,253400000,6151,2050,4101,2050,0,1,2052,860760
168,2050,3600,4300,15480000,2,16406,4103,1,253400000,253400000,6151,2050,4101,2050,0,1,2052,863856
168,2050,3600,4300,15480000,2,16406,4103,1,253400000,253400000,6151,2050,4101,2050,0,1,2052,864389

168,2450,3600,4300,15480000,2,19606,4903,1,278680000,278680000,7351,2450,4901,2450,0,1,2452,10184305
168,2450,3600,4300,15480000,2,19606,4903,1,278680000,278680000,7351,2450,4901,2450,0,1,2452,957113
168,2450,3600,4300,15480000,2,19606,4903,1,278680000,278680000,7351,2450,4901,2450,0,1,2452,958250
168,2450,3600,4300,15480000,2,19606,4903,1,278680000,278680000,7351,2450,4901,2450,0,1,2452,959683
168,2450,3600,4300,15480000,2,19606,4903,1,278680000,278680000,7351,2450,4901,2450,0,1,2452,954330
168,2450,3600,4300,15480000,2,19606,4903,1,278680000,278680000,7351,2450,4901,2450,0,1,2452,987738
168,2450,3600,4300,15480000,2,19606,4903,1,278680000,278680000,7351,2450,4901,2450,0,1,2452,988462

168,2850,3600,4300,15480000,2,22806,5703,1,303960000,303960000,8551,2850,5701,2850,0,1,2852,13005526
168,2850,3600,4300,15480000,2,22806,5703,1,303960000,303960000,8551,2850,5701,2850,0,1,2852,1095558
168,2850,3600,4300,15480000,2,22806,5703,1,303960000,303960000,8551,2850,5701,2850,0,1,2852,1096767
168,2850,3600,4300,15480000,2,22806,5703,1,303960000,303960000,8551,2850,5701,2850,0,1,2852,1098341
168,2850,3600,4300,15480000,2,22806,5703,1,303960000,303960000,8551,2850,5701,2850,0,1,2852,1092675
168,2850,3600,4300,15480000,2,22806,5703,1,303960000,303960000,8551,2850,5701,2850,0,1,2852,1122419
168,2850,3600,4300,15480000,2,22806,5703,1,303960000,303960000,8551,2850,5701,2850,0,1,2852,1121825

168,3250,3600,4300,15480000,2,26006,6503,1,329240000,329240000,9751,3250,6501,3250,0,1,3252,14561544
168,3250,3600,4300,15480000,2,26006,6503,1,329240000,329240000,9751,3250,6501,3250,0,1,3252,1308418
168,3250,3600,4300,15480000,2,26006,6503,1,329240000,329240000,9751,3250,6501,3250,0,1,3252,1288082
168,3250,3600,4300,15480000,2,26006,6503,1,329240000,329240000,9751,3250,6501,3250,0,1,3252,1310646
168,3250,3600,4300,15480000,2,26006,6503,1,329240000,329240000,9751,3250,6501,3250,0,1,3252,1306524
168,3250,3600,4300,15480000,2,26006,6503,1,329240000,329240000,9751,3250,6501,3250,0,1,3252,1312871
168,3250,3600,4300,15480000,2,26006,6503,1,329240000,329240000,9751,3250,6501,3250,0,1,3252,1313499

168,3650,3600,4300,15480000,2,29206,7303,1,354520000,354520000,10951,3650,7301,3650,0,1,3652,16956039
168,3650,3600,4300,15480000,2,29206,7303,1,354520000,354520000,10951,3650,7301,3650,0,1,3652,1388308
168,3650,3600,4300,15480000,2,29206,7303,1,354520000,354520000,10951,3650,7301,3650,0,1,3652,1400243
168,3650,3600,4300,15480000,2,29206,7303,1,354520000,354520000,10951,3650,7301,3650,0,1,3652,1401994
168,3650,3600,4300,15480000,2,29206,7303,1,354520000,354520000,10951,3650,7301,3650,0,1,3652,1398373
168,3650,3600,4300,15480000,2,29206,7303,1,354520000,354520000,10951,3650,7301,3650,0,1,3652,1408035
168,3650,3600,4300,15480000,2,29206,7303,1,354520000,354520000,10951,3650,7301,3650,0,1,3652,1408706

168,4050,3600,4300,15480000,2,32406,8103,1,379800000,379800000,12151,4050,8101,4050,0,1,4052,18904494
168,4050,3600,4300,15480000,2,32406,8103,1,379800000,379800000,12151,4050,8101,4050,0,1,4052,1580058
168,4050,3600,4300,15480000,2,32406,8103,1,379800000,379800000,12151,4050,8101,4050,0,1,4052,1586588
168,4050,3600,4300,15480000,2,32406,8103,1,379800000,379800000,12151,4050,8101,4050,0,1,4052,1585629
168,4050,3600,4300,15480000,2,32406,8103,1,379800000,379800000,12151,4050,8101,4050,0,1,4052,1571028
168,4050,3600,4300,15480000,2,32406,8103,1,379800000,379800000,12151,4050,8101,4050,0,1,4052,1587109
168,4050,3600,4300,15480000,2,32406,8103,1,379800000,379800000,12151,4050,8101,4050,0,1,4052,1587589

168,4450,3600,4300,15480000,2,35606,8903,1,405080000,405080000,13351,4450,8901,4450,0,1,4452,20636898
168,4450,3600,4300,15480000,2,35606,8903,1,405080000,405080000,13351,4450,8901,4450,0,1,4452,1669406
168,4450,3600,4300,15480000,2,35606,8903,1,405080000,405080000,13351,4450,8901,4450,0,1,4452,1670206
168,4450,3600,4300,15480000,2,35606,8903,1,405080000,405080000,13351,4450,8901,4450,0,1,4452,1671311
168,4450,3600,4300,15480000,2,35606,8903,1,405080000,405080000,13351,4450,8901,4450,0,1,4452,1667646
168,4450,3600,4300,15480000,2,35606,8903,1,405080000,405080000,13351,4450,8901,4450,0,1,4452,1674576
168,4450,3600,4300,15480000,2,35606,8903,1,405080000,405080000,13351,4450,8901,4450,0,1,4452,1673850

168,4850,3600,4300,15480000,2,38806,9703,1,430360000,430360000,14551,4850,9701,4850,0,1,4852,23176460
168,4850,3600,4300,15480000,2,38806,9703,1,430360000,430360000,14551,4850,9701,4850,0,1,4852,1896713
168,4850,3600,4300,15480000,2,38806,9703,1,430360000,430360000,14551,4850,9701,4850,0,1,4852,1891593
168,4850,3600,4300,15480000,2,38806,9703,1,430360000,430360000,14551,4850,9701,4850,0,1,4852,1887650
168,4850,3600,4300,15480000,2,38806,9703,1,430360000,430360000,14551,4850,9701,4850,0,1,4852,1894400
168,4850,3600,4300,15480000,2,38806,9703,1,430360000,430360000,14551,4850,9701,4850,0,1,4852,1877103
168,4850,3600,4300,15480000,2,38806,9703,1,430360000,430360000,14551,4850,9701,4850,0,1,4852,1878869

168,5250,3600,4300,15480000,2,42006,10503,1,455640000,455640000,15751,5250,10501,5250,0,1,5252,25452731
168,5250,3600,4300,15480000,2,42006,10503,1,455640000,455640000,15751,5250,10501,5250,0,1,5252,1996327
168,5250,3600,4300,15480000,2,42006,10503,1,455640000,455640000,15751,5250,10501,5250,0,1,5252,1999779
168,5250,3600,4300,15480000,2,42006,10503,1,455640000,455640000,15751,5250,10501,5250,0,1,5252,2002834
168,5250,3600,4300,15480000,2,42006,10503,1,455640000,455640000,15751,5250,10501,5250,0,1,5252,2001576
168,5250,3600,4300,15480000,2,42006,10503,1,455640000,455640000,15751,5250,10501,5250,0,1,5252,1977655
168,5250,3600,4300,15480000,2,42006,10503,1,455640000,455640000,15751,5250,10501,5250,0,1,5252,1979737

168,5650,3600,4300,15480000,2,45206,11303,1,480920000,480920000,16951,5650,11301,5650,0,1,5652,26709214
168,5650,3600,4300,15480000,2,45206,11303,1,480920000,480920000,16951,5650,11301,5650,0,1,5652,2207061
168,5650,3600,4300,15480000,2,45206,11303,1,480920000,480920000,16951,5650,11301,5650,0,1,5652,2194014
168,5650,3600,4300,15480000,2,45206,11303,1,480920000,480920000,16951,5650,11301,5650,0,1,5652,2210745
168,5650,3600,4300,15480000,2,45206,11303,1,480920000,480920000,16951,5650,11301,5650,0,1,5652,2205938
168,5650,3600,4300,15480000,2,45206,11303,1,480920000,480920000,16951,5650,11301,5650,0,1,5652,2164586
168,5650,3600,4300,15480000,2,45206,11303,1,480920000,480920000,16951,5650,11301,5650,0,1,5652,2169659

168,6050,3600,4300,15480000,2,48406,12103,1,506200000,506200000,18151,6050,12101,6050,0,1,6052,28792677
168,6050,3600,4300,15480000,2,48406,12103,1,506200000,506200000,18151,6050,12101,6050,0,1,6052,2329327
168,6050,3600,4300,15480000,2,48406,12103,1,506200000,506200000,18151,6050,12101,6050,0,1,6052,2316659
168,6050,3600,4300,15480000,2,48406,12103,1,506200000,506200000,18151,6050,12101,6050,0,1,6052,2331996
168,6050,3600,4300,15480000,2,48406,12103,1,506200000,506200000,18151,6050,12101,6050,0,1,6052,2328175
168,6050,3600,4300,15480000,2,48406,12103,1,506200000,506200000,18151,6050,12101,6050,0,1,6052,2281941
168,6050,3600,4300,15480000,2,48406,12103,1,506200000,506200000,18151,6050,12101,6050,0,1,6052,2286454

168,6450,3600,4300,15480000,2,51606,12903,1,531480000,531480000,19351,6450,12901,6450,0,1,6452,29799695
168,6450,3600,4300,15480000,2,51606,12903,1,531480000,531480000,19351,6450,12901,6450,0,1,6452,2377344
168,6450,3600,4300,15480000,2,51606,12903,1,531480000,531480000,19351,6450,12901,6450,0,1,6452,2379394
168,6450,3600,4300,15480000,2,51606,12903,1,531480000,531480000,19351,6450,12901,6450,0,1,6452,2380735
168,6450,3600,4300,15480000,2,51606,12903,1,531480000,531480000,19351,6450,12901,6450,0,1,6452,2376331
168,6450,3600,4300,15480000,2,51606,12903,1,531480000,531480000,19351,6450,12901,6450,0,1,6452,2352020
168,6450,3600,4300,15480000,2,51606,12903,1,531480000,531480000,19351,6450,12901,6450,0,1,6452,2353922

168,6850,3600,4300,15480000,2,54806,13703,1,556760000,556760000,20551,6850,13701,6850,0,1,6852,31392246
168,6850,3600,4300,15480000,2,54806,13703,1,556760000,556760000,20551,6850,13701,6850,0,1,6852,2661673
168,6850,3600,4300,15480000,2,54806,13703,1,556760000,556760000,20551,6850,13701,6850,0,1,6852,2653957
168,6850,3600,4300,15480000,2,54806,13703,1,556760000,556760000,20551,6850,13701,6850,0,1,6852,2662942
168,6850,3600,4300,15480000,2,54806,13703,1,556760000,556760000,20551,6850,13701,6850,0,1,6852,2657879
168,6850,3600,4300,15480000,2,54806,13703,1,556760000,556760000,20551,6850,13701,6850,0,1,6852,2581483
168,6850,3600,4300,15480000,2,54806,13703,1,556760000,556760000,20551,6850,13701,6850,0,1,6852,2554971

168,50,3600,3900,14040000,2,406,103,1,115320000,115320000,151,50,101,50,0,1,52,156981
168,50,3600,3900,14040000,2,406,103,1,115320000,115320000,151,50,101,50,0,1,52,134045
168,50,3600,3900,14040000,2,406,103,1,115320000,115320000,151,50,101,50,0,1,52,128251
168,50,3600,3900,14040000,2,406,103,1,115320000,115320000,151,50,101,50,0,1,52,100131
168,50,3600,3900,14040000,2,406,103,1,115320000,115320000,151,50,101,50,0,1,52,131867
168,50,3600,3900,14040000,2,406,103,1,115320000,115320000,151,50,101,50,0,1,52,179376
168,50,3600,3900,14040000,2,406,103,1,115320000,115320000,151,50,101,50,0,1,52,179847

168,450,3600,3900,14040000,2,3606,903,1,139320000,139320000,1351,450,901,450,0,1,452,1442626
168,450,3600,3900,14040000,2,3606,903,1,139320000,139320000,1351,450,901,450,0,1,452,268353
168,450,3600,3900,14040000,2,3606,903,1,139320000,139320000,1351,450,901,450,0,1,452,270532
168,450,3600,3900,14040000,2,3606,903,1,139320000,139320000,1351,450,901,450,0,1,452,271552
168,450,3600,3900,14040000,2,3606,903,1,139320000,139320000,1351,450,901,450,0,1,452,272070
168,450,3600,3900,14040000,2,3606,903,1,139320000,139320000,1351,450,901,450,0,1,452,274351
168,450,3600,3900,14040000,2,3606,903,1,139320000,139320000,1351,450,901,450,0,1,452,274758

168,850,3600,3900,14040000,2,6806,1703,1,163320000,163320000,2551,850,1701,850,0,1,852,2985219
168,850,3600,3900,14040000,2,6806,1703,1,163320000,163320000,2551,850,1701,850,0,1,852,437407
168,850,3600,3900,14040000,2,6806,1703,1,163320000,163320000,2551,850,1701,850,0,1,852,436247
168,850,3600,3900,14040000,2,6806,1703,1,163320000,163320000,2551,850,1701,850,0,1,852,435823
168,850,3600,3900,14040000,2,6806,1703,1,163320000,163320000,2551,850,1701,850,0,1,852,435231
168,850,3600,3900,14040000,2,6806,1703,1,163320000,163320000,2551,850,1701,850,0,1,852,438472
168,850,3600,3900,14040000,2,6806,1703,1,163320000,163320000,2551,850,1701,850,0,1,852,439078

168,1250,3600,3900,14040000,2,10006,2503,1,187320000,187320000,3751,1250,2501,1250,0,1,1252,4772535
168,1250,3600,3900,14040000,2,10006,2503,1,187320000,187320000,3751,1250,2501,1250,0,1,1252,518266
168,1250,3600,3900,14040000,2,10006,2503,1,187320000,187320000,3751,1250,2501,1250,0,1,1252,490513
168,1250,3600,3900,14040000,2,10006,2503,1,187320000,187320000,3751,1250,2501,1250,0,1,1252,524225
168,1250,3600,3900,14040000,2,10006,2503,1,187320000,187320000,3751,1250,2501,1250,0,1,1252,523364
168,1250,3600,3900,14040000,2,10006,2503,1,187320000,187320000,3751,1250,2501,1250,0,1,1252,527524
168,1250,3600,3900,14040000,2,10006,2503,1,187320000,187320000,3751,1250,2501,1250,0,1,1252,527052

168,1650,3600,3900,14040000,2,13206,3303,1,211320000,211320000,4951,1650,3301,1650,0,1,1652,6409934
168,1650,3600,3900,14040000,2,13206,3303,1,211320000,211320000,4951,1650,3301,1650,0,1,1652,663584
168,1650,3600,3900,14040000,2,13206,3303,1,211320000,211320000,4951,1650,3301,1650,0,1,1652,667595
168,1650,3600,3900,14040000,2,13206,3303,1,211320000,211320000,4951,1650,3301,1650,0,1,1652,667965
168,1650,3600,3900,14040000,2,13206,3303,1,211320000,211320000,4951,1650,3301,1650,0,1,1652,666409
168,1650,3600,3900,14040000,2,13206,3303,1,211320000,211320000,4951,1650,3301,1650,0,1,1652,668296
168,1650,3600,3900,14040000,2,13206,3303,1,211320000,211320000,4951,1650,3301,1650,0,1,1652,669518

168,2050,3600,3900,14040000,2,16406,4103,1,235320000,235320000,6151,2050,4101,2050,0,1,2052,8246635
168,2050,3600,3900,14040000,2,16406,4103,1,235320000,235320000,6151,2050,4101,2050,0,1,2052,818432
168,2050,3600,3900,14040000,2,16406,4103,1,235320000,235320000,6151,2050,4101,2050,0,1,2052,801248
168,2050,3600,3900,14040000,2,16406,4103,1,235320000,235320000,6151,2050,4101,2050,0,1,2052,819060
168,2050,3600,3900,14040000,2,16406,4103,1,235320000,235320000,6151,2050,4101,2050,0,1,2052,815155
168,2050,3600,3900,14040000,2,16406,4103,1,235320000,235320000,6151,2050,4101,2050,0,1,2052,819382
168,2050,3600,3900,14040000,2,16406,4103,1,235320000,235320000,6151,2050,4101,2050,0,1,2052,812377

168,2450,3600,3900,14040000,2,19606,4903,1,259320000,259320000,7351,2450,4901,2450,0,1,2452,10245291
168,2450,3600,3900,14040000,2,19606,4903,1,259320000,259320000,7351,2450,4901,2450,0,1,2452,866997
168,2450,3600,3900,14040000,2,19606,4903,1,259320000,259320000,7351,2450,4901,2450,0,1,2452,865191
168,2450,3600,3900,14040000,2,19606,4903,1,259320000,259320000,7351,2450,4901,2450,0,1,2452,868494
168,2450,3600,3900,14040000,2,19606,4903,1,259320000,259320000,7351,2450,4901,2450,0,1,2452,867787
168,2450,3600,3900,14040000,2,19606,4903,1,259320000,259320000,7351,2450,4901,2450,0,1,2452,916955
168,2450,3600,3900,14040000,2,19606,4903,1,259320000,259320000,7351,2450,4901,2450,0,1,2452,917565

168,2850,3600,3900,14040000,2,22806,5703,1,283320000,283320000,8551,2850,5701,2850,0,1,2852,11290095
168,2850,3600,3900,14040000,2,22806,5703,1,283320000,283320000,8551,2850,5701,2850,0,1,2852,1012521
168,2850,3600,3900,14040000,2,22806,5703,1,283320000,283320000,8551,2850,5701,2850,0,1,2852,1016321
168,2850,3600,3900,14040000,2,22806,5703,1,283320000,283320000,8551,2850,5701,2850,0,1,2852,1017683
168,2850,3600,3900,14040000,2,22806,5703,1,283320000,283320000,8551,2850,5701,2850,0,1,2852,1015181
168,2850,3600,3900,14040000,2,22806,5703,1,283320000,283320000,8551,2850,5701,2850,0,1,2852,1031611
168,2850,3600,3900,14040000,2,22806,5703,1,283320000,283320000,8551,2850,5701,2850,0,1,2852,1032210

168,3250,3600,3900,14040000,2,26006,6503,1,307320000,307320000,9751,3250,6501,3250,0,1,3252,12922212
168,3250,3600,3900,14040000,2,26006,6503,1,307320000,307320000,9751,3250,6501,3250,0,1,3252,1134346
168,3250,3600,3900,14040000,2,26006,6503,1,307320000,307320000,9751,3250,6501,3250,0,1,3252,1136208
168,3250,3600,3900,14040000,2,26006,6503,1,307320000,307320000,9751,3250,6501,3250,0,1,3252,1137615
168,3250,3600,3900,14040000,2,26006,6503,1,307320000,307320000,9751,3250,6501,3250,0,1,3252,1129791
168,3250,3600,3900,14040000,2,26006,6503,1,307320000,307320000,9751,3250,6501,3250,0,1,3252,1161894
168,3250,3600,3900,14040000,2,26006,6503,1,307320000,307320000,9751,3250,6501,3250,0,1,3252,1166897

168,3650,3600,3900,14040000,2,29206,7303,1,331320000,331320000,10951,3650,7301,3650,0,1,3652,14766809
168,3650,3600,3900,14040000,2,29206,7303,1,331320000,331320000,10951,3650,7301,3650,0,1,3652,1324491
168,3650,3600,3900,14040000,2,29206,7303,1,331320000,331320000,10951,3650,7301,3650,0,1,3652,1299518
168,3650,3600,3900,14040000,2,29206,7303,1,331320000,331320000,10951,3650,7301,3650,0,1,3652,1325901
168,3650,3600,3900,14040000,2,29206,7303,1,331320000,331320000,10951,3650,7301,3650,0,1,3652,1320832
168,3650,3600,3900,14040000,2,29206,7303,1,331320000,331320000,10951,3650,7301,3650,0,1,3652,1330175
168,3650,3600,3900,14040000,2,29206,7303,1,331320000,331320000,10951,3650,7301,3650,0,1,3652,1327765

168,4050,3600,3900,14040000,2,32406,8103,1,355320000,355320000,12151,4050,8101,4050,0,1,4052,17266665
168,4050,3600,3900,14040000,2,32406,8103,1,355320000,355320000,12151,4050,8101,4050,0,1,4052,1427535
168,4050,3600,3900,14040000,2,32406,8103,1,355320000,355320000,12151,4050,8101,4050,0,1,4052,1425644
168,4050,3600,3900,14040000,2,32406,8103,1,355320000,355320000,12151,4050,8101,4050,0,1,4052,1430036
168,4050,3600,3900,14040000,2,32406,8103,1,355320000,355320000,12151,4050,8101,4050,0,1,4052,1428436
168,4050,3600,3900,14040000,2,32406,8103,1,355320000,355320000,12151,4050,8101,4050,0,1,4052,1432792
168,4050,3600,3900,14040000,2,32406,8103,1,355320000,355320000,12151,4050,8101,4050,0,1,4052,1432109

168,4450,3600,3900,14040000,2,35606,8903,1,379320000,379320000,13351,4450,8901,4450,0,1,4452,18605255
168,4450,3600,3900,14040000,2,35606,8903,1,379320000,379320000,13351,4450,8901,4450,0,1,4452,1565884
168,4450,3600,3900,14040000,2,35606,8903,1,379320000,379320000,13351,4450,8901,4450,0,1,4452,1583496
168,4450,3600,3900,14040000,2,35606,8903,1,379320000,379320000,13351,4450,8901,4450,0,1,4452,1581608
168,4450,3600,3900,14040000,2,35606,8903,1,379320000,379320000,13351,4450,8901,4450,0,1,4452,1585412
168,4450,3600,3900,14040000,2,35606,8903,1,379320000,379320000,13351,4450,8901,4450,0,1,4452,1587920
168,4450,3600,3900,14040000,2,35606,8903,1,379320000,379320000,13351,4450,8901,4450,0,1,4452,1588633

168,4850,3600,3900,14040000,2,38806,9703,1,403320000,403320000,14551,4850,9701,4850,0,1,4852,20483499
168,4850,3600,3900,14040000,2,38806,9703,1,403320000,403320000,14551,4850,9701,4850,0,1,4852,1671989
168,4850,3600,3900,14040000,2,38806,9703,1,403320000,403320000,14551,4850,9701,4850,0,1,4852,1669967
168,4850,3600,3900,14040000,2,38806,9703,1,403320000,403320000,14551,4850,9701,4850,0,1,4852,1674929
168,4850,3600,3900,14040000,2,38806,9703,1,403320000,403320000,14551,4850,9701,4850,0,1,4852,1672831
168,4850,3600,3900,14040000,2,38806,9703,1,403320000,403320000,14551,4850,9701,4850,0,1,4852,1675618
168,4850,3600,3900,14040000,2,38806,9703,1,403320000,403320000,14551,4850,9701,4850,0,1,4852,1676375

168,5250,3600,3900,14040000,2,42006,10503,1,427320000,427320000,15751,5250,10501,5250,0,1,5252,21705303
168,5250,3600,3900,14040000,2,42006,10503,1,427320000,427320000,15751,5250,10501,5250,0,1,5252,1839052
168,5250,3600,3900,14040000,2,42006,10503,1,427320000,427320000,15751,5250,10501,5250,0,1,5252,1832327
168,5250,3600,3900,14040000,2,42006,10503,1,427320000,427320000,15751,5250,10501,5250,0,1,5252,1840088
168,5250,3600,3900,14040000,2,42006,10503,1,427320000,427320000,15751,5250,10501,5250,0,1,5252,1837964
168,5250,3600,3900,14040000,2,42006,10503,1,427320000,427320000,15751,5250,10501,5250,0,1,5252,1830613
168,5250,3600,3900,14040000,2,42006,10503,1,427320000,427320000,15751,5250,10501,5250,0,1,5252,1833704

168,5650,3600,3900,14040000,2,45206,11303,1,451320000,451320000,16951,5650,11301,5650,0,1,5652,24491504
168,5650,3600,3900,14040000,2,45206,11303,1,451320000,451320000,16951,5650,11301,5650,0,1,5652,1950753
168,5650,3600,3900,14040000,2,45206,11303,1,451320000,451320000,16951,5650,11301,5650,0,1,5652,1948797
168,5650,3600,3900,14040000,2,45206,11303,1,451320000,451320000,16951,5650,11301,5650,0,1,5652,1952041
168,5650,3600,3900,14040000,2,45206,11303,1,451320000,451320000,16951,5650,11301,5650,0,1,5652,1946740
168,5650,3600,3900,14040000,2,45206,11303,1,451320000,451320000,16951,5650,11301,5650,0,1,5652,1931348
168,5650,3600,3900,14040000,2,45206,11303,1,451320000,451320000,16951,5650,11301,5650,0,1,5652,1929551

168,6050,3600,3900,14040000,2,48406,12103,1,475320000,475320000,18151,6050,12101,6050,0,1,6052,26344239
168,6050,3600,3900,14040000,2,48406,12103,1,475320000,475320000,18151,6050,12101,6050,0,1,6052,2139869
168,6050,3600,3900,14040000,2,48406,12103,1,475320000,475320000,18151,6050,12101,6050,0,1,6052,2144182
168,6050,3600,3900,14040000,2,48406,12103,1,475320000,475320000,18151,6050,12101,6050,0,1,6052,2145329
168,6050,3600,3900,14040000,2,48406,12103,1,475320000,475320000,18151,6050,12101,6050,0,1,6052,2136237
168,6050,3600,3900,14040000,2,48406,12103,1,475320000,475320000,18151,6050,12101,6050,0,1,6052,2096607
168,6050,3600,3900,14040000,2,48406,12103,1,475320000,475320000,18151,6050,12101,6050,0,1,6052,2100990

168,6450,3600,3900,14040000,2,51606,12903,1,499320000,499320000,19351,6450,12901,6450,0,1,6452,28171708
168,6450,3600,3900,14040000,2,51606,12903,1,499320000,499320000,19351,6450,12901,6450,0,1,6452,2243019
168,6450,3600,3900,14040000,2,51606,12903,1,499320000,499320000,19351,6450,12901,6450,0,1,6452,2233226
168,6450,3600,3900,14040000,2,51606,12903,1,499320000,499320000,19351,6450,12901,6450,0,1,6452,2245666
168,6450,3600,3900,14040000,2,51606,12903,1,499320000,499320000,19351,6450,12901,6450,0,1,6452,2239554
168,6450,3600,3900,14040000,2,51606,12903,1,499320000,499320000,19351,6450,12901,6450,0,1,6452,2204269
168,6450,3600,3900,14040000,2,51606,12903,1,499320000,499320000,19351,6450,12901,6450,0,1,6452,2209598

168,6850,3600,3900,14040000,2,54806,13703,1,523320000,523320000,20551,6850,13701,6850,0,1,6852,28934158
168,6850,3600,3900,14040000,2,54806,13703,1,523320000,523320000,20551,6850,13701,6850,0,1,6852,2368288
168,6850,3600,3900,14040000,2,54806,13703,1,523320000,523320000,20551,6850,13701,6850,0,1,6852,2369994
168,6850,3600,3900,14040000,2,54806,13703,1,523320000,523320000,20551,6850,13701,6850,0,1,6852,2374942
168,6850,3600,3900,14040000,2,54806,13703,1,523320000,523320000,20551,6850,13701,6850,0,1,6852,2373650
168,6850,3600,3900,14040000,2,54806,13703,1,523320000,523320000,20551,6850,13701,6850,0,1,6852,2322338
168,6850,3600,3900,14040000,2,54806,13703,1,523320000,523320000,20551,6850,13701,6850,0,1,6852,2320251

168,50,3600,3500,12600000,2,406,103,1,103640000,103640000,151,50,101,50,0,1,52,139103
168,50,3600,3500,12600000,2,406,103,1,103640000,103640000,151,50,101,50,0,1,52,122155
168,50,3600,3500,12600000,2,406,103,1,103640000,103640000,151,50,101,50,0,1,52,105907
168,50,3600,3500,12600000,2,406,103,1,103640000,103640000,151,50,101,50,0,1,52,121703
168,50,3600,3500,12600000,2,406,103,1,103640000,103640000,151,50,101,50,0,1,52,117611
168,50,3600,3500,12600000,2,406,103,1,103640000,103640000,151,50,101,50,0,1,52,158007
168,50,3600,3500,12600000,2,406,103,1,103640000,103640000,151,50,101,50,0,1,52,158474

168,450,3600,3500,12600000,2,3606,903,1,126360000,126360000,1351,450,901,450,0,1,452,1307152
168,450,3600,3500,12600000,2,3606,903,1,126360000,126360000,1351,450,901,450,0,1,452,244562
168,450,3600,3500,12600000,2,3606,903,1,126360000,126360000,1351,450,901,450,0,1,452,243409
168,450,3600,3500,12600000,2,3606,903,1,126360000,126360000,1351,450,901,450,0,1,452,246144
168,450,3600,3500,12600000,2,3606,903,1,126360000,126360000,1351,450,901,450,0,1,452,245402
168,450,3600,3500,12600000,2,3606,903,1,126360000,126360000,1351,450,901,450,0,1,452,248275
168,450,3600,3500,12600000,2,3606,903,1,126360000,126360000,1351,450,901,450,0,1,452,247869

168,850,3600,3500,12600000,2,6806,1703,1,149080000,149080000,2551,850,1701,850,0,1,852,2626882
168,850,3600,3500,12600000,2,6806,1703,1,149080000,149080000,2551,850,1701,850,0,1,852,362597
168,850,3600,3500,12600000,2,6806,1703,1,149080000,149080000,2551,850,1701,850,0,1,852,363155
168,850,3600,3500,12600000,2,6806,1703,1,149080000,149080000,2551,850,1701,850,0,1,852,361411
168,850,3600,3500,12600000,2,6806,1703,1,149080000,149080000,2551,850,1701,850,0,1,852,362028
168,850,3600,3500,12600000,2,6806,1703,1,149080000,149080000,2551,850,1701,850,0,1,852,365466
168,850,3600,3500,12600000,2,6806,1703,1,149080000,149080000,2551,850,1701,850,0,1,852,365911

168,1250,3600,3500,12600000,2,10006,2503,1,171800000,171800000,3751,1250,2501,1250,0,1,1252,4195379
168,1250,3600,3500,12600000,2,10006,2503,1,171800000,171800000,3751,1250,2501,1250,0,1,1252,486903
168,1250,3600,3500,12600000,2,10006,2503,1,171800000,171800000,3751,1250,2501,1250,0,1,1252,480785
168,1250,3600,3500,12600000,2,10006,2503,1,171800000,171800000,3751,1250,2501,1250,0,1,1252,487280
168,1250,3600,3500,12600000,2,10006,2503,1,171800000,171800000,3751,1250,2501,1250,0,1,1252,486123
168,1250,3600,3500,12600000,2,10006,2503,1,171800000,171800000,3751,1250,2501,1250,0,1,1252,488731
168,1250,3600,3500,12600000,2,10006,2503,1,171800000,171800000,3751,1250,2501,1250,0,1,1252,489831

168,1650,3600,3500,12600000,2,13206,3303,1,194520000,194520000,4951,1650,3301,1650,0,1,1652,5764865
168,1650,3600,3500,12600000,2,13206,3303,1,194520000,194520000,4951,1650,3301,1650,0,1,1652,626210
168,1650,3600,3500,12600000,2,13206,3303,1,194520000,194520000,4951,1650,3301,1650,0,1,1652,618694
168,1650,3600,3500,12600000,2,13206,3303,1,194520000,194520000,4951,1650,3301,1650,0,1,1652,626585
168,1650,3600,3500,12600000,2,13206,3303,1,194520000,194520000,4951,1650,3301,1650,0,1,1652,625026
168,1650,3600,3500,12600000,2,13206,3303,1,194520000,194520000,4951,1650,3301,1650,0,1,1652,625661
168,1650,3600,3500,12600000,2,13206,3303,1,194520000,194520000,4951,1650,3301,1650,0,1,1652,617968

168,2050,3600,3500,12600000,2,16406,4103,1,217240000,217240000,6151,2050,4101,2050,0,1,2052,7321872
168,2050,3600,3500,12600000,2,16406,4103,1,217240000,217240000,6151,2050,4101,2050,0,1,2052,717130
168,2050,3600,3500,12600000,2,16406,4103,1,217240000,217240000,6151,2050,4101,2050,0,1,2052,715591
168,2050,3600,3500,12600000,2,16406,4103,1,217240000,217240000,6151,2050,4101,2050,0,1,2052,716544
168,2050,3600,3500,12600000,2,16406,4103,1,217240000,217240000,6151,2050,4101,2050,0,1,2052,714141
168,2050,3600,3500,12600000,2,16406,4103,1,217240000,217240000,6151,2050,4101,2050,0,1,2052,717379
168,2050,3600,3500,12600000,2,16406,4103,1,217240000,217240000,6151,2050,4101,2050,0,1,2052,717697

168,2450,3600,3500,12600000,2,19606,4903,1,239960000,239960000,7351,2450,4901,2450,0,1,2452,8956655
168,2450,3600,3500,12600000,2,19606,4903,1,239960000,239960000,7351,2450,4901,2450,0,1,2452,801974
168,2450,3600,3500,12600000,2,19606,4903,1,239960000,239960000,7351,2450,4901,2450,0,1,2452,796850
168,2450,3600,3500,12600000,2,19606,4903,1,239960000,239960000,7351,2450,4901,2450,0,1,2452,803422
168,2450,3600,3500,12600000,2,19606,4903,1,239960000,239960000,7351,2450,4901,2450,0,1,2452,800359
168,2450,3600,3500,12600000,2,19606,4903,1,239960000,239960000,7351,2450,4901,2450,0,1,2452,822230
168,2450,3600,3500,12600000,2,19606,4903,1,239960000,239960000,7351,2450,4901,2450,0,1,2452,822779

168,2850,3600,3500,12600000,2,22806,5703,1,262680000,262680000,8551,2850,5701,2850,0,1,2852,10658944
168,2850,3600,3500,12600000,2,22806,5703,1,262680000,262680000,8551,2850,5701,2850,0,1,2852,892812
168,2850,3600,3500,12600000,2,22806,5703,1,262680000,262680000,8551,2850,5701,2850,0,1,2852,889830
168,2850,3600,3500,12600000,2,22806,5703,1,262680000,262680000,8551,2850,5701,2850,0,1,2852,894688
168,2850,3600,3500,12600000,2,22806,5703,1,262680000,262680000,8551,2850,5701,2850,0,1,2852,891846
168,2850,3600,3500,12600000,2,22806,5703,1,262680000,262680000,8551,2850,5701,2850,0,1,2852,930091
168,2850,3600,3500,12600000,2,22806,5703,1,262680000,262680000,8551,2850,5701,2850,0,1,2852,929493

168,3250,3600,3500,12600000,2,26006,6503,1,285400000,285400000,9751,3250,6501,3250,0,1,3252,11462076
168,3250,3600,3500,12600000,2,26006,6503,1,285400000,285400000,9751,3250,6501,3250,0,1,3252,1071772
168,3250,3600,3500,12600000,2,26006,6503,1,285400000,285400000,9751,3250,6501,3250,0,1,3252,1055715
168,3250,3600,3500,12600000,2,26006,6503,1,285400000,285400000,9751,3250,6501,3250,0,1,3252,1073915
168,3250,3600,3500,12600000,2,26006,6503,1,285400000,285400000,9751,3250,6501,3250,0,1,3252,1069198
168,3250,3600,3500,12600000,2,26006,6503,1,285400000,285400000,9751,3250,6501,3250,0,1,3252,1084659
168,3250,3600,3500,12600000,2,26006,6503,1,285400000,285400000,9751,3250,6501,3250,0,1,3252,1086218

168,3650,3600,3500,12600000,2,29206,7303,1,308120000,308120000,10951,3650,7301,3650,0,1,3652,12967664
168,3650,3600,3500,12600000,2,29206,7303,1,308120000,308120000,10951,3650,7301,3650,0,1,3652,1133599
168,3650,3600,3500,12600000,2,29206,7303,1,308120000,308120000,10951,3650,7301,3650,0,1,3652,1135087
168,3650,3600,3500,12600000,2,29206,7303,1,308120000,308120000,10951,3650,7301,3650,0,1,3652,1136770
168,3650,3600,3500,12600000,2,29206,7303,1,308120000,308120000,10951,3650,7301,3650,0,1,3652,1130374
168,3650,3600,3500,12600000,2,29206,7303,1,308120000,308120000,10951,3650,7301,3650,0,1,3652,1163271
168,3650,3600,3500,12600000,2,29206,7303,1,308120000,308120000,10951,3650,7301,3650,0,1,3652,1162595

168,4050,3600,3500,12600000,2,32406,8103,1,330840000,330840000,12151,4050,8101,4050,0,1,4052,14895686
168,4050,3600,3500,12600000,2,32406,8103,1,330840000,330840000,12151,4050,8101,4050,0,1,4052,1236705
168,4050,3600,3500,12600000,2,32406,8103,1,330840000,330840000,12151,4050,8101,4050,0,1,4052,1233276
168,4050,3600,3500,12600000,2,32406,8103,1,330840000,330840000,12151,4050,8101,4050,0,1,4052,1238898
168,4050,3600,3500,12600000,2,32406,8103,1,330840000,330840000,12151,4050,8101,4050,0,1,4052,1240697
168,4050,3600,3500,12600000,2,32406,8103,1,330840000,330840000,12151,4050,8101,4050,0,1,4052,1268017
168,4050,3600,3500,12600000,2,32406,8103,1,330840000,330840000,12151,4050,8101,4050,0,1,4052,1267319

168,4450,3600,3500,12600000,2,35606,8903,1,353560000,353560000,13351,4450,8901,4450,0,1,4452,16425932
168,4450,3600,3500,12600000,2,35606,8903,1,353560000,353560000,13351,4450,8901,4450,0,1,4452,1429220
168,4450,3600,3500,12600000,2,35606,8903,1,353560000,353560000,13351,4450,8901,4450,0,1,4452,1384449
168,4450,3600,3500,12600000,2,35606,8903,1,353560000,353560000,13351,4450,8901,4450,0,1,4452,1434482
168,4450,3600,3500,12600000,2,35606,8903,1,353560000,353560000,13351,4450,8901,4450,0,1,4452,1421708
168,4450,3600,3500,12600000,2,35606,8903,1,353560000,353560000,13351,4450,8901,4450,0,1,4452,1444305
168,4450,3600,3500,12600000,2,35606,8903,1,353560000,353560000,13351,4450,8901,4450,0,1,4452,1441017

168,4850,3600,3500,12600000,2,38806,9703,1,376280000,376280000,14551,4850,9701,4850,0,1,4852,18380975
168,4850,3600,3500,12600000,2,38806,9703,1,376280000,376280000,14551,4850,9701,4850,0,1,4852,1533288
168,4850,3600,3500,12600000,2,38806,9703,1,376280000,376280000,14551,4850,9701,4850,0,1,4852,1531098
168,4850,3600,3500,12600000,2,38806,9703,1,376280000,376280000,14551,4850,9701,4850,0,1,4852,1537241
168,4850,3600,3500,12600000,2,38806,9703,1,376280000,376280000,14551,4850,9701,4850,0,1,4852,1534976
168,4850,3600,3500,12600000,2,38806,9703,1,376280000,376280000,14551,4850,9701,4850,0,1,4852,1536457
168,4850,3600,3500,12600000,2,38806,9703,1,376280000,376280000,14551,4850,9701,4850,0,1,4852,1535693

168,5250,3600,3500,12600000,2,42006,10503,1,399000000,399000000,15751,5250,10501,5250,0,1,5252,20061999
168,5250,3600,3500,12600000,2,42006,10503,1,399000000,399000000,15751,5250,10501,5250,0,1,5252,1632340
168,5250,3600,3500,12600000,2,42006,10503,1,399000000,399000000,15751,5250,10501,5250,0,1,5252,1626780
168,5250,3600,3500,12600000,2,42006,10503,1,399000000,399000000,15751,5250,10501,5250,0,1,5252,1636842
168,5250,3600,3500,12600000,2,42006,10503,1,399000000,399000000,15751,5250,10501,5250,0,1,5252,1634143
168,5250,3600,3500,12600000,2,42006,10503,1,399000000,399000000,15751,5250,10501,5250,0,1,5252,1638956
168,5250,3600,3500,12600000,2,42006,10503,1,399000000,399000000,15751,5250,10501,5250,0,1,5252,1640695

168,5650,3600,3500,12600000,2,45206,11303,1,421720000,421720000,16951,5650,11301,5650,0,1,5652,21595642
168,5650,3600,3500,12600000,2,45206,11303,1,421720000,421720000,16951,5650,11301,5650,0,1,5652,1782129
168,5650,3600,3500,12600000,2,45206,11303,1,421720000,421720000,16951,5650,11301,5650,0,1,5652,1779010
168,5650,3600,3500,12600000,2,45206,11303,1,421720000,421720000,16951,5650,11301,5650,0,1,5652,1784557
168,5650,3600,3500,12600000,2,45206,11303,1,421720000,421720000,16951,5650,11301,5650,0,1,5652,1780864
168,5650,3600,3500,12600000,2,45206,11303,1,421720000,421720000,16951,5650,11301,5650,0,1,5652,1764366
168,5650,3600,3500,12600000,2,45206,11303,1,421720000,421720000,16951,5650,11301,5650,0,1,5652,1757555

168,6050,3600,3500,12600000,2,48406,12103,1,444440000,444440000,18151,6050,12101,6050,0,1,6052,23264489
168,6050,3600,3500,12600000,2,48406,12103,1,444440000,444440000,18151,6050,12101,6050,0,1,6052,1898018
168,6050,3600,3500,12600000,2,48406,12103,1,444440000,444440000,18151,6050,12101,6050,0,1,6052,1895906
168,6050,3600,3500,12600000,2,48406,12103,1,444440000,444440000,18151,6050,12101,6050,0,1,6052,1901177
168,6050,3600,3500,12600000,2,48406,12103,1,444440000,444440000,18151,6050,12101,6050,0,1,6052,1899820
168,6050,3600,3500,12600000,2,48406,12103,1,444440000,444440000,18151,6050,12101,6050,0,1,6052,1874133
168,6050,3600,3500,12600000,2,48406,12103,1,444440000,444440000,18151,6050,12101,6050,0,1,6052,1880652

168,6450,3600,3500,12600000,2,51606,12903,1,467160000,467160000,19351,6450,12901,6450,0,1,6452,23927621
168,6450,3600,3500,12600000,2,51606,12903,1,467160000,467160000,19351,6450,12901,6450,0,1,6452,2018092
168,6450,3600,3500,12600000,2,51606,12903,1,467160000,467160000,19351,6450,12901,6450,0,1,6452,2057603
168,6450,3600,3500,12600000,2,51606,12903,1,467160000,467160000,19351,6450,12901,6450,0,1,6452,2056416
168,6450,3600,3500,12600000,2,51606,12903,1,467160000,467160000,19351,6450,12901,6450,0,1,6452,2014316
168,6450,3600,3500,12600000,2,51606,12903,1,467160000,467160000,19351,6450,12901,6450,0,1,6452,1993360
168,6450,3600,3500,12600000,2,51606,12903,1,467160000,467160000,19351,6450,12901,6450,0,1,6452,1973603

168,6850,3600,3500,12600000,2,54806,13703,1,489880000,489880000,20551,6850,13701,6850,0,1,6852,26871521
168,6850,3600,3500,12600000,2,54806,13703,1,489880000,489880000,20551,6850,13701,6850,0,1,6852,2142752
168,6850,3600,3500,12600000,2,54806,13703,1,489880000,489880000,20551,6850,13701,6850,0,1,6852,2131419
168,6850,3600,3500,12600000,2,54806,13703,1,489880000,489880000,20551,6850,13701,6850,0,1,6852,2145456
168,6850,3600,3500,12600000,2,54806,13703,1,489880000,489880000,20551,6850,13701,6850,0,1,6852,2141480
168,6850,3600,3500,12600000,2,54806,13703,1,489880000,489880000,20551,6850,13701,6850,0,1,6852,2113946
168,6850,3600,3500,12600000,2,54806,13703,1,489880000,489880000,20551,6850,13701,6850,0,1,6852,2119028

168,50,3600,3100,11160000,2,406,103,1,91960000,91960000,151,50,101,50,0,1,52,123167
168,50,3600,3100,11160000,2,406,103,1,91960000,91960000,151,50,101,50,0,1,52,100026
168,50,3600,3100,11160000,2,406,103,1,91960000,91960000,151,50,101,50,0,1,52,115265
168,50,3600,3100,11160000,2,406,103,1,91960000,91960000,151,50,101,50,0,1,52,114810
168,50,3600,3100,11160000,2,406,103,1,91960000,91960000,151,50,101,50,0,1,52,113104
168,50,3600,3100,11160000,2,406,103,1,91960000,91960000,151,50,101,50,0,1,52,142046
168,50,3600,3100,11160000,2,406,103,1,91960000,91960000,151,50,101,50,0,1,52,142517

168,450,3600,3100,11160000,2,3606,903,1,113400000,113400000,1351,450,901,450,0,1,452,1132786
168,450,3600,3100,11160000,2,3606,903,1,113400000,113400000,1351,450,901,450,0,1,452,212707
168,450,3600,3100,11160000,2,3606,903,1,113400000,113400000,1351,450,901,450,0,1,452,213907
168,450,3600,3100,11160000,2,3606,903,1,113400000,113400000,1351,450,901,450,0,1,452,211132
168,450,3600,3100,11160000,2,3606,903,1,113400000,113400000,1351,450,901,450,0,1,452,213520
168,450,3600,3100,11160000,2,3606,903,1,113400000,113400000,1351,450,901,450,0,1,452,218478
168,450,3600,3100,11160000,2,3606,903,1,113400000,113400000,1351,450,901,450,0,1,452,218072

168,850,3600,3100,11160000,2,6806,1703,1,134840000,134840000,2551,850,1701,850,0,1,852,2432429
168,850,3600,3100,11160000,2,6806,1703,1,134840000,134840000,2551,850,1701,850,0,1,852,321114
168,850,3600,3100,11160000,2,6806,1703,1,134840000,134840000,2551,850,1701,850,0,1,852,319172
168,850,3600,3100,11160000,2,6806,1703,1,134840000,134840000,2551,850,1701,850,0,1,852,321967
168,850,3600,3100,11160000,2,6806,1703,1,134840000,134840000,2551,850,1701,850,0,1,852,322418
168,850,3600,3100,11160000,2,6806,1703,1,134840000,134840000,2551,850,1701,850,0,1,852,324491
168,850,3600,3100,11160000,2,6806,1703,1,134840000,134840000,2551,850,1701,850,0,1,852,324928

168,1250,3600,3100,11160000,2,10006,2503,1,156280000,156280000,3751,1250,2501,1250,0,1,1252,3709932
168,1250,3600,3100,11160000,2,10006,2503,1,156280000,156280000,3751,1250,2501,1250,0,1,1252,430335
168,1250,3600,3100,11160000,2,10006,2503,1,156280000,156280000,3751,1250,2501,1250,0,1,1252,431996
168,1250,3600,3100,11160000,2,10006,2503,1,156280000,156280000,3751,1250,2501,1250,0,1,1252,430884
168,1250,3600,3100,11160000,2,10006,2503,1,156280000,156280000,3751,1250,2501,1250,0,1,1252,431348
168,1250,3600,3100,11160000,2,10006,2503,1,156280000,156280000,3751,1250,2501,1250,0,1,1252,433212
168,1250,3600,3100,11160000,2,10006,2503,1,156280000,156280000,3751,1250,2501,1250,0,1,1252,433680

168,1650,3600,3100,11160000,2,13206,3303,1,177720000,177720000,4951,1650,3301,1650,0,1,1652,5036544
168,1650,3600,3100,11160000,2,13206,3303,1,177720000,177720000,4951,1650,3301,1650,0,1,1652,521991
168,1650,3600,3100,11160000,2,13206,3303,1,177720000,177720000,4951,1650,3301,1650,0,1,1652,520840
168,1650,3600,3100,11160000,2,13206,3303,1,177720000,177720000,4951,1650,3301,1650,0,1,1652,519800
168,1650,3600,3100,11160000,2,13206,3303,1,177720000,177720000,4951,1650,3301,1650,0,1,1652,519010
168,1650,3600,3100,11160000,2,13206,3303,1,177720000,177720000,4951,1650,3301,1650,0,1,1652,524875
168,1650,3600,3100,11160000,2,13206,3303,1,177720000,177720000,4951,1650,3301,1650,0,1,1652,524374

168,2050,3600,3100,11160000,2,16406,4103,1,199160000,199160000,6151,2050,4101,2050,0,1,2052,6361129
168,2050,3600,3100,11160000,2,16406,4103,1,199160000,199160000,6151,2050,4101,2050,0,1,2052,637775
168,2050,3600,3100,11160000,2,16406,4103,1,199160000,199160000,6151,2050,4101,2050,0,1,2052,638757
168,2050,3600,3100,11160000,2,16406,4103,1,199160000,199160000,6151,2050,4101,2050,0,1,2052,639771
168,2050,3600,3100,11160000,2,16406,4103,1,199160000,199160000,6151,2050,4101,2050,0,1,2052,636100
168,2050,3600,3100,11160000,2,16406,4103,1,199160000,199160000,6151,2050,4101,2050,0,1,2052,640185
168,2050,3600,3100,11160000,2,16406,4103,1,199160000,199160000,6151,2050,4101,2050,0,1,2052,640504

168,2450,3600,3100,11160000,2,19606,4903,1,220600000,220600000,7351,2450,4901,2450,0,1,2452,7638082
168,2450,3600,3100,11160000,2,19606,4903,1,220600000,220600000,7351,2450,4901,2450,0,1,2452,736334
168,2450,3600,3100,11160000,2,19606,4903,1,220600000,220600000,7351,2450,4901,2450,0,1,2452,743967
168,2450,3600,3100,11160000,2,19606,4903,1,220600000,220600000,7351,2450,4901,2450,0,1,2452,745061
168,2450,3600,3100,11160000,2,19606,4903,1,220600000,220600000,7351,2450,4901,2450,0,1,2452,699374
168,2450,3600,3100,11160000,2,19606,4903,1,220600000,220600000,7351,2450,4901,2450,0,1,2452,745510
168,2450,3600,3100,11160000,2,19606,4903,1,220600000,220600000,7351,2450,4901,2450,0,1,2452,747414

168,2850,3600,3100,11160000,2,22806,5703,1,242040000,242040000,8551,2850,5701,2850,0,1,2852,9080894
168,2850,3600,3100,11160000,2,22806,5703,1,242040000,242040000,8551,2850,5701,2850,0,1,2852,870910
168,2850,3600,3100,11160000,2,22806,5703,1,242040000,242040000,8551,2850,5701,2850,0,1,2852,865049
168,2850,3600,3100,11160000,2,22806,5703,1,242040000,242040000,8551,2850,5701,2850,0,1,2852,868018
168,2850,3600,3100,11160000,2,22806,5703,1,242040000,242040000,8551,2850,5701,2850,0,1,2852,817188
168,2850,3600,3100,11160000,2,22806,5703,1,242040000,242040000,8551,2850,5701,2850,0,1,2852,861462
168,2850,3600,3100,11160000,2,22806,5703,1,242040000,242040000,8551,2850,5701,2850,0,1,2852,847633

168,3250,3600,3100,11160000,2,26006,6503,1,263480000,263480000,9751,3250,6501,3250,0,1,3252,10398293
168,3250,3600,3100,11160000,2,26006,6503,1,263480000,263480000,9751,3250,6501,3250,0,1,3252,908136
168,3250,3600,3100,11160000,2,26006,6503,1,263480000,263480000,9751,3250,6501,3250,0,1,3252,908753
168,3250,3600,3100,11160000,2,26006,6503,1,263480000,263480000,9751,3250,6501,3250,0,1,3252,909770
168,3250,3600,3100,11160000,2,26006,6503,1,263480000,263480000,9751,3250,6501,3250,0,1,3252,911699
168,3250,3600,3100,11160000,2,26006,6503,1,263480000,263480000,9751,3250,6501,3250,0,1,3252,954644
168,3250,3600,3100,11160000,2,26006,6503,1,263480000,263480000,9751,3250,6501,3250,0,1,3252,954011

168,3650,3600,3100,11160000,2,29206,7303,1,284920000,284920000,10951,3650,7301,3650,0,1,3652,11056912
168,3650,3600,3100,11160000,2,29206,7303,1,284920000,284920000,10951,3650,7301,3650,0,1,3652,998612
168,3650,3600,3100,11160000,2,29206,7303,1,284920000,284920000,10951,3650,7301,3650,0,1,3652,1000097
168,3650,3600,3100,11160000,2,29206,7303,1,284920000,284920000,10951,3650,7301,3650,0,1,3652,1001155
168,3650,3600,3100,11160000,2,29206,7303,1,284920000,284920000,10951,3650,7301,3650,0,1,3652,1002337
168,3650,3600,3100,11160000,2,29206,7303,1,284920000,284920000,10951,3650,7301,3650,0,1,3652,1045467
168,3650,3600,3100,11160000,2,29206,7303,1,284920000,284920000,10951,3650,7301,3650,0,1,3652,1046136

168,4050,3600,3100,11160000,2,32406,8103,1,306360000,306360000,12151,4050,8101,4050,0,1,4052,13133664
168,4050,3600,3100,11160000,2,32406,8103,1,306360000,306360000,12151,4050,8101,4050,0,1,4052,1111100
168,4050,3600,3100,11160000,2,32406,8103,1,306360000,306360000,12151,4050,8101,4050,0,1,4052,1108346
168,4050,3600,3100,11160000,2,32406,8103,1,306360000,306360000,12151,4050,8101,4050,0,1,4052,1112928
168,4050,3600,3100,11160000,2,32406,8103,1,306360000,306360000,12151,4050,8101,4050,0,1,4052,1110181
168,4050,3600,3100,11160000,2,32406,8103,1,306360000,306360000,12151,4050,8101,4050,0,1,4052,1137028
168,4050,3600,3100,11160000,2,32406,8103,1,306360000,306360000,12151,4050,8101,4050,0,1,4052,1157866

168,4450,3600,3100,11160000,2,35606,8903,1,327800000,327800000,13351,4450,8901,4450,0,1,4452,14420595
168,4450,3600,3100,11160000,2,35606,8903,1,327800000,327800000,13351,4450,8901,4450,0,1,4452,1329495
168,4450,3600,3100,11160000,2,35606,8903,1,327800000,327800000,13351,4450,8901,4450,0,1,4452,1333215
168,4450,3600,3100,11160000,2,35606,8903,1,327800000,327800000,13351,4450,8901,4450,0,1,4452,1331166
168,4450,3600,3100,11160000,2,35606,8903,1,327800000,327800000,13351,4450,8901,4450,0,1,4452,1325943
168,4450,3600,3100,11160000,2,35606,8903,1,327800000,327800000,13351,4450,8901,4450,0,1,4452,1311685
168,4450,3600,3100,11160000,2,35606,8903,1,327800000,327800000,13351,4450,8901,4450,0,1,4452,1289047

168,4850,3600,3100,11160000,2,38806,9703,1,349240000,349240000,14551,4850,9701,4850,0,1,4852,16271356
168,4850,3600,3100,11160000,2,38806,9703,1,349240000,349240000,14551,4850,9701,4850,0,1,4852,1369251
168,4850,3600,3100,11160000,2,38806,9703,1,349240000,349240000,14551,4850,9701,4850,0,1,4852,1366266
168,4850,3600,3100,11160000,2,38806,9703,1,349240000,349240000,14551,4850,9701,4850,0,1,4852,1370857
168,4850,3600,3100,11160000,2,38806,9703,1,349240000,349240000,14551,4850,9701,4850,0,1,4852,1368025
168,4850,3600,3100,11160000,2,38806,9703,1,349240000,349240000,14551,4850,9701,4850,0,1,4852,1372924
168,4850,3600,3100,11160000,2,38806,9703,1,349240000,349240000,14551,4850,9701,4850,0,1,4852,1373689

168,5250,3600,3100,11160000,2,42006,10503,1,370680000,370680000,15751,5250,10501,5250,0,1,5252,17523994
168,5250,3600,3100,11160000,2,42006,10503,1,370680000,370680000,15751,5250,10501,5250,0,1,5252,1493097
168,5250,3600,3100,11160000,2,42006,10503,1,370680000,370680000,15751,5250,10501,5250,0,1,5252,1488057
168,5250,3600,3100,11160000,2,42006,10503,1,370680000,370680000,15751,5250,10501,5250,0,1,5252,1496311
168,5250,3600,3100,11160000,2,42006,10503,1,370680000,370680000,15751,5250,10501,5250,0,1,5252,1435984
168,5250,3600,3100,11160000,2,42006,10503,1,370680000,370680000,15751,5250,10501,5250,0,1,5252,1498185
168,5250,3600,3100,11160000,2,42006,10503,1,370680000,370680000,15751,5250,10501,5250,0,1,5252,1498960

168,5650,3600,3100,11160000,2,45206,11303,1,392120000,392120000,16951,5650,11301,5650,0,1,5652,18688228
168,5650,3600,3100,11160000,2,45206,11303,1,392120000,392120000,16951,5650,11301,5650,0,1,5652,1565227
168,5650,3600,3100,11160000,2,45206,11303,1,392120000,392120000,16951,5650,11301,5650,0,1,5652,1556410
168,5650,3600,3100,11160000,2,45206,11303,1,392120000,392120000,16951,5650,11301,5650,0,1,5652,1567517
168,5650,3600,3100,11160000,2,45206,11303,1,392120000,392120000,16951,5650,11301,5650,0,1,5652,1573591
168,5650,3600,3100,11160000,2,45206,11303,1,392120000,392120000,16951,5650,11301,5650,0,1,5652,1571128
168,5650,3600,3100,11160000,2,45206,11303,1,392120000,392120000,16951,5650,11301,5650,0,1,5652,1569755

168,6050,3600,3100,11160000,2,48406,12103,1,413560000,413560000,18151,6050,12101,6050,0,1,6052,19821948
168,6050,3600,3100,11160000,2,48406,12103,1,413560000,413560000,18151,6050,12101,6050,0,1,6052,1681164
168,6050,3600,3100,11160000,2,48406,12103,1,413560000,413560000,18151,6050,12101,6050,0,1,6052,1684049
168,6050,3600,3100,11160000,2,48406,12103,1,413560000,413560000,18151,6050,12101,6050,0,1,6052,1685767
168,6050,3600,3100,11160000,2,48406,12103,1,413560000,413560000,18151,6050,12101,6050,0,1,6052,1682571
168,6050,3600,3100,11160000,2,48406,12103,1,413560000,413560000,18151,6050,12101,6050,0,1,6052,1679189
168,6050,3600,3100,11160000,2,48406,12103,1,413560000,413560000,18151,6050,12101,6050,0,1,6052,1686804

168,6450,3600,3100,11160000,2,51606,12903,1,435000000,435000000,19351,6450,12901,6450,0,1,6452,21510010
168,6450,3600,3100,11160000,2,51606,12903,1,435000000,435000000,19351,6450,12901,6450,0,1,6452,1844925
168,6450,3600,3100,11160000,2,51606,12903,1,435000000,435000000,19351,6450,12901,6450,0,1,6452,1852677
168,6450,3600,3100,11160000,2,51606,12903,1,435000000,435000000,19351,6450,12901,6450,0,1,6452,1851446
168,6450,3600,3100,11160000,2,51606,12903,1,435000000,435000000,19351,6450,12901,6450,0,1,6452,1840214
168,6450,3600,3100,11160000,2,51606,12903,1,435000000,435000000,19351,6450,12901,6450,0,1,6452,1819594
168,6450,3600,3100,11160000,2,51606,12903,1,435000000,435000000,19351,6450,12901,6450,0,1,6452,1793687

168,6850,3600,3100,11160000,2,54806,13703,1,456440000,456440000,20551,6850,13701,6850,0,1,6852,22807747
168,6850,3600,3100,11160000,2,54806,13703,1,456440000,456440000,20551,6850,13701,6850,0,1,6852,1931230
168,6850,3600,3100,11160000,2,54806,13703,1,456440000,456440000,20551,6850,13701,6850,0,1,6852,1929341
168,6850,3600,3100,11160000,2,54806,13703,1,456440000,456440000,20551,6850,13701,6850,0,1,6852,1932644
168,6850,3600,3100,11160000,2,54806,13703,1,456440000,456440000,20551,6850,13701,6850,0,1,6852,1928271
168,6850,3600,3100,11160000,2,54806,13703,1,456440000,456440000,20551,6850,13701,6850,0,1,6852,1897058
168,6850,3600,3100,11160000,2,54806,13703,1,456440000,456440000,20551,6850,13701,6850,0,1,6852,1911142

168,50,3600,2700,9720000,2,406,103,1,80280000,80280000,151,50,101,50,0,1,52,106650
168,50,3600,2700,9720000,2,406,103,1,80280000,80280000,151,50,101,50,0,1,52,106901
168,50,3600,2700,9720000,2,406,103,1,80280000,80280000,151,50,101,50,0,1,52,105950
168,50,3600,2700,9720000,2,406,103,1,80280000,80280000,151,50,101,50,0,1,52,106539
168,50,3600,2700,9720000,2,406,103,1,80280000,80280000,151,50,101,50,0,1,52,104548
168,50,3600,2700,9720000,2,406,103,1,80280000,80280000,151,50,101,50,0,1,52,180973
168,50,3600,2700,9720000,2,406,103,1,80280000,80280000,151,50,101,50,0,1,52,180236

168,450,3600,2700,9720000,2,3606,903,1,100440000,100440000,1351,450,901,450,0,1,452,1033020
168,450,3600,2700,9720000,2,3606,903,1,100440000,100440000,1351,450,901,450,0,1,452,179109
168,450,3600,2700,9720000,2,3606,903,1,100440000,100440000,1351,450,901,450,0,1,452,178218
168,450,3600,2700,9720000,2,3606,903,1,100440000,100440000,1351,450,901,450,0,1,452,178606
168,450,3600,2700,9720000,2,3606,903,1,100440000,100440000,1351,450,901,450,0,1,452,177219
168,450,3600,2700,9720000,2,3606,903,1,100440000,100440000,1351,450,901,450,0,1,452,204736
168,450,3600,2700,9720000,2,3606,903,1,100440000,100440000,1351,450,901,450,0,1,452,205140

168,850,3600,2700,9720000,2,6806,1703,1,120600000,120600000,2551,850,1701,850,0,1,852,2052980
168,850,3600,2700,9720000,2,6806,1703,1,120600000,120600000,2551,850,1701,850,0,1,852,281801
168,850,3600,2700,9720000,2,6806,1703,1,120600000,120600000,2551,850,1701,850,0,1,852,279595
168,850,3600,2700,9720000,2,6806,1703,1,120600000,120600000,2551,850,1701,850,0,1,852,282246
168,850,3600,2700,9720000,2,6806,1703,1,120600000,120600000,2551,850,1701,850,0,1,852,280955
168,850,3600,2700,9720000,2,6806,1703,1,120600000,120600000,2551,850,1701,850,0,1,852,284261
168,850,3600,2700,9720000,2,6806,1703,1,120600000,120600000,2551,850,1701,850,0,1,852,284698

168,1250,3600,2700,9720000,2,10006,2503,1,140760000,140760000,3751,1250,2501,1250,0,1,1252,3173802
168,1250,3600,2700,9720000,2,10006,2503,1,140760000,140760000,3751,1250,2501,1250,0,1,1252,409330
168,1250,3600,2700,9720000,2,10006,2503,1,140760000,140760000,3751,1250,2501,1250,0,1,1252,401156
168,1250,3600,2700,9720000,2,10006,2503,1,140760000,140760000,3751,1250,2501,1250,0,1,1252,410198
168,1250,3600,2700,9720000,2,10006,2503,1,140760000,140760000,3751,1250,2501,1250,0,1,1252,409855
168,1250,3600,2700,9720000,2,10006,2503,1,140760000,140760000,3751,1250,2501,1250,0,1,1252,400394
168,1250,3600,2700,9720000,2,10006,2503,1,140760000,140760000,3751,1250,2501,1250,0,1,1252,382553

168,1650,3600,2700,9720000,2,13206,3303,1,160920000,160920000,4951,1650,3301,1650,0,1,1652,4119078
168,1650,3600,2700,9720000,2,13206,3303,1,160920000,160920000,4951,1650,3301,1650,0,1,1652,470015
168,1650,3600,2700,9720000,2,13206,3303,1,160920000,160920000,4951,1650,3301,1650,0,1,1652,469090
168,1650,3600,2700,9720000,2,13206,3303,1,160920000,160920000,4951,1650,3301,1650,0,1,1652,471029
168,1650,3600,2700,9720000,2,13206,3303,1,160920000,160920000,4951,1650,3301,1650,0,1,1652,429114
168,1650,3600,2700,9720000,2,13206,3303,1,160920000,160920000,4951,1650,3301,1650,0,1,1652,472152
168,1650,3600,2700,9720000,2,13206,3303,1,160920000,160920000,4951,1650,3301,1650,0,1,1652,471642

168,2050,3600,2700,9720000,2,16406,4103,1,181080000,181080000,6151,2050,4101,2050,0,1,2052,5599504
168,2050,3600,2700,9720000,2,16406,4103,1,181080000,181080000,6151,2050,4101,2050,0,1,2052,548783
168,2050,3600,2700,9720000,2,16406,4103,1,181080000,181080000,6151,2050,4101,2050,0,1,2052,552072
168,2050,3600,2700,9720000,2,16406,4103,1,181080000,181080000,6151,2050,4101,2050,0,1,2052,553299
168,2050,3600,2700,9720000,2,16406,4103,1,181080000,181080000,6151,2050,4101,2050,0,1,2052,551059
168,2050,3600,2700,9720000,2,16406,4103,1,181080000,181080000,6151,2050,4101,2050,0,1,2052,557403
168,2050,3600,2700,9720000,2,16406,4103,1,181080000,181080000,6151,2050,4101,2050,0,1,2052,556866

168,2450,3600,2700,9720000,2,19606,4903,1,201240000,201240000,7351,2450,4901,2450,0,1,2452,6588896
168,2450,3600,2700,9720000,2,19606,4903,1,201240000,201240000,7351,2450,4901,2450,0,1,2452,656362
168,2450,3600,2700,9720000,2,19606,4903,1,201240000,201240000,7351,2450,4901,2450,0,1,2452,658200
168,2450,3600,2700,9720000,2,19606,4903,1,201240000,201240000,7351,2450,4901,2450,0,1,2452,658685
168,2450,3600,2700,9720000,2,19606,4903,1,201240000,201240000,7351,2450,4901,2450,0,1,2452,657561
168,2450,3600,2700,9720000,2,19606,4903,1,201240000,201240000,7351,2450,4901,2450,0,1,2452,655628
168,2450,3600,2700,9720000,2,19606,4903,1,201240000,201240000,7351,2450,4901,2450,0,1,2452,654893

168,2850,3600,2700,9720000,2,22806,5703,1,221400000,221400000,8551,2850,5701,2850,0,1,2852,7886294
168,2850,3600,2700,9720000,2,22806,5703,1,221400000,221400000,8551,2850,5701,2850,0,1,2852,719805
168,2850,3600,2700,9720000,2,22806,5703,1,221400000,221400000,8551,2850,5701,2850,0,1,2852,754926
168,2850,3600,2700,9720000,2,22806,5703,1,221400000,221400000,8551,2850,5701,2850,0,1,2852,747306
168,2850,3600,2700,9720000,2,22806,5703,1,221400000,221400000,8551,2850,5701,2850,0,1,2852,755594
168,2850,3600,2700,9720000,2,22806,5703,1,221400000,221400000,8551,2850,5701,2850,0,1,2852,751324
168,2850,3600,2700,9720000,2,22806,5703,1,221400000,221400000,8551,2850,5701,2850,0,1,2852,756198

168,3250,3600,2700,9720000,2,26006,6503,1,241560000,241560000,9751,3250,6501,3250,0,1,3252,9053555
168,3250,3600,2700,9720000,2,26006,6503,1,241560000,241560000,9751,3250,6501,3250,0,1,3252,796252
168,3250,3600,2700,9720000,2,26006,6503,1,241560000,241560000,9751,3250,6501,3250,0,1,3252,799472
168,3250,3600,2700,9720000,2,26006,6503,1,241560000,241560000,9751,3250,6501,3250,0,1,3252,800773
168,3250,3600,2700,9720000,2,26006,6503,1,241560000,241560000,9751,3250,6501,3250,0,1,3252,800206
168,3250,3600,2700,9720000,2,26006,6503,1,241560000,241560000,9751,3250,6501,3250,0,1,3252,855719
168,3250,3600,2700,9720000,2,26006,6503,1,241560000,241560000,9751,3250,6501,3250,0,1,3252,855105

168,3650,3600,2700,9720000,2,29206,7303,1,261720000,261720000,10951,3650,7301,3650,0,1,3652,10310979
168,3650,3600,2700,9720000,2,29206,7303,1,261720000,261720000,10951,3650,7301,3650,0,1,3652,930220
168,3650,3600,2700,9720000,2,29206,7303,1,261720000,261720000,10951,3650,7301,3650,0,1,3652,918023
168,3650,3600,2700,9720000,2,29206,7303,1,261720000,261720000,10951,3650,7301,3650,0,1,3652,932559
168,3650,3600,2700,9720000,2,29206,7303,1,261720000,261720000,10951,3650,7301,3650,0,1,3652,928076
168,3650,3600,2700,9720000,2,29206,7303,1,261720000,261720000,10951,3650,7301,3650,0,1,3652,964876
168,3650,3600,2700,9720000,2,29206,7303,1,261720000,261720000,10951,3650,7301,3650,0,1,3652,949657

168,4050,3600,2700,9720000,2,32406,8103,1,281880000,281880000,12151,4050,8101,4050,0,1,4052,11064463
168,4050,3600,2700,9720000,2,32406,8103,1,281880000,281880000,12151,4050,8101,4050,0,1,4052,974034
168,4050,3600,2700,9720000,2,32406,8103,1,281880000,281880000,12151,4050,8101,4050,0,1,4052,974930
168,4050,3600,2700,9720000,2,32406,8103,1,281880000,281880000,12151,4050,8101,4050,0,1,4052,978130
168,4050,3600,2700,9720000,2,32406,8103,1,281880000,281880000,12151,4050,8101,4050,0,1,4052,977237
168,4050,3600,2700,9720000,2,32406,8103,1,281880000,281880000,12151,4050,8101,4050,0,1,4052,1029248
168,4050,3600,2700,9720000,2,32406,8103,1,281880000,281880000,12151,4050,8101,4050,0,1,4052,1028401

168,4450,3600,2700,9720000,2,35606,8903,1,302040000,302040000,13351,4450,8901,4450,0,1,4452,12512817
168,4450,3600,2700,9720000,2,35606,8903,1,302040000,302040000,13351,4450,8901,4450,0,1,4452,1099416
168,4450,3600,2700,9720000,2,35606,8903,1,302040000,302040000,13351,4450,8901,4450,0,1,4452,1097242
168,4450,3600,2700,9720000,2,35606,8903,1,302040000,302040000,13351,4450,8901,4450,0,1,4452,1101333
168,4450,3600,2700,9720000,2,35606,8903,1,302040000,302040000,13351,4450,8901,4450,0,1,4452,1094887
168,4450,3600,2700,9720000,2,35606,8903,1,302040000,302040000,13351,4450,8901,4450,0,1,4452,1122271
168,4450,3600,2700,9720000,2,35606,8903,1,302040000,302040000,13351,4450,8901,4450,0,1,4452,1129655

168,4850,3600,2700,9720000,2,38806,9703,1,322200000,322200000,14551,4850,9701,4850,0,1,4852,13753384
168,4850,3600,2700,9720000,2,38806,9703,1,322200000,322200000,14551,4850,9701,4850,0,1,4852,1199659
168,4850,3600,2700,9720000,2,38806,9703,1,322200000,322200000,14551,4850,9701,4850,0,1,4852,1197666
168,4850,3600,2700,9720000,2,38806,9703,1,322200000,322200000,14551,4850,9701,4850,0,1,4852,1203248
168,4850,3600,2700,9720000,2,38806,9703,1,322200000,322200000,14551,4850,9701,4850,0,1,4852,1201582
168,4850,3600,2700,9720000,2,38806,9703,1,322200000,322200000,14551,4850,9701,4850,0,1,4852,1212507
168,4850,3600,2700,9720000,2,38806,9703,1,322200000,322200000,14551,4850,9701,4850,0,1,4852,1211572

168,5250,3600,2700,9720000,2,42006,10503,1,342360000,342360000,15751,5250,10501,5250,0,1,5252,14902035
168,5250,3600,2700,9720000,2,42006,10503,1,342360000,342360000,15751,5250,10501,5250,0,1,5252,1300231
168,5250,3600,2700,9720000,2,42006,10503,1,342360000,342360000,15751,5250,10501,5250,0,1,5252,1333662
168,5250,3600,2700,9720000,2,42006,10503,1,342360000,342360000,15751,5250,10501,5250,0,1,5252,1334681
168,5250,3600,2700,9720000,2,42006,10503,1,342360000,342360000,15751,5250,10501,5250,0,1,5252,1321565
168,5250,3600,2700,9720000,2,42006,10503,1,342360000,342360000,15751,5250,10501,5250,0,1,5252,1336171
168,5250,3600,2700,9720000,2,42006,10503,1,342360000,342360000,15751,5250,10501,5250,0,1,5252,1331715

168,5650,3600,2700,9720000,2,45206,11303,1,362520000,362520000,16951,5650,11301,5650,0,1,5652,16381356
168,5650,3600,2700,9720000,2,45206,11303,1,362520000,362520000,16951,5650,11301,5650,0,1,5652,1366162
168,5650,3600,2700,9720000,2,45206,11303,1,362520000,362520000,16951,5650,11301,5650,0,1,5652,1374812
168,5650,3600,2700,9720000,2,45206,11303,1,362520000,362520000,16951,5650,11301,5650,0,1,5652,1377583
168,5650,3600,2700,9720000,2,45206,11303,1,362520000,362520000,16951,5650,11301,5650,0,1,5652,1371484
168,5650,3600,2700,9720000,2,45206,11303,1,362520000,362520000,16951,5650,11301,5650,0,1,5652,1383251
168,5650,3600,2700,9720000,2,45206,11303,1,362520000,362520000,16951,5650,11301,5650,0,1,5652,1390986

168,6050,3600,2700,9720000,2,48406,12103,1,382680000,382680000,18151,6050,12101,6050,0,1,6052,17169420
168,6050,3600,2700,9720000,2,48406,12103,1,382680000,382680000,18151,6050,12101,6050,0,1,6052,1516532
168,6050,3600,2700,9720000,2,48406,12103,1,382680000,382680000,18151,6050,12101,6050,0,1,6052,1508424
168,6050,3600,2700,9720000,2,48406,12103,1,382680000,382680000,18151,6050,12101,6050,0,1,6052,1517721
168,6050,3600,2700,9720000,2,48406,12103,1,382680000,382680000,18151,6050,12101,6050,0,1,6052,1515387
168,6050,3600,2700,9720000,2,48406,12103,1,382680000,382680000,18151,6050,12101,6050,0,1,6052,1509530
168,6050,3600,2700,9720000,2,48406,12103,1,382680000,382680000,18151,6050,12101,6050,0,1,6052,1494771

168,6450,3600,2700,9720000,2,51606,12903,1,402840000,402840000,19351,6450,12901,6450,0,1,6452,18453007
168,6450,3600,2700,9720000,2,51606,12903,1,402840000,402840000,19351,6450,12901,6450,0,1,6452,1608847
168,6450,3600,2700,9720000,2,51606,12903,1,402840000,402840000,19351,6450,12901,6450,0,1,6452,1607751
168,6450,3600,2700,9720000,2,51606,12903,1,402840000,402840000,19351,6450,12901,6450,0,1,6452,1611019
168,6450,3600,2700,9720000,2,51606,12903,1,402840000,402840000,19351,6450,12901,6450,0,1,6452,1606395
168,6450,3600,2700,9720000,2,51606,12903,1,402840000,402840000,19351,6450,12901,6450,0,1,6452,1590216
168,6450,3600,2700,9720000,2,51606,12903,1,402840000,402840000,19351,6450,12901,6450,0,1,6452,1596191

168,6850,3600,2700,9720000,2,54806,13703,1,423000000,423000000,20551,6850,13701,6850,0,1,6852,18017153
168,6850,3600,2700,9720000,2,54806,13703,1,423000000,423000000,20551,6850,13701,6850,0,1,6852,1659353
168,6850,3600,2700,9720000,2,54806,13703,1,423000000,423000000,20551,6850,13701,6850,0,1,6852,1662210
168,6850,3600,2700,9720000,2,54806,13703,1,423000000,423000000,20551,6850,13701,6850,0,1,6852,1663443
168,6850,3600,2700,9720000,2,54806,13703,1,423000000,423000000,20551,6850,13701,6850,0,1,6852,1661157
168,6850,3600,2700,9720000,2,54806,13703,1,423000000,423000000,20551,6850,13701,6850,0,1,6852,1654196
168,6850,3600,2700,9720000,2,54806,13703,1,423000000,423000000,20551,6850,13701,6850,0,1,6852,1652194

168,50,3600,2300,8280000,2,406,103,1,68600000,68600000,151,50,101,50,0,1,52,89610
168,50,3600,2300,8280000,2,406,103,1,68600000,68600000,151,50,101,50,0,1,52,84652
168,50,3600,2300,8280000,2,406,103,1,68600000,68600000,151,50,101,50,0,1,52,86042
168,50,3600,2300,8280000,2,406,103,1,68600000,68600000,151,50,101,50,0,1,52,85585
168,50,3600,2300,8280000,2,406,103,1,68600000,68600000,151,50,101,50,0,1,52,77509
168,50,3600,2300,8280000,2,406,103,1,68600000,68600000,151,50,101,50,0,1,52,104404
168,50,3600,2300,8280000,2,406,103,1,68600000,68600000,151,50,101,50,0,1,52,106771

168,450,3600,2300,8280000,2,3606,903,1,87480000,87480000,1351,450,901,450,0,1,452,817689
168,450,3600,2300,8280000,2,3606,903,1,87480000,87480000,1351,450,901,450,0,1,452,155373
168,450,3600,2300,8280000,2,3606,903,1,87480000,87480000,1351,450,901,450,0,1,452,154064
168,450,3600,2300,8280000,2,3606,903,1,87480000,87480000,1351,450,901,450,0,1,452,155118
168,450,3600,2300,8280000,2,3606,903,1,87480000,87480000,1351,450,901,450,0,1,452,154645
168,450,3600,2300,8280000,2,3606,903,1,87480000,87480000,1351,450,901,450,0,1,452,181317
168,450,3600,2300,8280000,2,3606,903,1,87480000,87480000,1351,450,901,450,0,1,452,180053

168,850,3600,2300,8280000,2,6806,1703,1,106360000,106360000,2551,850,1701,850,0,1,852,1742587
168,850,3600,2300,8280000,2,6806,1703,1,106360000,106360000,2551,850,1701,850,0,1,852,243728
168,850,3600,2300,8280000,2,6806,1703,1,106360000,106360000,2551,850,1701,850,0,1,852,242744
168,850,3600,2300,8280000,2,6806,1703,1,106360000,106360000,2551,850,1701,850,0,1,852,243278
168,850,3600,2300,8280000,2,6806,1703,1,106360000,106360000,2551,850,1701,850,0,1,852,241414
168,850,3600,2300,8280000,2,6806,1703,1,106360000,106360000,2551,850,1701,850,0,1,852,246122
168,850,3600,2300,8280000,2,6806,1703,1,106360000,106360000,2551,850,1701,850,0,1,852,245676

168,1250,3600,2300,8280000,2,10006,2503,1,125240000,125240000,3751,1250,2501,1250,0,1,1252,2661688
168,1250,3600,2300,8280000,2,10006,2503,1,125240000,125240000,3751,1250,2501,1250,0,1,1252,350629
168,1250,3600,2300,8280000,2,10006,2503,1,125240000,125240000,3751,1250,2501,1250,0,1,1252,350927
168,1250,3600,2300,8280000,2,10006,2503,1,125240000,125240000,3751,1250,2501,1250,0,1,1252,349828
168,1250,3600,2300,8280000,2,10006,2503,1,125240000,125240000,3751,1250,2501,1250,0,1,1252,351685
168,1250,3600,2300,8280000,2,10006,2503,1,125240000,125240000,3751,1250,2501,1250,0,1,1252,344093
168,1250,3600,2300,8280000,2,10006,2503,1,125240000,125240000,3751,1250,2501,1250,0,1,1252,329033

168,1650,3600,2300,8280000,2,13206,3303,1,144120000,144120000,4951,1650,3301,1650,0,1,1652,3569316
168,1650,3600,2300,8280000,2,13206,3303,1,144120000,144120000,4951,1650,3301,1650,0,1,1652,412820
168,1650,3600,2300,8280000,2,13206,3303,1,144120000,144120000,4951,1650,3301,1650,0,1,1652,407174
168,1650,3600,2300,8280000,2,13206,3303,1,144120000,144120000,4951,1650,3301,1650,0,1,1652,413375
168,1650,3600,2300,8280000,2,13206,3303,1,144120000,144120000,4951,1650,3301,1650,0,1,1652,413756
168,1650,3600,2300,8280000,2,13206,3303,1,144120000,144120000,4951,1650,3301,1650,0,1,1652,412399
168,1650,3600,2300,8280000,2,13206,3303,1,144120000,144120000,4951,1650,3301,1650,0,1,1652,411915

168,2050,3600,2300,8280000,2,16406,4103,1,163000000,163000000,6151,2050,4101,2050,0,1,2052,4509132
168,2050,3600,2300,8280000,2,16406,4103,1,163000000,163000000,6151,2050,4101,2050,0,1,2052,478911
168,2050,3600,2300,8280000,2,16406,4103,1,163000000,163000000,6151,2050,4101,2050,0,1,2052,476621
168,2050,3600,2300,8280000,2,16406,4103,1,163000000,163000000,6151,2050,4101,2050,0,1,2052,480194
168,2050,3600,2300,8280000,2,16406,4103,1,163000000,163000000,6151,2050,4101,2050,0,1,2052,481385
168,2050,3600,2300,8280000,2,16406,4103,1,163000000,163000000,6151,2050,4101,2050,0,1,2052,482967
168,2050,3600,2300,8280000,2,16406,4103,1,163000000,163000000,6151,2050,4101,2050,0,1,2052,483504

168,2450,3600,2300,8280000,2,19606,4903,1,181880000,181880000,7351,2450,4901,2450,0,1,2452,5759810
168,2450,3600,2300,8280000,2,19606,4903,1,181880000,181880000,7351,2450,4901,2450,0,1,2452,559859
168,2450,3600,2300,8280000,2,19606,4903,1,181880000,181880000,7351,2450,4901,2450,0,1,2452,553598
168,2450,3600,2300,8280000,2,19606,4903,1,181880000,181880000,7351,2450,4901,2450,0,1,2452,558202
168,2450,3600,2300,8280000,2,19606,4903,1,181880000,181880000,7351,2450,4901,2450,0,1,2452,558850
168,2450,3600,2300,8280000,2,19606,4903,1,181880000,181880000,7351,2450,4901,2450,0,1,2452,561486
168,2450,3600,2300,8280000,2,19606,4903,1,181880000,181880000,7351,2450,4901,2450,0,1,2452,562050

168,2850,3600,2300,8280000,2,22806,5703,1,200760000,200760000,8551,2850,5701,2850,0,1,2852,6488451
168,2850,3600,2300,8280000,2,22806,5703,1,200760000,200760000,8551,2850,5701,2850,0,1,2852,610905
168,2850,3600,2300,8280000,2,22806,5703,1,200760000,200760000,8551,2850,5701,2850,0,1,2852,614690
168,2850,3600,2300,8280000,2,22806,5703,1,200760000,200760000,8551,2850,5701,2850,0,1,2852,615650
168,2850,3600,2300,8280000,2,22806,5703,1,200760000,200760000,8551,2850,5701,2850,0,1,2852,616841
168,2850,3600,2300,8280000,2,22806,5703,1,200760000,200760000,8551,2850,5701,2850,0,1,2852,638219
168,2850,3600,2300,8280000,2,22806,5703,1,200760000,200760000,8551,2850,5701,2850,0,1,2852,660888

168,3250,3600,2300,8280000,2,26006,6503,1,219640000,219640000,9751,3250,6501,3250,0,1,3252,7920239
168,3250,3600,2300,8280000,2,26006,6503,1,219640000,219640000,9751,3250,6501,3250,0,1,3252,684702
168,3250,3600,2300,8280000,2,26006,6503,1,219640000,219640000,9751,3250,6501,3250,0,1,3252,687484
168,3250,3600,2300,8280000,2,26006,6503,1,219640000,219640000,9751,3250,6501,3250,0,1,3252,688775
168,3250,3600,2300,8280000,2,26006,6503,1,219640000,219640000,9751,3250,6501,3250,0,1,3252,688208
168,3250,3600,2300,8280000,2,26006,6503,1,219640000,219640000,9751,3250,6501,3250,0,1,3252,730060
168,3250,3600,2300,8280000,2,26006,6503,1,219640000,219640000,9751,3250,6501,3250,0,1,3252,730703

168,3650,3600,2300,8280000,2,29206,7303,1,238520000,238520000,10951,3650,7301,3650,0,1,3652,8372220
168,3650,3600,2300,8280000,2,29206,7303,1,238520000,238520000,10951,3650,7301,3650,0,1,3652,778763
168,3650,3600,2300,8280000,2,29206,7303,1,238520000,238520000,10951,3650,7301,3650,0,1,3652,781523
168,3650,3600,2300,8280000,2,29206,7303,1,238520000,238520000,10951,3650,7301,3650,0,1,3652,782378
168,3650,3600,2300,8280000,2,29206,7303,1,238520000,238520000,10951,3650,7301,3650,0,1,3652,780614
168,3650,3600,2300,8280000,2,29206,7303,1,238520000,238520000,10951,3650,7301,3650,0,1,3652,826440
168,3650,3600,2300,8280000,2,29206,7303,1,238520000,238520000,10951,3650,7301,3650,0,1,3652,825760

168,4050,3600,2300,8280000,2,32406,8103,1,257400000,257400000,12151,4050,8101,4050,0,1,4052,9641532
168,4050,3600,2300,8280000,2,32406,8103,1,257400000,257400000,12151,4050,8101,4050,0,1,4052,905506
168,4050,3600,2300,8280000,2,32406,8103,1,257400000,257400000,12151,4050,8101,4050,0,1,4052,881271
168,4050,3600,2300,8280000,2,32406,8103,1,257400000,257400000,12151,4050,8101,4050,0,1,4052,899268
168,4050,3600,2300,8280000,2,32406,8103,1,257400000,257400000,12151,4050,8101,4050,0,1,4052,903202
168,4050,3600,2300,8280000,2,32406,8103,1,257400000,257400000,12151,4050,8101,4050,0,1,4052,928260
168,4050,3600,2300,8280000,2,32406,8103,1,257400000,257400000,12151,4050,8101,4050,0,1,4052,922348

168,4450,3600,2300,8280000,2,35606,8903,1,276280000,276280000,13351,4450,8901,4450,0,1,4452,10425806
168,4450,3600,2300,8280000,2,35606,8903,1,276280000,276280000,13351,4450,8901,4450,0,1,4452,942770
168,4450,3600,2300,8280000,2,35606,8903,1,276280000,276280000,13351,4450,8901,4450,0,1,4452,944232
168,4450,3600,2300,8280000,2,35606,8903,1,276280000,276280000,13351,4450,8901,4450,0,1,4452,946045
168,4450,3600,2300,8280000,2,35606,8903,1,276280000,276280000,13351,4450,8901,4450,0,1,4452,939894
168,4450,3600,2300,8280000,2,35606,8903,1,276280000,276280000,13351,4450,8901,4450,0,1,4452,971586
168,4450,3600,2300,8280000,2,35606,8903,1,276280000,276280000,13351,4450,8901,4450,0,1,4452,972304

168,4850,3600,2300,8280000,2,38806,9703,1,295160000,295160000,14551,4850,9701,4850,0,1,4852,11181405
168,4850,3600,2300,8280000,2,38806,9703,1,295160000,295160000,14551,4850,9701,4850,0,1,4852,1013350
168,4850,3600,2300,8280000,2,38806,9703,1,295160000,295160000,14551,4850,9701,4850,0,1,4852,1010522
168,4850,3600,2300,8280000,2,38806,9703,1,295160000,295160000,14551,4850,9701,4850,0,1,4852,1014602
168,4850,3600,2300,8280000,2,38806,9703,1,295160000,295160000,14551,4850,9701,4850,0,1,4852,1011956
168,4850,3600,2300,8280000,2,38806,9703,1,295160000,295160000,14551,4850,9701,4850,0,1,4852,1046448
168,4850,3600,2300,8280000,2,38806,9703,1,295160000,295160000,14551,4850,9701,4850,0,1,4852,1060353

168,5250,3600,2300,8280000,2,42006,10503,1,314040000,314040000,15751,5250,10501,5250,0,1,5252,12404957
168,5250,3600,2300,8280000,2,42006,10503,1,314040000,314040000,15751,5250,10501,5250,0,1,5252,1132861
168,5250,3600,2300,8280000,2,42006,10503,1,314040000,314040000,15751,5250,10501,5250,0,1,5252,1125210
168,5250,3600,2300,8280000,2,42006,10503,1,314040000,314040000,15751,5250,10501,5250,0,1,5252,1140636
168,5250,3600,2300,8280000,2,42006,10503,1,314040000,314040000,15751,5250,10501,5250,0,1,5252,1138413
168,5250,3600,2300,8280000,2,42006,10503,1,314040000,314040000,15751,5250,10501,5250,0,1,5252,1145938
168,5250,3600,2300,8280000,2,42006,10503,1,314040000,314040000,15751,5250,10501,5250,0,1,5252,1146736

168,5650,3600,2300,8280000,2,45206,11303,1,332920000,332920000,16951,5650,11301,5650,0,1,5652,13392973
168,5650,3600,2300,8280000,2,45206,11303,1,332920000,332920000,16951,5650,11301,5650,0,1,5652,1243281
168,5650,3600,2300,8280000,2,45206,11303,1,332920000,332920000,16951,5650,11301,5650,0,1,5652,1248692
168,5650,3600,2300,8280000,2,45206,11303,1,332920000,332920000,16951,5650,11301,5650,0,1,5652,1246121
168,5650,3600,2300,8280000,2,45206,11303,1,332920000,332920000,16951,5650,11301,5650,0,1,5652,1233931
168,5650,3600,2300,8280000,2,45206,11303,1,332920000,332920000,16951,5650,11301,5650,0,1,5652,1250144
168,5650,3600,2300,8280000,2,45206,11303,1,332920000,332920000,16951,5650,11301,5650,0,1,5652,1247632

168,6050,3600,2300,8280000,2,48406,12103,1,351800000,351800000,18151,6050,12101,6050,0,1,6052,14759620
168,6050,3600,2300,8280000,2,48406,12103,1,351800000,351800000,18151,6050,12101,6050,0,1,6052,1319592
168,6050,3600,2300,8280000,2,48406,12103,1,351800000,351800000,18151,6050,12101,6050,0,1,6052,1316196
168,6050,3600,2300,8280000,2,48406,12103,1,351800000,351800000,18151,6050,12101,6050,0,1,6052,1320625
168,6050,3600,2300,8280000,2,48406,12103,1,351800000,351800000,18151,6050,12101,6050,0,1,6052,1317758
168,6050,3600,2300,8280000,2,48406,12103,1,351800000,351800000,18151,6050,12101,6050,0,1,6052,1314621
168,6050,3600,2300,8280000,2,48406,12103,1,351800000,351800000,18151,6050,12101,6050,0,1,6052,1321501

168,6450,3600,2300,8280000,2,51606,12903,1,370680000,370680000,19351,6450,12901,6450,0,1,6452,15300729
168,6450,3600,2300,8280000,2,51606,12903,1,370680000,370680000,19351,6450,12901,6450,0,1,6452,1352019
168,6450,3600,2300,8280000,2,51606,12903,1,370680000,370680000,19351,6450,12901,6450,0,1,6452,1348266
168,6450,3600,2300,8280000,2,51606,12903,1,370680000,370680000,19351,6450,12901,6450,0,1,6452,1356725
168,6450,3600,2300,8280000,2,51606,12903,1,370680000,370680000,19351,6450,12901,6450,0,1,6452,1355137
168,6450,3600,2300,8280000,2,51606,12903,1,370680000,370680000,19351,6450,12901,6450,0,1,6452,1360499
168,6450,3600,2300,8280000,2,51606,12903,1,370680000,370680000,19351,6450,12901,6450,0,1,6452,1359610

168,6850,3600,2300,8280000,2,54806,13703,1,389560000,389560000,20551,6850,13701,6850,0,1,6852,16230114
168,6850,3600,2300,8280000,2,54806,13703,1,389560000,389560000,20551,6850,13701,6850,0,1,6852,1482492
168,6850,3600,2300,8280000,2,54806,13703,1,389560000,389560000,20551,6850,13701,6850,0,1,6852,1489497
168,6850,3600,2300,8280000,2,54806,13703,1,389560000,389560000,20551,6850,13701,6850,0,1,6852,1497426
168,6850,3600,2300,8280000,2,54806,13703,1,389560000,389560000,20551,6850,13701,6850,0,1,6852,1494499
168,6850,3600,2300,8280000,2,54806,13703,1,389560000,389560000,20551,6850,13701,6850,0,1,6852,1484442
168,6850,3600,2300,8280000,2,54806,13703,1,389560000,389560000,20551,6850,13701,6850,0,1,6852,1463541

168,50,3600,1900,6840000,2,406,103,1,56920000,56920000,151,50,101,50,0,1,52,72128
168,50,3600,1900,6840000,2,406,103,1,56920000,56920000,151,50,101,50,0,1,52,73928
168,50,3600,1900,6840000,2,406,103,1,56920000,56920000,151,50,101,50,0,1,52,63651
168,50,3600,1900,6840000,2,406,103,1,56920000,56920000,151,50,101,50,0,1,52,71752
168,50,3600,1900,6840000,2,406,103,1,56920000,56920000,151,50,101,50,0,1,52,73473
168,50,3600,1900,6840000,2,406,103,1,56920000,56920000,151,50,101,50,0,1,52,89599
168,50,3600,1900,6840000,2,406,103,1,56920000,56920000,151,50,101,50,0,1,52,89121

168,450,3600,1900,6840000,2,3606,903,1,74520000,74520000,1351,450,901,450,0,1,452,706514
168,450,3600,1900,6840000,2,3606,903,1,74520000,74520000,1351,450,901,450,0,1,452,125766
168,450,3600,1900,6840000,2,3606,903,1,74520000,74520000,1351,450,901,450,0,1,452,126270
168,450,3600,1900,6840000,2,3606,903,1,74520000,74520000,1351,450,901,450,0,1,452,113031
168,450,3600,1900,6840000,2,3606,903,1,74520000,74520000,1351,450,901,450,0,1,452,120003
168,450,3600,1900,6840000,2,3606,903,1,74520000,74520000,1351,450,901,450,0,1,452,151738
168,450,3600,1900,6840000,2,3606,903,1,74520000,74520000,1351,450,901,450,0,1,452,151200

168,850,3600,1900,6840000,2,6806,1703,1,92120000,92120000,2551,850,1701,850,0,1,852,1445329
168,850,3600,1900,6840000,2,6806,1703,1,92120000,92120000,2551,850,1701,850,0,1,852,198493
168,850,3600,1900,6840000,2,6806,1703,1,92120000,92120000,2551,850,1701,850,0,1,852,197380
168,850,3600,1900,6840000,2,6806,1703,1,92120000,92120000,2551,850,1701,850,0,1,852,197978
168,850,3600,1900,6840000,2,6806,1703,1,92120000,92120000,2551,850,1701,850,0,1,852,198794
168,850,3600,1900,6840000,2,6806,1703,1,92120000,92120000,2551,850,1701,850,0,1,852,209654
168,850,3600,1900,6840000,2,6806,1703,1,92120000,92120000,2551,850,1701,850,0,1,852,210087

168,1250,3600,1900,6840000,2,10006,2503,1,109720000,109720000,3751,1250,2501,1250,0,1,1252,2092590
168,1250,3600,1900,6840000,2,10006,2503,1,109720000,109720000,3751,1250,2501,1250,0,1,1252,265273
168,1250,3600,1900,6840000,2,10006,2503,1,109720000,109720000,3751,1250,2501,1250,0,1,1252,274209
168,1250,3600,1900,6840000,2,10006,2503,1,109720000,109720000,3751,1250,2501,1250,0,1,1252,275823
168,1250,3600,1900,6840000,2,10006,2503,1,109720000,109720000,3751,1250,2501,1250,0,1,1252,277668
168,1250,3600,1900,6840000,2,10006,2503,1,109720000,109720000,3751,1250,2501,1250,0,1,1252,278291
168,1250,3600,1900,6840000,2,10006,2503,1,109720000,109720000,3751,1250,2501,1250,0,1,1252,278035

168,1650,3600,1900,6840000,2,13206,3303,1,127320000,127320000,4951,1650,3301,1650,0,1,1652,2906051
168,1650,3600,1900,6840000,2,13206,3303,1,127320000,127320000,4951,1650,3301,1650,0,1,1652,344066
168,1650,3600,1900,6840000,2,13206,3303,1,127320000,127320000,4951,1650,3301,1650,0,1,1652,344545
168,1650,3600,1900,6840000,2,13206,3303,1,127320000,127320000,4951,1650,3301,1650,0,1,1652,316774
168,1650,3600,1900,6840000,2,13206,3303,1,127320000,127320000,4951,1650,3301,1650,0,1,1652,337580
168,1650,3600,1900,6840000,2,13206,3303,1,127320000,127320000,4951,1650,3301,1650,0,1,1652,345044
168,1650,3600,1900,6840000,2,13206,3303,1,127320000,127320000,4951,1650,3301,1650,0,1,1652,346883

168,2050,3600,1900,6840000,2,16406,4103,1,144920000,144920000,6151,2050,4101,2050,0,1,2052,3676432
168,2050,3600,1900,6840000,2,16406,4103,1,144920000,144920000,6151,2050,4101,2050,0,1,2052,401095
168,2050,3600,1900,6840000,2,16406,4103,1,144920000,144920000,6151,2050,4101,2050,0,1,2052,411284
168,2050,3600,1900,6840000,2,16406,4103,1,144920000,144920000,6151,2050,4101,2050,0,1,2052,414525
168,2050,3600,1900,6840000,2,16406,4103,1,144920000,144920000,6151,2050,4101,2050,0,1,2052,414955
168,2050,3600,1900,6840000,2,16406,4103,1,144920000,144920000,6151,2050,4101,2050,0,1,2052,413915
168,2050,3600,1900,6840000,2,16406,4103,1,144920000,144920000,6151,2050,4101,2050,0,1,2052,412880

168,2450,3600,1900,6840000,2,19606,4903,1,162520000,162520000,7351,2450,4901,2450,0,1,2452,4518453
168,2450,3600,1900,6840000,2,19606,4903,1,162520000,162520000,7351,2450,4901,2450,0,1,2452,469323
168,2450,3600,1900,6840000,2,19606,4903,1,162520000,162520000,7351,2450,4901,2450,0,1,2452,470913
168,2450,3600,1900,6840000,2,19606,4903,1,162520000,162520000,7351,2450,4901,2450,0,1,2452,470447
168,2450,3600,1900,6840000,2,19606,4903,1,162520000,162520000,7351,2450,4901,2450,0,1,2452,465698
168,2450,3600,1900,6840000,2,19606,4903,1,162520000,162520000,7351,2450,4901,2450,0,1,2452,472520
168,2450,3600,1900,6840000,2,19606,4903,1,162520000,162520000,7351,2450,4901,2450,0,1,2452,473092

168,2850,3600,1900,6840000,2,22806,5703,1,180120000,180120000,8551,2850,5701,2850,0,1,2852,5271404
168,2850,3600,1900,6840000,2,22806,5703,1,180120000,180120000,8551,2850,5701,2850,0,1,2852,521929
168,2850,3600,1900,6840000,2,22806,5703,1,180120000,180120000,8551,2850,5701,2850,0,1,2852,525091
168,2850,3600,1900,6840000,2,22806,5703,1,180120000,180120000,8551,2850,5701,2850,0,1,2852,526601
168,2850,3600,1900,6840000,2,22806,5703,1,180120000,180120000,8551,2850,5701,2850,0,1,2852,528102
168,2850,3600,1900,6840000,2,22806,5703,1,180120000,180120000,8551,2850,5701,2850,0,1,2852,540945
168,2850,3600,1900,6840000,2,22806,5703,1,180120000,180120000,8551,2850,5701,2850,0,1,2852,540348

168,3250,3600,1900,6840000,2,26006,6503,1,197720000,197720000,9751,3250,6501,3250,0,1,3252,6065133
168,3250,3600,1900,6840000,2,26006,6503,1,197720000,197720000,9751,3250,6501,3250,0,1,3252,645666
168,3250,3600,1900,6840000,2,26006,6503,1,197720000,197720000,9751,3250,6501,3250,0,1,3252,628781
168,3250,3600,1900,6840000,2,26006,6503,1,197720000,197720000,9751,3250,6501,3250,0,1,3252,644574
168,3250,3600,1900,6840000,2,26006,6503,1,197720000,197720000,9751,3250,6501,3250,0,1,3252,646407
168,3250,3600,1900,6840000,2,26006,6503,1,197720000,197720000,9751,3250,6501,3250,0,1,3252,649204
168,3250,3600,1900,6840000,2,26006,6503,1,197720000,197720000,9751,3250,6501,3250,0,1,3252,647882

168,3650,3600,1900,6840000,2,29206,7303,1,215320000,215320000,10951,3650,7301,3650,0,1,3652,6830800
168,3650,3600,1900,6840000,2,29206,7303,1,215320000,215320000,10951,3650,7301,3650,0,1,3652,649080
168,3650,3600,1900,6840000,2,29206,7303,1,215320000,215320000,10951,3650,7301,3650,0,1,3652,651880
168,3650,3600,1900,6840000,2,29206,7303,1,215320000,215320000,10951,3650,7301,3650,0,1,3652,652737
168,3650,3600,1900,6840000,2,29206,7303,1,215320000,215320000,10951,3650,7301,3650,0,1,3652,650852
168,3650,3600,1900,6840000,2,29206,7303,1,215320000,215320000,10951,3650,7301,3650,0,1,3652,691648
168,3650,3600,1900,6840000,2,29206,7303,1,215320000,215320000,10951,3650,7301,3650,0,1,3652,692320

168,4050,3600,1900,6840000,2,32406,8103,1,232920000,232920000,12151,4050,8101,4050,0,1,4052,7680231
168,4050,3600,1900,6840000,2,32406,8103,1,232920000,232920000,12151,4050,8101,4050,0,1,4052,714480
168,4050,3600,1900,6840000,2,32406,8103,1,232920000,232920000,12151,4050,8101,4050,0,1,4052,713125
168,4050,3600,1900,6840000,2,32406,8103,1,232920000,232920000,12151,4050,8101,4050,0,1,4052,715611
168,4050,3600,1900,6840000,2,32406,8103,1,232920000,232920000,12151,4050,8101,4050,0,1,4052,716492
168,4050,3600,1900,6840000,2,32406,8103,1,232920000,232920000,12151,4050,8101,4050,0,1,4052,762552
168,4050,3600,1900,6840000,2,32406,8103,1,232920000,232920000,12151,4050,8101,4050,0,1,4052,763241

168,4450,3600,1900,6840000,2,35606,8903,1,250520000,250520000,13351,4450,8901,4450,0,1,4452,8592574
168,4450,3600,1900,6840000,2,35606,8903,1,250520000,250520000,13351,4450,8901,4450,0,1,4452,777282
168,4450,3600,1900,6840000,2,35606,8903,1,250520000,250520000,13351,4450,8901,4450,0,1,4452,775867
168,4450,3600,1900,6840000,2,35606,8903,1,250520000,250520000,13351,4450,8901,4450,0,1,4452,779016
168,4450,3600,1900,6840000,2,35606,8903,1,250520000,250520000,13351,4450,8901,4450,0,1,4452,778069
168,4450,3600,1900,6840000,2,35606,8903,1,250520000,250520000,13351,4450,8901,4450,0,1,4452,825076
168,4450,3600,1900,6840000,2,35606,8903,1,250520000,250520000,13351,4450,8901,4450,0,1,4452,848994

168,4850,3600,1900,6840000,2,38806,9703,1,268120000,268120000,14551,4850,9701,4850,0,1,4852,9281615
168,4850,3600,1900,6840000,2,38806,9703,1,268120000,268120000,14551,4850,9701,4850,0,1,4852,867555
168,4850,3600,1900,6840000,2,38806,9703,1,268120000,268120000,14551,4850,9701,4850,0,1,4852,860228
168,4850,3600,1900,6840000,2,38806,9703,1,268120000,268120000,14551,4850,9701,4850,0,1,4852,869643
168,4850,3600,1900,6840000,2,38806,9703,1,268120000,268120000,14551,4850,9701,4850,0,1,4852,862905
168,4850,3600,1900,6840000,2,38806,9703,1,268120000,268120000,14551,4850,9701,4850,0,1,4852,897801
168,4850,3600,1900,6840000,2,38806,9703,1,268120000,268120000,14551,4850,9701,4850,0,1,4852,898561

168,5250,3600,1900,6840000,2,42006,10503,1,285720000,285720000,15751,5250,10501,5250,0,1,5252,10438012
168,5250,3600,1900,6840000,2,42006,10503,1,285720000,285720000,15751,5250,10501,5250,0,1,5252,949844
168,5250,3600,1900,6840000,2,42006,10503,1,285720000,285720000,15751,5250,10501,5250,0,1,5252,933896
168,5250,3600,1900,6840000,2,42006,10503,1,285720000,285720000,15751,5250,10501,5250,0,1,5252,976480
168,5250,3600,1900,6840000,2,42006,10503,1,285720000,285720000,15751,5250,10501,5250,0,1,5252,973780
168,5250,3600,1900,6840000,2,42006,10503,1,285720000,285720000,15751,5250,10501,5250,0,1,5252,990729
168,5250,3600,1900,6840000,2,42006,10503,1,285720000,285720000,15751,5250,10501,5250,0,1,5252,981840

168,5650,3600,1900,6840000,2,45206,11303,1,303320000,303320000,16951,5650,11301,5650,0,1,5652,11626606
168,5650,3600,1900,6840000,2,45206,11303,1,303320000,303320000,16951,5650,11301,5650,0,1,5652,983829
168,5650,3600,1900,6840000,2,45206,11303,1,303320000,303320000,16951,5650,11301,5650,0,1,5652,988402
168,5650,3600,1900,6840000,2,45206,11303,1,303320000,303320000,16951,5650,11301,5650,0,1,5652,990447
168,5650,3600,1900,6840000,2,45206,11303,1,303320000,303320000,16951,5650,11301,5650,0,1,5652,992203
168,5650,3600,1900,6840000,2,45206,11303,1,303320000,303320000,16951,5650,11301,5650,0,1,5652,1014482
168,5650,3600,1900,6840000,2,45206,11303,1,303320000,303320000,16951,5650,11301,5650,0,1,5652,1015278

168,6050,3600,1900,6840000,2,48406,12103,1,320920000,320920000,18151,6050,12101,6050,0,1,6052,11898238
168,6050,3600,1900,6840000,2,48406,12103,1,320920000,320920000,18151,6050,12101,6050,0,1,6052,1074147
168,6050,3600,1900,6840000,2,48406,12103,1,320920000,320920000,18151,6050,12101,6050,0,1,6052,1070044
168,6050,3600,1900,6840000,2,48406,12103,1,320920000,320920000,18151,6050,12101,6050,0,1,6052,1082367
168,6050,3600,1900,6840000,2,48406,12103,1,320920000,320920000,18151,6050,12101,6050,0,1,6052,1079554
168,6050,3600,1900,6840000,2,48406,12103,1,320920000,320920000,18151,6050,12101,6050,0,1,6052,1091594
168,6050,3600,1900,6840000,2,48406,12103,1,320920000,320920000,18151,6050,12101,6050,0,1,6052,1103965

168,6450,3600,1900,6840000,2,51606,12903,1,338520000,338520000,19351,6450,12901,6450,0,1,6452,12775092
168,6450,3600,1900,6840000,2,51606,12903,1,338520000,338520000,19351,6450,12901,6450,0,1,6452,1138995
168,6450,3600,1900,6840000,2,51606,12903,1,338520000,338520000,19351,6450,12901,6450,0,1,6452,1144217
168,6450,3600,1900,6840000,2,51606,12903,1,338520000,338520000,19351,6450,12901,6450,0,1,6452,1148959
168,6450,3600,1900,6840000,2,51606,12903,1,338520000,338520000,19351,6450,12901,6450,0,1,6452,1146690
168,6450,3600,1900,6840000,2,51606,12903,1,338520000,338520000,19351,6450,12901,6450,0,1,6452,1153165
168,6450,3600,1900,6840000,2,51606,12903,1,338520000,338520000,19351,6450,12901,6450,0,1,6452,1152272

168,6850,3600,1900,6840000,2,54806,13703,1,356120000,356120000,20551,6850,13701,6850,0,1,6852,13354081
168,6850,3600,1900,6840000,2,54806,13703,1,356120000,356120000,20551,6850,13701,6850,0,1,6852,1279337
168,6850,3600,1900,6840000,2,54806,13703,1,356120000,356120000,20551,6850,13701,6850,0,1,6852,1269940
168,6850,3600,1900,6840000,2,54806,13703,1,356120000,356120000,20551,6850,13701,6850,0,1,6852,1278065
168,6850,3600,1900,6840000,2,54806,13703,1,356120000,356120000,20551,6850,13701,6850,0,1,6852,1275024
168,6850,3600,1900,6840000,2,54806,13703,1,356120000,356120000,20551,6850,13701,6850,0,1,6852,1256793
168,6850,3600,1900,6840000,2,54806,13703,1,356120000,356120000,20551,6850,13701,6850,0,1,6852,1241231

168,50,3600,1500,5400000,2,406,103,1,45240000,45240000,151,50,101,50,0,1,52,55654
168,50,3600,1500,5400000,2,406,103,1,45240000,45240000,151,50,101,50,0,1,52,53899
168,50,3600,1500,5400000,2,406,103,1,45240000,45240000,151,50,101,50,0,1,52,52833
168,50,3600,1500,5400000,2,406,103,1,45240000,45240000,151,50,101,50,0,1,52,52426
168,50,3600,1500,5400000,2,406,103,1,45240000,45240000,151,50,101,50,0,1,52,47153
168,50,3600,1500,5400000,2,406,103,1,45240000,45240000,151,50,101,50,0,1,52,70110
168,50,3600,1500,5400000,2,406,103,1,45240000,45240000,151,50,101,50,0,1,52,68358

168,450,3600,1500,5400000,2,3606,903,1,61560000,61560000,1351,450,901,450,0,1,452,580232
168,450,3600,1500,5400000,2,3606,903,1,61560000,61560000,1351,450,901,450,0,1,452,96380
168,450,3600,1500,5400000,2,3606,903,1,61560000,61560000,1351,450,901,450,0,1,452,101359
168,450,3600,1500,5400000,2,3606,903,1,61560000,61560000,1351,450,901,450,0,1,452,101864
168,450,3600,1500,5400000,2,3606,903,1,61560000,61560000,1351,450,901,450,0,1,452,95710
168,450,3600,1500,5400000,2,3606,903,1,61560000,61560000,1351,450,901,450,0,1,452,122516
168,450,3600,1500,5400000,2,3606,903,1,61560000,61560000,1351,450,901,450,0,1,452,123755

168,850,3600,1500,5400000,2,6806,1703,1,77880000,77880000,2551,850,1701,850,0,1,852,1120890
168,850,3600,1500,5400000,2,6806,1703,1,77880000,77880000,2551,850,1701,850,0,1,852,162543
168,850,3600,1500,5400000,2,6806,1703,1,77880000,77880000,2551,850,1701,850,0,1,852,162838
168,850,3600,1500,5400000,2,6806,1703,1,77880000,77880000,2551,850,1701,850,0,1,852,161389
168,850,3600,1500,5400000,2,6806,1703,1,77880000,77880000,2551,850,1701,850,0,1,852,161992
168,850,3600,1500,5400000,2,6806,1703,1,77880000,77880000,2551,850,1701,850,0,1,852,182045
168,850,3600,1500,5400000,2,6806,1703,1,77880000,77880000,2551,850,1701,850,0,1,852,181435

168,1250,3600,1500,5400000,2,10006,2503,1,94200000,94200000,3751,1250,2501,1250,0,1,1252,1671535
168,1250,3600,1500,5400000,2,10006,2503,1,94200000,94200000,3751,1250,2501,1250,0,1,1252,224954
168,1250,3600,1500,5400000,2,10006,2503,1,94200000,94200000,3751,1250,2501,1250,0,1,1252,223152
168,1250,3600,1500,5400000,2,10006,2503,1,94200000,94200000,3751,1250,2501,1250,0,1,1252,225779
168,1250,3600,1500,5400000,2,10006,2503,1,94200000,94200000,3751,1250,2501,1250,0,1,1252,226110
168,1250,3600,1500,5400000,2,10006,2503,1,94200000,94200000,3751,1250,2501,1250,0,1,1252,227157
168,1250,3600,1500,5400000,2,10006,2503,1,94200000,94200000,3751,1250,2501,1250,0,1,1252,226685

168,1650,3600,1500,5400000,2,13206,3303,1,110520000,110520000,4951,1650,3301,1650,0,1,1652,2338854
168,1650,3600,1500,5400000,2,13206,3303,1,110520000,110520000,4951,1650,3301,1650,0,1,1652,277118
168,1650,3600,1500,5400000,2,13206,3303,1,110520000,110520000,4951,1650,3301,1650,0,1,1652,273305
168,1650,3600,1500,5400000,2,13206,3303,1,110520000,110520000,4951,1650,3301,1650,0,1,1652,278080
168,1650,3600,1500,5400000,2,13206,3303,1,110520000,110520000,4951,1650,3301,1650,0,1,1652,256050
168,1650,3600,1500,5400000,2,13206,3303,1,110520000,110520000,4951,1650,3301,1650,0,1,1652,278772
168,1650,3600,1500,5400000,2,13206,3303,1,110520000,110520000,4951,1650,3301,1650,0,1,1652,278480

168,2050,3600,1500,5400000,2,16406,4103,1,126840000,126840000,6151,2050,4101,2050,0,1,2052,2841105
168,2050,3600,1500,5400000,2,16406,4103,1,126840000,126840000,6151,2050,4101,2050,0,1,2052,333502
168,2050,3600,1500,5400000,2,16406,4103,1,126840000,126840000,6151,2050,4101,2050,0,1,2052,332593
168,2050,3600,1500,5400000,2,16406,4103,1,126840000,126840000,6151,2050,4101,2050,0,1,2052,334317
168,2050,3600,1500,5400000,2,16406,4103,1,126840000,126840000,6151,2050,4101,2050,0,1,2052,334923
168,2050,3600,1500,5400000,2,16406,4103,1,126840000,126840000,6151,2050,4101,2050,0,1,2052,335985
168,2050,3600,1500,5400000,2,16406,4103,1,126840000,126840000,6151,2050,4101,2050,0,1,2052,336518

168,2450,3600,1500,5400000,2,19606,4903,1,143160000,143160000,7351,2450,4901,2450,0,1,2452,3463500
168,2450,3600,1500,5400000,2,19606,4903,1,143160000,143160000,7351,2450,4901,2450,0,1,2452,392553
168,2450,3600,1500,5400000,2,19606,4903,1,143160000,143160000,7351,2450,4901,2450,0,1,2452,387038
168,2450,3600,1500,5400000,2,19606,4903,1,143160000,143160000,7351,2450,4901,2450,0,1,2452,393519
168,2450,3600,1500,5400000,2,19606,4903,1,143160000,143160000,7351,2450,4901,2450,0,1,2452,391919
168,2450,3600,1500,5400000,2,19606,4903,1,143160000,143160000,7351,2450,4901,2450,0,1,2452,393901
168,2450,3600,1500,5400000,2,19606,4903,1,143160000,143160000,7351,2450,4901,2450,0,1,2452,395239

168,2850,3600,1500,5400000,2,22806,5703,1,159480000,159480000,8551,2850,5701,2850,0,1,2852,4154310
168,2850,3600,1500,5400000,2,22806,5703,1,159480000,159480000,8551,2850,5701,2850,0,1,2852,429463
168,2850,3600,1500,5400000,2,22806,5703,1,159480000,159480000,8551,2850,5701,2850,0,1,2852,431080
168,2850,3600,1500,5400000,2,22806,5703,1,159480000,159480000,8551,2850,5701,2850,0,1,2852,432670
168,2850,3600,1500,5400000,2,22806,5703,1,159480000,159480000,8551,2850,5701,2850,0,1,2852,431910
168,2850,3600,1500,5400000,2,22806,5703,1,159480000,159480000,8551,2850,5701,2850,0,1,2852,464060
168,2850,3600,1500,5400000,2,22806,5703,1,159480000,159480000,8551,2850,5701,2850,0,1,2852,464684

168,3250,3600,1500,5400000,2,26006,6503,1,175800000,175800000,9751,3250,6501,3250,0,1,3252,4796973
168,3250,3600,1500,5400000,2,26006,6503,1,175800000,175800000,9751,3250,6501,3250,0,1,3252,540681
168,3250,3600,1500,5400000,2,26006,6503,1,175800000,175800000,9751,3250,6501,3250,0,1,3252,539902
168,3250,3600,1500,5400000,2,26006,6503,1,175800000,175800000,9751,3250,6501,3250,0,1,3252,535736
168,3250,3600,1500,5400000,2,26006,6503,1,175800000,175800000,9751,3250,6501,3250,0,1,3252,526068
168,3250,3600,1500,5400000,2,26006,6503,1,175800000,175800000,9751,3250,6501,3250,0,1,3252,536648
168,3250,3600,1500,5400000,2,26006,6503,1,175800000,175800000,9751,3250,6501,3250,0,1,3252,535119

168,3650,3600,1500,5400000,2,29206,7303,1,192120000,192120000,10951,3650,7301,3650,0,1,3652,5434650
168,3650,3600,1500,5400000,2,29206,7303,1,192120000,192120000,10951,3650,7301,3650,0,1,3652,534047
168,3650,3600,1500,5400000,2,29206,7303,1,192120000,192120000,10951,3650,7301,3650,0,1,3652,537222
168,3650,3600,1500,5400000,2,29206,7303,1,192120000,192120000,10951,3650,7301,3650,0,1,3652,536329
168,3650,3600,1500,5400000,2,29206,7303,1,192120000,192120000,10951,3650,7301,3650,0,1,3652,535274
168,3650,3600,1500,5400000,2,29206,7303,1,192120000,192120000,10951,3650,7301,3650,0,1,3652,573064
168,3650,3600,1500,5400000,2,29206,7303,1,192120000,192120000,10951,3650,7301,3650,0,1,3652,573724

168,4050,3600,1500,5400000,2,32406,8103,1,208440000,208440000,12151,4050,8101,4050,0,1,4052,5907101
168,4050,3600,1500,5400000,2,32406,8103,1,208440000,208440000,12151,4050,8101,4050,0,1,4052,623071
168,4050,3600,1500,5400000,2,32406,8103,1,208440000,208440000,12151,4050,8101,4050,0,1,4052,614969
168,4050,3600,1500,5400000,2,32406,8103,1,208440000,208440000,12151,4050,8101,4050,0,1,4052,625405
168,4050,3600,1500,5400000,2,32406,8103,1,208440000,208440000,12151,4050,8101,4050,0,1,4052,624358
168,4050,3600,1500,5400000,2,32406,8103,1,208440000,208440000,12151,4050,8101,4050,0,1,4052,652846
168,4050,3600,1500,5400000,2,32406,8103,1,208440000,208440000,12151,4050,8101,4050,0,1,4052,633235

168,4450,3600,1500,5400000,2,35606,8903,1,224760000,224760000,13351,4450,8901,4450,0,1,4452,6458559
168,4450,3600,1500,5400000,2,35606,8903,1,224760000,224760000,13351,4450,8901,4450,0,1,4452,633918
168,4450,3600,1500,5400000,2,35606,8903,1,224760000,224760000,13351,4450,8901,4450,0,1,4452,635737
168,4450,3600,1500,5400000,2,35606,8903,1,224760000,224760000,13351,4450,8901,4450,0,1,4452,637684
168,4450,3600,1500,5400000,2,35606,8903,1,224760000,224760000,13351,4450,8901,4450,0,1,4452,636737
168,4450,3600,1500,5400000,2,35606,8903,1,224760000,224760000,13351,4450,8901,4450,0,1,4452,689903
168,4450,3600,1500,5400000,2,35606,8903,1,224760000,224760000,13351,4450,8901,4450,0,1,4452,691299

168,4850,3600,1500,5400000,2,38806,9703,1,241080000,241080000,14551,4850,9701,4850,0,1,4852,7066108
168,4850,3600,1500,5400000,2,38806,9703,1,241080000,241080000,14551,4850,9701,4850,0,1,4852,712497
168,4850,3600,1500,5400000,2,38806,9703,1,241080000,241080000,14551,4850,9701,4850,0,1,4852,717307
168,4850,3600,1500,5400000,2,38806,9703,1,241080000,241080000,14551,4850,9701,4850,0,1,4852,719429
168,4850,3600,1500,5400000,2,38806,9703,1,241080000,241080000,14551,4850,9701,4850,0,1,4852,715564
168,4850,3600,1500,5400000,2,38806,9703,1,241080000,241080000,14551,4850,9701,4850,0,1,4852,744117
168,4850,3600,1500,5400000,2,38806,9703,1,241080000,241080000,14551,4850,9701,4850,0,1,4852,743384

168,5250,3600,1500,5400000,2,42006,10503,1,257400000,257400000,15751,5250,10501,5250,0,1,5252,7797488
168,5250,3600,1500,5400000,2,42006,10503,1,257400000,257400000,15751,5250,10501,5250,0,1,5252,743794
168,5250,3600,1500,5400000,2,42006,10503,1,257400000,257400000,15751,5250,10501,5250,0,1,5252,740771
168,5250,3600,1500,5400000,2,42006,10503,1,257400000,257400000,15751,5250,10501,5250,0,1,5252,744841
168,5250,3600,1500,5400000,2,42006,10503,1,257400000,257400000,15751,5250,10501,5250,0,1,5252,742707
168,5250,3600,1500,5400000,2,42006,10503,1,257400000,257400000,15751,5250,10501,5250,0,1,5252,784247
168,5250,3600,1500,5400000,2,42006,10503,1,257400000,257400000,15751,5250,10501,5250,0,1,5252,809924

168,5650,3600,1500,5400000,2,45206,11303,1,273720000,273720000,16951,5650,11301,5650,0,1,5652,8304689
168,5650,3600,1500,5400000,2,45206,11303,1,273720000,273720000,16951,5650,11301,5650,0,1,5652,789179
168,5650,3600,1500,5400000,2,45206,11303,1,273720000,273720000,16951,5650,11301,5650,0,1,5652,788195
168,5650,3600,1500,5400000,2,45206,11303,1,273720000,273720000,16951,5650,11301,5650,0,1,5652,790991
168,5650,3600,1500,5400000,2,45206,11303,1,273720000,273720000,16951,5650,11301,5650,0,1,5652,790125
168,5650,3600,1500,5400000,2,45206,11303,1,273720000,273720000,16951,5650,11301,5650,0,1,5652,836753
168,5650,3600,1500,5400000,2,45206,11303,1,273720000,273720000,16951,5650,11301,5650,0,1,5652,835942

168,6050,3600,1500,5400000,2,48406,12103,1,290040000,290040000,18151,6050,12101,6050,0,1,6052,9130661
168,6050,3600,1500,5400000,2,48406,12103,1,290040000,290040000,18151,6050,12101,6050,0,1,6052,892575
168,6050,3600,1500,5400000,2,48406,12103,1,290040000,290040000,18151,6050,12101,6050,0,1,6052,934267
168,6050,3600,1500,5400000,2,48406,12103,1,290040000,290040000,18151,6050,12101,6050,0,1,6052,920817
168,6050,3600,1500,5400000,2,48406,12103,1,290040000,290040000,18151,6050,12101,6050,0,1,6052,942995
168,6050,3600,1500,5400000,2,48406,12103,1,290040000,290040000,18151,6050,12101,6050,0,1,6052,945097
168,6050,3600,1500,5400000,2,48406,12103,1,290040000,290040000,18151,6050,12101,6050,0,1,6052,941884

168,6450,3600,1500,5400000,2,51606,12903,1,306360000,306360000,19351,6450,12901,6450,0,1,6452,9763632
168,6450,3600,1500,5400000,2,51606,12903,1,306360000,306360000,19351,6450,12901,6450,0,1,6452,922977
168,6450,3600,1500,5400000,2,51606,12903,1,306360000,306360000,19351,6450,12901,6450,0,1,6452,930577
168,6450,3600,1500,5400000,2,51606,12903,1,306360000,306360000,19351,6450,12901,6450,0,1,6452,934992
168,6450,3600,1500,5400000,2,51606,12903,1,306360000,306360000,19351,6450,12901,6450,0,1,6452,932602
168,6450,3600,1500,5400000,2,51606,12903,1,306360000,306360000,19351,6450,12901,6450,0,1,6452,948667
168,6450,3600,1500,5400000,2,51606,12903,1,306360000,306360000,19351,6450,12901,6450,0,1,6452,949528

168,6850,3600,1500,5400000,2,54806,13703,1,322680000,322680000,20551,6850,13701,6850,0,1,6852,10521436
168,6850,3600,1500,5400000,2,54806,13703,1,322680000,322680000,20551,6850,13701,6850,0,1,6852,985060
168,6850,3600,1500,5400000,2,54806,13703,1,322680000,322680000,20551,6850,13701,6850,0,1,6852,993342
168,6850,3600,1500,5400000,2,54806,13703,1,322680000,322680000,20551,6850,13701,6850,0,1,6852,995948
168,6850,3600,1500,5400000,2,54806,13703,1,322680000,322680000,20551,6850,13701,6850,0,1,6852,989432
168,6850,3600,1500,5400000,2,54806,13703,1,322680000,322680000,20551,6850,13701,6850,0,1,6852,1003137
168,6850,3600,1500,5400000,2,54806,13703,1,322680000,322680000,20551,6850,13701,6850,0,1,6852,1004049

168,50,3600,1100,3960000,2,406,103,1,33560000,33560000,151,50,101,50,0,1,52,41882
168,50,3600,1100,3960000,2,406,103,1,33560000,33560000,151,50,101,50,0,1,52,39850
168,50,3600,1100,3960000,2,406,103,1,33560000,33560000,151,50,101,50,0,1,52,43700
168,50,3600,1100,3960000,2,406,103,1,33560000,33560000,151,50,101,50,0,1,52,43255
168,50,3600,1100,3960000,2,406,103,1,33560000,33560000,151,50,101,50,0,1,52,34775
168,50,3600,1100,3960000,2,406,103,1,33560000,33560000,151,50,101,50,0,1,52,52730
168,50,3600,1100,3960000,2,406,103,1,33560000,33560000,151,50,101,50,0,1,52,51364

168,450,3600,1100,3960000,2,3606,903,1,48600000,48600000,1351,450,901,450,0,1,452,407149
168,450,3600,1100,3960000,2,3606,903,1,48600000,48600000,1351,450,901,450,0,1,452,81793
168,450,3600,1100,3960000,2,3606,903,1,48600000,48600000,1351,450,901,450,0,1,452,80839
168,450,3600,1100,3960000,2,3606,903,1,48600000,48600000,1351,450,901,450,0,1,452,83229
168,450,3600,1100,3960000,2,3606,903,1,48600000,48600000,1351,450,901,450,0,1,452,82738
168,450,3600,1100,3960000,2,3606,903,1,48600000,48600000,1351,450,901,450,0,1,452,94378
168,450,3600,1100,3960000,2,3606,903,1,48600000,48600000,1351,450,901,450,0,1,452,94914

168,850,3600,1100,3960000,2,6806,1703,1,63640000,63640000,2551,850,1701,850,0,1,852,828697
168,850,3600,1100,3960000,2,6806,1703,1,63640000,63640000,2551,850,1701,850,0,1,852,126070
168,850,3600,1100,3960000,2,6806,1703,1,63640000,63640000,2551,850,1701,850,0,1,852,126544
168,850,3600,1100,3960000,2,6806,1703,1,63640000,63640000,2551,850,1701,850,0,1,852,124423
168,850,3600,1100,3960000,2,6806,1703,1,63640000,63640000,2551,850,1701,850,0,1,852,125382
168,850,3600,1100,3960000,2,6806,1703,1,63640000,63640000,2551,850,1701,850,0,1,852,139699
168,850,3600,1100,3960000,2,6806,1703,1,63640000,63640000,2551,850,1701,850,0,1,852,138931

168,1250,3600,1100,3960000,2,10006,2503,1,78680000,78680000,3751,1250,2501,1250,0,1,1252,1200506
168,1250,3600,1100,3960000,2,10006,2503,1,78680000,78680000,3751,1250,2501,1250,0,1,1252,166671
168,1250,3600,1100,3960000,2,10006,2503,1,78680000,78680000,3751,1250,2501,1250,0,1,1252,167039
168,1250,3600,1100,3960000,2,10006,2503,1,78680000,78680000,3751,1250,2501,1250,0,1,1252,165036
168,1250,3600,1100,3960000,2,10006,2503,1,78680000,78680000,3751,1250,2501,1250,0,1,1252,166103
168,1250,3600,1100,3960000,2,10006,2503,1,78680000,78680000,3751,1250,2501,1250,0,1,1252,183515
168,1250,3600,1100,3960000,2,10006,2503,1,78680000,78680000,3751,1250,2501,1250,0,1,1252,184896

168,1650,3600,1100,3960000,2,13206,3303,1,93720000,93720000,4951,1650,3301,1650,0,1,1652,1573505
168,1650,3600,1100,3960000,2,13206,3303,1,93720000,93720000,4951,1650,3301,1650,0,1,1652,214530
168,1650,3600,1100,3960000,2,13206,3303,1,93720000,93720000,4951,1650,3301,1650,0,1,1652,199124
168,1650,3600,1100,3960000,2,13206,3303,1,93720000,93720000,4951,1650,3301,1650,0,1,1652,215881
168,1650,3600,1100,3960000,2,13206,3303,1,93720000,93720000,4951,1650,3301,1650,0,1,1652,212014
168,1650,3600,1100,3960000,2,13206,3303,1,93720000,93720000,4951,1650,3301,1650,0,1,1652,217709
168,1650,3600,1100,3960000,2,13206,3303,1,93720000,93720000,4951,1650,3301,1650,0,1,1652,217207

168,2050,3600,1100,3960000,2,16406,4103,1,108760000,108760000,6151,2050,4101,2050,0,1,2052,2039354
168,2050,3600,1100,3960000,2,16406,4103,1,108760000,108760000,6151,2050,4101,2050,0,1,2052,256183
168,2050,3600,1100,3960000,2,16406,4103,1,108760000,108760000,6151,2050,4101,2050,0,1,2052,256934
168,2050,3600,1100,3960000,2,16406,4103,1,108760000,108760000,6151,2050,4101,2050,0,1,2052,255596
168,2050,3600,1100,3960000,2,16406,4103,1,108760000,108760000,6151,2050,4101,2050,0,1,2052,253355
168,2050,3600,1100,3960000,2,16406,4103,1,108760000,108760000,6151,2050,4101,2050,0,1,2052,257559
168,2050,3600,1100,3960000,2,16406,4103,1,108760000,108760000,6151,2050,4101,2050,0,1,2052,258101

168,2450,3600,1100,3960000,2,19606,4903,1,123800000,123800000,7351,2450,4901,2450,0,1,2452,2420223
168,2450,3600,1100,3960000,2,19606,4903,1,123800000,123800000,7351,2450,4901,2450,0,1,2452,303962
168,2450,3600,1100,3960000,2,19606,4903,1,123800000,123800000,7351,2450,4901,2450,0,1,2452,303493
168,2450,3600,1100,3960000,2,19606,4903,1,123800000,123800000,7351,2450,4901,2450,0,1,2452,297802
168,2450,3600,1100,3960000,2,19606,4903,1,123800000,123800000,7351,2450,4901,2450,0,1,2452,299067
168,2450,3600,1100,3960000,2,19606,4903,1,123800000,123800000,7351,2450,4901,2450,0,1,2452,302876
168,2450,3600,1100,3960000,2,19606,4903,1,123800000,123800000,7351,2450,4901,2450,0,1,2452,301806

168,2850,3600,1100,3960000,2,22806,5703,1,138840000,138840000,8551,2850,5701,2850,0,1,2852,2961910
168,2850,3600,1100,3960000,2,22806,5703,1,138840000,138840000,8551,2850,5701,2850,0,1,2852,350577
168,2850,3600,1100,3960000,2,22806,5703,1,138840000,138840000,8551,2850,5701,2850,0,1,2852,352855
168,2850,3600,1100,3960000,2,22806,5703,1,138840000,138840000,8551,2850,5701,2850,0,1,2852,356446
168,2850,3600,1100,3960000,2,22806,5703,1,138840000,138840000,8551,2850,5701,2850,0,1,2852,354233
168,2850,3600,1100,3960000,2,22806,5703,1,138840000,138840000,8551,2850,5701,2850,0,1,2852,355155
168,2850,3600,1100,3960000,2,22806,5703,1,138840000,138840000,8551,2850,5701,2850,0,1,2852,357643

168,3250,3600,1100,3960000,2,26006,6503,1,153880000,153880000,9751,3250,6501,3250,0,1,3252,3412981
168,3250,3600,1100,3960000,2,26006,6503,1,153880000,153880000,9751,3250,6501,3250,0,1,3252,371551
168,3250,3600,1100,3960000,2,26006,6503,1,153880000,153880000,9751,3250,6501,3250,0,1,3252,369744
168,3250,3600,1100,3960000,2,26006,6503,1,153880000,153880000,9751,3250,6501,3250,0,1,3252,370751
168,3250,3600,1100,3960000,2,26006,6503,1,153880000,153880000,9751,3250,6501,3250,0,1,3252,368642
168,3250,3600,1100,3960000,2,26006,6503,1,153880000,153880000,9751,3250,6501,3250,0,1,3252,397823
168,3250,3600,1100,3960000,2,26006,6503,1,153880000,153880000,9751,3250,6501,3250,0,1,3252,397168

168,3650,3600,1100,3960000,2,29206,7303,1,168920000,168920000,10951,3650,7301,3650,0,1,3652,3734193
168,3650,3600,1100,3960000,2,29206,7303,1,168920000,168920000,10951,3650,7301,3650,0,1,3652,460380
168,3650,3600,1100,3960000,2,29206,7303,1,168920000,168920000,10951,3650,7301,3650,0,1,3652,407950
168,3650,3600,1100,3960000,2,29206,7303,1,168920000,168920000,10951,3650,7301,3650,0,1,3652,458841
168,3650,3600,1100,3960000,2,29206,7303,1,168920000,168920000,10951,3650,7301,3650,0,1,3652,461166
168,3650,3600,1100,3960000,2,29206,7303,1,168920000,168920000,10951,3650,7301,3650,0,1,3652,463889
168,3650,3600,1100,3960000,2,29206,7303,1,168920000,168920000,10951,3650,7301,3650,0,1,3652,463215

168,4050,3600,1100,3960000,2,32406,8103,1,183960000,183960000,12151,4050,8101,4050,0,1,4052,4350813
168,4050,3600,1100,3960000,2,32406,8103,1,183960000,183960000,12151,4050,8101,4050,0,1,4052,454965
168,4050,3600,1100,3960000,2,32406,8103,1,183960000,183960000,12151,4050,8101,4050,0,1,4052,459858
168,4050,3600,1100,3960000,2,32406,8103,1,183960000,183960000,12151,4050,8101,4050,0,1,4052,455856
168,4050,3600,1100,3960000,2,32406,8103,1,183960000,183960000,12151,4050,8101,4050,0,1,4052,456566
168,4050,3600,1100,3960000,2,32406,8103,1,183960000,183960000,12151,4050,8101,4050,0,1,4052,505073
168,4050,3600,1100,3960000,2,32406,8103,1,183960000,183960000,12151,4050,8101,4050,0,1,4052,498327

168,4450,3600,1100,3960000,2,35606,8903,1,199000000,199000000,13351,4450,8901,4450,0,1,4452,4757674
168,4450,3600,1100,3960000,2,35606,8903,1,199000000,199000000,13351,4450,8901,4450,0,1,4452,492210
168,4450,3600,1100,3960000,2,35606,8903,1,199000000,199000000,13351,4450,8901,4450,0,1,4452,491500
168,4450,3600,1100,3960000,2,35606,8903,1,199000000,199000000,13351,4450,8901,4450,0,1,4452,490642
168,4450,3600,1100,3960000,2,35606,8903,1,199000000,199000000,13351,4450,8901,4450,0,1,4452,489793
168,4450,3600,1100,3960000,2,35606,8903,1,199000000,199000000,13351,4450,8901,4450,0,1,4452,543109
168,4450,3600,1100,3960000,2,35606,8903,1,199000000,199000000,13351,4450,8901,4450,0,1,4452,545151

168,4850,3600,1100,3960000,2,38806,9703,1,214040000,214040000,14551,4850,9701,4850,0,1,4852,5271393
168,4850,3600,1100,3960000,2,38806,9703,1,214040000,214040000,14551,4850,9701,4850,0,1,4852,535363
168,4850,3600,1100,3960000,2,38806,9703,1,214040000,214040000,14551,4850,9701,4850,0,1,4852,534328
168,4850,3600,1100,3960000,2,38806,9703,1,214040000,214040000,14551,4850,9701,4850,0,1,4852,537241
168,4850,3600,1100,3960000,2,38806,9703,1,214040000,214040000,14551,4850,9701,4850,0,1,4852,536071
168,4850,3600,1100,3960000,2,38806,9703,1,214040000,214040000,14551,4850,9701,4850,0,1,4852,583397
168,4850,3600,1100,3960000,2,38806,9703,1,214040000,214040000,14551,4850,9701,4850,0,1,4852,582655

168,5250,3600,1100,3960000,2,42006,10503,1,229080000,229080000,15751,5250,10501,5250,0,1,5252,5605339
168,5250,3600,1100,3960000,2,42006,10503,1,229080000,229080000,15751,5250,10501,5250,0,1,5252,582056
168,5250,3600,1100,3960000,2,42006,10503,1,229080000,229080000,15751,5250,10501,5250,0,1,5252,581248
168,5250,3600,1100,3960000,2,42006,10503,1,229080000,229080000,15751,5250,10501,5250,0,1,5252,580301
168,5250,3600,1100,3960000,2,42006,10503,1,229080000,229080000,15751,5250,10501,5250,0,1,5252,576478
168,5250,3600,1100,3960000,2,42006,10503,1,229080000,229080000,15751,5250,10501,5250,0,1,5252,630313
168,5250,3600,1100,3960000,2,42006,10503,1,229080000,229080000,15751,5250,10501,5250,0,1,5252,631085

168,5650,3600,1100,3960000,2,45206,11303,1,244120000,244120000,16951,5650,11301,5650,0,1,5652,6013519
168,5650,3600,1100,3960000,2,45206,11303,1,244120000,244120000,16951,5650,11301,5650,0,1,5652,614947
168,5650,3600,1100,3960000,2,45206,11303,1,244120000,244120000,16951,5650,11301,5650,0,1,5652,620403
168,5650,3600,1100,3960000,2,45206,11303,1,244120000,244120000,16951,5650,11301,5650,0,1,5652,619546
168,5650,3600,1100,3960000,2,45206,11303,1,244120000,244120000,16951,5650,11301,5650,0,1,5652,618574
168,5650,3600,1100,3960000,2,45206,11303,1,244120000,244120000,16951,5650,11301,5650,0,1,5652,667905
168,5650,3600,1100,3960000,2,45206,11303,1,244120000,244120000,16951,5650,11301,5650,0,1,5652,668704

168,6050,3600,1100,3960000,2,48406,12103,1,259160000,259160000,18151,6050,12101,6050,0,1,6052,6477490
168,6050,3600,1100,3960000,2,48406,12103,1,259160000,259160000,18151,6050,12101,6050,0,1,6052,661383
168,6050,3600,1100,3960000,2,48406,12103,1,259160000,259160000,18151,6050,12101,6050,0,1,6052,662381
168,6050,3600,1100,3960000,2,48406,12103,1,259160000,259160000,18151,6050,12101,6050,0,1,6052,663494
168,6050,3600,1100,3960000,2,48406,12103,1,259160000,259160000,18151,6050,12101,6050,0,1,6052,659892
168,6050,3600,1100,3960000,2,48406,12103,1,259160000,259160000,18151,6050,12101,6050,0,1,6052,703954
168,6050,3600,1100,3960000,2,48406,12103,1,259160000,259160000,18151,6050,12101,6050,0,1,6052,704774

168,6450,3600,1100,3960000,2,51606,12903,1,274200000,274200000,19351,6450,12901,6450,0,1,6452,6870189
168,6450,3600,1100,3960000,2,51606,12903,1,274200000,274200000,19351,6450,12901,6450,0,1,6452,706529
168,6450,3600,1100,3960000,2,51606,12903,1,274200000,274200000,19351,6450,12901,6450,0,1,6452,702327
168,6450,3600,1100,3960000,2,51606,12903,1,274200000,274200000,19351,6450,12901,6450,0,1,6452,708376
168,6450,3600,1100,3960000,2,51606,12903,1,274200000,274200000,19351,6450,12901,6450,0,1,6452,699411
168,6450,3600,1100,3960000,2,51606,12903,1,274200000,274200000,19351,6450,12901,6450,0,1,6452,736866
168,6450,3600,1100,3960000,2,51606,12903,1,274200000,274200000,19351,6450,12901,6450,0,1,6452,759267

168,6850,3600,1100,3960000,2,54806,13703,1,289240000,289240000,20551,6850,13701,6850,0,1,6852,7307771
168,6850,3600,1100,3960000,2,54806,13703,1,289240000,289240000,20551,6850,13701,6850,0,1,6852,821633
168,6850,3600,1100,3960000,2,54806,13703,1,289240000,289240000,20551,6850,13701,6850,0,1,6852,827996
168,6850,3600,1100,3960000,2,54806,13703,1,289240000,289240000,20551,6850,13701,6850,0,1,6852,814374
168,6850,3600,1100,3960000,2,54806,13703,1,289240000,289240000,20551,6850,13701,6850,0,1,6852,810430
168,6850,3600,1100,3960000,2,54806,13703,1,289240000,289240000,20551,6850,13701,6850,0,1,6852,832358
168,6850,3600,1100,3960000,2,54806,13703,1,289240000,289240000,20551,6850,13701,6850,0,1,6852,829143

168,50,3600,700,2520000,2,406,103,1,21880000,21880000,151,50,101,50,0,1,52,26432
168,50,3600,700,2520000,2,406,103,1,21880000,21880000,151,50,101,50,0,1,52,30329
168,50,3600,700,2520000,2,406,103,1,21880000,21880000,151,50,101,50,0,1,52,29764
168,50,3600,700,2520000,2,406,103,1,21880000,21880000,151,50,101,50,0,1,52,31549
168,50,3600,700,2520000,2,406,103,1,21880000,21880000,151,50,101,50,0,1,52,27155
168,50,3600,700,2520000,2,406,103,1,21880000,21880000,151,50,101,50,0,1,52,37560
168,50,3600,700,2520000,2,406,103,1,21880000,21880000,151,50,101,50,0,1,52,37085

168,450,3600,700,2520000,2,3606,903,1,35640000,35640000,1351,450,901,450,0,1,452,250140
168,450,3600,700,2520000,2,3606,903,1,35640000,35640000,1351,450,901,450,0,1,452,59414
168,450,3600,700,2520000,2,3606,903,1,35640000,35640000,1351,450,901,450,0,1,452,60380
168,450,3600,700,2520000,2,3606,903,1,35640000,35640000,1351,450,901,450,0,1,452,60880
168,450,3600,700,2520000,2,3606,903,1,35640000,35640000,1351,450,901,450,0,1,452,58460
168,450,3600,700,2520000,2,3606,903,1,35640000,35640000,1351,450,901,450,0,1,452,69547
168,450,3600,700,2520000,2,3606,903,1,35640000,35640000,1351,450,901,450,0,1,452,68304

168,850,3600,700,2520000,2,6806,1703,1,49400000,49400000,2551,850,1701,850,0,1,852,526254
168,850,3600,700,2520000,2,6806,1703,1,49400000,49400000,2551,850,1701,850,0,1,852,87014
168,850,3600,700,2520000,2,6806,1703,1,49400000,49400000,2551,850,1701,850,0,1,852,87567
168,850,3600,700,2520000,2,6806,1703,1,49400000,49400000,2551,850,1701,850,0,1,852,85532
168,850,3600,700,2520000,2,6806,1703,1,49400000,49400000,2551,850,1701,850,0,1,852,84926
168,850,3600,700,2520000,2,6806,1703,1,49400000,49400000,2551,850,1701,850,0,1,852,100071
168,850,3600,700,2520000,2,6806,1703,1,49400000,49400000,2551,850,1701,850,0,1,852,98748

168,1250,3600,700,2520000,2,10006,2503,1,63160000,63160000,3751,1250,2501,1250,0,1,1252,791751
168,1250,3600,700,2520000,2,10006,2503,1,63160000,63160000,3751,1250,2501,1250,0,1,1252,115559
168,1250,3600,700,2520000,2,10006,2503,1,63160000,63160000,3751,1250,2501,1250,0,1,1252,116349
168,1250,3600,700,2520000,2,10006,2503,1,63160000,63160000,3751,1250,2501,1250,0,1,1252,115023
168,1250,3600,700,2520000,2,10006,2503,1,63160000,63160000,3751,1250,2501,1250,0,1,1252,114534
168,1250,3600,700,2520000,2,10006,2503,1,63160000,63160000,3751,1250,2501,1250,0,1,1252,130616
168,1250,3600,700,2520000,2,10006,2503,1,63160000,63160000,3751,1250,2501,1250,0,1,1252,129955

168,1650,3600,700,2520000,2,13206,3303,1,76920000,76920000,4951,1650,3301,1650,0,1,1652,1036461
168,1650,3600,700,2520000,2,13206,3303,1,76920000,76920000,4951,1650,3301,1650,0,1,1652,143654
168,1650,3600,700,2520000,2,13206,3303,1,76920000,76920000,4951,1650,3301,1650,0,1,1652,141778
168,1650,3600,700,2520000,2,13206,3303,1,76920000,76920000,4951,1650,3301,1650,0,1,1652,143085
168,1650,3600,700,2520000,2,13206,3303,1,76920000,76920000,4951,1650,3301,1650,0,1,1652,144036
168,1650,3600,700,2520000,2,13206,3303,1,76920000,76920000,4951,1650,3301,1650,0,1,1652,178423
168,1650,3600,700,2520000,2,13206,3303,1,76920000,76920000,4951,1650,3301,1650,0,1,1652,177732

168,2050,3600,700,2520000,2,16406,4103,1,90680000,90680000,6151,2050,4101,2050,0,1,2052,1294181
168,2050,3600,700,2520000,2,16406,4103,1,90680000,90680000,6151,2050,4101,2050,0,1,2052,177055
168,2050,3600,700,2520000,2,16406,4103,1,90680000,90680000,6151,2050,4101,2050,0,1,2052,178353
168,2050,3600,700,2520000,2,16406,4103,1,90680000,90680000,6151,2050,4101,2050,0,1,2052,177632
168,2050,3600,700,2520000,2,16406,4103,1,90680000,90680000,6151,2050,4101,2050,0,1,2052,172913
168,2050,3600,700,2520000,2,16406,4103,1,90680000,90680000,6151,2050,4101,2050,0,1,2052,197019
168,2050,3600,700,2520000,2,16406,4103,1,90680000,90680000,6151,2050,4101,2050,0,1,2052,196250

168,2450,3600,700,2520000,2,19606,4903,1,104440000,104440000,7351,2450,4901,2450,0,1,2452,1534393
168,2450,3600,700,2520000,2,19606,4903,1,104440000,104440000,7351,2450,4901,2450,0,1,2452,213967
168,2450,3600,700,2520000,2,19606,4903,1,104440000,104440000,7351,2450,4901,2450,0,1,2452,212665
168,2450,3600,700,2520000,2,19606,4903,1,104440000,104440000,7351,2450,4901,2450,0,1,2452,215803
168,2450,3600,700,2520000,2,19606,4903,1,104440000,104440000,7351,2450,4901,2450,0,1,2452,213439
168,2450,3600,700,2520000,2,19606,4903,1,104440000,104440000,7351,2450,4901,2450,0,1,2452,217185
168,2450,3600,700,2520000,2,19606,4903,1,104440000,104440000,7351,2450,4901,2450,0,1,2452,217749

168,2850,3600,700,2520000,2,22806,5703,1,118200000,118200000,8551,2850,5701,2850,0,1,2852,1811121
168,2850,3600,700,2520000,2,22806,5703,1,118200000,118200000,8551,2850,5701,2850,0,1,2852,229902
168,2850,3600,700,2520000,2,22806,5703,1,118200000,118200000,8551,2850,5701,2850,0,1,2852,231911
168,2850,3600,700,2520000,2,22806,5703,1,118200000,118200000,8551,2850,5701,2850,0,1,2852,228741
168,2850,3600,700,2520000,2,22806,5703,1,118200000,118200000,8551,2850,5701,2850,0,1,2852,230959
168,2850,3600,700,2520000,2,22806,5703,1,118200000,118200000,8551,2850,5701,2850,0,1,2852,247998
168,2850,3600,700,2520000,2,22806,5703,1,118200000,118200000,8551,2850,5701,2850,0,1,2852,248596

168,3250,3600,700,2520000,2,26006,6503,1,131960000,131960000,9751,3250,6501,3250,0,1,3252,2054406
168,3250,3600,700,2520000,2,26006,6503,1,131960000,131960000,9751,3250,6501,3250,0,1,3252,268544
168,3250,3600,700,2520000,2,26006,6503,1,131960000,131960000,9751,3250,6501,3250,0,1,3252,270976
168,3250,3600,700,2520000,2,26006,6503,1,131960000,131960000,9751,3250,6501,3250,0,1,3252,269891
168,3250,3600,700,2520000,2,26006,6503,1,131960000,131960000,9751,3250,6501,3250,0,1,3252,266443
168,3250,3600,700,2520000,2,26006,6503,1,131960000,131960000,9751,3250,6501,3250,0,1,3252,281849
168,3250,3600,700,2520000,2,26006,6503,1,131960000,131960000,9751,3250,6501,3250,0,1,3252,281222

168,3650,3600,700,2520000,2,29206,7303,1,145720000,145720000,10951,3650,7301,3650,0,1,3652,2344322
168,3650,3600,700,2520000,2,29206,7303,1,145720000,145720000,10951,3650,7301,3650,0,1,3652,294542
168,3650,3600,700,2520000,2,29206,7303,1,145720000,145720000,10951,3650,7301,3650,0,1,3652,292054
168,3650,3600,700,2520000,2,29206,7303,1,145720000,145720000,10951,3650,7301,3650,0,1,3652,291054
168,3650,3600,700,2520000,2,29206,7303,1,145720000,145720000,10951,3650,7301,3650,0,1,3652,293378
168,3650,3600,700,2520000,2,29206,7303,1,145720000,145720000,10951,3650,7301,3650,0,1,3652,314731
168,3650,3600,700,2520000,2,29206,7303,1,145720000,145720000,10951,3650,7301,3650,0,1,3652,316135

168,4050,3600,700,2520000,2,32406,8103,1,159480000,159480000,12151,4050,8101,4050,0,1,4052,2622749
168,4050,3600,700,2520000,2,32406,8103,1,159480000,159480000,12151,4050,8101,4050,0,1,4052,321647
168,4050,3600,700,2520000,2,32406,8103,1,159480000,159480000,12151,4050,8101,4050,0,1,4052,322540
168,4050,3600,700,2520000,2,32406,8103,1,159480000,159480000,12151,4050,8101,4050,0,1,4052,320911
168,4050,3600,700,2520000,2,32406,8103,1,159480000,159480000,12151,4050,8101,4050,0,1,4052,319671
168,4050,3600,700,2520000,2,32406,8103,1,159480000,159480000,12151,4050,8101,4050,0,1,4052,351414
168,4050,3600,700,2520000,2,32406,8103,1,159480000,159480000,12151,4050,8101,4050,0,1,4052,352079

168,4450,3600,700,2520000,2,35606,8903,1,173240000,173240000,13351,4450,8901,4450,0,1,4452,2788522
168,4450,3600,700,2520000,2,35606,8903,1,173240000,173240000,13351,4450,8901,4450,0,1,4452,348277
168,4450,3600,700,2520000,2,35606,8903,1,173240000,173240000,13351,4450,8901,4450,0,1,4452,345709
168,4450,3600,700,2520000,2,35606,8903,1,173240000,173240000,13351,4450,8901,4450,0,1,4452,349139
168,4450,3600,700,2520000,2,35606,8903,1,173240000,173240000,13351,4450,8901,4450,0,1,4452,349856
168,4450,3600,700,2520000,2,35606,8903,1,173240000,173240000,13351,4450,8901,4450,0,1,4452,391736
168,4450,3600,700,2520000,2,35606,8903,1,173240000,173240000,13351,4450,8901,4450,0,1,4452,392428

168,4850,3600,700,2520000,2,38806,9703,1,187000000,187000000,14551,4850,9701,4850,0,1,4852,3165214
168,4850,3600,700,2520000,2,38806,9703,1,187000000,187000000,14551,4850,9701,4850,0,1,4852,375616
168,4850,3600,700,2520000,2,38806,9703,1,187000000,187000000,14551,4850,9701,4850,0,1,4852,376786
168,4850,3600,700,2520000,2,38806,9703,1,187000000,187000000,14551,4850,9701,4850,0,1,4852,374400
168,4850,3600,700,2520000,2,38806,9703,1,187000000,187000000,14551,4850,9701,4850,0,1,4852,377791
168,4850,3600,700,2520000,2,38806,9703,1,187000000,187000000,14551,4850,9701,4850,0,1,4852,420281
168,4850,3600,700,2520000,2,38806,9703,1,187000000,187000000,14551,4850,9701,4850,0,1,4852,419553

168,5250,3600,700,2520000,2,42006,10503,1,200760000,200760000,15751,5250,10501,5250,0,1,5252,3426697
168,5250,3600,700,2520000,2,42006,10503,1,200760000,200760000,15751,5250,10501,5250,0,1,5252,450691
168,5250,3600,700,2520000,2,42006,10503,1,200760000,200760000,15751,5250,10501,5250,0,1,5252,447170
168,5250,3600,700,2520000,2,42006,10503,1,200760000,200760000,15751,5250,10501,5250,0,1,5252,449167
168,5250,3600,700,2520000,2,42006,10503,1,200760000,200760000,15751,5250,10501,5250,0,1,5252,443135
168,5250,3600,700,2520000,2,42006,10503,1,200760000,200760000,15751,5250,10501,5250,0,1,5252,455669
168,5250,3600,700,2520000,2,42006,10503,1,200760000,200760000,15751,5250,10501,5250,0,1,5252,454897

168,5650,3600,700,2520000,2,45206,11303,1,214520000,214520000,16951,5650,11301,5650,0,1,5652,3716045
168,5650,3600,700,2520000,2,45206,11303,1,214520000,214520000,16951,5650,11301,5650,0,1,5652,431967
168,5650,3600,700,2520000,2,45206,11303,1,214520000,214520000,16951,5650,11301,5650,0,1,5652,436532
168,5650,3600,700,2520000,2,45206,11303,1,214520000,214520000,16951,5650,11301,5650,0,1,5652,435676
168,5650,3600,700,2520000,2,45206,11303,1,214520000,214520000,16951,5650,11301,5650,0,1,5652,434701
168,5650,3600,700,2520000,2,45206,11303,1,214520000,214520000,16951,5650,11301,5650,0,1,5652,479815
168,5650,3600,700,2520000,2,45206,11303,1,214520000,214520000,16951,5650,11301,5650,0,1,5652,480759

168,6050,3600,700,2520000,2,48406,12103,1,228280000,228280000,18151,6050,12101,6050,0,1,6052,4163767
168,6050,3600,700,2520000,2,48406,12103,1,228280000,228280000,18151,6050,12101,6050,0,1,6052,468942
168,6050,3600,700,2520000,2,48406,12103,1,228280000,228280000,18151,6050,12101,6050,0,1,6052,465633
168,6050,3600,700,2520000,2,48406,12103,1,228280000,228280000,18151,6050,12101,6050,0,1,6052,467801
168,6050,3600,700,2520000,2,48406,12103,1,228280000,228280000,18151,6050,12101,6050,0,1,6052,464654
168,6050,3600,700,2520000,2,48406,12103,1,228280000,228280000,18151,6050,12101,6050,0,1,6052,511441
168,6050,3600,700,2520000,2,48406,12103,1,228280000,228280000,18151,6050,12101,6050,0,1,6052,530869

168,6450,3600,700,2520000,2,51606,12903,1,242040000,242040000,19351,6450,12901,6450,0,1,6452,4438312
168,6450,3600,700,2520000,2,51606,12903,1,242040000,242040000,19351,6450,12901,6450,0,1,6452,496598
168,6450,3600,700,2520000,2,51606,12903,1,242040000,242040000,19351,6450,12901,6450,0,1,6452,498485
168,6450,3600,700,2520000,2,51606,12903,1,242040000,242040000,19351,6450,12901,6450,0,1,6452,499681
168,6450,3600,700,2520000,2,51606,12903,1,242040000,242040000,19351,6450,12901,6450,0,1,6452,500919
168,6450,3600,700,2520000,2,51606,12903,1,242040000,242040000,19351,6450,12901,6450,0,1,6452,544593
168,6450,3600,700,2520000,2,51606,12903,1,242040000,242040000,19351,6450,12901,6450,0,1,6452,545509

168,6850,3600,700,2520000,2,54806,13703,1,255800000,255800000,20551,6850,13701,6850,0,1,6852,4478081
168,6850,3600,700,2520000,2,54806,13703,1,255800000,255800000,20551,6850,13701,6850,0,1,6852,588681
168,6850,3600,700,2520000,2,54806,13703,1,255800000,255800000,20551,6850,13701,6850,0,1,6852,570431
168,6850,3600,700,2520000,2,54806,13703,1,255800000,255800000,20551,6850,13701,6850,0,1,6852,581098
168,6850,3600,700,2520000,2,54806,13703,1,255800000,255800000,20551,6850,13701,6850,0,1,6852,598303
168,6850,3600,700,2520000,2,54806,13703,1,255800000,255800000,20551,6850,13701,6850,0,1,6852,606903
168,6850,3600,700,2520000,2,54806,13703,1,255800000,255800000,20551,6850,13701,6850,0,1,6852,602599

168,50,3600,300,1080000,2,406,103,1,10200000,10200000,151,50,101,50,0,1,52,11375
168,50,3600,300,1080000,2,406,103,1,10200000,10200000,151,50,101,50,0,1,52,17338
168,50,3600,300,1080000,2,406,103,1,10200000,10200000,151,50,101,50,0,1,52,20235
168,50,3600,300,1080000,2,406,103,1,10200000,10200000,151,50,101,50,0,1,52,16570
168,50,3600,300,1080000,2,406,103,1,10200000,10200000,151,50,101,50,0,1,52,19245
168,50,3600,300,1080000,2,406,103,1,10200000,10200000,151,50,101,50,0,1,52,21751
168,50,3600,300,1080000,2,406,103,1,10200000,10200000,151,50,101,50,0,1,52,22230

168,450,3600,300,1080000,2,3606,903,1,22680000,22680000,1351,450,901,450,0,1,452,106541
168,450,3600,300,1080000,2,3606,903,1,22680000,22680000,1351,450,901,450,0,1,452,37499
168,450,3600,300,1080000,2,3606,903,1,22680000,22680000,1351,450,901,450,0,1,452,35994
168,450,3600,300,1080000,2,3606,903,1,22680000,22680000,1351,450,901,450,0,1,452,37995
168,450,3600,300,1080000,2,3606,903,1,22680000,22680000,1351,450,901,450,0,1,452,35014
168,450,3600,300,1080000,2,3606,903,1,22680000,22680000,1351,450,901,450,0,1,452,42864
168,450,3600,300,1080000,2,3606,903,1,22680000,22680000,1351,450,901,450,0,1,452,43412

168,850,3600,300,1080000,2,6806,1703,1,35160000,35160000,2551,850,1701,850,0,1,852,213786
168,850,3600,300,1080000,2,6806,1703,1,35160000,35160000,2551,850,1701,850,0,1,852,56163
168,850,3600,300,1080000,2,6806,1703,1,35160000,35160000,2551,850,1701,850,0,1,852,55619
168,850,3600,300,1080000,2,6806,1703,1,35160000,35160000,2551,850,1701,850,0,1,852,54603
168,850,3600,300,1080000,2,6806,1703,1,35160000,35160000,2551,850,1701,850,0,1,852,52310
168,850,3600,300,1080000,2,6806,1703,1,35160000,35160000,2551,850,1701,850,0,1,852,62508
168,850,3600,300,1080000,2,6806,1703,1,35160000,35160000,2551,850,1701,850,0,1,852,63107

168,1250,3600,300,1080000,2,10006,2503,1,47640000,47640000,3751,1250,2501,1250,0,1,1252,333664
168,1250,3600,300,1080000,2,10006,2503,1,47640000,47640000,3751,1250,2501,1250,0,1,1252,75767
168,1250,3600,300,1080000,2,10006,2503,1,47640000,47640000,3751,1250,2501,1250,0,1,1252,73285
168,1250,3600,300,1080000,2,10006,2503,1,47640000,47640000,3751,1250,2501,1250,0,1,1252,74134
168,1250,3600,300,1080000,2,10006,2503,1,47640000,47640000,3751,1250,2501,1250,0,1,1252,75002
168,1250,3600,300,1080000,2,10006,2503,1,47640000,47640000,3751,1250,2501,1250,0,1,1252,79744
168,1250,3600,300,1080000,2,10006,2503,1,47640000,47640000,3751,1250,2501,1250,0,1,1252,79082

168,1650,3600,300,1080000,2,13206,3303,1,60120000,60120000,4951,1650,3301,1650,0,1,1652,441125
168,1650,3600,300,1080000,2,13206,3303,1,60120000,60120000,4951,1650,3301,1650,0,1,1652,88356
168,1650,3600,300,1080000,2,13206,3303,1,60120000,60120000,4951,1650,3301,1650,0,1,1652,86947
168,1650,3600,300,1080000,2,13206,3303,1,60120000,60120000,4951,1650,3301,1650,0,1,1652,89102
168,1650,3600,300,1080000,2,13206,3303,1,60120000,60120000,4951,1650,3301,1650,0,1,1652,89769
168,1650,3600,300,1080000,2,13206,3303,1,60120000,60120000,4951,1650,3301,1650,0,1,1652,102362
168,1650,3600,300,1080000,2,13206,3303,1,60120000,60120000,4951,1650,3301,1650,0,1,1652,103073

168,2050,3600,300,1080000,2,16406,4103,1,72600000,72600000,6151,2050,4101,2050,0,1,2052,559688
168,2050,3600,300,1080000,2,16406,4103,1,72600000,72600000,6151,2050,4101,2050,0,1,2052,103256
168,2050,3600,300,1080000,2,16406,4103,1,72600000,72600000,6151,2050,4101,2050,0,1,2052,103691
168,2050,3600,300,1080000,2,16406,4103,1,72600000,72600000,6151,2050,4101,2050,0,1,2052,102650
168,2050,3600,300,1080000,2,16406,4103,1,72600000,72600000,6151,2050,4101,2050,0,1,2052,101984
168,2050,3600,300,1080000,2,16406,4103,1,72600000,72600000,6151,2050,4101,2050,0,1,2052,147282
168,2050,3600,300,1080000,2,16406,4103,1,72600000,72600000,6151,2050,4101,2050,0,1,2052,148186

168,2450,3600,300,1080000,2,19606,4903,1,85080000,85080000,7351,2450,4901,2450,0,1,2452,650973
168,2450,3600,300,1080000,2,19606,4903,1,85080000,85080000,7351,2450,4901,2450,0,1,2452,121700
168,2450,3600,300,1080000,2,19606,4903,1,85080000,85080000,7351,2450,4901,2450,0,1,2452,122212
168,2450,3600,300,1080000,2,19606,4903,1,85080000,85080000,7351,2450,4901,2450,0,1,2452,120264
168,2450,3600,300,1080000,2,19606,4903,1,85080000,85080000,7351,2450,4901,2450,0,1,2452,121008
168,2450,3600,300,1080000,2,19606,4903,1,85080000,85080000,7351,2450,4901,2450,0,1,2452,146641
168,2450,3600,300,1080000,2,19606,4903,1,85080000,85080000,7351,2450,4901,2450,0,1,2452,145677

168,2850,3600,300,1080000,2,22806,5703,1,97560000,97560000,8551,2850,5701,2850,0,1,2852,764912
168,2850,3600,300,1080000,2,22806,5703,1,97560000,97560000,8551,2850,5701,2850,0,1,2852,137334
168,2850,3600,300,1080000,2,22806,5703,1,97560000,97560000,8551,2850,5701,2850,0,1,2852,136635
168,2850,3600,300,1080000,2,22806,5703,1,97560000,97560000,8551,2850,5701,2850,0,1,2852,137868
168,2850,3600,300,1080000,2,22806,5703,1,97560000,97560000,8551,2850,5701,2850,0,1,2852,135898
168,2850,3600,300,1080000,2,22806,5703,1,97560000,97560000,8551,2850,5701,2850,0,1,2852,183234
168,2850,3600,300,1080000,2,22806,5703,1,97560000,97560000,8551,2850,5701,2850,0,1,2852,184275

168,3250,3600,300,1080000,2,26006,6503,1,110040000,110040000,9751,3250,6501,3250,0,1,3252,866203
168,3250,3600,300,1080000,2,26006,6503,1,110040000,110040000,9751,3250,6501,3250,0,1,3252,151191
168,3250,3600,300,1080000,2,26006,6503,1,110040000,110040000,9751,3250,6501,3250,0,1,3252,153962
168,3250,3600,300,1080000,2,26006,6503,1,110040000,110040000,9751,3250,6501,3250,0,1,3252,153378
168,3250,3600,300,1080000,2,26006,6503,1,110040000,110040000,9751,3250,6501,3250,0,1,3252,152641
168,3250,3600,300,1080000,2,26006,6503,1,110040000,110040000,9751,3250,6501,3250,0,1,3252,201631
168,3250,3600,300,1080000,2,26006,6503,1,110040000,110040000,9751,3250,6501,3250,0,1,3252,202309

168,3650,3600,300,1080000,2,29206,7303,1,122520000,122520000,10951,3650,7301,3650,0,1,3652,951553
168,3650,3600,300,1080000,2,29206,7303,1,122520000,122520000,10951,3650,7301,3650,0,1,3652,170713
168,3650,3600,300,1080000,2,29206,7303,1,122520000,122520000,10951,3650,7301,3650,0,1,3652,171425
168,3650,3600,300,1080000,2,29206,7303,1,122520000,122520000,10951,3650,7301,3650,0,1,3652,172292
168,3650,3600,300,1080000,2,29206,7303,1,122520000,122520000,10951,3650,7301,3650,0,1,3652,169516
168,3650,3600,300,1080000,2,29206,7303,1,122520000,122520000,10951,3650,7301,3650,0,1,3652,209285
168,3650,3600,300,1080000,2,29206,7303,1,122520000,122520000,10951,3650,7301,3650,0,1,3652,208624

168,4050,3600,300,1080000,2,32406,8103,1,135000000,135000000,12151,4050,8101,4050,0,1,4052,1058108
168,4050,3600,300,1080000,2,32406,8103,1,135000000,135000000,12151,4050,8101,4050,0,1,4052,189651
168,4050,3600,300,1080000,2,32406,8103,1,135000000,135000000,12151,4050,8101,4050,0,1,4052,188973
168,4050,3600,300,1080000,2,32406,8103,1,135000000,135000000,12151,4050,8101,4050,0,1,4052,187294
168,4050,3600,300,1080000,2,32406,8103,1,135000000,135000000,12151,4050,8101,4050,0,1,4052,188134
168,4050,3600,300,1080000,2,32406,8103,1,135000000,135000000,12151,4050,8101,4050,0,1,4052,220301
168,4050,3600,300,1080000,2,32406,8103,1,135000000,135000000,12151,4050,8101,4050,0,1,4052,219578

168,4450,3600,300,1080000,2,35606,8903,1,147480000,147480000,13351,4450,8901,4450,0,1,4452,1206111
168,4450,3600,300,1080000,2,35606,8903,1,147480000,147480000,13351,4450,8901,4450,0,1,4452,207891
168,4450,3600,300,1080000,2,35606,8903,1,147480000,147480000,13351,4450,8901,4450,0,1,4452,206320
168,4450,3600,300,1080000,2,35606,8903,1,147480000,147480000,13351,4450,8901,4450,0,1,4452,207175
168,4450,3600,300,1080000,2,35606,8903,1,147480000,147480000,13351,4450,8901,4450,0,1,4452,204784
168,4450,3600,300,1080000,2,35606,8903,1,147480000,147480000,13351,4450,8901,4450,0,1,4452,238318
168,4450,3600,300,1080000,2,35606,8903,1,147480000,147480000,13351,4450,8901,4450,0,1,4452,237562

168,4850,3600,300,1080000,2,38806,9703,1,159960000,159960000,14551,4850,9701,4850,0,1,4852,1289521
168,4850,3600,300,1080000,2,38806,9703,1,159960000,159960000,14551,4850,9701,4850,0,1,4852,261000
168,4850,3600,300,1080000,2,38806,9703,1,159960000,159960000,14551,4850,9701,4850,0,1,4852,257666
168,4850,3600,300,1080000,2,38806,9703,1,159960000,159960000,14551,4850,9701,4850,0,1,4852,260010
168,4850,3600,300,1080000,2,38806,9703,1,159960000,159960000,14551,4850,9701,4850,0,1,4852,258611
168,4850,3600,300,1080000,2,38806,9703,1,159960000,159960000,14551,4850,9701,4850,0,1,4852,287256
168,4850,3600,300,1080000,2,38806,9703,1,159960000,159960000,14551,4850,9701,4850,0,1,4852,287993

168,5250,3600,300,1080000,2,42006,10503,1,172440000,172440000,15751,5250,10501,5250,0,1,5252,1419864
168,5250,3600,300,1080000,2,42006,10503,1,172440000,172440000,15751,5250,10501,5250,0,1,5252,239957
168,5250,3600,300,1080000,2,42006,10503,1,172440000,172440000,15751,5250,10501,5250,0,1,5252,240738
168,5250,3600,300,1080000,2,42006,10503,1,172440000,172440000,15751,5250,10501,5250,0,1,5252,238070
168,5250,3600,300,1080000,2,42006,10503,1,172440000,172440000,15751,5250,10501,5250,0,1,5252,238989
168,5250,3600,300,1080000,2,42006,10503,1,172440000,172440000,15751,5250,10501,5250,0,1,5252,270488
168,5250,3600,300,1080000,2,42006,10503,1,172440000,172440000,15751,5250,10501,5250,0,1,5252,269710

168,5650,3600,300,1080000,2,45206,11303,1,184920000,184920000,16951,5650,11301,5650,0,1,5652,1532939
168,5650,3600,300,1080000,2,45206,11303,1,184920000,184920000,16951,5650,11301,5650,0,1,5652,256078
168,5650,3600,300,1080000,2,45206,11303,1,184920000,184920000,16951,5650,11301,5650,0,1,5652,260491
168,5650,3600,300,1080000,2,45206,11303,1,184920000,184920000,16951,5650,11301,5650,0,1,5652,262791
168,5650,3600,300,1080000,2,45206,11303,1,184920000,184920000,16951,5650,11301,5650,0,1,5652,258718
168,5650,3600,300,1080000,2,45206,11303,1,184920000,184920000,16951,5650,11301,5650,0,1,5652,285685
168,5650,3600,300,1080000,2,45206,11303,1,184920000,184920000,16951,5650,11301,5650,0,1,5652,286491

168,6050,3600,300,1080000,2,48406,12103,1,197400000,197400000,18151,6050,12101,6050,0,1,6052,1672836
168,6050,3600,300,1080000,2,48406,12103,1,197400000,197400000,18151,6050,12101,6050,0,1,6052,280619
168,6050,3600,300,1080000,2,48406,12103,1,197400000,197400000,18151,6050,12101,6050,0,1,6052,275087
168,6050,3600,300,1080000,2,48406,12103,1,197400000,197400000,18151,6050,12101,6050,0,1,6052,282896
168,6050,3600,300,1080000,2,48406,12103,1,197400000,197400000,18151,6050,12101,6050,0,1,6052,277781
168,6050,3600,300,1080000,2,48406,12103,1,197400000,197400000,18151,6050,12101,6050,0,1,6052,300887
168,6050,3600,300,1080000,2,48406,12103,1,197400000,197400000,18151,6050,12101,6050,0,1,6052,300032

168,6450,3600,300,1080000,2,51606,12903,1,209880000,209880000,19351,6450,12901,6450,0,1,6452,1747321
168,6450,3600,300,1080000,2,51606,12903,1,209880000,209880000,19351,6450,12901,6450,0,1,6452,303946
168,6450,3600,300,1080000,2,51606,12903,1,209880000,209880000,19351,6450,12901,6450,0,1,6452,301509
168,6450,3600,300,1080000,2,51606,12903,1,209880000,209880000,19351,6450,12901,6450,0,1,6452,306455
168,6450,3600,300,1080000,2,51606,12903,1,209880000,209880000,19351,6450,12901,6450,0,1,6452,297886
168,6450,3600,300,1080000,2,51606,12903,1,209880000,209880000,19351,6450,12901,6450,0,1,6452,331564
168,6450,3600,300,1080000,2,51606,12903,1,209880000,209880000,19351,6450,12901,6450,0,1,6452,330058

168,6850,3600,300,1080000,2,54806,13703,1,222360000,222360000,20551,6850,13701,6850,0,1,6852,1861971
168,6850,3600,300,1080000,2,54806,13703,1,222360000,222360000,20551,6850,13701,6850,0,1,6852,309902
168,6850,3600,300,1080000,2,54806,13703,1,222360000,222360000,20551,6850,13701,6850,0,1,6852,308659
168,6850,3600,300,1080000,2,54806,13703,1,222360000,222360000,20551,6850,13701,6850,0,1,6852,311141
168,6850,3600,300,1080000,2,54806,13703,1,222360000,222360000,20551,6850,13701,6850,0,1,6852,306866
168,6850,3600,300,1080000,2,54806,13703,1,222360000,222360000,20551,6850,13701,6850,0,1,6852,348964
168,6850,3600,300,1080000,2,54806,13703,1,222360000,222360000,20551,6850,13701,6850,0,1,6852,347998

168,50,3200,5100,16320000,2,406,103,1,133880000,133880000,151,50,101,50,0,1,52,192214
168,50,3200,5100,16320000,2,406,103,1,133880000,133880000,151,50,101,50,0,1,52,167366
168,50,3200,5100,16320000,2,406,103,1,133880000,133880000,151,50,101,50,0,1,52,161963
168,50,3200,5100,16320000,2,406,103,1,133880000,133880000,151,50,101,50,0,1,52,151259
168,50,3200,5100,16320000,2,406,103,1,133880000,133880000,151,50,101,50,0,1,52,167822
168,50,3200,5100,16320000,2,406,103,1,133880000,133880000,151,50,101,50,0,1,52,204917
168,50,3200,5100,16320000,2,406,103,1,133880000,133880000,151,50,101,50,0,1,52,204547

168,450,3200,5100,16320000,2,3606,903,1,160440000,160440000,1351,450,901,450,0,1,452,1804945
168,450,3200,5100,16320000,2,3606,903,1,160440000,160440000,1351,450,901,450,0,1,452,305201
168,450,3200,5100,16320000,2,3606,903,1,160440000,160440000,1351,450,901,450,0,1,452,307467
168,450,3200,5100,16320000,2,3606,903,1,160440000,160440000,1351,450,901,450,0,1,452,308759
168,450,3200,5100,16320000,2,3606,903,1,160440000,160440000,1351,450,901,450,0,1,452,308351
168,450,3200,5100,16320000,2,3606,903,1,160440000,160440000,1351,450,901,450,0,1,452,314923
168,450,3200,5100,16320000,2,3606,903,1,160440000,160440000,1351,450,901,450,0,1,452,315323

168,850,3200,5100,16320000,2,6806,1703,1,187000000,187000000,2551,850,1701,850,0,1,852,3634079
168,850,3200,5100,16320000,2,6806,1703,1,187000000,187000000,2551,850,1701,850,0,1,852,477070
168,850,3200,5100,16320000,2,6806,1703,1,187000000,187000000,2551,850,1701,850,0,1,852,479047
168,850,3200,5100,16320000,2,6806,1703,1,187000000,187000000,2551,850,1701,850,0,1,852,477886
168,850,3200,5100,16320000,2,6806,1703,1,187000000,187000000,2551,850,1701,850,0,1,852,478345
168,850,3200,5100,16320000,2,6806,1703,1,187000000,187000000,2551,850,1701,850,0,1,852,481947
168,850,3200,5100,16320000,2,6806,1703,1,187000000,187000000,2551,850,1701,850,0,1,852,481514

168,1250,3200,5100,16320000,2,10006,2503,1,213560000,213560000,3751,1250,2501,1250,0,1,1252,5488567
168,1250,3200,5100,16320000,2,10006,2503,1,213560000,213560000,3751,1250,2501,1250,0,1,1252,594487
168,1250,3200,5100,16320000,2,10006,2503,1,213560000,213560000,3751,1250,2501,1250,0,1,1252,601760
168,1250,3200,5100,16320000,2,10006,2503,1,213560000,213560000,3751,1250,2501,1250,0,1,1252,559028
168,1250,3200,5100,16320000,2,10006,2503,1,213560000,213560000,3751,1250,2501,1250,0,1,1252,603165
168,1250,3200,5100,16320000,2,10006,2503,1,213560000,213560000,3751,1250,2501,1250,0,1,1252,612048
168,1250,3200,5100,16320000,2,10006,2503,1,213560000,213560000,3751,1250,2501,1250,0,1,1252,620801

168,1650,3200,5100,16320000,2,13206,3303,1,240120000,240120000,4951,1650,3301,1650,0,1,1652,8007868
168,1650,3200,5100,16320000,2,13206,3303,1,240120000,240120000,4951,1650,3301,1650,0,1,1652,776586
168,1650,3200,5100,16320000,2,13206,3303,1,240120000,240120000,4951,1650,3301,1650,0,1,1652,779746
168,1650,3200,5100,16320000,2,13206,3303,1,240120000,240120000,4951,1650,3301,1650,0,1,1652,760324
168,1650,3200,5100,16320000,2,13206,3303,1,240120000,240120000,4951,1650,3301,1650,0,1,1652,775460
168,1650,3200,5100,16320000,2,13206,3303,1,240120000,240120000,4951,1650,3301,1650,0,1,1652,781042
168,1650,3200,5100,16320000,2,13206,3303,1,240120000,240120000,4951,1650,3301,1650,0,1,1652,781534

168,2050,3200,5100,16320000,2,16406,4103,1,266680000,266680000,6151,2050,4101,2050,0,1,2052,9775434
168,2050,3200,5100,16320000,2,16406,4103,1,266680000,266680000,6151,2050,4101,2050,0,1,2052,870318
168,2050,3200,5100,16320000,2,16406,4103,1,266680000,266680000,6151,2050,4101,2050,0,1,2052,867819
168,2050,3200,5100,16320000,2,16406,4103,1,266680000,266680000,6151,2050,4101,2050,0,1,2052,870942
168,2050,3200,5100,16320000,2,16406,4103,1,266680000,266680000,6151,2050,4101,2050,0,1,2052,869416
168,2050,3200,5100,16320000,2,16406,4103,1,266680000,266680000,6151,2050,4101,2050,0,1,2052,907741
168,2050,3200,5100,16320000,2,16406,4103,1,266680000,266680000,6151,2050,4101,2050,0,1,2052,892141

168,2450,3200,5100,16320000,2,19606,4903,1,293240000,293240000,7351,2450,4901,2450,0,1,2452,11873898
168,2450,3200,5100,16320000,2,19606,4903,1,293240000,293240000,7351,2450,4901,2450,0,1,2452,1017844
168,2450,3200,5100,16320000,2,19606,4903,1,293240000,293240000,7351,2450,4901,2450,0,1,2452,1020637
168,2450,3200,5100,16320000,2,19606,4903,1,293240000,293240000,7351,2450,4901,2450,0,1,2452,1022268
168,2450,3200,5100,16320000,2,19606,4903,1,293240000,293240000,7351,2450,4901,2450,0,1,2452,1019810
168,2450,3200,5100,16320000,2,19606,4903,1,293240000,293240000,7351,2450,4901,2450,0,1,2452,1042076
168,2450,3200,5100,16320000,2,19606,4903,1,293240000,293240000,7351,2450,4901,2450,0,1,2452,1041539

168,2850,3200,5100,16320000,2,22806,5703,1,319800000,319800000,8551,2850,5701,2850,0,1,2852,13971536
168,2850,3200,5100,16320000,2,22806,5703,1,319800000,319800000,8551,2850,5701,2850,0,1,2852,1148451
168,2850,3200,5100,16320000,2,22806,5703,1,319800000,319800000,8551,2850,5701,2850,0,1,2852,1152646
168,2850,3200,5100,16320000,2,22806,5703,1,319800000,319800000,8551,2850,5701,2850,0,1,2852,1155526
168,2850,3200,5100,16320000,2,22806,5703,1,319800000,319800000,8551,2850,5701,2850,0,1,2852,1154296
168,2850,3200,5100,16320000,2,22806,5703,1,319800000,319800000,8551,2850,5701,2850,0,1,2852,1180729
168,2850,3200,5100,16320000,2,22806,5703,1,319800000,319800000,8551,2850,5701,2850,0,1,2852,1197579

168,3250,3200,5100,16320000,2,26006,6503,1,346360000,346360000,9751,3250,6501,3250,0,1,3252,15586476
168,3250,3200,5100,16320000,2,26006,6503,1,346360000,346360000,9751,3250,6501,3250,0,1,3252,1376330
168,3250,3200,5100,16320000,2,26006,6503,1,346360000,346360000,9751,3250,6501,3250,0,1,3252,1300320
168,3250,3200,5100,16320000,2,26006,6503,1,346360000,346360000,9751,3250,6501,3250,0,1,3252,1377079
168,3250,3200,5100,16320000,2,26006,6503,1,346360000,346360000,9751,3250,6501,3250,0,1,3252,1368934
168,3250,3200,5100,16320000,2,26006,6503,1,346360000,346360000,9751,3250,6501,3250,0,1,3252,1369632
168,3250,3200,5100,16320000,2,26006,6503,1,346360000,346360000,9751,3250,6501,3250,0,1,3252,1358387

168,3650,3200,5100,16320000,2,29206,7303,1,372920000,372920000,10951,3650,7301,3650,0,1,3652,18072015
168,3650,3200,5100,16320000,2,29206,7303,1,372920000,372920000,10951,3650,7301,3650,0,1,3652,1454132
168,3650,3200,5100,16320000,2,29206,7303,1,372920000,372920000,10951,3650,7301,3650,0,1,3652,1455629
168,3650,3200,5100,16320000,2,29206,7303,1,372920000,372920000,10951,3650,7301,3650,0,1,3652,1456791
168,3650,3200,5100,16320000,2,29206,7303,1,372920000,372920000,10951,3650,7301,3650,0,1,3652,1452437
168,3650,3200,5100,16320000,2,29206,7303,1,372920000,372920000,10951,3650,7301,3650,0,1,3652,1464851
168,3650,3200,5100,16320000,2,29206,7303,1,372920000,372920000,10951,3650,7301,3650,0,1,3652,1465470

168,4050,3200,5100,16320000,2,32406,8103,1,399480000,399480000,12151,4050,8101,4050,0,1,4052,20225485
168,4050,3200,5100,16320000,2,32406,8103,1,399480000,399480000,12151,4050,8101,4050,0,1,4052,1639984
168,4050,3200,5100,16320000,2,32406,8103,1,399480000,399480000,12151,4050,8101,4050,0,1,4052,1662522
168,4050,3200,5100,16320000,2,32406,8103,1,399480000,399480000,12151,4050,8101,4050,0,1,4052,1669486
168,4050,3200,5100,16320000,2,32406,8103,1,399480000,399480000,12151,4050,8101,4050,0,1,4052,1637110
168,4050,3200,5100,16320000,2,32406,8103,1,399480000,399480000,12151,4050,8101,4050,0,1,4052,1668514
168,4050,3200,5100,16320000,2,32406,8103,1,399480000,399480000,12151,4050,8101,4050,0,1,4052,1670133

168,4450,3200,5100,16320000,2,35606,8903,1,426040000,426040000,13351,4450,8901,4450,0,1,4452,22985413
168,4450,3200,5100,16320000,2,35606,8903,1,426040000,426040000,13351,4450,8901,4450,0,1,4452,1771109
168,4450,3200,5100,16320000,2,35606,8903,1,426040000,426040000,13351,4450,8901,4450,0,1,4452,1768998
168,4450,3200,5100,16320000,2,35606,8903,1,426040000,426040000,13351,4450,8901,4450,0,1,4452,1772739
168,4450,3200,5100,16320000,2,35606,8903,1,426040000,426040000,13351,4450,8901,4450,0,1,4452,1770319
168,4450,3200,5100,16320000,2,35606,8903,1,426040000,426040000,13351,4450,8901,4450,0,1,4452,1773474
168,4450,3200,5100,16320000,2,35606,8903,1,426040000,426040000,13351,4450,8901,4450,0,1,4452,1774173

168,4850,3200,5100,16320000,2,38806,9703,1,452600000,452600000,14551,4850,9701,4850,0,1,4852,24727145
168,4850,3200,5100,16320000,2,38806,9703,1,452600000,452600000,14551,4850,9701,4850,0,1,4852,1941826
168,4850,3200,5100,16320000,2,38806,9703,1,452600000,452600000,14551,4850,9701,4850,0,1,4852,1944989
168,4850,3200,5100,16320000,2,38806,9703,1,452600000,452600000,14551,4850,9701,4850,0,1,4852,1943871
168,4850,3200,5100,16320000,2,38806,9703,1,452600000,452600000,14551,4850,9701,4850,0,1,4852,1943236
168,4850,3200,5100,16320000,2,38806,9703,1,452600000,452600000,14551,4850,9701,4850,0,1,4852,1936375
168,4850,3200,5100,16320000,2,38806,9703,1,452600000,452600000,14551,4850,9701,4850,0,1,4852,1924273

168,5250,3200,5100,16320000,2,42006,10503,1,479160000,479160000,15751,5250,10501,5250,0,1,5252,26444295
168,5250,3200,5100,16320000,2,42006,10503,1,479160000,479160000,15751,5250,10501,5250,0,1,5252,2067936
168,5250,3200,5100,16320000,2,42006,10503,1,479160000,479160000,15751,5250,10501,5250,0,1,5252,2067058
168,5250,3200,5100,16320000,2,42006,10503,1,479160000,479160000,15751,5250,10501,5250,0,1,5252,2068694
168,5250,3200,5100,16320000,2,42006,10503,1,479160000,479160000,15751,5250,10501,5250,0,1,5252,2064238
168,5250,3200,5100,16320000,2,42006,10503,1,479160000,479160000,15751,5250,10501,5250,0,1,5252,2051573
168,5250,3200,5100,16320000,2,42006,10503,1,479160000,479160000,15751,5250,10501,5250,0,1,5252,2066201

168,5650,3200,5100,16320000,2,45206,11303,1,505720000,505720000,16951,5650,11301,5650,0,1,5652,28267480
168,5650,3200,5100,16320000,2,45206,11303,1,505720000,505720000,16951,5650,11301,5650,0,1,5652,2263537
168,5650,3200,5100,16320000,2,45206,11303,1,505720000,505720000,16951,5650,11301,5650,0,1,5652,2251845
168,5650,3200,5100,16320000,2,45206,11303,1,505720000,505720000,16951,5650,11301,5650,0,1,5652,2262495
168,5650,3200,5100,16320000,2,45206,11303,1,505720000,505720000,16951,5650,11301,5650,0,1,5652,2260210
168,5650,3200,5100,16320000,2,45206,11303,1,505720000,505720000,16951,5650,11301,5650,0,1,5652,2215847
168,5650,3200,5100,16320000,2,45206,11303,1,505720000,505720000,16951,5650,11301,5650,0,1,5652,2195663

168,6050,3200,5100,16320000,2,48406,12103,1,532280000,532280000,18151,6050,12101,6050,0,1,6052,30852104
168,6050,3200,5100,16320000,2,48406,12103,1,532280000,532280000,18151,6050,12101,6050,0,1,6052,2400957
168,6050,3200,5100,16320000,2,48406,12103,1,532280000,532280000,18151,6050,12101,6050,0,1,6052,2407272
168,6050,3200,5100,16320000,2,48406,12103,1,532280000,532280000,18151,6050,12101,6050,0,1,6052,2411487
168,6050,3200,5100,16320000,2,48406,12103,1,532280000,532280000,18151,6050,12101,6050,0,1,6052,2398962
168,6050,3200,5100,16320000,2,48406,12103,1,532280000,532280000,18151,6050,12101,6050,0,1,6052,2379033
168,6050,3200,5100,16320000,2,48406,12103,1,532280000,532280000,18151,6050,12101,6050,0,1,6052,2367482

168,6450,3200,5100,16320000,2,51606,12903,1,558840000,558840000,19351,6450,12901,6450,0,1,6452,32219402
168,6450,3200,5100,16320000,2,51606,12903,1,558840000,558840000,19351,6450,12901,6450,0,1,6452,2564524
168,6450,3200,5100,16320000,2,51606,12903,1,558840000,558840000,19351,6450,12901,6450,0,1,6452,2572444
168,6450,3200,5100,16320000,2,51606,12903,1,558840000,558840000,19351,6450,12901,6450,0,1,6452,2578615
168,6450,3200,5100,16320000,2,51606,12903,1,558840000,558840000,19351,6450,12901,6450,0,1,6452,2556250
168,6450,3200,5100,16320000,2,51606,12903,1,558840000,558840000,19351,6450,12901,6450,0,1,6452,2510395
168,6450,3200,5100,16320000,2,51606,12903,1,558840000,558840000,19351,6450,12901,6450,0,1,6452,2519860

168,6850,3200,5100,16320000,2,54806,13703,1,585400000,585400000,20551,6850,13701,6850,0,1,6852,35394150
168,6850,3200,5100,16320000,2,54806,13703,1,585400000,585400000,20551,6850,13701,6850,0,1,6852,2689274
168,6850,3200,5100,16320000,2,54806,13703,1,585400000,585400000,20551,6850,13701,6850,0,1,6852,2690601
168,6850,3200,5100,16320000,2,54806,13703,1,585400000,585400000,20551,6850,13701,6850,0,1,6852,2694316
168,6850,3200,5100,16320000,2,54806,13703,1,585400000,585400000,20551,6850,13701,6850,0,1,6852,2691612
168,6850,3200,5100,16320000,2,54806,13703,1,585400000,585400000,20551,6850,13701,6850,0,1,6852,2669208
168,6850,3200,5100,16320000,2,54806,13703,1,585400000,585400000,20551,6850,13701,6850,0,1,6852,2664053

168,50,3200,4700,15040000,2,406,103,1,123480000,123480000,151,50,101,50,0,1,52,176407
168,50,3200,4700,15040000,2,406,103,1,123480000,123480000,151,50,101,50,0,1,52,159834
168,50,3200,4700,15040000,2,406,103,1,123480000,123480000,151,50,101,50,0,1,52,162055
168,50,3200,4700,15040000,2,406,103,1,123480000,123480000,151,50,101,50,0,1,52,163179
168,50,3200,4700,15040000,2,406,103,1,123480000,123480000,151,50,101,50,0,1,52,146685
168,50,3200,4700,15040000,2,406,103,1,123480000,123480000,151,50,101,50,0,1,52,201928
168,50,3200,4700,15040000,2,406,103,1,123480000,123480000,151,50,101,50,0,1,52,201559

168,450,3200,4700,15040000,2,3606,903,1,148760000,148760000,1351,450,901,450,0,1,452,1628577
168,450,3200,4700,15040000,2,3606,903,1,148760000,148760000,1351,450,901,450,0,1,452,307845
168,450,3200,4700,15040000,2,3606,903,1,148760000,148760000,1351,450,901,450,0,1,452,306402
168,450,3200,4700,15040000,2,3606,903,1,148760000,148760000,1351,450,901,450,0,1,452,308627
168,450,3200,4700,15040000,2,3606,903,1,148760000,148760000,1351,450,901,450,0,1,452,284517
168,450,3200,4700,15040000,2,3606,903,1,148760000,148760000,1351,450,901,450,0,1,452,308399
168,450,3200,4700,15040000,2,3606,903,1,148760000,148760000,1351,450,901,450,0,1,452,308209

168,850,3200,4700,15040000,2,6806,1703,1,174040000,174040000,2551,850,1701,850,0,1,852,3422143
168,850,3200,4700,15040000,2,6806,1703,1,174040000,174040000,2551,850,1701,850,0,1,852,435247
168,850,3200,4700,15040000,2,6806,1703,1,174040000,174040000,2551,850,1701,850,0,1,852,430836
168,850,3200,4700,15040000,2,6806,1703,1,174040000,174040000,2551,850,1701,850,0,1,852,435759
168,850,3200,4700,15040000,2,6806,1703,1,174040000,174040000,2551,850,1701,850,0,1,852,440405
168,850,3200,4700,15040000,2,6806,1703,1,174040000,174040000,2551,850,1701,850,0,1,852,440747
168,850,3200,4700,15040000,2,6806,1703,1,174040000,174040000,2551,850,1701,850,0,1,852,440966

168,1250,3200,4700,15040000,2,10006,2503,1,199320000,199320000,3751,1250,2501,1250,0,1,1252,5159978
168,1250,3200,4700,15040000,2,10006,2503,1,199320000,199320000,3751,1250,2501,1250,0,1,1252,575091
168,1250,3200,4700,15040000,2,10006,2503,1,199320000,199320000,3751,1250,2501,1250,0,1,1252,577208
168,1250,3200,4700,15040000,2,10006,2503,1,199320000,199320000,3751,1250,2501,1250,0,1,1252,579030
168,1250,3200,4700,15040000,2,10006,2503,1,199320000,199320000,3751,1250,2501,1250,0,1,1252,578717
168,1250,3200,4700,15040000,2,10006,2503,1,199320000,199320000,3751,1250,2501,1250,0,1,1252,581696
168,1250,3200,4700,15040000,2,10006,2503,1,199320000,199320000,3751,1250,2501,1250,0,1,1252,579632

168,1650,3200,4700,15040000,2,13206,3303,1,224600000,224600000,4951,1650,3301,1650,0,1,1652,7263377
168,1650,3200,4700,15040000,2,13206,3303,1,224600000,224600000,4951,1650,3301,1650,0,1,1652,665350
168,1650,3200,4700,15040000,2,13206,3303,1,224600000,224600000,4951,1650,3301,1650,0,1,1652,663419
168,1650,3200,4700,15040000,2,13206,3303,1,224600000,224600000,4951,1650,3301,1650,0,1,1652,667482
168,1650,3200,4700,15040000,2,13206,3303,1,224600000,224600000,4951,1650,3301,1650,0,1,1652,666286
168,1650,3200,4700,15040000,2,13206,3303,1,224600000,224600000,4951,1650,3301,1650,0,1,1652,698870
168,1650,3200,4700,15040000,2,13206,3303,1,224600000,224600000,4951,1650,3301,1650,0,1,1652,699456

168,2050,3200,4700,15040000,2,16406,4103,1,249880000,249880000,6151,2050,4101,2050,0,1,2052,8904896
168,2050,3200,4700,15040000,2,16406,4103,1,249880000,249880000,6151,2050,4101,2050,0,1,2052,844017
168,2050,3200,4700,15040000,2,16406,4103,1,249880000,249880000,6151,2050,4101,2050,0,1,2052,845736
168,2050,3200,4700,15040000,2,16406,4103,1,249880000,249880000,6151,2050,4101,2050,0,1,2052,846693
168,2050,3200,4700,15040000,2,16406,4103,1,249880000,249880000,6151,2050,4101,2050,0,1,2052,845172
168,2050,3200,4700,15040000,2,16406,4103,1,249880000,249880000,6151,2050,4101,2050,0,1,2052,847301
168,2050,3200,4700,15040000,2,16406,4103,1,249880000,249880000,6151,2050,4101,2050,0,1,2052,847818

168,2450,3200,4700,15040000,2,19606,4903,1,275160000,275160000,7351,2450,4901,2450,0,1,2452,10748463
168,2450,3200,4700,15040000,2,19606,4903,1,275160000,275160000,7351,2450,4901,2450,0,1,2452,938770
168,2450,3200,4700,15040000,2,19606,4903,1,275160000,275160000,7351,2450,4901,2450,0,1,2452,935834
168,2450,3200,4700,15040000,2,19606,4903,1,275160000,275160000,7351,2450,4901,2450,0,1,2452,941036
168,2450,3200,4700,15040000,2,19606,4903,1,275160000,275160000,7351,2450,4901,2450,0,1,2452,939961
168,2450,3200,4700,15040000,2,19606,4903,1,275160000,275160000,7351,2450,4901,2450,0,1,2452,958825
168,2450,3200,4700,15040000,2,19606,4903,1,275160000,275160000,7351,2450,4901,2450,0,1,2452,980662

168,2850,3200,4700,15040000,2,22806,5703,1,300440000,300440000,8551,2850,5701,2850,0,1,2852,12177617
168,2850,3200,4700,15040000,2,22806,5703,1,300440000,300440000,8551,2850,5701,2850,0,1,2852,1144090
168,2850,3200,4700,15040000,2,22806,5703,1,300440000,300440000,8551,2850,5701,2850,0,1,2852,1139806
168,2850,3200,4700,15040000,2,22806,5703,1,300440000,300440000,8551,2850,5701,2850,0,1,2852,1145205
168,2850,3200,4700,15040000,2,22806,5703,1,300440000,300440000,8551,2850,5701,2850,0,1,2852,1145682
168,2850,3200,4700,15040000,2,22806,5703,1,300440000,300440000,8551,2850,5701,2850,0,1,2852,1146430
168,2850,3200,4700,15040000,2,22806,5703,1,300440000,300440000,8551,2850,5701,2850,0,1,2852,1142724

168,3250,3200,4700,15040000,2,26006,6503,1,325720000,325720000,9751,3250,6501,3250,0,1,3252,14312868
168,3250,3200,4700,15040000,2,26006,6503,1,325720000,325720000,9751,3250,6501,3250,0,1,3252,1210593
168,3250,3200,4700,15040000,2,26006,6503,1,325720000,325720000,9751,3250,6501,3250,0,1,3252,1207558
168,3250,3200,4700,15040000,2,26006,6503,1,325720000,325720000,9751,3250,6501,3250,0,1,3252,1213376
168,3250,3200,4700,15040000,2,26006,6503,1,325720000,325720000,9751,3250,6501,3250,0,1,3252,1211834
168,3250,3200,4700,15040000,2,26006,6503,1,325720000,325720000,9751,3250,6501,3250,0,1,3252,1231056
168,3250,3200,4700,15040000,2,26006,6503,1,325720000,325720000,9751,3250,6501,3250,0,1,3252,1230447

168,3650,3200,4700,15040000,2,29206,7303,1,351000000,351000000,10951,3650,7301,3650,0,1,3652,16491927
168,3650,3200,4700,15040000,2,29206,7303,1,351000000,351000000,10951,3650,7301,3650,0,1,3652,1352202
168,3650,3200,4700,15040000,2,29206,7303,1,351000000,351000000,10951,3650,7301,3650,0,1,3652,1355777
168,3650,3200,4700,15040000,2,29206,7303,1,351000000,351000000,10951,3650,7301,3650,0,1,3652,1362338
168,3650,3200,4700,15040000,2,29206,7303,1,351000000,351000000,10951,3650,7301,3650,0,1,3652,1360225
168,3650,3200,4700,15040000,2,29206,7303,1,351000000,351000000,10951,3650,7301,3650,0,1,3652,1371311
168,3650,3200,4700,15040000,2,29206,7303,1,351000000,351000000,10951,3650,7301,3650,0,1,3652,1380960

168,4050,3200,4700,15040000,2,32406,8103,1,376280000,376280000,12151,4050,8101,4050,0,1,4052,19044363
168,4050,3200,4700,15040000,2,32406,8103,1,376280000,376280000,12151,4050,8101,4050,0,1,4052,1546240
168,4050,3200,4700,15040000,2,32406,8103,1,376280000,376280000,12151,4050,8101,4050,0,1,4052,1545463
168,4050,3200,4700,15040000,2,32406,8103,1,376280000,376280000,12151,4050,8101,4050,0,1,4052,1548092
168,4050,3200,4700,15040000,2,32406,8103,1,376280000,376280000,12151,4050,8101,4050,0,1,4052,1515156
168,4050,3200,4700,15040000,2,32406,8103,1,376280000,376280000,12151,4050,8101,4050,0,1,4052,1544341
168,4050,3200,4700,15040000,2,32406,8103,1,376280000,376280000,12151,4050,8101,4050,0,1,4052,1533374

168,4450,3200,4700,15040000,2,35606,8903,1,401560000,401560000,13351,4450,8901,4450,0,1,4452,20246501
168,4450,3200,4700,15040000,2,35606,8903,1,401560000,401560000,13351,4450,8901,4450,0,1,4452,1636218
168,4450,3200,4700,15040000,2,35606,8903,1,401560000,401560000,13351,4450,8901,4450,0,1,4452,1641580
168,4450,3200,4700,15040000,2,35606,8903,1,401560000,401560000,13351,4450,8901,4450,0,1,4452,1642853
168,4450,3200,4700,15040000,2,35606,8903,1,401560000,401560000,13351,4450,8901,4450,0,1,4452,1638408
168,4450,3200,4700,15040000,2,35606,8903,1,401560000,401560000,13351,4450,8901,4450,0,1,4452,1644057
168,4450,3200,4700,15040000,2,35606,8903,1,401560000,401560000,13351,4450,8901,4450,0,1,4452,1644756

168,4850,3200,4700,15040000,2,38806,9703,1,426840000,426840000,14551,4850,9701,4850,0,1,4852,22691231
168,4850,3200,4700,15040000,2,38806,9703,1,426840000,426840000,14551,4850,9701,4850,0,1,4852,1819525
168,4850,3200,4700,15040000,2,38806,9703,1,426840000,426840000,14551,4850,9701,4850,0,1,4852,1802349
168,4850,3200,4700,15040000,2,38806,9703,1,426840000,426840000,14551,4850,9701,4850,0,1,4852,1816381
168,4850,3200,4700,15040000,2,38806,9703,1,426840000,426840000,14551,4850,9701,4850,0,1,4852,1818228
168,4850,3200,4700,15040000,2,38806,9703,1,426840000,426840000,14551,4850,9701,4850,0,1,4852,1821679
168,4850,3200,4700,15040000,2,38806,9703,1,426840000,426840000,14551,4850,9701,4850,0,1,4852,1820952

168,5250,3200,4700,15040000,2,42006,10503,1,452120000,452120000,15751,5250,10501,5250,0,1,5252,25110566
168,5250,3200,4700,15040000,2,42006,10503,1,452120000,452120000,15751,5250,10501,5250,0,1,5252,1960420
168,5250,3200,4700,15040000,2,42006,10503,1,452120000,452120000,15751,5250,10501,5250,0,1,5252,1957770
168,5250,3200,4700,15040000,2,42006,10503,1,452120000,452120000,15751,5250,10501,5250,0,1,5252,1962436
168,5250,3200,4700,15040000,2,42006,10503,1,452120000,452120000,15751,5250,10501,5250,0,1,5252,1961419
168,5250,3200,4700,15040000,2,42006,10503,1,452120000,452120000,15751,5250,10501,5250,0,1,5252,1928385
168,5250,3200,4700,15040000,2,42006,10503,1,452120000,452120000,15751,5250,10501,5250,0,1,5252,1946567

168,5650,3200,4700,15040000,2,45206,11303,1,477400000,477400000,16951,5650,11301,5650,0,1,5652,26387613
168,5650,3200,4700,15040000,2,45206,11303,1,477400000,477400000,16951,5650,11301,5650,0,1,5652,2075058
168,5650,3200,4700,15040000,2,45206,11303,1,477400000,477400000,16951,5650,11301,5650,0,1,5652,2059856
168,5650,3200,4700,15040000,2,45206,11303,1,477400000,477400000,16951,5650,11301,5650,0,1,5652,2076097
168,5650,3200,4700,15040000,2,45206,11303,1,477400000,477400000,16951,5650,11301,5650,0,1,5652,2074008
168,5650,3200,4700,15040000,2,45206,11303,1,477400000,477400000,16951,5650,11301,5650,0,1,5652,2052827
168,5650,3200,4700,15040000,2,45206,11303,1,477400000,477400000,16951,5650,11301,5650,0,1,5652,2031945

168,6050,3200,4700,15040000,2,48406,12103,1,502680000,502680000,18151,6050,12101,6050,0,1,6052,26878975
168,6050,3200,4700,15040000,2,48406,12103,1,502680000,502680000,18151,6050,12101,6050,0,1,6052,2219506
168,6050,3200,4700,15040000,2,48406,12103,1,502680000,502680000,18151,6050,12101,6050,0,1,6052,2214886
168,6050,3200,4700,15040000,2,48406,12103,1,502680000,502680000,18151,6050,12101,6050,0,1,6052,2220462
168,6050,3200,4700,15040000,2,48406,12103,1,502680000,502680000,18151,6050,12101,6050,0,1,6052,2221295
168,6050,3200,4700,15040000,2,48406,12103,1,502680000,502680000,18151,6050,12101,6050,0,1,6052,2207156
168,6050,3200,4700,15040000,2,48406,12103,1,502680000,502680000,18151,6050,12101,6050,0,1,6052,2201484

168,6450,3200,4700,15040000,2,51606,12903,1,527960000,527960000,19351,6450,12901,6450,0,1,6452,29349656
168,6450,3200,4700,15040000,2,51606,12903,1,527960000,527960000,19351,6450,12901,6450,0,1,6452,2343249
168,6450,3200,4700,15040000,2,51606,12903,1,527960000,527960000,19351,6450,12901,6450,0,1,6452,2348631
168,6450,3200,4700,15040000,2,51606,12903,1,527960000,527960000,19351,6450,12901,6450,0,1,6452,2351966
168,6450,3200,4700,15040000,2,51606,12903,1,527960000,527960000,19351,6450,12901,6450,0,1,6452,2350703
168,6450,3200,4700,15040000,2,51606,12903,1,527960000,527960000,19351,6450,12901,6450,0,1,6452,2316012
168,6450,3200,4700,15040000,2,51606,12903,1,527960000,527960000,19351,6450,12901,6450,0,1,6452,2335801

168,6850,3200,4700,15040000,2,54806,13703,1,553240000,553240000,20551,6850,13701,6850,0,1,6852,32570336
168,6850,3200,4700,15040000,2,54806,13703,1,553240000,553240000,20551,6850,13701,6850,0,1,6852,2538706
168,6850,3200,4700,15040000,2,54806,13703,1,553240000,553240000,20551,6850,13701,6850,0,1,6852,2513019
168,6850,3200,4700,15040000,2,54806,13703,1,553240000,553240000,20551,6850,13701,6850,0,1,6852,2539864
168,6850,3200,4700,15040000,2,54806,13703,1,553240000,553240000,20551,6850,13701,6850,0,1,6852,2494398
168,6850,3200,4700,15040000,2,54806,13703,1,553240000,553240000,20551,6850,13701,6850,0,1,6852,2476874
168,6850,3200,4700,15040000,2,54806,13703,1,553240000,553240000,20551,6850,13701,6850,0,1,6852,2445420

168,50,3200,4300,13760000,2,406,103,1,113080000,113080000,151,50,101,50,0,1,52,159916
168,50,3200,4300,13760000,2,406,103,1,113080000,113080000,151,50,101,50,0,1,52,138369
168,50,3200,4300,13760000,2,406,103,1,113080000,113080000,151,50,101,50,0,1,52,133491
168,50,3200,4300,13760000,2,406,103,1,113080000,113080000,151,50,101,50,0,1,52,136559
168,50,3200,4300,13760000,2,406,103,1,113080000,113080000,151,50,101,50,0,1,52,137915
168,50,3200,4300,13760000,2,406,103,1,113080000,113080000,151,50,101,50,0,1,52,172155
168,50,3200,4300,13760000,2,406,103,1,113080000,113080000,151,50,101,50,0,1,52,171673

168,450,3200,4300,13760000,2,3606,903,1,137080000,137080000,1351,450,901,450,0,1,452,1529258
168,450,3200,4300,13760000,2,3606,903,1,137080000,137080000,1351,450,901,450,0,1,452,262040
168,450,3200,4300,13760000,2,3606,903,1,137080000,137080000,1351,450,901,450,0,1,452,263264
168,450,3200,4300,13760000,2,3606,903,1,137080000,137080000,1351,450,901,450,0,1,452,262836
168,450,3200,4300,13760000,2,3606,903,1,137080000,137080000,1351,450,901,450,0,1,452,260455
168,450,3200,4300,13760000,2,3606,903,1,137080000,137080000,1351,450,901,450,0,1,452,267529
168,450,3200,4300,13760000,2,3606,903,1,137080000,137080000,1351,450,901,450,0,1,452,267931

168,850,3200,4300,13760000,2,6806,1703,1,161080000,161080000,2551,850,1701,850,0,1,852,3065627
168,850,3200,4300,13760000,2,6806,1703,1,161080000,161080000,2551,850,1701,850,0,1,852,386960
168,850,3200,4300,13760000,2,6806,1703,1,161080000,161080000,2551,850,1701,850,0,1,852,389810
168,850,3200,4300,13760000,2,6806,1703,1,161080000,161080000,2551,850,1701,850,0,1,852,389538
168,850,3200,4300,13760000,2,6806,1703,1,161080000,161080000,2551,850,1701,850,0,1,852,388816
168,850,3200,4300,13760000,2,6806,1703,1,161080000,161080000,2551,850,1701,850,0,1,852,392552
168,850,3200,4300,13760000,2,6806,1703,1,161080000,161080000,2551,850,1701,850,0,1,852,392981

168,1250,3200,4300,13760000,2,10006,2503,1,185080000,185080000,3751,1250,2501,1250,0,1,1252,4657761
168,1250,3200,4300,13760000,2,10006,2503,1,185080000,185080000,3751,1250,2501,1250,0,1,1252,524479
168,1250,3200,4300,13760000,2,10006,2503,1,185080000,185080000,3751,1250,2501,1250,0,1,1252,521909
168,1250,3200,4300,13760000,2,10006,2503,1,185080000,185080000,3751,1250,2501,1250,0,1,1252,525956
168,1250,3200,4300,13760000,2,10006,2503,1,185080000,185080000,3751,1250,2501,1250,0,1,1252,525476
168,1250,3200,4300,13760000,2,10006,2503,1,185080000,185080000,3751,1250,2501,1250,0,1,1252,527387
168,1250,3200,4300,13760000,2,10006,2503,1,185080000,185080000,3751,1250,2501,1250,0,1,1252,528498

168,1650,3200,4300,13760000,2,13206,3303,1,209080000,209080000,4951,1650,3301,1650,0,1,1652,6325217
168,1650,3200,4300,13760000,2,13206,3303,1,209080000,209080000,4951,1650,3301,1650,0,1,1652,679525
168,1650,3200,4300,13760000,2,13206,3303,1,209080000,209080000,4951,1650,3301,1650,0,1,1652,677564
168,1650,3200,4300,13760000,2,13206,3303,1,209080000,209080000,4951,1650,3301,1650,0,1,1652,676265
168,1650,3200,4300,13760000,2,13206,3303,1,209080000,209080000,4951,1650,3301,1650,0,1,1652,680127
168,1650,3200,4300,13760000,2,13206,3303,1,209080000,209080000,4951,1650,3301,1650,0,1,1652,668945
168,1650,3200,4300,13760000,2,13206,3303,1,209080000,209080000,4951,1650,3301,1650,0,1,1652,654119

168,2050,3200,4300,13760000,2,16406,4103,1,233080000,233080000,6151,2050,4101,2050,0,1,2052,8104607
168,2050,3200,4300,13760000,2,16406,4103,1,233080000,233080000,6151,2050,4101,2050,0,1,2052,736834
168,2050,3200,4300,13760000,2,16406,4103,1,233080000,233080000,6151,2050,4101,2050,0,1,2052,734771
168,2050,3200,4300,13760000,2,16406,4103,1,233080000,233080000,6151,2050,4101,2050,0,1,2052,737233
168,2050,3200,4300,13760000,2,16406,4103,1,233080000,233080000,6151,2050,4101,2050,0,1,2052,736260
168,2050,3200,4300,13760000,2,16406,4103,1,233080000,233080000,6151,2050,4101,2050,0,1,2052,786086
168,2050,3200,4300,13760000,2,16406,4103,1,233080000,233080000,6151,2050,4101,2050,0,1,2052,786598

168,2450,3200,4300,13760000,2,19606,4903,1,257080000,257080000,7351,2450,4901,2450,0,1,2452,9956396
168,2450,3200,4300,13760000,2,19606,4903,1,257080000,257080000,7351,2450,4901,2450,0,1,2452,862060
168,2450,3200,4300,13760000,2,19606,4903,1,257080000,257080000,7351,2450,4901,2450,0,1,2452,860690
168,2450,3200,4300,13760000,2,19606,4903,1,257080000,257080000,7351,2450,4901,2450,0,1,2452,864067
168,2450,3200,4300,13760000,2,19606,4903,1,257080000,257080000,7351,2450,4901,2450,0,1,2452,863200
168,2450,3200,4300,13760000,2,19606,4903,1,257080000,257080000,7351,2450,4901,2450,0,1,2452,886180
168,2450,3200,4300,13760000,2,19606,4903,1,257080000,257080000,7351,2450,4901,2450,0,1,2452,886714

168,2850,3200,4300,13760000,2,22806,5703,1,281080000,281080000,8551,2850,5701,2850,0,1,2852,11308448
168,2850,3200,4300,13760000,2,22806,5703,1,281080000,281080000,8551,2850,5701,2850,0,1,2852,969255
168,2850,3200,4300,13760000,2,22806,5703,1,281080000,281080000,8551,2850,5701,2850,0,1,2852,967793
168,2850,3200,4300,13760000,2,22806,5703,1,281080000,281080000,8551,2850,5701,2850,0,1,2852,971758
168,2850,3200,4300,13760000,2,22806,5703,1,281080000,281080000,8551,2850,5701,2850,0,1,2852,970346
168,2850,3200,4300,13760000,2,22806,5703,1,281080000,281080000,8551,2850,5701,2850,0,1,2852,1011398
168,2850,3200,4300,13760000,2,22806,5703,1,281080000,281080000,8551,2850,5701,2850,0,1,2852,1011972

168,3250,3200,4300,13760000,2,26006,6503,1,305080000,305080000,9751,3250,6501,3250,0,1,3252,12727893
168,3250,3200,4300,13760000,2,26006,6503,1,305080000,305080000,9751,3250,6501,3250,0,1,3252,1170810
168,3250,3200,4300,13760000,2,26006,6503,1,305080000,305080000,9751,3250,6501,3250,0,1,3252,1153261
168,3250,3200,4300,13760000,2,26006,6503,1,305080000,305080000,9751,3250,6501,3250,0,1,3252,1169095
168,3250,3200,4300,13760000,2,26006,6503,1,305080000,305080000,9751,3250,6501,3250,0,1,3252,1172199
168,3250,3200,4300,13760000,2,26006,6503,1,305080000,305080000,9751,3250,6501,3250,0,1,3252,1182103
168,3250,3200,4300,13760000,2,26006,6503,1,305080000,305080000,9751,3250,6501,3250,0,1,3252,1178896

168,3650,3200,4300,13760000,2,29206,7303,1,329080000,329080000,10951,3650,7301,3650,0,1,3652,15142512
168,3650,3200,4300,13760000,2,29206,7303,1,329080000,329080000,10951,3650,7301,3650,0,1,3652,1241303
168,3650,3200,4300,13760000,2,29206,7303,1,329080000,329080000,10951,3650,7301,3650,0,1,3652,1244911
168,3650,3200,4300,13760000,2,29206,7303,1,329080000,329080000,10951,3650,7301,3650,0,1,3652,1247558
168,3650,3200,4300,13760000,2,29206,7303,1,329080000,329080000,10951,3650,7301,3650,0,1,3652,1246515
168,3650,3200,4300,13760000,2,29206,7303,1,329080000,329080000,10951,3650,7301,3650,0,1,3652,1258192
168,3650,3200,4300,13760000,2,29206,7303,1,329080000,329080000,10951,3650,7301,3650,0,1,3652,1258815

168,4050,3200,4300,13760000,2,32406,8103,1,353080000,353080000,12151,4050,8101,4050,0,1,4052,17177920
168,4050,3200,4300,13760000,2,32406,8103,1,353080000,353080000,12151,4050,8101,4050,0,1,4052,1361286
168,4050,3200,4300,13760000,2,32406,8103,1,353080000,353080000,12151,4050,8101,4050,0,1,4052,1359548
168,4050,3200,4300,13760000,2,32406,8103,1,353080000,353080000,12151,4050,8101,4050,0,1,4052,1363235
168,4050,3200,4300,13760000,2,32406,8103,1,353080000,353080000,12151,4050,8101,4050,0,1,4052,1356013
168,4050,3200,4300,13760000,2,32406,8103,1,353080000,353080000,12151,4050,8101,4050,0,1,4052,1377145
168,4050,3200,4300,13760000,2,32406,8103,1,353080000,353080000,12151,4050,8101,4050,0,1,4052,1376302

168,4450,3200,4300,13760000,2,35606,8903,1,377080000,377080000,13351,4450,8901,4450,0,1,4452,18665088
168,4450,3200,4300,13760000,2,35606,8903,1,377080000,377080000,13351,4450,8901,4450,0,1,4452,1503198
168,4450,3200,4300,13760000,2,35606,8903,1,377080000,377080000,13351,4450,8901,4450,0,1,4452,1524379
168,4450,3200,4300,13760000,2,35606,8903,1,377080000,377080000,13351,4450,8901,4450,0,1,4452,1529117
168,4450,3200,4300,13760000,2,35606,8903,1,377080000,377080000,13351,4450,8901,4450,0,1,4452,1506867
168,4450,3200,4300,13760000,2,35606,8903,1,377080000,377080000,13351,4450,8901,4450,0,1,4452,1538534
168,4450,3200,4300,13760000,2,35606,8903,1,377080000,377080000,13351,4450,8901,4450,0,1,4452,1540208

168,4850,3200,4300,13760000,2,38806,9703,1,401080000,401080000,14551,4850,9701,4850,0,1,4852,20650101
168,4850,3200,4300,13760000,2,38806,9703,1,401080000,401080000,14551,4850,9701,4850,0,1,4852,1623342
168,4850,3200,4300,13760000,2,38806,9703,1,401080000,401080000,14551,4850,9701,4850,0,1,4852,1626002
168,4850,3200,4300,13760000,2,38806,9703,1,401080000,401080000,14551,4850,9701,4850,0,1,4852,1631796
168,4850,3200,4300,13760000,2,38806,9703,1,401080000,401080000,14551,4850,9701,4850,0,1,4852,1630985
168,4850,3200,4300,13760000,2,38806,9703,1,401080000,401080000,14551,4850,9701,4850,0,1,4852,1634635
168,4850,3200,4300,13760000,2,38806,9703,1,401080000,401080000,14551,4850,9701,4850,0,1,4852,1633923

168,5250,3200,4300,13760000,2,42006,10503,1,425080000,425080000,15751,5250,10501,5250,0,1,5252,21605839
168,5250,3200,4300,13760000,2,42006,10503,1,425080000,425080000,15751,5250,10501,5250,0,1,5252,1795580
168,5250,3200,4300,13760000,2,42006,10503,1,425080000,425080000,15751,5250,10501,5250,0,1,5252,1804843
168,5250,3200,4300,13760000,2,42006,10503,1,425080000,425080000,15751,5250,10501,5250,0,1,5252,1806519
168,5250,3200,4300,13760000,2,42006,10503,1,425080000,425080000,15751,5250,10501,5250,0,1,5252,1788672
168,5250,3200,4300,13760000,2,42006,10503,1,425080000,425080000,15751,5250,10501,5250,0,1,5252,1803125
168,5250,3200,4300,13760000,2,42006,10503,1,425080000,425080000,15751,5250,10501,5250,0,1,5252,1805355

168,5650,3200,4300,13760000,2,45206,11303,1,449080000,449080000,16951,5650,11301,5650,0,1,5652,24617705
168,5650,3200,4300,13760000,2,45206,11303,1,449080000,449080000,16951,5650,11301,5650,0,1,5652,1882299
168,5650,3200,4300,13760000,2,45206,11303,1,449080000,449080000,16951,5650,11301,5650,0,1,5652,1881396
168,5650,3200,4300,13760000,2,45206,11303,1,449080000,449080000,16951,5650,11301,5650,0,1,5652,1884163
168,5650,3200,4300,13760000,2,45206,11303,1,449080000,449080000,16951,5650,11301,5650,0,1,5652,1883367
168,5650,3200,4300,13760000,2,45206,11303,1,449080000,449080000,16951,5650,11301,5650,0,1,5652,1880112
168,5650,3200,4300,13760000,2,45206,11303,1,449080000,449080000,16951,5650,11301,5650,0,1,5652,1877829

168,6050,3200,4300,13760000,2,48406,12103,1,473080000,473080000,18151,6050,12101,6050,0,1,6052,26543957
168,6050,3200,4300,13760000,2,48406,12103,1,473080000,473080000,18151,6050,12101,6050,0,1,6052,2053990
168,6050,3200,4300,13760000,2,48406,12103,1,473080000,473080000,18151,6050,12101,6050,0,1,6052,2045887
168,6050,3200,4300,13760000,2,48406,12103,1,473080000,473080000,18151,6050,12101,6050,0,1,6052,2049612
168,6050,3200,4300,13760000,2,48406,12103,1,473080000,473080000,18151,6050,12101,6050,0,1,6052,2052920
168,6050,3200,4300,13760000,2,48406,12103,1,473080000,473080000,18151,6050,12101,6050,0,1,6052,2034539
168,6050,3200,4300,13760000,2,48406,12103,1,473080000,473080000,18151,6050,12101,6050,0,1,6052,2038735

168,6450,3200,4300,13760000,2,51606,12903,1,497080000,497080000,19351,6450,12901,6450,0,1,6452,27449424
168,6450,3200,4300,13760000,2,51606,12903,1,497080000,497080000,19351,6450,12901,6450,0,1,6452,2172741
168,6450,3200,4300,13760000,2,51606,12903,1,497080000,497080000,19351,6450,12901,6450,0,1,6452,2160870
168,6450,3200,4300,13760000,2,51606,12903,1,497080000,497080000,19351,6450,12901,6450,0,1,6452,2173620
168,6450,3200,4300,13760000,2,51606,12903,1,497080000,497080000,19351,6450,12901,6450,0,1,6452,2171783
168,6450,3200,4300,13760000,2,51606,12903,1,497080000,497080000,19351,6450,12901,6450,0,1,6452,2141640
168,6450,3200,4300,13760000,2,51606,12903,1,497080000,497080000,19351,6450,12901,6450,0,1,6452,2145917

168,6850,3200,4300,13760000,2,54806,13703,1,521080000,521080000,20551,6850,13701,6850,0,1,6852,28954899
168,6850,3200,4300,13760000,2,54806,13703,1,521080000,521080000,20551,6850,13701,6850,0,1,6852,2261287
168,6850,3200,4300,13760000,2,54806,13703,1,521080000,521080000,20551,6850,13701,6850,0,1,6852,2262943
168,6850,3200,4300,13760000,2,54806,13703,1,521080000,521080000,20551,6850,13701,6850,0,1,6852,2267791
168,6850,3200,4300,13760000,2,54806,13703,1,521080000,521080000,20551,6850,13701,6850,0,1,6852,2266668
168,6850,3200,4300,13760000,2,54806,13703,1,521080000,521080000,20551,6850,13701,6850,0,1,6852,2245468
168,6850,3200,4300,13760000,2,54806,13703,1,521080000,521080000,20551,6850,13701,6850,0,1,6852,2247442

168,50,3200,3900,12480000,2,406,103,1,102680000,102680000,151,50,101,50,0,1,52,142991
168,50,3200,3900,12480000,2,406,103,1,102680000,102680000,151,50,101,50,0,1,52,123898
168,50,3200,3900,12480000,2,406,103,1,102680000,102680000,151,50,101,50,0,1,52,122974
168,50,3200,3900,12480000,2,406,103,1,102680000,102680000,151,50,101,50,0,1,52,124353
168,50,3200,3900,12480000,2,406,103,1,102680000,102680000,151,50,101,50,0,1,52,114115
168,50,3200,3900,12480000,2,406,103,1,102680000,102680000,151,50,101,50,0,1,52,157169
168,50,3200,3900,12480000,2,406,103,1,102680000,102680000,151,50,101,50,0,1,52,157637

168,450,3200,3900,12480000,2,3606,903,1,125400000,125400000,1351,450,901,450,0,1,452,1335135
168,450,3200,3900,12480000,2,3606,903,1,125400000,125400000,1351,450,901,450,0,1,452,239395
168,450,3200,3900,12480000,2,3606,903,1,125400000,125400000,1351,450,901,450,0,1,452,238615
168,450,3200,3900,12480000,2,3606,903,1,125400000,125400000,1351,450,901,450,0,1,452,239819
168,450,3200,3900,12480000,2,3606,903,1,125400000,125400000,1351,450,901,450,0,1,452,237548
168,450,3200,3900,12480000,2,3606,903,1,125400000,125400000,1351,450,901,450,0,1,452,243346
168,450,3200,3900,12480000,2,3606,903,1,125400000,125400000,1351,450,901,450,0,1,452,243746

168,850,3200,3900,12480000,2,6806,1703,1,148120000,148120000,2551,850,1701,850,0,1,852,2818987
168,850,3200,3900,12480000,2,6806,1703,1,148120000,148120000,2551,850,1701,850,0,1,852,385949
168,850,3200,3900,12480000,2,6806,1703,1,148120000,148120000,2551,850,1701,850,0,1,852,386410
168,850,3200,3900,12480000,2,6806,1703,1,148120000,148120000,2551,850,1701,850,0,1,852,384094
168,850,3200,3900,12480000,2,6806,1703,1,148120000,148120000,2551,850,1701,850,0,1,852,387125
168,850,3200,3900,12480000,2,6806,1703,1,148120000,148120000,2551,850,1701,850,0,1,852,387403
168,850,3200,3900,12480000,2,6806,1703,1,148120000,148120000,2551,850,1701,850,0,1,852,387838

168,1250,3200,3900,12480000,2,10006,2503,1,170840000,170840000,3751,1250,2501,1250,0,1,1252,4315381
168,1250,3200,3900,12480000,2,10006,2503,1,170840000,170840000,3751,1250,2501,1250,0,1,1252,478942
168,1250,3200,3900,12480000,2,10006,2503,1,170840000,170840000,3751,1250,2501,1250,0,1,1252,475164
168,1250,3200,3900,12480000,2,10006,2503,1,170840000,170840000,3751,1250,2501,1250,0,1,1252,476907
168,1250,3200,3900,12480000,2,10006,2503,1,170840000,170840000,3751,1250,2501,1250,0,1,1252,478261
168,1250,3200,3900,12480000,2,10006,2503,1,170840000,170840000,3751,1250,2501,1250,0,1,1252,479717
168,1250,3200,3900,12480000,2,10006,2503,1,170840000,170840000,3751,1250,2501,1250,0,1,1252,480177

168,1650,3200,3900,12480000,2,13206,3303,1,193560000,193560000,4951,1650,3301,1650,0,1,1652,5934723
168,1650,3200,3900,12480000,2,13206,3303,1,193560000,193560000,4951,1650,3301,1650,0,1,1652,550101
168,1650,3200,3900,12480000,2,13206,3303,1,193560000,193560000,4951,1650,3301,1650,0,1,1652,553226
168,1650,3200,3900,12480000,2,13206,3303,1,193560000,193560000,4951,1650,3301,1650,0,1,1652,552862
168,1650,3200,3900,12480000,2,13206,3303,1,193560000,193560000,4951,1650,3301,1650,0,1,1652,552326
168,1650,3200,3900,12480000,2,13206,3303,1,193560000,193560000,4951,1650,3301,1650,0,1,1652,592771
168,1650,3200,3900,12480000,2,13206,3303,1,193560000,193560000,4951,1650,3301,1650,0,1,1652,593256

168,2050,3200,3900,12480000,2,16406,4103,1,216280000,216280000,6151,2050,4101,2050,0,1,2052,7537253
168,2050,3200,3900,12480000,2,16406,4103,1,216280000,216280000,6151,2050,4101,2050,0,1,2052,689026
168,2050,3200,3900,12480000,2,16406,4103,1,216280000,216280000,6151,2050,4101,2050,0,1,2052,681746
168,2050,3200,3900,12480000,2,16406,4103,1,216280000,216280000,6151,2050,4101,2050,0,1,2052,687870
168,2050,3200,3900,12480000,2,16406,4103,1,216280000,216280000,6151,2050,4101,2050,0,1,2052,689830
168,2050,3200,3900,12480000,2,16406,4103,1,216280000,216280000,6151,2050,4101,2050,0,1,2052,694283
168,2050,3200,3900,12480000,2,16406,4103,1,216280000,216280000,6151,2050,4101,2050,0,1,2052,694866

168,2450,3200,3900,12480000,2,19606,4903,1,239000000,239000000,7351,2450,4901,2450,0,1,2452,9184943
168,2450,3200,3900,12480000,2,19606,4903,1,239000000,239000000,7351,2450,4901,2450,0,1,2452,803948
168,2450,3200,3900,12480000,2,19606,4903,1,239000000,239000000,7351,2450,4901,2450,0,1,2452,797418
168,2450,3200,3900,12480000,2,19606,4903,1,239000000,239000000,7351,2450,4901,2450,0,1,2452,805639
168,2450,3200,3900,12480000,2,19606,4903,1,239000000,239000000,7351,2450,4901,2450,0,1,2452,802062
168,2450,3200,3900,12480000,2,19606,4903,1,239000000,239000000,7351,2450,4901,2450,0,1,2452,823773
168,2450,3200,3900,12480000,2,19606,4903,1,239000000,239000000,7351,2450,4901,2450,0,1,2452,816236

168,2850,3200,3900,12480000,2,22806,5703,1,261720000,261720000,8551,2850,5701,2850,0,1,2852,10350292
168,2850,3200,3900,12480000,2,22806,5703,1,261720000,261720000,8551,2850,5701,2850,0,1,2852,900971
168,2850,3200,3900,12480000,2,22806,5703,1,261720000,261720000,8551,2850,5701,2850,0,1,2852,898426
168,2850,3200,3900,12480000,2,22806,5703,1,261720000,261720000,8551,2850,5701,2850,0,1,2852,903429
168,2850,3200,3900,12480000,2,22806,5703,1,261720000,261720000,8551,2850,5701,2850,0,1,2852,902072
168,2850,3200,3900,12480000,2,22806,5703,1,261720000,261720000,8551,2850,5701,2850,0,1,2852,921502
168,2850,3200,3900,12480000,2,22806,5703,1,261720000,261720000,8551,2850,5701,2850,0,1,2852,922069

168,3250,3200,3900,12480000,2,26006,6503,1,284440000,284440000,9751,3250,6501,3250,0,1,3252,11656159
168,3250,3200,3900,12480000,2,26006,6503,1,284440000,284440000,9751,3250,6501,3250,0,1,3252,1046781
168,3250,3200,3900,12480000,2,26006,6503,1,284440000,284440000,9751,3250,6501,3250,0,1,3252,1051472
168,3250,3200,3900,12480000,2,26006,6503,1,284440000,284440000,9751,3250,6501,3250,0,1,3252,1053204
168,3250,3200,3900,12480000,2,26006,6503,1,284440000,284440000,9751,3250,6501,3250,0,1,3252,1054890
168,3250,3200,3900,12480000,2,26006,6503,1,284440000,284440000,9751,3250,6501,3250,0,1,3252,1070451
168,3250,3200,3900,12480000,2,26006,6503,1,284440000,284440000,9751,3250,6501,3250,0,1,3252,1072895

168,3650,3200,3900,12480000,2,29206,7303,1,307160000,307160000,10951,3650,7301,3650,0,1,3652,13120381
168,3650,3200,3900,12480000,2,29206,7303,1,307160000,307160000,10951,3650,7301,3650,0,1,3652,1129900
168,3650,3200,3900,12480000,2,29206,7303,1,307160000,307160000,10951,3650,7301,3650,0,1,3652,1132178
168,3650,3200,3900,12480000,2,29206,7303,1,307160000,307160000,10951,3650,7301,3650,0,1,3652,1143090
168,3650,3200,3900,12480000,2,29206,7303,1,307160000,307160000,10951,3650,7301,3650,0,1,3652,1141563
168,3650,3200,3900,12480000,2,29206,7303,1,307160000,307160000,10951,3650,7301,3650,0,1,3652,1159144
168,3650,3200,3900,12480000,2,29206,7303,1,307160000,307160000,10951,3650,7301,3650,0,1,3652,1159769

168,4050,3200,3900,12480000,2,32406,8103,1,329880000,329880000,12151,4050,8101,4050,0,1,4052,15166340
168,4050,3200,3900,12480000,2,32406,8103,1,329880000,329880000,12151,4050,8101,4050,0,1,4052,1243194
168,4050,3200,3900,12480000,2,32406,8103,1,329880000,329880000,12151,4050,8101,4050,0,1,4052,1238612
168,4050,3200,3900,12480000,2,32406,8103,1,329880000,329880000,12151,4050,8101,4050,0,1,4052,1246938
168,4050,3200,3900,12480000,2,32406,8103,1,329880000,329880000,12151,4050,8101,4050,0,1,4052,1245018
168,4050,3200,3900,12480000,2,32406,8103,1,329880000,329880000,12151,4050,8101,4050,0,1,4052,1262076
168,4050,3200,3900,12480000,2,32406,8103,1,329880000,329880000,12151,4050,8101,4050,0,1,4052,1261420

168,4450,3200,3900,12480000,2,35606,8903,1,352600000,352600000,13351,4450,8901,4450,0,1,4452,16828964
168,4450,3200,3900,12480000,2,35606,8903,1,352600000,352600000,13351,4450,8901,4450,0,1,4452,1452788
168,4450,3200,3900,12480000,2,35606,8903,1,352600000,352600000,13351,4450,8901,4450,0,1,4452,1442541
168,4450,3200,3900,12480000,2,35606,8903,1,352600000,352600000,13351,4450,8901,4450,0,1,4452,1447718
168,4450,3200,3900,12480000,2,35606,8903,1,352600000,352600000,13351,4450,8901,4450,0,1,4452,1453447
168,4450,3200,3900,12480000,2,35606,8903,1,352600000,352600000,13351,4450,8901,4450,0,1,4452,1450810
168,4450,3200,3900,12480000,2,35606,8903,1,352600000,352600000,13351,4450,8901,4450,0,1,4452,1451996

168,4850,3200,3900,12480000,2,38806,9703,1,375320000,375320000,14551,4850,9701,4850,0,1,4852,18894253
168,4850,3200,3900,12480000,2,38806,9703,1,375320000,375320000,14551,4850,9701,4850,0,1,4852,1483993
168,4850,3200,3900,12480000,2,38806,9703,1,375320000,375320000,14551,4850,9701,4850,0,1,4852,1483155
168,4850,3200,3900,12480000,2,38806,9703,1,375320000,375320000,14551,4850,9701,4850,0,1,4852,1485096
168,4850,3200,3900,12480000,2,38806,9703,1,375320000,375320000,14551,4850,9701,4850,0,1,4852,1481372
168,4850,3200,3900,12480000,2,38806,9703,1,375320000,375320000,14551,4850,9701,4850,0,1,4852,1488082
168,4850,3200,3900,12480000,2,38806,9703,1,375320000,375320000,14551,4850,9701,4850,0,1,4852,1488791

168,5250,3200,3900,12480000,2,42006,10503,1,398040000,398040000,15751,5250,10501,5250,0,1,5252,21184376
168,5250,3200,3900,12480000,2,42006,10503,1,398040000,398040000,15751,5250,10501,5250,0,1,5252,1677080
168,5250,3200,3900,12480000,2,42006,10503,1,398040000,398040000,15751,5250,10501,5250,0,1,5252,1668454
168,5250,3200,3900,12480000,2,42006,10503,1,398040000,398040000,15751,5250,10501,5250,0,1,5252,1674981
168,5250,3200,3900,12480000,2,42006,10503,1,398040000,398040000,15751,5250,10501,5250,0,1,5252,1676150
168,5250,3200,3900,12480000,2,42006,10503,1,398040000,398040000,15751,5250,10501,5250,0,1,5252,1659326
168,5250,3200,3900,12480000,2,42006,10503,1,398040000,398040000,15751,5250,10501,5250,0,1,5252,1666708

168,5650,3200,3900,12480000,2,45206,11303,1,420760000,420760000,16951,5650,11301,5650,0,1,5652,21969951
168,5650,3200,3900,12480000,2,45206,11303,1,420760000,420760000,16951,5650,11301,5650,0,1,5652,1752074
168,5650,3200,3900,12480000,2,45206,11303,1,420760000,420760000,16951,5650,11301,5650,0,1,5652,1757747
168,5650,3200,3900,12480000,2,45206,11303,1,420760000,420760000,16951,5650,11301,5650,0,1,5652,1758538
168,5650,3200,3900,12480000,2,45206,11303,1,420760000,420760000,16951,5650,11301,5650,0,1,5652,1756834
168,5650,3200,3900,12480000,2,45206,11303,1,420760000,420760000,16951,5650,11301,5650,0,1,5652,1745411
168,5650,3200,3900,12480000,2,45206,11303,1,420760000,420760000,16951,5650,11301,5650,0,1,5652,1743929

168,6050,3200,3900,12480000,2,48406,12103,1,443480000,443480000,18151,6050,12101,6050,0,1,6052,23832401
168,6050,3200,3900,12480000,2,48406,12103,1,443480000,443480000,18151,6050,12101,6050,0,1,6052,1870771
168,6050,3200,3900,12480000,2,48406,12103,1,443480000,443480000,18151,6050,12101,6050,0,1,6052,1866140
168,6050,3200,3900,12480000,2,48406,12103,1,443480000,443480000,18151,6050,12101,6050,0,1,6052,1865424
168,6050,3200,3900,12480000,2,48406,12103,1,443480000,443480000,18151,6050,12101,6050,0,1,6052,1869687
168,6050,3200,3900,12480000,2,48406,12103,1,443480000,443480000,18151,6050,12101,6050,0,1,6052,1863896
168,6050,3200,3900,12480000,2,48406,12103,1,443480000,443480000,18151,6050,12101,6050,0,1,6052,1852447

168,6450,3200,3900,12480000,2,51606,12903,1,466200000,466200000,19351,6450,12901,6450,0,1,6452,25602032
168,6450,3200,3900,12480000,2,51606,12903,1,466200000,466200000,19351,6450,12901,6450,0,1,6452,1942006
168,6450,3200,3900,12480000,2,51606,12903,1,466200000,466200000,19351,6450,12901,6450,0,1,6452,1941404
168,6450,3200,3900,12480000,2,51606,12903,1,466200000,466200000,19351,6450,12901,6450,0,1,6452,1944026
168,6450,3200,3900,12480000,2,51606,12903,1,466200000,466200000,19351,6450,12901,6450,0,1,6452,1942913
168,6450,3200,3900,12480000,2,51606,12903,1,466200000,466200000,19351,6450,12901,6450,0,1,6452,1936348
168,6450,3200,3900,12480000,2,51606,12903,1,466200000,466200000,19351,6450,12901,6450,0,1,6452,1934452

168,6850,3200,3900,12480000,2,54806,13703,1,488920000,488920000,20551,6850,13701,6850,0,1,6852,26605042
168,6850,3200,3900,12480000,2,54806,13703,1,488920000,488920000,20551,6850,13701,6850,0,1,6852,2143706
168,6850,3200,3900,12480000,2,54806,13703,1,488920000,488920000,20551,6850,13701,6850,0,1,6852,2147223
168,6850,3200,3900,12480000,2,54806,13703,1,488920000,488920000,20551,6850,13701,6850,0,1,6852,2150040
168,6850,3200,3900,12480000,2,54806,13703,1,488920000,488920000,20551,6850,13701,6850,0,1,6852,2139320
168,6850,3200,3900,12480000,2,54806,13703,1,488920000,488920000,20551,6850,13701,6850,0,1,6852,2123766
168,6850,3200,3900,12480000,2,54806,13703,1,488920000,488920000,20551,6850,13701,6850,0,1,6852,2121376

168,50,3200,3500,11200000,2,406,103,1,92280000,92280000,151,50,101,50,0,1,52,127984
168,50,3200,3500,11200000,2,406,103,1,92280000,92280000,151,50,101,50,0,1,52,111016
168,50,3200,3500,11200000,2,406,103,1,92280000,92280000,151,50,101,50,0,1,52,112713
168,50,3200,3500,11200000,2,406,103,1,92280000,92280000,151,50,101,50,0,1,52,100115
168,50,3200,3500,11200000,2,406,103,1,92280000,92280000,151,50,101,50,0,1,52,113166
168,50,3200,3500,11200000,2,406,103,1,92280000,92280000,151,50,101,50,0,1,52,141107
168,50,3200,3500,11200000,2,406,103,1,92280000,92280000,151,50,101,50,0,1,52,140632

168,450,3200,3500,11200000,2,3606,903,1,113720000,113720000,1351,450,901,450,0,1,452,1204819
168,450,3200,3500,11200000,2,3606,903,1,113720000,113720000,1351,450,901,450,0,1,452,222919
168,450,3200,3500,11200000,2,3606,903,1,113720000,113720000,1351,450,901,450,0,1,452,223626
168,450,3200,3500,11200000,2,3606,903,1,113720000,113720000,1351,450,901,450,0,1,452,220556
168,450,3200,3500,11200000,2,3606,903,1,113720000,113720000,1351,450,901,450,0,1,452,222401
168,450,3200,3500,11200000,2,3606,903,1,113720000,113720000,1351,450,901,450,0,1,452,225320
168,450,3200,3500,11200000,2,3606,903,1,113720000,113720000,1351,450,901,450,0,1,452,225727

168,850,3200,3500,11200000,2,6806,1703,1,135160000,135160000,2551,850,1701,850,0,1,852,2436249
168,850,3200,3500,11200000,2,6806,1703,1,135160000,135160000,2551,850,1701,850,0,1,852,327583
168,850,3200,3500,11200000,2,6806,1703,1,135160000,135160000,2551,850,1701,850,0,1,852,326706
168,850,3200,3500,11200000,2,6806,1703,1,135160000,135160000,2551,850,1701,850,0,1,852,328016
168,850,3200,3500,11200000,2,6806,1703,1,135160000,135160000,2551,850,1701,850,0,1,852,324569
168,850,3200,3500,11200000,2,6806,1703,1,135160000,135160000,2551,850,1701,850,0,1,852,329175
168,850,3200,3500,11200000,2,6806,1703,1,135160000,135160000,2551,850,1701,850,0,1,852,329606

168,1250,3200,3500,11200000,2,10006,2503,1,156600000,156600000,3751,1250,2501,1250,0,1,1252,3746575
168,1250,3200,3500,11200000,2,10006,2503,1,156600000,156600000,3751,1250,2501,1250,0,1,1252,431759
168,1250,3200,3500,11200000,2,10006,2503,1,156600000,156600000,3751,1250,2501,1250,0,1,1252,434448
168,1250,3200,3500,11200000,2,10006,2503,1,156600000,156600000,3751,1250,2501,1250,0,1,1252,433870
168,1250,3200,3500,11200000,2,10006,2503,1,156600000,156600000,3751,1250,2501,1250,0,1,1252,433489
168,1250,3200,3500,11200000,2,10006,2503,1,156600000,156600000,3751,1250,2501,1250,0,1,1252,435577
168,1250,3200,3500,11200000,2,10006,2503,1,156600000,156600000,3751,1250,2501,1250,0,1,1252,436102

168,1650,3200,3500,11200000,2,13206,3303,1,178040000,178040000,4951,1650,3301,1650,0,1,1652,5366489
168,1650,3200,3500,11200000,2,13206,3303,1,178040000,178040000,4951,1650,3301,1650,0,1,1652,513393
168,1650,3200,3500,11200000,2,13206,3303,1,178040000,178040000,4951,1650,3301,1650,0,1,1652,516986
168,1650,3200,3500,11200000,2,13206,3303,1,178040000,178040000,4951,1650,3301,1650,0,1,1652,516308
168,1650,3200,3500,11200000,2,13206,3303,1,178040000,178040000,4951,1650,3301,1650,0,1,1652,515306
168,1650,3200,3500,11200000,2,13206,3303,1,178040000,178040000,4951,1650,3301,1650,0,1,1652,526260
168,1650,3200,3500,11200000,2,13206,3303,1,178040000,178040000,4951,1650,3301,1650,0,1,1652,525773

168,2050,3200,3500,11200000,2,16406,4103,1,199480000,199480000,6151,2050,4101,2050,0,1,2052,6600689
168,2050,3200,3500,11200000,2,16406,4103,1,199480000,199480000,6151,2050,4101,2050,0,1,2052,664042
168,2050,3200,3500,11200000,2,16406,4103,1,199480000,199480000,6151,2050,4101,2050,0,1,2052,673464
168,2050,3200,3500,11200000,2,16406,4103,1,199480000,199480000,6151,2050,4101,2050,0,1,2052,675084
168,2050,3200,3500,11200000,2,16406,4103,1,199480000,199480000,6151,2050,4101,2050,0,1,2052,664970
168,2050,3200,3500,11200000,2,16406,4103,1,199480000,199480000,6151,2050,4101,2050,0,1,2052,675735
168,2050,3200,3500,11200000,2,16406,4103,1,199480000,199480000,6151,2050,4101,2050,0,1,2052,676428

168,2450,3200,3500,11200000,2,19606,4903,1,220920000,220920000,7351,2450,4901,2450,0,1,2452,7904100
168,2450,3200,3500,11200000,2,19606,4903,1,220920000,220920000,7351,2450,4901,2450,0,1,2452,704923
168,2450,3200,3500,11200000,2,19606,4903,1,220920000,220920000,7351,2450,4901,2450,0,1,2452,703685
168,2450,3200,3500,11200000,2,19606,4903,1,220920000,220920000,7351,2450,4901,2450,0,1,2452,705813
168,2450,3200,3500,11200000,2,19606,4903,1,220920000,220920000,7351,2450,4901,2450,0,1,2452,706487
168,2450,3200,3500,11200000,2,19606,4903,1,220920000,220920000,7351,2450,4901,2450,0,1,2452,749732
168,2450,3200,3500,11200000,2,19606,4903,1,220920000,220920000,7351,2450,4901,2450,0,1,2452,750266

168,2850,3200,3500,11200000,2,22806,5703,1,242360000,242360000,8551,2850,5701,2850,0,1,2852,9410129
168,2850,3200,3500,11200000,2,22806,5703,1,242360000,242360000,8551,2850,5701,2850,0,1,2852,807362
168,2850,3200,3500,11200000,2,22806,5703,1,242360000,242360000,8551,2850,5701,2850,0,1,2852,805554
168,2850,3200,3500,11200000,2,22806,5703,1,242360000,242360000,8551,2850,5701,2850,0,1,2852,808875
168,2850,3200,3500,11200000,2,22806,5703,1,242360000,242360000,8551,2850,5701,2850,0,1,2852,808166
168,2850,3200,3500,11200000,2,22806,5703,1,242360000,242360000,8551,2850,5701,2850,0,1,2852,863371
168,2850,3200,3500,11200000,2,22806,5703,1,242360000,242360000,8551,2850,5701,2850,0,1,2852,862805

168,3250,3200,3500,11200000,2,26006,6503,1,263800000,263800000,9751,3250,6501,3250,0,1,3252,10725523
168,3250,3200,3500,11200000,2,26006,6503,1,263800000,263800000,9751,3250,6501,3250,0,1,3252,899468
168,3250,3200,3500,11200000,2,26006,6503,1,263800000,263800000,9751,3250,6501,3250,0,1,3252,898045
168,3250,3200,3500,11200000,2,26006,6503,1,263800000,263800000,9751,3250,6501,3250,0,1,3252,901237
168,3250,3200,3500,11200000,2,26006,6503,1,263800000,263800000,9751,3250,6501,3250,0,1,3252,900446
168,3250,3200,3500,11200000,2,26006,6503,1,263800000,263800000,9751,3250,6501,3250,0,1,3252,952557
168,3250,3200,3500,11200000,2,26006,6503,1,263800000,263800000,9751,3250,6501,3250,0,1,3252,953160

168,3650,3200,3500,11200000,2,29206,7303,1,285240000,285240000,10951,3650,7301,3650,0,1,3652,11523813
168,3650,3200,3500,11200000,2,29206,7303,1,285240000,285240000,10951,3650,7301,3650,0,1,3652,1002323
168,3650,3200,3500,11200000,2,29206,7303,1,285240000,285240000,10951,3650,7301,3650,0,1,3652,999984
168,3650,3200,3500,11200000,2,29206,7303,1,285240000,285240000,10951,3650,7301,3650,0,1,3652,1007431
168,3650,3200,3500,11200000,2,29206,7303,1,285240000,285240000,10951,3650,7301,3650,0,1,3652,1005844
168,3650,3200,3500,11200000,2,29206,7303,1,285240000,285240000,10951,3650,7301,3650,0,1,3652,1042805
168,3650,3200,3500,11200000,2,29206,7303,1,285240000,285240000,10951,3650,7301,3650,0,1,3652,1043429

168,4050,3200,3500,11200000,2,32406,8103,1,306680000,306680000,12151,4050,8101,4050,0,1,4052,13141861
168,4050,3200,3500,11200000,2,32406,8103,1,306680000,306680000,12151,4050,8101,4050,0,1,4052,1153421
168,4050,3200,3500,11200000,2,32406,8103,1,306680000,306680000,12151,4050,8101,4050,0,1,4052,1163235
168,4050,3200,3500,11200000,2,32406,8103,1,306680000,306680000,12151,4050,8101,4050,0,1,4052,1164979
168,4050,3200,3500,11200000,2,32406,8103,1,306680000,306680000,12151,4050,8101,4050,0,1,4052,1156787
168,4050,3200,3500,11200000,2,32406,8103,1,306680000,306680000,12151,4050,8101,4050,0,1,4052,1178857
168,4050,3200,3500,11200000,2,32406,8103,1,306680000,306680000,12151,4050,8101,4050,0,1,4052,1180382

168,4450,3200,3500,11200000,2,35606,8903,1,328120000,328120000,13351,4450,8901,4450,0,1,4452,15084931
168,4450,3200,3500,11200000,2,35606,8903,1,328120000,328120000,13351,4450,8901,4450,0,1,4452,1221530
168,4450,3200,3500,11200000,2,35606,8903,1,328120000,328120000,13351,4450,8901,4450,0,1,4452,1214614
168,4450,3200,3500,11200000,2,35606,8903,1,328120000,328120000,13351,4450,8901,4450,0,1,4452,1222918
168,4450,3200,3500,11200000,2,35606,8903,1,328120000,328120000,13351,4450,8901,4450,0,1,4452,1219861
168,4450,3200,3500,11200000,2,35606,8903,1,328120000,328120000,13351,4450,8901,4450,0,1,4452,1245548
168,4450,3200,3500,11200000,2,35606,8903,1,328120000,328120000,13351,4450,8901,4450,0,1,4452,1246218

168,4850,3200,3500,11200000,2,38806,9703,1,349560000,349560000,14551,4850,9701,4850,0,1,4852,16306538
168,4850,3200,3500,11200000,2,38806,9703,1,349560000,349560000,14551,4850,9701,4850,0,1,4852,1336287
168,4850,3200,3500,11200000,2,38806,9703,1,349560000,349560000,14551,4850,9701,4850,0,1,4852,1326565
168,4850,3200,3500,11200000,2,38806,9703,1,349560000,349560000,14551,4850,9701,4850,0,1,4852,1339516
168,4850,3200,3500,11200000,2,38806,9703,1,349560000,349560000,14551,4850,9701,4850,0,1,4852,1338064
168,4850,3200,3500,11200000,2,38806,9703,1,349560000,349560000,14551,4850,9701,4850,0,1,4852,1354492
168,4850,3200,3500,11200000,2,38806,9703,1,349560000,349560000,14551,4850,9701,4850,0,1,4852,1355188

168,5250,3200,3500,11200000,2,42006,10503,1,371000000,371000000,15751,5250,10501,5250,0,1,5252,18600206
168,5250,3200,3500,11200000,2,42006,10503,1,371000000,371000000,15751,5250,10501,5250,0,1,5252,1524160
168,5250,3200,3500,11200000,2,42006,10503,1,371000000,371000000,15751,5250,10501,5250,0,1,5252,1516980
168,5250,3200,3500,11200000,2,42006,10503,1,371000000,371000000,15751,5250,10501,5250,0,1,5252,1519040
168,5250,3200,3500,11200000,2,42006,10503,1,371000000,371000000,15751,5250,10501,5250,0,1,5252,1525136
168,5250,3200,3500,11200000,2,42006,10503,1,371000000,371000000,15751,5250,10501,5250,0,1,5252,1523139
168,5250,3200,3500,11200000,2,42006,10503,1,371000000,371000000,15751,5250,10501,5250,0,1,5252,1519439

168,5650,3200,3500,11200000,2,45206,11303,1,392440000,392440000,16951,5650,11301,5650,0,1,5652,19213487
168,5650,3200,3500,11200000,2,45206,11303,1,392440000,392440000,16951,5650,11301,5650,0,1,5652,1562696
168,5650,3200,3500,11200000,2,45206,11303,1,392440000,392440000,16951,5650,11301,5650,0,1,5652,1557442
168,5650,3200,3500,11200000,2,45206,11303,1,392440000,392440000,16951,5650,11301,5650,0,1,5652,1564857
168,5650,3200,3500,11200000,2,45206,11303,1,392440000,392440000,16951,5650,11301,5650,0,1,5652,1560818
168,5650,3200,3500,11200000,2,45206,11303,1,392440000,392440000,16951,5650,11301,5650,0,1,5652,1567455
168,5650,3200,3500,11200000,2,45206,11303,1,392440000,392440000,16951,5650,11301,5650,0,1,5652,1566698

168,6050,3200,3500,11200000,2,48406,12103,1,413880000,413880000,18151,6050,12101,6050,0,1,6052,20420461
168,6050,3200,3500,11200000,2,48406,12103,1,413880000,413880000,18151,6050,12101,6050,0,1,6052,1708710
168,6050,3200,3500,11200000,2,48406,12103,1,413880000,413880000,18151,6050,12101,6050,0,1,6052,1698493
168,6050,3200,3500,11200000,2,48406,12103,1,413880000,413880000,18151,6050,12101,6050,0,1,6052,1705485
168,6050,3200,3500,11200000,2,48406,12103,1,413880000,413880000,18151,6050,12101,6050,0,1,6052,1710124
168,6050,3200,3500,11200000,2,48406,12103,1,413880000,413880000,18151,6050,12101,6050,0,1,6052,1709274
168,6050,3200,3500,11200000,2,48406,12103,1,413880000,413880000,18151,6050,12101,6050,0,1,6052,1707739

168,6450,3200,3500,11200000,2,51606,12903,1,435320000,435320000,19351,6450,12901,6450,0,1,6452,22841232
168,6450,3200,3500,11200000,2,51606,12903,1,435320000,435320000,19351,6450,12901,6450,0,1,6452,1762764
168,6450,3200,3500,11200000,2,51606,12903,1,435320000,435320000,19351,6450,12901,6450,0,1,6452,1768405
168,6450,3200,3500,11200000,2,51606,12903,1,435320000,435320000,19351,6450,12901,6450,0,1,6452,1769882
168,6450,3200,3500,11200000,2,51606,12903,1,435320000,435320000,19351,6450,12901,6450,0,1,6452,1766636
168,6450,3200,3500,11200000,2,51606,12903,1,435320000,435320000,19351,6450,12901,6450,0,1,6452,1770603
168,6450,3200,3500,11200000,2,51606,12903,1,435320000,435320000,19351,6450,12901,6450,0,1,6452,1771442

168,6850,3200,3500,11200000,2,54806,13703,1,456760000,456760000,20551,6850,13701,6850,0,1,6852,24200785
168,6850,3200,3500,11200000,2,54806,13703,1,456760000,456760000,20551,6850,13701,6850,0,1,6852,1928523
168,6850,3200,3500,11200000,2,54806,13703,1,456760000,456760000,20551,6850,13701,6850,0,1,6852,1919640
168,6850,3200,3500,11200000,2,54806,13703,1,456760000,456760000,20551,6850,13701,6850,0,1,6852,1924256
168,6850,3200,3500,11200000,2,54806,13703,1,456760000,456760000,20551,6850,13701,6850,0,1,6852,1929683
168,6850,3200,3500,11200000,2,54806,13703,1,456760000,456760000,20551,6850,13701,6850,0,1,6852,1905197
168,6850,3200,3500,11200000,2,54806,13703,1,456760000,456760000,20551,6850,13701,6850,0,1,6852,1909812

168,50,3200,3100,9920000,2,406,103,1,81880000,81880000,151,50,101,50,0,1,52,111760
168,50,3200,3100,9920000,2,406,103,1,81880000,81880000,151,50,101,50,0,1,52,98099
168,50,3200,3100,9920000,2,406,103,1,81880000,81880000,151,50,101,50,0,1,52,98551
168,50,3200,3100,9920000,2,406,103,1,81880000,81880000,151,50,101,50,0,1,52,85285
168,50,3200,3100,9920000,2,406,103,1,81880000,81880000,151,50,101,50,0,1,52,93477
168,50,3200,3100,9920000,2,406,103,1,81880000,81880000,151,50,101,50,0,1,52,126698
168,50,3200,3100,9920000,2,406,103,1,81880000,81880000,151,50,101,50,0,1,52,127169

168,450,3200,3100,9920000,2,3606,903,1,102040000,102040000,1351,450,901,450,0,1,452,1068422
168,450,3200,3100,9920000,2,3606,903,1,102040000,102040000,1351,450,901,450,0,1,452,173413
168,450,3200,3100,9920000,2,3606,903,1,102040000,102040000,1351,450,901,450,0,1,452,183712
168,450,3200,3100,9920000,2,3606,903,1,102040000,102040000,1351,450,901,450,0,1,452,185205
168,450,3200,3100,9920000,2,3606,903,1,102040000,102040000,1351,450,901,450,0,1,452,184707
168,450,3200,3100,9920000,2,3606,903,1,102040000,102040000,1351,450,901,450,0,1,452,207216
168,450,3200,3100,9920000,2,3606,903,1,102040000,102040000,1351,450,901,450,0,1,452,207615

168,850,3200,3100,9920000,2,6806,1703,1,122200000,122200000,2551,850,1701,850,0,1,852,2180695
168,850,3200,3100,9920000,2,6806,1703,1,122200000,122200000,2551,850,1701,850,0,1,852,290216
168,850,3200,3100,9920000,2,6806,1703,1,122200000,122200000,2551,850,1701,850,0,1,852,292469
168,850,3200,3100,9920000,2,6806,1703,1,122200000,122200000,2551,850,1701,850,0,1,852,293334
168,850,3200,3100,9920000,2,6806,1703,1,122200000,122200000,2551,850,1701,850,0,1,852,292015
168,850,3200,3100,9920000,2,6806,1703,1,122200000,122200000,2551,850,1701,850,0,1,852,295182
168,850,3200,3100,9920000,2,6806,1703,1,122200000,122200000,2551,850,1701,850,0,1,852,294752

168,1250,3200,3100,9920000,2,10006,2503,1,142360000,142360000,3751,1250,2501,1250,0,1,1252,3323233
168,1250,3200,3100,9920000,2,10006,2503,1,142360000,142360000,3751,1250,2501,1250,0,1,1252,388265
168,1250,3200,3100,9920000,2,10006,2503,1,142360000,142360000,3751,1250,2501,1250,0,1,1252,389534
168,1250,3200,3100,9920000,2,10006,2503,1,142360000,142360000,3751,1250,2501,1250,0,1,1252,388869
168,1250,3200,3100,9920000,2,10006,2503,1,142360000,142360000,3751,1250,2501,1250,0,1,1252,386084
168,1250,3200,3100,9920000,2,10006,2503,1,142360000,142360000,3751,1250,2501,1250,0,1,1252,390294
168,1250,3200,3100,9920000,2,10006,2503,1,142360000,142360000,3751,1250,2501,1250,0,1,1252,390754

168,1650,3200,3100,9920000,2,13206,3303,1,162520000,162520000,4951,1650,3301,1650,0,1,1652,4564560
168,1650,3200,3100,9920000,2,13206,3303,1,162520000,162520000,4951,1650,3301,1650,0,1,1652,479055
168,1650,3200,3100,9920000,2,13206,3303,1,162520000,162520000,4951,1650,3301,1650,0,1,1652,476473
168,1650,3200,3100,9920000,2,13206,3303,1,162520000,162520000,4951,1650,3301,1650,0,1,1652,480348
168,1650,3200,3100,9920000,2,13206,3303,1,162520000,162520000,4951,1650,3301,1650,0,1,1652,480808
168,1650,3200,3100,9920000,2,13206,3303,1,162520000,162520000,4951,1650,3301,1650,0,1,1652,481293
168,1650,3200,3100,9920000,2,13206,3303,1,162520000,162520000,4951,1650,3301,1650,0,1,1652,481781

168,2050,3200,3100,9920000,2,16406,4103,1,182680000,182680000,6151,2050,4101,2050,0,1,2052,5871032
168,2050,3200,3100,9920000,2,16406,4103,1,182680000,182680000,6151,2050,4101,2050,0,1,2052,540111
168,2050,3200,3100,9920000,2,16406,4103,1,182680000,182680000,6151,2050,4101,2050,0,1,2052,542297
168,2050,3200,3100,9920000,2,16406,4103,1,182680000,182680000,6151,2050,4101,2050,0,1,2052,544406
168,2050,3200,3100,9920000,2,16406,4103,1,182680000,182680000,6151,2050,4101,2050,0,1,2052,543219
168,2050,3200,3100,9920000,2,16406,4103,1,182680000,182680000,6151,2050,4101,2050,0,1,2052,565303
168,2050,3200,3100,9920000,2,16406,4103,1,182680000,182680000,6151,2050,4101,2050,0,1,2052,565817

168,2450,3200,3100,9920000,2,19606,4903,1,202840000,202840000,7351,2450,4901,2450,0,1,2452,7116361
168,2450,3200,3100,9920000,2,19606,4903,1,202840000,202840000,7351,2450,4901,2450,0,1,2452,669411
168,2450,3200,3100,9920000,2,19606,4903,1,202840000,202840000,7351,2450,4901,2450,0,1,2452,673567
168,2450,3200,3100,9920000,2,19606,4903,1,202840000,202840000,7351,2450,4901,2450,0,1,2452,672133
168,2450,3200,3100,9920000,2,19606,4903,1,202840000,202840000,7351,2450,4901,2450,0,1,2452,659043
168,2450,3200,3100,9920000,2,19606,4903,1,202840000,202840000,7351,2450,4901,2450,0,1,2452,681507
168,2450,3200,3100,9920000,2,19606,4903,1,202840000,202840000,7351,2450,4901,2450,0,1,2452,682761

168,2850,3200,3100,9920000,2,22806,5703,1,223000000,223000000,8551,2850,5701,2850,0,1,2852,8263746
168,2850,3200,3100,9920000,2,22806,5703,1,223000000,223000000,8551,2850,5701,2850,0,1,2852,728560
168,2850,3200,3100,9920000,2,22806,5703,1,223000000,223000000,8551,2850,5701,2850,0,1,2852,727422
168,2850,3200,3100,9920000,2,22806,5703,1,223000000,223000000,8551,2850,5701,2850,0,1,2852,728079
168,2850,3200,3100,9920000,2,22806,5703,1,223000000,223000000,8551,2850,5701,2850,0,1,2852,725899
168,2850,3200,3100,9920000,2,22806,5703,1,223000000,223000000,8551,2850,5701,2850,0,1,2852,773187
168,2850,3200,3100,9920000,2,22806,5703,1,223000000,223000000,8551,2850,5701,2850,0,1,2852,773769

168,3250,3200,3100,9920000,2,26006,6503,1,243160000,243160000,9751,3250,6501,3250,0,1,3252,9294451
168,3250,3200,3100,9920000,2,26006,6503,1,243160000,243160000,9751,3250,6501,3250,0,1,3252,810963
168,3250,3200,3100,9920000,2,26006,6503,1,243160000,243160000,9751,3250,6501,3250,0,1,3252,809603
168,3250,3200,3100,9920000,2,26006,6503,1,243160000,243160000,9751,3250,6501,3250,0,1,3252,812712
168,3250,3200,3100,9920000,2,26006,6503,1,243160000,243160000,9751,3250,6501,3250,0,1,3252,811944
168,3250,3200,3100,9920000,2,26006,6503,1,243160000,243160000,9751,3250,6501,3250,0,1,3252,874780
168,3250,3200,3100,9920000,2,26006,6503,1,243160000,243160000,9751,3250,6501,3250,0,1,3252,875426

168,3650,3200,3100,9920000,2,29206,7303,1,263320000,263320000,10951,3650,7301,3650,0,1,3652,10659888
168,3650,3200,3100,9920000,2,29206,7303,1,263320000,263320000,10951,3650,7301,3650,0,1,3652,902999
168,3650,3200,3100,9920000,2,29206,7303,1,263320000,263320000,10951,3650,7301,3650,0,1,3652,901152
168,3650,3200,3100,9920000,2,29206,7303,1,263320000,263320000,10951,3650,7301,3650,0,1,3652,903581
168,3650,3200,3100,9920000,2,29206,7303,1,263320000,263320000,10951,3650,7301,3650,0,1,3652,902265
168,3650,3200,3100,9920000,2,29206,7303,1,263320000,263320000,10951,3650,7301,3650,0,1,3652,951896
168,3650,3200,3100,9920000,2,29206,7303,1,263320000,263320000,10951,3650,7301,3650,0,1,3652,952528

168,4050,3200,3100,9920000,2,32406,8103,1,283480000,283480000,12151,4050,8101,4050,0,1,4052,11732490
168,4050,3200,3100,9920000,2,32406,8103,1,283480000,283480000,12151,4050,8101,4050,0,1,4052,1020953
168,4050,3200,3100,9920000,2,32406,8103,1,283480000,283480000,12151,4050,8101,4050,0,1,4052,1009275
168,4050,3200,3100,9920000,2,32406,8103,1,283480000,283480000,12151,4050,8101,4050,0,1,4052,1026823
168,4050,3200,3100,9920000,2,32406,8103,1,283480000,283480000,12151,4050,8101,4050,0,1,4052,1028650
168,4050,3200,3100,9920000,2,32406,8103,1,283480000,283480000,12151,4050,8101,4050,0,1,4052,1063649
168,4050,3200,3100,9920000,2,32406,8103,1,283480000,283480000,12151,4050,8101,4050,0,1,4052,1066597

168,4450,3200,3100,9920000,2,35606,8903,1,303640000,303640000,13351,4450,8901,4450,0,1,4452,13577294
168,4450,3200,3100,9920000,2,35606,8903,1,303640000,303640000,13351,4450,8901,4450,0,1,4452,1120676
168,4450,3200,3100,9920000,2,35606,8903,1,303640000,303640000,13351,4450,8901,4450,0,1,4452,1113512
168,4450,3200,3100,9920000,2,35606,8903,1,303640000,303640000,13351,4450,8901,4450,0,1,4452,1123736
168,4450,3200,3100,9920000,2,35606,8903,1,303640000,303640000,13351,4450,8901,4450,0,1,4452,1122334
168,4450,3200,3100,9920000,2,35606,8903,1,303640000,303640000,13351,4450,8901,4450,0,1,4452,1137145
168,4450,3200,3100,9920000,2,35606,8903,1,303640000,303640000,13351,4450,8901,4450,0,1,4452,1137838

168,4850,3200,3100,9920000,2,38806,9703,1,323800000,323800000,14551,4850,9701,4850,0,1,4852,14531146
168,4850,3200,3100,9920000,2,38806,9703,1,323800000,323800000,14551,4850,9701,4850,0,1,4852,1191286
168,4850,3200,3100,9920000,2,38806,9703,1,323800000,323800000,14551,4850,9701,4850,0,1,4852,1194115
168,4850,3200,3100,9920000,2,38806,9703,1,323800000,323800000,14551,4850,9701,4850,0,1,4852,1196270
168,4850,3200,3100,9920000,2,38806,9703,1,323800000,323800000,14551,4850,9701,4850,0,1,4852,1189554
168,4850,3200,3100,9920000,2,38806,9703,1,323800000,323800000,14551,4850,9701,4850,0,1,4852,1215506
168,4850,3200,3100,9920000,2,38806,9703,1,323800000,323800000,14551,4850,9701,4850,0,1,4852,1214688

168,5250,3200,3100,9920000,2,42006,10503,1,343960000,343960000,15751,5250,10501,5250,0,1,5252,15648625
168,5250,3200,3100,9920000,2,42006,10503,1,343960000,343960000,15751,5250,10501,5250,0,1,5252,1364865
168,5250,3200,3100,9920000,2,42006,10503,1,343960000,343960000,15751,5250,10501,5250,0,1,5252,1358765
168,5250,3200,3100,9920000,2,42006,10503,1,343960000,343960000,15751,5250,10501,5250,0,1,5252,1360447
168,5250,3200,3100,9920000,2,42006,10503,1,343960000,343960000,15751,5250,10501,5250,0,1,5252,1366202
168,5250,3200,3100,9920000,2,42006,10503,1,343960000,343960000,15751,5250,10501,5250,0,1,5252,1366784
168,5250,3200,3100,9920000,2,42006,10503,1,343960000,343960000,15751,5250,10501,5250,0,1,5252,1367305

168,5650,3200,3100,9920000,2,45206,11303,1,364120000,364120000,16951,5650,11301,5650,0,1,5652,17062727
168,5650,3200,3100,9920000,2,45206,11303,1,364120000,364120000,16951,5650,11301,5650,0,1,5652,1426257
168,5650,3200,3100,9920000,2,45206,11303,1,364120000,364120000,16951,5650,11301,5650,0,1,5652,1424963
168,5650,3200,3100,9920000,2,45206,11303,1,364120000,364120000,16951,5650,11301,5650,0,1,5652,1427439
168,5650,3200,3100,9920000,2,45206,11303,1,364120000,364120000,16951,5650,11301,5650,0,1,5652,1422572
168,5650,3200,3100,9920000,2,45206,11303,1,364120000,364120000,16951,5650,11301,5650,0,1,5652,1428246
168,5650,3200,3100,9920000,2,45206,11303,1,364120000,364120000,16951,5650,11301,5650,0,1,5652,1429002

168,6050,3200,3100,9920000,2,48406,12103,1,384280000,384280000,18151,6050,12101,6050,0,1,6052,17927241
168,6050,3200,3100,9920000,2,48406,12103,1,384280000,384280000,18151,6050,12101,6050,0,1,6052,1478645
168,6050,3200,3100,9920000,2,48406,12103,1,384280000,384280000,18151,6050,12101,6050,0,1,6052,1484636
168,6050,3200,3100,9920000,2,48406,12103,1,384280000,384280000,18151,6050,12101,6050,0,1,6052,1486752
168,6050,3200,3100,9920000,2,48406,12103,1,384280000,384280000,18151,6050,12101,6050,0,1,6052,1482685
168,6050,3200,3100,9920000,2,48406,12103,1,384280000,384280000,18151,6050,12101,6050,0,1,6052,1490105
168,6050,3200,3100,9920000,2,48406,12103,1,384280000,384280000,18151,6050,12101,6050,0,1,6052,1490913

168,6450,3200,3100,9920000,2,51606,12903,1,404440000,404440000,19351,6450,12901,6450,0,1,6452,18998506
168,6450,3200,3100,9920000,2,51606,12903,1,404440000,404440000,19351,6450,12901,6450,0,1,6452,1623447
168,6450,3200,3100,9920000,2,51606,12903,1,404440000,404440000,19351,6450,12901,6450,0,1,6452,1631435
168,6450,3200,3100,9920000,2,51606,12903,1,404440000,404440000,19351,6450,12901,6450,0,1,6452,1633265
168,6450,3200,3100,9920000,2,51606,12903,1,404440000,404440000,19351,6450,12901,6450,0,1,6452,1625526
168,6450,3200,3100,9920000,2,51606,12903,1,404440000,404440000,19351,6450,12901,6450,0,1,6452,1632198
168,6450,3200,3100,9920000,2,51606,12903,1,404440000,404440000,19351,6450,12901,6450,0,1,6452,1633870

168,6850,3200,3100,9920000,2,54806,13703,1,424600000,424600000,20551,6850,13701,6850,0,1,6852,20630574
168,6850,3200,3100,9920000,2,54806,13703,1,424600000,424600000,20551,6850,13701,6850,0,1,6852,1673588
168,6850,3200,3100,9920000,2,54806,13703,1,424600000,424600000,20551,6850,13701,6850,0,1,6852,1674992
168,6850,3200,3100,9920000,2,54806,13703,1,424600000,424600000,20551,6850,13701,6850,0,1,6852,1678142
168,6850,3200,3100,9920000,2,54806,13703,1,424600000,424600000,20551,6850,13701,6850,0,1,6852,1676077
168,6850,3200,3100,9920000,2,54806,13703,1,424600000,424600000,20551,6850,13701,6850,0,1,6852,1681027
168,6850,3200,3100,9920000,2,54806,13703,1,424600000,424600000,20551,6850,13701,6850,0,1,6852,1680177

168,50,3200,2700,8640000,2,406,103,1,71480000,71480000,151,50,101,50,0,1,52,96742
168,50,3200,2700,8640000,2,406,103,1,71480000,71480000,151,50,101,50,0,1,52,90308
168,50,3200,2700,8640000,2,406,103,1,71480000,71480000,151,50,101,50,0,1,52,77585
168,50,3200,2700,8640000,2,406,103,1,71480000,71480000,151,50,101,50,0,1,52,89862
168,50,3200,2700,8640000,2,406,103,1,71480000,71480000,151,50,101,50,0,1,52,88146
168,50,3200,2700,8640000,2,406,103,1,71480000,71480000,151,50,101,50,0,1,52,111040
168,50,3200,2700,8640000,2,406,103,1,71480000,71480000,151,50,101,50,0,1,52,110566

168,450,3200,2700,8640000,2,3606,903,1,90360000,90360000,1351,450,901,450,0,1,452,935453
168,450,3200,2700,8640000,2,3606,903,1,90360000,90360000,1351,450,901,450,0,1,452,164250
168,450,3200,2700,8640000,2,3606,903,1,90360000,90360000,1351,450,901,450,0,1,452,162837
168,450,3200,2700,8640000,2,3606,903,1,90360000,90360000,1351,450,901,450,0,1,452,164498
168,450,3200,2700,8640000,2,3606,903,1,90360000,90360000,1351,450,901,450,0,1,452,163783
168,450,3200,2700,8640000,2,3606,903,1,90360000,90360000,1351,450,901,450,0,1,452,190360
168,450,3200,2700,8640000,2,3606,903,1,90360000,90360000,1351,450,901,450,0,1,452,189844

168,850,3200,2700,8640000,2,6806,1703,1,109240000,109240000,2551,850,1701,850,0,1,852,1910097
168,850,3200,2700,8640000,2,6806,1703,1,109240000,109240000,2551,850,1701,850,0,1,852,253331
168,850,3200,2700,8640000,2,6806,1703,1,109240000,109240000,2551,850,1701,850,0,1,852,255414
168,850,3200,2700,8640000,2,6806,1703,1,109240000,109240000,2551,850,1701,850,0,1,852,254877
168,850,3200,2700,8640000,2,6806,1703,1,109240000,109240000,2551,850,1701,850,0,1,852,254152
168,850,3200,2700,8640000,2,6806,1703,1,109240000,109240000,2551,850,1701,850,0,1,852,256818
168,850,3200,2700,8640000,2,6806,1703,1,109240000,109240000,2551,850,1701,850,0,1,852,257247

168,1250,3200,2700,8640000,2,10006,2503,1,128120000,128120000,3751,1250,2501,1250,0,1,1252,2847289
168,1250,3200,2700,8640000,2,10006,2503,1,128120000,128120000,3751,1250,2501,1250,0,1,1252,363850
168,1250,3200,2700,8640000,2,10006,2503,1,128120000,128120000,3751,1250,2501,1250,0,1,1252,360753
168,1250,3200,2700,8640000,2,10006,2503,1,128120000,128120000,3751,1250,2501,1250,0,1,1252,359744
168,1250,3200,2700,8640000,2,10006,2503,1,128120000,128120000,3751,1250,2501,1250,0,1,1252,363256
168,1250,3200,2700,8640000,2,10006,2503,1,128120000,128120000,3751,1250,2501,1250,0,1,1252,364307
168,1250,3200,2700,8640000,2,10006,2503,1,128120000,128120000,3751,1250,2501,1250,0,1,1252,364766

168,1650,3200,2700,8640000,2,13206,3303,1,147000000,147000000,4951,1650,3301,1650,0,1,1652,3880035
168,1650,3200,2700,8640000,2,13206,3303,1,147000000,147000000,4951,1650,3301,1650,0,1,1652,411751
168,1650,3200,2700,8640000,2,13206,3303,1,147000000,147000000,4951,1650,3301,1650,0,1,1652,409966
168,1650,3200,2700,8640000,2,13206,3303,1,147000000,147000000,4951,1650,3301,1650,0,1,1652,412709
168,1650,3200,2700,8640000,2,13206,3303,1,147000000,147000000,4951,1650,3301,1650,0,1,1652,413073
168,1650,3200,2700,8640000,2,13206,3303,1,147000000,147000000,4951,1650,3301,1650,0,1,1652,415725
168,1650,3200,2700,8640000,2,13206,3303,1,147000000,147000000,4951,1650,3301,1650,0,1,1652,416216

168,2050,3200,2700,8640000,2,16406,4103,1,165880000,165880000,6151,2050,4101,2050,0,1,2052,5001025
168,2050,3200,2700,8640000,2,16406,4103,1,165880000,165880000,6151,2050,4101,2050,0,1,2052,501591
168,2050,3200,2700,8640000,2,16406,4103,1,165880000,165880000,6151,2050,4101,2050,0,1,2052,505108
168,2050,3200,2700,8640000,2,16406,4103,1,165880000,165880000,6151,2050,4101,2050,0,1,2052,505674
168,2050,3200,2700,8640000,2,16406,4103,1,165880000,165880000,6151,2050,4101,2050,0,1,2052,503172
168,2050,3200,2700,8640000,2,16406,4103,1,165880000,165880000,6151,2050,4101,2050,0,1,2052,506212
168,2050,3200,2700,8640000,2,16406,4103,1,165880000,165880000,6151,2050,4101,2050,0,1,2052,505910

168,2450,3200,2700,8640000,2,19606,4903,1,184760000,184760000,7351,2450,4901,2450,0,1,2452,6015742
168,2450,3200,2700,8640000,2,19606,4903,1,184760000,184760000,7351,2450,4901,2450,0,1,2452,565610
168,2450,3200,2700,8640000,2,19606,4903,1,184760000,184760000,7351,2450,4901,2450,0,1,2452,563576
168,2450,3200,2700,8640000,2,19606,4903,1,184760000,184760000,7351,2450,4901,2450,0,1,2452,566567
168,2450,3200,2700,8640000,2,19606,4903,1,184760000,184760000,7351,2450,4901,2450,0,1,2452,564756
168,2450,3200,2700,8640000,2,19606,4903,1,184760000,184760000,7351,2450,4901,2450,0,1,2452,580796
168,2450,3200,2700,8640000,2,19606,4903,1,184760000,184760000,7351,2450,4901,2450,0,1,2452,581328

168,2850,3200,2700,8640000,2,22806,5703,1,203640000,203640000,8551,2850,5701,2850,0,1,2852,7009904
168,2850,3200,2700,8640000,2,22806,5703,1,203640000,203640000,8551,2850,5701,2850,0,1,2852,660376
168,2850,3200,2700,8640000,2,22806,5703,1,203640000,203640000,8551,2850,5701,2850,0,1,2852,657067
168,2850,3200,2700,8640000,2,22806,5703,1,203640000,203640000,8551,2850,5701,2850,0,1,2852,661705
168,2850,3200,2700,8640000,2,22806,5703,1,203640000,203640000,8551,2850,5701,2850,0,1,2852,662811
168,2850,3200,2700,8640000,2,22806,5703,1,203640000,203640000,8551,2850,5701,2850,0,1,2852,665244
168,2850,3200,2700,8640000,2,22806,5703,1,203640000,203640000,8551,2850,5701,2850,0,1,2852,665817

168,3250,3200,2700,8640000,2,26006,6503,1,222520000,222520000,9751,3250,6501,3250,0,1,3252,8118443
168,3250,3200,2700,8640000,2,26006,6503,1,222520000,222520000,9751,3250,6501,3250,0,1,3252,739291
168,3250,3200,2700,8640000,2,26006,6503,1,222520000,222520000,9751,3250,6501,3250,0,1,3252,742661
168,3250,3200,2700,8640000,2,26006,6503,1,222520000,222520000,9751,3250,6501,3250,0,1,3252,742135
168,3250,3200,2700,8640000,2,26006,6503,1,222520000,222520000,9751,3250,6501,3250,0,1,3252,740910
168,3250,3200,2700,8640000,2,26006,6503,1,222520000,222520000,9751,3250,6501,3250,0,1,3252,745015
168,3250,3200,2700,8640000,2,26006,6503,1,222520000,222520000,9751,3250,6501,3250,0,1,3252,744420

168,3650,3200,2700,8640000,2,29206,7303,1,241400000,241400000,10951,3650,7301,3650,0,1,3652,9200846
168,3650,3200,2700,8640000,2,29206,7303,1,241400000,241400000,10951,3650,7301,3650,0,1,3652,792467
168,3650,3200,2700,8640000,2,29206,7303,1,241400000,241400000,10951,3650,7301,3650,0,1,3652,791716
168,3650,3200,2700,8640000,2,29206,7303,1,241400000,241400000,10951,3650,7301,3650,0,1,3652,794661
168,3650,3200,2700,8640000,2,29206,7303,1,241400000,241400000,10951,3650,7301,3650,0,1,3652,793653
168,3650,3200,2700,8640000,2,29206,7303,1,241400000,241400000,10951,3650,7301,3650,0,1,3652,852036
168,3650,3200,2700,8640000,2,29206,7303,1,241400000,241400000,10951,3650,7301,3650,0,1,3652,852659

168,4050,3200,2700,8640000,2,32406,8103,1,260280000,260280000,12151,4050,8101,4050,0,1,4052,9990478
168,4050,3200,2700,8640000,2,32406,8103,1,260280000,260280000,12151,4050,8101,4050,0,1,4052,911190
168,4050,3200,2700,8640000,2,32406,8103,1,260280000,260280000,12151,4050,8101,4050,0,1,4052,907160
168,4050,3200,2700,8640000,2,32406,8103,1,260280000,260280000,12151,4050,8101,4050,0,1,4052,906019
168,4050,3200,2700,8640000,2,32406,8103,1,260280000,260280000,12151,4050,8101,4050,0,1,4052,912411
168,4050,3200,2700,8640000,2,32406,8103,1,260280000,260280000,12151,4050,8101,4050,0,1,4052,965035
168,4050,3200,2700,8640000,2,32406,8103,1,260280000,260280000,12151,4050,8101,4050,0,1,4052,955001

168,4450,3200,2700,8640000,2,35606,8903,1,279160000,279160000,13351,4450,8901,4450,0,1,4452,11118013
168,4450,3200,2700,8640000,2,35606,8903,1,279160000,279160000,13351,4450,8901,4450,0,1,4452,952166
168,4450,3200,2700,8640000,2,35606,8903,1,279160000,279160000,13351,4450,8901,4450,0,1,4452,953008
168,4450,3200,2700,8640000,2,35606,8903,1,279160000,279160000,13351,4450,8901,4450,0,1,4452,953644
168,4450,3200,2700,8640000,2,35606,8903,1,279160000,279160000,13351,4450,8901,4450,0,1,4452,950425
168,4450,3200,2700,8640000,2,35606,8903,1,279160000,279160000,13351,4450,8901,4450,0,1,4452,994905
168,4450,3200,2700,8640000,2,35606,8903,1,279160000,279160000,13351,4450,8901,4450,0,1,4452,995589

168,4850,3200,2700,8640000,2,38806,9703,1,298040000,298040000,14551,4850,9701,4850,0,1,4852,12103040
168,4850,3200,2700,8640000,2,38806,9703,1,298040000,298040000,14551,4850,9701,4850,0,1,4852,1073172
168,4850,3200,2700,8640000,2,38806,9703,1,298040000,298040000,14551,4850,9701,4850,0,1,4852,1066519
168,4850,3200,2700,8640000,2,38806,9703,1,298040000,298040000,14551,4850,9701,4850,0,1,4852,1076442
168,4850,3200,2700,8640000,2,38806,9703,1,298040000,298040000,14551,4850,9701,4850,0,1,4852,1074893
168,4850,3200,2700,8640000,2,38806,9703,1,298040000,298040000,14551,4850,9701,4850,0,1,4852,1091497
168,4850,3200,2700,8640000,2,38806,9703,1,298040000,298040000,14551,4850,9701,4850,0,1,4852,1092206

168,5250,3200,2700,8640000,2,42006,10503,1,316920000,316920000,15751,5250,10501,5250,0,1,5252,13058459
168,5250,3200,2700,8640000,2,42006,10503,1,316920000,316920000,15751,5250,10501,5250,0,1,5252,1220925
168,5250,3200,2700,8640000,2,42006,10503,1,316920000,316920000,15751,5250,10501,5250,0,1,5252,1215678
168,5250,3200,2700,8640000,2,42006,10503,1,316920000,316920000,15751,5250,10501,5250,0,1,5252,1210702
168,5250,3200,2700,8640000,2,42006,10503,1,316920000,316920000,15751,5250,10501,5250,0,1,5252,1221866
168,5250,3200,2700,8640000,2,42006,10503,1,316920000,316920000,15751,5250,10501,5250,0,1,5252,1219892
168,5250,3200,2700,8640000,2,42006,10503,1,316920000,316920000,15751,5250,10501,5250,0,1,5252,1222374

168,5650,3200,2700,8640000,2,45206,11303,1,335800000,335800000,16951,5650,11301,5650,0,1,5652,14149364
168,5650,3200,2700,8640000,2,45206,11303,1,335800000,335800000,16951,5650,11301,5650,0,1,5652,1246021
168,5650,3200,2700,8640000,2,45206,11303,1,335800000,335800000,16951,5650,11301,5650,0,1,5652,1254053
168,5650,3200,2700,8640000,2,45206,11303,1,335800000,335800000,16951,5650,11301,5650,0,1,5652,1256159
168,5650,3200,2700,8640000,2,45206,11303,1,335800000,335800000,16951,5650,11301,5650,0,1,5652,1255070
168,5650,3200,2700,8640000,2,45206,11303,1,335800000,335800000,16951,5650,11301,5650,0,1,5652,1258954
168,5650,3200,2700,8640000,2,45206,11303,1,335800000,335800000,16951,5650,11301,5650,0,1,5652,1259722

168,6050,3200,2700,8640000,2,48406,12103,1,354680000,354680000,18151,6050,12101,6050,0,1,6052,15740236
168,6050,3200,2700,8640000,2,48406,12103,1,354680000,354680000,18151,6050,12101,6050,0,1,6052,1289817
168,6050,3200,2700,8640000,2,48406,12103,1,354680000,354680000,18151,6050,12101,6050,0,1,6052,1297684
168,6050,3200,2700,8640000,2,48406,12103,1,354680000,354680000,18151,6050,12101,6050,0,1,6052,1301513
168,6050,3200,2700,8640000,2,48406,12103,1,354680000,354680000,18151,6050,12101,6050,0,1,6052,1299683
168,6050,3200,2700,8640000,2,48406,12103,1,354680000,354680000,18151,6050,12101,6050,0,1,6052,1316451
168,6050,3200,2700,8640000,2,48406,12103,1,354680000,354680000,18151,6050,12101,6050,0,1,6052,1315646

168,6450,3200,2700,8640000,2,51606,12903,1,373560000,373560000,19351,6450,12901,6450,0,1,6452,15971640
168,6450,3200,2700,8640000,2,51606,12903,1,373560000,373560000,19351,6450,12901,6450,0,1,6452,1450572
168,6450,3200,2700,8640000,2,51606,12903,1,373560000,373560000,19351,6450,12901,6450,0,1,6452,1445769
168,6450,3200,2700,8640000,2,51606,12903,1,373560000,373560000,19351,6450,12901,6450,0,1,6452,1447325
168,6450,3200,2700,8640000,2,51606,12903,1,373560000,373560000,19351,6450,12901,6450,0,1,6452,1431829
168,6450,3200,2700,8640000,2,51606,12903,1,373560000,373560000,19351,6450,12901,6450,0,1,6452,1451816
168,6450,3200,2700,8640000,2,51606,12903,1,373560000,373560000,19351,6450,12901,6450,0,1,6452,1452632

168,6850,3200,2700,8640000,2,54806,13703,1,392440000,392440000,20551,6850,13701,6850,0,1,6852,17770173
168,6850,3200,2700,8640000,2,54806,13703,1,392440000,392440000,20551,6850,13701,6850,0,1,6852,1502358
168,6850,3200,2700,8640000,2,54806,13703,1,392440000,392440000,20551,6850,13701,6850,0,1,6852,1503381
168,6850,3200,2700,8640000,2,54806,13703,1,392440000,392440000,20551,6850,13701,6850,0,1,6852,1504309
168,6850,3200,2700,8640000,2,54806,13703,1,392440000,392440000,20551,6850,13701,6850,0,1,6852,1501036
168,6850,3200,2700,8640000,2,54806,13703,1,392440000,392440000,20551,6850,13701,6850,0,1,6852,1495509
168,6850,3200,2700,8640000,2,54806,13703,1,392440000,392440000,20551,6850,13701,6850,0,1,6852,1497411

168,50,3200,2300,7360000,2,406,103,1,61080000,61080000,151,50,101,50,0,1,52,81392
168,50,3200,2300,7360000,2,406,103,1,61080000,61080000,151,50,101,50,0,1,52,70718
168,50,3200,2300,7360000,2,406,103,1,61080000,61080000,151,50,101,50,0,1,52,75578
168,50,3200,2300,7360000,2,406,103,1,61080000,61080000,151,50,101,50,0,1,52,75130
168,50,3200,2300,7360000,2,406,103,1,61080000,61080000,151,50,101,50,0,1,52,66410
168,50,3200,2300,7360000,2,406,103,1,61080000,61080000,151,50,101,50,0,1,52,94662
168,50,3200,2300,7360000,2,406,103,1,61080000,61080000,151,50,101,50,0,1,52,95134

168,450,3200,2300,7360000,2,3606,903,1,78680000,78680000,1351,450,901,450,0,1,452,753425
168,450,3200,2300,7360000,2,3606,903,1,78680000,78680000,1351,450,901,450,0,1,452,134152
168,450,3200,2300,7360000,2,3606,903,1,78680000,78680000,1351,450,901,450,0,1,452,129438
168,450,3200,2300,7360000,2,3606,903,1,78680000,78680000,1351,450,901,450,0,1,452,133656
168,450,3200,2300,7360000,2,3606,903,1,78680000,78680000,1351,450,901,450,0,1,452,130043
168,450,3200,2300,7360000,2,3606,903,1,78680000,78680000,1351,450,901,450,0,1,452,162228
168,450,3200,2300,7360000,2,3606,903,1,78680000,78680000,1351,450,901,450,0,1,452,162761

168,850,3200,2300,7360000,2,6806,1703,1,96280000,96280000,2551,850,1701,850,0,1,852,1575238
168,850,3200,2300,7360000,2,6806,1703,1,96280000,96280000,2551,850,1701,850,0,1,852,221207
168,850,3200,2300,7360000,2,6806,1703,1,96280000,96280000,2551,850,1701,850,0,1,852,219776
168,850,3200,2300,7360000,2,6806,1703,1,96280000,96280000,2551,850,1701,850,0,1,852,222896
168,850,3200,2300,7360000,2,6806,1703,1,96280000,96280000,2551,850,1701,850,0,1,852,222517
168,850,3200,2300,7360000,2,6806,1703,1,96280000,96280000,2551,850,1701,850,0,1,852,224177
168,850,3200,2300,7360000,2,6806,1703,1,96280000,96280000,2551,850,1701,850,0,1,852,224608

168,1250,3200,2300,7360000,2,10006,2503,1,113880000,113880000,3751,1250,2501,1250,0,1,1252,2411974
168,1250,3200,2300,7360000,2,10006,2503,1,113880000,113880000,3751,1250,2501,1250,0,1,1252,295805
168,1250,3200,2300,7360000,2,10006,2503,1,113880000,113880000,3751,1250,2501,1250,0,1,1252,293891
168,1250,3200,2300,7360000,2,10006,2503,1,113880000,113880000,3751,1250,2501,1250,0,1,1252,295361
168,1250,3200,2300,7360000,2,10006,2503,1,113880000,113880000,3751,1250,2501,1250,0,1,1252,296289
168,1250,3200,2300,7360000,2,10006,2503,1,113880000,113880000,3751,1250,2501,1250,0,1,1252,297033
168,1250,3200,2300,7360000,2,10006,2503,1,113880000,113880000,3751,1250,2501,1250,0,1,1252,297502

168,1650,3200,2300,7360000,2,13206,3303,1,131480000,131480000,4951,1650,3301,1650,0,1,1652,3222414
168,1650,3200,2300,7360000,2,13206,3303,1,131480000,131480000,4951,1650,3301,1650,0,1,1652,366955
168,1650,3200,2300,7360000,2,13206,3303,1,131480000,131480000,4951,1650,3301,1650,0,1,1652,368468
168,1650,3200,2300,7360000,2,13206,3303,1,131480000,131480000,4951,1650,3301,1650,0,1,1652,367930
168,1650,3200,2300,7360000,2,13206,3303,1,131480000,131480000,4951,1650,3301,1650,0,1,1652,369192
168,1650,3200,2300,7360000,2,13206,3303,1,131480000,131480000,4951,1650,3301,1650,0,1,1652,369573
168,1650,3200,2300,7360000,2,13206,3303,1,131480000,131480000,4951,1650,3301,1650,0,1,1652,369847

168,2050,3200,2300,7360000,2,16406,4103,1,149080000,149080000,6151,2050,4101,2050,0,1,2052,4071519
168,2050,3200,2300,7360000,2,16406,4103,1,149080000,149080000,6151,2050,4101,2050,0,1,2052,439866
168,2050,3200,2300,7360000,2,16406,4103,1,149080000,149080000,6151,2050,4101,2050,0,1,2052,438235
168,2050,3200,2300,7360000,2,16406,4103,1,149080000,149080000,6151,2050,4101,2050,0,1,2052,439199
168,2050,3200,2300,7360000,2,16406,4103,1,149080000,149080000,6151,2050,4101,2050,0,1,2052,438729
168,2050,3200,2300,7360000,2,16406,4103,1,149080000,149080000,6151,2050,4101,2050,0,1,2052,440566
168,2050,3200,2300,7360000,2,16406,4103,1,149080000,149080000,6151,2050,4101,2050,0,1,2052,440265

168,2450,3200,2300,7360000,2,19606,4903,1,166680000,166680000,7351,2450,4901,2450,0,1,2452,4892987
168,2450,3200,2300,7360000,2,19606,4903,1,166680000,166680000,7351,2450,4901,2450,0,1,2452,513699
168,2450,3200,2300,7360000,2,19606,4903,1,166680000,166680000,7351,2450,4901,2450,0,1,2452,511548
168,2450,3200,2300,7360000,2,19606,4903,1,166680000,166680000,7351,2450,4901,2450,0,1,2452,514155
168,2450,3200,2300,7360000,2,19606,4903,1,166680000,166680000,7351,2450,4901,2450,0,1,2452,513314
168,2450,3200,2300,7360000,2,19606,4903,1,166680000,166680000,7351,2450,4901,2450,0,1,2452,512126
168,2450,3200,2300,7360000,2,19606,4903,1,166680000,166680000,7351,2450,4901,2450,0,1,2452,512786

168,2850,3200,2300,7360000,2,22806,5703,1,184280000,184280000,8551,2850,5701,2850,0,1,2852,6029471
168,2850,3200,2300,7360000,2,22806,5703,1,184280000,184280000,8551,2850,5701,2850,0,1,2852,607750
168,2850,3200,2300,7360000,2,22806,5703,1,184280000,184280000,8551,2850,5701,2850,0,1,2852,598069
168,2850,3200,2300,7360000,2,22806,5703,1,184280000,184280000,8551,2850,5701,2850,0,1,2852,612160
168,2850,3200,2300,7360000,2,22806,5703,1,184280000,184280000,8551,2850,5701,2850,0,1,2852,604086
168,2850,3200,2300,7360000,2,22806,5703,1,184280000,184280000,8551,2850,5701,2850,0,1,2852,602808
168,2850,3200,2300,7360000,2,22806,5703,1,184280000,184280000,8551,2850,5701,2850,0,1,2852,604953

168,3250,3200,2300,7360000,2,26006,6503,1,201880000,201880000,9751,3250,6501,3250,0,1,3252,6653271
168,3250,3200,2300,7360000,2,26006,6503,1,201880000,201880000,9751,3250,6501,3250,0,1,3252,619433
168,3250,3200,2300,7360000,2,26006,6503,1,201880000,201880000,9751,3250,6501,3250,0,1,3252,617444
168,3250,3200,2300,7360000,2,26006,6503,1,201880000,201880000,9751,3250,6501,3250,0,1,3252,618908
168,3250,3200,2300,7360000,2,26006,6503,1,201880000,201880000,9751,3250,6501,3250,0,1,3252,618216
168,3250,3200,2300,7360000,2,26006,6503,1,201880000,201880000,9751,3250,6501,3250,0,1,3252,652148
168,3250,3200,2300,7360000,2,26006,6503,1,201880000,201880000,9751,3250,6501,3250,0,1,3252,652727

168,3650,3200,2300,7360000,2,29206,7303,1,219480000,219480000,10951,3650,7301,3650,0,1,3652,7819909
168,3650,3200,2300,7360000,2,29206,7303,1,219480000,219480000,10951,3650,7301,3650,0,1,3652,694692
168,3650,3200,2300,7360000,2,29206,7303,1,219480000,219480000,10951,3650,7301,3650,0,1,3652,692716
168,3650,3200,2300,7360000,2,29206,7303,1,219480000,219480000,10951,3650,7301,3650,0,1,3652,695435
168,3650,3200,2300,7360000,2,29206,7303,1,219480000,219480000,10951,3650,7301,3650,0,1,3652,693799
168,3650,3200,2300,7360000,2,29206,7303,1,219480000,219480000,10951,3650,7301,3650,0,1,3652,754947
168,3650,3200,2300,7360000,2,29206,7303,1,219480000,219480000,10951,3650,7301,3650,0,1,3652,755557

168,4050,3200,2300,7360000,2,32406,8103,1,237080000,237080000,12151,4050,8101,4050,0,1,4052,8580792
168,4050,3200,2300,7360000,2,32406,8103,1,237080000,237080000,12151,4050,8101,4050,0,1,4052,753943
168,4050,3200,2300,7360000,2,32406,8103,1,237080000,237080000,12151,4050,8101,4050,0,1,4052,756478
168,4050,3200,2300,7360000,2,32406,8103,1,237080000,237080000,12151,4050,8101,4050,0,1,4052,757329
168,4050,3200,2300,7360000,2,32406,8103,1,237080000,237080000,12151,4050,8101,4050,0,1,4052,754964
168,4050,3200,2300,7360000,2,32406,8103,1,237080000,237080000,12151,4050,8101,4050,0,1,4052,801961
168,4050,3200,2300,7360000,2,32406,8103,1,237080000,237080000,12151,4050,8101,4050,0,1,4052,801317

168,4450,3200,2300,7360000,2,35606,8903,1,254680000,254680000,13351,4450,8901,4450,0,1,4452,9643123
168,4450,3200,2300,7360000,2,35606,8903,1,254680000,254680000,13351,4450,8901,4450,0,1,4452,822530
168,4450,3200,2300,7360000,2,35606,8903,1,254680000,254680000,13351,4450,8901,4450,0,1,4452,824220
168,4450,3200,2300,7360000,2,35606,8903,1,254680000,254680000,13351,4450,8901,4450,0,1,4452,825029
168,4450,3200,2300,7360000,2,35606,8903,1,254680000,254680000,13351,4450,8901,4450,0,1,4452,825686
168,4450,3200,2300,7360000,2,35606,8903,1,254680000,254680000,13351,4450,8901,4450,0,1,4452,885306
168,4450,3200,2300,7360000,2,35606,8903,1,254680000,254680000,13351,4450,8901,4450,0,1,4452,884614

168,4850,3200,2300,7360000,2,38806,9703,1,272280000,272280000,14551,4850,9701,4850,0,1,4852,10704201
168,4850,3200,2300,7360000,2,38806,9703,1,272280000,272280000,14551,4850,9701,4850,0,1,4852,946312
168,4850,3200,2300,7360000,2,38806,9703,1,272280000,272280000,14551,4850,9701,4850,0,1,4852,954962
168,4850,3200,2300,7360000,2,38806,9703,1,272280000,272280000,14551,4850,9701,4850,0,1,4852,956827
168,4850,3200,2300,7360000,2,38806,9703,1,272280000,272280000,14551,4850,9701,4850,0,1,4852,949403
168,4850,3200,2300,7360000,2,38806,9703,1,272280000,272280000,14551,4850,9701,4850,0,1,4852,976141
168,4850,3200,2300,7360000,2,38806,9703,1,272280000,272280000,14551,4850,9701,4850,0,1,4852,978448

168,5250,3200,2300,7360000,2,42006,10503,1,289880000,289880000,15751,5250,10501,5250,0,1,5252,11218093
168,5250,3200,2300,7360000,2,42006,10503,1,289880000,289880000,15751,5250,10501,5250,0,1,5252,975664
168,5250,3200,2300,7360000,2,42006,10503,1,289880000,289880000,15751,5250,10501,5250,0,1,5252,989858
168,5250,3200,2300,7360000,2,42006,10503,1,289880000,289880000,15751,5250,10501,5250,0,1,5252,988101
168,5250,3200,2300,7360000,2,42006,10503,1,289880000,289880000,15751,5250,10501,5250,0,1,5252,986190
168,5250,3200,2300,7360000,2,42006,10503,1,289880000,289880000,15751,5250,10501,5250,0,1,5252,1015261
168,5250,3200,2300,7360000,2,42006,10503,1,289880000,289880000,15751,5250,10501,5250,0,1,5252,1014381

168,5650,3200,2300,7360000,2,45206,11303,1,307480000,307480000,16951,5650,11301,5650,0,1,5652,12304947
168,5650,3200,2300,7360000,2,45206,11303,1,307480000,307480000,16951,5650,11301,5650,0,1,5652,1038638
168,5650,3200,2300,7360000,2,45206,11303,1,307480000,307480000,16951,5650,11301,5650,0,1,5652,1036710
168,5650,3200,2300,7360000,2,45206,11303,1,307480000,307480000,16951,5650,11301,5650,0,1,5652,1040366
168,5650,3200,2300,7360000,2,45206,11303,1,307480000,307480000,16951,5650,11301,5650,0,1,5652,1032653
168,5650,3200,2300,7360000,2,45206,11303,1,307480000,307480000,16951,5650,11301,5650,0,1,5652,1069542
168,5650,3200,2300,7360000,2,45206,11303,1,307480000,307480000,16951,5650,11301,5650,0,1,5652,1070317

168,6050,3200,2300,7360000,2,48406,12103,1,325080000,325080000,18151,6050,12101,6050,0,1,6052,12777267
168,6050,3200,2300,7360000,2,48406,12103,1,325080000,325080000,18151,6050,12101,6050,0,1,6052,1156550
168,6050,3200,2300,7360000,2,48406,12103,1,325080000,325080000,18151,6050,12101,6050,0,1,6052,1154255
168,6050,3200,2300,7360000,2,48406,12103,1,325080000,325080000,18151,6050,12101,6050,0,1,6052,1158866
168,6050,3200,2300,7360000,2,48406,12103,1,325080000,325080000,18151,6050,12101,6050,0,1,6052,1149247
168,6050,3200,2300,7360000,2,48406,12103,1,325080000,325080000,18151,6050,12101,6050,0,1,6052,1164000
168,6050,3200,2300,7360000,2,48406,12103,1,325080000,325080000,18151,6050,12101,6050,0,1,6052,1162886

168,6450,3200,2300,7360000,2,51606,12903,1,342680000,342680000,19351,6450,12901,6450,0,1,6452,13856694
168,6450,3200,2300,7360000,2,51606,12903,1,342680000,342680000,19351,6450,12901,6450,0,1,6452,1276000
168,6450,3200,2300,7360000,2,51606,12903,1,342680000,342680000,19351,6450,12901,6450,0,1,6452,1268059
168,6450,3200,2300,7360000,2,51606,12903,1,342680000,342680000,19351,6450,12901,6450,0,1,6452,1280224
168,6450,3200,2300,7360000,2,51606,12903,1,342680000,342680000,19351,6450,12901,6450,0,1,6452,1279086
168,6450,3200,2300,7360000,2,51606,12903,1,342680000,342680000,19351,6450,12901,6450,0,1,6452,1276610
168,6450,3200,2300,7360000,2,51606,12903,1,342680000,342680000,19351,6450,12901,6450,0,1,6452,1278177

168,6850,3200,2300,7360000,2,54806,13703,1,360280000,360280000,20551,6850,13701,6850,0,1,6852,14859350
168,6850,3200,2300,7360000,2,54806,13703,1,360280000,360280000,20551,6850,13701,6850,0,1,6852,1264857
168,6850,3200,2300,7360000,2,54806,13703,1,360280000,360280000,20551,6850,13701,6850,0,1,6852,1257670
168,6850,3200,2300,7360000,2,54806,13703,1,360280000,360280000,20551,6850,13701,6850,0,1,6852,1270027
168,6850,3200,2300,7360000,2,54806,13703,1,360280000,360280000,20551,6850,13701,6850,0,1,6852,1261892
168,6850,3200,2300,7360000,2,54806,13703,1,360280000,360280000,20551,6850,13701,6850,0,1,6852,1287808
168,6850,3200,2300,7360000,2,54806,13703,1,360280000,360280000,20551,6850,13701,6850,0,1,6852,1288672

168,50,3200,1900,6080000,2,406,103,1,50680000,50680000,151,50,101,50,0,1,52,65836
168,50,3200,1900,6080000,2,406,103,1,50680000,50680000,151,50,101,50,0,1,52,59722
168,50,3200,1900,6080000,2,406,103,1,50680000,50680000,151,50,101,50,0,1,52,58924
168,50,3200,1900,6080000,2,406,103,1,50680000,50680000,151,50,101,50,0,1,52,60358
168,50,3200,1900,6080000,2,406,103,1,50680000,50680000,151,50,101,50,0,1,52,53447
168,50,3200,1900,6080000,2,406,103,1,50680000,50680000,151,50,101,50,0,1,52,75926
168,50,3200,1900,6080000,2,406,103,1,50680000,50680000,151,50,101,50,0,1,52,77692

168,450,3200,1900,6080000,2,3606,903,1,67000000,67000000,1351,450,901,450,0,1,452,623338
168,450,3200,1900,6080000,2,3606,903,1,67000000,67000000,1351,450,901,450,0,1,452,119791
168,450,3200,1900,6080000,2,3606,903,1,67000000,67000000,1351,450,901,450,0,1,452,118013
168,450,3200,1900,6080000,2,3606,903,1,67000000,67000000,1351,450,901,450,0,1,452,119321
168,450,3200,1900,6080000,2,3606,903,1,67000000,67000000,1351,450,901,450,0,1,452,120039
168,450,3200,1900,6080000,2,3606,903,1,67000000,67000000,1351,450,901,450,0,1,452,138116
168,450,3200,1900,6080000,2,3606,903,1,67000000,67000000,1351,450,901,450,0,1,452,133549

168,850,3200,1900,6080000,2,6806,1703,1,83320000,83320000,2551,850,1701,850,0,1,852,1282128
168,850,3200,1900,6080000,2,6806,1703,1,83320000,83320000,2551,850,1701,850,0,1,852,179204
168,850,3200,1900,6080000,2,6806,1703,1,83320000,83320000,2551,850,1701,850,0,1,852,178414
168,850,3200,1900,6080000,2,6806,1703,1,83320000,83320000,2551,850,1701,850,0,1,852,178914
168,850,3200,1900,6080000,2,6806,1703,1,83320000,83320000,2551,850,1701,850,0,1,852,176868
168,850,3200,1900,6080000,2,6806,1703,1,83320000,83320000,2551,850,1701,850,0,1,852,199429
168,850,3200,1900,6080000,2,6806,1703,1,83320000,83320000,2551,850,1701,850,0,1,852,199987

168,1250,3200,1900,6080000,2,10006,2503,1,99640000,99640000,3751,1250,2501,1250,0,1,1252,1933621
168,1250,3200,1900,6080000,2,10006,2503,1,99640000,99640000,3751,1250,2501,1250,0,1,1252,250644
168,1250,3200,1900,6080000,2,10006,2503,1,99640000,99640000,3751,1250,2501,1250,0,1,1252,248152
168,1250,3200,1900,6080000,2,10006,2503,1,99640000,99640000,3751,1250,2501,1250,0,1,1252,251056
168,1250,3200,1900,6080000,2,10006,2503,1,99640000,99640000,3751,1250,2501,1250,0,1,1252,249474
168,1250,3200,1900,6080000,2,10006,2503,1,99640000,99640000,3751,1250,2501,1250,0,1,1252,251516
168,1250,3200,1900,6080000,2,10006,2503,1,99640000,99640000,3751,1250,2501,1250,0,1,1252,251976

168,1650,3200,1900,6080000,2,13206,3303,1,115960000,115960000,4951,1650,3301,1650,0,1,1652,2616110
168,1650,3200,1900,6080000,2,13206,3303,1,115960000,115960000,4951,1650,3301,1650,0,1,1652,308722
168,1650,3200,1900,6080000,2,13206,3303,1,115960000,115960000,4951,1650,3301,1650,0,1,1652,309073
168,1650,3200,1900,6080000,2,13206,3303,1,115960000,115960000,4951,1650,3301,1650,0,1,1652,307842
168,1650,3200,1900,6080000,2,13206,3303,1,115960000,115960000,4951,1650,3301,1650,0,1,1652,306028
168,1650,3200,1900,6080000,2,13206,3303,1,115960000,115960000,4951,1650,3301,1650,0,1,1652,309661
168,1650,3200,1900,6080000,2,13206,3303,1,115960000,115960000,4951,1650,3301,1650,0,1,1652,310157

168,2050,3200,1900,6080000,2,16406,4103,1,132280000,132280000,6151,2050,4101,2050,0,1,2052,3353210
168,2050,3200,1900,6080000,2,16406,4103,1,132280000,132280000,6151,2050,4101,2050,0,1,2052,370095
168,2050,3200,1900,6080000,2,16406,4103,1,132280000,132280000,6151,2050,4101,2050,0,1,2052,358071
168,2050,3200,1900,6080000,2,16406,4103,1,132280000,132280000,6151,2050,4101,2050,0,1,2052,371605
168,2050,3200,1900,6080000,2,16406,4103,1,132280000,132280000,6151,2050,4101,2050,0,1,2052,368145
168,2050,3200,1900,6080000,2,16406,4103,1,132280000,132280000,6151,2050,4101,2050,0,1,2052,370661
168,2050,3200,1900,6080000,2,16406,4103,1,132280000,132280000,6151,2050,4101,2050,0,1,2052,371194

168,2450,3200,1900,6080000,2,19606,4903,1,148600000,148600000,7351,2450,4901,2450,0,1,2452,4069293
168,2450,3200,1900,6080000,2,19606,4903,1,148600000,148600000,7351,2450,4901,2450,0,1,2452,426324
168,2450,3200,1900,6080000,2,19606,4903,1,148600000,148600000,7351,2450,4901,2450,0,1,2452,429100
168,2450,3200,1900,6080000,2,19606,4903,1,148600000,148600000,7351,2450,4901,2450,0,1,2452,428416
168,2450,3200,1900,6080000,2,19606,4903,1,148600000,148600000,7351,2450,4901,2450,0,1,2452,408590
168,2450,3200,1900,6080000,2,19606,4903,1,148600000,148600000,7351,2450,4901,2450,0,1,2452,424047
168,2450,3200,1900,6080000,2,19606,4903,1,148600000,148600000,7351,2450,4901,2450,0,1,2452,425561

168,2850,3200,1900,6080000,2,22806,5703,1,164920000,164920000,8551,2850,5701,2850,0,1,2852,4932177
168,2850,3200,1900,6080000,2,22806,5703,1,164920000,164920000,8551,2850,5701,2850,0,1,2852,487817
168,2850,3200,1900,6080000,2,22806,5703,1,164920000,164920000,8551,2850,5701,2850,0,1,2852,494623
168,2850,3200,1900,6080000,2,22806,5703,1,164920000,164920000,8551,2850,5701,2850,0,1,2852,496227
168,2850,3200,1900,6080000,2,22806,5703,1,164920000,164920000,8551,2850,5701,2850,0,1,2852,489619
168,2850,3200,1900,6080000,2,22806,5703,1,164920000,164920000,8551,2850,5701,2850,0,1,2852,514271
168,2850,3200,1900,6080000,2,22806,5703,1,164920000,164920000,8551,2850,5701,2850,0,1,2852,516414

168,3250,3200,1900,6080000,2,26006,6503,1,181240000,181240000,9751,3250,6501,3250,0,1,3252,5577887
168,3250,3200,1900,6080000,2,26006,6503,1,181240000,181240000,9751,3250,6501,3250,0,1,3252,530207
168,3250,3200,1900,6080000,2,26006,6503,1,181240000,181240000,9751,3250,6501,3250,0,1,3252,532573
168,3250,3200,1900,6080000,2,26006,6503,1,181240000,181240000,9751,3250,6501,3250,0,1,3252,535292
168,3250,3200,1900,6080000,2,26006,6503,1,181240000,181240000,9751,3250,6501,3250,0,1,3252,533759
168,3250,3200,1900,6080000,2,26006,6503,1,181240000,181240000,9751,3250,6501,3250,0,1,3252,547289
168,3250,3200,1900,6080000,2,26006,6503,1,181240000,181240000,9751,3250,6501,3250,0,1,3252,546692

168,3650,3200,1900,6080000,2,29206,7303,1,197560000,197560000,10951,3650,7301,3650,0,1,3652,6427184
168,3650,3200,1900,6080000,2,29206,7303,1,197560000,197560000,10951,3650,7301,3650,0,1,3652,595854
168,3650,3200,1900,6080000,2,29206,7303,1,197560000,197560000,10951,3650,7301,3650,0,1,3652,591012
168,3650,3200,1900,6080000,2,29206,7303,1,197560000,197560000,10951,3650,7301,3650,0,1,3652,597502
168,3650,3200,1900,6080000,2,29206,7303,1,197560000,197560000,10951,3650,7301,3650,0,1,3652,593865
168,3650,3200,1900,6080000,2,29206,7303,1,197560000,197560000,10951,3650,7301,3650,0,1,3652,612037
168,3650,3200,1900,6080000,2,29206,7303,1,197560000,197560000,10951,3650,7301,3650,0,1,3652,612724

168,4050,3200,1900,6080000,2,32406,8103,1,213880000,213880000,12151,4050,8101,4050,0,1,4052,7256124
168,4050,3200,1900,6080000,2,32406,8103,1,213880000,213880000,12151,4050,8101,4050,0,1,4052,640511
168,4050,3200,1900,6080000,2,32406,8103,1,213880000,213880000,12151,4050,8101,4050,0,1,4052,638084
168,4050,3200,1900,6080000,2,32406,8103,1,213880000,213880000,12151,4050,8101,4050,0,1,4052,641367
168,4050,3200,1900,6080000,2,32406,8103,1,213880000,213880000,12151,4050,8101,4050,0,1,4052,639065
168,4050,3200,1900,6080000,2,32406,8103,1,213880000,213880000,12151,4050,8101,4050,0,1,4052,681052
168,4050,3200,1900,6080000,2,32406,8103,1,213880000,213880000,12151,4050,8101,4050,0,1,4052,681705

168,4450,3200,1900,6080000,2,35606,8903,1,230200000,230200000,13351,4450,8901,4450,0,1,4452,7289068
168,4450,3200,1900,6080000,2,35606,8903,1,230200000,230200000,13351,4450,8901,4450,0,1,4452,703873
168,4450,3200,1900,6080000,2,35606,8903,1,230200000,230200000,13351,4450,8901,4450,0,1,4452,701772
168,4450,3200,1900,6080000,2,35606,8903,1,230200000,230200000,13351,4450,8901,4450,0,1,4452,704788
168,4450,3200,1900,6080000,2,35606,8903,1,230200000,230200000,13351,4450,8901,4450,0,1,4452,703147
168,4450,3200,1900,6080000,2,35606,8903,1,230200000,230200000,13351,4450,8901,4450,0,1,4452,754894
168,4450,3200,1900,6080000,2,35606,8903,1,230200000,230200000,13351,4450,8901,4450,0,1,4452,754079

168,4850,3200,1900,6080000,2,38806,9703,1,246520000,246520000,14551,4850,9701,4850,0,1,4852,8458006
168,4850,3200,1900,6080000,2,38806,9703,1,246520000,246520000,14551,4850,9701,4850,0,1,4852,763890
168,4850,3200,1900,6080000,2,38806,9703,1,246520000,246520000,14551,4850,9701,4850,0,1,4852,762316
168,4850,3200,1900,6080000,2,38806,9703,1,246520000,246520000,14551,4850,9701,4850,0,1,4852,763166
168,4850,3200,1900,6080000,2,38806,9703,1,246520000,246520000,14551,4850,9701,4850,0,1,4852,760152
168,4850,3200,1900,6080000,2,38806,9703,1,246520000,246520000,14551,4850,9701,4850,0,1,4852,807134
168,4850,3200,1900,6080000,2,38806,9703,1,246520000,246520000,14551,4850,9701,4850,0,1,4852,807840

168,5250,3200,1900,6080000,2,42006,10503,1,262840000,262840000,15751,5250,10501,5250,0,1,5252,9207549
168,5250,3200,1900,6080000,2,42006,10503,1,262840000,262840000,15751,5250,10501,5250,0,1,5252,885937
168,5250,3200,1900,6080000,2,42006,10503,1,262840000,262840000,15751,5250,10501,5250,0,1,5252,862847
168,5250,3200,1900,6080000,2,42006,10503,1,262840000,262840000,15751,5250,10501,5250,0,1,5252,849086
168,5250,3200,1900,6080000,2,42006,10503,1,262840000,262840000,15751,5250,10501,5250,0,1,5252,883797
168,5250,3200,1900,6080000,2,42006,10503,1,262840000,262840000,15751,5250,10501,5250,0,1,5252,906406
168,5250,3200,1900,6080000,2,42006,10503,1,262840000,262840000,15751,5250,10501,5250,0,1,5252,904030

168,5650,3200,1900,6080000,2,45206,11303,1,279160000,279160000,16951,5650,11301,5650,0,1,5652,9687553
168,5650,3200,1900,6080000,2,45206,11303,1,279160000,279160000,16951,5650,11301,5650,0,1,5652,869197
168,5650,3200,1900,6080000,2,45206,11303,1,279160000,279160000,16951,5650,11301,5650,0,1,5652,870965
168,5650,3200,1900,6080000,2,45206,11303,1,279160000,279160000,16951,5650,11301,5650,0,1,5652,873411
168,5650,3200,1900,6080000,2,45206,11303,1,279160000,279160000,16951,5650,11301,5650,0,1,5652,870257
168,5650,3200,1900,6080000,2,45206,11303,1,279160000,279160000,16951,5650,11301,5650,0,1,5652,916767
168,5650,3200,1900,6080000,2,45206,11303,1,279160000,279160000,16951,5650,11301,5650,0,1,5652,916004

168,6050,3200,1900,6080000,2,48406,12103,1,295480000,295480000,18151,6050,12101,6050,0,1,6052,10550822
168,6050,3200,1900,6080000,2,48406,12103,1,295480000,295480000,18151,6050,12101,6050,0,1,6052,934400
168,6050,3200,1900,6080000,2,48406,12103,1,295480000,295480000,18151,6050,12101,6050,0,1,6052,932304
168,6050,3200,1900,6080000,2,48406,12103,1,295480000,295480000,18151,6050,12101,6050,0,1,6052,936062
168,6050,3200,1900,6080000,2,48406,12103,1,295480000,295480000,18151,6050,12101,6050,0,1,6052,925186
168,6050,3200,1900,6080000,2,48406,12103,1,295480000,295480000,18151,6050,12101,6050,0,1,6052,968184
168,6050,3200,1900,6080000,2,48406,12103,1,295480000,295480000,18151,6050,12101,6050,0,1,6052,968959

168,6450,3200,1900,6080000,2,51606,12903,1,311800000,311800000,19351,6450,12901,6450,0,1,6452,11742743
168,6450,3200,1900,6080000,2,51606,12903,1,311800000,311800000,19351,6450,12901,6450,0,1,6452,993518
168,6450,3200,1900,6080000,2,51606,12903,1,311800000,311800000,19351,6450,12901,6450,0,1,6452,989646
168,6450,3200,1900,6080000,2,51606,12903,1,311800000,311800000,19351,6450,12901,6450,0,1,6452,997685
168,6450,3200,1900,6080000,2,51606,12903,1,311800000,311800000,19351,6450,12901,6450,0,1,6452,995456
168,6450,3200,1900,6080000,2,51606,12903,1,311800000,311800000,19351,6450,12901,6450,0,1,6452,1024716
168,6450,3200,1900,6080000,2,51606,12903,1,311800000,311800000,19351,6450,12901,6450,0,1,6452,1023881

168,6850,3200,1900,6080000,2,54806,13703,1,328120000,328120000,20551,6850,13701,6850,0,1,6852,11476178
168,6850,3200,1900,6080000,2,54806,13703,1,328120000,328120000,20551,6850,13701,6850,0,1,6852,1115369
168,6850,3200,1900,6080000,2,54806,13703,1,328120000,328120000,20551,6850,13701,6850,0,1,6852,1099948
168,6850,3200,1900,6080000,2,54806,13703,1,328120000,328120000,20551,6850,13701,6850,0,1,6852,1125520
168,6850,3200,1900,6080000,2,54806,13703,1,328120000,328120000,20551,6850,13701,6850,0,1,6852,1120585
168,6850,3200,1900,6080000,2,54806,13703,1,328120000,328120000,20551,6850,13701,6850,0,1,6852,1138782
168,6850,3200,1900,6080000,2,54806,13703,1,328120000,328120000,20551,6850,13701,6850,0,1,6852,1140494

168,50,3200,1500,4800000,2,406,103,1,40280000,40280000,151,50,101,50,0,1,52,51699
168,50,3200,1500,4800000,2,406,103,1,40280000,40280000,151,50,101,50,0,1,52,50190
168,50,3200,1500,4800000,2,406,103,1,40280000,40280000,151,50,101,50,0,1,52,41067
168,50,3200,1500,4800000,2,406,103,1,40280000,40280000,151,50,101,50,0,1,52,49578
168,50,3200,1500,4800000,2,406,103,1,40280000,40280000,151,50,101,50,0,1,52,48831
168,50,3200,1500,4800000,2,406,103,1,40280000,40280000,151,50,101,50,0,1,52,61186
168,50,3200,1500,4800000,2,406,103,1,40280000,40280000,151,50,101,50,0,1,52,61663

168,450,3200,1500,4800000,2,3606,903,1,55320000,55320000,1351,450,901,450,0,1,452,518754
168,450,3200,1500,4800000,2,3606,903,1,55320000,55320000,1351,450,901,450,0,1,452,89823
168,450,3200,1500,4800000,2,3606,903,1,55320000,55320000,1351,450,901,450,0,1,452,93749
168,450,3200,1500,4800000,2,3606,903,1,55320000,55320000,1351,450,901,450,0,1,452,93249
168,450,3200,1500,4800000,2,3606,903,1,55320000,55320000,1351,450,901,450,0,1,452,90927
168,450,3200,1500,4800000,2,3606,903,1,55320000,55320000,1351,450,901,450,0,1,452,107425
168,450,3200,1500,4800000,2,3606,903,1,55320000,55320000,1351,450,901,450,0,1,452,109576

168,850,3200,1500,4800000,2,6806,1703,1,70360000,70360000,2551,850,1701,850,0,1,852,1034297
168,850,3200,1500,4800000,2,6806,1703,1,70360000,70360000,2551,850,1701,850,0,1,852,141534
168,850,3200,1500,4800000,2,6806,1703,1,70360000,70360000,2551,850,1701,850,0,1,852,143659
168,850,3200,1500,4800000,2,6806,1703,1,70360000,70360000,2551,850,1701,850,0,1,852,143365
168,850,3200,1500,4800000,2,6806,1703,1,70360000,70360000,2551,850,1701,850,0,1,852,142865
168,850,3200,1500,4800000,2,6806,1703,1,70360000,70360000,2551,850,1701,850,0,1,852,161954
168,850,3200,1500,4800000,2,6806,1703,1,70360000,70360000,2551,850,1701,850,0,1,852,162531

168,1250,3200,1500,4800000,2,10006,2503,1,85400000,85400000,3751,1250,2501,1250,0,1,1252,1523557
168,1250,3200,1500,4800000,2,10006,2503,1,85400000,85400000,3751,1250,2501,1250,0,1,1252,198021
168,1250,3200,1500,4800000,2,10006,2503,1,85400000,85400000,3751,1250,2501,1250,0,1,1252,196495
168,1250,3200,1500,4800000,2,10006,2503,1,85400000,85400000,3751,1250,2501,1250,0,1,1252,197678
168,1250,3200,1500,4800000,2,10006,2503,1,85400000,85400000,3751,1250,2501,1250,0,1,1252,197129
168,1250,3200,1500,4800000,2,10006,2503,1,85400000,85400000,3751,1250,2501,1250,0,1,1252,207530
168,1250,3200,1500,4800000,2,10006,2503,1,85400000,85400000,3751,1250,2501,1250,0,1,1252,207986

168,1650,3200,1500,4800000,2,13206,3303,1,100440000,100440000,4951,1650,3301,1650,0,1,1652,2010054
168,1650,3200,1500,4800000,2,13206,3303,1,100440000,100440000,4951,1650,3301,1650,0,1,1652,253894
168,1650,3200,1500,4800000,2,13206,3303,1,100440000,100440000,4951,1650,3301,1650,0,1,1652,252987
168,1650,3200,1500,4800000,2,13206,3303,1,100440000,100440000,4951,1650,3301,1650,0,1,1652,253533
168,1650,3200,1500,4800000,2,13206,3303,1,100440000,100440000,4951,1650,3301,1650,0,1,1652,251750
168,1650,3200,1500,4800000,2,13206,3303,1,100440000,100440000,4951,1650,3301,1650,0,1,1652,252363
168,1650,3200,1500,4800000,2,13206,3303,1,100440000,100440000,4951,1650,3301,1650,0,1,1652,246241

168,2050,3200,1500,4800000,2,16406,4103,1,115480000,115480000,6151,2050,4101,2050,0,1,2052,2564896
168,2050,3200,1500,4800000,2,16406,4103,1,115480000,115480000,6151,2050,4101,2050,0,1,2052,301389
168,2050,3200,1500,4800000,2,16406,4103,1,115480000,115480000,6151,2050,4101,2050,0,1,2052,298957
168,2050,3200,1500,4800000,2,16406,4103,1,115480000,115480000,6151,2050,4101,2050,0,1,2052,289352
168,2050,3200,1500,4800000,2,16406,4103,1,115480000,115480000,6151,2050,4101,2050,0,1,2052,302042
168,2050,3200,1500,4800000,2,16406,4103,1,115480000,115480000,6151,2050,4101,2050,0,1,2052,300269
168,2050,3200,1500,4800000,2,16406,4103,1,115480000,115480000,6151,2050,4101,2050,0,1,2052,299745

168,2450,3200,1500,4800000,2,19606,4903,1,130520000,130520000,7351,2450,4901,2450,0,1,2452,3144318
168,2450,3200,1500,4800000,2,19606,4903,1,130520000,130520000,7351,2450,4901,2450,0,1,2452,351369
168,2450,3200,1500,4800000,2,19606,4903,1,130520000,130520000,7351,2450,4901,2450,0,1,2452,355980
168,2450,3200,1500,4800000,2,19606,4903,1,130520000,130520000,7351,2450,4901,2450,0,1,2452,353207
168,2450,3200,1500,4800000,2,19606,4903,1,130520000,130520000,7351,2450,4901,2450,0,1,2452,355126
168,2450,3200,1500,4800000,2,19606,4903,1,130520000,130520000,7351,2450,4901,2450,0,1,2452,355541
168,2450,3200,1500,4800000,2,19606,4903,1,130520000,130520000,7351,2450,4901,2450,0,1,2452,356305

168,2850,3200,1500,4800000,2,22806,5703,1,145560000,145560000,8551,2850,5701,2850,0,1,2852,3659669
168,2850,3200,1500,4800000,2,22806,5703,1,145560000,145560000,8551,2850,5701,2850,0,1,2852,396012
168,2850,3200,1500,4800000,2,22806,5703,1,145560000,145560000,8551,2850,5701,2850,0,1,2852,398269
168,2850,3200,1500,4800000,2,22806,5703,1,145560000,145560000,8551,2850,5701,2850,0,1,2852,397419
168,2850,3200,1500,4800000,2,22806,5703,1,145560000,145560000,8551,2850,5701,2850,0,1,2852,393947
168,2850,3200,1500,4800000,2,22806,5703,1,145560000,145560000,8551,2850,5701,2850,0,1,2852,399495
168,2850,3200,1500,4800000,2,22806,5703,1,145560000,145560000,8551,2850,5701,2850,0,1,2852,400067

168,3250,3200,1500,4800000,2,26006,6503,1,160600000,160600000,9751,3250,6501,3250,0,1,3252,4289680
168,3250,3200,1500,4800000,2,26006,6503,1,160600000,160600000,9751,3250,6501,3250,0,1,3252,441874
168,3250,3200,1500,4800000,2,26006,6503,1,160600000,160600000,9751,3250,6501,3250,0,1,3252,439286
168,3250,3200,1500,4800000,2,26006,6503,1,160600000,160600000,9751,3250,6501,3250,0,1,3252,441111
168,3250,3200,1500,4800000,2,26006,6503,1,160600000,160600000,9751,3250,6501,3250,0,1,3252,438168
168,3250,3200,1500,4800000,2,26006,6503,1,160600000,160600000,9751,3250,6501,3250,0,1,3252,474725
168,3250,3200,1500,4800000,2,26006,6503,1,160600000,160600000,9751,3250,6501,3250,0,1,3252,475320

168,3650,3200,1500,4800000,2,29206,7303,1,175640000,175640000,10951,3650,7301,3650,0,1,3652,4844197
168,3650,3200,1500,4800000,2,29206,7303,1,175640000,175640000,10951,3650,7301,3650,0,1,3652,471561
168,3650,3200,1500,4800000,2,29206,7303,1,175640000,175640000,10951,3650,7301,3650,0,1,3652,472184
168,3650,3200,1500,4800000,2,29206,7303,1,175640000,175640000,10951,3650,7301,3650,0,1,3652,473878
168,3650,3200,1500,4800000,2,29206,7303,1,175640000,175640000,10951,3650,7301,3650,0,1,3652,474688
168,3650,3200,1500,4800000,2,29206,7303,1,175640000,175640000,10951,3650,7301,3650,0,1,3652,506025
168,3650,3200,1500,4800000,2,29206,7303,1,175640000,175640000,10951,3650,7301,3650,0,1,3652,506648

168,4050,3200,1500,4800000,2,32406,8103,1,190680000,190680000,12151,4050,8101,4050,0,1,4052,5373097
168,4050,3200,1500,4800000,2,32406,8103,1,190680000,190680000,12151,4050,8101,4050,0,1,4052,525807
168,4050,3200,1500,4800000,2,32406,8103,1,190680000,190680000,12151,4050,8101,4050,0,1,4052,527796
168,4050,3200,1500,4800000,2,32406,8103,1,190680000,190680000,12151,4050,8101,4050,0,1,4052,528655
168,4050,3200,1500,4800000,2,32406,8103,1,190680000,190680000,12151,4050,8101,4050,0,1,4052,527097
168,4050,3200,1500,4800000,2,32406,8103,1,190680000,190680000,12151,4050,8101,4050,0,1,4052,563243
168,4050,3200,1500,4800000,2,32406,8103,1,190680000,190680000,12151,4050,8101,4050,0,1,4052,562591

168,4450,3200,1500,4800000,2,35606,8903,1,205720000,205720000,13351,4450,8901,4450,0,1,4452,6170786
168,4450,3200,1500,4800000,2,35606,8903,1,205720000,205720000,13351,4450,8901,4450,0,1,4452,595417
168,4450,3200,1500,4800000,2,35606,8903,1,205720000,205720000,13351,4450,8901,4450,0,1,4452,599729
168,4450,3200,1500,4800000,2,35606,8903,1,205720000,205720000,13351,4450,8901,4450,0,1,4452,598825
168,4450,3200,1500,4800000,2,35606,8903,1,205720000,205720000,13351,4450,8901,4450,0,1,4452,594251
168,4450,3200,1500,4800000,2,35606,8903,1,205720000,205720000,13351,4450,8901,4450,0,1,4452,649332
168,4450,3200,1500,4800000,2,35606,8903,1,205720000,205720000,13351,4450,8901,4450,0,1,4452,651547

168,4850,3200,1500,4800000,2,38806,9703,1,220760000,220760000,14551,4850,9701,4850,0,1,4852,6466449
168,4850,3200,1500,4800000,2,38806,9703,1,220760000,220760000,14551,4850,9701,4850,0,1,4852,627688
168,4850,3200,1500,4800000,2,38806,9703,1,220760000,220760000,14551,4850,9701,4850,0,1,4852,627031
168,4850,3200,1500,4800000,2,38806,9703,1,220760000,220760000,14551,4850,9701,4850,0,1,4852,628766
168,4850,3200,1500,4800000,2,38806,9703,1,220760000,220760000,14551,4850,9701,4850,0,1,4852,625993
168,4850,3200,1500,4800000,2,38806,9703,1,220760000,220760000,14551,4850,9701,4850,0,1,4852,668249
168,4850,3200,1500,4800000,2,38806,9703,1,220760000,220760000,14551,4850,9701,4850,0,1,4852,667541

168,5250,3200,1500,4800000,2,42006,10503,1,235800000,235800000,15751,5250,10501,5250,0,1,5252,7126427
168,5250,3200,1500,4800000,2,42006,10503,1,235800000,235800000,15751,5250,10501,5250,0,1,5252,662879
168,5250,3200,1500,4800000,2,42006,10503,1,235800000,235800000,15751,5250,10501,5250,0,1,5252,659945
168,5250,3200,1500,4800000,2,42006,10503,1,235800000,235800000,15751,5250,10501,5250,0,1,5252,664539
168,5250,3200,1500,4800000,2,42006,10503,1,235800000,235800000,15751,5250,10501,5250,0,1,5252,663756
168,5250,3200,1500,4800000,2,42006,10503,1,235800000,235800000,15751,5250,10501,5250,0,1,5252,718611
168,5250,3200,1500,4800000,2,42006,10503,1,235800000,235800000,15751,5250,10501,5250,0,1,5252,719380

168,5650,3200,1500,4800000,2,45206,11303,1,250840000,250840000,16951,5650,11301,5650,0,1,5652,7555094
168,5650,3200,1500,4800000,2,45206,11303,1,250840000,250840000,16951,5650,11301,5650,0,1,5652,731002
168,5650,3200,1500,4800000,2,45206,11303,1,250840000,250840000,16951,5650,11301,5650,0,1,5652,732796
168,5650,3200,1500,4800000,2,45206,11303,1,250840000,250840000,16951,5650,11301,5650,0,1,5652,736396
168,5650,3200,1500,4800000,2,45206,11303,1,250840000,250840000,16951,5650,11301,5650,0,1,5652,725771
168,5650,3200,1500,4800000,2,45206,11303,1,250840000,250840000,16951,5650,11301,5650,0,1,5652,765970
168,5650,3200,1500,4800000,2,45206,11303,1,250840000,250840000,16951,5650,11301,5650,0,1,5652,766745

168,6050,3200,1500,4800000,2,48406,12103,1,265880000,265880000,18151,6050,12101,6050,0,1,6052,8339804
168,6050,3200,1500,4800000,2,48406,12103,1,265880000,265880000,18151,6050,12101,6050,0,1,6052,755694
168,6050,3200,1500,4800000,2,48406,12103,1,265880000,265880000,18151,6050,12101,6050,0,1,6052,754411
168,6050,3200,1500,4800000,2,48406,12103,1,265880000,265880000,18151,6050,12101,6050,0,1,6052,759101
168,6050,3200,1500,4800000,2,48406,12103,1,265880000,265880000,18151,6050,12101,6050,0,1,6052,758023
168,6050,3200,1500,4800000,2,48406,12103,1,265880000,265880000,18151,6050,12101,6050,0,1,6052,809309
168,6050,3200,1500,4800000,2,48406,12103,1,265880000,265880000,18151,6050,12101,6050,0,1,6052,810095

168,6450,3200,1500,4800000,2,51606,12903,1,280920000,280920000,19351,6450,12901,6450,0,1,6452,8744383
168,6450,3200,1500,4800000,2,51606,12903,1,280920000,280920000,19351,6450,12901,6450,0,1,6452,821690
168,6450,3200,1500,4800000,2,51606,12903,1,280920000,280920000,19351,6450,12901,6450,0,1,6452,811411
168,6450,3200,1500,4800000,2,51606,12903,1,280920000,280920000,19351,6450,12901,6450,0,1,6452,829605
168,6450,3200,1500,4800000,2,51606,12903,1,280920000,280920000,19351,6450,12901,6450,0,1,6452,822913
168,6450,3200,1500,4800000,2,51606,12903,1,280920000,280920000,19351,6450,12901,6450,0,1,6452,869842
168,6450,3200,1500,4800000,2,51606,12903,1,280920000,280920000,19351,6450,12901,6450,0,1,6452,871473

168,6850,3200,1500,4800000,2,54806,13703,1,295960000,295960000,20551,6850,13701,6850,0,1,6852,9447087
168,6850,3200,1500,4800000,2,54806,13703,1,295960000,295960000,20551,6850,13701,6850,0,1,6852,875187
168,6850,3200,1500,4800000,2,54806,13703,1,295960000,295960000,20551,6850,13701,6850,0,1,6852,886799
168,6850,3200,1500,4800000,2,54806,13703,1,295960000,295960000,20551,6850,13701,6850,0,1,6852,878046
168,6850,3200,1500,4800000,2,54806,13703,1,295960000,295960000,20551,6850,13701,6850,0,1,6852,882724
168,6850,3200,1500,4800000,2,54806,13703,1,295960000,295960000,20551,6850,13701,6850,0,1,6852,907015
168,6850,3200,1500,4800000,2,54806,13703,1,295960000,295960000,20551,6850,13701,6850,0,1,6852,907841

168,50,3200,1100,3520000,2,406,103,1,29880000,29880000,151,50,101,50,0,1,52,37987
168,50,3200,1100,3520000,2,406,103,1,29880000,29880000,151,50,101,50,0,1,52,31534
168,50,3200,1100,3520000,2,406,103,1,29880000,29880000,151,50,101,50,0,1,52,38412
168,50,3200,1100,3520000,2,406,103,1,29880000,29880000,151,50,101,50,0,1,52,40388
168,50,3200,1100,3520000,2,406,103,1,29880000,29880000,151,50,101,50,0,1,52,40833
168,50,3200,1100,3520000,2,406,103,1,29880000,29880000,151,50,101,50,0,1,52,47133
168,50,3200,1100,3520000,2,406,103,1,29880000,29880000,151,50,101,50,0,1,52,47610

168,450,3200,1100,3520000,2,3606,903,1,43640000,43640000,1351,450,901,450,0,1,452,364779
168,450,3200,1100,3520000,2,3606,903,1,43640000,43640000,1351,450,901,450,0,1,452,68387
168,450,3200,1100,3520000,2,3606,903,1,43640000,43640000,1351,450,901,450,0,1,452,75818
168,450,3200,1100,3520000,2,3606,903,1,43640000,43640000,1351,450,901,450,0,1,452,76309
168,450,3200,1100,3520000,2,3606,903,1,43640000,43640000,1351,450,901,450,0,1,452,74863
168,450,3200,1100,3520000,2,3606,903,1,43640000,43640000,1351,450,901,450,0,1,452,83061
168,450,3200,1100,3520000,2,3606,903,1,43640000,43640000,1351,450,901,450,0,1,452,85709

168,850,3200,1100,3520000,2,6806,1703,1,57400000,57400000,2551,850,1701,850,0,1,852,725575
168,850,3200,1100,3520000,2,6806,1703,1,57400000,57400000,2551,850,1701,850,0,1,852,111823
168,850,3200,1100,3520000,2,6806,1703,1,57400000,57400000,2551,850,1701,850,0,1,852,109834
168,850,3200,1100,3520000,2,6806,1703,1,57400000,57400000,2551,850,1701,850,0,1,852,111270
168,850,3200,1100,3520000,2,6806,1703,1,57400000,57400000,2551,850,1701,850,0,1,852,110855
168,850,3200,1100,3520000,2,6806,1703,1,57400000,57400000,2551,850,1701,850,0,1,852,125920
168,850,3200,1100,3520000,2,6806,1703,1,57400000,57400000,2551,850,1701,850,0,1,852,125346

168,1250,3200,1100,3520000,2,10006,2503,1,71160000,71160000,3751,1250,2501,1250,0,1,1252,1074376
168,1250,3200,1100,3520000,2,10006,2503,1,71160000,71160000,3751,1250,2501,1250,0,1,1252,152379
168,1250,3200,1100,3520000,2,10006,2503,1,71160000,71160000,3751,1250,2501,1250,0,1,1252,153761
168,1250,3200,1100,3520000,2,10006,2503,1,71160000,71160000,3751,1250,2501,1250,0,1,1252,154313
168,1250,3200,1100,3520000,2,10006,2503,1,71160000,71160000,3751,1250,2501,1250,0,1,1252,154659
168,1250,3200,1100,3520000,2,10006,2503,1,71160000,71160000,3751,1250,2501,1250,0,1,1252,169321
168,1250,3200,1100,3520000,2,10006,2503,1,71160000,71160000,3751,1250,2501,1250,0,1,1252,168693

168,1650,3200,1100,3520000,2,13206,3303,1,84920000,84920000,4951,1650,3301,1650,0,1,1652,1520060
168,1650,3200,1100,3520000,2,13206,3303,1,84920000,84920000,4951,1650,3301,1650,0,1,1652,185148
168,1650,3200,1100,3520000,2,13206,3303,1,84920000,84920000,4951,1650,3301,1650,0,1,1652,189381
168,1650,3200,1100,3520000,2,13206,3303,1,84920000,84920000,4951,1650,3301,1650,0,1,1652,188748
168,1650,3200,1100,3520000,2,13206,3303,1,84920000,84920000,4951,1650,3301,1650,0,1,1652,181655
168,1650,3200,1100,3520000,2,13206,3303,1,84920000,84920000,4951,1650,3301,1650,0,1,1652,203993
168,1650,3200,1100,3520000,2,13206,3303,1,84920000,84920000,4951,1650,3301,1650,0,1,1652,204479

168,2050,3200,1100,3520000,2,16406,4103,1,98680000,98680000,6151,2050,4101,2050,0,1,2052,1851746
168,2050,3200,1100,3520000,2,16406,4103,1,98680000,98680000,6151,2050,4101,2050,0,1,2052,228045
168,2050,3200,1100,3520000,2,16406,4103,1,98680000,98680000,6151,2050,4101,2050,0,1,2052,233450
168,2050,3200,1100,3520000,2,16406,4103,1,98680000,98680000,6151,2050,4101,2050,0,1,2052,232814
168,2050,3200,1100,3520000,2,16406,4103,1,98680000,98680000,6151,2050,4101,2050,0,1,2052,228614
168,2050,3200,1100,3520000,2,16406,4103,1,98680000,98680000,6151,2050,4101,2050,0,1,2052,231672
168,2050,3200,1100,3520000,2,16406,4103,1,98680000,98680000,6151,2050,4101,2050,0,1,2052,232109

168,2450,3200,1100,3520000,2,19606,4903,1,112440000,112440000,7351,2450,4901,2450,0,1,2452,2256533
168,2450,3200,1100,3520000,2,19606,4903,1,112440000,112440000,7351,2450,4901,2450,0,1,2452,271081
168,2450,3200,1100,3520000,2,19606,4903,1,112440000,112440000,7351,2450,4901,2450,0,1,2452,272504
168,2450,3200,1100,3520000,2,19606,4903,1,112440000,112440000,7351,2450,4901,2450,0,1,2452,263080
168,2450,3200,1100,3520000,2,19606,4903,1,112440000,112440000,7351,2450,4901,2450,0,1,2452,271833
168,2450,3200,1100,3520000,2,19606,4903,1,112440000,112440000,7351,2450,4901,2450,0,1,2452,268161
168,2450,3200,1100,3520000,2,19606,4903,1,112440000,112440000,7351,2450,4901,2450,0,1,2452,269493

168,2850,3200,1100,3520000,2,22806,5703,1,126200000,126200000,8551,2850,5701,2850,0,1,2852,2610386
168,2850,3200,1100,3520000,2,22806,5703,1,126200000,126200000,8551,2850,5701,2850,0,1,2852,311565
168,2850,3200,1100,3520000,2,22806,5703,1,126200000,126200000,8551,2850,5701,2850,0,1,2852,309793
168,2850,3200,1100,3520000,2,22806,5703,1,126200000,126200000,8551,2850,5701,2850,0,1,2852,314230
168,2850,3200,1100,3520000,2,22806,5703,1,126200000,126200000,8551,2850,5701,2850,0,1,2852,313750
168,2850,3200,1100,3520000,2,22806,5703,1,126200000,126200000,8551,2850,5701,2850,0,1,2852,313319
168,2850,3200,1100,3520000,2,22806,5703,1,126200000,126200000,8551,2850,5701,2850,0,1,2852,312753

168,3250,3200,1100,3520000,2,26006,6503,1,139960000,139960000,9751,3250,6501,3250,0,1,3252,2987933
168,3250,3200,1100,3520000,2,26006,6503,1,139960000,139960000,9751,3250,6501,3250,0,1,3252,338162
168,3250,3200,1100,3520000,2,26006,6503,1,139960000,139960000,9751,3250,6501,3250,0,1,3252,340586
168,3250,3200,1100,3520000,2,26006,6503,1,139960000,139960000,9751,3250,6501,3250,0,1,3252,339523
168,3250,3200,1100,3520000,2,26006,6503,1,139960000,139960000,9751,3250,6501,3250,0,1,3252,335213
168,3250,3200,1100,3520000,2,26006,6503,1,139960000,139960000,9751,3250,6501,3250,0,1,3252,348027
168,3250,3200,1100,3520000,2,26006,6503,1,139960000,139960000,9751,3250,6501,3250,0,1,3252,347429

168,3650,3200,1100,3520000,2,29206,7303,1,153720000,153720000,10951,3650,7301,3650,0,1,3652,3432191
168,3650,3200,1100,3520000,2,29206,7303,1,153720000,153720000,10951,3650,7301,3650,0,1,3652,371018
168,3650,3200,1100,3520000,2,29206,7303,1,153720000,153720000,10951,3650,7301,3650,0,1,3652,372314
168,3650,3200,1100,3520000,2,29206,7303,1,153720000,153720000,10951,3650,7301,3650,0,1,3652,371746
168,3650,3200,1100,3520000,2,29206,7303,1,153720000,153720000,10951,3650,7301,3650,0,1,3652,367056
168,3650,3200,1100,3520000,2,29206,7303,1,153720000,153720000,10951,3650,7301,3650,0,1,3652,398125
168,3650,3200,1100,3520000,2,29206,7303,1,153720000,153720000,10951,3650,7301,3650,0,1,3652,398777

168,4050,3200,1100,3520000,2,32406,8103,1,167480000,167480000,12151,4050,8101,4050,0,1,4052,3788427
168,4050,3200,1100,3520000,2,32406,8103,1,167480000,167480000,12151,4050,8101,4050,0,1,4052,406477
168,4050,3200,1100,3520000,2,32406,8103,1,167480000,167480000,12151,4050,8101,4050,0,1,4052,399897
168,4050,3200,1100,3520000,2,32406,8103,1,167480000,167480000,12151,4050,8101,4050,0,1,4052,407856
168,4050,3200,1100,3520000,2,32406,8103,1,167480000,167480000,12151,4050,8101,4050,0,1,4052,407242
168,4050,3200,1100,3520000,2,32406,8103,1,167480000,167480000,12151,4050,8101,4050,0,1,4052,442417
168,4050,3200,1100,3520000,2,32406,8103,1,167480000,167480000,12151,4050,8101,4050,0,1,4052,443098

168,4450,3200,1100,3520000,2,35606,8903,1,181240000,181240000,13351,4450,8901,4450,0,1,4452,4298358
168,4450,3200,1100,3520000,2,35606,8903,1,181240000,181240000,13351,4450,8901,4450,0,1,4452,442446
168,4450,3200,1100,3520000,2,35606,8903,1,181240000,181240000,13351,4450,8901,4450,0,1,4452,439330
168,4450,3200,1100,3520000,2,35606,8903,1,181240000,181240000,13351,4450,8901,4450,0,1,4452,444083
168,4450,3200,1100,3520000,2,35606,8903,1,181240000,181240000,13351,4450,8901,4450,0,1,4452,443176
168,4450,3200,1100,3520000,2,35606,8903,1,181240000,181240000,13351,4450,8901,4450,0,1,4452,483742
168,4450,3200,1100,3520000,2,35606,8903,1,181240000,181240000,13351,4450,8901,4450,0,1,4452,484490

168,4850,3200,1100,3520000,2,38806,9703,1,195000000,195000000,14551,4850,9701,4850,0,1,4852,4664602
168,4850,3200,1100,3520000,2,38806,9703,1,195000000,195000000,14551,4850,9701,4850,0,1,4852,479416
168,4850,3200,1100,3520000,2,38806,9703,1,195000000,195000000,14551,4850,9701,4850,0,1,4852,477469
168,4850,3200,1100,3520000,2,38806,9703,1,195000000,195000000,14551,4850,9701,4850,0,1,4852,478457
168,4850,3200,1100,3520000,2,38806,9703,1,195000000,195000000,14551,4850,9701,4850,0,1,4852,475710
168,4850,3200,1100,3520000,2,38806,9703,1,195000000,195000000,14551,4850,9701,4850,0,1,4852,524280
168,4850,3200,1100,3520000,2,38806,9703,1,195000000,195000000,14551,4850,9701,4850,0,1,4852,525747

168,5250,3200,1100,3520000,2,42006,10503,1,208760000,208760000,15751,5250,10501,5250,0,1,5252,5162110
168,5250,3200,1100,3520000,2,42006,10503,1,208760000,208760000,15751,5250,10501,5250,0,1,5252,550350
168,5250,3200,1100,3520000,2,42006,10503,1,208760000,208760000,15751,5250,10501,5250,0,1,5252,544985
168,5250,3200,1100,3520000,2,42006,10503,1,208760000,208760000,15751,5250,10501,5250,0,1,5252,542294
168,5250,3200,1100,3520000,2,42006,10503,1,208760000,208760000,15751,5250,10501,5250,0,1,5252,551338
168,5250,3200,1100,3520000,2,42006,10503,1,208760000,208760000,15751,5250,10501,5250,0,1,5252,600162
168,5250,3200,1100,3520000,2,42006,10503,1,208760000,208760000,15751,5250,10501,5250,0,1,5252,590685

168,5650,3200,1100,3520000,2,45206,11303,1,222520000,222520000,16951,5650,11301,5650,0,1,5652,5543573
168,5650,3200,1100,3520000,2,45206,11303,1,222520000,222520000,16951,5650,11301,5650,0,1,5652,563073
168,5650,3200,1100,3520000,2,45206,11303,1,222520000,222520000,16951,5650,11301,5650,0,1,5652,560118
168,5650,3200,1100,3520000,2,45206,11303,1,222520000,222520000,16951,5650,11301,5650,0,1,5652,564083
168,5650,3200,1100,3520000,2,45206,11303,1,222520000,222520000,16951,5650,11301,5650,0,1,5652,561526
168,5650,3200,1100,3520000,2,45206,11303,1,222520000,222520000,16951,5650,11301,5650,0,1,5652,618232
168,5650,3200,1100,3520000,2,45206,11303,1,222520000,222520000,16951,5650,11301,5650,0,1,5652,617464

168,6050,3200,1100,3520000,2,48406,12103,1,236280000,236280000,18151,6050,12101,6050,0,1,6052,6107124
168,6050,3200,1100,3520000,2,48406,12103,1,236280000,236280000,18151,6050,12101,6050,0,1,6052,582849
168,6050,3200,1100,3520000,2,48406,12103,1,236280000,236280000,18151,6050,12101,6050,0,1,6052,579010
168,6050,3200,1100,3520000,2,48406,12103,1,236280000,236280000,18151,6050,12101,6050,0,1,6052,583678
168,6050,3200,1100,3520000,2,48406,12103,1,236280000,236280000,18151,6050,12101,6050,0,1,6052,581896
168,6050,3200,1100,3520000,2,48406,12103,1,236280000,236280000,18151,6050,12101,6050,0,1,6052,652121
168,6050,3200,1100,3520000,2,48406,12103,1,236280000,236280000,18151,6050,12101,6050,0,1,6052,653066

168,6450,3200,1100,3520000,2,51606,12903,1,250040000,250040000,19351,6450,12901,6450,0,1,6452,6397987
168,6450,3200,1100,3520000,2,51606,12903,1,250040000,250040000,19351,6450,12901,6450,0,1,6452,621302
168,6450,3200,1100,3520000,2,51606,12903,1,250040000,250040000,19351,6450,12901,6450,0,1,6452,618006
168,6450,3200,1100,3520000,2,51606,12903,1,250040000,250040000,19351,6450,12901,6450,0,1,6452,622302
168,6450,3200,1100,3520000,2,51606,12903,1,250040000,250040000,19351,6450,12901,6450,0,1,6452,623169
168,6450,3200,1100,3520000,2,51606,12903,1,250040000,250040000,19351,6450,12901,6450,0,1,6452,683297
168,6450,3200,1100,3520000,2,51606,12903,1,250040000,250040000,19351,6450,12901,6450,0,1,6452,681749

168,6850,3200,1100,3520000,2,54806,13703,1,263800000,263800000,20551,6850,13701,6850,0,1,6852,6637840
168,6850,3200,1100,3520000,2,54806,13703,1,263800000,263800000,20551,6850,13701,6850,0,1,6852,654889
168,6850,3200,1100,3520000,2,54806,13703,1,263800000,263800000,20551,6850,13701,6850,0,1,6852,653819
168,6850,3200,1100,3520000,2,54806,13703,1,263800000,263800000,20551,6850,13701,6850,0,1,6852,655773
168,6850,3200,1100,3520000,2,54806,13703,1,263800000,263800000,20551,6850,13701,6850,0,1,6852,652053
168,6850,3200,1100,3520000,2,54806,13703,1,263800000,263800000,20551,6850,13701,6850,0,1,6852,714539
168,6850,3200,1100,3520000,2,54806,13703,1,263800000,263800000,20551,6850,13701,6850,0,1,6852,715352

168,50,3200,700,2240000,2,406,103,1,19480000,19480000,151,50,101,50,0,1,52,23988
168,50,3200,700,2240000,2,406,103,1,19480000,19480000,151,50,101,50,0,1,52,27752
168,50,3200,700,2240000,2,406,103,1,19480000,19480000,151,50,101,50,0,1,52,28375
168,50,3200,700,2240000,2,406,103,1,19480000,19480000,151,50,101,50,0,1,52,27071
168,50,3200,700,2240000,2,406,103,1,19480000,19480000,151,50,101,50,0,1,52,24081
168,50,3200,700,2240000,2,406,103,1,19480000,19480000,151,50,101,50,0,1,52,34561
168,50,3200,700,2240000,2,406,103,1,19480000,19480000,151,50,101,50,0,1,52,31524

168,450,3200,700,2240000,2,3606,903,1,31960000,31960000,1351,450,901,450,0,1,452,225852
168,450,3200,700,2240000,2,3606,903,1,31960000,31960000,1351,450,901,450,0,1,452,50944
168,450,3200,700,2240000,2,3606,903,1,31960000,31960000,1351,450,901,450,0,1,452,53370
168,450,3200,700,2240000,2,3606,903,1,31960000,31960000,1351,450,901,450,0,1,452,52866
168,450,3200,700,2240000,2,3606,903,1,31960000,31960000,1351,450,901,450,0,1,452,51908
168,450,3200,700,2240000,2,3606,903,1,31960000,31960000,1351,450,901,450,0,1,452,63484
168,450,3200,700,2240000,2,3606,903,1,31960000,31960000,1351,450,901,450,0,1,452,61444

168,850,3200,700,2240000,2,6806,1703,1,44440000,44440000,2551,850,1701,850,0,1,852,467961
168,850,3200,700,2240000,2,6806,1703,1,44440000,44440000,2551,850,1701,850,0,1,852,81133
168,850,3200,700,2240000,2,6806,1703,1,44440000,44440000,2551,850,1701,850,0,1,852,76281
168,850,3200,700,2240000,2,6806,1703,1,44440000,44440000,2551,850,1701,850,0,1,852,78778
168,850,3200,700,2240000,2,6806,1703,1,44440000,44440000,2551,850,1701,850,0,1,852,80597
168,850,3200,700,2240000,2,6806,1703,1,44440000,44440000,2551,850,1701,850,0,1,852,91112
168,850,3200,700,2240000,2,6806,1703,1,44440000,44440000,2551,850,1701,850,0,1,852,91697

168,1250,3200,700,2240000,2,10006,2503,1,56920000,56920000,3751,1250,2501,1250,0,1,1252,709758
168,1250,3200,700,2240000,2,10006,2503,1,56920000,56920000,3751,1250,2501,1250,0,1,1252,104751
168,1250,3200,700,2240000,2,10006,2503,1,56920000,56920000,3751,1250,2501,1250,0,1,1252,103714
168,1250,3200,700,2240000,2,10006,2503,1,56920000,56920000,3751,1250,2501,1250,0,1,1252,105815
168,1250,3200,700,2240000,2,10006,2503,1,56920000,56920000,3751,1250,2501,1250,0,1,1252,106412
168,1250,3200,700,2240000,2,10006,2503,1,56920000,56920000,3751,1250,2501,1250,0,1,1252,118602
168,1250,3200,700,2240000,2,10006,2503,1,56920000,56920000,3751,1250,2501,1250,0,1,1252,119234

168,1650,3200,700,2240000,2,13206,3303,1,69400000,69400000,4951,1650,3301,1650,0,1,1652,896730
168,1650,3200,700,2240000,2,13206,3303,1,69400000,69400000,4951,1650,3301,1650,0,1,1652,162859
168,1650,3200,700,2240000,2,13206,3303,1,69400000,69400000,4951,1650,3301,1650,0,1,1652,162025
168,1650,3200,700,2240000,2,13206,3303,1,69400000,69400000,4951,1650,3301,1650,0,1,1652,162534
168,1650,3200,700,2240000,2,13206,3303,1,69400000,69400000,4951,1650,3301,1650,0,1,1652,163223
168,1650,3200,700,2240000,2,13206,3303,1,69400000,69400000,4951,1650,3301,1650,0,1,1652,163610
168,1650,3200,700,2240000,2,13206,3303,1,69400000,69400000,4951,1650,3301,1650,0,1,1652,164038

168,2050,3200,700,2240000,2,16406,4103,1,81880000,81880000,6151,2050,4101,2050,0,1,2052,1160461
168,2050,3200,700,2240000,2,16406,4103,1,81880000,81880000,6151,2050,4101,2050,0,1,2052,157000
168,2050,3200,700,2240000,2,16406,4103,1,81880000,81880000,6151,2050,4101,2050,0,1,2052,161238
168,2050,3200,700,2240000,2,16406,4103,1,81880000,81880000,6151,2050,4101,2050,0,1,2052,159564
168,2050,3200,700,2240000,2,16406,4103,1,81880000,81880000,6151,2050,4101,2050,0,1,2052,161939
168,2050,3200,700,2240000,2,16406,4103,1,81880000,81880000,6151,2050,4101,2050,0,1,2052,177761
168,2050,3200,700,2240000,2,16406,4103,1,81880000,81880000,6151,2050,4101,2050,0,1,2052,178492

168,2450,3200,700,2240000,2,19606,4903,1,94360000,94360000,7351,2450,4901,2450,0,1,2452,1411492
168,2450,3200,700,2240000,2,19606,4903,1,94360000,94360000,7351,2450,4901,2450,0,1,2452,187021
168,2450,3200,700,2240000,2,19606,4903,1,94360000,94360000,7351,2450,4901,2450,0,1,2452,189131
168,2450,3200,700,2240000,2,19606,4903,1,94360000,94360000,7351,2450,4901,2450,0,1,2452,188316
168,2450,3200,700,2240000,2,19606,4903,1,94360000,94360000,7351,2450,4901,2450,0,1,2452,186179
168,2450,3200,700,2240000,2,19606,4903,1,94360000,94360000,7351,2450,4901,2450,0,1,2452,207141
168,2450,3200,700,2240000,2,19606,4903,1,94360000,94360000,7351,2450,4901,2450,0,1,2452,205226

168,2850,3200,700,2240000,2,22806,5703,1,106840000,106840000,8551,2850,5701,2850,0,1,2852,1604367
168,2850,3200,700,2240000,2,22806,5703,1,106840000,106840000,8551,2850,5701,2850,0,1,2852,216985
168,2850,3200,700,2240000,2,22806,5703,1,106840000,106840000,8551,2850,5701,2850,0,1,2852,218653
168,2850,3200,700,2240000,2,22806,5703,1,106840000,106840000,8551,2850,5701,2850,0,1,2852,219136
168,2850,3200,700,2240000,2,22806,5703,1,106840000,106840000,8551,2850,5701,2850,0,1,2852,217664
168,2850,3200,700,2240000,2,22806,5703,1,106840000,106840000,8551,2850,5701,2850,0,1,2852,220643
168,2850,3200,700,2240000,2,22806,5703,1,106840000,106840000,8551,2850,5701,2850,0,1,2852,221212

168,3250,3200,700,2240000,2,26006,6503,1,119320000,119320000,9751,3250,6501,3250,0,1,3252,1876870
168,3250,3200,700,2240000,2,26006,6503,1,119320000,119320000,9751,3250,6501,3250,0,1,3252,252977
168,3250,3200,700,2240000,2,26006,6503,1,119320000,119320000,9751,3250,6501,3250,0,1,3252,245800
168,3250,3200,700,2240000,2,26006,6503,1,119320000,119320000,9751,3250,6501,3250,0,1,3252,252400
168,3250,3200,700,2240000,2,26006,6503,1,119320000,119320000,9751,3250,6501,3250,0,1,3252,253741
168,3250,3200,700,2240000,2,26006,6503,1,119320000,119320000,9751,3250,6501,3250,0,1,3252,249773
168,3250,3200,700,2240000,2,26006,6503,1,119320000,119320000,9751,3250,6501,3250,0,1,3252,249189

168,3650,3200,700,2240000,2,29206,7303,1,131800000,131800000,10951,3650,7301,3650,0,1,3652,2074175
168,3650,3200,700,2240000,2,29206,7303,1,131800000,131800000,10951,3650,7301,3650,0,1,3652,275427
168,3650,3200,700,2240000,2,29206,7303,1,131800000,131800000,10951,3650,7301,3650,0,1,3652,276837
168,3650,3200,700,2240000,2,29206,7303,1,131800000,131800000,10951,3650,7301,3650,0,1,3652,277927
168,3650,3200,700,2240000,2,29206,7303,1,131800000,131800000,10951,3650,7301,3650,0,1,3652,279083
168,3650,3200,700,2240000,2,29206,7303,1,131800000,131800000,10951,3650,7301,3650,0,1,3652,279747
168,3650,3200,700,2240000,2,29206,7303,1,131800000,131800000,10951,3650,7301,3650,0,1,3652,280374

168,4050,3200,700,2240000,2,32406,8103,1,144280000,144280000,12151,4050,8101,4050,0,1,4052,2373689
168,4050,3200,700,2240000,2,32406,8103,1,144280000,144280000,12151,4050,8101,4050,0,1,4052,286569
168,4050,3200,700,2240000,2,32406,8103,1,144280000,144280000,12151,4050,8101,4050,0,1,4052,287353
168,4050,3200,700,2240000,2,32406,8103,1,144280000,144280000,12151,4050,8101,4050,0,1,4052,285786
168,4050,3200,700,2240000,2,32406,8103,1,144280000,144280000,12151,4050,8101,4050,0,1,4052,287968
168,4050,3200,700,2240000,2,32406,8103,1,144280000,144280000,12151,4050,8101,4050,0,1,4052,314986
168,4050,3200,700,2240000,2,32406,8103,1,144280000,144280000,12151,4050,8101,4050,0,1,4052,315636

168,4450,3200,700,2240000,2,35606,8903,1,156760000,156760000,13351,4450,8901,4450,0,1,4452,2634245
168,4450,3200,700,2240000,2,35606,8903,1,156760000,156760000,13351,4450,8901,4450,0,1,4452,334246
168,4450,3200,700,2240000,2,35606,8903,1,156760000,156760000,13351,4450,8901,4450,0,1,4452,339431
168,4450,3200,700,2240000,2,35606,8903,1,156760000,156760000,13351,4450,8901,4450,0,1,4452,338497
168,4450,3200,700,2240000,2,35606,8903,1,156760000,156760000,13351,4450,8901,4450,0,1,4452,335121
168,4450,3200,700,2240000,2,35606,8903,1,156760000,156760000,13351,4450,8901,4450,0,1,4452,372874
168,4450,3200,700,2240000,2,35606,8903,1,156760000,156760000,13351,4450,8901,4450,0,1,4452,374747

168,4850,3200,700,2240000,2,38806,9703,1,169240000,169240000,14551,4850,9701,4850,0,1,4852,2848140
168,4850,3200,700,2240000,2,38806,9703,1,169240000,169240000,14551,4850,9701,4850,0,1,4852,340924
168,4850,3200,700,2240000,2,38806,9703,1,169240000,169240000,14551,4850,9701,4850,0,1,4852,344709
168,4850,3200,700,2240000,2,38806,9703,1,169240000,169240000,14551,4850,9701,4850,0,1,4852,343790
168,4850,3200,700,2240000,2,38806,9703,1,169240000,169240000,14551,4850,9701,4850,0,1,4852,339862
168,4850,3200,700,2240000,2,38806,9703,1,169240000,169240000,14551,4850,9701,4850,0,1,4852,379784
168,4850,3200,700,2240000,2,38806,9703,1,169240000,169240000,14551,4850,9701,4850,0,1,4852,382719

168,5250,3200,700,2240000,2,42006,10503,1,181720000,181720000,15751,5250,10501,5250,0,1,5252,3132569
168,5250,3200,700,2240000,2,42006,10503,1,181720000,181720000,15751,5250,10501,5250,0,1,5252,365797
168,5250,3200,700,2240000,2,42006,10503,1,181720000,181720000,15751,5250,10501,5250,0,1,5252,364840
168,5250,3200,700,2240000,2,42006,10503,1,181720000,181720000,15751,5250,10501,5250,0,1,5252,366975
168,5250,3200,700,2240000,2,42006,10503,1,181720000,181720000,15751,5250,10501,5250,0,1,5252,364105
168,5250,3200,700,2240000,2,42006,10503,1,181720000,181720000,15751,5250,10501,5250,0,1,5252,404554
168,5250,3200,700,2240000,2,42006,10503,1,181720000,181720000,15751,5250,10501,5250,0,1,5252,405288

168,5650,3200,700,2240000,2,45206,11303,1,194200000,194200000,16951,5650,11301,5650,0,1,5652,3466365
168,5650,3200,700,2240000,2,45206,11303,1,194200000,194200000,16951,5650,11301,5650,0,1,5652,383843
168,5650,3200,700,2240000,2,45206,11303,1,194200000,194200000,16951,5650,11301,5650,0,1,5652,385319
168,5650,3200,700,2240000,2,45206,11303,1,194200000,194200000,16951,5650,11301,5650,0,1,5652,384603
168,5650,3200,700,2240000,2,45206,11303,1,194200000,194200000,16951,5650,11301,5650,0,1,5652,386096
168,5650,3200,700,2240000,2,45206,11303,1,194200000,194200000,16951,5650,11301,5650,0,1,5652,440862
168,5650,3200,700,2240000,2,45206,11303,1,194200000,194200000,16951,5650,11301,5650,0,1,5652,441604

168,6050,3200,700,2240000,2,48406,12103,1,206680000,206680000,18151,6050,12101,6050,0,1,6052,3820575
168,6050,3200,700,2240000,2,48406,12103,1,206680000,206680000,18151,6050,12101,6050,0,1,6052,427105
168,6050,3200,700,2240000,2,48406,12103,1,206680000,206680000,18151,6050,12101,6050,0,1,6052,428142
168,6050,3200,700,2240000,2,48406,12103,1,206680000,206680000,18151,6050,12101,6050,0,1,6052,424721
168,6050,3200,700,2240000,2,48406,12103,1,206680000,206680000,18151,6050,12101,6050,0,1,6052,425983
168,6050,3200,700,2240000,2,48406,12103,1,206680000,206680000,18151,6050,12101,6050,0,1,6052,490896
168,6050,3200,700,2240000,2,48406,12103,1,206680000,206680000,18151,6050,12101,6050,0,1,6052,490136

168,6450,3200,700,2240000,2,51606,12903,1,219160000,219160000,19351,6450,12901,6450,0,1,6452,3938227
168,6450,3200,700,2240000,2,51606,12903,1,219160000,219160000,19351,6450,12901,6450,0,1,6452,433886
168,6450,3200,700,2240000,2,51606,12903,1,219160000,219160000,19351,6450,12901,6450,0,1,6452,438377
168,6450,3200,700,2240000,2,51606,12903,1,219160000,219160000,19351,6450,12901,6450,0,1,6452,437358
168,6450,3200,700,2240000,2,51606,12903,1,219160000,219160000,19351,6450,12901,6450,0,1,6452,439243
168,6450,3200,700,2240000,2,51606,12903,1,219160000,219160000,19351,6450,12901,6450,0,1,6452,502558
168,6450,3200,700,2240000,2,51606,12903,1,219160000,219160000,19351,6450,12901,6450,0,1,6452,504117

168,6850,3200,700,2240000,2,54806,13703,1,231640000,231640000,20551,6850,13701,6850,0,1,6852,4223942
168,6850,3200,700,2240000,2,54806,13703,1,231640000,231640000,20551,6850,13701,6850,0,1,6852,460248
168,6850,3200,700,2240000,2,54806,13703,1,231640000,231640000,20551,6850,13701,6850,0,1,6852,465044
168,6850,3200,700,2240000,2,54806,13703,1,231640000,231640000,20551,6850,13701,6850,0,1,6852,463089
168,6850,3200,700,2240000,2,54806,13703,1,231640000,231640000,20551,6850,13701,6850,0,1,6852,464121
168,6850,3200,700,2240000,2,54806,13703,1,231640000,231640000,20551,6850,13701,6850,0,1,6852,530742
168,6850,3200,700,2240000,2,54806,13703,1,231640000,231640000,20551,6850,13701,6850,0,1,6852,531760

168,50,3200,300,960000,2,406,103,1,9080000,9080000,151,50,101,50,0,1,52,10486
168,50,3200,300,960000,2,406,103,1,9080000,9080000,151,50,101,50,0,1,52,20165
168,50,3200,300,960000,2,406,103,1,9080000,9080000,151,50,101,50,0,1,52,17075
168,50,3200,300,960000,2,406,103,1,9080000,9080000,151,50,101,50,0,1,52,17729
168,50,3200,300,960000,2,406,103,1,9080000,9080000,151,50,101,50,0,1,52,14722
168,50,3200,300,960000,2,406,103,1,9080000,9080000,151,50,101,50,0,1,52,21536
168,50,3200,300,960000,2,406,103,1,9080000,9080000,151,50,101,50,0,1,52,20867

168,450,3200,300,960000,2,3606,903,1,20280000,20280000,1351,450,901,450,0,1,452,94653
168,450,3200,300,960000,2,3606,903,1,20280000,20280000,1351,450,901,450,0,1,452,37266
168,450,3200,300,960000,2,3606,903,1,20280000,20280000,1351,450,901,450,0,1,452,34909
168,450,3200,300,960000,2,3606,903,1,20280000,20280000,1351,450,901,450,0,1,452,35857
168,450,3200,300,960000,2,3606,903,1,20280000,20280000,1351,450,901,450,0,1,452,36226
168,450,3200,300,960000,2,3606,903,1,20280000,20280000,1351,450,901,450,0,1,452,40539
168,450,3200,300,960000,2,3606,903,1,20280000,20280000,1351,450,901,450,0,1,452,40006

168,850,3200,300,960000,2,6806,1703,1,31480000,31480000,2551,850,1701,850,0,1,852,194168
168,850,3200,300,960000,2,6806,1703,1,31480000,31480000,2551,850,1701,850,0,1,852,49148
168,850,3200,300,960000,2,6806,1703,1,31480000,31480000,2551,850,1701,850,0,1,852,47544
168,850,3200,300,960000,2,6806,1703,1,31480000,31480000,2551,850,1701,850,0,1,852,48342
168,850,3200,300,960000,2,6806,1703,1,31480000,31480000,2551,850,1701,850,0,1,852,49692
168,850,3200,300,960000,2,6806,1703,1,31480000,31480000,2551,850,1701,850,0,1,852,57233
168,850,3200,300,960000,2,6806,1703,1,31480000,31480000,2551,850,1701,850,0,1,852,57805

168,1250,3200,300,960000,2,10006,2503,1,42680000,42680000,3751,1250,2501,1250,0,1,1252,289817
168,1250,3200,300,960000,2,10006,2503,1,42680000,42680000,3751,1250,2501,1250,0,1,1252,69043
168,1250,3200,300,960000,2,10006,2503,1,42680000,42680000,3751,1250,2501,1250,0,1,1252,68382
168,1250,3200,300,960000,2,10006,2503,1,42680000,42680000,3751,1250,2501,1250,0,1,1252,70668
168,1250,3200,300,960000,2,10006,2503,1,42680000,42680000,3751,1250,2501,1250,0,1,1252,70086
168,1250,3200,300,960000,2,10006,2503,1,42680000,42680000,3751,1250,2501,1250,0,1,1252,77467
168,1250,3200,300,960000,2,10006,2503,1,42680000,42680000,3751,1250,2501,1250,0,1,1252,78092

168,1650,3200,300,960000,2,13206,3303,1,53880000,53880000,4951,1650,3301,1650,0,1,1652,381145
168,1650,3200,300,960000,2,13206,3303,1,53880000,53880000,4951,1650,3301,1650,0,1,1652,84286
168,1650,3200,300,960000,2,13206,3303,1,53880000,53880000,4951,1650,3301,1650,0,1,1652,82525
168,1650,3200,300,960000,2,13206,3303,1,53880000,53880000,4951,1650,3301,1650,0,1,1652,83400
168,1650,3200,300,960000,2,13206,3303,1,53880000,53880000,4951,1650,3301,1650,0,1,1652,84935
168,1650,3200,300,960000,2,13206,3303,1,53880000,53880000,4951,1650,3301,1650,0,1,1652,94147
168,1650,3200,300,960000,2,13206,3303,1,53880000,53880000,4951,1650,3301,1650,0,1,1652,93443

168,2050,3200,300,960000,2,16406,4103,1,65080000,65080000,6151,2050,4101,2050,0,1,2052,478189
168,2050,3200,300,960000,2,16406,4103,1,65080000,65080000,6151,2050,4101,2050,0,1,2052,92162
168,2050,3200,300,960000,2,16406,4103,1,65080000,65080000,6151,2050,4101,2050,0,1,2052,94485
168,2050,3200,300,960000,2,16406,4103,1,65080000,65080000,6151,2050,4101,2050,0,1,2052,93483
168,2050,3200,300,960000,2,16406,4103,1,65080000,65080000,6151,2050,4101,2050,0,1,2052,94074
168,2050,3200,300,960000,2,16406,4103,1,65080000,65080000,6151,2050,4101,2050,0,1,2052,132447
168,2050,3200,300,960000,2,16406,4103,1,65080000,65080000,6151,2050,4101,2050,0,1,2052,131592

168,2450,3200,300,960000,2,19606,4903,1,76280000,76280000,7351,2450,4901,2450,0,1,2452,568819
168,2450,3200,300,960000,2,19606,4903,1,76280000,76280000,7351,2450,4901,2450,0,1,2452,109866
168,2450,3200,300,960000,2,19606,4903,1,76280000,76280000,7351,2450,4901,2450,0,1,2452,110499
168,2450,3200,300,960000,2,19606,4903,1,76280000,76280000,7351,2450,4901,2450,0,1,2452,109190
168,2450,3200,300,960000,2,19606,4903,1,76280000,76280000,7351,2450,4901,2450,0,1,2452,110946
168,2450,3200,300,960000,2,19606,4903,1,76280000,76280000,7351,2450,4901,2450,0,1,2452,149596
168,2450,3200,300,960000,2,19606,4903,1,76280000,76280000,7351,2450,4901,2450,0,1,2452,150478

168,2850,3200,300,960000,2,22806,5703,1,87480000,87480000,8551,2850,5701,2850,0,1,2852,663869
168,2850,3200,300,960000,2,22806,5703,1,87480000,87480000,8551,2850,5701,2850,0,1,2852,124212
168,2850,3200,300,960000,2,22806,5703,1,87480000,87480000,8551,2850,5701,2850,0,1,2852,122836
168,2850,3200,300,960000,2,22806,5703,1,87480000,87480000,8551,2850,5701,2850,0,1,2852,124702
168,2850,3200,300,960000,2,22806,5703,1,87480000,87480000,8551,2850,5701,2850,0,1,2852,123550
168,2850,3200,300,960000,2,22806,5703,1,87480000,87480000,8551,2850,5701,2850,0,1,2852,169628
168,2850,3200,300,960000,2,22806,5703,1,87480000,87480000,8551,2850,5701,2850,0,1,2852,170534

168,3250,3200,300,960000,2,26006,6503,1,98680000,98680000,9751,3250,6501,3250,0,1,3252,786213
168,3250,3200,300,960000,2,26006,6503,1,98680000,98680000,9751,3250,6501,3250,0,1,3252,139372
168,3250,3200,300,960000,2,26006,6503,1,98680000,98680000,9751,3250,6501,3250,0,1,3252,140618
168,3250,3200,300,960000,2,26006,6503,1,98680000,98680000,9751,3250,6501,3250,0,1,3252,138621
168,3250,3200,300,960000,2,26006,6503,1,98680000,98680000,9751,3250,6501,3250,0,1,3252,140071
168,3250,3200,300,960000,2,26006,6503,1,98680000,98680000,9751,3250,6501,3250,0,1,3252,183257
168,3250,3200,300,960000,2,26006,6503,1,98680000,98680000,9751,3250,6501,3250,0,1,3252,184249

168,3650,3200,300,960000,2,29206,7303,1,109880000,109880000,10951,3650,7301,3650,0,1,3652,880501
168,3650,3200,300,960000,2,29206,7303,1,109880000,109880000,10951,3650,7301,3650,0,1,3652,158019
168,3650,3200,300,960000,2,29206,7303,1,109880000,109880000,10951,3650,7301,3650,0,1,3652,157405
168,3650,3200,300,960000,2,29206,7303,1,109880000,109880000,10951,3650,7301,3650,0,1,3652,156608
168,3650,3200,300,960000,2,29206,7303,1,109880000,109880000,10951,3650,7301,3650,0,1,3652,155823
168,3650,3200,300,960000,2,29206,7303,1,109880000,109880000,10951,3650,7301,3650,0,1,3652,200927
168,3650,3200,300,960000,2,29206,7303,1,109880000,109880000,10951,3650,7301,3650,0,1,3652,200278

168,4050,3200,300,960000,2,32406,8103,1,121080000,121080000,12151,4050,8101,4050,0,1,4052,991816
168,4050,3200,300,960000,2,32406,8103,1,121080000,121080000,12151,4050,8101,4050,0,1,4052,170973
168,4050,3200,300,960000,2,32406,8103,1,121080000,121080000,12151,4050,8101,4050,0,1,4052,171783
168,4050,3200,300,960000,2,32406,8103,1,121080000,121080000,12151,4050,8101,4050,0,1,4052,173196
168,4050,3200,300,960000,2,32406,8103,1,121080000,121080000,12151,4050,8101,4050,0,1,4052,172560
168,4050,3200,300,960000,2,32406,8103,1,121080000,121080000,12151,4050,8101,4050,0,1,4052,211725
168,4050,3200,300,960000,2,32406,8103,1,121080000,121080000,12151,4050,8101,4050,0,1,4052,211044

168,4450,3200,300,960000,2,35606,8903,1,132280000,132280000,13351,4450,8901,4450,0,1,4452,1071840
168,4450,3200,300,960000,2,35606,8903,1,132280000,132280000,13351,4450,8901,4450,0,1,4452,192104
168,4450,3200,300,960000,2,35606,8903,1,132280000,132280000,13351,4450,8901,4450,0,1,4452,191262
168,4450,3200,300,960000,2,35606,8903,1,132280000,132280000,13351,4450,8901,4450,0,1,4452,192790
168,4450,3200,300,960000,2,35606,8903,1,132280000,132280000,13351,4450,8901,4450,0,1,4452,190433
168,4450,3200,300,960000,2,35606,8903,1,132280000,132280000,13351,4450,8901,4450,0,1,4452,222828
168,4450,3200,300,960000,2,35606,8903,1,132280000,132280000,13351,4450,8901,4450,0,1,4452,222139

168,4850,3200,300,960000,2,38806,9703,1,143480000,143480000,14551,4850,9701,4850,0,1,4852,1212221
168,4850,3200,300,960000,2,38806,9703,1,143480000,143480000,14551,4850,9701,4850,0,1,4852,202658
168,4850,3200,300,960000,2,38806,9703,1,143480000,143480000,14551,4850,9701,4850,0,1,4852,201092
168,4850,3200,300,960000,2,38806,9703,1,143480000,143480000,14551,4850,9701,4850,0,1,4852,204589
168,4850,3200,300,960000,2,38806,9703,1,143480000,143480000,14551,4850,9701,4850,0,1,4852,203649
168,4850,3200,300,960000,2,38806,9703,1,143480000,143480000,14551,4850,9701,4850,0,1,4852,234881
168,4850,3200,300,960000,2,38806,9703,1,143480000,143480000,14551,4850,9701,4850,0,1,4852,235622

168,5250,3200,300,960000,2,42006,10503,1,154680000,154680000,15751,5250,10501,5250,0,1,5252,1289171
168,5250,3200,300,960000,2,42006,10503,1,154680000,154680000,15751,5250,10501,5250,0,1,5252,219688
168,5250,3200,300,960000,2,42006,10503,1,154680000,154680000,15751,5250,10501,5250,0,1,5252,218885
168,5250,3200,300,960000,2,42006,10503,1,154680000,154680000,15751,5250,10501,5250,0,1,5252,220675
168,5250,3200,300,960000,2,42006,10503,1,154680000,154680000,15751,5250,10501,5250,0,1,5252,217615
168,5250,3200,300,960000,2,42006,10503,1,154680000,154680000,15751,5250,10501,5250,0,1,5252,251652
168,5250,3200,300,960000,2,42006,10503,1,154680000,154680000,15751,5250,10501,5250,0,1,5252,250890

168,5650,3200,300,960000,2,45206,11303,1,165880000,165880000,16951,5650,11301,5650,0,1,5652,1341455
168,5650,3200,300,960000,2,45206,11303,1,165880000,165880000,16951,5650,11301,5650,0,1,5652,231797
168,5650,3200,300,960000,2,45206,11303,1,165880000,165880000,16951,5650,11301,5650,0,1,5652,228337
168,5650,3200,300,960000,2,45206,11303,1,165880000,165880000,16951,5650,11301,5650,0,1,5652,230100
168,5650,3200,300,960000,2,45206,11303,1,165880000,165880000,16951,5650,11301,5650,0,1,5652,231019
168,5650,3200,300,960000,2,45206,11303,1,165880000,165880000,16951,5650,11301,5650,0,1,5652,278565
168,5650,3200,300,960000,2,45206,11303,1,165880000,165880000,16951,5650,11301,5650,0,1,5652,277780

168,6050,3200,300,960000,2,48406,12103,1,177080000,177080000,18151,6050,12101,6050,0,1,6052,1485532
168,6050,3200,300,960000,2,48406,12103,1,177080000,177080000,18151,6050,12101,6050,0,1,6052,245776
168,6050,3200,300,960000,2,48406,12103,1,177080000,177080000,18151,6050,12101,6050,0,1,6052,241907
168,6050,3200,300,960000,2,48406,12103,1,177080000,177080000,18151,6050,12101,6050,0,1,6052,243582
168,6050,3200,300,960000,2,48406,12103,1,177080000,177080000,18151,6050,12101,6050,0,1,6052,244691
168,6050,3200,300,960000,2,48406,12103,1,177080000,177080000,18151,6050,12101,6050,0,1,6052,289167
168,6050,3200,300,960000,2,48406,12103,1,177080000,177080000,18151,6050,12101,6050,0,1,6052,288338

168,6450,3200,300,960000,2,51606,12903,1,188280000,188280000,19351,6450,12901,6450,0,1,6452,1578021
168,6450,3200,300,960000,2,51606,12903,1,188280000,188280000,19351,6450,12901,6450,0,1,6452,255725
168,6450,3200,300,960000,2,51606,12903,1,188280000,188280000,19351,6450,12901,6450,0,1,6452,256951
168,6450,3200,300,960000,2,51606,12903,1,188280000,188280000,19351,6450,12901,6450,0,1,6452,259355
168,6450,3200,300,960000,2,51606,12903,1,188280000,188280000,19351,6450,12901,6450,0,1,6452,258242
168,6450,3200,300,960000,2,51606,12903,1,188280000,188280000,19351,6450,12901,6450,0,1,6452,318112
168,6450,3200,300,960000,2,51606,12903,1,188280000,188280000,19351,6450,12901,6450,0,1,6452,318957

168,6850,3200,300,960000,2,54806,13703,1,199480000,199480000,20551,6850,13701,6850,0,1,6852,1622304
168,6850,3200,300,960000,2,54806,13703,1,199480000,199480000,20551,6850,13701,6850,0,1,6852,275404
168,6850,3200,300,960000,2,54806,13703,1,199480000,199480000,20551,6850,13701,6850,0,1,6852,273463
168,6850,3200,300,960000,2,54806,13703,1,199480000,199480000,20551,6850,13701,6850,0,1,6852,274499
168,6850,3200,300,960000,2,54806,13703,1,199480000,199480000,20551,6850,13701,6850,0,1,6852,272482
168,6850,3200,300,960000,2,54806,13703,1,199480000,199480000,20551,6850,13701,6850,0,1,6852,345238
168,6850,3200,300,960000,2,54806,13703,1,199480000,199480000,20551,6850,13701,6850,0,1,6852,344362

168,50,2800,5100,14280000,2,406,103,1,117400000,117400000,151,50,101,50,0,1,52,165480
168,50,2800,5100,14280000,2,406,103,1,117400000,117400000,151,50,101,50,0,1,52,147689
168,50,2800,5100,14280000,2,406,103,1,117400000,117400000,151,50,101,50,0,1,52,147237
168,50,2800,5100,14280000,2,406,103,1,117400000,117400000,151,50,101,50,0,1,52,134156
168,50,2800,5100,14280000,2,406,103,1,117400000,117400000,151,50,101,50,0,1,52,143180
168,50,2800,5100,14280000,2,406,103,1,117400000,117400000,151,50,101,50,0,1,52,184999
168,50,2800,5100,14280000,2,406,103,1,117400000,117400000,151,50,101,50,0,1,52,184527

168,450,2800,5100,14280000,2,3606,903,1,142680000,142680000,1351,450,901,450,0,1,452,1548269
168,450,2800,5100,14280000,2,3606,903,1,142680000,142680000,1351,450,901,450,0,1,452,274140
168,450,2800,5100,14280000,2,3606,903,1,142680000,142680000,1351,450,901,450,0,1,452,277175
168,450,2800,5100,14280000,2,3606,903,1,142680000,142680000,1351,450,901,450,0,1,452,277565
168,450,2800,5100,14280000,2,3606,903,1,142680000,142680000,1351,450,901,450,0,1,452,276356
168,450,2800,5100,14280000,2,3606,903,1,142680000,142680000,1351,450,901,450,0,1,452,282123
168,450,2800,5100,14280000,2,3606,903,1,142680000,142680000,1351,450,901,450,0,1,452,282520

168,850,2800,5100,14280000,2,6806,1703,1,167960000,167960000,2551,850,1701,850,0,1,852,3153810
168,850,2800,5100,14280000,2,6806,1703,1,167960000,167960000,2551,850,1701,850,0,1,852,448514
168,850,2800,5100,14280000,2,6806,1703,1,167960000,167960000,2551,850,1701,850,0,1,852,437904
168,850,2800,5100,14280000,2,6806,1703,1,167960000,167960000,2551,850,1701,850,0,1,852,436840
168,850,2800,5100,14280000,2,6806,1703,1,167960000,167960000,2551,850,1701,850,0,1,852,449500
168,850,2800,5100,14280000,2,6806,1703,1,167960000,167960000,2551,850,1701,850,0,1,852,449773
168,850,2800,5100,14280000,2,6806,1703,1,167960000,167960000,2551,850,1701,850,0,1,852,450206

168,1250,2800,5100,14280000,2,10006,2503,1,193240000,193240000,3751,1250,2501,1250,0,1,1252,4948403
168,1250,2800,5100,14280000,2,10006,2503,1,193240000,193240000,3751,1250,2501,1250,0,1,1252,541117
168,1250,2800,5100,14280000,2,10006,2503,1,193240000,193240000,3751,1250,2501,1250,0,1,1252,542602
168,1250,2800,5100,14280000,2,10006,2503,1,193240000,193240000,3751,1250,2501,1250,0,1,1252,543702
168,1250,2800,5100,14280000,2,10006,2503,1,193240000,193240000,3751,1250,2501,1250,0,1,1252,543409
168,1250,2800,5100,14280000,2,10006,2503,1,193240000,193240000,3751,1250,2501,1250,0,1,1252,545628
168,1250,2800,5100,14280000,2,10006,2503,1,193240000,193240000,3751,1250,2501,1250,0,1,1252,546076

168,1650,2800,5100,14280000,2,13206,3303,1,218520000,218520000,4951,1650,3301,1650,0,1,1652,6866580
168,1650,2800,5100,14280000,2,13206,3303,1,218520000,218520000,4951,1650,3301,1650,0,1,1652,640527
168,1650,2800,5100,14280000,2,13206,3303,1,218520000,218520000,4951,1650,3301,1650,0,1,1652,638749
168,1650,2800,5100,14280000,2,13206,3303,1,218520000,218520000,4951,1650,3301,1650,0,1,1652,641465
168,1650,2800,5100,14280000,2,13206,3303,1,218520000,218520000,4951,1650,3301,1650,0,1,1652,641124
168,1650,2800,5100,14280000,2,13206,3303,1,218520000,218520000,4951,1650,3301,1650,0,1,1652,675830
168,1650,2800,5100,14280000,2,13206,3303,1,218520000,218520000,4951,1650,3301,1650,0,1,1652,676297

168,2050,2800,5100,14280000,2,16406,4103,1,243800000,243800000,6151,2050,4101,2050,0,1,2052,8608460
168,2050,2800,5100,14280000,2,16406,4103,1,243800000,243800000,6151,2050,4101,2050,0,1,2052,765036
168,2050,2800,5100,14280000,2,16406,4103,1,243800000,243800000,6151,2050,4101,2050,0,1,2052,762764
168,2050,2800,5100,14280000,2,16406,4103,1,243800000,243800000,6151,2050,4101,2050,0,1,2052,767067
168,2050,2800,5100,14280000,2,16406,4103,1,243800000,243800000,6151,2050,4101,2050,0,1,2052,765932
168,2050,2800,5100,14280000,2,16406,4103,1,243800000,243800000,6151,2050,4101,2050,0,1,2052,788951
168,2050,2800,5100,14280000,2,16406,4103,1,243800000,243800000,6151,2050,4101,2050,0,1,2052,789441

168,2450,2800,5100,14280000,2,19606,4903,1,269080000,269080000,7351,2450,4901,2450,0,1,2452,10094422
168,2450,2800,5100,14280000,2,19606,4903,1,269080000,269080000,7351,2450,4901,2450,0,1,2452,875532
168,2450,2800,5100,14280000,2,19606,4903,1,269080000,269080000,7351,2450,4901,2450,0,1,2452,868693
168,2450,2800,5100,14280000,2,19606,4903,1,269080000,269080000,7351,2450,4901,2450,0,1,2452,898575
168,2450,2800,5100,14280000,2,19606,4903,1,269080000,269080000,7351,2450,4901,2450,0,1,2452,874810
168,2450,2800,5100,14280000,2,19606,4903,1,269080000,269080000,7351,2450,4901,2450,0,1,2452,937707
168,2450,2800,5100,14280000,2,19606,4903,1,269080000,269080000,7351,2450,4901,2450,0,1,2452,938228

168,2850,2800,5100,14280000,2,22806,5703,1,294360000,294360000,8551,2850,5701,2850,0,1,2852,11616721
168,2850,2800,5100,14280000,2,22806,5703,1,294360000,294360000,8551,2850,5701,2850,0,1,2852,1064295
168,2850,2800,5100,14280000,2,22806,5703,1,294360000,294360000,8551,2850,5701,2850,0,1,2852,1075972
168,2850,2800,5100,14280000,2,22806,5703,1,294360000,294360000,8551,2850,5701,2850,0,1,2852,1074633
168,2850,2800,5100,14280000,2,22806,5703,1,294360000,294360000,8551,2850,5701,2850,0,1,2852,1068923
168,2850,2800,5100,14280000,2,22806,5703,1,294360000,294360000,8551,2850,5701,2850,0,1,2852,1087919
168,2850,2800,5100,14280000,2,22806,5703,1,294360000,294360000,8551,2850,5701,2850,0,1,2852,1089354

168,3250,2800,5100,14280000,2,26006,6503,1,319640000,319640000,9751,3250,6501,3250,0,1,3252,13665573
168,3250,2800,5100,14280000,2,26006,6503,1,319640000,319640000,9751,3250,6501,3250,0,1,3252,1165089
168,3250,2800,5100,14280000,2,26006,6503,1,319640000,319640000,9751,3250,6501,3250,0,1,3252,1157203
168,3250,2800,5100,14280000,2,26006,6503,1,319640000,319640000,9751,3250,6501,3250,0,1,3252,1166165
168,3250,2800,5100,14280000,2,26006,6503,1,319640000,319640000,9751,3250,6501,3250,0,1,3252,1163741
168,3250,2800,5100,14280000,2,26006,6503,1,319640000,319640000,9751,3250,6501,3250,0,1,3252,1180777
168,3250,2800,5100,14280000,2,26006,6503,1,319640000,319640000,9751,3250,6501,3250,0,1,3252,1181346

168,3650,2800,5100,14280000,2,29206,7303,1,344920000,344920000,10951,3650,7301,3650,0,1,3652,15395537
168,3650,2800,5100,14280000,2,29206,7303,1,344920000,344920000,10951,3650,7301,3650,0,1,3652,1295481
168,3650,2800,5100,14280000,2,29206,7303,1,344920000,344920000,10951,3650,7301,3650,0,1,3652,1298892
168,3650,2800,5100,14280000,2,29206,7303,1,344920000,344920000,10951,3650,7301,3650,0,1,3652,1301464
168,3650,2800,5100,14280000,2,29206,7303,1,344920000,344920000,10951,3650,7301,3650,0,1,3652,1299906
168,3650,2800,5100,14280000,2,29206,7303,1,344920000,344920000,10951,3650,7301,3650,0,1,3652,1314936
168,3650,2800,5100,14280000,2,29206,7303,1,344920000,344920000,10951,3650,7301,3650,0,1,3652,1314347

168,4050,2800,5100,14280000,2,32406,8103,1,370200000,370200000,12151,4050,8101,4050,0,1,4052,16917852
168,4050,2800,5100,14280000,2,32406,8103,1,370200000,370200000,12151,4050,8101,4050,0,1,4052,1484922
168,4050,2800,5100,14280000,2,32406,8103,1,370200000,370200000,12151,4050,8101,4050,0,1,4052,1465117
168,4050,2800,5100,14280000,2,32406,8103,1,370200000,370200000,12151,4050,8101,4050,0,1,4052,1477481
168,4050,2800,5100,14280000,2,32406,8103,1,370200000,370200000,12151,4050,8101,4050,0,1,4052,1371787
168,4050,2800,5100,14280000,2,32406,8103,1,370200000,370200000,12151,4050,8101,4050,0,1,4052,1488399
168,4050,2800,5100,14280000,2,32406,8103,1,370200000,370200000,12151,4050,8101,4050,0,1,4052,1489176

168,4450,2800,5100,14280000,2,35606,8903,1,395480000,395480000,13351,4450,8901,4450,0,1,4452,18949693
168,4450,2800,5100,14280000,2,35606,8903,1,395480000,395480000,13351,4450,8901,4450,0,1,4452,1545875
168,4450,2800,5100,14280000,2,35606,8903,1,395480000,395480000,13351,4450,8901,4450,0,1,4452,1547592
168,4450,2800,5100,14280000,2,35606,8903,1,395480000,395480000,13351,4450,8901,4450,0,1,4452,1550488
168,4450,2800,5100,14280000,2,35606,8903,1,395480000,395480000,13351,4450,8901,4450,0,1,4452,1549178
168,4450,2800,5100,14280000,2,35606,8903,1,395480000,395480000,13351,4450,8901,4450,0,1,4452,1554354
168,4450,2800,5100,14280000,2,35606,8903,1,395480000,395480000,13351,4450,8901,4450,0,1,4452,1554998

168,4850,2800,5100,14280000,2,38806,9703,1,420760000,420760000,14551,4850,9701,4850,0,1,4852,20487840
168,4850,2800,5100,14280000,2,38806,9703,1,420760000,420760000,14551,4850,9701,4850,0,1,4852,1735901
168,4850,2800,5100,14280000,2,38806,9703,1,420760000,420760000,14551,4850,9701,4850,0,1,4852,1723959
168,4850,2800,5100,14280000,2,38806,9703,1,420760000,420760000,14551,4850,9701,4850,0,1,4852,1742271
168,4850,2800,5100,14280000,2,38806,9703,1,420760000,420760000,14551,4850,9701,4850,0,1,4852,1739043
168,4850,2800,5100,14280000,2,38806,9703,1,420760000,420760000,14551,4850,9701,4850,0,1,4852,1741395
168,4850,2800,5100,14280000,2,38806,9703,1,420760000,420760000,14551,4850,9701,4850,0,1,4852,1740791

168,5250,2800,5100,14280000,2,42006,10503,1,446040000,446040000,15751,5250,10501,5250,0,1,5252,21393335
168,5250,2800,5100,14280000,2,42006,10503,1,446040000,446040000,15751,5250,10501,5250,0,1,5252,1837778
168,5250,2800,5100,14280000,2,42006,10503,1,446040000,446040000,15751,5250,10501,5250,0,1,5252,1832664
168,5250,2800,5100,14280000,2,42006,10503,1,446040000,446040000,15751,5250,10501,5250,0,1,5252,1839657
168,5250,2800,5100,14280000,2,42006,10503,1,446040000,446040000,15751,5250,10501,5250,0,1,5252,1838727
168,5250,2800,5100,14280000,2,42006,10503,1,446040000,446040000,15751,5250,10501,5250,0,1,5252,1836427
168,5250,2800,5100,14280000,2,42006,10503,1,446040000,446040000,15751,5250,10501,5250,0,1,5252,1834665

168,5650,2800,5100,14280000,2,45206,11303,1,471320000,471320000,16951,5650,11301,5650,0,1,5652,24228965
168,5650,2800,5100,14280000,2,45206,11303,1,471320000,471320000,16951,5650,11301,5650,0,1,5652,2069170
168,5650,2800,5100,14280000,2,45206,11303,1,471320000,471320000,16951,5650,11301,5650,0,1,5652,2061155
168,5650,2800,5100,14280000,2,45206,11303,1,471320000,471320000,16951,5650,11301,5650,0,1,5652,2073380
168,5650,2800,5100,14280000,2,45206,11303,1,471320000,471320000,16951,5650,11301,5650,0,1,5652,2070617
168,5650,2800,5100,14280000,2,45206,11303,1,471320000,471320000,16951,5650,11301,5650,0,1,5652,2011310
168,5650,2800,5100,14280000,2,45206,11303,1,471320000,471320000,16951,5650,11301,5650,0,1,5652,2018523

168,6050,2800,5100,14280000,2,48406,12103,1,496600000,496600000,18151,6050,12101,6050,0,1,6052,25954159
168,6050,2800,5100,14280000,2,48406,12103,1,496600000,496600000,18151,6050,12101,6050,0,1,6052,2079864
168,6050,2800,5100,14280000,2,48406,12103,1,496600000,496600000,18151,6050,12101,6050,0,1,6052,2078999
168,6050,2800,5100,14280000,2,48406,12103,1,496600000,496600000,18151,6050,12101,6050,0,1,6052,2080631
168,6050,2800,5100,14280000,2,48406,12103,1,496600000,496600000,18151,6050,12101,6050,0,1,6052,2078136
168,6050,2800,5100,14280000,2,48406,12103,1,496600000,496600000,18151,6050,12101,6050,0,1,6052,2071288
168,6050,2800,5100,14280000,2,48406,12103,1,496600000,496600000,18151,6050,12101,6050,0,1,6052,2069856

168,6450,2800,5100,14280000,2,51606,12903,1,521880000,521880000,19351,6450,12901,6450,0,1,6452,27281602
168,6450,2800,5100,14280000,2,51606,12903,1,521880000,521880000,19351,6450,12901,6450,0,1,6452,2267462
168,6450,2800,5100,14280000,2,51606,12903,1,521880000,521880000,19351,6450,12901,6450,0,1,6452,2274530
168,6450,2800,5100,14280000,2,51606,12903,1,521880000,521880000,19351,6450,12901,6450,0,1,6452,2275563
168,6450,2800,5100,14280000,2,51606,12903,1,521880000,521880000,19351,6450,12901,6450,0,1,6452,2273478
168,6450,2800,5100,14280000,2,51606,12903,1,521880000,521880000,19351,6450,12901,6450,0,1,6452,2262284
168,6450,2800,5100,14280000,2,51606,12903,1,521880000,521880000,19351,6450,12901,6450,0,1,6452,2263803

168,6850,2800,5100,14280000,2,54806,13703,1,547160000,547160000,20551,6850,13701,6850,0,1,6852,28434071
168,6850,2800,5100,14280000,2,54806,13703,1,547160000,547160000,20551,6850,13701,6850,0,1,6852,2409004
168,6850,2800,5100,14280000,2,54806,13703,1,547160000,547160000,20551,6850,13701,6850,0,1,6852,2416752
168,6850,2800,5100,14280000,2,54806,13703,1,547160000,547160000,20551,6850,13701,6850,0,1,6852,2419633
168,6850,2800,5100,14280000,2,54806,13703,1,547160000,547160000,20551,6850,13701,6850,0,1,6852,2413056
168,6850,2800,5100,14280000,2,54806,13703,1,547160000,547160000,20551,6850,13701,6850,0,1,6852,2388825
168,6850,2800,5100,14280000,2,54806,13703,1,547160000,547160000,20551,6850,13701,6850,0,1,6852,2390962

168,50,2800,4700,13160000,2,406,103,1,108280000,108280000,151,50,101,50,0,1,52,148597
168,50,2800,4700,13160000,2,406,103,1,108280000,108280000,151,50,101,50,0,1,52,131210
168,50,2800,4700,13160000,2,406,103,1,108280000,108280000,151,50,101,50,0,1,52,126156
168,50,2800,4700,13160000,2,406,103,1,108280000,108280000,151,50,101,50,0,1,52,129362
168,50,2800,4700,13160000,2,406,103,1,108280000,108280000,151,50,101,50,0,1,52,130756
168,50,2800,4700,13160000,2,406,103,1,108280000,108280000,151,50,101,50,0,1,52,165551
168,50,2800,4700,13160000,2,406,103,1,108280000,108280000,151,50,101,50,0,1,52,165075

168,450,2800,4700,13160000,2,3606,903,1,132280000,132280000,1351,450,901,450,0,1,452,1396945
168,450,2800,4700,13160000,2,3606,903,1,132280000,132280000,1351,450,901,450,0,1,452,254531
168,450,2800,4700,13160000,2,3606,903,1,132280000,132280000,1351,450,901,450,0,1,452,252186
168,450,2800,4700,13160000,2,3606,903,1,132280000,132280000,1351,450,901,450,0,1,452,253773
168,450,2800,4700,13160000,2,3606,903,1,132280000,132280000,1351,450,901,450,0,1,452,254882
168,450,2800,4700,13160000,2,3606,903,1,132280000,132280000,1351,450,901,450,0,1,452,258594
168,450,2800,4700,13160000,2,3606,903,1,132280000,132280000,1351,450,901,450,0,1,452,258988

168,850,2800,4700,13160000,2,6806,1703,1,156280000,156280000,2551,850,1701,850,0,1,852,2882827
168,850,2800,4700,13160000,2,6806,1703,1,156280000,156280000,2551,850,1701,850,0,1,852,371896
168,850,2800,4700,13160000,2,6806,1703,1,156280000,156280000,2551,850,1701,850,0,1,852,374384
168,850,2800,4700,13160000,2,6806,1703,1,156280000,156280000,2551,850,1701,850,0,1,852,372940
168,850,2800,4700,13160000,2,6806,1703,1,156280000,156280000,2551,850,1701,850,0,1,852,373873
168,850,2800,4700,13160000,2,6806,1703,1,156280000,156280000,2551,850,1701,850,0,1,852,377473
168,850,2800,4700,13160000,2,6806,1703,1,156280000,156280000,2551,850,1701,850,0,1,852,377899

168,1250,2800,4700,13160000,2,10006,2503,1,180280000,180280000,3751,1250,2501,1250,0,1,1252,4533672
168,1250,2800,4700,13160000,2,10006,2503,1,180280000,180280000,3751,1250,2501,1250,0,1,1252,472619
168,1250,2800,4700,13160000,2,10006,2503,1,180280000,180280000,3751,1250,2501,1250,0,1,1252,473287
168,1250,2800,4700,13160000,2,10006,2503,1,180280000,180280000,3751,1250,2501,1250,0,1,1252,471980
168,1250,2800,4700,13160000,2,10006,2503,1,180280000,180280000,3751,1250,2501,1250,0,1,1252,470642
168,1250,2800,4700,13160000,2,10006,2503,1,180280000,180280000,3751,1250,2501,1250,0,1,1252,500956
168,1250,2800,4700,13160000,2,10006,2503,1,180280000,180280000,3751,1250,2501,1250,0,1,1252,501401

168,1650,2800,4700,13160000,2,13206,3303,1,204280000,204280000,4951,1650,3301,1650,0,1,1652,5915660
168,1650,2800,4700,13160000,2,13206,3303,1,204280000,204280000,4951,1650,3301,1650,0,1,1652,615605
168,1650,2800,4700,13160000,2,13206,3303,1,204280000,204280000,4951,1650,3301,1650,0,1,1652,618619
168,1650,2800,4700,13160000,2,13206,3303,1,204280000,204280000,4951,1650,3301,1650,0,1,1652,617087
168,1650,2800,4700,13160000,2,13206,3303,1,204280000,204280000,4951,1650,3301,1650,0,1,1652,618289
168,1650,2800,4700,13160000,2,13206,3303,1,204280000,204280000,4951,1650,3301,1650,0,1,1652,620871
168,1650,2800,4700,13160000,2,13206,3303,1,204280000,204280000,4951,1650,3301,1650,0,1,1652,620399

168,2050,2800,4700,13160000,2,16406,4103,1,228280000,228280000,6151,2050,4101,2050,0,1,2052,7770982
168,2050,2800,4700,13160000,2,16406,4103,1,228280000,228280000,6151,2050,4101,2050,0,1,2052,701537
168,2050,2800,4700,13160000,2,16406,4103,1,228280000,228280000,6151,2050,4101,2050,0,1,2052,702736
168,2050,2800,4700,13160000,2,16406,4103,1,228280000,228280000,6151,2050,4101,2050,0,1,2052,704054
168,2050,2800,4700,13160000,2,16406,4103,1,228280000,228280000,6151,2050,4101,2050,0,1,2052,702397
168,2050,2800,4700,13160000,2,16406,4103,1,228280000,228280000,6151,2050,4101,2050,0,1,2052,738511
168,2050,2800,4700,13160000,2,16406,4103,1,228280000,228280000,6151,2050,4101,2050,0,1,2052,739000

168,2450,2800,4700,13160000,2,19606,4903,1,252280000,252280000,7351,2450,4901,2450,0,1,2452,8941716
168,2450,2800,4700,13160000,2,19606,4903,1,252280000,252280000,7351,2450,4901,2450,0,1,2452,816336
168,2450,2800,4700,13160000,2,19606,4903,1,252280000,252280000,7351,2450,4901,2450,0,1,2452,814991
168,2450,2800,4700,13160000,2,19606,4903,1,252280000,252280000,7351,2450,4901,2450,0,1,2452,817210
168,2450,2800,4700,13160000,2,19606,4903,1,252280000,252280000,7351,2450,4901,2450,0,1,2452,817864
168,2450,2800,4700,13160000,2,19606,4903,1,252280000,252280000,7351,2450,4901,2450,0,1,2452,876940
168,2450,2800,4700,13160000,2,19606,4903,1,252280000,252280000,7351,2450,4901,2450,0,1,2452,877458

168,2850,2800,4700,13160000,2,22806,5703,1,276280000,276280000,8551,2850,5701,2850,0,1,2852,10595763
168,2850,2800,4700,13160000,2,22806,5703,1,276280000,276280000,8551,2850,5701,2850,0,1,2852,984840
168,2850,2800,4700,13160000,2,22806,5703,1,276280000,276280000,8551,2850,5701,2850,0,1,2852,989505
168,2850,2800,4700,13160000,2,22806,5703,1,276280000,276280000,8551,2850,5701,2850,0,1,2852,988176
168,2850,2800,4700,13160000,2,22806,5703,1,276280000,276280000,8551,2850,5701,2850,0,1,2852,978067
168,2850,2800,4700,13160000,2,22806,5703,1,276280000,276280000,8551,2850,5701,2850,0,1,2852,1008004
168,2850,2800,4700,13160000,2,22806,5703,1,276280000,276280000,8551,2850,5701,2850,0,1,2852,1008550

168,3250,2800,4700,13160000,2,26006,6503,1,300280000,300280000,9751,3250,6501,3250,0,1,3252,12242232
168,3250,2800,4700,13160000,2,26006,6503,1,300280000,300280000,9751,3250,6501,3250,0,1,3252,1070991
168,3250,2800,4700,13160000,2,26006,6503,1,300280000,300280000,9751,3250,6501,3250,0,1,3252,1075714
168,3250,2800,4700,13160000,2,26006,6503,1,300280000,300280000,9751,3250,6501,3250,0,1,3252,1078965
168,3250,2800,4700,13160000,2,26006,6503,1,300280000,300280000,9751,3250,6501,3250,0,1,3252,1077421
168,3250,2800,4700,13160000,2,26006,6503,1,300280000,300280000,9751,3250,6501,3250,0,1,3252,1101826
168,3250,2800,4700,13160000,2,26006,6503,1,300280000,300280000,9751,3250,6501,3250,0,1,3252,1102384

168,3650,2800,4700,13160000,2,29206,7303,1,324280000,324280000,10951,3650,7301,3650,0,1,3652,13971544
168,3650,2800,4700,13160000,2,29206,7303,1,324280000,324280000,10951,3650,7301,3650,0,1,3652,1178534
168,3650,2800,4700,13160000,2,29206,7303,1,324280000,324280000,10951,3650,7301,3650,0,1,3652,1177190
168,3650,2800,4700,13160000,2,29206,7303,1,324280000,324280000,10951,3650,7301,3650,0,1,3652,1184905
168,3650,2800,4700,13160000,2,29206,7303,1,324280000,324280000,10951,3650,7301,3650,0,1,3652,1183429
168,3650,2800,4700,13160000,2,29206,7303,1,324280000,324280000,10951,3650,7301,3650,0,1,3652,1211127
168,3650,2800,4700,13160000,2,29206,7303,1,324280000,324280000,10951,3650,7301,3650,0,1,3652,1211721

168,4050,2800,4700,13160000,2,32406,8103,1,348280000,348280000,12151,4050,8101,4050,0,1,4052,15941863
168,4050,2800,4700,13160000,2,32406,8103,1,348280000,348280000,12151,4050,8101,4050,0,1,4052,1379100
168,4050,2800,4700,13160000,2,32406,8103,1,348280000,348280000,12151,4050,8101,4050,0,1,4052,1365198
168,4050,2800,4700,13160000,2,32406,8103,1,348280000,348280000,12151,4050,8101,4050,0,1,4052,1386556
168,4050,2800,4700,13160000,2,32406,8103,1,348280000,348280000,12151,4050,8101,4050,0,1,4052,1385399
168,4050,2800,4700,13160000,2,32406,8103,1,348280000,348280000,12151,4050,8101,4050,0,1,4052,1389538
168,4050,2800,4700,13160000,2,32406,8103,1,348280000,348280000,12151,4050,8101,4050,0,1,4052,1390162

168,4450,2800,4700,13160000,2,35606,8903,1,372280000,372280000,13351,4450,8901,4450,0,1,4452,18320286
168,4450,2800,4700,13160000,2,35606,8903,1,372280000,372280000,13351,4450,8901,4450,0,1,4452,1440661
168,4450,2800,4700,13160000,2,35606,8903,1,372280000,372280000,13351,4450,8901,4450,0,1,4452,1442157
168,4450,2800,4700,13160000,2,35606,8903,1,372280000,372280000,13351,4450,8901,4450,0,1,4452,1443358
168,4450,2800,4700,13160000,2,35606,8903,1,372280000,372280000,13351,4450,8901,4450,0,1,4452,1433022
168,4450,2800,4700,13160000,2,35606,8903,1,372280000,372280000,13351,4450,8901,4450,0,1,4452,1452902
168,4450,2800,4700,13160000,2,35606,8903,1,372280000,372280000,13351,4450,8901,4450,0,1,4452,1452247

168,4850,2800,4700,13160000,2,38806,9703,1,396280000,396280000,14551,4850,9701,4850,0,1,4852,19607101
168,4850,2800,4700,13160000,2,38806,9703,1,396280000,396280000,14551,4850,9701,4850,0,1,4852,1614933
168,4850,2800,4700,13160000,2,38806,9703,1,396280000,396280000,14551,4850,9701,4850,0,1,4852,1608517
168,4850,2800,4700,13160000,2,38806,9703,1,396280000,396280000,14551,4850,9701,4850,0,1,4852,1607117
168,4850,2800,4700,13160000,2,38806,9703,1,396280000,396280000,14551,4850,9701,4850,0,1,4852,1616079
168,4850,2800,4700,13160000,2,38806,9703,1,396280000,396280000,14551,4850,9701,4850,0,1,4852,1615443
168,4850,2800,4700,13160000,2,38806,9703,1,396280000,396280000,14551,4850,9701,4850,0,1,4852,1616542

168,5250,2800,4700,13160000,2,42006,10503,1,420280000,420280000,15751,5250,10501,5250,0,1,5252,20964555
168,5250,2800,4700,13160000,2,42006,10503,1,420280000,420280000,15751,5250,10501,5250,0,1,5252,1691392
168,5250,2800,4700,13160000,2,42006,10503,1,420280000,420280000,15751,5250,10501,5250,0,1,5252,1698059
168,5250,2800,4700,13160000,2,42006,10503,1,420280000,420280000,15751,5250,10501,5250,0,1,5252,1699468
168,5250,2800,4700,13160000,2,42006,10503,1,420280000,420280000,15751,5250,10501,5250,0,1,5252,1698667
168,5250,2800,4700,13160000,2,42006,10503,1,420280000,420280000,15751,5250,10501,5250,0,1,5252,1700096
168,5250,2800,4700,13160000,2,42006,10503,1,420280000,420280000,15751,5250,10501,5250,0,1,5252,1700800

168,5650,2800,4700,13160000,2,45206,11303,1,444280000,444280000,16951,5650,11301,5650,0,1,5652,21506451
168,5650,2800,4700,13160000,2,45206,11303,1,444280000,444280000,16951,5650,11301,5650,0,1,5652,1827196
168,5650,2800,4700,13160000,2,45206,11303,1,444280000,444280000,16951,5650,11301,5650,0,1,5652,1838432
168,5650,2800,4700,13160000,2,45206,11303,1,444280000,444280000,16951,5650,11301,5650,0,1,5652,1837461
168,5650,2800,4700,13160000,2,45206,11303,1,444280000,444280000,16951,5650,11301,5650,0,1,5652,1819904
168,5650,2800,4700,13160000,2,45206,11303,1,444280000,444280000,16951,5650,11301,5650,0,1,5652,1834676
168,5650,2800,4700,13160000,2,45206,11303,1,444280000,444280000,16951,5650,11301,5650,0,1,5652,1836689

168,6050,2800,4700,13160000,2,48406,12103,1,468280000,468280000,18151,6050,12101,6050,0,1,6052,23760334
168,6050,2800,4700,13160000,2,48406,12103,1,468280000,468280000,18151,6050,12101,6050,0,1,6052,1939008
168,6050,2800,4700,13160000,2,48406,12103,1,468280000,468280000,18151,6050,12101,6050,0,1,6052,1936641
168,6050,2800,4700,13160000,2,48406,12103,1,468280000,468280000,18151,6050,12101,6050,0,1,6052,1940834
168,6050,2800,4700,13160000,2,48406,12103,1,468280000,468280000,18151,6050,12101,6050,0,1,6052,1939823
168,6050,2800,4700,13160000,2,48406,12103,1,468280000,468280000,18151,6050,12101,6050,0,1,6052,1938281
168,6050,2800,4700,13160000,2,48406,12103,1,468280000,468280000,18151,6050,12101,6050,0,1,6052,1935090

168,6450,2800,4700,13160000,2,51606,12903,1,492280000,492280000,19351,6450,12901,6450,0,1,6452,25462204
168,6450,2800,4700,13160000,2,51606,12903,1,492280000,492280000,19351,6450,12901,6450,0,1,6452,2152231
168,6450,2800,4700,13160000,2,51606,12903,1,492280000,492280000,19351,6450,12901,6450,0,1,6452,2153460
168,6450,2800,4700,13160000,2,51606,12903,1,492280000,492280000,19351,6450,12901,6450,0,1,6452,2156802
168,6450,2800,4700,13160000,2,51606,12903,1,492280000,492280000,19351,6450,12901,6450,0,1,6452,2154374
168,6450,2800,4700,13160000,2,51606,12903,1,492280000,492280000,19351,6450,12901,6450,0,1,6452,2115337
168,6450,2800,4700,13160000,2,51606,12903,1,492280000,492280000,19351,6450,12901,6450,0,1,6452,2119680

168,6850,2800,4700,13160000,2,54806,13703,1,516280000,516280000,20551,6850,13701,6850,0,1,6852,26888596
168,6850,2800,4700,13160000,2,54806,13703,1,516280000,516280000,20551,6850,13701,6850,0,1,6852,2169815
168,6850,2800,4700,13160000,2,54806,13703,1,516280000,516280000,20551,6850,13701,6850,0,1,6852,2168565
168,6850,2800,4700,13160000,2,54806,13703,1,516280000,516280000,20551,6850,13701,6850,0,1,6852,2173140
168,6850,2800,4700,13160000,2,54806,13703,1,516280000,516280000,20551,6850,13701,6850,0,1,6852,2171885
168,6850,2800,4700,13160000,2,54806,13703,1,516280000,516280000,20551,6850,13701,6850,0,1,6852,2159542
168,6850,2800,4700,13160000,2,54806,13703,1,516280000,516280000,20551,6850,13701,6850,0,1,6852,2157956

168,50,2800,4300,12040000,2,406,103,1,99160000,99160000,151,50,101,50,0,1,52,136067
168,50,2800,4300,12040000,2,406,103,1,99160000,99160000,151,50,101,50,0,1,52,122899
168,50,2800,4300,12040000,2,406,103,1,99160000,99160000,151,50,101,50,0,1,52,113028
168,50,2800,4300,12040000,2,406,103,1,99160000,99160000,151,50,101,50,0,1,52,122290
168,50,2800,4300,12040000,2,406,103,1,99160000,99160000,151,50,101,50,0,1,52,123537
168,50,2800,4300,12040000,2,406,103,1,99160000,99160000,151,50,101,50,0,1,52,153033
168,50,2800,4300,12040000,2,406,103,1,99160000,99160000,151,50,101,50,0,1,52,153497

168,450,2800,4300,12040000,2,3606,903,1,121880000,121880000,1351,450,901,450,0,1,452,1299256
168,450,2800,4300,12040000,2,3606,903,1,121880000,121880000,1351,450,901,450,0,1,452,229885
168,450,2800,4300,12040000,2,3606,903,1,121880000,121880000,1351,450,901,450,0,1,452,229532
168,450,2800,4300,12040000,2,3606,903,1,121880000,121880000,1351,450,901,450,0,1,452,227773
168,450,2800,4300,12040000,2,3606,903,1,121880000,121880000,1351,450,901,450,0,1,452,228769
168,450,2800,4300,12040000,2,3606,903,1,121880000,121880000,1351,450,901,450,0,1,452,233718
168,450,2800,4300,12040000,2,3606,903,1,121880000,121880000,1351,450,901,450,0,1,452,234135

168,850,2800,4300,12040000,2,6806,1703,1,144600000,144600000,2551,850,1701,850,0,1,852,2598928
168,850,2800,4300,12040000,2,6806,1703,1,144600000,144600000,2551,850,1701,850,0,1,852,374828
168,850,2800,4300,12040000,2,6806,1703,1,144600000,144600000,2551,850,1701,850,0,1,852,367238
168,850,2800,4300,12040000,2,6806,1703,1,144600000,144600000,2551,850,1701,850,0,1,852,350515
168,850,2800,4300,12040000,2,6806,1703,1,144600000,144600000,2551,850,1701,850,0,1,852,373503
168,850,2800,4300,12040000,2,6806,1703,1,144600000,144600000,2551,850,1701,850,0,1,852,375930
168,850,2800,4300,12040000,2,6806,1703,1,144600000,144600000,2551,850,1701,850,0,1,852,376362

168,1250,2800,4300,12040000,2,10006,2503,1,167320000,167320000,3751,1250,2501,1250,0,1,1252,4222012
168,1250,2800,4300,12040000,2,10006,2503,1,167320000,167320000,3751,1250,2501,1250,0,1,1252,464839
168,1250,2800,4300,12040000,2,10006,2503,1,167320000,167320000,3751,1250,2501,1250,0,1,1252,463637
168,1250,2800,4300,12040000,2,10006,2503,1,167320000,167320000,3751,1250,2501,1250,0,1,1252,460964
168,1250,2800,4300,12040000,2,10006,2503,1,167320000,167320000,3751,1250,2501,1250,0,1,1252,465313
168,1250,2800,4300,12040000,2,10006,2503,1,167320000,167320000,3751,1250,2501,1250,0,1,1252,466312
168,1250,2800,4300,12040000,2,10006,2503,1,167320000,167320000,3751,1250,2501,1250,0,1,1252,466761

168,1650,2800,4300,12040000,2,13206,3303,1,190040000,190040000,4951,1650,3301,1650,0,1,1652,5511432
168,1650,2800,4300,12040000,2,13206,3303,1,190040000,190040000,4951,1650,3301,1650,0,1,1652,580650
168,1650,2800,4300,12040000,2,13206,3303,1,190040000,190040000,4951,1650,3301,1650,0,1,1652,579081
168,1650,2800,4300,12040000,2,13206,3303,1,190040000,190040000,4951,1650,3301,1650,0,1,1652,581259
168,1650,2800,4300,12040000,2,13206,3303,1,190040000,190040000,4951,1650,3301,1650,0,1,1652,576690
168,1650,2800,4300,12040000,2,13206,3303,1,190040000,190040000,4951,1650,3301,1650,0,1,1652,581886
168,1650,2800,4300,12040000,2,13206,3303,1,190040000,190040000,4951,1650,3301,1650,0,1,1652,581627

168,2050,2800,4300,12040000,2,16406,4103,1,212760000,212760000,6151,2050,4101,2050,0,1,2052,7021049
168,2050,2800,4300,12040000,2,16406,4103,1,212760000,212760000,6151,2050,4101,2050,0,1,2052,687934
168,2050,2800,4300,12040000,2,16406,4103,1,212760000,212760000,6151,2050,4101,2050,0,1,2052,686230
168,2050,2800,4300,12040000,2,16406,4103,1,212760000,212760000,6151,2050,4101,2050,0,1,2052,687576
168,2050,2800,4300,12040000,2,16406,4103,1,212760000,212760000,6151,2050,4101,2050,0,1,2052,686969
168,2050,2800,4300,12040000,2,16406,4103,1,212760000,212760000,6151,2050,4101,2050,0,1,2052,688527
168,2050,2800,4300,12040000,2,16406,4103,1,212760000,212760000,6151,2050,4101,2050,0,1,2052,689021

168,2450,2800,4300,12040000,2,19606,4903,1,235480000,235480000,7351,2450,4901,2450,0,1,2452,8297614
168,2450,2800,4300,12040000,2,19606,4903,1,235480000,235480000,7351,2450,4901,2450,0,1,2452,775643
168,2450,2800,4300,12040000,2,19606,4903,1,235480000,235480000,7351,2450,4901,2450,0,1,2452,772101
168,2450,2800,4300,12040000,2,19606,4903,1,235480000,235480000,7351,2450,4901,2450,0,1,2452,776790
168,2450,2800,4300,12040000,2,19606,4903,1,235480000,235480000,7351,2450,4901,2450,0,1,2452,774664
168,2450,2800,4300,12040000,2,19606,4903,1,235480000,235480000,7351,2450,4901,2450,0,1,2452,787343
168,2450,2800,4300,12040000,2,19606,4903,1,235480000,235480000,7351,2450,4901,2450,0,1,2452,786824

168,2850,2800,4300,12040000,2,22806,5703,1,258200000,258200000,8551,2850,5701,2850,0,1,2852,9803795
168,2850,2800,4300,12040000,2,22806,5703,1,258200000,258200000,8551,2850,5701,2850,0,1,2852,878058
168,2850,2800,4300,12040000,2,22806,5703,1,258200000,258200000,8551,2850,5701,2850,0,1,2852,875958
168,2850,2800,4300,12040000,2,22806,5703,1,258200000,258200000,8551,2850,5701,2850,0,1,2852,879354
168,2850,2800,4300,12040000,2,22806,5703,1,258200000,258200000,8551,2850,5701,2850,0,1,2852,880325
168,2850,2800,4300,12040000,2,22806,5703,1,258200000,258200000,8551,2850,5701,2850,0,1,2852,897098
168,2850,2800,4300,12040000,2,22806,5703,1,258200000,258200000,8551,2850,5701,2850,0,1,2852,897640

168,3250,2800,4300,12040000,2,26006,6503,1,280920000,280920000,9751,3250,6501,3250,0,1,3252,11445178
168,3250,2800,4300,12040000,2,26006,6503,1,280920000,280920000,9751,3250,6501,3250,0,1,3252,1057976
168,3250,2800,4300,12040000,2,26006,6503,1,280920000,280920000,9751,3250,6501,3250,0,1,3252,1039140
168,3250,2800,4300,12040000,2,26006,6503,1,280920000,280920000,9751,3250,6501,3250,0,1,3252,1062685
168,3250,2800,4300,12040000,2,26006,6503,1,280920000,280920000,9751,3250,6501,3250,0,1,3252,1059299
168,3250,2800,4300,12040000,2,26006,6503,1,280920000,280920000,9751,3250,6501,3250,0,1,3252,1072371
168,3250,2800,4300,12040000,2,26006,6503,1,280920000,280920000,9751,3250,6501,3250,0,1,3252,1071805

168,3650,2800,4300,12040000,2,29206,7303,1,303640000,303640000,10951,3650,7301,3650,0,1,3652,12826023
168,3650,2800,4300,12040000,2,29206,7303,1,303640000,303640000,10951,3650,7301,3650,0,1,3652,1078422
168,3650,2800,4300,12040000,2,29206,7303,1,303640000,303640000,10951,3650,7301,3650,0,1,3652,1081400
168,3650,2800,4300,12040000,2,29206,7303,1,303640000,303640000,10951,3650,7301,3650,0,1,3652,1084197
168,3650,2800,4300,12040000,2,29206,7303,1,303640000,303640000,10951,3650,7301,3650,0,1,3652,1082663
168,3650,2800,4300,12040000,2,29206,7303,1,303640000,303640000,10951,3650,7301,3650,0,1,3652,1123331
168,3650,2800,4300,12040000,2,29206,7303,1,303640000,303640000,10951,3650,7301,3650,0,1,3652,1122726

168,4050,2800,4300,12040000,2,32406,8103,1,326360000,326360000,12151,4050,8101,4050,0,1,4052,15022223
168,4050,2800,4300,12040000,2,32406,8103,1,326360000,326360000,12151,4050,8101,4050,0,1,4052,1224177
168,4050,2800,4300,12040000,2,32406,8103,1,326360000,326360000,12151,4050,8101,4050,0,1,4052,1225846
168,4050,2800,4300,12040000,2,32406,8103,1,326360000,326360000,12151,4050,8101,4050,0,1,4052,1219013
168,4050,2800,4300,12040000,2,32406,8103,1,326360000,326360000,12151,4050,8101,4050,0,1,4052,1175801
168,4050,2800,4300,12040000,2,32406,8103,1,326360000,326360000,12151,4050,8101,4050,0,1,4052,1233578
168,4050,2800,4300,12040000,2,32406,8103,1,326360000,326360000,12151,4050,8101,4050,0,1,4052,1232958

168,4450,2800,4300,12040000,2,35606,8903,1,349080000,349080000,13351,4450,8901,4450,0,1,4452,16102434
168,4450,2800,4300,12040000,2,35606,8903,1,349080000,349080000,13351,4450,8901,4450,0,1,4452,1355562
168,4450,2800,4300,12040000,2,35606,8903,1,349080000,349080000,13351,4450,8901,4450,0,1,4452,1326600
168,4450,2800,4300,12040000,2,35606,8903,1,349080000,349080000,13351,4450,8901,4450,0,1,4452,1357692
168,4450,2800,4300,12040000,2,35606,8903,1,349080000,349080000,13351,4450,8901,4450,0,1,4452,1352511
168,4450,2800,4300,12040000,2,35606,8903,1,349080000,349080000,13351,4450,8901,4450,0,1,4452,1368632
168,4450,2800,4300,12040000,2,35606,8903,1,349080000,349080000,13351,4450,8901,4450,0,1,4452,1369289

168,4850,2800,4300,12040000,2,38806,9703,1,371800000,371800000,14551,4850,9701,4850,0,1,4852,17077162
168,4850,2800,4300,12040000,2,38806,9703,1,371800000,371800000,14551,4850,9701,4850,0,1,4852,1430970
168,4850,2800,4300,12040000,2,38806,9703,1,371800000,371800000,14551,4850,9701,4850,0,1,4852,1432669
168,4850,2800,4300,12040000,2,38806,9703,1,371800000,371800000,14551,4850,9701,4850,0,1,4852,1434058
168,4850,2800,4300,12040000,2,38806,9703,1,371800000,371800000,14551,4850,9701,4850,0,1,4852,1426771
168,4850,2800,4300,12040000,2,38806,9703,1,371800000,371800000,14551,4850,9701,4850,0,1,4852,1440879
168,4850,2800,4300,12040000,2,38806,9703,1,371800000,371800000,14551,4850,9701,4850,0,1,4852,1441532

168,5250,2800,4300,12040000,2,42006,10503,1,394520000,394520000,15751,5250,10501,5250,0,1,5252,19660321
168,5250,2800,4300,12040000,2,42006,10503,1,394520000,394520000,15751,5250,10501,5250,0,1,5252,1581266
168,5250,2800,4300,12040000,2,42006,10503,1,394520000,394520000,15751,5250,10501,5250,0,1,5252,1586852
168,5250,2800,4300,12040000,2,42006,10503,1,394520000,394520000,15751,5250,10501,5250,0,1,5252,1585575
168,5250,2800,4300,12040000,2,42006,10503,1,394520000,394520000,15751,5250,10501,5250,0,1,5252,1578943
168,5250,2800,4300,12040000,2,42006,10503,1,394520000,394520000,15751,5250,10501,5250,0,1,5252,1589428
168,5250,2800,4300,12040000,2,42006,10503,1,394520000,394520000,15751,5250,10501,5250,0,1,5252,1588733

168,5650,2800,4300,12040000,2,45206,11303,1,417240000,417240000,16951,5650,11301,5650,0,1,5652,20387602
168,5650,2800,4300,12040000,2,45206,11303,1,417240000,417240000,16951,5650,11301,5650,0,1,5652,1683797
168,5650,2800,4300,12040000,2,45206,11303,1,417240000,417240000,16951,5650,11301,5650,0,1,5652,1683145
168,5650,2800,4300,12040000,2,45206,11303,1,417240000,417240000,16951,5650,11301,5650,0,1,5652,1685149
168,5650,2800,4300,12040000,2,45206,11303,1,417240000,417240000,16951,5650,11301,5650,0,1,5652,1684427
168,5650,2800,4300,12040000,2,45206,11303,1,417240000,417240000,16951,5650,11301,5650,0,1,5652,1685520
168,5650,2800,4300,12040000,2,45206,11303,1,417240000,417240000,16951,5650,11301,5650,0,1,5652,1686020

168,6050,2800,4300,12040000,2,48406,12103,1,439960000,439960000,18151,6050,12101,6050,0,1,6052,22244030
168,6050,2800,4300,12040000,2,48406,12103,1,439960000,439960000,18151,6050,12101,6050,0,1,6052,1813452
168,6050,2800,4300,12040000,2,48406,12103,1,439960000,439960000,18151,6050,12101,6050,0,1,6052,1809319
168,6050,2800,4300,12040000,2,48406,12103,1,439960000,439960000,18151,6050,12101,6050,0,1,6052,1816592
168,6050,2800,4300,12040000,2,48406,12103,1,439960000,439960000,18151,6050,12101,6050,0,1,6052,1814352
168,6050,2800,4300,12040000,2,48406,12103,1,439960000,439960000,18151,6050,12101,6050,0,1,6052,1801653
168,6050,2800,4300,12040000,2,48406,12103,1,439960000,439960000,18151,6050,12101,6050,0,1,6052,1804343

168,6450,2800,4300,12040000,2,51606,12903,1,462680000,462680000,19351,6450,12901,6450,0,1,6452,23134718
168,6450,2800,4300,12040000,2,51606,12903,1,462680000,462680000,19351,6450,12901,6450,0,1,6452,1900736
168,6450,2800,4300,12040000,2,51606,12903,1,462680000,462680000,19351,6450,12901,6450,0,1,6452,1898876
168,6450,2800,4300,12040000,2,51606,12903,1,462680000,462680000,19351,6450,12901,6450,0,1,6452,1903945
168,6450,2800,4300,12040000,2,51606,12903,1,462680000,462680000,19351,6450,12901,6450,0,1,6452,1902904
168,6450,2800,4300,12040000,2,51606,12903,1,462680000,462680000,19351,6450,12901,6450,0,1,6452,1892297
168,6450,2800,4300,12040000,2,51606,12903,1,462680000,462680000,19351,6450,12901,6450,0,1,6452,1890774

168,6850,2800,4300,12040000,2,54806,13703,1,485400000,485400000,20551,6850,13701,6850,0,1,6852,24717115
168,6850,2800,4300,12040000,2,54806,13703,1,485400000,485400000,20551,6850,13701,6850,0,1,6852,2033651
168,6850,2800,4300,12040000,2,54806,13703,1,485400000,485400000,20551,6850,13701,6850,0,1,6852,2007285
168,6850,2800,4300,12040000,2,54806,13703,1,485400000,485400000,20551,6850,13701,6850,0,1,6852,2036317
168,6850,2800,4300,12040000,2,54806,13703,1,485400000,485400000,20551,6850,13701,6850,0,1,6852,2032581
168,6850,2800,4300,12040000,2,54806,13703,1,485400000,485400000,20551,6850,13701,6850,0,1,6852,2027756
168,6850,2800,4300,12040000,2,54806,13703,1,485400000,485400000,20551,6850,13701,6850,0,1,6852,2025597

168,50,2800,3900,10920000,2,406,103,1,90040000,90040000,151,50,101,50,0,1,52,120535
168,50,2800,3900,10920000,2,406,103,1,90040000,90040000,151,50,101,50,0,1,52,107056
168,50,2800,3900,10920000,2,406,103,1,90040000,90040000,151,50,101,50,0,1,52,109219
168,50,2800,3900,10920000,2,406,103,1,90040000,90040000,151,50,101,50,0,1,52,97955
168,50,2800,3900,10920000,2,406,103,1,90040000,90040000,151,50,101,50,0,1,52,108773
168,50,2800,3900,10920000,2,406,103,1,90040000,90040000,151,50,101,50,0,1,52,136976
168,50,2800,3900,10920000,2,406,103,1,90040000,90040000,151,50,101,50,0,1,52,136500

168,450,2800,3900,10920000,2,3606,903,1,111480000,111480000,1351,450,901,450,0,1,452,1137553
168,450,2800,3900,10920000,2,3606,903,1,111480000,111480000,1351,450,901,450,0,1,452,210860
168,450,2800,3900,10920000,2,3606,903,1,111480000,111480000,1351,450,901,450,0,1,452,213106
168,450,2800,3900,10920000,2,3606,903,1,111480000,111480000,1351,450,901,450,0,1,452,213948
168,450,2800,3900,10920000,2,3606,903,1,111480000,111480000,1351,450,901,450,0,1,452,214234
168,450,2800,3900,10920000,2,3606,903,1,111480000,111480000,1351,450,901,450,0,1,452,218611
168,450,2800,3900,10920000,2,3606,903,1,111480000,111480000,1351,450,901,450,0,1,452,218211

168,850,2800,3900,10920000,2,6806,1703,1,132920000,132920000,2551,850,1701,850,0,1,852,2357807
168,850,2800,3900,10920000,2,6806,1703,1,132920000,132920000,2551,850,1701,850,0,1,852,317701
168,850,2800,3900,10920000,2,6806,1703,1,132920000,132920000,2551,850,1701,850,0,1,852,317185
168,850,2800,3900,10920000,2,6806,1703,1,132920000,132920000,2551,850,1701,850,0,1,852,318130
168,850,2800,3900,10920000,2,6806,1703,1,132920000,132920000,2551,850,1701,850,0,1,852,314811
168,850,2800,3900,10920000,2,6806,1703,1,132920000,132920000,2551,850,1701,850,0,1,852,320204
168,850,2800,3900,10920000,2,6806,1703,1,132920000,132920000,2551,850,1701,850,0,1,852,320630

168,1250,2800,3900,10920000,2,10006,2503,1,154360000,154360000,3751,1250,2501,1250,0,1,1252,3793610
168,1250,2800,3900,10920000,2,10006,2503,1,154360000,154360000,3751,1250,2501,1250,0,1,1252,421611
168,1250,2800,3900,10920000,2,10006,2503,1,154360000,154360000,3751,1250,2501,1250,0,1,1252,419911
168,1250,2800,3900,10920000,2,10006,2503,1,154360000,154360000,3751,1250,2501,1250,0,1,1252,422274
168,1250,2800,3900,10920000,2,10006,2503,1,154360000,154360000,3751,1250,2501,1250,0,1,1252,421879
168,1250,2800,3900,10920000,2,10006,2503,1,154360000,154360000,3751,1250,2501,1250,0,1,1252,423672
168,1250,2800,3900,10920000,2,10006,2503,1,154360000,154360000,3751,1250,2501,1250,0,1,1252,424120

168,1650,2800,3900,10920000,2,13206,3303,1,175800000,175800000,4951,1650,3301,1650,0,1,1652,5154966
168,1650,2800,3900,10920000,2,13206,3303,1,175800000,175800000,4951,1650,3301,1650,0,1,1652,490045
168,1650,2800,3900,10920000,2,13206,3303,1,175800000,175800000,4951,1650,3301,1650,0,1,1652,492575
168,1650,2800,3900,10920000,2,13206,3303,1,175800000,175800000,4951,1650,3301,1650,0,1,1652,492248
168,1650,2800,3900,10920000,2,13206,3303,1,175800000,175800000,4951,1650,3301,1650,0,1,1652,491733
168,1650,2800,3900,10920000,2,13206,3303,1,175800000,175800000,4951,1650,3301,1650,0,1,1652,535153
168,1650,2800,3900,10920000,2,13206,3303,1,175800000,175800000,4951,1650,3301,1650,0,1,1652,535619

168,2050,2800,3900,10920000,2,16406,4103,1,197240000,197240000,6151,2050,4101,2050,0,1,2052,6513739
168,2050,2800,3900,10920000,2,16406,4103,1,197240000,197240000,6151,2050,4101,2050,0,1,2052,631526
168,2050,2800,3900,10920000,2,16406,4103,1,197240000,197240000,6151,2050,4101,2050,0,1,2052,627908
168,2050,2800,3900,10920000,2,16406,4103,1,197240000,197240000,6151,2050,4101,2050,0,1,2052,632268
168,2050,2800,3900,10920000,2,16406,4103,1,197240000,197240000,6151,2050,4101,2050,0,1,2052,630275
168,2050,2800,3900,10920000,2,16406,4103,1,197240000,197240000,6151,2050,4101,2050,0,1,2052,631907
168,2050,2800,3900,10920000,2,16406,4103,1,197240000,197240000,6151,2050,4101,2050,0,1,2052,632547

168,2450,2800,3900,10920000,2,19606,4903,1,218680000,218680000,7351,2450,4901,2450,0,1,2452,7753876
168,2450,2800,3900,10920000,2,19606,4903,1,218680000,218680000,7351,2450,4901,2450,0,1,2452,692567
168,2450,2800,3900,10920000,2,19606,4903,1,218680000,218680000,7351,2450,4901,2450,0,1,2452,695027
168,2450,2800,3900,10920000,2,19606,4903,1,218680000,218680000,7351,2450,4901,2450,0,1,2452,695662
168,2450,2800,3900,10920000,2,19606,4903,1,218680000,218680000,7351,2450,4901,2450,0,1,2452,694305
168,2450,2800,3900,10920000,2,19606,4903,1,218680000,218680000,7351,2450,4901,2450,0,1,2452,736812
168,2450,2800,3900,10920000,2,19606,4903,1,218680000,218680000,7351,2450,4901,2450,0,1,2452,736278

168,2850,2800,3900,10920000,2,22806,5703,1,240120000,240120000,8551,2850,5701,2850,0,1,2852,8485479
168,2850,2800,3900,10920000,2,22806,5703,1,240120000,240120000,8551,2850,5701,2850,0,1,2852,872393
168,2850,2800,3900,10920000,2,22806,5703,1,240120000,240120000,8551,2850,5701,2850,0,1,2852,857334
168,2850,2800,3900,10920000,2,22806,5703,1,240120000,240120000,8551,2850,5701,2850,0,1,2852,874396
168,2850,2800,3900,10920000,2,22806,5703,1,240120000,240120000,8551,2850,5701,2850,0,1,2852,868234
168,2850,2800,3900,10920000,2,22806,5703,1,240120000,240120000,8551,2850,5701,2850,0,1,2852,874769
168,2850,2800,3900,10920000,2,22806,5703,1,240120000,240120000,8551,2850,5701,2850,0,1,2852,875320

168,3250,2800,3900,10920000,2,26006,6503,1,261560000,261560000,9751,3250,6501,3250,0,1,3252,9893505
168,3250,2800,3900,10920000,2,26006,6503,1,261560000,261560000,9751,3250,6501,3250,0,1,3252,892479
168,3250,2800,3900,10920000,2,26006,6503,1,261560000,261560000,9751,3250,6501,3250,0,1,3252,890386
168,3250,2800,3900,10920000,2,26006,6503,1,261560000,261560000,9751,3250,6501,3250,0,1,3252,893967
168,3250,2800,3900,10920000,2,26006,6503,1,261560000,261560000,9751,3250,6501,3250,0,1,3252,893249
168,3250,2800,3900,10920000,2,26006,6503,1,261560000,261560000,9751,3250,6501,3250,0,1,3252,936723
168,3250,2800,3900,10920000,2,26006,6503,1,261560000,261560000,9751,3250,6501,3250,0,1,3252,936156

168,3650,2800,3900,10920000,2,29206,7303,1,283000000,283000000,10951,3650,7301,3650,0,1,3652,11600214
168,3650,2800,3900,10920000,2,29206,7303,1,283000000,283000000,10951,3650,7301,3650,0,1,3652,999540
168,3650,2800,3900,10920000,2,29206,7303,1,283000000,283000000,10951,3650,7301,3650,0,1,3652,1002462
168,3650,2800,3900,10920000,2,29206,7303,1,283000000,283000000,10951,3650,7301,3650,0,1,3652,1005070
168,3650,2800,3900,10920000,2,29206,7303,1,283000000,283000000,10951,3650,7301,3650,0,1,3652,1003608
168,3650,2800,3900,10920000,2,29206,7303,1,283000000,283000000,10951,3650,7301,3650,0,1,3652,1028775
168,3650,2800,3900,10920000,2,29206,7303,1,283000000,283000000,10951,3650,7301,3650,0,1,3652,1029366

168,4050,2800,3900,10920000,2,32406,8103,1,304440000,304440000,12151,4050,8101,4050,0,1,4052,13027837
168,4050,2800,3900,10920000,2,32406,8103,1,304440000,304440000,12151,4050,8101,4050,0,1,4052,1111169
168,4050,2800,3900,10920000,2,32406,8103,1,304440000,304440000,12151,4050,8101,4050,0,1,4052,1112668
168,4050,2800,3900,10920000,2,32406,8103,1,304440000,304440000,12151,4050,8101,4050,0,1,4052,1115236
168,4050,2800,3900,10920000,2,32406,8103,1,304440000,304440000,12151,4050,8101,4050,0,1,4052,1114111
168,4050,2800,3900,10920000,2,32406,8103,1,304440000,304440000,12151,4050,8101,4050,0,1,4052,1127614
168,4050,2800,3900,10920000,2,32406,8103,1,304440000,304440000,12151,4050,8101,4050,0,1,4052,1128232

168,4450,2800,3900,10920000,2,35606,8903,1,325880000,325880000,13351,4450,8901,4450,0,1,4452,14686487
168,4450,2800,3900,10920000,2,35606,8903,1,325880000,325880000,13351,4450,8901,4450,0,1,4452,1241005
168,4450,2800,3900,10920000,2,35606,8903,1,325880000,325880000,13351,4450,8901,4450,0,1,4452,1249717
168,4450,2800,3900,10920000,2,35606,8903,1,325880000,325880000,13351,4450,8901,4450,0,1,4452,1238147
168,4450,2800,3900,10920000,2,35606,8903,1,325880000,325880000,13351,4450,8901,4450,0,1,4452,1251538
168,4450,2800,3900,10920000,2,35606,8903,1,325880000,325880000,13351,4450,8901,4450,0,1,4452,1257138
168,4450,2800,3900,10920000,2,35606,8903,1,325880000,325880000,13351,4450,8901,4450,0,1,4452,1257792

168,4850,2800,3900,10920000,2,38806,9703,1,347320000,347320000,14551,4850,9701,4850,0,1,4852,15644564
168,4850,2800,3900,10920000,2,38806,9703,1,347320000,347320000,14551,4850,9701,4850,0,1,4852,1296296
168,4850,2800,3900,10920000,2,38806,9703,1,347320000,347320000,14551,4850,9701,4850,0,1,4852,1294780
168,4850,2800,3900,10920000,2,38806,9703,1,347320000,347320000,14551,4850,9701,4850,0,1,4852,1297394
168,4850,2800,3900,10920000,2,38806,9703,1,347320000,347320000,14551,4850,9701,4850,0,1,4852,1285318
168,4850,2800,3900,10920000,2,38806,9703,1,347320000,347320000,14551,4850,9701,4850,0,1,4852,1316130
168,4850,2800,3900,10920000,2,38806,9703,1,347320000,347320000,14551,4850,9701,4850,0,1,4852,1315481

168,5250,2800,3900,10920000,2,42006,10503,1,368760000,368760000,15751,5250,10501,5250,0,1,5252,17778983
168,5250,2800,3900,10920000,2,42006,10503,1,368760000,368760000,15751,5250,10501,5250,0,1,5252,1460314
168,5250,2800,3900,10920000,2,42006,10503,1,368760000,368760000,15751,5250,10501,5250,0,1,5252,1467022
168,5250,2800,3900,10920000,2,42006,10503,1,368760000,368760000,15751,5250,10501,5250,0,1,5252,1465762
168,5250,2800,3900,10920000,2,42006,10503,1,368760000,368760000,15751,5250,10501,5250,0,1,5252,1453463
168,5250,2800,3900,10920000,2,42006,10503,1,368760000,368760000,15751,5250,10501,5250,0,1,5252,1469568
168,5250,2800,3900,10920000,2,42006,10503,1,368760000,368760000,15751,5250,10501,5250,0,1,5252,1468882

168,5650,2800,3900,10920000,2,45206,11303,1,390200000,390200000,16951,5650,11301,5650,0,1,5652,19096477
168,5650,2800,3900,10920000,2,45206,11303,1,390200000,390200000,16951,5650,11301,5650,0,1,5652,1502170
168,5650,2800,3900,10920000,2,45206,11303,1,390200000,390200000,16951,5650,11301,5650,0,1,5652,1492400
168,5650,2800,3900,10920000,2,45206,11303,1,390200000,390200000,16951,5650,11301,5650,0,1,5652,1505373
168,5650,2800,3900,10920000,2,45206,11303,1,390200000,390200000,16951,5650,11301,5650,0,1,5652,1503932
168,5650,2800,3900,10920000,2,45206,11303,1,390200000,390200000,16951,5650,11301,5650,0,1,5652,1515591
168,5650,2800,3900,10920000,2,45206,11303,1,390200000,390200000,16951,5650,11301,5650,0,1,5652,1514861

168,6050,2800,3900,10920000,2,48406,12103,1,411640000,411640000,18151,6050,12101,6050,0,1,6052,20209713
168,6050,2800,3900,10920000,2,48406,12103,1,411640000,411640000,18151,6050,12101,6050,0,1,6052,1628415
168,6050,2800,3900,10920000,2,48406,12103,1,411640000,411640000,18151,6050,12101,6050,0,1,6052,1624505
168,6050,2800,3900,10920000,2,48406,12103,1,411640000,411640000,18151,6050,12101,6050,0,1,6052,1630821
168,6050,2800,3900,10920000,2,48406,12103,1,411640000,411640000,18151,6050,12101,6050,0,1,6052,1626532
168,6050,2800,3900,10920000,2,48406,12103,1,411640000,411640000,18151,6050,12101,6050,0,1,6052,1632222
168,6050,2800,3900,10920000,2,48406,12103,1,411640000,411640000,18151,6050,12101,6050,0,1,6052,1631488

168,6450,2800,3900,10920000,2,51606,12903,1,433080000,433080000,19351,6450,12901,6450,0,1,6452,21309707
168,6450,2800,3900,10920000,2,51606,12903,1,433080000,433080000,19351,6450,12901,6450,0,1,6452,1763521
168,6450,2800,3900,10920000,2,51606,12903,1,433080000,433080000,19351,6450,12901,6450,0,1,6452,1767791
168,6450,2800,3900,10920000,2,51606,12903,1,433080000,433080000,19351,6450,12901,6450,0,1,6452,1766742
168,6450,2800,3900,10920000,2,51606,12903,1,433080000,433080000,19351,6450,12901,6450,0,1,6452,1760004
168,6450,2800,3900,10920000,2,51606,12903,1,433080000,433080000,19351,6450,12901,6450,0,1,6452,1764101
168,6450,2800,3900,10920000,2,51606,12903,1,433080000,433080000,19351,6450,12901,6450,0,1,6452,1765916

168,6850,2800,3900,10920000,2,54806,13703,1,454520000,454520000,20551,6850,13701,6850,0,1,6852,23070318
168,6850,2800,3900,10920000,2,54806,13703,1,454520000,454520000,20551,6850,13701,6850,0,1,6852,1828640
168,6850,2800,3900,10920000,2,54806,13703,1,454520000,454520000,20551,6850,13701,6850,0,1,6852,1826557
168,6850,2800,3900,10920000,2,54806,13703,1,454520000,454520000,20551,6850,13701,6850,0,1,6852,1829879
168,6850,2800,3900,10920000,2,54806,13703,1,454520000,454520000,20551,6850,13701,6850,0,1,6852,1827901
168,6850,2800,3900,10920000,2,54806,13703,1,454520000,454520000,20551,6850,13701,6850,0,1,6852,1824880
168,6850,2800,3900,10920000,2,54806,13703,1,454520000,454520000,20551,6850,13701,6850,0,1,6852,1825969

168,50,2800,3500,9800000,2,406,103,1,80920000,80920000,151,50,101,50,0,1,52,109192
168,50,2800,3500,9800000,2,406,103,1,80920000,80920000,151,50,101,50,0,1,52,97079
168,50,2800,3500,9800000,2,406,103,1,80920000,80920000,151,50,101,50,0,1,52,98187
168,50,2800,3500,9800000,2,406,103,1,80920000,80920000,151,50,101,50,0,1,52,88666
168,50,2800,3500,9800000,2,406,103,1,80920000,80920000,151,50,101,50,0,1,52,95846
168,50,2800,3500,9800000,2,406,103,1,80920000,80920000,151,50,101,50,0,1,52,140655
168,50,2800,3500,9800000,2,406,103,1,80920000,80920000,151,50,101,50,0,1,52,140184

168,450,2800,3500,9800000,2,3606,903,1,101080000,101080000,1351,450,901,450,0,1,452,1017906
168,450,2800,3500,9800000,2,3606,903,1,101080000,101080000,1351,450,901,450,0,1,452,184091
168,450,2800,3500,9800000,2,3606,903,1,101080000,101080000,1351,450,901,450,0,1,452,185386
168,450,2800,3500,9800000,2,3606,903,1,101080000,101080000,1351,450,901,450,0,1,452,185839
168,450,2800,3500,9800000,2,3606,903,1,101080000,101080000,1351,450,901,450,0,1,452,186089
168,450,2800,3500,9800000,2,3606,903,1,101080000,101080000,1351,450,901,450,0,1,452,207167
168,450,2800,3500,9800000,2,3606,903,1,101080000,101080000,1351,450,901,450,0,1,452,206776

168,850,2800,3500,9800000,2,6806,1703,1,121240000,121240000,2551,850,1701,850,0,1,852,2176071
168,850,2800,3500,9800000,2,6806,1703,1,121240000,121240000,2551,850,1701,850,0,1,852,287238
168,850,2800,3500,9800000,2,6806,1703,1,121240000,121240000,2551,850,1701,850,0,1,852,285948
168,850,2800,3500,9800000,2,6806,1703,1,121240000,121240000,2551,850,1701,850,0,1,852,286393
168,850,2800,3500,9800000,2,6806,1703,1,121240000,121240000,2551,850,1701,850,0,1,852,284517
168,850,2800,3500,9800000,2,6806,1703,1,121240000,121240000,2551,850,1701,850,0,1,852,288664
168,850,2800,3500,9800000,2,6806,1703,1,121240000,121240000,2551,850,1701,850,0,1,852,289090

168,1250,2800,3500,9800000,2,10006,2503,1,141400000,141400000,3751,1250,2501,1250,0,1,1252,3308432
168,1250,2800,3500,9800000,2,10006,2503,1,141400000,141400000,3751,1250,2501,1250,0,1,1252,417633
168,1250,2800,3500,9800000,2,10006,2503,1,141400000,141400000,3751,1250,2501,1250,0,1,1252,407637
168,1250,2800,3500,9800000,2,10006,2503,1,141400000,141400000,3751,1250,2501,1250,0,1,1252,422464
168,1250,2800,3500,9800000,2,10006,2503,1,141400000,141400000,3751,1250,2501,1250,0,1,1252,422980
168,1250,2800,3500,9800000,2,10006,2503,1,141400000,141400000,3751,1250,2501,1250,0,1,1252,423221
168,1250,2800,3500,9800000,2,10006,2503,1,141400000,141400000,3751,1250,2501,1250,0,1,1252,415846

168,1650,2800,3500,9800000,2,13206,3303,1,161560000,161560000,4951,1650,3301,1650,0,1,1652,4623050
168,1650,2800,3500,9800000,2,13206,3303,1,161560000,161560000,4951,1650,3301,1650,0,1,1652,473000
168,1650,2800,3500,9800000,2,13206,3303,1,161560000,161560000,4951,1650,3301,1650,0,1,1652,472439
168,1650,2800,3500,9800000,2,13206,3303,1,161560000,161560000,4951,1650,3301,1650,0,1,1652,473629
168,1650,2800,3500,9800000,2,13206,3303,1,161560000,161560000,4951,1650,3301,1650,0,1,1652,474135
168,1650,2800,3500,9800000,2,13206,3303,1,161560000,161560000,4951,1650,3301,1650,0,1,1652,476199
168,1650,2800,3500,9800000,2,13206,3303,1,161560000,161560000,4951,1650,3301,1650,0,1,1652,475729

168,2050,2800,3500,9800000,2,16406,4103,1,181720000,181720000,6151,2050,4101,2050,0,1,2052,5821804
168,2050,2800,3500,9800000,2,16406,4103,1,181720000,181720000,6151,2050,4101,2050,0,1,2052,566593
168,2050,2800,3500,9800000,2,16406,4103,1,181720000,181720000,6151,2050,4101,2050,0,1,2052,566024
168,2050,2800,3500,9800000,2,16406,4103,1,181720000,181720000,6151,2050,4101,2050,0,1,2052,567063
168,2050,2800,3500,9800000,2,16406,4103,1,181720000,181720000,6151,2050,4101,2050,0,1,2052,564688
168,2050,2800,3500,9800000,2,16406,4103,1,181720000,181720000,6151,2050,4101,2050,0,1,2052,568044
168,2050,2800,3500,9800000,2,16406,4103,1,181720000,181720000,6151,2050,4101,2050,0,1,2052,567550

168,2450,2800,3500,9800000,2,19606,4903,1,201880000,201880000,7351,2450,4901,2450,0,1,2452,6937608
168,2450,2800,3500,9800000,2,19606,4903,1,201880000,201880000,7351,2450,4901,2450,0,1,2452,664054
168,2450,2800,3500,9800000,2,19606,4903,1,201880000,201880000,7351,2450,4901,2450,0,1,2452,661541
168,2450,2800,3500,9800000,2,19606,4903,1,201880000,201880000,7351,2450,4901,2450,0,1,2452,665047
168,2450,2800,3500,9800000,2,19606,4903,1,201880000,201880000,7351,2450,4901,2450,0,1,2452,664641
168,2450,2800,3500,9800000,2,19606,4903,1,201880000,201880000,7351,2450,4901,2450,0,1,2452,663268
168,2450,2800,3500,9800000,2,19606,4903,1,201880000,201880000,7351,2450,4901,2450,0,1,2452,661933

168,2850,2800,3500,9800000,2,22806,5703,1,222040000,222040000,8551,2850,5701,2850,0,1,2852,8120841
168,2850,2800,3500,9800000,2,22806,5703,1,222040000,222040000,8551,2850,5701,2850,0,1,2852,731808
168,2850,2800,3500,9800000,2,22806,5703,1,222040000,222040000,8551,2850,5701,2850,0,1,2852,735139
168,2850,2800,3500,9800000,2,22806,5703,1,222040000,222040000,8551,2850,5701,2850,0,1,2852,735952
168,2850,2800,3500,9800000,2,22806,5703,1,222040000,222040000,8551,2850,5701,2850,0,1,2852,734017
168,2850,2800,3500,9800000,2,22806,5703,1,222040000,222040000,8551,2850,5701,2850,0,1,2852,747511
168,2850,2800,3500,9800000,2,22806,5703,1,222040000,222040000,8551,2850,5701,2850,0,1,2852,746969

168,3250,2800,3500,9800000,2,26006,6503,1,242200000,242200000,9751,3250,6501,3250,0,1,3252,8997250
168,3250,2800,3500,9800000,2,26006,6503,1,242200000,242200000,9751,3250,6501,3250,0,1,3252,829444
168,3250,2800,3500,9800000,2,26006,6503,1,242200000,242200000,9751,3250,6501,3250,0,1,3252,826850
168,3250,2800,3500,9800000,2,26006,6503,1,242200000,242200000,9751,3250,6501,3250,0,1,3252,832070
168,3250,2800,3500,9800000,2,26006,6503,1,242200000,242200000,9751,3250,6501,3250,0,1,3252,830642
168,3250,2800,3500,9800000,2,26006,6503,1,242200000,242200000,9751,3250,6501,3250,0,1,3252,841200
168,3250,2800,3500,9800000,2,26006,6503,1,242200000,242200000,9751,3250,6501,3250,0,1,3252,841769

168,3650,2800,3500,9800000,2,29206,7303,1,262360000,262360000,10951,3650,7301,3650,0,1,3652,9956086
168,3650,2800,3500,9800000,2,29206,7303,1,262360000,262360000,10951,3650,7301,3650,0,1,3652,944777
168,3650,2800,3500,9800000,2,29206,7303,1,262360000,262360000,10951,3650,7301,3650,0,1,3652,929926
168,3650,2800,3500,9800000,2,29206,7303,1,262360000,262360000,10951,3650,7301,3650,0,1,3652,946324
168,3650,2800,3500,9800000,2,29206,7303,1,262360000,262360000,10951,3650,7301,3650,0,1,3652,939507
168,3650,2800,3500,9800000,2,29206,7303,1,262360000,262360000,10951,3650,7301,3650,0,1,3652,963410
168,3650,2800,3500,9800000,2,29206,7303,1,262360000,262360000,10951,3650,7301,3650,0,1,3652,964068

168,4050,2800,3500,9800000,2,32406,8103,1,282520000,282520000,12151,4050,8101,4050,0,1,4052,11605796
168,4050,2800,3500,9800000,2,32406,8103,1,282520000,282520000,12151,4050,8101,4050,0,1,4052,978352
168,4050,2800,3500,9800000,2,32406,8103,1,282520000,282520000,12151,4050,8101,4050,0,1,4052,977101
168,4050,2800,3500,9800000,2,32406,8103,1,282520000,282520000,12151,4050,8101,4050,0,1,4052,982639
168,4050,2800,3500,9800000,2,32406,8103,1,282520000,282520000,12151,4050,8101,4050,0,1,4052,980678
168,4050,2800,3500,9800000,2,32406,8103,1,282520000,282520000,12151,4050,8101,4050,0,1,4052,1020359
168,4050,2800,3500,9800000,2,32406,8103,1,282520000,282520000,12151,4050,8101,4050,0,1,4052,1019749

168,4450,2800,3500,9800000,2,35606,8903,1,302680000,302680000,13351,4450,8901,4450,0,1,4452,12732224
168,4450,2800,3500,9800000,2,35606,8903,1,302680000,302680000,13351,4450,8901,4450,0,1,4452,1071703
168,4450,2800,3500,9800000,2,35606,8903,1,302680000,302680000,13351,4450,8901,4450,0,1,4452,1076284
168,4450,2800,3500,9800000,2,35606,8903,1,302680000,302680000,13351,4450,8901,4450,0,1,4452,1079891
168,4450,2800,3500,9800000,2,35606,8903,1,302680000,302680000,13351,4450,8901,4450,0,1,4452,1078206
168,4450,2800,3500,9800000,2,35606,8903,1,302680000,302680000,13351,4450,8901,4450,0,1,4452,1104056
168,4450,2800,3500,9800000,2,35606,8903,1,302680000,302680000,13351,4450,8901,4450,0,1,4452,1104684

168,4850,2800,3500,9800000,2,38806,9703,1,322840000,322840000,14551,4850,9701,4850,0,1,4852,14058957
168,4850,2800,3500,9800000,2,38806,9703,1,322840000,322840000,14551,4850,9701,4850,0,1,4852,1209499
168,4850,2800,3500,9800000,2,38806,9703,1,322840000,322840000,14551,4850,9701,4850,0,1,4852,1193050
168,4850,2800,3500,9800000,2,38806,9703,1,322840000,322840000,14551,4850,9701,4850,0,1,4852,1211161
168,4850,2800,3500,9800000,2,38806,9703,1,322840000,322840000,14551,4850,9701,4850,0,1,4852,1205675
168,4850,2800,3500,9800000,2,38806,9703,1,322840000,322840000,14551,4850,9701,4850,0,1,4852,1230025
168,4850,2800,3500,9800000,2,38806,9703,1,322840000,322840000,14551,4850,9701,4850,0,1,4852,1229360

168,5250,2800,3500,9800000,2,42006,10503,1,343000000,343000000,15751,5250,10501,5250,0,1,5252,15321741
168,5250,2800,3500,9800000,2,42006,10503,1,343000000,343000000,15751,5250,10501,5250,0,1,5252,1262427
168,5250,2800,3500,9800000,2,42006,10503,1,343000000,343000000,15751,5250,10501,5250,0,1,5252,1265959
168,5250,2800,3500,9800000,2,42006,10503,1,343000000,343000000,15751,5250,10501,5250,0,1,5252,1271620
168,5250,2800,3500,9800000,2,42006,10503,1,343000000,343000000,15751,5250,10501,5250,0,1,5252,1269654
168,5250,2800,3500,9800000,2,42006,10503,1,343000000,343000000,15751,5250,10501,5250,0,1,5252,1287502
168,5250,2800,3500,9800000,2,42006,10503,1,343000000,343000000,15751,5250,10501,5250,0,1,5252,1288199

168,5650,2800,3500,9800000,2,45206,11303,1,363160000,363160000,16951,5650,11301,5650,0,1,5652,16017865
168,5650,2800,3500,9800000,2,45206,11303,1,363160000,363160000,16951,5650,11301,5650,0,1,5652,1372299
168,5650,2800,3500,9800000,2,45206,11303,1,363160000,363160000,16951,5650,11301,5650,0,1,5652,1373853
168,5650,2800,3500,9800000,2,45206,11303,1,363160000,363160000,16951,5650,11301,5650,0,1,5652,1381208
168,5650,2800,3500,9800000,2,45206,11303,1,363160000,363160000,16951,5650,11301,5650,0,1,5652,1379631
168,5650,2800,3500,9800000,2,45206,11303,1,363160000,363160000,16951,5650,11301,5650,0,1,5652,1385389
168,5650,2800,3500,9800000,2,45206,11303,1,363160000,363160000,16951,5650,11301,5650,0,1,5652,1384667

168,6050,2800,3500,9800000,2,48406,12103,1,383320000,383320000,18151,6050,12101,6050,0,1,6052,17415770
168,6050,2800,3500,9800000,2,48406,12103,1,383320000,383320000,18151,6050,12101,6050,0,1,6052,1496950
168,6050,2800,3500,9800000,2,48406,12103,1,383320000,383320000,18151,6050,12101,6050,0,1,6052,1506165
168,6050,2800,3500,9800000,2,48406,12103,1,383320000,383320000,18151,6050,12101,6050,0,1,6052,1502757
168,6050,2800,3500,9800000,2,48406,12103,1,383320000,383320000,18151,6050,12101,6050,0,1,6052,1500954
168,6050,2800,3500,9800000,2,48406,12103,1,383320000,383320000,18151,6050,12101,6050,0,1,6052,1508075
168,6050,2800,3500,9800000,2,48406,12103,1,383320000,383320000,18151,6050,12101,6050,0,1,6052,1508818

168,6450,2800,3500,9800000,2,51606,12903,1,403480000,403480000,19351,6450,12901,6450,0,1,6452,19144970
168,6450,2800,3500,9800000,2,51606,12903,1,403480000,403480000,19351,6450,12901,6450,0,1,6452,1547227
168,6450,2800,3500,9800000,2,51606,12903,1,403480000,403480000,19351,6450,12901,6450,0,1,6452,1549560
168,6450,2800,3500,9800000,2,51606,12903,1,403480000,403480000,19351,6450,12901,6450,0,1,6452,1551555
168,6450,2800,3500,9800000,2,51606,12903,1,403480000,403480000,19351,6450,12901,6450,0,1,6452,1545720
168,6450,2800,3500,9800000,2,51606,12903,1,403480000,403480000,19351,6450,12901,6450,0,1,6452,1554169
168,6450,2800,3500,9800000,2,51606,12903,1,403480000,403480000,19351,6450,12901,6450,0,1,6452,1554949

168,6850,2800,3500,9800000,2,54806,13703,1,423640000,423640000,20551,6850,13701,6850,0,1,6852,20124735
168,6850,2800,3500,9800000,2,54806,13703,1,423640000,423640000,20551,6850,13701,6850,0,1,6852,1719312
168,6850,2800,3500,9800000,2,54806,13703,1,423640000,423640000,20551,6850,13701,6850,0,1,6852,1712420
168,6850,2800,3500,9800000,2,54806,13703,1,423640000,423640000,20551,6850,13701,6850,0,1,6852,1718265
168,6850,2800,3500,9800000,2,54806,13703,1,423640000,423640000,20551,6850,13701,6850,0,1,6852,1717177
168,6850,2800,3500,9800000,2,54806,13703,1,423640000,423640000,20551,6850,13701,6850,0,1,6852,1708185
168,6850,2800,3500,9800000,2,54806,13703,1,423640000,423640000,20551,6850,13701,6850,0,1,6852,1706507

168,50,2800,3100,8680000,2,406,103,1,71800000,71800000,151,50,101,50,0,1,52,94506
168,50,2800,3100,8680000,2,406,103,1,71800000,71800000,151,50,101,50,0,1,52,83179
168,50,2800,3100,8680000,2,406,103,1,71800000,71800000,151,50,101,50,0,1,52,91165
168,50,2800,3100,8680000,2,406,103,1,71800000,71800000,151,50,101,50,0,1,52,92450
168,50,2800,3100,8680000,2,406,103,1,71800000,71800000,151,50,101,50,0,1,52,91583
168,50,2800,3100,8680000,2,406,103,1,71800000,71800000,151,50,101,50,0,1,52,113373
168,50,2800,3100,8680000,2,406,103,1,71800000,71800000,151,50,101,50,0,1,52,112896

168,450,2800,3100,8680000,2,3606,903,1,90680000,90680000,1351,450,901,450,0,1,452,921400
168,450,2800,3100,8680000,2,3606,903,1,90680000,90680000,1351,450,901,450,0,1,452,166283
168,450,2800,3100,8680000,2,3606,903,1,90680000,90680000,1351,450,901,450,0,1,452,166051
168,450,2800,3100,8680000,2,3606,903,1,90680000,90680000,1351,450,901,450,0,1,452,164666
168,450,2800,3100,8680000,2,3606,903,1,90680000,90680000,1351,450,901,450,0,1,452,165601
168,450,2800,3100,8680000,2,3606,903,1,90680000,90680000,1351,450,901,450,0,1,452,191803
168,450,2800,3100,8680000,2,3606,903,1,90680000,90680000,1351,450,901,450,0,1,452,191298

168,850,2800,3100,8680000,2,6806,1703,1,109560000,109560000,2551,850,1701,850,0,1,852,1860456
168,850,2800,3100,8680000,2,6806,1703,1,109560000,109560000,2551,850,1701,850,0,1,852,255698
168,850,2800,3100,8680000,2,6806,1703,1,109560000,109560000,2551,850,1701,850,0,1,852,256901
168,850,2800,3100,8680000,2,6806,1703,1,109560000,109560000,2551,850,1701,850,0,1,852,256495
168,850,2800,3100,8680000,2,6806,1703,1,109560000,109560000,2551,850,1701,850,0,1,852,257163
168,850,2800,3100,8680000,2,6806,1703,1,109560000,109560000,2551,850,1701,850,0,1,852,259156
168,850,2800,3100,8680000,2,6806,1703,1,109560000,109560000,2551,850,1701,850,0,1,852,259581

168,1250,2800,3100,8680000,2,10006,2503,1,128440000,128440000,3751,1250,2501,1250,0,1,1252,2777428
168,1250,2800,3100,8680000,2,10006,2503,1,128440000,128440000,3751,1250,2501,1250,0,1,1252,338818
168,1250,2800,3100,8680000,2,10006,2503,1,128440000,128440000,3751,1250,2501,1250,0,1,1252,342601
168,1250,2800,3100,8680000,2,10006,2503,1,128440000,128440000,3751,1250,2501,1250,0,1,1252,341446
168,1250,2800,3100,8680000,2,10006,2503,1,128440000,128440000,3751,1250,2501,1250,0,1,1252,342025
168,1250,2800,3100,8680000,2,10006,2503,1,128440000,128440000,3751,1250,2501,1250,0,1,1252,344162
168,1250,2800,3100,8680000,2,10006,2503,1,128440000,128440000,3751,1250,2501,1250,0,1,1252,343712

168,1650,2800,3100,8680000,2,13206,3303,1,147320000,147320000,4951,1650,3301,1650,0,1,1652,3900793
168,1650,2800,3100,8680000,2,13206,3303,1,147320000,147320000,4951,1650,3301,1650,0,1,1652,425446
168,1650,2800,3100,8680000,2,13206,3303,1,147320000,147320000,4951,1650,3301,1650,0,1,1652,427710
168,1650,2800,3100,8680000,2,13206,3303,1,147320000,147320000,4951,1650,3301,1650,0,1,1652,426975
168,1650,2800,3100,8680000,2,13206,3303,1,147320000,147320000,4951,1650,3301,1650,0,1,1652,427271
168,1650,2800,3100,8680000,2,13206,3303,1,147320000,147320000,4951,1650,3301,1650,0,1,1652,428179
168,1650,2800,3100,8680000,2,13206,3303,1,147320000,147320000,4951,1650,3301,1650,0,1,1652,428650

168,2050,2800,3100,8680000,2,16406,4103,1,166200000,166200000,6151,2050,4101,2050,0,1,2052,4783158
168,2050,2800,3100,8680000,2,16406,4103,1,166200000,166200000,6151,2050,4101,2050,0,1,2052,479643
168,2050,2800,3100,8680000,2,16406,4103,1,166200000,166200000,6151,2050,4101,2050,0,1,2052,478068
168,2050,2800,3100,8680000,2,16406,4103,1,166200000,166200000,6151,2050,4101,2050,0,1,2052,480927
168,2050,2800,3100,8680000,2,16406,4103,1,166200000,166200000,6151,2050,4101,2050,0,1,2052,480334
168,2050,2800,3100,8680000,2,16406,4103,1,166200000,166200000,6151,2050,4101,2050,0,1,2052,510586
168,2050,2800,3100,8680000,2,16406,4103,1,166200000,166200000,6151,2050,4101,2050,0,1,2052,510097

168,2450,2800,3100,8680000,2,19606,4903,1,185080000,185080000,7351,2450,4901,2450,0,1,2452,6154475
168,2450,2800,3100,8680000,2,19606,4903,1,185080000,185080000,7351,2450,4901,2450,0,1,2452,587501
168,2450,2800,3100,8680000,2,19606,4903,1,185080000,185080000,7351,2450,4901,2450,0,1,2452,594085
168,2450,2800,3100,8680000,2,19606,4903,1,185080000,185080000,7351,2450,4901,2450,0,1,2452,594496
168,2450,2800,3100,8680000,2,19606,4903,1,185080000,185080000,7351,2450,4901,2450,0,1,2452,562960
168,2450,2800,3100,8680000,2,19606,4903,1,185080000,185080000,7351,2450,4901,2450,0,1,2452,593486
168,2450,2800,3100,8680000,2,19606,4903,1,185080000,185080000,7351,2450,4901,2450,0,1,2452,592474

168,2850,2800,3100,8680000,2,22806,5703,1,203960000,203960000,8551,2850,5701,2850,0,1,2852,7135119
168,2850,2800,3100,8680000,2,22806,5703,1,203960000,203960000,8551,2850,5701,2850,0,1,2852,678455
168,2850,2800,3100,8680000,2,22806,5703,1,203960000,203960000,8551,2850,5701,2850,0,1,2852,679078
168,2850,2800,3100,8680000,2,22806,5703,1,203960000,203960000,8551,2850,5701,2850,0,1,2852,679519
168,2850,2800,3100,8680000,2,22806,5703,1,203960000,203960000,8551,2850,5701,2850,0,1,2852,677313
168,2850,2800,3100,8680000,2,22806,5703,1,203960000,203960000,8551,2850,5701,2850,0,1,2852,675766
168,2850,2800,3100,8680000,2,22806,5703,1,203960000,203960000,8551,2850,5701,2850,0,1,2852,676785

168,3250,2800,3100,8680000,2,26006,6503,1,222840000,222840000,9751,3250,6501,3250,0,1,3252,7620876
168,3250,2800,3100,8680000,2,26006,6503,1,222840000,222840000,9751,3250,6501,3250,0,1,3252,714182
168,3250,2800,3100,8680000,2,26006,6503,1,222840000,222840000,9751,3250,6501,3250,0,1,3252,709614
168,3250,2800,3100,8680000,2,26006,6503,1,222840000,222840000,9751,3250,6501,3250,0,1,3252,733284
168,3250,2800,3100,8680000,2,26006,6503,1,222840000,222840000,9751,3250,6501,3250,0,1,3252,731636
168,3250,2800,3100,8680000,2,26006,6503,1,222840000,222840000,9751,3250,6501,3250,0,1,3252,802971
168,3250,2800,3100,8680000,2,26006,6503,1,222840000,222840000,9751,3250,6501,3250,0,1,3252,802402

168,3650,2800,3100,8680000,2,29206,7303,1,241720000,241720000,10951,3650,7301,3650,0,1,3652,9409874
168,3650,2800,3100,8680000,2,29206,7303,1,241720000,241720000,10951,3650,7301,3650,0,1,3652,852748
168,3650,2800,3100,8680000,2,29206,7303,1,241720000,241720000,10951,3650,7301,3650,0,1,3652,859335
168,3650,2800,3100,8680000,2,29206,7303,1,241720000,241720000,10951,3650,7301,3650,0,1,3652,838240
168,3650,2800,3100,8680000,2,29206,7303,1,241720000,241720000,10951,3650,7301,3650,0,1,3652,826926
168,3650,2800,3100,8680000,2,29206,7303,1,241720000,241720000,10951,3650,7301,3650,0,1,3652,858389
168,3650,2800,3100,8680000,2,29206,7303,1,241720000,241720000,10951,3650,7301,3650,0,1,3652,857226

168,4050,2800,3100,8680000,2,32406,8103,1,260600000,260600000,12151,4050,8101,4050,0,1,4052,10273668
168,4050,2800,3100,8680000,2,32406,8103,1,260600000,260600000,12151,4050,8101,4050,0,1,4052,874903
168,4050,2800,3100,8680000,2,32406,8103,1,260600000,260600000,12151,4050,8101,4050,0,1,4052,873420
168,4050,2800,3100,8680000,2,32406,8103,1,260600000,260600000,12151,4050,8101,4050,0,1,4052,875456
168,4050,2800,3100,8680000,2,32406,8103,1,260600000,260600000,12151,4050,8101,4050,0,1,4052,874187
168,4050,2800,3100,8680000,2,32406,8103,1,260600000,260600000,12151,4050,8101,4050,0,1,4052,925076
168,4050,2800,3100,8680000,2,32406,8103,1,260600000,260600000,12151,4050,8101,4050,0,1,4052,925711

168,4450,2800,3100,8680000,2,35606,8903,1,279480000,279480000,13351,4450,8901,4450,0,1,4452,11286413
168,4450,2800,3100,8680000,2,35606,8903,1,279480000,279480000,13351,4450,8901,4450,0,1,4452,948784
168,4450,2800,3100,8680000,2,35606,8903,1,279480000,279480000,13351,4450,8901,4450,0,1,4452,950553
168,4450,2800,3100,8680000,2,35606,8903,1,279480000,279480000,13351,4450,8901,4450,0,1,4452,951549
168,4450,2800,3100,8680000,2,35606,8903,1,279480000,279480000,13351,4450,8901,4450,0,1,4452,949455
168,4450,2800,3100,8680000,2,35606,8903,1,279480000,279480000,13351,4450,8901,4450,0,1,4452,1006428
168,4450,2800,3100,8680000,2,35606,8903,1,279480000,279480000,13351,4450,8901,4450,0,1,4452,1007069

168,4850,2800,3100,8680000,2,38806,9703,1,298360000,298360000,14551,4850,9701,4850,0,1,4852,11808088
168,4850,2800,3100,8680000,2,38806,9703,1,298360000,298360000,14551,4850,9701,4850,0,1,4852,1046178
168,4850,2800,3100,8680000,2,38806,9703,1,298360000,298360000,14551,4850,9701,4850,0,1,4852,1048318
168,4850,2800,3100,8680000,2,38806,9703,1,298360000,298360000,14551,4850,9701,4850,0,1,4852,1067689
168,4850,2800,3100,8680000,2,38806,9703,1,298360000,298360000,14551,4850,9701,4850,0,1,4852,1065576
168,4850,2800,3100,8680000,2,38806,9703,1,298360000,298360000,14551,4850,9701,4850,0,1,4852,1102670
168,4850,2800,3100,8680000,2,38806,9703,1,298360000,298360000,14551,4850,9701,4850,0,1,4852,1105726

168,5250,2800,3100,8680000,2,42006,10503,1,317240000,317240000,15751,5250,10501,5250,0,1,5252,13209895
168,5250,2800,3100,8680000,2,42006,10503,1,317240000,317240000,15751,5250,10501,5250,0,1,5252,1200925
168,5250,2800,3100,8680000,2,42006,10503,1,317240000,317240000,15751,5250,10501,5250,0,1,5252,1197108
168,5250,2800,3100,8680000,2,42006,10503,1,317240000,317240000,15751,5250,10501,5250,0,1,5252,1183037
168,5250,2800,3100,8680000,2,42006,10503,1,317240000,317240000,15751,5250,10501,5250,0,1,5252,1172196
168,5250,2800,3100,8680000,2,42006,10503,1,317240000,317240000,15751,5250,10501,5250,0,1,5252,1197695
168,5250,2800,3100,8680000,2,42006,10503,1,317240000,317240000,15751,5250,10501,5250,0,1,5252,1198206

168,5650,2800,3100,8680000,2,45206,11303,1,336120000,336120000,16951,5650,11301,5650,0,1,5652,14259335
168,5650,2800,3100,8680000,2,45206,11303,1,336120000,336120000,16951,5650,11301,5650,0,1,5652,1251938
168,5650,2800,3100,8680000,2,45206,11303,1,336120000,336120000,16951,5650,11301,5650,0,1,5652,1250951
168,5650,2800,3100,8680000,2,45206,11303,1,336120000,336120000,16951,5650,11301,5650,0,1,5652,1252751
168,5650,2800,3100,8680000,2,45206,11303,1,336120000,336120000,16951,5650,11301,5650,0,1,5652,1248943
168,5650,2800,3100,8680000,2,45206,11303,1,336120000,336120000,16951,5650,11301,5650,0,1,5652,1255894
168,5650,2800,3100,8680000,2,45206,11303,1,336120000,336120000,16951,5650,11301,5650,0,1,5652,1256626

168,6050,2800,3100,8680000,2,48406,12103,1,355000000,355000000,18151,6050,12101,6050,0,1,6052,15581164
168,6050,2800,3100,8680000,2,48406,12103,1,355000000,355000000,18151,6050,12101,6050,0,1,6052,1284865
168,6050,2800,3100,8680000,2,48406,12103,1,355000000,355000000,18151,6050,12101,6050,0,1,6052,1287932
168,6050,2800,3100,8680000,2,48406,12103,1,355000000,355000000,18151,6050,12101,6050,0,1,6052,1318173
168,6050,2800,3100,8680000,2,48406,12103,1,355000000,355000000,18151,6050,12101,6050,0,1,6052,1313946
168,6050,2800,3100,8680000,2,48406,12103,1,355000000,355000000,18151,6050,12101,6050,0,1,6052,1337006
168,6050,2800,3100,8680000,2,48406,12103,1,355000000,355000000,18151,6050,12101,6050,0,1,6052,1337758

168,6450,2800,3100,8680000,2,51606,12903,1,373880000,373880000,19351,6450,12901,6450,0,1,6452,16670433
168,6450,2800,3100,8680000,2,51606,12903,1,373880000,373880000,19351,6450,12901,6450,0,1,6452,1452290
168,6450,2800,3100,8680000,2,51606,12903,1,373880000,373880000,19351,6450,12901,6450,0,1,6452,1449958
168,6450,2800,3100,8680000,2,51606,12903,1,373880000,373880000,19351,6450,12901,6450,0,1,6452,1445870
168,6450,2800,3100,8680000,2,51606,12903,1,373880000,373880000,19351,6450,12901,6450,0,1,6452,1440968
168,6450,2800,3100,8680000,2,51606,12903,1,373880000,373880000,19351,6450,12901,6450,0,1,6452,1442021
168,6450,2800,3100,8680000,2,51606,12903,1,373880000,373880000,19351,6450,12901,6450,0,1,6452,1443194

168,6850,2800,3100,8680000,2,54806,13703,1,392760000,392760000,20551,6850,13701,6850,0,1,6852,17949254
168,6850,2800,3100,8680000,2,54806,13703,1,392760000,392760000,20551,6850,13701,6850,0,1,6852,1512007
168,6850,2800,3100,8680000,2,54806,13703,1,392760000,392760000,20551,6850,13701,6850,0,1,6852,1513059
168,6850,2800,3100,8680000,2,54806,13703,1,392760000,392760000,20551,6850,13701,6850,0,1,6852,1470089
168,6850,2800,3100,8680000,2,54806,13703,1,392760000,392760000,20551,6850,13701,6850,0,1,6852,1463863
168,6850,2800,3100,8680000,2,54806,13703,1,392760000,392760000,20551,6850,13701,6850,0,1,6852,1506097
168,6850,2800,3100,8680000,2,54806,13703,1,392760000,392760000,20551,6850,13701,6850,0,1,6852,1507413

168,50,2800,2700,7560000,2,406,103,1,62680000,62680000,151,50,101,50,0,1,52,81739
168,50,2800,2700,7560000,2,406,103,1,62680000,62680000,151,50,101,50,0,1,52,69496
168,50,2800,2700,7560000,2,406,103,1,62680000,62680000,151,50,101,50,0,1,52,80271
168,50,2800,2700,7560000,2,406,103,1,62680000,62680000,151,50,101,50,0,1,52,82417
168,50,2800,2700,7560000,2,406,103,1,62680000,62680000,151,50,101,50,0,1,52,81970
168,50,2800,2700,7560000,2,406,103,1,62680000,62680000,151,50,101,50,0,1,52,99911
168,50,2800,2700,7560000,2,406,103,1,62680000,62680000,151,50,101,50,0,1,52,100382

168,450,2800,2700,7560000,2,3606,903,1,80280000,80280000,1351,450,901,450,0,1,452,779721
168,450,2800,2700,7560000,2,3606,903,1,80280000,80280000,1351,450,901,450,0,1,452,148360
168,450,2800,2700,7560000,2,3606,903,1,80280000,80280000,1351,450,901,450,0,1,452,148124
168,450,2800,2700,7560000,2,3606,903,1,80280000,80280000,1351,450,901,450,0,1,452,146374
168,450,2800,2700,7560000,2,3606,903,1,80280000,80280000,1351,450,901,450,0,1,452,147671
168,450,2800,2700,7560000,2,3606,903,1,80280000,80280000,1351,450,901,450,0,1,452,168465
168,450,2800,2700,7560000,2,3606,903,1,80280000,80280000,1351,450,901,450,0,1,452,168980

168,850,2800,2700,7560000,2,6806,1703,1,97880000,97880000,2551,850,1701,850,0,1,852,1623616
168,850,2800,2700,7560000,2,6806,1703,1,97880000,97880000,2551,850,1701,850,0,1,852,227852
168,850,2800,2700,7560000,2,6806,1703,1,97880000,97880000,2551,850,1701,850,0,1,852,229573
168,850,2800,2700,7560000,2,6806,1703,1,97880000,97880000,2551,850,1701,850,0,1,852,230123
168,850,2800,2700,7560000,2,6806,1703,1,97880000,97880000,2551,850,1701,850,0,1,852,230708
168,850,2800,2700,7560000,2,6806,1703,1,97880000,97880000,2551,850,1701,850,0,1,852,231419
168,850,2800,2700,7560000,2,6806,1703,1,97880000,97880000,2551,850,1701,850,0,1,852,231847

168,1250,2800,2700,7560000,2,10006,2503,1,115480000,115480000,3751,1250,2501,1250,0,1,1252,2470401
168,1250,2800,2700,7560000,2,10006,2503,1,115480000,115480000,3751,1250,2501,1250,0,1,1252,295867
168,1250,2800,2700,7560000,2,10006,2503,1,115480000,115480000,3751,1250,2501,1250,0,1,1252,290922
168,1250,2800,2700,7560000,2,10006,2503,1,115480000,115480000,3751,1250,2501,1250,0,1,1252,317301
168,1250,2800,2700,7560000,2,10006,2503,1,115480000,115480000,3751,1250,2501,1250,0,1,1252,316382
168,1250,2800,2700,7560000,2,10006,2503,1,115480000,115480000,3751,1250,2501,1250,0,1,1252,319469
168,1250,2800,2700,7560000,2,10006,2503,1,115480000,115480000,3751,1250,2501,1250,0,1,1252,321274

168,1650,2800,2700,7560000,2,13206,3303,1,133080000,133080000,4951,1650,3301,1650,0,1,1652,3284911
168,1650,2800,2700,7560000,2,13206,3303,1,133080000,133080000,4951,1650,3301,1650,0,1,1652,372210
168,1650,2800,2700,7560000,2,13206,3303,1,133080000,133080000,4951,1650,3301,1650,0,1,1652,370851
168,1650,2800,2700,7560000,2,13206,3303,1,133080000,133080000,4951,1650,3301,1650,0,1,1652,372639
168,1650,2800,2700,7560000,2,13206,3303,1,133080000,133080000,4951,1650,3301,1650,0,1,1652,369071
168,1650,2800,2700,7560000,2,13206,3303,1,133080000,133080000,4951,1650,3301,1650,0,1,1652,374036
168,1650,2800,2700,7560000,2,13206,3303,1,133080000,133080000,4951,1650,3301,1650,0,1,1652,374506

168,2050,2800,2700,7560000,2,16406,4103,1,150680000,150680000,6151,2050,4101,2050,0,1,2052,4373973
168,2050,2800,2700,7560000,2,16406,4103,1,150680000,150680000,6151,2050,4101,2050,0,1,2052,464973
168,2050,2800,2700,7560000,2,16406,4103,1,150680000,150680000,6151,2050,4101,2050,0,1,2052,462179
168,2050,2800,2700,7560000,2,16406,4103,1,150680000,150680000,6151,2050,4101,2050,0,1,2052,455157
168,2050,2800,2700,7560000,2,16406,4103,1,150680000,150680000,6151,2050,4101,2050,0,1,2052,451844
168,2050,2800,2700,7560000,2,16406,4103,1,150680000,150680000,6151,2050,4101,2050,0,1,2052,457310
168,2050,2800,2700,7560000,2,16406,4103,1,150680000,150680000,6151,2050,4101,2050,0,1,2052,456684

168,2450,2800,2700,7560000,2,19606,4903,1,168280000,168280000,7351,2450,4901,2450,0,1,2452,5132408
168,2450,2800,2700,7560000,2,19606,4903,1,168280000,168280000,7351,2450,4901,2450,0,1,2452,503279
168,2450,2800,2700,7560000,2,19606,4903,1,168280000,168280000,7351,2450,4901,2450,0,1,2452,502386
168,2450,2800,2700,7560000,2,19606,4903,1,168280000,168280000,7351,2450,4901,2450,0,1,2452,504270
168,2450,2800,2700,7560000,2,19606,4903,1,168280000,168280000,7351,2450,4901,2450,0,1,2452,501143
168,2450,2800,2700,7560000,2,19606,4903,1,168280000,168280000,7351,2450,4901,2450,0,1,2452,516968
168,2450,2800,2700,7560000,2,19606,4903,1,168280000,168280000,7351,2450,4901,2450,0,1,2452,517609

168,2850,2800,2700,7560000,2,22806,5703,1,185880000,185880000,8551,2850,5701,2850,0,1,2852,6136790
168,2850,2800,2700,7560000,2,22806,5703,1,185880000,185880000,8551,2850,5701,2850,0,1,2852,586102
168,2850,2800,2700,7560000,2,22806,5703,1,185880000,185880000,8551,2850,5701,2850,0,1,2852,577607
168,2850,2800,2700,7560000,2,22806,5703,1,185880000,185880000,8551,2850,5701,2850,0,1,2852,586923
168,2850,2800,2700,7560000,2,22806,5703,1,185880000,185880000,8551,2850,5701,2850,0,1,2852,584958
168,2850,2800,2700,7560000,2,22806,5703,1,185880000,185880000,8551,2850,5701,2850,0,1,2852,591987
168,2850,2800,2700,7560000,2,22806,5703,1,185880000,185880000,8551,2850,5701,2850,0,1,2852,592529

168,3250,2800,2700,7560000,2,26006,6503,1,203480000,203480000,9751,3250,6501,3250,0,1,3252,7028137
168,3250,2800,2700,7560000,2,26006,6503,1,203480000,203480000,9751,3250,6501,3250,0,1,3252,636835
168,3250,2800,2700,7560000,2,26006,6503,1,203480000,203480000,9751,3250,6501,3250,0,1,3252,634293
168,3250,2800,2700,7560000,2,26006,6503,1,203480000,203480000,9751,3250,6501,3250,0,1,3252,637310
168,3250,2800,2700,7560000,2,26006,6503,1,203480000,203480000,9751,3250,6501,3250,0,1,3252,636185
168,3250,2800,2700,7560000,2,26006,6503,1,203480000,203480000,9751,3250,6501,3250,0,1,3252,704902
168,3250,2800,2700,7560000,2,26006,6503,1,203480000,203480000,9751,3250,6501,3250,0,1,3252,705461

168,3650,2800,2700,7560000,2,29206,7303,1,221080000,221080000,10951,3650,7301,3650,0,1,3652,7689996
168,3650,2800,2700,7560000,2,29206,7303,1,221080000,221080000,10951,3650,7301,3650,0,1,3652,704666
168,3650,2800,2700,7560000,2,29206,7303,1,221080000,221080000,10951,3650,7301,3650,0,1,3652,705860
168,3650,2800,2700,7560000,2,29206,7303,1,221080000,221080000,10951,3650,7301,3650,0,1,3652,705339
168,3650,2800,2700,7560000,2,29206,7303,1,221080000,221080000,10951,3650,7301,3650,0,1,3652,703945
168,3650,2800,2700,7560000,2,29206,7303,1,221080000,221080000,10951,3650,7301,3650,0,1,3652,759670
168,3650,2800,2700,7560000,2,29206,7303,1,221080000,221080000,10951,3650,7301,3650,0,1,3652,760257

168,4050,2800,2700,7560000,2,32406,8103,1,238680000,238680000,12151,4050,8101,4050,0,1,4052,8686605
168,4050,2800,2700,7560000,2,32406,8103,1,238680000,238680000,12151,4050,8101,4050,0,1,4052,773095
168,4050,2800,2700,7560000,2,32406,8103,1,238680000,238680000,12151,4050,8101,4050,0,1,4052,774466
168,4050,2800,2700,7560000,2,32406,8103,1,238680000,238680000,12151,4050,8101,4050,0,1,4052,786126
168,4050,2800,2700,7560000,2,32406,8103,1,238680000,238680000,12151,4050,8101,4050,0,1,4052,786922
168,4050,2800,2700,7560000,2,32406,8103,1,238680000,238680000,12151,4050,8101,4050,0,1,4052,846861
168,4050,2800,2700,7560000,2,32406,8103,1,238680000,238680000,12151,4050,8101,4050,0,1,4052,847475

168,4450,2800,2700,7560000,2,35606,8903,1,256280000,256280000,13351,4450,8901,4450,0,1,4452,9947005
168,4450,2800,2700,7560000,2,35606,8903,1,256280000,256280000,13351,4450,8901,4450,0,1,4452,872474
168,4450,2800,2700,7560000,2,35606,8903,1,256280000,256280000,13351,4450,8901,4450,0,1,4452,878659
168,4450,2800,2700,7560000,2,35606,8903,1,256280000,256280000,13351,4450,8901,4450,0,1,4452,855135
168,4450,2800,2700,7560000,2,35606,8903,1,256280000,256280000,13351,4450,8901,4450,0,1,4452,853794
168,4450,2800,2700,7560000,2,35606,8903,1,256280000,256280000,13351,4450,8901,4450,0,1,4452,905024
168,4450,2800,2700,7560000,2,35606,8903,1,256280000,256280000,13351,4450,8901,4450,0,1,4452,905666

168,4850,2800,2700,7560000,2,38806,9703,1,273880000,273880000,14551,4850,9701,4850,0,1,4852,10724539
168,4850,2800,2700,7560000,2,38806,9703,1,273880000,273880000,14551,4850,9701,4850,0,1,4852,911103
168,4850,2800,2700,7560000,2,38806,9703,1,273880000,273880000,14551,4850,9701,4850,0,1,4852,912519
168,4850,2800,2700,7560000,2,38806,9703,1,273880000,273880000,14551,4850,9701,4850,0,1,4852,911881
168,4850,2800,2700,7560000,2,38806,9703,1,273880000,273880000,14551,4850,9701,4850,0,1,4852,908907
168,4850,2800,2700,7560000,2,38806,9703,1,273880000,273880000,14551,4850,9701,4850,0,1,4852,960473
168,4850,2800,2700,7560000,2,38806,9703,1,273880000,273880000,14551,4850,9701,4850,0,1,4852,959797

168,5250,2800,2700,7560000,2,42006,10503,1,291480000,291480000,15751,5250,10501,5250,0,1,5252,11575660
168,5250,2800,2700,7560000,2,42006,10503,1,291480000,291480000,15751,5250,10501,5250,0,1,5252,1017831
168,5250,2800,2700,7560000,2,42006,10503,1,291480000,291480000,15751,5250,10501,5250,0,1,5252,1025356
168,5250,2800,2700,7560000,2,42006,10503,1,291480000,291480000,15751,5250,10501,5250,0,1,5252,1028223
168,5250,2800,2700,7560000,2,42006,10503,1,291480000,291480000,15751,5250,10501,5250,0,1,5252,1026925
168,5250,2800,2700,7560000,2,42006,10503,1,291480000,291480000,15751,5250,10501,5250,0,1,5252,1043875
168,5250,2800,2700,7560000,2,42006,10503,1,291480000,291480000,15751,5250,10501,5250,0,1,5252,1043170

168,5650,2800,2700,7560000,2,45206,11303,1,309080000,309080000,16951,5650,11301,5650,0,1,5652,12069162
168,5650,2800,2700,7560000,2,45206,11303,1,309080000,309080000,16951,5650,11301,5650,0,1,5652,1058757
168,5650,2800,2700,7560000,2,45206,11303,1,309080000,309080000,16951,5650,11301,5650,0,1,5652,1057246
168,5650,2800,2700,7560000,2,45206,11303,1,309080000,309080000,16951,5650,11301,5650,0,1,5652,1086404
168,5650,2800,2700,7560000,2,45206,11303,1,309080000,309080000,16951,5650,11301,5650,0,1,5652,1082365
168,5650,2800,2700,7560000,2,45206,11303,1,309080000,309080000,16951,5650,11301,5650,0,1,5652,1120756
168,5650,2800,2700,7560000,2,45206,11303,1,309080000,309080000,16951,5650,11301,5650,0,1,5652,1120026

168,6050,2800,2700,7560000,2,48406,12103,1,326680000,326680000,18151,6050,12101,6050,0,1,6052,12894856
168,6050,2800,2700,7560000,2,48406,12103,1,326680000,326680000,18151,6050,12101,6050,0,1,6052,1209484
168,6050,2800,2700,7560000,2,48406,12103,1,326680000,326680000,18151,6050,12101,6050,0,1,6052,1215559
168,6050,2800,2700,7560000,2,48406,12103,1,326680000,326680000,18151,6050,12101,6050,0,1,6052,1202651
168,6050,2800,2700,7560000,2,48406,12103,1,326680000,326680000,18151,6050,12101,6050,0,1,6052,1194493
168,6050,2800,2700,7560000,2,48406,12103,1,326680000,326680000,18151,6050,12101,6050,0,1,6052,1211805
168,6050,2800,2700,7560000,2,48406,12103,1,326680000,326680000,18151,6050,12101,6050,0,1,6052,1212545

168,6450,2800,2700,7560000,2,51606,12903,1,344280000,344280000,19351,6450,12901,6450,0,1,6452,14276157
168,6450,2800,2700,7560000,2,51606,12903,1,344280000,344280000,19351,6450,12901,6450,0,1,6452,1284253
168,6450,2800,2700,7560000,2,51606,12903,1,344280000,344280000,19351,6450,12901,6450,0,1,6452,1274459
168,6450,2800,2700,7560000,2,51606,12903,1,344280000,344280000,19351,6450,12901,6450,0,1,6452,1282548
168,6450,2800,2700,7560000,2,51606,12903,1,344280000,344280000,19351,6450,12901,6450,0,1,6452,1279835
168,6450,2800,2700,7560000,2,51606,12903,1,344280000,344280000,19351,6450,12901,6450,0,1,6452,1284759
168,6450,2800,2700,7560000,2,51606,12903,1,344280000,344280000,19351,6450,12901,6450,0,1,6452,1285531

168,6850,2800,2700,7560000,2,54806,13703,1,361880000,361880000,20551,6850,13701,6850,0,1,6852,15564278
168,6850,2800,2700,7560000,2,54806,13703,1,361880000,361880000,20551,6850,13701,6850,0,1,6852,1304367
168,6850,2800,2700,7560000,2,54806,13703,1,361880000,361880000,20551,6850,13701,6850,0,1,6852,1312978
168,6850,2800,2700,7560000,2,54806,13703,1,361880000,361880000,20551,6850,13701,6850,0,1,6852,1355664
168,6850,2800,2700,7560000,2,54806,13703,1,361880000,361880000,20551,6850,13701,6850,0,1,6852,1353487
168,6850,2800,2700,7560000,2,54806,13703,1,361880000,361880000,20551,6850,13701,6850,0,1,6852,1358747
168,6850,2800,2700,7560000,2,54806,13703,1,361880000,361880000,20551,6850,13701,6850,0,1,6852,1360484

168,50,2800,2300,6440000,2,406,103,1,53560000,53560000,151,50,101,50,0,1,52,69204
168,50,2800,2300,6440000,2,406,103,1,53560000,53560000,151,50,101,50,0,1,52,63536
168,50,2800,2300,6440000,2,406,103,1,53560000,53560000,151,50,101,50,0,1,52,62901
168,50,2800,2300,6440000,2,406,103,1,53560000,53560000,151,50,101,50,0,1,52,52513
168,50,2800,2300,6440000,2,406,103,1,53560000,53560000,151,50,101,50,0,1,52,62100
168,50,2800,2300,6440000,2,406,103,1,53560000,53560000,151,50,101,50,0,1,52,81772
168,50,2800,2300,6440000,2,406,103,1,53560000,53560000,151,50,101,50,0,1,52,78401

168,450,2800,2300,6440000,2,3606,903,1,69880000,69880000,1351,450,901,450,0,1,452,659263
168,450,2800,2300,6440000,2,3606,903,1,69880000,69880000,1351,450,901,450,0,1,452,120150
168,450,2800,2300,6440000,2,3606,903,1,69880000,69880000,1351,450,901,450,0,1,452,120516
168,450,2800,2300,6440000,2,3606,903,1,69880000,69880000,1351,450,901,450,0,1,452,119183
168,450,2800,2300,6440000,2,3606,903,1,69880000,69880000,1351,450,901,450,0,1,452,121002
168,450,2800,2300,6440000,2,3606,903,1,69880000,69880000,1351,450,901,450,0,1,452,141108
168,450,2800,2300,6440000,2,3606,903,1,69880000,69880000,1351,450,901,450,0,1,452,141617

168,850,2800,2300,6440000,2,6806,1703,1,86200000,86200000,2551,850,1701,850,0,1,852,1276536
168,850,2800,2300,6440000,2,6806,1703,1,86200000,86200000,2551,850,1701,850,0,1,852,190312
168,850,2800,2300,6440000,2,6806,1703,1,86200000,86200000,2551,850,1701,850,0,1,852,194411
168,850,2800,2300,6440000,2,6806,1703,1,86200000,86200000,2551,850,1701,850,0,1,852,192741
168,850,2800,2300,6440000,2,6806,1703,1,86200000,86200000,2551,850,1701,850,0,1,852,193149
168,850,2800,2300,6440000,2,6806,1703,1,86200000,86200000,2551,850,1701,850,0,1,852,206665
168,850,2800,2300,6440000,2,6806,1703,1,86200000,86200000,2551,850,1701,850,0,1,852,207088

168,1250,2800,2300,6440000,2,10006,2503,1,102520000,102520000,3751,1250,2501,1250,0,1,1252,2012267
168,1250,2800,2300,6440000,2,10006,2503,1,102520000,102520000,3751,1250,2501,1250,0,1,1252,262201
168,1250,2800,2300,6440000,2,10006,2503,1,102520000,102520000,3751,1250,2501,1250,0,1,1252,263850
168,1250,2800,2300,6440000,2,10006,2503,1,102520000,102520000,3751,1250,2501,1250,0,1,1252,261768
168,1250,2800,2300,6440000,2,10006,2503,1,102520000,102520000,3751,1250,2501,1250,0,1,1252,260979
168,1250,2800,2300,6440000,2,10006,2503,1,102520000,102520000,3751,1250,2501,1250,0,1,1252,264201
168,1250,2800,2300,6440000,2,10006,2503,1,102520000,102520000,3751,1250,2501,1250,0,1,1252,264435

168,1650,2800,2300,6440000,2,13206,3303,1,118840000,118840000,4951,1650,3301,1650,0,1,1652,2799278
168,1650,2800,2300,6440000,2,13206,3303,1,118840000,118840000,4951,1650,3301,1650,0,1,1652,333317
168,1650,2800,2300,6440000,2,13206,3303,1,118840000,118840000,4951,1650,3301,1650,0,1,1652,322386
168,1650,2800,2300,6440000,2,13206,3303,1,118840000,118840000,4951,1650,3301,1650,0,1,1652,329813
168,1650,2800,2300,6440000,2,13206,3303,1,118840000,118840000,4951,1650,3301,1650,0,1,1652,330429
168,1650,2800,2300,6440000,2,13206,3303,1,118840000,118840000,4951,1650,3301,1650,0,1,1652,331208
168,1650,2800,2300,6440000,2,13206,3303,1,118840000,118840000,4951,1650,3301,1650,0,1,1652,330798

168,2050,2800,2300,6440000,2,16406,4103,1,135160000,135160000,6151,2050,4101,2050,0,1,2052,3476238
168,2050,2800,2300,6440000,2,16406,4103,1,135160000,135160000,6151,2050,4101,2050,0,1,2052,375074
168,2050,2800,2300,6440000,2,16406,4103,1,135160000,135160000,6151,2050,4101,2050,0,1,2052,388758
168,2050,2800,2300,6440000,2,16406,4103,1,135160000,135160000,6151,2050,4101,2050,0,1,2052,392035
168,2050,2800,2300,6440000,2,16406,4103,1,135160000,135160000,6151,2050,4101,2050,0,1,2052,391667
168,2050,2800,2300,6440000,2,16406,4103,1,135160000,135160000,6151,2050,4101,2050,0,1,2052,391117
168,2050,2800,2300,6440000,2,16406,4103,1,135160000,135160000,6151,2050,4101,2050,0,1,2052,390477

168,2450,2800,2300,6440000,2,19606,4903,1,151480000,151480000,7351,2450,4901,2450,0,1,2452,4389847
168,2450,2800,2300,6440000,2,19606,4903,1,151480000,151480000,7351,2450,4901,2450,0,1,2452,442174
168,2450,2800,2300,6440000,2,19606,4903,1,151480000,151480000,7351,2450,4901,2450,0,1,2452,438403
168,2450,2800,2300,6440000,2,19606,4903,1,151480000,151480000,7351,2450,4901,2450,0,1,2452,442747
168,2450,2800,2300,6440000,2,19606,4903,1,151480000,151480000,7351,2450,4901,2450,0,1,2452,440605
168,2450,2800,2300,6440000,2,19606,4903,1,151480000,151480000,7351,2450,4901,2450,0,1,2452,444824
168,2450,2800,2300,6440000,2,19606,4903,1,151480000,151480000,7351,2450,4901,2450,0,1,2452,445343

168,2850,2800,2300,6440000,2,22806,5703,1,167800000,167800000,8551,2850,5701,2850,0,1,2852,5426968
168,2850,2800,2300,6440000,2,22806,5703,1,167800000,167800000,8551,2850,5701,2850,0,1,2852,496282
168,2850,2800,2300,6440000,2,22806,5703,1,167800000,167800000,8551,2850,5701,2850,0,1,2852,501941
168,2850,2800,2300,6440000,2,22806,5703,1,167800000,167800000,8551,2850,5701,2850,0,1,2852,503086
168,2850,2800,2300,6440000,2,22806,5703,1,167800000,167800000,8551,2850,5701,2850,0,1,2852,503914
168,2850,2800,2300,6440000,2,22806,5703,1,167800000,167800000,8551,2850,5701,2850,0,1,2852,512429
168,2850,2800,2300,6440000,2,22806,5703,1,167800000,167800000,8551,2850,5701,2850,0,1,2852,512974

168,3250,2800,2300,6440000,2,26006,6503,1,184120000,184120000,9751,3250,6501,3250,0,1,3252,5876228
168,3250,2800,2300,6440000,2,26006,6503,1,184120000,184120000,9751,3250,6501,3250,0,1,3252,556046
168,3250,2800,2300,6440000,2,26006,6503,1,184120000,184120000,9751,3250,6501,3250,0,1,3252,551697
168,3250,2800,2300,6440000,2,26006,6503,1,184120000,184120000,9751,3250,6501,3250,0,1,3252,556957
168,3250,2800,2300,6440000,2,26006,6503,1,184120000,184120000,9751,3250,6501,3250,0,1,3252,554798
168,3250,2800,2300,6440000,2,26006,6503,1,184120000,184120000,9751,3250,6501,3250,0,1,3252,581113
168,3250,2800,2300,6440000,2,26006,6503,1,184120000,184120000,9751,3250,6501,3250,0,1,3252,580547

168,3650,2800,2300,6440000,2,29206,7303,1,200440000,200440000,10951,3650,7301,3650,0,1,3652,6793834
168,3650,2800,2300,6440000,2,29206,7303,1,200440000,200440000,10951,3650,7301,3650,0,1,3652,611326
168,3650,2800,2300,6440000,2,29206,7303,1,200440000,200440000,10951,3650,7301,3650,0,1,3652,612082
168,3650,2800,2300,6440000,2,29206,7303,1,200440000,200440000,10951,3650,7301,3650,0,1,3652,612597
168,3650,2800,2300,6440000,2,29206,7303,1,200440000,200440000,10951,3650,7301,3650,0,1,3652,607743
168,3650,2800,2300,6440000,2,29206,7303,1,200440000,200440000,10951,3650,7301,3650,0,1,3652,664756
168,3650,2800,2300,6440000,2,29206,7303,1,200440000,200440000,10951,3650,7301,3650,0,1,3652,665360

168,4050,2800,2300,6440000,2,32406,8103,1,216760000,216760000,12151,4050,8101,4050,0,1,4052,7394857
168,4050,2800,2300,6440000,2,32406,8103,1,216760000,216760000,12151,4050,8101,4050,0,1,4052,674021
168,4050,2800,2300,6440000,2,32406,8103,1,216760000,216760000,12151,4050,8101,4050,0,1,4052,671115
168,4050,2800,2300,6440000,2,32406,8103,1,216760000,216760000,12151,4050,8101,4050,0,1,4052,691187
168,4050,2800,2300,6440000,2,32406,8103,1,216760000,216760000,12151,4050,8101,4050,0,1,4052,691954
168,4050,2800,2300,6440000,2,32406,8103,1,216760000,216760000,12151,4050,8101,4050,0,1,4052,762520
168,4050,2800,2300,6440000,2,32406,8103,1,216760000,216760000,12151,4050,8101,4050,0,1,4052,764593

168,4450,2800,2300,6440000,2,35606,8903,1,233080000,233080000,13351,4450,8901,4450,0,1,4452,8305683
168,4450,2800,2300,6440000,2,35606,8903,1,233080000,233080000,13351,4450,8901,4450,0,1,4452,750728
168,4450,2800,2300,6440000,2,35606,8903,1,233080000,233080000,13351,4450,8901,4450,0,1,4452,754360
168,4450,2800,2300,6440000,2,35606,8903,1,233080000,233080000,13351,4450,8901,4450,0,1,4452,742845
168,4450,2800,2300,6440000,2,35606,8903,1,233080000,233080000,13351,4450,8901,4450,0,1,4452,741361
168,4450,2800,2300,6440000,2,35606,8903,1,233080000,233080000,13351,4450,8901,4450,0,1,4452,797059
168,4450,2800,2300,6440000,2,35606,8903,1,233080000,233080000,13351,4450,8901,4450,0,1,4452,799058

168,4850,2800,2300,6440000,2,38806,9703,1,249400000,249400000,14551,4850,9701,4850,0,1,4852,8830223
168,4850,2800,2300,6440000,2,38806,9703,1,249400000,249400000,14551,4850,9701,4850,0,1,4852,794505
168,4850,2800,2300,6440000,2,38806,9703,1,249400000,249400000,14551,4850,9701,4850,0,1,4852,793430
168,4850,2800,2300,6440000,2,38806,9703,1,249400000,249400000,14551,4850,9701,4850,0,1,4852,796977
168,4850,2800,2300,6440000,2,38806,9703,1,249400000,249400000,14551,4850,9701,4850,0,1,4852,796073
168,4850,2800,2300,6440000,2,38806,9703,1,249400000,249400000,14551,4850,9701,4850,0,1,4852,853572
168,4850,2800,2300,6440000,2,38806,9703,1,249400000,249400000,14551,4850,9701,4850,0,1,4852,852760

168,5250,2800,2300,6440000,2,42006,10503,1,265720000,265720000,15751,5250,10501,5250,0,1,5252,9664711
168,5250,2800,2300,6440000,2,42006,10503,1,265720000,265720000,15751,5250,10501,5250,0,1,5252,866209
168,5250,2800,2300,6440000,2,42006,10503,1,265720000,265720000,15751,5250,10501,5250,0,1,5252,870464
168,5250,2800,2300,6440000,2,42006,10503,1,265720000,265720000,15751,5250,10501,5250,0,1,5252,874229
168,5250,2800,2300,6440000,2,42006,10503,1,265720000,265720000,15751,5250,10501,5250,0,1,5252,872415
168,5250,2800,2300,6440000,2,42006,10503,1,265720000,265720000,15751,5250,10501,5250,0,1,5252,907211
168,5250,2800,2300,6440000,2,42006,10503,1,265720000,265720000,15751,5250,10501,5250,0,1,5252,906519

168,5650,2800,2300,6440000,2,45206,11303,1,282040000,282040000,16951,5650,11301,5650,0,1,5652,10813510
168,5650,2800,2300,6440000,2,45206,11303,1,282040000,282040000,16951,5650,11301,5650,0,1,5652,910801
168,5650,2800,2300,6440000,2,45206,11303,1,282040000,282040000,16951,5650,11301,5650,0,1,5652,912465
168,5650,2800,2300,6440000,2,45206,11303,1,282040000,282040000,16951,5650,11301,5650,0,1,5652,929348
168,5650,2800,2300,6440000,2,45206,11303,1,282040000,282040000,16951,5650,11301,5650,0,1,5652,925869
168,5650,2800,2300,6440000,2,45206,11303,1,282040000,282040000,16951,5650,11301,5650,0,1,5652,978044
168,5650,2800,2300,6440000,2,45206,11303,1,282040000,282040000,16951,5650,11301,5650,0,1,5652,978746

168,6050,2800,2300,6440000,2,48406,12103,1,298360000,298360000,18151,6050,12101,6050,0,1,6052,11301431
168,6050,2800,2300,6440000,2,48406,12103,1,298360000,298360000,18151,6050,12101,6050,0,1,6052,1025507
168,6050,2800,2300,6440000,2,48406,12103,1,298360000,298360000,18151,6050,12101,6050,0,1,6052,1033222
168,6050,2800,2300,6440000,2,48406,12103,1,298360000,298360000,18151,6050,12101,6050,0,1,6052,1028668
168,6050,2800,2300,6440000,2,48406,12103,1,298360000,298360000,18151,6050,12101,6050,0,1,6052,1022182
168,6050,2800,2300,6440000,2,48406,12103,1,298360000,298360000,18151,6050,12101,6050,0,1,6052,1043248
168,6050,2800,2300,6440000,2,48406,12103,1,298360000,298360000,18151,6050,12101,6050,0,1,6052,1044000

168,6450,2800,2300,6440000,2,51606,12903,1,314680000,314680000,19351,6450,12901,6450,0,1,6452,11687892
168,6450,2800,2300,6440000,2,51606,12903,1,314680000,314680000,19351,6450,12901,6450,0,1,6452,1096380
168,6450,2800,2300,6440000,2,51606,12903,1,314680000,314680000,19351,6450,12901,6450,0,1,6452,1083984
168,6450,2800,2300,6440000,2,51606,12903,1,314680000,314680000,19351,6450,12901,6450,0,1,6452,1087569
168,6450,2800,2300,6440000,2,51606,12903,1,314680000,314680000,19351,6450,12901,6450,0,1,6452,1089997
168,6450,2800,2300,6440000,2,51606,12903,1,314680000,314680000,19351,6450,12901,6450,0,1,6452,1103927
168,6450,2800,2300,6440000,2,51606,12903,1,314680000,314680000,19351,6450,12901,6450,0,1,6452,1102990

168,6850,2800,2300,6440000,2,54806,13703,1,331000000,331000000,20551,6850,13701,6850,0,1,6852,13070354
168,6850,2800,2300,6440000,2,54806,13703,1,331000000,331000000,20551,6850,13701,6850,0,1,6852,1115055
168,6850,2800,2300,6440000,2,54806,13703,1,331000000,331000000,20551,6850,13701,6850,0,1,6852,1107531
168,6850,2800,2300,6440000,2,54806,13703,1,331000000,331000000,20551,6850,13701,6850,0,1,6852,1118604
168,6850,2800,2300,6440000,2,54806,13703,1,331000000,331000000,20551,6850,13701,6850,0,1,6852,1116877
168,6850,2800,2300,6440000,2,54806,13703,1,331000000,331000000,20551,6850,13701,6850,0,1,6852,1141686
168,6850,2800,2300,6440000,2,54806,13703,1,331000000,331000000,20551,6850,13701,6850,0,1,6852,1140911

168,50,2800,1900,5320000,2,406,103,1,44440000,44440000,151,50,101,50,0,1,52,55894
168,50,2800,1900,5320000,2,406,103,1,44440000,44440000,151,50,101,50,0,1,52,53930
168,50,2800,1900,5320000,2,406,103,1,44440000,44440000,151,50,101,50,0,1,52,50155
168,50,2800,1900,5320000,2,406,103,1,44440000,44440000,151,50,101,50,0,1,52,53482
168,50,2800,1900,5320000,2,406,103,1,44440000,44440000,151,50,101,50,0,1,52,45217
168,50,2800,1900,5320000,2,406,103,1,44440000,44440000,151,50,101,50,0,1,52,66718
168,50,2800,1900,5320000,2,406,103,1,44440000,44440000,151,50,101,50,0,1,52,67188

168,450,2800,1900,5320000,2,3606,903,1,59480000,59480000,1351,450,901,450,0,1,452,535291
168,450,2800,1900,5320000,2,3606,903,1,59480000,59480000,1351,450,901,450,0,1,452,105798
168,450,2800,1900,5320000,2,3606,903,1,59480000,59480000,1351,450,901,450,0,1,452,103389
168,450,2800,1900,5320000,2,3606,903,1,59480000,59480000,1351,450,901,450,0,1,452,104352
168,450,2800,1900,5320000,2,3606,903,1,59480000,59480000,1351,450,901,450,0,1,452,105315
168,450,2800,1900,5320000,2,3606,903,1,59480000,59480000,1351,450,901,450,0,1,452,121289
168,450,2800,1900,5320000,2,3606,903,1,59480000,59480000,1351,450,901,450,0,1,452,120762

168,850,2800,1900,5320000,2,6806,1703,1,74520000,74520000,2551,850,1701,850,0,1,852,1131201
168,850,2800,1900,5320000,2,6806,1703,1,74520000,74520000,2551,850,1701,850,0,1,852,158395
168,850,2800,1900,5320000,2,6806,1703,1,74520000,74520000,2551,850,1701,850,0,1,852,160540
168,850,2800,1900,5320000,2,6806,1703,1,74520000,74520000,2551,850,1701,850,0,1,852,160252
168,850,2800,1900,5320000,2,6806,1703,1,74520000,74520000,2551,850,1701,850,0,1,852,159752
168,850,2800,1900,5320000,2,6806,1703,1,74520000,74520000,2551,850,1701,850,0,1,852,176405
168,850,2800,1900,5320000,2,6806,1703,1,74520000,74520000,2551,850,1701,850,0,1,852,177719

168,1250,2800,1900,5320000,2,10006,2503,1,89560000,89560000,3751,1250,2501,1250,0,1,1252,1682174
168,1250,2800,1900,5320000,2,10006,2503,1,89560000,89560000,3751,1250,2501,1250,0,1,1252,221114
168,1250,2800,1900,5320000,2,10006,2503,1,89560000,89560000,3751,1250,2501,1250,0,1,1252,221573
168,1250,2800,1900,5320000,2,10006,2503,1,89560000,89560000,3751,1250,2501,1250,0,1,1252,220231
168,1250,2800,1900,5320000,2,10006,2503,1,89560000,89560000,3751,1250,2501,1250,0,1,1252,219284
168,1250,2800,1900,5320000,2,10006,2503,1,89560000,89560000,3751,1250,2501,1250,0,1,1252,222472
168,1250,2800,1900,5320000,2,10006,2503,1,89560000,89560000,3751,1250,2501,1250,0,1,1252,222921

168,1650,2800,1900,5320000,2,13206,3303,1,104600000,104600000,4951,1650,3301,1650,0,1,1652,2272041
168,1650,2800,1900,5320000,2,13206,3303,1,104600000,104600000,4951,1650,3301,1650,0,1,1652,279025
168,1650,2800,1900,5320000,2,13206,3303,1,104600000,104600000,4951,1650,3301,1650,0,1,1652,278440
168,1650,2800,1900,5320000,2,13206,3303,1,104600000,104600000,4951,1650,3301,1650,0,1,1652,277667
168,1650,2800,1900,5320000,2,13206,3303,1,104600000,104600000,4951,1650,3301,1650,0,1,1652,276824
168,1650,2800,1900,5320000,2,13206,3303,1,104600000,104600000,4951,1650,3301,1650,0,1,1652,278078
168,1650,2800,1900,5320000,2,13206,3303,1,104600000,104600000,4951,1650,3301,1650,0,1,1652,278695

168,2050,2800,1900,5320000,2,16406,4103,1,119640000,119640000,6151,2050,4101,2050,0,1,2052,2866186
168,2050,2800,1900,5320000,2,16406,4103,1,119640000,119640000,6151,2050,4101,2050,0,1,2052,307217
168,2050,2800,1900,5320000,2,16406,4103,1,119640000,119640000,6151,2050,4101,2050,0,1,2052,310436
168,2050,2800,1900,5320000,2,16406,4103,1,119640000,119640000,6151,2050,4101,2050,0,1,2052,343330
168,2050,2800,1900,5320000,2,16406,4103,1,119640000,119640000,6151,2050,4101,2050,0,1,2052,342387
168,2050,2800,1900,5320000,2,16406,4103,1,119640000,119640000,6151,2050,4101,2050,0,1,2052,343714
168,2050,2800,1900,5320000,2,16406,4103,1,119640000,119640000,6151,2050,4101,2050,0,1,2052,343994

168,2450,2800,1900,5320000,2,19606,4903,1,134680000,134680000,7351,2450,4901,2450,0,1,2452,3436306
168,2450,2800,1900,5320000,2,19606,4903,1,134680000,134680000,7351,2450,4901,2450,0,1,2452,389344
168,2450,2800,1900,5320000,2,19606,4903,1,134680000,134680000,7351,2450,4901,2450,0,1,2452,397937
168,2450,2800,1900,5320000,2,19606,4903,1,134680000,134680000,7351,2450,4901,2450,0,1,2452,397120
168,2450,2800,1900,5320000,2,19606,4903,1,134680000,134680000,7351,2450,4901,2450,0,1,2452,396278
168,2450,2800,1900,5320000,2,19606,4903,1,134680000,134680000,7351,2450,4901,2450,0,1,2452,388364
168,2450,2800,1900,5320000,2,19606,4903,1,134680000,134680000,7351,2450,4901,2450,0,1,2452,390487

168,2850,2800,1900,5320000,2,22806,5703,1,149720000,149720000,8551,2850,5701,2850,0,1,2852,4126122
168,2850,2800,1900,5320000,2,22806,5703,1,149720000,149720000,8551,2850,5701,2850,0,1,2852,409850
168,2850,2800,1900,5320000,2,22806,5703,1,149720000,149720000,8551,2850,5701,2850,0,1,2852,408361
168,2850,2800,1900,5320000,2,22806,5703,1,149720000,149720000,8551,2850,5701,2850,0,1,2852,408998
168,2850,2800,1900,5320000,2,22806,5703,1,149720000,149720000,8551,2850,5701,2850,0,1,2852,409405
168,2850,2800,1900,5320000,2,22806,5703,1,149720000,149720000,8551,2850,5701,2850,0,1,2852,435775
168,2850,2800,1900,5320000,2,22806,5703,1,149720000,149720000,8551,2850,5701,2850,0,1,2852,435235

168,3250,2800,1900,5320000,2,26006,6503,1,164760000,164760000,9751,3250,6501,3250,0,1,3252,4918871
168,3250,2800,1900,5320000,2,26006,6503,1,164760000,164760000,9751,3250,6501,3250,0,1,3252,475623
168,3250,2800,1900,5320000,2,26006,6503,1,164760000,164760000,9751,3250,6501,3250,0,1,3252,463907
168,3250,2800,1900,5320000,2,26006,6503,1,164760000,164760000,9751,3250,6501,3250,0,1,3252,460022
168,3250,2800,1900,5320000,2,26006,6503,1,164760000,164760000,9751,3250,6501,3250,0,1,3252,464706
168,3250,2800,1900,5320000,2,26006,6503,1,164760000,164760000,9751,3250,6501,3250,0,1,3252,504251
168,3250,2800,1900,5320000,2,26006,6503,1,164760000,164760000,9751,3250,6501,3250,0,1,3252,503683

168,3650,2800,1900,5320000,2,29206,7303,1,179800000,179800000,10951,3650,7301,3650,0,1,3652,5313504
168,3650,2800,1900,5320000,2,29206,7303,1,179800000,179800000,10951,3650,7301,3650,0,1,3652,517608
168,3650,2800,1900,5320000,2,29206,7303,1,179800000,179800000,10951,3650,7301,3650,0,1,3652,518852
168,3650,2800,1900,5320000,2,29206,7303,1,179800000,179800000,10951,3650,7301,3650,0,1,3652,520945
168,3650,2800,1900,5320000,2,29206,7303,1,179800000,179800000,10951,3650,7301,3650,0,1,3652,520196
168,3650,2800,1900,5320000,2,29206,7303,1,179800000,179800000,10951,3650,7301,3650,0,1,3652,563617
168,3650,2800,1900,5320000,2,29206,7303,1,179800000,179800000,10951,3650,7301,3650,0,1,3652,564210

168,4050,2800,1900,5320000,2,32406,8103,1,194840000,194840000,12151,4050,8101,4050,0,1,4052,6068713
168,4050,2800,1900,5320000,2,32406,8103,1,194840000,194840000,12151,4050,8101,4050,0,1,4052,564377
168,4050,2800,1900,5320000,2,32406,8103,1,194840000,194840000,12151,4050,8101,4050,0,1,4052,567539
168,4050,2800,1900,5320000,2,32406,8103,1,194840000,194840000,12151,4050,8101,4050,0,1,4052,566985
168,4050,2800,1900,5320000,2,32406,8103,1,194840000,194840000,12151,4050,8101,4050,0,1,4052,566270
168,4050,2800,1900,5320000,2,32406,8103,1,194840000,194840000,12151,4050,8101,4050,0,1,4052,620290
168,4050,2800,1900,5320000,2,32406,8103,1,194840000,194840000,12151,4050,8101,4050,0,1,4052,621633

168,4450,2800,1900,5320000,2,35606,8903,1,209880000,209880000,13351,4450,8901,4450,0,1,4452,6748417
168,4450,2800,1900,5320000,2,35606,8903,1,209880000,209880000,13351,4450,8901,4450,0,1,4452,601541
168,4450,2800,1900,5320000,2,35606,8903,1,209880000,209880000,13351,4450,8901,4450,0,1,4452,666972
168,4450,2800,1900,5320000,2,35606,8903,1,209880000,209880000,13351,4450,8901,4450,0,1,4452,604916
168,4450,2800,1900,5320000,2,35606,8903,1,209880000,209880000,13351,4450,8901,4450,0,1,4452,667822
168,4450,2800,1900,5320000,2,35606,8903,1,209880000,209880000,13351,4450,8901,4450,0,1,4452,658505
168,4450,2800,1900,5320000,2,35606,8903,1,209880000,209880000,13351,4450,8901,4450,0,1,4452,661463

168,4850,2800,1900,5320000,2,38806,9703,1,224920000,224920000,14551,4850,9701,4850,0,1,4852,7321385
168,4850,2800,1900,5320000,2,38806,9703,1,224920000,224920000,14551,4850,9701,4850,0,1,4852,762887
168,4850,2800,1900,5320000,2,38806,9703,1,224920000,224920000,14551,4850,9701,4850,0,1,4852,754979
168,4850,2800,1900,5320000,2,38806,9703,1,224920000,224920000,14551,4850,9701,4850,0,1,4852,742047
168,4850,2800,1900,5320000,2,38806,9703,1,224920000,224920000,14551,4850,9701,4850,0,1,4852,756927
168,4850,2800,1900,5320000,2,38806,9703,1,224920000,224920000,14551,4850,9701,4850,0,1,4852,751629
168,4850,2800,1900,5320000,2,38806,9703,1,224920000,224920000,14551,4850,9701,4850,0,1,4852,761055

168,5250,2800,1900,5320000,2,42006,10503,1,239960000,239960000,15751,5250,10501,5250,0,1,5252,7705547
168,5250,2800,1900,5320000,2,42006,10503,1,239960000,239960000,15751,5250,10501,5250,0,1,5252,744151
168,5250,2800,1900,5320000,2,42006,10503,1,239960000,239960000,15751,5250,10501,5250,0,1,5252,762507
168,5250,2800,1900,5320000,2,42006,10503,1,239960000,239960000,15751,5250,10501,5250,0,1,5252,766911
168,5250,2800,1900,5320000,2,42006,10503,1,239960000,239960000,15751,5250,10501,5250,0,1,5252,767833
168,5250,2800,1900,5320000,2,42006,10503,1,239960000,239960000,15751,5250,10501,5250,0,1,5252,815232
168,5250,2800,1900,5320000,2,42006,10503,1,239960000,239960000,15751,5250,10501,5250,0,1,5252,814550

168,5650,2800,1900,5320000,2,45206,11303,1,255000000,255000000,16951,5650,11301,5650,0,1,5652,8143319
168,5650,2800,1900,5320000,2,45206,11303,1,255000000,255000000,16951,5650,11301,5650,0,1,5652,781370
168,5650,2800,1900,5320000,2,45206,11303,1,255000000,255000000,16951,5650,11301,5650,0,1,5652,777499
168,5650,2800,1900,5320000,2,45206,11303,1,255000000,255000000,16951,5650,11301,5650,0,1,5652,778321
168,5650,2800,1900,5320000,2,45206,11303,1,255000000,255000000,16951,5650,11301,5650,0,1,5652,779315
168,5650,2800,1900,5320000,2,45206,11303,1,255000000,255000000,16951,5650,11301,5650,0,1,5652,829580
168,5650,2800,1900,5320000,2,45206,11303,1,255000000,255000000,16951,5650,11301,5650,0,1,5652,831063

168,6050,2800,1900,5320000,2,48406,12103,1,270040000,270040000,18151,6050,12101,6050,0,1,6052,9255969
168,6050,2800,1900,5320000,2,48406,12103,1,270040000,270040000,18151,6050,12101,6050,0,1,6052,842497
168,6050,2800,1900,5320000,2,48406,12103,1,270040000,270040000,18151,6050,12101,6050,0,1,6052,839360
168,6050,2800,1900,5320000,2,48406,12103,1,270040000,270040000,18151,6050,12101,6050,0,1,6052,846046
168,6050,2800,1900,5320000,2,48406,12103,1,270040000,270040000,18151,6050,12101,6050,0,1,6052,848162
168,6050,2800,1900,5320000,2,48406,12103,1,270040000,270040000,18151,6050,12101,6050,0,1,6052,877542
168,6050,2800,1900,5320000,2,48406,12103,1,270040000,270040000,18151,6050,12101,6050,0,1,6052,879103

168,6450,2800,1900,5320000,2,51606,12903,1,285080000,285080000,19351,6450,12901,6450,0,1,6452,9665987
168,6450,2800,1900,5320000,2,51606,12903,1,285080000,285080000,19351,6450,12901,6450,0,1,6452,900977
168,6450,2800,1900,5320000,2,51606,12903,1,285080000,285080000,19351,6450,12901,6450,0,1,6452,914041
168,6450,2800,1900,5320000,2,51606,12903,1,285080000,285080000,19351,6450,12901,6450,0,1,6452,912308
168,6450,2800,1900,5320000,2,51606,12903,1,285080000,285080000,19351,6450,12901,6450,0,1,6452,910440
168,6450,2800,1900,5320000,2,51606,12903,1,285080000,285080000,19351,6450,12901,6450,0,1,6452,933685
168,6450,2800,1900,5320000,2,51606,12903,1,285080000,285080000,19351,6450,12901,6450,0,1,6452,932904

168,6850,2800,1900,5320000,2,54806,13703,1,300120000,300120000,20551,6850,13701,6850,0,1,6852,10825342
168,6850,2800,1900,5320000,2,54806,13703,1,300120000,300120000,20551,6850,13701,6850,0,1,6852,947842
168,6850,2800,1900,5320000,2,54806,13703,1,300120000,300120000,20551,6850,13701,6850,0,1,6852,946122
168,6850,2800,1900,5320000,2,54806,13703,1,300120000,300120000,20551,6850,13701,6850,0,1,6852,974741
168,6850,2800,1900,5320000,2,54806,13703,1,300120000,300120000,20551,6850,13701,6850,0,1,6852,978918
168,6850,2800,1900,5320000,2,54806,13703,1,300120000,300120000,20551,6850,13701,6850,0,1,6852,1003867
168,6850,2800,1900,5320000,2,54806,13703,1,300120000,300120000,20551,6850,13701,6850,0,1,6852,1003093

168,50,2800,1500,4200000,2,406,103,1,35320000,35320000,151,50,101,50,0,1,52,42982
168,50,2800,1500,4200000,2,406,103,1,35320000,35320000,151,50,101,50,0,1,52,45083
168,50,2800,1500,4200000,2,406,103,1,35320000,35320000,151,50,101,50,0,1,52,44649
168,50,2800,1500,4200000,2,406,103,1,35320000,35320000,151,50,101,50,0,1,52,36499
168,50,2800,1500,4200000,2,406,103,1,35320000,35320000,151,50,101,50,0,1,52,42586
168,50,2800,1500,4200000,2,406,103,1,35320000,35320000,151,50,101,50,0,1,52,55255
168,50,2800,1500,4200000,2,406,103,1,35320000,35320000,151,50,101,50,0,1,52,54776

168,450,2800,1500,4200000,2,3606,903,1,49080000,49080000,1351,450,901,450,0,1,452,449174
168,450,2800,1500,4200000,2,3606,903,1,49080000,49080000,1351,450,901,450,0,1,452,97488
168,450,2800,1500,4200000,2,3606,903,1,49080000,49080000,1351,450,901,450,0,1,452,97965
168,450,2800,1500,4200000,2,3606,903,1,49080000,49080000,1351,450,901,450,0,1,452,94048
168,450,2800,1500,4200000,2,3606,903,1,49080000,49080000,1351,450,901,450,0,1,452,95401
168,450,2800,1500,4200000,2,3606,903,1,49080000,49080000,1351,450,901,450,0,1,452,111370
168,450,2800,1500,4200000,2,3606,903,1,49080000,49080000,1351,450,901,450,0,1,452,110853

168,850,2800,1500,4200000,2,6806,1703,1,62840000,62840000,2551,850,1701,850,0,1,852,895583
168,850,2800,1500,4200000,2,6806,1703,1,62840000,62840000,2551,850,1701,850,0,1,852,129490
168,850,2800,1500,4200000,2,6806,1703,1,62840000,62840000,2551,850,1701,850,0,1,852,130091
168,850,2800,1500,4200000,2,6806,1703,1,62840000,62840000,2551,850,1701,850,0,1,852,130880
168,850,2800,1500,4200000,2,6806,1703,1,62840000,62840000,2551,850,1701,850,0,1,852,130592
168,850,2800,1500,4200000,2,6806,1703,1,62840000,62840000,2551,850,1701,850,0,1,852,145683
168,850,2800,1500,4200000,2,6806,1703,1,62840000,62840000,2551,850,1701,850,0,1,852,145108

168,1250,2800,1500,4200000,2,10006,2503,1,76600000,76600000,3751,1250,2501,1250,0,1,1252,1306646
168,1250,2800,1500,4200000,2,10006,2503,1,76600000,76600000,3751,1250,2501,1250,0,1,1252,172604
168,1250,2800,1500,4200000,2,10006,2503,1,76600000,76600000,3751,1250,2501,1250,0,1,1252,172066
168,1250,2800,1500,4200000,2,10006,2503,1,76600000,76600000,3751,1250,2501,1250,0,1,1252,171432
168,1250,2800,1500,4200000,2,10006,2503,1,76600000,76600000,3751,1250,2501,1250,0,1,1252,172947
168,1250,2800,1500,4200000,2,10006,2503,1,76600000,76600000,3751,1250,2501,1250,0,1,1252,190613
168,1250,2800,1500,4200000,2,10006,2503,1,76600000,76600000,3751,1250,2501,1250,0,1,1252,189996

168,1650,2800,1500,4200000,2,13206,3303,1,90360000,90360000,4951,1650,3301,1650,0,1,1652,1784232
168,1650,2800,1500,4200000,2,13206,3303,1,90360000,90360000,4951,1650,3301,1650,0,1,1652,226288
168,1650,2800,1500,4200000,2,13206,3303,1,90360000,90360000,4951,1650,3301,1650,0,1,1652,228962
168,1650,2800,1500,4200000,2,13206,3303,1,90360000,90360000,4951,1650,3301,1650,0,1,1652,229973
168,1650,2800,1500,4200000,2,13206,3303,1,90360000,90360000,4951,1650,3301,1650,0,1,1652,220669
168,1650,2800,1500,4200000,2,13206,3303,1,90360000,90360000,4951,1650,3301,1650,0,1,1652,229644
168,1650,2800,1500,4200000,2,13206,3303,1,90360000,90360000,4951,1650,3301,1650,0,1,1652,229386

168,2050,2800,1500,4200000,2,16406,4103,1,104120000,104120000,6151,2050,4101,2050,0,1,2052,2257647
168,2050,2800,1500,4200000,2,16406,4103,1,104120000,104120000,6151,2050,4101,2050,0,1,2052,270988
168,2050,2800,1500,4200000,2,16406,4103,1,104120000,104120000,6151,2050,4101,2050,0,1,2052,271350
168,2050,2800,1500,4200000,2,16406,4103,1,104120000,104120000,6151,2050,4101,2050,0,1,2052,270655
168,2050,2800,1500,4200000,2,16406,4103,1,104120000,104120000,6151,2050,4101,2050,0,1,2052,268403
168,2050,2800,1500,4200000,2,16406,4103,1,104120000,104120000,6151,2050,4101,2050,0,1,2052,269227
168,2050,2800,1500,4200000,2,16406,4103,1,104120000,104120000,6151,2050,4101,2050,0,1,2052,270172

168,2450,2800,1500,4200000,2,19606,4903,1,117880000,117880000,7351,2450,4901,2450,0,1,2452,2708533
168,2450,2800,1500,4200000,2,19606,4903,1,117880000,117880000,7351,2450,4901,2450,0,1,2452,318479
168,2450,2800,1500,4200000,2,19606,4903,1,117880000,117880000,7351,2450,4901,2450,0,1,2452,321661
168,2450,2800,1500,4200000,2,19606,4903,1,117880000,117880000,7351,2450,4901,2450,0,1,2452,312141
168,2450,2800,1500,4200000,2,19606,4903,1,117880000,117880000,7351,2450,4901,2450,0,1,2452,311106
168,2450,2800,1500,4200000,2,19606,4903,1,117880000,117880000,7351,2450,4901,2450,0,1,2452,314522
168,2450,2800,1500,4200000,2,19606,4903,1,117880000,117880000,7351,2450,4901,2450,0,1,2452,315177

168,2850,2800,1500,4200000,2,22806,5703,1,131640000,131640000,8551,2850,5701,2850,0,1,2852,3215674
168,2850,2800,1500,4200000,2,22806,5703,1,131640000,131640000,8551,2850,5701,2850,0,1,2852,358180
168,2850,2800,1500,4200000,2,22806,5703,1,131640000,131640000,8551,2850,5701,2850,0,1,2852,360356
168,2850,2800,1500,4200000,2,22806,5703,1,131640000,131640000,8551,2850,5701,2850,0,1,2852,359550
168,2850,2800,1500,4200000,2,22806,5703,1,131640000,131640000,8551,2850,5701,2850,0,1,2852,356120
168,2850,2800,1500,4200000,2,22806,5703,1,131640000,131640000,8551,2850,5701,2850,0,1,2852,361565
168,2850,2800,1500,4200000,2,22806,5703,1,131640000,131640000,8551,2850,5701,2850,0,1,2852,362113

168,3250,2800,1500,4200000,2,26006,6503,1,145400000,145400000,9751,3250,6501,3250,0,1,3252,3773222
168,3250,2800,1500,4200000,2,26006,6503,1,145400000,145400000,9751,3250,6501,3250,0,1,3252,383921
168,3250,2800,1500,4200000,2,26006,6503,1,145400000,145400000,9751,3250,6501,3250,0,1,3252,380985
168,3250,2800,1500,4200000,2,26006,6503,1,145400000,145400000,9751,3250,6501,3250,0,1,3252,382974
168,3250,2800,1500,4200000,2,26006,6503,1,145400000,145400000,9751,3250,6501,3250,0,1,3252,381748
168,3250,2800,1500,4200000,2,26006,6503,1,145400000,145400000,9751,3250,6501,3250,0,1,3252,405020
168,3250,2800,1500,4200000,2,26006,6503,1,145400000,145400000,9751,3250,6501,3250,0,1,3252,404455

168,3650,2800,1500,4200000,2,29206,7303,1,159160000,159160000,10951,3650,7301,3650,0,1,3652,4171210
168,3650,2800,1500,4200000,2,29206,7303,1,159160000,159160000,10951,3650,7301,3650,0,1,3652,421507
168,3650,2800,1500,4200000,2,29206,7303,1,159160000,159160000,10951,3650,7301,3650,0,1,3652,422700
168,3650,2800,1500,4200000,2,29206,7303,1,159160000,159160000,10951,3650,7301,3650,0,1,3652,422183
168,3650,2800,1500,4200000,2,29206,7303,1,159160000,159160000,10951,3650,7301,3650,0,1,3652,420791
168,3650,2800,1500,4200000,2,29206,7303,1,159160000,159160000,10951,3650,7301,3650,0,1,3652,457227
168,3650,2800,1500,4200000,2,29206,7303,1,159160000,159160000,10951,3650,7301,3650,0,1,3652,457814

168,4050,2800,1500,4200000,2,32406,8103,1,172920000,172920000,12151,4050,8101,4050,0,1,4052,4672976
168,4050,2800,1500,4200000,2,32406,8103,1,172920000,172920000,12151,4050,8101,4050,0,1,4052,466610
168,4050,2800,1500,4200000,2,32406,8103,1,172920000,172920000,12151,4050,8101,4050,0,1,4052,466052
168,4050,2800,1500,4200000,2,32406,8103,1,172920000,172920000,12151,4050,8101,4050,0,1,4052,465335
168,4050,2800,1500,4200000,2,32406,8103,1,172920000,172920000,12151,4050,8101,4050,0,1,4052,463811
168,4050,2800,1500,4200000,2,32406,8103,1,172920000,172920000,12151,4050,8101,4050,0,1,4052,502562
168,4050,2800,1500,4200000,2,32406,8103,1,172920000,172920000,12151,4050,8101,4050,0,1,4052,501946

168,4450,2800,1500,4200000,2,35606,8903,1,186680000,186680000,13351,4450,8901,4450,0,1,4452,5310222
168,4450,2800,1500,4200000,2,35606,8903,1,186680000,186680000,13351,4450,8901,4450,0,1,4452,502340
168,4450,2800,1500,4200000,2,35606,8903,1,186680000,186680000,13351,4450,8901,4450,0,1,4452,501571
168,4450,2800,1500,4200000,2,35606,8903,1,186680000,186680000,13351,4450,8901,4450,0,1,4452,503091
168,4450,2800,1500,4200000,2,35606,8903,1,186680000,186680000,13351,4450,8901,4450,0,1,4452,503711
168,4450,2800,1500,4200000,2,35606,8903,1,186680000,186680000,13351,4450,8901,4450,0,1,4452,556074
168,4450,2800,1500,4200000,2,35606,8903,1,186680000,186680000,13351,4450,8901,4450,0,1,4452,555448

168,4850,2800,1500,4200000,2,38806,9703,1,200440000,200440000,14551,4850,9701,4850,0,1,4852,5877153
168,4850,2800,1500,4200000,2,38806,9703,1,200440000,200440000,14551,4850,9701,4850,0,1,4852,553057
168,4850,2800,1500,4200000,2,38806,9703,1,200440000,200440000,14551,4850,9701,4850,0,1,4852,553834
168,4850,2800,1500,4200000,2,38806,9703,1,200440000,200440000,14551,4850,9701,4850,0,1,4852,554462
168,4850,2800,1500,4200000,2,38806,9703,1,200440000,200440000,14551,4850,9701,4850,0,1,4852,552263
168,4850,2800,1500,4200000,2,38806,9703,1,200440000,200440000,14551,4850,9701,4850,0,1,4852,618834
168,4850,2800,1500,4200000,2,38806,9703,1,200440000,200440000,14551,4850,9701,4850,0,1,4852,619506

168,5250,2800,1500,4200000,2,42006,10503,1,214200000,214200000,15751,5250,10501,5250,0,1,5252,6281915
168,5250,2800,1500,4200000,2,42006,10503,1,214200000,214200000,15751,5250,10501,5250,0,1,5252,591288
168,5250,2800,1500,4200000,2,42006,10503,1,214200000,214200000,15751,5250,10501,5250,0,1,5252,589810
168,5250,2800,1500,4200000,2,42006,10503,1,214200000,214200000,15751,5250,10501,5250,0,1,5252,613877
168,5250,2800,1500,4200000,2,42006,10503,1,214200000,214200000,15751,5250,10501,5250,0,1,5252,612101
168,5250,2800,1500,4200000,2,42006,10503,1,214200000,214200000,15751,5250,10501,5250,0,1,5252,690396
168,5250,2800,1500,4200000,2,42006,10503,1,214200000,214200000,15751,5250,10501,5250,0,1,5252,691074

168,5650,2800,1500,4200000,2,45206,11303,1,227960000,227960000,16951,5650,11301,5650,0,1,5652,6864371
168,5650,2800,1500,4200000,2,45206,11303,1,227960000,227960000,16951,5650,11301,5650,0,1,5652,633701
168,5650,2800,1500,4200000,2,45206,11303,1,227960000,227960000,16951,5650,11301,5650,0,1,5652,632118
168,5650,2800,1500,4200000,2,45206,11303,1,227960000,227960000,16951,5650,11301,5650,0,1,5652,632966
168,5650,2800,1500,4200000,2,45206,11303,1,227960000,227960000,16951,5650,11301,5650,0,1,5652,631267
168,5650,2800,1500,4200000,2,45206,11303,1,227960000,227960000,16951,5650,11301,5650,0,1,5652,696296
168,5650,2800,1500,4200000,2,45206,11303,1,227960000,227960000,16951,5650,11301,5650,0,1,5652,697124

168,6050,2800,1500,4200000,2,48406,12103,1,241720000,241720000,18151,6050,12101,6050,0,1,6052,7031244
168,6050,2800,1500,4200000,2,48406,12103,1,241720000,241720000,18151,6050,12101,6050,0,1,6052,708069
168,6050,2800,1500,4200000,2,48406,12103,1,241720000,241720000,18151,6050,12101,6050,0,1,6052,720125
168,6050,2800,1500,4200000,2,48406,12103,1,241720000,241720000,18151,6050,12101,6050,0,1,6052,696686
168,6050,2800,1500,4200000,2,48406,12103,1,241720000,241720000,18151,6050,12101,6050,0,1,6052,698520
168,6050,2800,1500,4200000,2,48406,12103,1,241720000,241720000,18151,6050,12101,6050,0,1,6052,742594
168,6050,2800,1500,4200000,2,48406,12103,1,241720000,241720000,18151,6050,12101,6050,0,1,6052,743319

168,6450,2800,1500,4200000,2,51606,12903,1,255480000,255480000,19351,6450,12901,6450,0,1,6452,7894984
168,6450,2800,1500,4200000,2,51606,12903,1,255480000,255480000,19351,6450,12901,6450,0,1,6452,729942
168,6450,2800,1500,4200000,2,51606,12903,1,255480000,255480000,19351,6450,12901,6450,0,1,6452,731835
168,6450,2800,1500,4200000,2,51606,12903,1,255480000,255480000,19351,6450,12901,6450,0,1,6452,727813
168,6450,2800,1500,4200000,2,51606,12903,1,255480000,255480000,19351,6450,12901,6450,0,1,6452,730864
168,6450,2800,1500,4200000,2,51606,12903,1,255480000,255480000,19351,6450,12901,6450,0,1,6452,771313
168,6450,2800,1500,4200000,2,51606,12903,1,255480000,255480000,19351,6450,12901,6450,0,1,6452,772091

168,6850,2800,1500,4200000,2,54806,13703,1,269240000,269240000,20551,6850,13701,6850,0,1,6852,8430470
168,6850,2800,1500,4200000,2,54806,13703,1,269240000,269240000,20551,6850,13701,6850,0,1,6852,759834
168,6850,2800,1500,4200000,2,54806,13703,1,269240000,269240000,20551,6850,13701,6850,0,1,6852,757919
168,6850,2800,1500,4200000,2,54806,13703,1,269240000,269240000,20551,6850,13701,6850,0,1,6852,756336
168,6850,2800,1500,4200000,2,54806,13703,1,269240000,269240000,20551,6850,13701,6850,0,1,6852,758779
168,6850,2800,1500,4200000,2,54806,13703,1,269240000,269240000,20551,6850,13701,6850,0,1,6852,807939
168,6850,2800,1500,4200000,2,54806,13703,1,269240000,269240000,20551,6850,13701,6850,0,1,6852,809516

168,50,2800,1100,3080000,2,406,103,1,26200000,26200000,151,50,101,50,0,1,52,32009
168,50,2800,1100,3080000,2,406,103,1,26200000,26200000,151,50,101,50,0,1,52,34655
168,50,2800,1100,3080000,2,406,103,1,26200000,26200000,151,50,101,50,0,1,52,35985
168,50,2800,1100,3080000,2,406,103,1,26200000,26200000,151,50,101,50,0,1,52,35360
168,50,2800,1100,3080000,2,406,103,1,26200000,26200000,151,50,101,50,0,1,52,29039
168,50,2800,1100,3080000,2,406,103,1,26200000,26200000,151,50,101,50,0,1,52,40827
168,50,2800,1100,3080000,2,406,103,1,26200000,26200000,151,50,101,50,0,1,52,44378

168,450,2800,1100,3080000,2,3606,903,1,38680000,38680000,1351,450,901,450,0,1,452,319964
168,450,2800,1100,3080000,2,3606,903,1,38680000,38680000,1351,450,901,450,0,1,452,64395
168,450,2800,1100,3080000,2,3606,903,1,38680000,38680000,1351,450,901,450,0,1,452,60141
168,450,2800,1100,3080000,2,3606,903,1,38680000,38680000,1351,450,901,450,0,1,452,67004
168,450,2800,1100,3080000,2,3606,903,1,38680000,38680000,1351,450,901,450,0,1,452,65863
168,450,2800,1100,3080000,2,3606,903,1,38680000,38680000,1351,450,901,450,0,1,452,76942
168,450,2800,1100,3080000,2,3606,903,1,38680000,38680000,1351,450,901,450,0,1,452,76420

168,850,2800,1100,3080000,2,6806,1703,1,51160000,51160000,2551,850,1701,850,0,1,852,650815
168,850,2800,1100,3080000,2,6806,1703,1,51160000,51160000,2551,850,1701,850,0,1,852,96028
168,850,2800,1100,3080000,2,6806,1703,1,51160000,51160000,2551,850,1701,850,0,1,852,96286
168,850,2800,1100,3080000,2,6806,1703,1,51160000,51160000,2551,850,1701,850,0,1,852,95396
168,850,2800,1100,3080000,2,6806,1703,1,51160000,51160000,2551,850,1701,850,0,1,852,97012
168,850,2800,1100,3080000,2,6806,1703,1,51160000,51160000,2551,850,1701,850,0,1,852,111204
168,850,2800,1100,3080000,2,6806,1703,1,51160000,51160000,2551,850,1701,850,0,1,852,110625

168,1250,2800,1100,3080000,2,10006,2503,1,63640000,63640000,3751,1250,2501,1250,0,1,1252,965866
168,1250,2800,1100,3080000,2,10006,2503,1,63640000,63640000,3751,1250,2501,1250,0,1,1252,134417
168,1250,2800,1100,3080000,2,10006,2503,1,63640000,63640000,3751,1250,2501,1250,0,1,1252,133830
168,1250,2800,1100,3080000,2,10006,2503,1,63640000,63640000,3751,1250,2501,1250,0,1,1252,127442
168,1250,2800,1100,3080000,2,10006,2503,1,63640000,63640000,3751,1250,2501,1250,0,1,1252,132758
168,1250,2800,1100,3080000,2,10006,2503,1,63640000,63640000,3751,1250,2501,1250,0,1,1252,148182
168,1250,2800,1100,3080000,2,10006,2503,1,63640000,63640000,3751,1250,2501,1250,0,1,1252,148793

168,1650,2800,1100,3080000,2,13206,3303,1,76120000,76120000,4951,1650,3301,1650,0,1,1652,1268573
168,1650,2800,1100,3080000,2,13206,3303,1,76120000,76120000,4951,1650,3301,1650,0,1,1652,169416
168,1650,2800,1100,3080000,2,13206,3303,1,76120000,76120000,4951,1650,3301,1650,0,1,1652,168806
168,1650,2800,1100,3080000,2,13206,3303,1,76120000,76120000,4951,1650,3301,1650,0,1,1652,168094
168,1650,2800,1100,3080000,2,13206,3303,1,76120000,76120000,4951,1650,3301,1650,0,1,1652,163352
168,1650,2800,1100,3080000,2,13206,3303,1,76120000,76120000,4951,1650,3301,1650,0,1,1652,185433
168,1650,2800,1100,3080000,2,13206,3303,1,76120000,76120000,4951,1650,3301,1650,0,1,1652,186089

168,2050,2800,1100,3080000,2,16406,4103,1,88600000,88600000,6151,2050,4101,2050,0,1,2052,1580121
168,2050,2800,1100,3080000,2,16406,4103,1,88600000,88600000,6151,2050,4101,2050,0,1,2052,207842
168,2050,2800,1100,3080000,2,16406,4103,1,88600000,88600000,6151,2050,4101,2050,0,1,2052,207000
168,2050,2800,1100,3080000,2,16406,4103,1,88600000,88600000,6151,2050,4101,2050,0,1,2052,205989
168,2050,2800,1100,3080000,2,16406,4103,1,88600000,88600000,6151,2050,4101,2050,0,1,2052,198634
168,2050,2800,1100,3080000,2,16406,4103,1,88600000,88600000,6151,2050,4101,2050,0,1,2052,210723
168,2050,2800,1100,3080000,2,16406,4103,1,88600000,88600000,6151,2050,4101,2050,0,1,2052,210230

168,2450,2800,1100,3080000,2,19606,4903,1,101080000,101080000,7351,2450,4901,2450,0,1,2452,1929638
168,2450,2800,1100,3080000,2,19606,4903,1,101080000,101080000,7351,2450,4901,2450,0,1,2452,237757
168,2450,2800,1100,3080000,2,19606,4903,1,101080000,101080000,7351,2450,4901,2450,0,1,2452,241245
168,2450,2800,1100,3080000,2,19606,4903,1,101080000,101080000,7351,2450,4901,2450,0,1,2452,239506
168,2450,2800,1100,3080000,2,19606,4903,1,101080000,101080000,7351,2450,4901,2450,0,1,2452,240562
168,2450,2800,1100,3080000,2,19606,4903,1,101080000,101080000,7351,2450,4901,2450,0,1,2452,242189
168,2450,2800,1100,3080000,2,19606,4903,1,101080000,101080000,7351,2450,4901,2450,0,1,2452,242709

168,2850,2800,1100,3080000,2,22806,5703,1,113560000,113560000,8551,2850,5701,2850,0,1,2852,2248698
168,2850,2800,1100,3080000,2,22806,5703,1,113560000,113560000,8551,2850,5701,2850,0,1,2852,271744
168,2850,2800,1100,3080000,2,22806,5703,1,113560000,113560000,8551,2850,5701,2850,0,1,2852,274140
168,2850,2800,1100,3080000,2,22806,5703,1,113560000,113560000,8551,2850,5701,2850,0,1,2852,273010
168,2850,2800,1100,3080000,2,22806,5703,1,113560000,113560000,8551,2850,5701,2850,0,1,2852,268662
168,2850,2800,1100,3080000,2,22806,5703,1,113560000,113560000,8551,2850,5701,2850,0,1,2852,276228
168,2850,2800,1100,3080000,2,22806,5703,1,113560000,113560000,8551,2850,5701,2850,0,1,2852,276773

168,3250,2800,1100,3080000,2,26006,6503,1,126040000,126040000,9751,3250,6501,3250,0,1,3252,2760188
168,3250,2800,1100,3080000,2,26006,6503,1,126040000,126040000,9751,3250,6501,3250,0,1,3252,293753
168,3250,2800,1100,3080000,2,26006,6503,1,126040000,126040000,9751,3250,6501,3250,0,1,3252,292726
168,3250,2800,1100,3080000,2,26006,6503,1,126040000,126040000,9751,3250,6501,3250,0,1,3252,310348
168,3250,2800,1100,3080000,2,26006,6503,1,126040000,126040000,9751,3250,6501,3250,0,1,3252,308997
168,3250,2800,1100,3080000,2,26006,6503,1,126040000,126040000,9751,3250,6501,3250,0,1,3252,325324
168,3250,2800,1100,3080000,2,26006,6503,1,126040000,126040000,9751,3250,6501,3250,0,1,3252,324761

168,3650,2800,1100,3080000,2,29206,7303,1,138520000,138520000,10951,3650,7301,3650,0,1,3652,2924185
168,3650,2800,1100,3080000,2,29206,7303,1,138520000,138520000,10951,3650,7301,3650,0,1,3652,345221
168,3650,2800,1100,3080000,2,29206,7303,1,138520000,138520000,10951,3650,7301,3650,0,1,3652,336655
168,3650,2800,1100,3080000,2,29206,7303,1,138520000,138520000,10951,3650,7301,3650,0,1,3652,349284
168,3650,2800,1100,3080000,2,29206,7303,1,138520000,138520000,10951,3650,7301,3650,0,1,3652,347770
168,3650,2800,1100,3080000,2,29206,7303,1,138520000,138520000,10951,3650,7301,3650,0,1,3652,353495
168,3650,2800,1100,3080000,2,29206,7303,1,138520000,138520000,10951,3650,7301,3650,0,1,3652,352899

168,4050,2800,1100,3080000,2,32406,8103,1,151000000,151000000,12151,4050,8101,4050,0,1,4052,3137887
168,4050,2800,1100,3080000,2,32406,8103,1,151000000,151000000,12151,4050,8101,4050,0,1,4052,362105
168,4050,2800,1100,3080000,2,32406,8103,1,151000000,151000000,12151,4050,8101,4050,0,1,4052,359699
168,4050,2800,1100,3080000,2,32406,8103,1,151000000,151000000,12151,4050,8101,4050,0,1,4052,364801
168,4050,2800,1100,3080000,2,32406,8103,1,151000000,151000000,12151,4050,8101,4050,0,1,4052,363365
168,4050,2800,1100,3080000,2,32406,8103,1,151000000,151000000,12151,4050,8101,4050,0,1,4052,380255
168,4050,2800,1100,3080000,2,32406,8103,1,151000000,151000000,12151,4050,8101,4050,0,1,4052,379632

168,4450,2800,1100,3080000,2,35606,8903,1,163480000,163480000,13351,4450,8901,4450,0,1,4452,3732259
168,4450,2800,1100,3080000,2,35606,8903,1,163480000,163480000,13351,4450,8901,4450,0,1,4452,408648
168,4450,2800,1100,3080000,2,35606,8903,1,163480000,163480000,13351,4450,8901,4450,0,1,4452,414220
168,4450,2800,1100,3080000,2,35606,8903,1,163480000,163480000,13351,4450,8901,4450,0,1,4452,401957
168,4450,2800,1100,3080000,2,35606,8903,1,163480000,163480000,13351,4450,8901,4450,0,1,4452,400597
168,4450,2800,1100,3080000,2,35606,8903,1,163480000,163480000,13351,4450,8901,4450,0,1,4452,435994
168,4450,2800,1100,3080000,2,35606,8903,1,163480000,163480000,13351,4450,8901,4450,0,1,4452,436638

168,4850,2800,1100,3080000,2,38806,9703,1,175960000,175960000,14551,4850,9701,4850,0,1,4852,3755034
168,4850,2800,1100,3080000,2,38806,9703,1,175960000,175960000,14551,4850,9701,4850,0,1,4852,418968
168,4850,2800,1100,3080000,2,38806,9703,1,175960000,175960000,14551,4850,9701,4850,0,1,4852,426197
168,4850,2800,1100,3080000,2,38806,9703,1,175960000,175960000,14551,4850,9701,4850,0,1,4852,421600
168,4850,2800,1100,3080000,2,38806,9703,1,175960000,175960000,14551,4850,9701,4850,0,1,4852,425336
168,4850,2800,1100,3080000,2,38806,9703,1,175960000,175960000,14551,4850,9701,4850,0,1,4852,468384
168,4850,2800,1100,3080000,2,38806,9703,1,175960000,175960000,14551,4850,9701,4850,0,1,4852,469813

168,5250,2800,1100,3080000,2,42006,10503,1,188440000,188440000,15751,5250,10501,5250,0,1,5252,4342439
168,5250,2800,1100,3080000,2,42006,10503,1,188440000,188440000,15751,5250,10501,5250,0,1,5252,459916
168,5250,2800,1100,3080000,2,42006,10503,1,188440000,188440000,15751,5250,10501,5250,0,1,5252,463647
168,5250,2800,1100,3080000,2,42006,10503,1,188440000,188440000,15751,5250,10501,5250,0,1,5252,455495
168,5250,2800,1100,3080000,2,42006,10503,1,188440000,188440000,15751,5250,10501,5250,0,1,5252,462715
168,5250,2800,1100,3080000,2,42006,10503,1,188440000,188440000,15751,5250,10501,5250,0,1,5252,507002
168,5250,2800,1100,3080000,2,42006,10503,1,188440000,188440000,15751,5250,10501,5250,0,1,5252,506308

168,5650,2800,1100,3080000,2,45206,11303,1,200920000,200920000,16951,5650,11301,5650,0,1,5652,4716930
168,5650,2800,1100,3080000,2,45206,11303,1,200920000,200920000,16951,5650,11301,5650,0,1,5652,493356
168,5650,2800,1100,3080000,2,45206,11303,1,200920000,200920000,16951,5650,11301,5650,0,1,5652,490962
168,5650,2800,1100,3080000,2,45206,11303,1,200920000,200920000,16951,5650,11301,5650,0,1,5652,492652
168,5650,2800,1100,3080000,2,45206,11303,1,200920000,200920000,16951,5650,11301,5650,0,1,5652,491811
168,5650,2800,1100,3080000,2,45206,11303,1,200920000,200920000,16951,5650,11301,5650,0,1,5652,553887
168,5650,2800,1100,3080000,2,45206,11303,1,200920000,200920000,16951,5650,11301,5650,0,1,5652,555449

168,6050,2800,1100,3080000,2,48406,12103,1,213400000,213400000,18151,6050,12101,6050,0,1,6052,4974960
168,6050,2800,1100,3080000,2,48406,12103,1,213400000,213400000,18151,6050,12101,6050,0,1,6052,522234
168,6050,2800,1100,3080000,2,48406,12103,1,213400000,213400000,18151,6050,12101,6050,0,1,6052,521494
168,6050,2800,1100,3080000,2,48406,12103,1,213400000,213400000,18151,6050,12101,6050,0,1,6052,524413
168,6050,2800,1100,3080000,2,48406,12103,1,213400000,213400000,18151,6050,12101,6050,0,1,6052,523277
168,6050,2800,1100,3080000,2,48406,12103,1,213400000,213400000,18151,6050,12101,6050,0,1,6052,589977
168,6050,2800,1100,3080000,2,48406,12103,1,213400000,213400000,18151,6050,12101,6050,0,1,6052,589257

168,6450,2800,1100,3080000,2,51606,12903,1,225880000,225880000,19351,6450,12901,6450,0,1,6452,5559037
168,6450,2800,1100,3080000,2,51606,12903,1,225880000,225880000,19351,6450,12901,6450,0,1,6452,550740
168,6450,2800,1100,3080000,2,51606,12903,1,225880000,225880000,19351,6450,12901,6450,0,1,6452,550050
168,6450,2800,1100,3080000,2,51606,12903,1,225880000,225880000,19351,6450,12901,6450,0,1,6452,551918
168,6450,2800,1100,3080000,2,51606,12903,1,225880000,225880000,19351,6450,12901,6450,0,1,6452,548974
168,6450,2800,1100,3080000,2,51606,12903,1,225880000,225880000,19351,6450,12901,6450,0,1,6452,618708
168,6450,2800,1100,3080000,2,51606,12903,1,225880000,225880000,19351,6450,12901,6450,0,1,6452,617940

168,6850,2800,1100,3080000,2,54806,13703,1,238360000,238360000,20551,6850,13701,6850,0,1,6852,5881799
168,6850,2800,1100,3080000,2,54806,13703,1,238360000,238360000,20551,6850,13701,6850,0,1,6852,583202
168,6850,2800,1100,3080000,2,54806,13703,1,238360000,238360000,20551,6850,13701,6850,0,1,6852,580690
168,6850,2800,1100,3080000,2,54806,13703,1,238360000,238360000,20551,6850,13701,6850,0,1,6852,585773
168,6850,2800,1100,3080000,2,54806,13703,1,238360000,238360000,20551,6850,13701,6850,0,1,6852,584554
168,6850,2800,1100,3080000,2,54806,13703,1,238360000,238360000,20551,6850,13701,6850,0,1,6852,648994
168,6850,2800,1100,3080000,2,54806,13703,1,238360000,238360000,20551,6850,13701,6850,0,1,6852,649762

168,50,2800,700,1960000,2,406,103,1,17080000,17080000,151,50,101,50,0,1,52,20528
168,50,2800,700,1960000,2,406,103,1,17080000,17080000,151,50,101,50,0,1,52,24042
168,50,2800,700,1960000,2,406,103,1,17080000,17080000,151,50,101,50,0,1,52,21957
168,50,2800,700,1960000,2,406,103,1,17080000,17080000,151,50,101,50,0,1,52,25804
168,50,2800,700,1960000,2,406,103,1,17080000,17080000,151,50,101,50,0,1,52,24616
168,50,2800,700,1960000,2,406,103,1,17080000,17080000,151,50,101,50,0,1,52,30453
168,50,2800,700,1960000,2,406,103,1,17080000,17080000,151,50,101,50,0,1,52,29165

168,450,2800,700,1960000,2,3606,903,1,28280000,28280000,1351,450,901,450,0,1,452,195623
168,450,2800,700,1960000,2,3606,903,1,28280000,28280000,1351,450,901,450,0,1,452,49649
168,450,2800,700,1960000,2,3606,903,1,28280000,28280000,1351,450,901,450,0,1,452,45134
168,450,2800,700,1960000,2,3606,903,1,28280000,28280000,1351,450,901,450,0,1,452,50242
168,450,2800,700,1960000,2,3606,903,1,28280000,28280000,1351,450,901,450,0,1,452,50737
168,450,2800,700,1960000,2,3606,903,1,28280000,28280000,1351,450,901,450,0,1,452,53731
168,450,2800,700,1960000,2,3606,903,1,28280000,28280000,1351,450,901,450,0,1,452,55912

168,850,2800,700,1960000,2,6806,1703,1,39480000,39480000,2551,850,1701,850,0,1,852,410343
168,850,2800,700,1960000,2,6806,1703,1,39480000,39480000,2551,850,1701,850,0,1,852,72332
168,850,2800,700,1960000,2,6806,1703,1,39480000,39480000,2551,850,1701,850,0,1,852,72858
168,850,2800,700,1960000,2,6806,1703,1,39480000,39480000,2551,850,1701,850,0,1,852,71348
168,850,2800,700,1960000,2,6806,1703,1,39480000,39480000,2551,850,1701,850,0,1,852,69011
168,850,2800,700,1960000,2,6806,1703,1,39480000,39480000,2551,850,1701,850,0,1,852,81165
168,850,2800,700,1960000,2,6806,1703,1,39480000,39480000,2551,850,1701,850,0,1,852,81736

168,1250,2800,700,1960000,2,10006,2503,1,50680000,50680000,3751,1250,2501,1250,0,1,1252,612166
168,1250,2800,700,1960000,2,10006,2503,1,50680000,50680000,3751,1250,2501,1250,0,1,1252,92915
168,1250,2800,700,1960000,2,10006,2503,1,50680000,50680000,3751,1250,2501,1250,0,1,1252,91946
168,1250,2800,700,1960000,2,10006,2503,1,50680000,50680000,3751,1250,2501,1250,0,1,1252,93658
168,1250,2800,700,1960000,2,10006,2503,1,50680000,50680000,3751,1250,2501,1250,0,1,1252,92627
168,1250,2800,700,1960000,2,10006,2503,1,50680000,50680000,3751,1250,2501,1250,0,1,1252,105086
168,1250,2800,700,1960000,2,10006,2503,1,50680000,50680000,3751,1250,2501,1250,0,1,1252,104480

168,1650,2800,700,1960000,2,13206,3303,1,61880000,61880000,4951,1650,3301,1650,0,1,1652,802465
168,1650,2800,700,1960000,2,13206,3303,1,61880000,61880000,4951,1650,3301,1650,0,1,1652,134576
168,1650,2800,700,1960000,2,13206,3303,1,61880000,61880000,4951,1650,3301,1650,0,1,1652,136893
168,1650,2800,700,1960000,2,13206,3303,1,61880000,61880000,4951,1650,3301,1650,0,1,1652,138961
168,1650,2800,700,1960000,2,13206,3303,1,61880000,61880000,4951,1650,3301,1650,0,1,1652,140294
168,1650,2800,700,1960000,2,13206,3303,1,61880000,61880000,4951,1650,3301,1650,0,1,1652,150276
168,1650,2800,700,1960000,2,13206,3303,1,61880000,61880000,4951,1650,3301,1650,0,1,1652,150925

168,2050,2800,700,1960000,2,16406,4103,1,73080000,73080000,6151,2050,4101,2050,0,1,2052,988182
168,2050,2800,700,1960000,2,16406,4103,1,73080000,73080000,6151,2050,4101,2050,0,1,2052,135971
168,2050,2800,700,1960000,2,16406,4103,1,73080000,73080000,6151,2050,4101,2050,0,1,2052,142062
168,2050,2800,700,1960000,2,16406,4103,1,73080000,73080000,6151,2050,4101,2050,0,1,2052,144206
168,2050,2800,700,1960000,2,16406,4103,1,73080000,73080000,6151,2050,4101,2050,0,1,2052,142819
168,2050,2800,700,1960000,2,16406,4103,1,73080000,73080000,6151,2050,4101,2050,0,1,2052,163726
168,2050,2800,700,1960000,2,16406,4103,1,73080000,73080000,6151,2050,4101,2050,0,1,2052,164413

168,2450,2800,700,1960000,2,19606,4903,1,84280000,84280000,7351,2450,4901,2450,0,1,2452,1191756
168,2450,2800,700,1960000,2,19606,4903,1,84280000,84280000,7351,2450,4901,2450,0,1,2452,163772
168,2450,2800,700,1960000,2,19606,4903,1,84280000,84280000,7351,2450,4901,2450,0,1,2452,163353
168,2450,2800,700,1960000,2,19606,4903,1,84280000,84280000,7351,2450,4901,2450,0,1,2452,162097
168,2450,2800,700,1960000,2,19606,4903,1,84280000,84280000,7351,2450,4901,2450,0,1,2452,162756
168,2450,2800,700,1960000,2,19606,4903,1,84280000,84280000,7351,2450,4901,2450,0,1,2452,201118
168,2450,2800,700,1960000,2,19606,4903,1,84280000,84280000,7351,2450,4901,2450,0,1,2452,201632

168,2850,2800,700,1960000,2,22806,5703,1,95480000,95480000,8551,2850,5701,2850,0,1,2852,1417591
168,2850,2800,700,1960000,2,22806,5703,1,95480000,95480000,8551,2850,5701,2850,0,1,2852,191014
168,2850,2800,700,1960000,2,22806,5703,1,95480000,95480000,8551,2850,5701,2850,0,1,2852,190533
168,2850,2800,700,1960000,2,22806,5703,1,95480000,95480000,8551,2850,5701,2850,0,1,2852,189110
168,2850,2800,700,1960000,2,22806,5703,1,95480000,95480000,8551,2850,5701,2850,0,1,2852,189865
168,2850,2800,700,1960000,2,22806,5703,1,95480000,95480000,8551,2850,5701,2850,0,1,2852,206667
168,2850,2800,700,1960000,2,22806,5703,1,95480000,95480000,8551,2850,5701,2850,0,1,2852,206124

168,3250,2800,700,1960000,2,26006,6503,1,106680000,106680000,9751,3250,6501,3250,0,1,3252,1651606
168,3250,2800,700,1960000,2,26006,6503,1,106680000,106680000,9751,3250,6501,3250,0,1,3252,220070
168,3250,2800,700,1960000,2,26006,6503,1,106680000,106680000,9751,3250,6501,3250,0,1,3252,223100
168,3250,2800,700,1960000,2,26006,6503,1,106680000,106680000,9751,3250,6501,3250,0,1,3252,222353
168,3250,2800,700,1960000,2,26006,6503,1,106680000,106680000,9751,3250,6501,3250,0,1,3252,221484
168,3250,2800,700,1960000,2,26006,6503,1,106680000,106680000,9751,3250,6501,3250,0,1,3252,224262
168,3250,2800,700,1960000,2,26006,6503,1,106680000,106680000,9751,3250,6501,3250,0,1,3252,224833

168,3650,2800,700,1960000,2,29206,7303,1,117880000,117880000,10951,3650,7301,3650,0,1,3652,1845781
168,3650,2800,700,1960000,2,29206,7303,1,117880000,117880000,10951,3650,7301,3650,0,1,3652,236538
168,3650,2800,700,1960000,2,29206,7303,1,117880000,117880000,10951,3650,7301,3650,0,1,3652,239630
168,3650,2800,700,1960000,2,29206,7303,1,117880000,117880000,10951,3650,7301,3650,0,1,3652,242764
168,3650,2800,700,1960000,2,29206,7303,1,117880000,117880000,10951,3650,7301,3650,0,1,3652,241295
168,3650,2800,700,1960000,2,29206,7303,1,117880000,117880000,10951,3650,7301,3650,0,1,3652,248592
168,3650,2800,700,1960000,2,29206,7303,1,117880000,117880000,10951,3650,7301,3650,0,1,3652,247999

168,4050,2800,700,1960000,2,32406,8103,1,129080000,129080000,12151,4050,8101,4050,0,1,4052,2022198
168,4050,2800,700,1960000,2,32406,8103,1,129080000,129080000,12151,4050,8101,4050,0,1,4052,256768
168,4050,2800,700,1960000,2,32406,8103,1,129080000,129080000,12151,4050,8101,4050,0,1,4052,258010
168,4050,2800,700,1960000,2,32406,8103,1,129080000,129080000,12151,4050,8101,4050,0,1,4052,252589
168,4050,2800,700,1960000,2,32406,8103,1,129080000,129080000,12151,4050,8101,4050,0,1,4052,258811
168,4050,2800,700,1960000,2,32406,8103,1,129080000,129080000,12151,4050,8101,4050,0,1,4052,281770
168,4050,2800,700,1960000,2,32406,8103,1,129080000,129080000,12151,4050,8101,4050,0,1,4052,281123

168,4450,2800,700,1960000,2,35606,8903,1,140280000,140280000,13351,4450,8901,4450,0,1,4452,2283599
168,4450,2800,700,1960000,2,35606,8903,1,140280000,140280000,13351,4450,8901,4450,0,1,4452,276823
168,4450,2800,700,1960000,2,35606,8903,1,140280000,140280000,13351,4450,8901,4450,0,1,4452,278035
168,4450,2800,700,1960000,2,35606,8903,1,140280000,140280000,13351,4450,8901,4450,0,1,4452,278707
168,4450,2800,700,1960000,2,35606,8903,1,140280000,140280000,13351,4450,8901,4450,0,1,4452,279729
168,4450,2800,700,1960000,2,35606,8903,1,140280000,140280000,13351,4450,8901,4450,0,1,4452,303149
168,4450,2800,700,1960000,2,35606,8903,1,140280000,140280000,13351,4450,8901,4450,0,1,4452,302508

168,4850,2800,700,1960000,2,38806,9703,1,151480000,151480000,14551,4850,9701,4850,0,1,4852,2459023
168,4850,2800,700,1960000,2,38806,9703,1,151480000,151480000,14551,4850,9701,4850,0,1,4852,311409
168,4850,2800,700,1960000,2,38806,9703,1,151480000,151480000,14551,4850,9701,4850,0,1,4852,306678
168,4850,2800,700,1960000,2,38806,9703,1,151480000,151480000,14551,4850,9701,4850,0,1,4852,308036
168,4850,2800,700,1960000,2,38806,9703,1,151480000,151480000,14551,4850,9701,4850,0,1,4852,302510
168,4850,2800,700,1960000,2,38806,9703,1,151480000,151480000,14551,4850,9701,4850,0,1,4852,345027
168,4850,2800,700,1960000,2,38806,9703,1,151480000,151480000,14551,4850,9701,4850,0,1,4852,344390

168,5250,2800,700,1960000,2,42006,10503,1,162680000,162680000,15751,5250,10501,5250,0,1,5252,2708277
168,5250,2800,700,1960000,2,42006,10503,1,162680000,162680000,15751,5250,10501,5250,0,1,5252,325833
168,5250,2800,700,1960000,2,42006,10503,1,162680000,162680000,15751,5250,10501,5250,0,1,5252,335179
168,5250,2800,700,1960000,2,42006,10503,1,162680000,162680000,15751,5250,10501,5250,0,1,5252,322574
168,5250,2800,700,1960000,2,42006,10503,1,162680000,162680000,15751,5250,10501,5250,0,1,5252,323809
168,5250,2800,700,1960000,2,42006,10503,1,162680000,162680000,15751,5250,10501,5250,0,1,5252,360425
168,5250,2800,700,1960000,2,42006,10503,1,162680000,162680000,15751,5250,10501,5250,0,1,5252,361121

168,5650,2800,700,1960000,2,45206,11303,1,173880000,173880000,16951,5650,11301,5650,0,1,5652,2982848
168,5650,2800,700,1960000,2,45206,11303,1,173880000,173880000,16951,5650,11301,5650,0,1,5652,343805
168,5650,2800,700,1960000,2,45206,11303,1,173880000,173880000,16951,5650,11301,5650,0,1,5652,350839
168,5650,2800,700,1960000,2,45206,11303,1,173880000,173880000,16951,5650,11301,5650,0,1,5652,348985
168,5650,2800,700,1960000,2,45206,11303,1,173880000,173880000,16951,5650,11301,5650,0,1,5652,347910
168,5650,2800,700,1960000,2,45206,11303,1,173880000,173880000,16951,5650,11301,5650,0,1,5652,386183
168,5650,2800,700,1960000,2,45206,11303,1,173880000,173880000,16951,5650,11301,5650,0,1,5652,385483

168,6050,2800,700,1960000,2,48406,12103,1,185080000,185080000,18151,6050,12101,6050,0,1,6052,3115401
168,6050,2800,700,1960000,2,48406,12103,1,185080000,185080000,18151,6050,12101,6050,0,1,6052,375463
168,6050,2800,700,1960000,2,48406,12103,1,185080000,185080000,18151,6050,12101,6050,0,1,6052,379918
168,6050,2800,700,1960000,2,48406,12103,1,185080000,185080000,18151,6050,12101,6050,0,1,6052,381950
168,6050,2800,700,1960000,2,48406,12103,1,185080000,185080000,18151,6050,12101,6050,0,1,6052,380952
168,6050,2800,700,1960000,2,48406,12103,1,185080000,185080000,18151,6050,12101,6050,0,1,6052,413391
168,6050,2800,700,1960000,2,48406,12103,1,185080000,185080000,18151,6050,12101,6050,0,1,6052,411979

168,6450,2800,700,1960000,2,51606,12903,1,196280000,196280000,19351,6450,12901,6450,0,1,6452,3585297
168,6450,2800,700,1960000,2,51606,12903,1,196280000,196280000,19351,6450,12901,6450,0,1,6452,390601
168,6450,2800,700,1960000,2,51606,12903,1,196280000,196280000,19351,6450,12901,6450,0,1,6452,387011
168,6450,2800,700,1960000,2,51606,12903,1,196280000,196280000,19351,6450,12901,6450,0,1,6452,388913
168,6450,2800,700,1960000,2,51606,12903,1,196280000,196280000,19351,6450,12901,6450,0,1,6452,389830
168,6450,2800,700,1960000,2,51606,12903,1,196280000,196280000,19351,6450,12901,6450,0,1,6452,446091
168,6450,2800,700,1960000,2,51606,12903,1,196280000,196280000,19351,6450,12901,6450,0,1,6452,445304

168,6850,2800,700,1960000,2,54806,13703,1,207480000,207480000,20551,6850,13701,6850,0,1,6852,3546517
168,6850,2800,700,1960000,2,54806,13703,1,207480000,207480000,20551,6850,13701,6850,0,1,6852,413256
168,6850,2800,700,1960000,2,54806,13703,1,207480000,207480000,20551,6850,13701,6850,0,1,6852,417309
168,6850,2800,700,1960000,2,54806,13703,1,207480000,207480000,20551,6850,13701,6850,0,1,6852,416252
168,6850,2800,700,1960000,2,54806,13703,1,207480000,207480000,20551,6850,13701,6850,0,1,6852,414187
168,6850,2800,700,1960000,2,54806,13703,1,207480000,207480000,20551,6850,13701,6850,0,1,6852,475160
168,6850,2800,700,1960000,2,54806,13703,1,207480000,207480000,20551,6850,13701,6850,0,1,6852,474344

168,50,2800,300,840000,2,406,103,1,7960000,7960000,151,50,101,50,0,1,52,8867
168,50,2800,300,840000,2,406,103,1,7960000,7960000,151,50,101,50,0,1,52,20952
168,50,2800,300,840000,2,406,103,1,7960000,7960000,151,50,101,50,0,1,52,15012
168,50,2800,300,840000,2,406,103,1,7960000,7960000,151,50,101,50,0,1,52,19621
168,50,2800,300,840000,2,406,103,1,7960000,7960000,151,50,101,50,0,1,52,17854
168,50,2800,300,840000,2,406,103,1,7960000,7960000,151,50,101,50,0,1,52,21394
168,50,2800,300,840000,2,406,103,1,7960000,7960000,151,50,101,50,0,1,52,21599

168,450,2800,300,840000,2,3606,903,1,17880000,17880000,1351,450,901,450,0,1,452,82889
168,450,2800,300,840000,2,3606,903,1,17880000,17880000,1351,450,901,450,0,1,452,36578
168,450,2800,300,840000,2,3606,903,1,17880000,17880000,1351,450,901,450,0,1,452,34976
168,450,2800,300,840000,2,3606,903,1,17880000,17880000,1351,450,901,450,0,1,452,33711
168,450,2800,300,840000,2,3606,903,1,17880000,17880000,1351,450,901,450,0,1,452,36949
168,450,2800,300,840000,2,3606,903,1,17880000,17880000,1351,450,901,450,0,1,452,38770
168,450,2800,300,840000,2,3606,903,1,17880000,17880000,1351,450,901,450,0,1,452,39282

168,850,2800,300,840000,2,6806,1703,1,27800000,27800000,2551,850,1701,850,0,1,852,168853
168,850,2800,300,840000,2,6806,1703,1,27800000,27800000,2551,850,1701,850,0,1,852,43661
168,850,2800,300,840000,2,6806,1703,1,27800000,27800000,2551,850,1701,850,0,1,852,45916
168,850,2800,300,840000,2,6806,1703,1,27800000,27800000,2551,850,1701,850,0,1,852,47846
168,850,2800,300,840000,2,6806,1703,1,27800000,27800000,2551,850,1701,850,0,1,852,47322
168,850,2800,300,840000,2,6806,1703,1,27800000,27800000,2551,850,1701,850,0,1,852,53039
168,850,2800,300,840000,2,6806,1703,1,27800000,27800000,2551,850,1701,850,0,1,852,52469

168,1250,2800,300,840000,2,10006,2503,1,37720000,37720000,3751,1250,2501,1250,0,1,1252,257240
168,1250,2800,300,840000,2,10006,2503,1,37720000,37720000,3751,1250,2501,1250,0,1,1252,60670
168,1250,2800,300,840000,2,10006,2503,1,37720000,37720000,3751,1250,2501,1250,0,1,1252,62550
168,1250,2800,300,840000,2,10006,2503,1,37720000,37720000,3751,1250,2501,1250,0,1,1252,63380
168,1250,2800,300,840000,2,10006,2503,1,37720000,37720000,3751,1250,2501,1250,0,1,1252,63068
168,1250,2800,300,840000,2,10006,2503,1,37720000,37720000,3751,1250,2501,1250,0,1,1252,69521
168,1250,2800,300,840000,2,10006,2503,1,37720000,37720000,3751,1250,2501,1250,0,1,1252,70123

168,1650,2800,300,840000,2,13206,3303,1,47640000,47640000,4951,1650,3301,1650,0,1,1652,339108
168,1650,2800,300,840000,2,13206,3303,1,47640000,47640000,4951,1650,3301,1650,0,1,1652,75127
168,1650,2800,300,840000,2,13206,3303,1,47640000,47640000,4951,1650,3301,1650,0,1,1652,76027
168,1650,2800,300,840000,2,13206,3303,1,47640000,47640000,4951,1650,3301,1650,0,1,1652,73807
168,1650,2800,300,840000,2,13206,3303,1,47640000,47640000,4951,1650,3301,1650,0,1,1652,75677
168,1650,2800,300,840000,2,13206,3303,1,47640000,47640000,4951,1650,3301,1650,0,1,1652,83694
168,1650,2800,300,840000,2,13206,3303,1,47640000,47640000,4951,1650,3301,1650,0,1,1652,83042

168,2050,2800,300,840000,2,16406,4103,1,57560000,57560000,6151,2050,4101,2050,0,1,2052,420405
168,2050,2800,300,840000,2,16406,4103,1,57560000,57560000,6151,2050,4101,2050,0,1,2052,89890
168,2050,2800,300,840000,2,16406,4103,1,57560000,57560000,6151,2050,4101,2050,0,1,2052,92094
168,2050,2800,300,840000,2,16406,4103,1,57560000,57560000,6151,2050,4101,2050,0,1,2052,90951
168,2050,2800,300,840000,2,16406,4103,1,57560000,57560000,6151,2050,4101,2050,0,1,2052,91460
168,2050,2800,300,840000,2,16406,4103,1,57560000,57560000,6151,2050,4101,2050,0,1,2052,100298
168,2050,2800,300,840000,2,16406,4103,1,57560000,57560000,6151,2050,4101,2050,0,1,2052,100998

168,2450,2800,300,840000,2,19606,4903,1,67480000,67480000,7351,2450,4901,2450,0,1,2452,513641
168,2450,2800,300,840000,2,19606,4903,1,67480000,67480000,7351,2450,4901,2450,0,1,2452,101656
168,2450,2800,300,840000,2,19606,4903,1,67480000,67480000,7351,2450,4901,2450,0,1,2452,102751
168,2450,2800,300,840000,2,19606,4903,1,67480000,67480000,7351,2450,4901,2450,0,1,2452,102299
168,2450,2800,300,840000,2,19606,4903,1,67480000,67480000,7351,2450,4901,2450,0,1,2452,100945
168,2450,2800,300,840000,2,19606,4903,1,67480000,67480000,7351,2450,4901,2450,0,1,2452,118348
168,2450,2800,300,840000,2,19606,4903,1,67480000,67480000,7351,2450,4901,2450,0,1,2452,116881

168,2850,2800,300,840000,2,22806,5703,1,77400000,77400000,8551,2850,5701,2850,0,1,2852,586868
168,2850,2800,300,840000,2,22806,5703,1,77400000,77400000,8551,2850,5701,2850,0,1,2852,116171
168,2850,2800,300,840000,2,22806,5703,1,77400000,77400000,8551,2850,5701,2850,0,1,2852,114694
168,2850,2800,300,840000,2,22806,5703,1,77400000,77400000,8551,2850,5701,2850,0,1,2852,117321
168,2850,2800,300,840000,2,22806,5703,1,77400000,77400000,8551,2850,5701,2850,0,1,2852,116842
168,2850,2800,300,840000,2,22806,5703,1,77400000,77400000,8551,2850,5701,2850,0,1,2852,138303
168,2850,2800,300,840000,2,22806,5703,1,77400000,77400000,8551,2850,5701,2850,0,1,2852,137400

168,3250,2800,300,840000,2,26006,6503,1,87320000,87320000,9751,3250,6501,3250,0,1,3252,676143
168,3250,2800,300,840000,2,26006,6503,1,87320000,87320000,9751,3250,6501,3250,0,1,3252,126842
168,3250,2800,300,840000,2,26006,6503,1,87320000,87320000,9751,3250,6501,3250,0,1,3252,126089
168,3250,2800,300,840000,2,26006,6503,1,87320000,87320000,9751,3250,6501,3250,0,1,3252,127546
168,3250,2800,300,840000,2,26006,6503,1,87320000,87320000,9751,3250,6501,3250,0,1,3252,128073
168,3250,2800,300,840000,2,26006,6503,1,87320000,87320000,9751,3250,6501,3250,0,1,3252,156591
168,3250,2800,300,840000,2,26006,6503,1,87320000,87320000,9751,3250,6501,3250,0,1,3252,151539

168,3650,2800,300,840000,2,29206,7303,1,97240000,97240000,10951,3650,7301,3650,0,1,3652,758774
168,3650,2800,300,840000,2,29206,7303,1,97240000,97240000,10951,3650,7301,3650,0,1,3652,140825
168,3650,2800,300,840000,2,29206,7303,1,97240000,97240000,10951,3650,7301,3650,0,1,3652,139412
168,3650,2800,300,840000,2,29206,7303,1,97240000,97240000,10951,3650,7301,3650,0,1,3652,141518
168,3650,2800,300,840000,2,29206,7303,1,97240000,97240000,10951,3650,7301,3650,0,1,3652,142048
168,3650,2800,300,840000,2,29206,7303,1,97240000,97240000,10951,3650,7301,3650,0,1,3652,184272
168,3650,2800,300,840000,2,29206,7303,1,97240000,97240000,10951,3650,7301,3650,0,1,3652,185274

168,4050,2800,300,840000,2,32406,8103,1,107160000,107160000,12151,4050,8101,4050,0,1,4052,841888
168,4050,2800,300,840000,2,32406,8103,1,107160000,107160000,12151,4050,8101,4050,0,1,4052,156217
168,4050,2800,300,840000,2,32406,8103,1,107160000,107160000,12151,4050,8101,4050,0,1,4052,153262
168,4050,2800,300,840000,2,32406,8103,1,107160000,107160000,12151,4050,8101,4050,0,1,4052,155608
168,4050,2800,300,840000,2,32406,8103,1,107160000,107160000,12151,4050,8101,4050,0,1,4052,154802
168,4050,2800,300,840000,2,32406,8103,1,107160000,107160000,12151,4050,8101,4050,0,1,4052,196855
168,4050,2800,300,840000,2,32406,8103,1,107160000,107160000,12151,4050,8101,4050,0,1,4052,195785

168,4450,2800,300,840000,2,35606,8903,1,117080000,117080000,13351,4450,8901,4450,0,1,4452,898349
168,4450,2800,300,840000,2,35606,8903,1,117080000,117080000,13351,4450,8901,4450,0,1,4452,169458
168,4450,2800,300,840000,2,35606,8903,1,117080000,117080000,13351,4450,8901,4450,0,1,4452,171772
168,4450,2800,300,840000,2,35606,8903,1,117080000,117080000,13351,4450,8901,4450,0,1,4452,171115
168,4450,2800,300,840000,2,35606,8903,1,117080000,117080000,13351,4450,8901,4450,0,1,4452,170281
168,4450,2800,300,840000,2,35606,8903,1,117080000,117080000,13351,4450,8901,4450,0,1,4452,207930
168,4450,2800,300,840000,2,35606,8903,1,117080000,117080000,13351,4450,8901,4450,0,1,4452,207262

168,4850,2800,300,840000,2,38806,9703,1,127000000,127000000,14551,4850,9701,4850,0,1,4852,1002056
168,4850,2800,300,840000,2,38806,9703,1,127000000,127000000,14551,4850,9701,4850,0,1,4852,179545
168,4850,2800,300,840000,2,38806,9703,1,127000000,127000000,14551,4850,9701,4850,0,1,4852,181149
168,4850,2800,300,840000,2,38806,9703,1,127000000,127000000,14551,4850,9701,4850,0,1,4852,181803
168,4850,2800,300,840000,2,38806,9703,1,127000000,127000000,14551,4850,9701,4850,0,1,4852,180356
168,4850,2800,300,840000,2,38806,9703,1,127000000,127000000,14551,4850,9701,4850,0,1,4852,215469
168,4850,2800,300,840000,2,38806,9703,1,127000000,127000000,14551,4850,9701,4850,0,1,4852,216299

168,5250,2800,300,840000,2,42006,10503,1,136920000,136920000,15751,5250,10501,5250,0,1,5252,1113596
168,5250,2800,300,840000,2,42006,10503,1,136920000,136920000,15751,5250,10501,5250,0,1,5252,194337
168,5250,2800,300,840000,2,42006,10503,1,136920000,136920000,15751,5250,10501,5250,0,1,5252,196952
168,5250,2800,300,840000,2,42006,10503,1,136920000,136920000,15751,5250,10501,5250,0,1,5252,196088
168,5250,2800,300,840000,2,42006,10503,1,136920000,136920000,15751,5250,10501,5250,0,1,5252,197642
168,5250,2800,300,840000,2,42006,10503,1,136920000,136920000,15751,5250,10501,5250,0,1,5252,232349
168,5250,2800,300,840000,2,42006,10503,1,136920000,136920000,15751,5250,10501,5250,0,1,5252,231600

168,5650,2800,300,840000,2,45206,11303,1,146840000,146840000,16951,5650,11301,5650,0,1,5652,1173693
168,5650,2800,300,840000,2,45206,11303,1,146840000,146840000,16951,5650,11301,5650,0,1,5652,209315
168,5650,2800,300,840000,2,45206,11303,1,146840000,146840000,16951,5650,11301,5650,0,1,5652,210094
168,5650,2800,300,840000,2,45206,11303,1,146840000,146840000,16951,5650,11301,5650,0,1,5652,211029
168,5650,2800,300,840000,2,45206,11303,1,146840000,146840000,16951,5650,11301,5650,0,1,5652,208074
168,5650,2800,300,840000,2,45206,11303,1,146840000,146840000,16951,5650,11301,5650,0,1,5652,249223
168,5650,2800,300,840000,2,45206,11303,1,146840000,146840000,16951,5650,11301,5650,0,1,5652,250002

168,6050,2800,300,840000,2,48406,12103,1,156760000,156760000,18151,6050,12101,6050,0,1,6052,1279989
168,6050,2800,300,840000,2,48406,12103,1,156760000,156760000,18151,6050,12101,6050,0,1,6052,222632
168,6050,2800,300,840000,2,48406,12103,1,156760000,156760000,18151,6050,12101,6050,0,1,6052,220891
168,6050,2800,300,840000,2,48406,12103,1,156760000,156760000,18151,6050,12101,6050,0,1,6052,221755
168,6050,2800,300,840000,2,48406,12103,1,156760000,156760000,18151,6050,12101,6050,0,1,6052,223379
168,6050,2800,300,840000,2,48406,12103,1,156760000,156760000,18151,6050,12101,6050,0,1,6052,254994
168,6050,2800,300,840000,2,48406,12103,1,156760000,156760000,18151,6050,12101,6050,0,1,6052,254213

168,6450,2800,300,840000,2,51606,12903,1,166680000,166680000,19351,6450,12901,6450,0,1,6452,1348192
168,6450,2800,300,840000,2,51606,12903,1,166680000,166680000,19351,6450,12901,6450,0,1,6452,235803
168,6450,2800,300,840000,2,51606,12903,1,166680000,166680000,19351,6450,12901,6450,0,1,6452,236590
168,6450,2800,300,840000,2,51606,12903,1,166680000,166680000,19351,6450,12901,6450,0,1,6452,234896
168,6450,2800,300,840000,2,51606,12903,1,166680000,166680000,19351,6450,12901,6450,0,1,6452,234008
168,6450,2800,300,840000,2,51606,12903,1,166680000,166680000,19351,6450,12901,6450,0,1,6452,273030
168,6450,2800,300,840000,2,51606,12903,1,166680000,166680000,19351,6450,12901,6450,0,1,6452,273813

168,6850,2800,300,840000,2,54806,13703,1,176600000,176600000,20551,6850,13701,6850,0,1,6852,1427791
168,6850,2800,300,840000,2,54806,13703,1,176600000,176600000,20551,6850,13701,6850,0,1,6852,252265
168,6850,2800,300,840000,2,54806,13703,1,176600000,176600000,20551,6850,13701,6850,0,1,6852,253140
168,6850,2800,300,840000,2,54806,13703,1,176600000,176600000,20551,6850,13701,6850,0,1,6852,254198
168,6850,2800,300,840000,2,54806,13703,1,176600000,176600000,20551,6850,13701,6850,0,1,6852,250943
168,6850,2800,300,840000,2,54806,13703,1,176600000,176600000,20551,6850,13701,6850,0,1,6852,297739
168,6850,2800,300,840000,2,54806,13703,1,176600000,176600000,20551,6850,13701,6850,0,1,6852,298589

